period,mktsize,entries,exits,surviv,entryrate,exitrate,survivrate,firms,totresinv,totinninv,totimiinv,costshareinn,firmsres,firmsinn,firmsimi,hindex,div,gini,pcm,cs,totprofits,ts,maxage,minage,avgage,actfirms,inactfirms,profitablefirms,wmc,avgproxopt,price,totoutput,avgoutput,magtechshock
1,32,40,14,26,1.0,0.35,0.65,40,0,0,0,0,0,0,0,424.913494809689,0.5001201923076923,0.46232620320855666,0.18308484684196255,948594.8350694431,72614.1493055554,1021208.9843749985,0,0,0.0,35,5,26,46.16421568627451,0.49296874999999996,56.51041666666666,7791.666666666655,222.61904761904728,0
2,32,32,16,42,0.5517241379310345,0.27586206896551724,0.7241379310344828,58,1200,900,300,0.75,15,9,6,319.6675409549264,0.4993257209114741,0.5068434456205564,0.15246914265579728,984091.5557484581,50116.425540123586,1034207.9812885817,1,0,0.4482758620689655,47,11,31,44.06866176642167,0.5210129310344828,51.996527777777786,7936.111111111122,168.85342789598133,0
3,32,17,9,50,0.288135593220339,0.15254237288135594,0.847457627118644,59,1500,900,600,0.6,21,9,12,286.62173686568354,0.4947642704071693,0.45450621690267123,0.14415802627579455,1001961.7454825072,44136.80315263365,1046098.5486351408,2,0,1.1355932203389831,50,9,37,42.582333496572005,0.543255649717514,49.754901960784316,8007.843137254905,160.1568627450981,0
4,32,13,8,55,0.20634920634920634,0.12698412698412698,0.873015873015873,63,2050,1300,750,0.6341463414634146,28,13,15,293.7374400162406,0.49458098651647037,0.5071225071225074,0.15069518474396404,1008518.0624999998,44597.90277777777,1053115.9652777775,3,0,1.746031746031746,49,14,32,41.562854396592286,0.5471230158730158,48.9375,8033.999999999998,163.95918367346934,8
5,32,10,8,57,0.15384615384615385,0.12307692307692308,0.8769230769230769,65,1500,900,600,0.6,21,9,12,272.61574990106817,0.4918669871794872,0.4878426836321572,0.14274761707418154,1015208.9072543626,40852.38751147846,1056061.294765841,4,0,2.4307692307692306,54,11,36,41.239035087719294,0.5544871794871795,48.10606060606061,8060.606060606067,149.27048260381605,0
6,32,4,3,58,0.06557377049180328,0.04918032786885246,0.9508196721311475,61,1250,1000,250,0.8,15,10,5,276.40733421471685,0.49055100182149364,0.46405427915574804,0.14579131941913465,1017576.5624999974,42803.12499999975,1060379.6874999972,5,0,3.278688524590164,49,12,39,40.84185254027262,0.5609631147540983,47.812499999999986,8069.99999999998,164.69387755102,0
7,32,4,2,60,0.06451612903225806,0.03225806451612903,0.967741935483871,62,1950,1400,550,0.717948717948718,25,14,11,266.70317580832676,0.48928036312356776,0.4524017746410449,0.14250150626099245,1021751.6295303219,40150.88089661378,1061902.5104269357,6,0,4.032258064516129,51,11,42,40.555968423834045,0.5648521505376345,47.29567307692306,8086.538461538434,158.55957767722418,0
8,32,4,1,63,0.0625,0.015625,0.984375,64,2100,1100,1000,0.5238095238095238,31,11,20,277.6242164733144,0.48930431547619047,0.4930704725710515,0.14635729600143704,1017408.4444444434,41591.44444444437,1058999.8888888878,7,0,4.671875,49,15,36,40.83257600793128,0.5559895833333333,47.83333333333333,8069.333333333325,164.68027210884335,8
9,32,5,5,63,0.07352941176470588,0.07352941176470588,0.9264705882352942,68,2100,1200,900,0.5714285714285714,30,12,18,263.89825639488447,0.4900040239976588,0.4974322012977863,0.14108406784188018,1021937.190082642,38237.488521579224,1060174.6786042212,8,0,5.3088235294117645,54,14,35,40.60329861111111,0.5588235294117647,47.27272727272726,8087.272727272706,149.76430976430936,0
10,32,8,5,66,0.11267605633802817,0.07042253521126761,0.9295774647887324,71,2350,1900,450,0.8085106382978723,28,19,9,243.57827032655004,0.48905097250167673,0.4749780951757905,0.13224115023557598,1026875.7204027595,33474.92236320687,1060350.6427659665,9,0,5.71830985915493,53,18,41,40.49206515393791,0.5635269953051643,46.66280864197531,8106.790123456796,152.95830421616597,0
11,32,8,5,69,0.10810810810810811,0.06756756756756757,0.9324324324324325,74,2350,1400,950,0.5957446808510638,33,14,19,224.00672474717322,0.4877514500802172,0.4515606722896013,0.12385258458943237,1032669.9674211284,29115.003429355562,1061784.970850484,10,0,6.027027027027027,62,12,41,40.25816249050874,0.5695382882882882,45.94907407407409,8129.629629629658,131.12305854241384,0
12,32,2,3,68,0.028169014084507043,0.04225352112676056,0.9577464788732395,71,2100,1400,700,0.6666666666666666,28,14,14,237.1842500772569,0.48735747820254866,0.45968453774417783,0.12705273801753178,1022572.1949430521,32207.603841484226,1054779.7987845363,11,0,7.056338028169014,61,10,40,41.19806550585942,0.5561913145539906,47.19422043010751,8089.78494623652,132.61942534813969,8
13,32,6,1,73,0.08108108108108109,0.013513513513513514,0.9864864864864865,74,2950,2000,950,0.6779661016949152,39,20,19,223.10061549479707,0.4871922436134765,0.44723030248332174,0.12147282463234166,1027794.6641710041,28110.32443576373,1055904.9886067677,12,0,7.391891891891892,63,11,43,40.89498244712731,0.5629222972972974,46.54947916666666,8110.416666666644,128.73677248677214,0
14,32,5,5,73,0.0641025641025641,0.0641025641025641,0.9358974358974359,78,2450,1800,650,0.7346938775510204,31,18,13,212.4903574604518,0.4879148629148629,0.44937787779436644,0.1168046415469836,1030829.2552437567,25758.2553854871,1056587.5106292437,13,0,7.884615384615385,69,9,38,40.78207138809092,0.5649038461538461,46.17559523809521,8122.380952380892,117.71566597653467,0
15,32,4,2,75,0.05194805194805195,0.025974025974025976,0.974025974025974,77,2600,1800,800,0.6923076923076923,34,18,16,226.94289837146954,0.48622265892002736,0.4865800865800858,0.12306058573664211,1026488.9196675917,28590.874115112434,1055079.793782704,14,0,8.7012987012987,56,21,40,40.962301587301575,0.557224025974026,46.71052631578948,8105.26315789475,144.7368421052634,8
16,32,11,4,82,0.12790697674418605,0.046511627906976744,0.9534883720930233,86,2750,1500,1250,0.5454545454545454,40,15,25,199.52413650754212,0.4869813041495668,0.47636887946061246,0.11078233732653683,1034002.173734391,21311.678172255422,1055313.8519066465,15,0,8.581395348837209,64,22,46,40.71305869003339,0.5632267441860466,45.78525641025643,8134.87179487184,127.1073717948725,0
17,32,5,1,86,0.05747126436781609,0.011494252873563218,0.9885057471264368,87,2900,1700,1200,0.5862068965517241,41,17,24,195.38675891165843,0.48601643945469125,0.46980166399840617,0.10990835680592254,1038101.271145717,20266.24855824706,1058367.519703964,16,0,9.091954022988507,67,20,46,40.305007617672985,0.5683668582375478,45.28186274509805,8150.980392156894,121.65642376353573,0
18,32,4,6,84,0.044444444444444446,0.06666666666666667,0.9333333333333333,90,3400,2700,700,0.7941176470588235,41,27,14,231.02962684328355,0.48635819808572617,0.5656665972173973,0.12829138437780402,1034041.9469580963,26378.865029206587,1060420.811987303,17,0,9.566666666666666,58,32,41,39.90714054216726,0.5584490740740741,45.780367231638444,8135.028248587622,140.25910773426935,8
19,32,6,2,88,0.06666666666666667,0.022222222222222223,0.9777777777777777,90,2900,1900,1000,0.6551724137931034,39,19,20,230.16847731994477,0.4866651061173533,0.5637426900584801,0.12494860197368413,1026844.4444444423,26369.444444444303,1053213.8888888867,18,0,10.255555555555556,59,31,42,40.83573190789475,0.5510416666666667,46.66666666666666,8106.66666666665,137.40112994350253,8
20,32,2,4,86,0.022222222222222223,0.044444444444444446,0.9555555555555556,90,3400,2200,1200,0.6470588235294118,46,22,24,236.9338231683341,0.48679255097794427,0.5690567062624197,0.12762900952789014,1024365.3869628871,27141.361490885174,1051506.7484537724,19,0,11.1,63,27,42,40.977582657918404,0.5476851851851852,46.972656249999986,8096.874999999973,128.52182539682497,8
21,32,3,5,84,0.033707865168539325,0.056179775280898875,0.9438202247191011,89,2550,1800,750,0.7058823529411765,33,18,15,229.453474322615,0.4863274599931903,0.5508946542648443,0.125125532130609,1028288.679507751,26838.882023933667,1055127.5615316846,20,0,11.696629213483146,61,28,42,40.6716675503126,0.5531367041198502,46.48857526881722,8112.365591397885,132.9895998589817,0
22,32,7,1,90,0.07692307692307693,0.01098901098901099,0.989010989010989,91,2800,1900,900,0.6785714285714286,37,19,18,262.1355040387476,0.48646214896214895,0.615759405903487,0.14347050615332074,1029450.9928899688,32971.13098087994,1062422.1238708487,21,0,11.692307692307692,58,33,38,39.69614974130529,0.5538003663003663,46.34533898305082,8116.94915254233,139.9473991817643,8
23,32,3,7,86,0.03225806451612903,0.07526881720430108,0.9247311827956989,93,2550,1600,950,0.6274509803921569,35,16,19,236.9489985244735,0.48631077606358114,0.5908155259694872,0.12733714347115657,1023609.9585262345,27358.670910493824,1050968.6294367283,22,0,12.376344086021506,59,34,39,41.07272576475164,0.5412186379928315,47.06597222222222,8093.888888888889,137.1845574387947,8
24,32,5,4,87,0.054945054945054944,0.04395604395604396,0.9560439560439561,91,2900,1800,1100,0.6206896551724138,40,18,22,224.1915013810382,0.4861365486365486,0.5566675006254687,0.12227579094426509,1028340.070620205,25009.02087252537,1053349.0914927304,23,0,13.098901098901099,60,31,43,40.79858772284339,0.5476190476190477,46.482240437158474,8112.56830601094,135.20947176684902,0
25,32,4,9,82,0.04395604395604396,0.0989010989010989,0.9010989010989011,91,2950,1900,1050,0.6440677966101694,40,19,21,226.89407688749407,0.48609076109076105,0.5552268688979294,0.12535719807402146,1032438.3670282732,25700.830046022475,1058139.1970742957,24,0,13.428571428571429,64,27,42,40.21394549239792,0.5543727106227105,45.97756410256411,8128.717948717967,127.01121794871824,0
26,32,4,4,82,0.046511627906976744,0.046511627906976744,0.9534883720930233,86,2750,1900,850,0.6909090909090909,36,19,17,226.65854536779693,0.48417122663018697,0.5269222563227263,0.12674631364884292,1036242.0935724663,27024.62511560311,1063266.7186880694,25,0,14.023255813953488,57,29,47,39.741825452834625,0.561531007751938,45.51005747126437,8143.678160919537,142.87154668279888,0
27,32,6,3,85,0.06818181818181818,0.03409090909090909,0.9659090909090909,88,2650,2100,550,0.7924528301886793,32,21,11,238.52664331685907,0.484375,0.5618562472010753,0.13086732052249292,1030224.9999999997,28897.222222222215,1059122.2222222218,26,0,14.204545454545455,59,29,37,40.19738642583471,0.5542140151515151,46.25,8119.999999999997,137.62711864406776,8
28,32,2,0,87,0.022988505747126436,0.0,1.0,87,2600,1500,1100,0.5769230769230769,37,15,22,228.27630887678757,0.4843401942439633,0.5472561784927397,0.12355455217956116,1025896.5151670586,26837.57395437903,1052734.0891214376,27,0,15.080459770114942,56,31,42,41.00329580446497,0.5529214559386972,46.783625730994146,8102.923976608176,144.6950710108603,8
29,32,5,3,89,0.05434782608695652,0.03260869565217391,0.967391304347826,92,2650,1700,950,0.6415094339622641,36,17,19,214.68131401971493,0.4836782329988852,0.5436690055078406,0.11767341281349276,1029924.8874508654,23171.125635911943,1053096.0130867772,28,0,15.206521739130435,61,31,46,40.84021753526255,0.5553668478260869,46.286962365591414,8118.817204301107,133.0953640049362,0
30,32,5,3,91,0.05319148936170213,0.031914893617021274,0.9680851063829787,94,3200,2100,1100,0.65625,43,21,22,208.55698752708585,0.482941546556852,0.5351959427660267,0.11651034954252035,1035935.4450297757,21210.31513758838,1057145.760167364,29,0,15.627659574468085,61,33,45,40.24093485198633,0.561613475177305,45.547715053763454,8142.473118279598,133.48316587343604,0
31,32,8,1,98,0.08080808080808081,0.010101010101010102,0.98989898989899,99,2350,1500,850,0.6382978723404256,32,15,17,236.31144704156824,0.4849129045557617,0.6084304373532177,0.13089050400576197,1033237.370392396,26683.16362697032,1059920.5340193664,30,0,15.585858585858587,67,32,41,39.87412592681897,0.5548190235690236,45.87928921568627,8131.86274509803,121.3710857477318,7
32,32,5,1,102,0.04854368932038835,0.009708737864077669,0.9902912621359223,103,3750,2500,1250,0.6666666666666666,50,25,25,265.3984094807427,0.4855003490069167,0.6618728038768344,0.14300117627289521,1024453.2455632688,30027.652391975105,1054480.897955244,31,0,15.815533980582524,59,44,38,40.246212121212125,0.5392394822006472,46.96180555555554,8097.2222222222,137.2410546139356,8
33,32,4,2,104,0.03773584905660377,0.018867924528301886,0.9811320754716981,106,3800,2900,900,0.7631578947368421,47,29,18,252.37282728716696,0.48590333932315066,0.6560060196822408,0.13806395230266377,1029305.1761653125,26953.7314900309,1056258.9076553434,32,0,16.235849056603772,56,50,39,39.962203088599075,0.5431407232704403,46.36330409356724,8116.374269005822,144.93525480367538,0
34,32,5,3,106,0.045871559633027525,0.027522935779816515,0.9724770642201834,109,3050,2200,850,0.7213114754098361,39,22,17,239.7623133466607,0.4858598085853438,0.6513718850474368,0.1296368245360897,1025564.5567767923,24328.346123829146,1049892.9029006215,33,0,16.44954128440367,61,48,38,40.75440473820426,0.5397553516819572,46.82459677419354,8101.612903225785,132.8133262823899,8
35,32,7,5,108,0.061946902654867256,0.04424778761061947,0.9557522123893806,113,3500,2600,900,0.7428571428571429,44,26,18,227.1552294480856,0.48569189844079225,0.6452463180375223,0.12456110738446874,1030053.3887897007,20696.402774860384,1050749.791564561,34,0,16.56637168141593,68,45,42,40.50755141706828,0.5436025073746313,46.27113526570047,8119.323671497563,119.40181869849357,0
36,32,6,3,111,0.05263157894736842,0.02631578947368421,0.9736842105263158,114,3650,2400,1250,0.6575342465753424,49,24,25,224.07677722000886,0.4860383351446463,0.6429626029172832,0.12447270688348501,1034149.0999692085,19895.759497214727,1054044.8594664233,35,0,16.82456140350877,62,52,41,40.07042902358657,0.5476059941520468,45.76719576719578,8135.449735449757,131.21693121693156,0
37,32,4,3,112,0.034782608695652174,0.02608695652173913,0.9739130434782609,115,3750,2700,1050,0.72,48,27,21,220.53208088106726,0.4860856852275617,0.6415187520743442,0.12362933325667519,1037028.1096074369,18989.59338877759,1056017.7029962146,36,0,17.556521739130435,66,49,43,39.79910941475828,0.5503623188405797,45.41355721393035,8146.766169154241,123.43585104779153,0
38,32,7,6,113,0.058823529411764705,0.05042016806722689,0.9495798319327731,119,3450,1800,1650,0.5217391304347826,51,18,33,220.02134028801441,0.4862525518682049,0.6576915347986212,0.12254168687564232,1034978.0502081158,18293.451555093074,1053271.501763209,37,0,17.77310924369748,61,58,41,40.06941691989259,0.5497198879551821,45.66532258064516,8138.709677419349,133.42147012162866,8
39,32,3,1,115,0.02586206896551724,0.008620689655172414,0.9913793103448276,116,4950,4000,950,0.8080808080808081,59,40,19,216.83157779253668,0.4854635182408796,0.643402575313283,0.12184967670049919,1037788.2083673695,16855.05092695742,1054643.2592943269,38,0,18.948275862068964,66,50,44,39.798012941822876,0.5536997126436782,45.320273631840806,8149.751243781113,123.48107945122898,0
40,32,1,5,111,0.008620689655172414,0.04310344827586207,0.9568965517241379,116,3800,2500,1300,0.6578947368421053,51,25,26,220.02721209265133,0.4853214017991005,0.6485739936145307,0.12418185781798931,1039143.8576454561,18727.985192186712,1057871.8428376429,39,0,19.905172413793103,68,48,37,39.546679699069976,0.5552262931034483,45.15398550724639,8155.072463768143,119.92753623188446,0
41,32,2,6,107,0.017699115044247787,0.05309734513274336,0.9469026548672567,113,4100,3000,1100,0.7317073170731707,52,30,22,237.18994692504788,0.4846976401179941,0.6604573107755003,0.1337257522329099,1038810.2851485722,22579.07127991676,1061389.3564284889,40,0,20.539823008849556,61,52,37,39.151171480065045,0.556047197640118,45.19489247311828,8153.763440860215,133.66825312885598,8
42,32,5,3,109,0.044642857142857144,0.026785714285714284,0.9732142857142857,112,3350,2100,1250,0.6268656716417911,46,21,25,224.18877916019346,0.48415212087087084,0.6382567071772531,0.12813725634568843,1043077.1298038153,21019.237660127143,1064096.3674639424,41,0,21.294642857142858,60,52,42,38.94796682718032,0.560546875,44.67213114754098,8170.491803278682,136.17486338797804,0
43,32,2,1,110,0.018018018018018018,0.009009009009009009,0.990990990990991,111,4050,2600,1450,0.6419753086419753,55,26,29,217.23770760978834,0.48366434616434617,0.6209987590113784,0.1252079151132778,1045671.1758584783,19181.841831425434,1064853.0176899037,42,0,22.18918918918919,61,50,42,38.80126182965299,0.5636261261261262,44.35483870967741,8180.645161290303,134.10893707033284,0
44,32,3,0,113,0.02654867256637168,0.0,1.0,113,3000,2100,900,0.7,39,21,18,246.68657794754824,0.483871286346397,0.669931672695774,0.14005967189228444,1041003.3132443083,25760.308995259733,1066763.622239568,43,0,22.663716814159294,61,52,40,38.633743907258584,0.5578908554572272,44.926075268817215,8162.365591397871,133.80927199012902,8
45,32,1,4,110,0.008771929824561403,0.03508771929824561,0.9649122807017544,114,3650,2800,850,0.7671232876712328,45,28,17,229.87466077501162,0.4837224421673653,0.6511754296134586,0.12790461894404564,1034670.4101562557,21118.90190972256,1055789.3120659783,44,0,23.45614035087719,63,51,38,39.85748421232292,0.5514437134502924,45.70312500000002,8137.5000000000455,129.1666666666674,8
46,32,2,0,112,0.017857142857142856,0.0,1.0,112,3400,2100,1300,0.6176470588235294,47,21,26,229.317394080224,0.48413871460746466,0.6451698571690327,0.12845069084076358,1036774.8052337851,21750.09931684886,1058524.9045506339,45,0,23.901785714285715,66,46,38,39.6072548301065,0.5547805059523809,45.44465174129355,8145.771144278637,123.42077491331268,0
47,32,1,3,110,0.008849557522123894,0.02654867256637168,0.9734513274336283,113,4400,2800,1600,0.6363636363636364,60,28,32,229.89421775291794,0.48368692056468604,0.6467973242134144,0.12964866359677613,1038897.6441982334,20767.312247660535,1059664.956445894,46,0,24.68141592920354,68,45,40,39.326110354088925,0.5567846607669616,45.18417874396136,8154.106280193256,119.91332764990082,0
48,32,1,0,111,0.009009009009009009,0.0,1.0,111,3600,2300,1300,0.6388888888888888,49,23,26,229.34401733355946,0.48283510783510786,0.6409050119151047,0.13001218739812184,1040521.4321145162,21927.473072562527,1062448.9051870788,47,0,25.61261261261261,69,42,41,39.13650531987315,0.5594031531531531,44.98511904761906,8160.47619047622,118.26777087646695,0
49,32,1,3,109,0.008928571428571428,0.026785714285714284,0.9732142857142857,112,3850,2500,1350,0.6493506493506493,52,25,27,228.32168946947002,0.48229367760617764,0.6436713291726011,0.1302069550744056,1042379.6293185827,21349.575606915772,1063729.2049254985,48,0,26.375,60,52,44,38.92977409067596,0.5617559523809523,44.75751366120219,8167.759562841534,136.1293260473589,0
50,32,1,5,105,0.00909090909090909,0.045454545454545456,0.9545454545454546,110,3350,2400,950,0.7164179104477612,43,24,19,228.95715186723714,0.4813038643313872,0.6384843541450385,0.13116891036880055,1043802.7777777793,22447.22222222226,1066250.0000000016,49,0,27.509090909090908,59,51,46,38.73538607939094,0.5632575757575757,44.583333333333336,8173.333333333345,138.53107344632787,0
51,32,4,2,107,0.03669724770642202,0.01834862385321101,0.981651376146789,109,3100,1900,1200,0.6129032258064516,43,19,24,219.59698372756128,0.481159389511836,0.6192945245941324,0.12693296503355378,1046561.4764424233,21064.34870244361,1067625.825144867,50,0,27.587155963302752,62,47,44,38.6297517455392,0.5667048929663608,44.246031746031726,8184.12698412694,132.00204813107968,0
52,32,2,2,107,0.01834862385321101,0.01834862385321101,0.981651376146789,109,3350,1900,1450,0.5671641791044776,48,19,29,215.36289924497606,0.48151687620342054,0.6130562758199936,0.1255321476629993,1049140.017853391,20039.167191766388,1069179.1850451573,51,0,28.155963302752294,68,41,41,38.416386628935285,0.5705275229357798,43.93115942028985,8194.202898550715,120.50298380221639,0
53,32,0,3,104,0.0,0.028037383177570093,0.9719626168224299,107,3700,2700,1000,0.7297297297297297,47,27,20,217.86215943415021,0.4808712455181332,0.611548355542963,0.12745269449465696,1050258.9604591806,20662.337018140428,1070921.297477321,52,1,29.50467289719626,69,38,42,38.212897620568846,0.5726246105919003,43.79464285714285,8198.571428571404,118.81987577639715,0
54,32,5,1,108,0.045871559633027525,0.009174311926605505,0.9908256880733946,109,3200,2300,900,0.71875,41,23,18,224.896843140299,0.4804656529618303,0.6307802722414744,0.12864912001841924,1043335.9393065653,21928.591816972938,1065264.5311235383,53,0,29.642201834862384,61,48,42,38.897501480360546,0.564315749235474,44.640456989247305,8171.505376344071,133.95910453023066,8
55,32,3,1,110,0.02702702702702703,0.009009009009009009,0.990990990990991,111,4000,2800,1200,0.7,52,28,24,216.0453925924039,0.48085926835926834,0.6220158889743146,0.1249781574869976,1046803.8538649979,19031.429915100744,1065835.2837800987,54,0,29.855855855855857,66,45,43,38.69033146932488,0.5670983483483483,44.21641791044774,8185.0746268656285,124.0162822252368,0
56,32,2,1,111,0.017857142857142856,0.008928571428571428,0.9910714285714286,112,3550,2600,950,0.7323943661971831,45,26,19,236.4781941705011,0.4803430662805663,0.6517530088958647,0.1328365164784919,1037661.5059033233,23126.863815252338,1060788.3697185756,55,0,30.089285714285715,66,46,38,39.313568376068396,0.5554315476190477,45.3358208955224,8149.253731343316,123.47354138398964,8
57,32,7,7,111,0.059322033898305086,0.059322033898305086,0.940677966101695,118,4000,2400,1600,0.6,56,24,32,238.52626740464495,0.48013544835578736,0.6670147214555748,0.13649641348887545,1043451.4405041874,22178.115464292878,1065629.5559684802,56,0,29.491525423728813,62,56,41,38.53498974857018,0.560204802259887,44.62632275132276,8171.957671957689,131.80576890254338,0
58,32,1,4,108,0.008928571428571428,0.03571428571428571,0.9642857142857143,112,3950,2500,1450,0.6329113924050633,54,25,29,237.1810018903597,0.4795906397468897,0.6491411102484486,0.1363790760869565,1044938.2716049356,23217.901234567755,1068156.1728395035,57,0,31.401785714285715,62,50,40,38.38315217391307,0.5624069940476191,44.444444444444436,8177.7777777777565,131.89964157706058,0
59,32,2,2,108,0.01818181818181818,0.01818181818181818,0.9818181818181818,110,3250,2100,1150,0.6461538461538462,44,21,23,234.40260910073943,0.47915797887128164,0.6376856086711358,0.1356034811111598,1046817.5583497689,23825.353385930197,1070642.911735699,58,0,32.263636363636365,64,46,44,38.21907044253699,0.5658143939393939,44.214743589743584,8185.128205128197,127.89262820512808,0
60,32,3,3,108,0.02702702702702703,0.02702702702702703,0.972972972972973,111,4000,2600,1400,0.65,54,26,28,229.59413177969884,0.4794021294021294,0.6335146607520139,0.13382734237963084,1049140.0178533937,21975.278302877614,1071115.2961562714,59,0,32.31531531531532,68,43,41,38.051969107416554,0.5689752252252251,43.93115942028986,8194.202898550737,120.50298380221672,0
61,32,1,0,109,0.009174311926605505,0.0,1.0,109,4050,3100,950,0.7654320987654321,50,31,19,225.93978080989987,0.4786428247819685,0.6190170221962545,0.1326248828913571,1051292.4236721452,21655.755954318534,1072948.1796264637,60,0,32.81651376146789,63,46,38,37.8770742057697,0.5720565749235473,43.668619791666664,8202.604166666659,130.200066137566,0
62,32,1,3,107,0.00909090909090909,0.02727272727272727,0.9727272727272728,110,3800,2600,1200,0.6842105263157895,50,26,24,223.1106703529352,0.47834132610508756,0.6193141975205094,0.13184697084433525,1053344.5606634512,21202.482208448044,1074547.0428718992,61,0,33.50909090909091,65,45,42,37.69395491173035,0.5739583333333333,43.4185606060606,8210.60606060605,126.31701631701614,0
63,32,3,3,107,0.02727272727272727,0.02727272727272727,0.9727272727272728,110,4150,2900,1250,0.6987951807228916,54,29,25,217.53084756133117,0.47807721712538226,0.6098976405274119,0.12952973195697431,1055655.517108803,19777.527873894604,1075433.0449826976,62,0,33.6,67,43,47,37.549697837150134,0.5767992424242424,43.13725490196078,8219.607843137244,122.68071407667529,0
64,32,2,3,106,0.01834862385321101,0.027522935779816515,0.9724770642201834,109,2850,1900,950,0.6666666666666666,38,19,19,214.71652134337987,0.47705360176690453,0.6027143542830398,0.1286000235968808,1057419.0365484431,20759.067425989993,1078178.1039744332,63,0,34.137614678899084,67,42,40,37.402921781273584,0.579224006116208,42.92279411764706,8226.470588235296,122.78314310798949,0
65,32,2,3,105,0.018518518518518517,0.027777777777777776,0.9722222222222222,108,3400,2100,1300,0.6176470588235294,47,21,26,212.58005245567497,0.47640475366332063,0.5979914136767852,0.12823225139806838,1059573.8995064308,20048.855027548372,1079622.754533979,64,0,35.111111111111114,65,43,45,37.19047071450477,0.5815972222222222,42.66098484848486,8234.848484848508,126.68997668997704,0
66,32,0,1,104,0.0,0.009523809523809525,0.9904761904761905,105,3200,2200,1000,0.6875,42,22,20,214.65556592895635,0.47561050061050064,0.590480932523628,0.12999890606032968,1060767.9528270897,21339.949046679954,1082107.9018737697,65,1,36.51428571428571,64,41,42,36.9889888176594,0.5839285714285714,42.51602564102565,8239.487179487196,128.74198717948744,0
67,32,1,2,103,0.009523809523809525,0.01904761904761905,0.9809523809523809,105,3900,2800,1100,0.717948717948718,50,28,22,215.4813967506869,0.47539300976800974,0.5903991879736097,0.13116887708246486,1062305.010330576,20881.393480256975,1083186.4038108329,66,0,36.904761904761905,65,40,42,36.77722650986158,0.5860119047619048,42.329545454545446,8245.454545454526,126.85314685314655,0
68,32,0,0,103,0.0,0.0,1.0,103,3800,3000,800,0.7894736842105263,46,30,16,216.6886380047559,0.4747009645282061,0.5859888758446481,0.13227463917671714,1063146.059335963,21674.33431952663,1084820.3936554897,67,1,38.12621359223301,64,39,44,36.64192829758575,0.5879854368932038,42.2275641025641,8248.717948717947,128.88621794871793,0
69,32,2,1,104,0.01904761904761905,0.009523809523809525,0.9904761904761905,105,3150,2100,1050,0.6666666666666666,42,21,21,217.77871572110226,0.4742368742368743,0.5903088680866446,0.1341058407335211,1065752.5951557118,22269.646289888657,1088022.2414456005,68,0,38.38095238095238,67,38,37,36.291152263374485,0.5904761904761905,41.91176470588236,8258.823529411784,123.26602282704155,0
70,32,0,3,101,0.0,0.028846153846153848,0.9711538461538461,104,3550,2600,950,0.7323943661971831,45,26,19,250.45127818059206,0.4737385642270351,0.6464812047191106,0.14973133338611974,1056871.0282466873,28588.939979283736,1085459.968225971,69,1,39.75,62,42,37,36.55255511236917,0.5792267628205128,42.98941798941798,8224.338624338605,132.6506229732033,8
71,32,1,2,100,0.00980392156862745,0.0196078431372549,0.9803921568627451,102,3600,2300,1300,0.6388888888888888,49,23,26,260.4000448437457,0.47309583899566426,0.6544658403902108,0.15180234125456896,1049177.758626189,30641.187079063846,1079818.945705253,70,0,40.69607843137255,58,44,38,37.258399981614254,0.5704656862745099,43.926553672316366,8194.350282485844,141.28190142216974,8
72,32,3,0,103,0.02912621359223301,0.0,1.0,103,3600,2200,1400,0.6111111111111112,50,22,28,257.4594200875688,0.47332476679992386,0.6466650360360129,0.14718588451159964,1043145.6687527742,29513.535788789442,1072659.2045415638,71,0,40.310679611650485,56,47,41,38.08987021662375,0.5604773462783171,44.66374269005846,8170.760233918094,145.90643274853738,8
73,32,5,0,108,0.046296296296296294,0.0,1.0,108,2900,1900,1000,0.6551724137931034,39,19,20,253.33393024215493,0.47413140359986156,0.6680970739843031,0.1442182047326262,1041834.8693847713,28286.424424913544,1070121.293809685,72,0,39.398148148148145,63,45,38,38.35975039333248,0.5591242283950617,44.82421875000002,8165.6250000000455,129.61309523809595,8
74,32,2,3,107,0.01818181818181818,0.02727272727272727,0.9727272727272728,110,3200,2000,1200,0.625,44,20,24,248.9162224664617,0.47414164581595775,0.6659202135547979,0.1426034059550855,1043802.7777777812,26763.888888889156,1070566.6666666705,73,0,39.663636363636364,59,51,39,38.22559815116915,0.5609848484848485,44.58333333333335,8173.333333333361,138.53107344632815,0
75,32,0,1,106,0.0,0.009345794392523364,0.9906542056074766,107,4000,2600,1400,0.65,54,26,28,233.96072051131844,0.47292144242637985,0.6317659252314254,0.12923910319512233,1032383.6174706474,22907.442997502563,1055291.06046815,74,1,41.60747663551402,68,39,41,40.04132988628711,0.5500389408099688,45.984299516908195,8128.5024154588955,119.5368002273367,8
76,32,8,3,111,0.07017543859649122,0.02631578947368421,0.9736842105263158,114,3700,2700,1000,0.7297297297297297,47,27,20,218.05440236718945,0.4745639910986907,0.6297659364923847,0.11969809577103363,1030391.7907877606,18436.293228856586,1048828.0840166172,75,0,39.824561403508774,70,44,36,40.695881752134234,0.544407894736842,46.229460093896705,8120.65727699529,116.00938967136129,8
77,32,5,2,114,0.04310344827586207,0.017241379310344827,0.9827586206896551,116,4100,2800,1300,0.6829268292682927,54,28,26,223.78273777456454,0.4751639805097451,0.6484615135167671,0.12426160452256443,1034027.8197691811,18979.51528860242,1053007.3350577834,76,0,39.991379310344826,60,56,41,40.093146145406486,0.5460668103448276,45.78210382513662,8134.972677595653,135.58287795992754,8
78,32,4,0,118,0.03389830508474576,0.0,1.0,118,2950,2000,950,0.6779661016949152,39,20,19,215.05362065119107,0.4755284538123521,0.6400868853491151,0.12039819022921663,1036611.1480933618,18035.396120973186,1054646.544214335,77,0,39.6271186440678,64,54,44,39.990870742303095,0.5496998587570621,45.4647435897436,8145.128205128221,127.26762820512846,0
79,32,1,4,115,0.008403361344537815,0.03361344537815126,0.9663865546218487,119,4500,3100,1400,0.6888888888888889,59,31,28,212.88113514580476,0.47532106062764085,0.6410441528863089,0.11998820470620737,1038725.674169794,15925.02012447157,1054650.6942942655,78,0,40.285714285714285,67,52,41,39.78117046433798,0.5516456582633054,45.20526960784315,8153.431372549047,121.69300556043355,0
80,32,2,5,112,0.017094017094017096,0.042735042735042736,0.9572649572649573,117,3350,2000,1350,0.5970149253731343,47,20,27,209.73526127205147,0.47419319186560566,0.6302860620699176,0.11914322420592557,1041168.6350628674,16923.955140635306,1058092.5902035027,79,0,41.48717948717949,72,45,43,39.55559750890345,0.5557336182336182,44.90582191780823,8163.013698630168,113.37519025875233,0
81,32,5,1,116,0.042735042735042736,0.008547008547008548,0.9914529914529915,117,3550,2500,1050,0.704225352112676,46,25,21,224.08068802507586,0.4751725365949504,0.6578217195549234,0.12603004742702759,1038053.7052784044,19571.55769715267,1057625.262975557,80,0,42.12820512820513,62,55,43,39.58008763388507,0.5496794871794872,45.2876984126984,8150.793650793625,131.46441372247781,8
82,32,2,2,116,0.01694915254237288,0.01694915254237288,0.9830508474576272,118,3750,2400,1350,0.64,51,24,27,217.32814263216918,0.47538057124921534,0.6496204309234666,0.12275733387082531,1039395.6970270874,17827.987258953082,1057223.6842860405,81,0,42.46610169491525,65,53,39,39.58391386463559,0.5516419491525424,45.123106060606055,8156.060606060593,125.47785547785529,0
83,32,3,3,116,0.025210084033613446,0.025210084033613446,0.9747899159663865,119,3150,1900,1250,0.6031746031746031,44,19,25,213.74427321949156,0.475445686749276,0.6456525467329786,0.12178452776459425,1042100.6944444459,17598.611111111197,1059699.3055555571,82,0,43.016806722689076,68,51,45,39.33673469387754,0.5545343137254901,44.79166666666667,8166.666666666679,120.09803921568646,0
84,32,5,0,121,0.04132231404958678,0.0,1.0,121,3800,2600,1200,0.6842105263157895,50,26,24,203.76600274986194,0.476122015610652,0.6342035781811863,0.11765706966113543,1046233.1532643622,14637.349517012262,1060870.5027813746,83,0,42.586776859504134,67,54,48,39.07557309451066,0.5582816804407713,44.28615196078429,8182.843137254845,122.13198712320664,0
85,32,2,1,122,0.016260162601626018,0.008130081300813009,0.991869918699187,123,4250,3000,1250,0.7058823529411765,55,30,25,202.94295032517752,0.4760429161668666,0.6390331774780365,0.11834785605374316,1049283.1668083838,13738.924319727535,1063022.0911281114,84,0,42.8780487804878,69,54,42,38.716599356925634,0.5609756097560976,43.91369047619045,8194.761904761855,118.7646652864037,0
86,32,0,2,120,0.0,0.01639344262295082,0.9836065573770492,122,4550,3200,1350,0.7032967032967034,59,32,27,204.5881335577528,0.47532798175495644,0.6396352590434287,0.11973616502857186,1050384.4034472841,14029.236923890563,1064413.6403711748,85,1,43.81967213114754,70,52,42,38.537372117880565,0.5636953551912569,43.77934272300468,8199.061032863821,117.12944332662602,0
87,32,1,3,118,0.008264462809917356,0.024793388429752067,0.9752066115702479,121,4500,3400,1100,0.7555555555555555,56,34,22,200.51242785066808,0.47526113406795223,0.6285702410064213,0.1180169731892223,1052116.931391898,13492.50405923681,1065609.4354511348,86,0,44.45454545454545,62,59,43,38.42634384335976,0.5658574380165289,43.56812169312169,8205.820105820103,132.35193719064682,0
88,32,0,4,114,0.0,0.03389830508474576,0.9661016949152542,118,4100,2900,1200,0.7073170731707317,53,29,24,202.36446863468103,0.475317193007871,0.6220718615650846,0.11943962394986261,1052968.3751373005,14916.67714475667,1067885.0522820572,87,1,46.04237288135593,61,57,45,38.27301231252863,0.5675317796610169,43.46438172043011,8209.139784946246,134.57606204829912,0
89,32,1,1,114,0.008695652173913044,0.008695652173913044,0.991304347826087,115,3850,2300,1550,0.5974025974025974,54,23,31,218.63692638263953,0.4748919399949148,0.6424797500279746,0.12256771533393074,1037030.1525104096,18496.617022199338,1055526.769532609,88,0,47.6,61,54,44,39.84710123407907,0.548731884057971,45.41330645161292,8146.774193548417,133.5536753040724,8
90,32,5,2,117,0.04201680672268908,0.01680672268907563,0.9831932773109243,119,4150,3100,1050,0.7469879518072289,52,31,21,212.57758159992798,0.47676909746949625,0.6437002645263143,0.12059387721790434,1040744.9561249993,16297.80916707519,1057042.7652920745,89,0,46.21848739495798,68,51,42,39.53610256106705,0.5523459383753502,44.95772946859904,8161.352657004849,120.01989201477718,0
91,32,2,3,116,0.01680672268907563,0.025210084033613446,0.9747899159663865,119,3350,2100,1250,0.6268656716417911,46,21,25,209.97269325958834,0.4757750557850258,0.6395188835939751,0.12009703188296342,1043297.3268296997,16662.78991699227,1059960.116746692,90,0,47.10084033613445,63,56,44,39.28342841056366,0.555234593837535,44.64518229166667,8171.354166666678,129.70403439153458,0
92,32,4,0,120,0.03333333333333333,0.0,1.0,120,3650,2600,1050,0.7123287671232876,47,26,21,203.97579281439002,0.4756608893557423,0.6312004592193274,0.11787386157965517,1046483.8681336491,15041.475334006067,1061525.3434676551,91,0,46.583333333333336,67,53,46,39.03894629130479,0.5587673611111111,44.25551470588235,8183.823529411754,122.14661984196648,0
93,32,2,2,120,0.01639344262295082,0.01639344262295082,0.9836065573770492,122,3950,2800,1150,0.7088607594936709,51,28,23,211.3148307350002,0.4755001580634964,0.6464205093363724,0.12348710421076571,1049923.0624882712,16022.862846896394,1065945.9253351674,92,0,46.80327868852459,72,50,37,38.42248310308971,0.5623292349726776,43.83561643835616,8197.260273972599,113.85083713850833,0
94,32,2,2,120,0.01639344262295082,0.01639344262295082,0.9836065573770492,122,4350,2900,1450,0.6666666666666666,58,29,29,214.64198553375007,0.4750993541977149,0.6508216598174312,0.1264019832695182,1052282.9919123282,16422.822145491373,1068705.8140578195,93,0,47.27049180327869,66,56,40,38.04334646862684,0.5645491803278688,43.5478855721393,8206.467661691537,124.34041911653844,0
95,32,1,1,120,0.008264462809917356,0.008264462809917356,0.9917355371900827,121,4250,3200,1050,0.7529411764705882,53,32,21,220.62673265150656,0.47428259871441686,0.6574348621538073,0.13052562183318148,1053686.9291601684,18044.300883641437,1071731.2300438099,94,0,48.59504132231405,66,55,39,37.71507330667636,0.5661157024793388,43.37686567164179,8211.940298507456,124.42333785617357,0
96,32,4,1,123,0.03225806451612903,0.008064516129032258,0.9919354838709677,124,4700,3500,1200,0.7446808510638298,59,35,24,222.11258480821152,0.4744582677681615,0.6655287081194494,0.12751677852348997,1044457.795036161,16897.4441157134,1061355.2391518743,95,0,48.346774193548384,64,60,42,38.828299776286336,0.5558635752688172,44.50320512820513,8175.89743589744,127.7483974358975,8
97,32,4,3,124,0.031496062992125984,0.023622047244094488,0.9763779527559056,127,3850,2600,1250,0.6753246753246753,51,26,25,213.47648084936355,0.4751827896512936,0.659175302656464,0.1237842242188117,1047532.4723155738,15474.709153072456,1063007.1814686463,96,0,48.07874015748032,68,59,38,38.66513756957144,0.558480971128609,44.1274154589372,8187.922705314014,120.41062801932374,0
98,32,2,0,126,0.015873015873015872,0.0,1.0,126,3450,2300,1150,0.6666666666666666,46,23,23,211.37615230199796,0.4756772486772487,0.6523187302315046,0.12298441085420363,1048580.807517249,15678.995294143668,1064259.8028113926,97,0,48.61904761904762,70,56,41,38.588171241904995,0.5601851851851851,43.99941314553991,8192.018779342734,117.0288397048962,0
99,32,2,1,127,0.015625,0.0078125,0.9921875,128,5000,3400,1600,0.68,66,34,32,211.39951224247199,0.47560387959317585,0.6562095905172425,0.12402919359890635,1051142.740536674,13842.212529333347,1064984.9530660072,98,0,48.84375,65,63,46,38.26842159277503,0.5628255208333333,43.686868686868664,8202.020202020154,126.18492618492544,0
100,32,1,0,128,0.0078125,0.0,1.0,128,4000,2900,1100,0.725,51,29,22,211.69316395681497,0.4756384822014436,0.655559961928935,0.12486093802243198,1052761.501736104,14972.482638888454,1067733.9843749925,99,0,49.796875,67,61,42,38.05943316412858,0.564697265625,43.48958333333331,8208.333333333278,122.51243781094445,0
101,32,1,1,128,0.007751937984496124,0.007751937984496124,0.9922480620155039,129,3200,1600,1600,0.5,48,16,32,209.6484693553275,0.47559603116925064,0.6517937676198304,0.1242262606633465,1054166.670209742,15200.885770974572,1069367.5559807166,100,0,50.4031007751938,69,60,42,37.93716302394343,0.5661337209302326,43.31845238095235,8213.809523809456,119.04071773636892,0
102,32,3,2,129,0.022900763358778626,0.015267175572519083,0.9847328244274809,131,4050,2900,1150,0.7160493827160493,52,29,23,223.100430984063,0.47546241926012917,0.6826440949653478,0.12872100756105456,1045993.2114512573,16422.307256236374,1062415.5187074938,101,0,50.43511450381679,69,62,40,38.61114344469017,0.5565362595419847,44.315476190476225,8181.904761904843,118.57832988267889,8
103,32,2,0,131,0.015267175572519083,0.0,1.0,131,4300,3000,1300,0.6976744186046512,56,30,26,220.73782390655475,0.4746427872382071,0.6827692274563988,0.12852435394483452,1048803.5679012432,15802.123456790574,1064605.6913580338,102,0,51.38931297709924,74,57,38,38.32072076959241,0.5592398218829516,43.97222222222225,8192.888888888956,110.71471471471563,0
104,32,0,2,129,0.0,0.015267175572519083,0.9847328244274809,131,4550,3200,1350,0.7032967032967034,59,32,27,219.7931655157054,0.474229301233118,0.6837871710151542,0.1299059817356408,1053390.297601882,15555.597606689631,1068945.8952085716,103,1,52.38931297709924,67,64,38,37.77338308457711,0.5697360050890585,43.412990196078425,8210.784313725475,122.54901960784291,8
105,32,0,2,127,0.0,0.015503875968992248,0.9844961240310077,129,3950,2800,1150,0.7088607594936709,51,28,23,220.3694635337458,0.4731003714470284,0.682330671196018,0.1307268305557955,1054511.162764005,16726.41184573009,1071237.574609735,104,2,53.86046511627907,65,64,38,37.61911348825772,0.5714631782945736,43.276515151515156,8215.151515151523,126.3869463869465,0
106,32,2,4,125,0.015503875968992248,0.031007751937984496,0.9689922480620154,129,4050,2700,1350,0.6666666666666666,54,27,27,214.40595224840354,0.4725452196382429,0.6733632192260444,0.12826689188268872,1057072.0582744058,15478.508249900813,1072550.5665243065,105,0,54.55813953488372,68,61,37,37.45399193390501,0.5748546511627908,42.96497584541063,8225.120772946862,120.95765842568915,0
107,32,0,3,122,0.0,0.024,0.976,125,4100,3400,700,0.8292682926829268,48,34,14,218.10697648277213,0.47154569892473114,0.6687763296935536,0.13091029730118164,1058065.6637261063,17054.30056710768,1075119.964293214,106,1,56.864,68,57,38,37.23545555946928,0.5765,42.84420289855072,8228.985507246365,121.01449275362302,0
108,32,2,3,121,0.016129032258064516,0.024193548387096774,0.9758064516129032,124,3650,2700,950,0.7397260273972602,46,27,19,215.89203457378022,0.4706104117492788,0.6625232072406602,0.1304738817641539,1060137.1742112464,17325.034293552722,1077462.208504799,107,0,58.08870967741935,62,62,40,37.03537170263791,0.5786290322580645,42.59259259259259,8237.037037037024,132.85543608124232,0
109,32,0,1,120,0.0,0.008264462809917356,0.9917355371900827,121,4650,3800,850,0.8172043010752689,55,38,17,241.81726518274655,0.46983184113865933,0.6880172284975381,0.14209771408490296,1051621.764081788,22010.059799382594,1073631.8238811707,108,1,58.925619834710744,59,62,39,37.428966050427746,0.5699896694214877,43.628472222222214,8203.888888888872,139.04896421845547,8
110,32,3,1,122,0.024390243902439025,0.008130081300813009,0.991869918699187,123,3650,2600,1050,0.7123287671232876,47,26,21,241.79862245880895,0.47053678528588566,0.670824516464344,0.13626676407508045,1038678.6346770065,21980.2126084591,1060658.8472854656,109,0,58.9349593495935,76,47,37,39.05027698134579,0.5531842818428184,45.211038961038945,8153.246753246715,107.27956254271994,8
111,32,6,1,127,0.046875,0.0078125,0.9921875,128,3800,2800,1000,0.7368421052631579,48,28,20,241.28793485372017,0.47238199229002625,0.6856102521895278,0.13441491098853572,1035045.3690006548,20548.791913214845,1055594.1609138697,110,0,57.4765625,64,64,38,39.520062797975314,0.5460611979166667,45.65705128205127,8138.9743589743375,127.17147435897402,8
112,32,1,1,127,0.0078125,0.0078125,0.9921875,128,4600,3400,1200,0.7391304347826086,58,34,24,238.8236442557922,0.47257935531496065,0.6830216730792724,0.13382951235606902,1036901.4535531288,19327.316774337203,1056228.770327466,111,0,57.8125,66,62,39,39.34934957860023,0.5481770833333333,45.429104477611936,8146.268656716409,123.42831298055165,0
113,32,2,2,127,0.015503875968992248,0.015503875968992248,0.9844961240310077,129,3900,2800,1100,0.717948717948718,50,28,22,240.939176591405,0.473491501130491,0.6913329256265728,0.13614514918237275,1039513.232514182,20391.892459567527,1059905.1249737495,112,0,57.49612403100775,68,61,37,38.96736555318646,0.5499838501291989,45.10869565217393,8156.5217391304695,119.94884910485985,8
114,32,2,0,129,0.015503875968992248,0.0,1.0,129,5150,4100,1050,0.7961165048543689,62,41,21,237.73427738442217,0.4735823441537468,0.6890049042872952,0.1354532510678691,1042100.6944444497,18598.61111111141,1060699.305555561,113,0,58.02325581395349,71,58,40,38.724489795918394,0.5535368217054264,44.791666666666686,8166.666666666709,115.02347417840436,0
115,32,3,4,128,0.022727272727272728,0.030303030303030304,0.9696969696969697,132,4600,3400,1200,0.7391304347826086,58,34,24,229.01016670745537,0.4735354499190377,0.6861846571622541,0.13228704923924764,1046358.5069444432,16925.34722222214,1063283.8541666653,114,0,57.68181818181818,65,67,41,38.41437542430413,0.5566603535353536,44.27083333333333,8183.333333333323,125.89743589743574,0
116,32,2,5,125,0.015384615384615385,0.038461538461538464,0.9615384615384616,130,4150,3200,950,0.7710843373493976,51,32,19,225.8048682514864,0.47353657324587556,0.675820676139149,0.1313013493166043,1048397.9206049086,17196.67086746443,1065594.591472373,115,0,59.08461538461538,68,62,41,38.2416253833451,0.558974358974359,44.02173913043476,8191.304347826037,120.46035805626525,0
117,32,1,0,126,0.007936507936507936,0.0,1.0,126,4200,3300,900,0.7857142857142857,51,33,18,230.2264033738197,0.473968253968254,0.671064300307582,0.13452071668205753,1049882.3776517475,18942.128754462912,1068824.5064062104,116,0,60.57936507936508,68,58,43,37.94311350777928,0.5611772486772486,43.8405797101449,8197.101449275311,120.54560954816634,0
118,32,0,0,126,0.0,0.0,1.0,126,4400,3400,1000,0.7727272727272727,54,34,20,232.32757544224765,0.4736719576719577,0.6754203789042497,0.136198086965009,1050896.1815178741,19230.432378712794,1070126.613896587,117,1,61.57936507936508,62,64,43,37.76276881720429,0.5628306878306879,43.716931216931215,8201.058201058198,132.27513227513222,0
119,32,0,0,126,0.0,0.0,1.0,126,2850,1600,1250,0.5614035087719298,41,16,25,231.08005718964125,0.47316137566137567,0.6738510202181149,0.13612923536150923,1052388.3053735935,20587.18995828812,1072975.4953318816,118,2,62.57936507936508,62,64,42,37.6086594459846,0.564484126984127,43.535052910052926,8206.878306878336,132.3690049496506,0
120,32,0,1,125,0.0,0.007936507936507936,0.9920634920634921,126,4350,3100,1250,0.7126436781609196,56,31,25,235.3120758352777,0.4731018518518519,0.6778808597682249,0.1392793097511516,1053830.566406256,20045.811631944824,1073876.3780382008,119,3,63.57936507936508,63,63,42,37.32031117875867,0.5663855820105821,43.35937500000002,8212.500000000047,130.3571428571436,0
121,32,2,1,126,0.015748031496062992,0.007874015748031496,0.9921259842519685,127,3150,2000,1150,0.6349206349206349,43,20,23,251.20623632656873,0.4729565054368204,0.7026438438151839,0.14798556519792624,1052388.305373587,24323.301069398745,1076711.6064429856,120,0,63.84251968503937,62,65,41,37.092493499237065,0.5643864829396326,43.5350529100529,8206.878306878285,132.36900494964976,8
122,32,1,1,126,0.007874015748031496,0.007874015748031496,0.9921259842519685,127,3850,2900,950,0.7532467532467533,48,29,19,241.648015690983,0.47284193642461364,0.7024265253781827,0.13984645804304385,1046931.1132459578,21347.765216207426,1068278.8784621651,121,0,64.28346456692914,66,61,41,38.01953544439714,0.5553641732283465,44.20087064676616,8185.572139303471,124.02382029247683,8
123,32,4,1,129,0.03076923076923077,0.007692307692307693,0.9923076923076923,130,4250,2900,1350,0.6823529411764706,56,29,27,272.6661122009993,0.47357135758298546,0.7334990907316263,0.15739793230908902,1046148.9033712576,26799.870853116015,1072948.7742243735,122,0,63.761538461538464,60,70,37,37.32427874983303,0.5552884615384616,44.2964480874317,8182.513661202197,136.37522768670328,8
124,32,4,2,131,0.03007518796992481,0.015037593984962405,0.9849624060150376,133,4450,3300,1150,0.7415730337078652,56,33,23,261.7841190688589,0.47431315029999244,0.7291250062548527,0.15281412533271382,1049589.9015406598,23903.193551678498,1073493.0950923383,123,0,63.24812030075188,65,68,40,37.17134993016185,0.5588972431077694,43.87626262626263,8195.959595959603,126.0916860916862,0
125,32,0,3,128,0.0,0.022900763358778626,0.9770992366412213,131,4600,3500,1100,0.7608695652173914,57,35,22,262.24653006880897,0.4740188882364455,0.7265841547469056,0.15347382157436013,1050370.0403455386,24291.179673770603,1074661.2200193093,124,1,64.94656488549619,66,65,40,37.06184263754046,0.5601145038167938,43.781094527363194,8199.004975124399,124.22734810794543,0
126,32,0,2,126,0.0,0.015625,0.984375,128,3650,2500,1150,0.684931506849315,48,25,23,235.1651873578387,0.47377122293307083,0.6908343964363388,0.13633194227330792,1047468.1284012028,20015.607733366774,1067483.7361345696,125,2,65.828125,72,56,37,38.11822634915325,0.5615234375,44.13527397260275,8187.671232876728,113.71765601217677,8
127,32,1,1,126,0.007874015748031496,0.007874015748031496,0.9921259842519685,127,3900,3200,700,0.8205128205128205,46,32,14,234.0645260281027,0.4738079615048119,0.6869668635170589,0.13618299696180564,1048576.000000004,19786.888888889145,1068362.8888888932,126,0,66.45669291338582,74,53,38,38.007948133680586,0.5635662729658792,44.000000000000014,8192.000000000031,110.70270270270312,0
128,32,3,1,128,0.023255813953488372,0.007751937984496124,0.9922480620155039,129,4100,2900,1200,0.7073170731707317,53,29,24,237.7808439069691,0.4742434794896641,0.6974881858602779,0.13493698197174694,1040850.0486591753,19598.840590158004,1060448.8892493332,127,0,66.37984496124031,67,62,39,38.88013013013016,0.5507913436692506,44.94485294117649,8161.764705882399,121.81738366988655,8
129,32,1,0,129,0.007751937984496124,0.0,1.0,129,4350,3100,1250,0.7126436781609196,56,31,25,234.17328460946493,0.47363533591731266,0.6927282803627246,0.1334851282296913,1042242.4816743811,18663.069058641864,1060905.5507330229,128,0,67.25581395348837,59,70,43,38.797601637076845,0.5529715762273901,44.77430555555555,8167.222222222209,138.42749529190183,0
130,32,3,4,128,0.022727272727272728,0.030303030303030304,0.9696969696969697,132,5200,3700,1500,0.7115384615384616,67,37,30,222.83586049665422,0.4733776216362094,0.6840885342452743,0.12831162364338,1045375.164365546,14989.414858645374,1060364.5792241914,129,0,66.70454545454545,64,68,42,38.69514106583071,0.5562657828282829,44.39102564102563,8179.487179487156,127.80448717948681,0
131,32,1,1,128,0.007751937984496124,0.007751937984496124,0.9922480620155039,129,4700,2900,1800,0.6170212765957447,65,29,36,220.86740436727905,0.4723811975129199,0.6760811138670422,0.12792584086108982,1047185.655212738,15757.835511496984,1062943.4907242348,130,0,67.51937984496124,66,63,47,38.51932036868225,0.5593507751937985,44.16977611940297,8186.5671641790705,124.03889642695562,0
132,32,0,2,126,0.0,0.015625,0.984375,128,4450,3100,1350,0.6966292134831461,58,31,27,220.01541412011275,0.47214361876640415,0.6725254896557571,0.1278257041444635,1048135.1574556325,16071.17814429008,1064206.3355999226,131,1,68.125,71,57,40,38.42260895370526,0.5615234375,44.05381944444444,8190.2777777777765,115.35602503912361,0
133,32,3,2,127,0.023255813953488372,0.015503875968992248,0.9844961240310077,129,4450,3200,1250,0.7191011235955056,57,32,25,218.95230853624585,0.4721212855297157,0.6745145627484757,0.1287478804170021,1051826.5151977558,15809.968736436736,1067636.4839341925,132,0,67.42635658914729,63,66,43,37.98965540955162,0.5647609819121446,43.60351562500001,8204.687500000015,130.23313492063514,0
134,32,1,1,127,0.0078125,0.0078125,0.9921875,128,4350,2900,1450,0.6666666666666666,58,29,29,237.05213811264608,0.47183860318241466,0.7011466590103872,0.13468540620914074,1041225.1635488812,19414.93025519066,1060640.093804072,133,0,68.7890625,67,61,41,38.8516708701135,0.54833984375,44.89889705882355,8163.235294117692,121.83933274802526,8
135,32,1,0,128,0.0078125,0.0,1.0,128,4300,3100,1200,0.7209302325581395,55,31,24,239.71169106923244,0.47171044537401574,0.7040357620320852,0.13750333199370116,1044193.6158141508,20161.083490101453,1064354.6993042522,134,0,69.7734375,60,68,38,38.411736853832465,0.552734375,44.535519125683074,8174.863387978165,136.2477231329694,8
136,32,2,0,130,0.015384615384615385,0.0,1.0,130,4100,2600,1500,0.6341463414634146,56,26,30,242.78120043707185,0.4720135161995627,0.7131218206594034,0.1356988887176677,1036095.8401456613,20208.91836768411,1056304.7585133454,135,0,69.68461538461538,57,73,38,39.349915896205346,0.5455128205128206,45.52801724137932,8143.103448275872,142.86146400483986,8
137,32,7,4,133,0.051094890510948905,0.029197080291970802,0.9708029197080292,137,3800,2500,1300,0.6578947368421053,51,25,26,225.85215316887408,0.4729050379275798,0.7076059112782458,0.12857980750126763,1041850.5052143361,15860.83597654723,1057711.3411908834,136,0,67.07299270072993,67,70,41,39.05906071157001,0.5497262773722628,44.82230392156861,8165.686274509768,121.87591454492191,0
138,32,0,2,131,0.0,0.015037593984962405,0.9849624060150376,133,4800,3400,1400,0.7083333333333334,62,34,28,229.73760932944586,0.4720632072605757,0.7041890440386676,0.13089700996677747,1042100.6944444458,16481.944444444547,1058582.6388888904,137,1,69.96992481203007,65,68,42,38.92857142857141,0.5509868421052632,44.79166666666667,8166.666666666678,125.64102564102582,0
139,32,3,2,132,0.022388059701492536,0.014925373134328358,0.9850746268656716,134,4200,3000,1200,0.7142857142857143,54,30,24,219.2090015720291,0.47259122619982796,0.6915569279001106,0.1264315103061651,1045884.9879972561,14853.480795610423,1060738.4687928664,138,0,70.00746268656717,62,72,44,38.72415874452998,0.5543376865671642,44.3287037037037,8181.481481481478,131.95937873357224,0
140,32,3,2,133,0.022222222222222223,0.014814814814814815,0.9851851851851852,135,3600,2100,1500,0.5833333333333334,51,21,30,217.1509191702563,0.47309286898839137,0.6910675381263609,0.12622772785316194,1048296.7458677684,14927.7203856749,1063224.4662534434,139,0,69.63703703703703,65,70,41,38.475767665556766,0.5566358024691358,44.03409090909091,8190.909090909089,126.01398601398598,0
141,32,1,1,133,0.007462686567164179,0.007462686567164179,0.9925373134328358,134,4650,3600,1050,0.7741935483870968,57,36,21,222.28296336284163,0.47263564695320387,0.6965238502496751,0.12986510062559153,1049848.6283287457,15222.69283746577,1065071.3211662115,140,0,71.14925373134328,65,69,42,38.150800985828724,0.5583799751243781,43.84469696969698,8196.969696969727,126.10722610722657,0
142,32,0,1,132,0.0,0.007518796992481203,0.9924812030075187,133,4400,3000,1400,0.6818181818181818,58,30,28,219.97729033278063,0.47236462368041315,0.6914427524707516,0.12915408740928763,1051361.479596052,15255.129888360596,1066616.6094844127,141,1,71.66165413533835,57,76,41,38.02130771386536,0.5606203007518797,43.6602011494253,8202.873563218409,143.91006251260367,0
143,32,1,2,131,0.007518796992481203,0.015037593984962405,0.9849624060150376,133,3550,2500,1050,0.704225352112676,46,25,21,220.96864876949667,0.47256161236424393,0.6926876723812294,0.13040919848175425,1052942.6609531115,16383.463404513517,1069326.124357625,142,0,71.78195488721805,58,75,45,37.79895044735033,0.5620300751879699,43.46751412429379,8209.039548022607,141.53516462107945,0
144,32,3,4,130,0.022388059701492536,0.029850746268656716,0.9701492537313433,134,4650,3300,1350,0.7096774193548387,60,33,27,211.25115009960004,0.472659026297086,0.680888884550432,0.12587802357844485,1055866.7367614787,13160.61249855495,1069027.3492600336,143,0,71.64925373134328,61,73,41,37.68476128188359,0.5645988805970149,43.11155913978496,8220.430107526909,134.7611493037198,0
145,32,0,0,130,0.0,0.0,1.0,130,3750,2900,850,0.7733333333333333,46,29,17,217.2887143764418,0.4711600576426158,0.6791120430853712,0.12988923266183816,1056833.7425208148,16177.609044398385,1073011.3515652132,144,1,73.29230769230769,61,69,44,37.40950022880304,0.5669070512820513,42.99395161290324,8224.19354838712,134.82284505552656,0
146,32,1,0,131,0.007633587786259542,0.0,1.0,131,4150,2900,1250,0.6987951807228916,54,29,25,206.57137441319003,0.4710290663534938,0.6600762812892476,0.11986150703662317,1047741.2833018895,12936.671384222445,1060677.954686112,145,0,73.72519083969466,73,58,36,38.81579248950256,0.560512086513995,44.10191441441444,8188.738738738791,112.1745032703944,8
147,32,1,3,129,0.007575757575757576,0.022727272727272728,0.9772727272727273,132,4150,3000,1150,0.7228915662650602,53,30,23,200.49898104796102,0.47100176382142034,0.6516621155231905,0.11693334734111097,1049311.3083497777,11527.169625246997,1060838.4779750246,146,0,74.1590909090909,77,55,39,38.775683145598684,0.5622632575757576,43.91025641025644,8194.871794871859,106.42690642690725,0
148,32,3,2,130,0.022727272727272728,0.015151515151515152,0.9848484848484849,132,4000,2900,1100,0.725,51,29,22,198.80610949491611,0.4706668305189297,0.6508040123919956,0.11514028788912065,1047165.015522279,11236.560547033527,1058401.5760693124,147,0,74.17424242424242,73,59,47,39.08628626976265,0.5610006313131313,44.1722972972973,8186.486486486486,112.14365049981487,8
149,32,2,2,130,0.015151515151515152,0.015151515151515152,0.9848484848484849,132,4150,2900,1250,0.6987951807228916,54,29,25,195.31825214574937,0.47052105019662277,0.6450503158423941,0.11394072873379071,1049389.0698339844,10442.967788165395,1059832.0376221498,148,0,73.77272727272727,75,57,43,38.898682097939485,0.5639204545454546,43.90076754385964,8195.175438596467,109.2690058479529,0
150,32,1,1,130,0.007633587786259542,0.007633587786259542,0.9923664122137404,131,3900,2700,1200,0.6923076923076923,51,27,24,210.11018902505046,0.4699843413583871,0.6701106659558831,0.12010002162789953,1043101.7517301064,13733.261245674888,1056835.0129757812,149,0,74.25190839694656,67,64,40,39.30435565154789,0.5583651399491094,44.66911764705883,8170.588235294139,121.94907813871849,8
151,32,1,0,131,0.007633587786259542,0.0,1.0,131,4300,2700,1600,0.627906976744186,59,27,32,210.96960100447694,0.4699451947543551,0.6697762085418162,0.12113536437497428,1044498.3944157924,13571.481903943355,1058069.8763197358,150,0,74.59541984732824,70,61,40,39.10792898841998,0.5607506361323156,44.49823943661973,8176.056338028184,116.80080482897405,0
152,32,2,0,133,0.015037593984962405,0.0,1.0,133,3700,2600,1100,0.7027027027027027,48,26,22,211.40505052083648,0.47006009341535654,0.6749966625310628,0.12232003818543072,1046870.0277777823,13962.722222222488,1060832.750000005,151,0,74.45864661654136,74,59,42,38.80076831188579,0.56281328320802,44.20833333333335,8185.3333333333685,110.61261261261309,0
153,32,6,4,135,0.04316546762589928,0.02877697841726619,0.9712230215827338,139,4550,3700,850,0.8131868131868132,54,37,17,207.25086148009524,0.4717052445000521,0.6837721097291702,0.12130730922964442,1050416.6769945205,11189.952244034921,1061606.6292385554,152,0,72.20143884892086,81,58,37,38.46512973062305,0.5660221822541966,43.77540650406506,8199.186991869972,101.22453076382682,0
154,32,5,2,138,0.03571428571428571,0.014285714285714285,0.9857142857142858,140,3850,2900,950,0.7532467532467533,48,29,19,198.4577351873948,0.4713836073997944,0.6733153942831362,0.11714555793418373,1052999.0247770892,9945.160322359243,1062944.1850994485,153,0,72.57142857142857,71,69,40,38.36942627265206,0.5684523809523809,43.46064814814814,8209.25925925924,115.62336984872168,0
155,32,1,4,135,0.007194244604316547,0.02877697841726619,0.9712230215827338,139,5400,3900,1500,0.7222222222222222,69,39,30,224.8801690325856,0.47159446355958706,0.6971434208964504,0.13037462718945106,1047480.4266697487,13911.515081563828,1061391.9417513125,154,0,72.87050359712231,75,64,38,38.37984786800943,0.5628747002398082,44.133771929824576,8187.719298245647,109.1695906432753,8
156,32,2,1,136,0.014598540145985401,0.0072992700729927005,0.9927007299270073,137,3700,2200,1500,0.5945945945945946,52,22,30,223.38766030157223,0.4710533848575927,0.691988733572906,0.12471413949407814,1035730.2517361145,15173.871527777985,1050904.1232638925,155,0,74.51824817518248,67,70,44,39.88932958034799,0.5427311435523114,45.57291666666668,8141.666666666694,121.51741293532379,8
157,32,8,3,141,0.05555555555555555,0.020833333333333332,0.9791666666666666,144,4150,2700,1450,0.6506024096385542,56,27,29,213.66651422299407,0.4730700433825434,0.6917845564397294,0.12109482240238886,1040444.1563126671,11511.615224602512,1051955.7715372695,156,0,71.5625,76,68,44,39.54597701149431,0.5473090277777778,44.99458874458876,8160.1731601731935,107.37069947596308,0
158,32,1,1,141,0.007042253521126761,0.007042253521126761,0.9929577464788732,142,4400,3000,1400,0.6818181818181818,58,30,28,212.71940339802012,0.4722138980454833,0.6874065476750615,0.12090001534900194,1041327.4793388487,11502.112029385036,1052829.5913682338,157,0,72.53521126760563,76,66,45,39.459601583766386,0.5490023474178404,44.886363636363654,8163.636363636409,107.41626794258434,0
159,32,4,6,139,0.027586206896551724,0.041379310344827586,0.9586206896551724,145,4700,3200,1500,0.6808510638297872,62,32,30,209.71934200271545,0.47270713601532566,0.6918197779180963,0.1207099246128748,1045249.4735305845,10141.806363504114,1055391.2798940886,158,0,71.96551724137932,72,73,46,39.04610037963379,0.5526580459770115,44.40639269406395,8178.995433790014,113.59715880263909,0
160,32,2,3,138,0.014184397163120567,0.02127659574468085,0.9787234042553191,141,5150,4000,1150,0.7766990291262136,63,40,23,212.56229533934123,0.47178107058426205,0.6872093445188483,0.12324544951780661,1047510.7571676503,11182.258187241849,1058693.015354892,159,0,73.36170212765957,73,68,39,38.69123755295153,0.5559249408983451,44.1300675675676,8187.837837837915,112.16216216216321,0
161,32,2,1,139,0.014285714285714285,0.007142857142857143,0.9928571428571429,140,4750,3200,1550,0.6736842105263158,63,32,31,223.36469101876912,0.47181290681740323,0.6979160210722026,0.13034319311348486,1049486.4197530916,14133.641975308929,1063620.0617284006,160,0,74.77857142857142,74,66,42,38.16827096890819,0.558110119047619,43.88888888888891,8195.555555555597,110.75075075075131,0
162,32,1,4,136,0.007142857142857143,0.02857142857142857,0.9714285714285714,140,4600,3400,1200,0.7391304347826086,58,34,24,206.87573863304226,0.47216191332648166,0.6839761467287877,0.1188307343018826,1044618.351737976,10621.238621085195,1055239.5903590613,161,0,74.65714285714286,70,70,44,39.19755301638344,0.5523065476190476,44.48356807511739,8176.525821596284,116.80751173708977,8
163,32,4,1,139,0.02857142857142857,0.007142857142857143,0.9928571428571429,140,4200,2700,1500,0.6428571428571429,57,27,30,198.1200598928745,0.4722850291195615,0.6691503411842401,0.11465725249596591,1046934.5527960437,9283.7472607746,1056218.3000568182,162,0,75.25714285714285,73,67,45,39.132548242717746,0.5549107142857144,44.20045045045047,8185.585585585621,112.13130939158384,0
164,32,1,5,135,0.007142857142857143,0.03571428571428571,0.9642857142857143,140,4650,3600,1050,0.7741935483870968,57,36,21,194.19354732164544,0.47228824083590276,0.6612000744087978,0.1129435554018701,1048462.2253086475,8070.919753086681,1056533.1450617341,163,0,76.22142857142858,74,66,39,39.04280379071493,0.5570684523809524,44.01388888888891,8191.555555555599,110.69669669669729,0
165,32,2,1,136,0.014598540145985401,0.0072992700729927005,0.9927007299270073,137,3750,2100,1650,0.56,54,21,33,195.5842841494831,0.4714201373980249,0.6569126362969815,0.11391234532164483,1048894.2944211164,9879.447944566487,1058773.7423656827,164,0,78.53284671532846,73,64,43,38.953431103047606,0.5586982968369829,43.96114864864867,8193.24324324329,112.23620881155193,0
166,32,0,1,135,0.0,0.007352941176470588,0.9926470588235294,136,4700,3500,1200,0.7446808510638298,59,35,24,218.41995454190237,0.4703976034858388,0.6971401379793172,0.12251567130285027,1037208.5118865436,13409.407203346662,1050617.9190898903,165,1,80.0220588235294,65,71,43,39.8302545664931,0.5415134803921569,45.391414141414145,8147.474747474758,125.34576534576551,8
167,32,5,3,137,0.03571428571428571,0.02142857142857143,0.9785714285714285,140,3900,2700,1200,0.6923076923076923,51,27,24,210.4048339495083,0.4716576738609113,0.6942196724592247,0.11904410882506522,1039914.3424036284,11860.600907029517,1051774.943310658,166,0,78.64285714285714,69,71,42,39.69545295353725,0.544345238095238,45.05952380952381,8158.095238095239,118.23326432022085,0
168,32,5,2,140,0.035211267605633804,0.014084507042253521,0.9859154929577465,142,5250,3900,1350,0.7428571428571429,66,39,27,204.1257111187186,0.4720515765990743,0.688688072490891,0.11675990675990659,1043316.3265306074,8943.537414965658,1052259.863945573,167,0,78.15492957746478,62,80,45,39.43036130536132,0.5478286384976525,44.642857142857125,8171.428571428532,131.79723502304086,0
169,32,2,4,138,0.014084507042253521,0.028169014084507043,0.971830985915493,142,4150,2800,1350,0.6746987951807228,55,28,27,206.10249539106215,0.4720047531049179,0.6897103642229481,0.11665291252626052,1040029.5201667394,10320.535877346749,1050350.056044086,168,0,76.90845070422536,77,65,40,39.790728179072204,0.5459947183098591,45.04540598290598,8158.547008547005,105.95515595515592,8
170,32,2,4,136,0.014285714285714285,0.02857142857142857,0.9714285714285714,140,4050,2700,1350,0.6666666666666666,54,27,27,206.19486985463527,0.471512076053443,0.6844022268820695,0.11719912872936215,1041347.0508643568,10894.083925296898,1052241.1347896536,169,0,77.82857142857142,78,62,44,39.62360450692575,0.5483630952380952,44.88396624472574,8163.7130801687845,104.6629882072921,0
171,32,2,1,137,0.014492753623188406,0.007246376811594203,0.9927536231884058,138,4350,3000,1350,0.6896551724137931,57,30,27,206.86076705111117,0.471260226030537,0.676964907166481,0.11490045640204477,1034124.6428935827,10833.963371084606,1044958.6062646674,170,0,79.81884057971014,65,73,44,40.51118491846703,0.54068538647343,45.77020202020202,8135.353535353539,125.15928515928522,7
172,32,4,2,139,0.028368794326241134,0.014184397163120567,0.9858156028368794,141,4050,2500,1550,0.6172839506172839,56,25,31,205.34897298549132,0.4726802600472813,0.6829945709799858,0.11561866300000213,1038389.7044237239,10396.451872423851,1048786.1562961477,171,0,78.48226950354609,70,71,47,40.01514148045766,0.5444739952718676,45.24647887323943,8152.112676056325,116.45875251509035,0
173,32,1,2,138,0.007142857142857143,0.014285714285714285,0.9857142857142858,140,4400,3100,1300,0.7045454545454546,57,31,26,235.81823896277527,0.4726661527920521,0.721734496281712,0.1302862378762867,1032434.7484782196,16293.388846021688,1048728.1373242412,172,0,79.92857142857143,71,69,39,39.98770740782928,0.5380952380952381,45.978009259259245,8128.703703703672,114.48878455920665,8
174,32,1,0,139,0.007194244604316547,0.0,1.0,139,3800,2600,1200,0.6842105263157895,50,26,24,226.18253544198643,0.47264362423104994,0.7028633120414538,0.12287337534518412,1027074.7603879656,14861.274678603906,1041936.0350665695,173,0,80.89208633093526,65,74,39,40.90765744720611,0.5309502398081535,46.63825757575756,8107.575757575718,124.73193473193412,8
175,32,9,0,148,0.060810810810810814,0.0,1.0,148,4300,3000,1300,0.6976744186046512,56,30,26,231.99505306017147,0.4746066219280505,0.7221179147359136,0.12640178277861852,1028012.0964592902,13798.74417291402,1041810.8406322043,174,0,76.91216216216216,67,81,37,40.64212294272881,0.529420045045045,46.52267156862744,8111.274509803888,121.06379865378936,8
176,32,3,3,148,0.019867549668874173,0.019867549668874173,0.9801324503311258,151,4050,2800,1250,0.691358024691358,53,28,25,228.14164955900793,0.4751140544518028,0.7225518884590671,0.12539213972002494,1030788.9660493727,12783.179012345132,1043572.1450617178,175,0,76.36423841059603,71,80,33,40.389876880984936,0.5317328918322296,46.18055555555552,8122.222222222142,114.3974960876358,0
177,32,6,5,149,0.03896103896103896,0.032467532467532464,0.9675324675324676,154,5550,4000,1550,0.7207207207207207,71,40,31,217.50548325061118,0.4770605211781682,0.7148079644916812,0.12095053656539033,1034483.4356077004,8651.163915321162,1043134.5995230215,176,0,74.27272727272727,67,87,39,40.19550625539693,0.5362554112554112,45.72610294117648,8136.764705882364,121.44424934152782,0
178,32,4,3,150,0.026143790849673203,0.0196078431372549,0.9803921568627451,153,4250,2900,1350,0.6823529411764706,56,29,27,221.96152821073866,0.4769020181171884,0.7161523209110778,0.124543883675958,1037313.5600575317,11198.740604818398,1048512.3006623501,177,0,75.30718954248366,70,83,40,39.7269038701623,0.539692265795207,45.378521126760575,8147.887323943689,116.39839034205269,0
179,32,4,5,149,0.025974025974025976,0.032467532467532464,0.9675324675324676,154,4250,3000,1250,0.7058823529411765,55,30,25,217.69968361487128,0.4778333050391874,0.7108556376758453,0.12311923283429266,1039781.9100091816,10222.038567492984,1050003.9485766746,178,0,74.24675324675324,76,78,36,39.526064883605706,0.5435606060606061,45.07575757575757,8157.575757575748,107.33652312599668,0
180,32,3,4,148,0.019736842105263157,0.02631578947368421,0.9736842105263158,152,4750,3200,1550,0.6736842105263158,63,32,31,217.44448664729236,0.47661242302776813,0.7166807491040308,0.123295040054098,1040593.6798990549,10104.271706813397,1050697.9516058683,179,0,75.98026315789474,78,74,40,39.43091532668083,0.5434484649122807,44.97626582278481,8160.759493670888,104.62512171372934,8
181,32,1,2,147,0.006711409395973154,0.013422818791946308,0.9865771812080537,149,4900,3200,1700,0.6530612244897959,66,32,34,196.21849529090147,0.4763475724046194,0.6841469992748388,0.1119763259154187,1042593.9089885429,6215.241604238234,1048809.1505927811,180,0,78.3489932885906,68,81,47,39.7224357837049,0.5477488814317674,44.73128019323672,8168.599033816439,120.12645637965352,8
182,32,2,1,148,0.013422818791946308,0.006711409395973154,0.9932885906040269,149,4250,2800,1450,0.6588235294117647,57,28,29,189.14438329348908,0.4761038303404075,0.6707451895408292,0.10880985655239372,1045085.783624749,5484.421206499331,1050570.2048312484,181,0,79.2751677852349,76,73,42,39.59237596160633,0.5501957494407159,44.42640692640694,8178.354978355013,107.60993392572387,0
183,32,2,1,149,0.013333333333333334,0.006666666666666667,0.9933333333333333,150,4100,3000,1100,0.7317073170731707,52,30,22,202.90802201830726,0.47601323639075316,0.689130125139892,0.11794103775387052,1048277.354600699,8440.77690972246,1056718.1315104214,182,0,79.68666666666667,79,71,44,38.84275273849496,0.553125,44.03645833333335,8190.833333333369,103.68143459915657,0
184,32,4,3,150,0.026143790849673203,0.0196078431372549,0.9803921568627451,153,4100,2600,1500,0.6341463414634146,56,26,30,202.54229471529018,0.47636093911248706,0.6951868898631366,0.11901086812261248,1051601.4172335532,7898.75283446673,1059500.17006802,183,0,78.43137254901961,69,84,46,38.438394861078876,0.5561683006535948,43.63095238095236,8203.80952380947,118.89579020013726,0
185,32,1,5,146,0.006622516556291391,0.033112582781456956,0.9668874172185431,151,5400,4000,1400,0.7407407407407407,68,40,28,202.40737940918993,0.4756972038263429,0.6910951656310871,0.11949005524473569,1053032.4808790074,7028.308977495237,1060060.7898565026,184,0,79.25827814569537,70,81,47,38.26394448892447,0.5580160044150111,43.45657276995303,8209.389671361447,117.27699530516352,0
186,32,3,3,146,0.020134228187919462,0.020134228187919462,0.9798657718120806,149,5150,3600,1550,0.6990291262135923,67,36,31,234.74834297765554,0.47472829372997155,0.7323546788719271,0.13570870402815227,1046602.0727040822,14187.620464852625,1060789.693168935,185,0,80.13422818791946,69,80,39,38.23717296018309,0.5513143176733781,44.24107142857143,8184.285714285719,118.61283643892347,8
187,32,2,1,147,0.013513513513513514,0.006756756756756757,0.9932432432432432,148,4550,2900,1650,0.6373626373626373,62,29,33,232.52201356082853,0.4744830927866642,0.7283560823791353,0.13545670164580478,1048964.7767704069,14631.480409808142,1063596.257180215,186,0,80.58108108108108,71,77,34,37.998879346065486,0.5541244369369369,43.952546296296305,8193.518518518536,115.40166927490897,0
188,32,0,2,145,0.0,0.013605442176870748,0.9863945578231292,147,4700,3200,1500,0.6808510638297872,62,32,30,239.79823476564093,0.47415393097878417,0.7334249335898113,0.1399784690908203,1049586.405451067,16237.793452236403,1065824.1989033034,187,1,82.12925170068027,73,74,34,37.73489740771275,0.555342970521542,43.876689189189214,8195.945945946009,112.27323213624669,0
189,32,1,1,145,0.00684931506849315,0.00684931506849315,0.9931506849315068,146,5300,3700,1600,0.6981132075471698,69,37,32,246.83269671372702,0.47346087230357425,0.7393495845874061,0.14482969206874335,1051167.3980291714,17392.496710618485,1068559.89473979,188,0,83.63013698630137,62,84,35,37.35714208919279,0.5573630136986301,43.68386243386244,8202.11640211641,132.29220003413565,0
190,32,0,1,144,0.0,0.006896551724137931,0.993103448275862,145,4600,3100,1500,0.6739130434782609,61,31,30,243.43669547971027,0.47268718071519794,0.7335897187301392,0.14350660446234878,1052597.0784023686,17648.15088757416,1070245.2292899427,189,1,85.12413793103448,64,81,37,37.26569821930651,0.5591235632183909,43.509615384615394,8207.692307692321,128.24519230769252,0
191,32,2,2,144,0.0136986301369863,0.0136986301369863,0.9863013698630136,146,4650,3300,1350,0.7096774193548387,60,33,27,239.54636849869854,0.4727257518501023,0.7312322228397683,0.14216703739511988,1054648.4525182617,16677.441368704327,1071325.8938869662,190,0,85.0068493150685,67,79,37,37.10968575974542,0.5618578767123288,43.259803921568626,8215.6862745098,122.62218320163882,0
192,32,3,2,145,0.02040816326530612,0.013605442176870748,0.9863945578231292,147,5300,3900,1400,0.7358490566037735,67,39,28,232.55718463634165,0.4726415680427422,0.7264230920331662,0.13911147953701142,1057041.015624998,14464.496527777676,1071505.5121527757,191,0,85.1156462585034,71,76,36,36.99130361364402,0.564625850340136,42.96874999999999,8224.999999999984,115.84507042253497,0
193,32,2,1,146,0.013605442176870748,0.006802721088435374,0.9931972789115646,147,4400,3300,1100,0.75,55,33,22,231.49477860363405,0.4721484484204641,0.7257050891263697,0.13952160353327345,1059313.9770495358,15245.130917763501,1074559.1079672994,192,0,85.94557823129252,65,82,38,36.73601739966058,0.5668225623582767,42.692550505050505,8233.838383838385,126.67443667443669,0
194,32,1,0,147,0.006802721088435374,0.0,1.0,147,4200,2700,1500,0.6428571428571429,57,27,30,229.80726253918849,0.4720494362128413,0.722537200484,0.13925955599436762,1060950.4907968086,15162.825595924574,1076113.3163927332,193,0,86.85034013605443,67,80,38,36.57619472536189,0.5683815192743764,42.493872549019606,8240.19607843137,122.98800117061747,0
195,32,1,3,145,0.006756756756756757,0.02027027027027027,0.9797297297297297,148,5400,4000,1400,0.7407407407407407,68,40,28,223.1844979214711,0.4721571060856775,0.7163855448010661,0.13599961769894586,1062617.3611111126,12431.944444444514,1075049.3055555571,194,0,87.25675675675676,69,79,40,36.54001616814874,0.5703828828828829,42.29166666666667,8246.666666666679,119.51690821256057,0
196,32,1,2,144,0.00684931506849315,0.0136986301369863,0.9863013698630136,146,4600,3600,1000,0.782608695652174,56,36,20,226.76175995466625,0.47186663517556293,0.717200057173685,0.1389091110980024,1064192.8288966015,14463.64776234554,1078656.476658947,195,0,87.92465753424658,71,75,43,36.25252440255809,0.5724885844748858,42.100694444444436,8252.777777777752,116.23630672926411,0
197,32,0,1,143,0.0,0.006944444444444444,0.9930555555555556,144,4250,2700,1550,0.6352941176470588,58,27,31,228.56976704594098,0.4714735495985496,0.7163967065961521,0.14063466487749066,1065506.6102162648,15658.519536608419,1081165.1297528732,196,1,89.01388888888889,71,73,35,36.04311496701615,0.5743634259259259,41.94155092592593,8257.87037037038,116.3080333854983,0
198,32,1,1,143,0.006944444444444444,0.006944444444444444,0.9930555555555556,144,5000,3400,1600,0.68,66,34,32,229.64845587528478,0.47080581455581455,0.7198393509563734,0.14187397777614477,1066716.3978284444,15193.95472362965,1081910.352552074,197,0,90.0,72,72,37,35.86545546651932,0.5758101851851851,41.79509132420092,8262.557077625575,114.7577371892441,0
199,32,2,1,144,0.013793103448275862,0.006896551724137931,0.993103448275862,145,4350,2400,1950,0.5517241379310345,63,24,39,222.9197567318778,0.470573914431673,0.7163141260447963,0.1361102200636179,1063216.1617755902,14052.377627283324,1077268.5394028735,198,0,90.20689655172414,65,80,42,36.47261933917024,0.5734195402298851,42.21906565656568,8248.989898989947,126.90753690753763,8
200,32,1,0,145,0.006896551724137931,0.0,1.0,145,4300,2600,1700,0.6046511627906976,60,26,34,222.7323185598404,0.4706118295019157,0.7163889965129788,0.13671156104707494,1064784.7090947316,14132.393404747118,1078917.1024994787,199,0,90.62068965517241,68,77,40,36.28313728932584,0.5755747126436781,42.02898550724639,8255.072463768143,121.39812446717858,0
201,32,1,1,145,0.00684931506849315,0.00684931506849315,0.9931506849315068,146,4400,2900,1500,0.6590909090909091,59,29,30,247.86506419256654,0.47044559911824907,0.7466675204688185,0.14913643937605758,1058805.6914708274,18888.188136774246,1077693.8796076018,200,0,90.9931506849315,67,79,37,36.378066754004635,0.564925799086758,42.75428921568627,8231.862745098031,122.86362306116465,8
202,32,3,2,146,0.02027027027027027,0.013513513513513514,0.9864864864864865,148,4800,3700,1100,0.7708333333333334,59,37,22,241.73714404542653,0.471054919715634,0.7423011662323509,0.1467568678854115,1061499.5555835518,16920.774194451562,1078420.3297780033,201,0,90.28378378378379,62,86,39,36.20075854838021,0.5672156531531531,42.427248677248684,8242.328042328056,132.94077487625896,0
203,32,2,0,148,0.013513513513513514,0.0,1.0,148,4700,3400,1300,0.723404255319149,60,34,26,239.03988659390114,0.47038747931605074,0.7382587230153881,0.14617684285098023,1063674.8890532586,16552.144970414476,1080227.034023673,202,0,90.14189189189189,64,84,43,36.000139847100506,0.5705236486486487,42.163461538461554,8250.769230769263,128.91826923076974,0
204,32,0,2,146,0.0,0.013513513513513514,0.9864864864864865,148,5250,3700,1550,0.7047619047619048,68,37,31,244.97363162246702,0.4703300239014525,0.743783599046757,0.15007082808147587,1064203.8502629872,17290.37639710735,1081494.2266600945,203,1,91.14189189189189,64,84,40,35.78147331137764,0.5716497747747749,42.099358974358985,8252.820512820532,128.9503205128208,0
205,32,1,1,146,0.006802721088435374,0.006802721088435374,0.9931972789115646,147,5550,4500,1050,0.8108108108108109,66,45,21,242.80232515605482,0.4699546485260771,0.7397743025889352,0.149564430423587,1065850.78726393,16808.209883418764,1082658.997147349,204,0,92.45578231292517,66,81,35,35.63314458968337,0.5737670068027211,41.89987562189055,8259.20398009951,125.13945424393197,0
206,32,0,2,144,0.0,0.0136986301369863,0.9863013698630136,146,5600,3900,1700,0.6964285714285714,73,39,34,243.32348244328,0.4692499212722406,0.7382642958989878,0.15053431533949096,1067135.2542325705,17131.813259572915,1084267.0674921435,205,1,93.9931506849315,66,80,37,35.46043786246064,0.5758418949771689,41.744402985074636,8264.17910447763,125.21483491632772,0
207,32,0,1,143,0.0,0.006944444444444444,0.9930555555555556,144,4200,2800,1400,0.6666666666666666,56,28,28,249.1241495514435,0.46851831617456613,0.742892266636809,0.154831439084477,1068495.4909336378,20237.606095678733,1088733.0970293165,206,2,96.24305555555556,59,85,36,35.14199137834508,0.5773292824074074,41.57986111111109,8269.44444444441,140.1600753295663,0
208,32,0,0,143,0.0,0.0,1.0,143,4650,3300,1350,0.7096774193548387,60,33,27,250.72790500269303,0.4682749761975114,0.7436390397115478,0.15658667274696447,1069931.6406249967,20402.34374999979,1090333.9843749965,207,3,97.13986013986013,59,84,42,34.922583081570984,0.5787441724941724,41.406249999999986,8274.999999999975,140.25423728813516,0
209,32,1,0,144,0.006944444444444444,0.0,1.0,144,3900,2700,1200,0.6923076923076923,51,27,24,246.91566186321688,0.4682795503108003,0.7415374037403752,0.15470522238328027,1070885.6826121954,20183.689420406314,1091069.3720326016,208,0,97.45833333333333,60,84,40,34.90305280528052,0.5799334490740741,41.290983606557354,8278.68852459012,137.978142076502,0
210,32,0,2,142,0.0,0.013888888888888888,0.9861111111111112,144,4950,3600,1350,0.7272727272727273,63,36,27,244.72792489342547,0.4674701745014245,0.7399256651017216,0.15396174515447097,1072087.6736111068,18723.95833333303,1090811.6319444398,209,1,98.45833333333333,61,83,39,34.81094902749829,0.5818142361111112,41.145833333333314,8283.3333333333,135.7923497267754,0
211,32,1,1,142,0.006993006993006993,0.006993006993006993,0.993006993006993,143,4950,3100,1850,0.6262626262626263,68,31,37,252.02849817594898,0.46684067106602317,0.7430630053163472,0.15649674728633012,1068231.0422437657,20294.933056324895,1088525.9753000906,210,0,99.07692307692308,56,87,40,35.09972416719711,0.5785984848484849,41.61184210526315,8268.421052631566,147.6503759398494,8
212,32,3,4,141,0.020689655172413793,0.027586206896551724,0.9724137931034482,145,4250,3200,1050,0.7529411764705882,53,32,21,233.46949782928695,0.4673251915708812,0.7244455937229264,0.1401660945068429,1058141.2102558597,16158.739398181686,1074299.9496540413,211,0,97.24827586206897,73,72,39,36.83100470742784,0.5672413793103448,42.83502252252251,8229.279279279246,112.72985314081158,8
213,32,0,0,141,0.0,0.0,1.0,141,5100,3600,1500,0.7058823529411765,66,36,30,238.07810039346415,0.46666033434650456,0.7246624153604109,0.1432043348612938,1058714.140786263,17111.3302996184,1075825.4710858813,212,1,99.61702127659575,72,69,39,36.64121872746435,0.5688534278959811,42.765410958904106,8231.506849315061,114.32648401826474,0
214,32,2,1,142,0.013986013986013986,0.006993006993006993,0.993006993006993,143,5150,3800,1350,0.7378640776699029,65,38,27,233.53346364988806,0.4667237105617387,0.7236001041403048,0.1362965540437483,1049530.199886774,15270.084556943691,1064800.2844437177,213,0,99.20979020979021,77,66,36,37.90237077206521,0.5578379953379953,43.88354700854702,8195.726495726523,106.4380064380068,8
215,32,2,0,144,0.013888888888888888,0.0,1.0,144,5100,3400,1700,0.6666666666666666,68,34,34,229.19392979175308,0.4671575530950531,0.7216147336504715,0.135294703638438,1053012.9975550256,14368.83740628602,1067381.8349613117,214,0,98.88194444444444,67,77,39,37.579180848311125,0.5614872685185186,43.45894607843137,8209.313725490187,122.52707052970428,0
216,32,0,0,144,0.0,0.0,1.0,144,4900,3600,1300,0.7346938775510204,62,36,26,231.46047035822576,0.4670381701631701,0.7234738965663687,0.13728584926549126,1054466.0646981273,15113.442262363222,1069579.5069604905,215,1,99.88194444444444,68,76,38,37.3399980397922,0.5632233796296297,43.28200483091788,8214.975845410638,120.80846831486232,0
217,32,1,0,145,0.006896551724137931,0.0,1.0,145,5750,4300,1450,0.7478260869565218,72,43,29,232.2132434260298,0.46737707535121326,0.7269977457745587,0.1386708134540372,1056528.2220514002,14317.969042738427,1070846.1910941387,216,0,100.18620689655172,70,75,40,37.0639451898373,0.565301724137931,43.031103286384976,8223.004694835676,117.47149564050966,0
218,32,1,1,145,0.00684931506849315,0.00684931506849315,0.9931506849315068,146,4100,3000,1100,0.7317073170731707,52,30,22,227.84432786400828,0.46719709494567785,0.724203219280714,0.13662319280471094,1057774.6795573481,14901.592179062165,1072676.2717364102,217,0,100.4931506849315,72,74,41,37.02122296834821,0.5665667808219178,42.87956621004566,8227.853881278534,114.27574835109074,0
219,32,2,2,145,0.013605442176870748,0.013605442176870748,0.9863945578231292,147,5300,3700,1600,0.6981132075471698,69,37,32,224.04954767770582,0.46743274935544993,0.7197917253377886,0.13515086477562,1059573.8995064327,12779.41058310404,1072353.3100895367,218,0,100.46938775510205,65,82,44,36.895315854032496,0.5688775510204082,42.660984848484865,8234.848484848522,126.68997668997727,0
220,32,1,1,145,0.00684931506849315,0.00684931506849315,0.9931506849315068,146,4150,2500,1650,0.6024096385542169,58,25,33,200.08238543904804,0.4670740828216029,0.6908010853455837,0.12058713498667409,1059308.3269154495,9039.787392938135,1068348.1143083875,219,0,101.9931506849315,68,78,41,37.544981616209036,0.571917808219178,42.69323671497585,8233.81642512079,121.08553566354104,8
221,32,1,4,142,0.00684931506849315,0.0273972602739726,0.9726027397260274,146,5100,3800,1300,0.7450980392156863,64,38,26,196.80206630937778,0.4663861990237758,0.68433536204732,0.11917272453582838,1060733.1084158516,7450.893507801697,1068184.0019236533,220,0,102.97945205479452,71,75,41,37.453000037459475,0.573558789954338,42.520254629629626,8239.351851851847,116.04720918101192,0
222,32,1,1,142,0.006993006993006993,0.006993006993006993,0.993006993006993,143,4150,3000,1150,0.7228915662650602,53,30,23,212.4700096280773,0.4663789848649003,0.6968596630464727,0.12275588370581579,1046416.8934133999,11716.441483705617,1058133.3348971056,221,0,104.74125874125875,72,71,41,38.83006918870662,0.5553613053613053,44.26369863013699,8183.561643835628,113.66057838660595,8
223,32,4,1,145,0.0273972602739726,0.00684931506849315,0.9931506849315068,146,3950,2900,1050,0.7341772151898734,50,29,21,229.64499012784208,0.4671223035742403,0.7319866177739132,0.13284526644104347,1046803.8538650088,14928.652137323705,1061732.5060023325,222,0,103.54794520547945,66,80,42,38.34247609206582,0.5527254566210046,44.21641791044778,8185.074626865715,124.0162822252381,7
224,32,2,0,147,0.013605442176870748,0.0,1.0,147,4600,2800,1800,0.6086956521739131,64,28,36,232.64579143924138,0.4667668437237909,0.7366124754986745,0.13563341595766076,1049201.8711419776,14818.479938271788,1064020.3510802493,223,0,103.63265306122449,71,76,37,37.96610169491528,0.555342970521542,43.92361111111112,8194.444444444463,115.41471048513328,0
225,32,1,1,147,0.006756756756756757,0.006756756756756757,0.9932432432432432,148,4900,3500,1400,0.7142857142857143,63,35,28,230.4857010218246,0.46702825274253845,0.7362412338762974,0.13519364731946,1051066.8567925096,13951.176261725472,1065018.033054235,224,0,103.92567567567568,57,91,40,37.78868275990938,0.5574324324324325,43.696120689655174,8201.72413793104,143.88989715668492,0
226,32,1,2,146,0.006756756756756757,0.013513513513513514,0.9864864864864865,148,4050,3000,1050,0.7407407407407407,51,30,21,229.76330840152988,0.46685397131825707,0.7340171356923924,0.1358965909448078,1053609.9213347926,14766.180258111719,1068376.1015929044,225,0,104.69594594594595,62,86,39,37.49020081615119,0.5595439189189189,43.3862433862434,8211.64021164024,132.44580986516516,0
227,32,4,2,148,0.02666666666666667,0.013333333333333334,0.9866666666666667,150,3800,2000,1800,0.5263157894736842,56,20,36,229.15923803949536,0.46753355704697985,0.7370981326976551,0.1371359491548767,1057167.0150903536,14651.917531718771,1071818.9326220723,226,0,102.04,67,83,37,37.06297179181565,0.5633333333333334,42.95343137254903,8225.490196078461,122.76851038923076,0
228,32,2,2,148,0.013333333333333334,0.013333333333333334,0.9866666666666667,150,5300,3400,1900,0.6415094339622641,72,34,38,203.71694818133696,0.46737509321401943,0.7007494738410531,0.11659489036141293,1043499.5654020963,7215.70937845323,1050715.2747805496,227,0,102.44,72,78,37,39.417919204335895,0.5511111111111111,44.62043378995433,8172.146118721452,113.50202942668683,8
229,32,4,1,151,0.02631578947368421,0.006578947368421052,0.993421052631579,152,4600,3100,1500,0.6739130434782609,61,31,30,195.5311672154085,0.46903683048681305,0.6932407005546852,0.1130442980691876,1046621.6193330983,5929.429372216458,1052551.0487053148,228,0,100.90131578947368,80,72,42,39.23775224591044,0.5542763157894737,44.238683127572024,8184.362139917712,102.3045267489714,0
230,32,3,2,152,0.01948051948051948,0.012987012987012988,0.987012987012987,154,4100,2600,1500,0.6341463414634146,56,26,30,193.14718414574293,0.4695758353846589,0.6941111210293425,0.11258759409444033,1049152.8149359252,5628.182388690831,1054780.997324616,229,0,100.53896103896103,86,68,40,38.98366998644037,0.5567505411255411,43.92959770114943,8194.252873563237,95.28201015771205,0
231,32,0,2,150,0.0,0.013157894736842105,0.9868421052631579,152,4850,3600,1250,0.7422680412371134,61,36,25,193.66779033643962,0.46830704658998484,0.6927150192554554,0.11343399148277203,1050625.0000000023,5444.444444444569,1056069.4444444468,230,1,102.85526315789474,84,68,43,38.78726287262873,0.5585252192982456,43.75000000000001,8200.000000000018,97.61904761904783,0
232,32,1,1,150,0.006622516556291391,0.006622516556291391,0.9933774834437086,151,5350,3700,1650,0.6915887850467289,70,37,33,191.11436373811506,0.4684841795437822,0.6869267381803164,0.11262588766651976,1052497.9801296794,4679.496361626623,1057177.476491306,231,0,103.8476821192053,72,79,44,38.62002058528987,0.5606374172185431,43.521689497716864,8207.305936072986,113.99036022323591,0
233,32,3,1,152,0.0196078431372549,0.006535947712418301,0.9934640522875817,153,4200,3200,1000,0.7619047619047619,52,32,20,191.77619174378276,0.4685385850246531,0.6912586330009793,0.11407509877589461,1055339.1437696286,5677.784398056668,1061016.9281676852,232,0,102.16993464052288,77,76,48,38.250470161024715,0.5634531590413943,43.17574786324785,8218.376068376037,106.73215673215633,0
234,32,1,2,151,0.006535947712418301,0.013071895424836602,0.9869281045751634,153,4500,3100,1400,0.6888888888888889,59,31,28,197.6947453216363,0.46856366815732137,0.7006477094756542,0.11839179026301631,1057384.8096496065,6707.88413012884,1064092.6937797354,233,0,103.00653594771242,80,73,43,37.84475571118892,0.5657679738562091,42.92695473251027,8226.337448559618,102.82921810699523,0
235,32,1,1,151,0.006578947368421052,0.006578947368421052,0.993421052631579,152,5400,3600,1800,0.6666666666666666,72,36,36,215.6452286200566,0.46882987684442895,0.721979768371295,0.1273116965101804,1053048.6598413372,9616.983799905747,1062665.643641243,234,0,104.35526315789474,66,86,40,37.92232288952183,0.5586622807017544,43.45460199004974,8209.452736318382,124.38564751997549,8
236,32,2,3,150,0.013071895424836602,0.0196078431372549,0.9803921568627451,153,5150,3400,1750,0.6601941747572816,69,34,35,213.30768979591926,0.46911908038069033,0.7199372549019627,0.12662430703624722,1054719.3568295476,9245.949877669487,1063965.3067072171,235,0,104.50980392156863,70,83,41,37.77452380952383,0.5605936819172113,43.25117370892017,8215.96244131451,117.37089201877872,0
237,32,4,6,148,0.025974025974025976,0.03896103896103896,0.961038961038961,154,5550,4300,1250,0.7747747747747747,68,43,25,210.97693458105917,0.46958025634496225,0.7183160940183408,0.1264768462747591,1057697.9753086395,8279.975308641788,1065977.9506172813,236,0,102.28571428571429,74,80,35,37.46443748199364,0.5641233766233766,42.88888888888888,8227.555555555535,111.1831831831829,0
238,32,1,0,149,0.006711409395973154,0.0,1.0,149,4350,3400,950,0.7816091954022989,53,34,19,217.2690101428032,0.46781848963057016,0.7201150825311904,0.1302313048820034,1057657.2762244309,11809.22989512307,1069466.506119554,237,0,106.66442953020135,72,77,37,37.30771543271545,0.5651565995525727,42.89383561643835,8227.397260273961,114.26940639269391,0
239,32,0,2,147,0.0,0.013422818791946308,0.9865771812080537,149,4350,2500,1850,0.5747126436781609,62,25,37,232.5795993761135,0.4675728580929923,0.7262540062377345,0.13569216198895195,1049422.2927549663,14664.843285062627,1064087.1360400289,238,1,107.66442953020135,70,79,36,37.940273640391105,0.555299217002237,43.89671361502348,8195.305164319261,117.07578806170373,8
240,32,1,1,147,0.006756756756756757,0.006756756756756757,0.9932432432432432,148,4450,2900,1550,0.651685393258427,60,29,31,230.6138744842281,0.46747736256664824,0.7199962680116907,0.1351292296408628,1050750.616499658,14413.534157535156,1065164.150657193,239,0,109.01351351351352,67,81,38,37.824847570087876,0.5573620495495495,43.734681372549,8200.490196078386,122.39537606087144,0
241,32,3,2,148,0.02,0.013333333333333334,0.9866666666666667,150,5100,3500,1600,0.6862745098039216,67,35,32,225.9246681395044,0.4676016032811335,0.71857897245258,0.13332071624769534,1052912.0413994077,12475.76070664957,1065387.8021060573,240,0,108.42666666666666,70,80,39,37.67562672767132,0.5599305555555556,43.47124413145538,8208.92018779338,117.27028839704828,0
242,32,0,2,146,0.0,0.013513513513513514,0.9864864864864865,148,3750,2600,1150,0.6933333333333334,49,26,23,228.24641031865866,0.4668558864987436,0.717003869709621,0.13514991051578726,1053949.3848593913,14762.03275034267,1068711.417609734,241,1,110.66216216216216,71,77,41,37.486847049981186,0.5615146396396397,43.34490740740739,8212.962962962922,115.67553468961862,0
243,32,0,2,144,0.0,0.0136986301369863,0.9863013698630136,146,4800,3500,1300,0.7291666666666666,61,35,26,227.5500720982603,0.46622579121398205,0.7134115198804076,0.13528968112165077,1055193.31136235,14021.862815620641,1069215.1741779705,242,2,111.5,72,74,40,37.34985923579856,0.5632134703196348,43.19349315068491,8217.808219178027,114.13622526636148,0
244,32,2,6,140,0.0136986301369863,0.0410958904109589,0.9589041095890412,146,5000,3200,1800,0.64,68,32,36,225.53843163317097,0.466461974492206,0.7124508780888532,0.13510408962880208,1057469.4444444415,13499.999999999884,1070969.4444444412,243,0,110.95890410958904,74,72,33,37.1184494867639,0.5664954337899544,42.91666666666666,8226.666666666642,111.17117117117084,0
245,32,1,2,139,0.0070921985815602835,0.014184397163120567,0.9858156028368794,141,3700,2600,1100,0.7027027027027027,48,26,22,227.6488202182737,0.4655352921310368,0.7090653421450617,0.13061192087383663,1044260.2905868692,15644.924630578591,1059905.2152174478,244,0,113.44680851063829,66,75,39,38.71155874716001,0.5516400709219857,44.52736318407961,8175.124378109473,123.86552088044655,8
246,32,6,3,142,0.041379310344827586,0.020689655172413793,0.9793103448275862,145,3950,2400,1550,0.6075949367088608,55,24,31,218.12771528528958,0.46707575031928483,0.7055957992675645,0.12667631293923923,1048007.1882716131,12769.882716049866,1060777.070987663,245,0,110.26896551724138,74,71,32,38.48688970894159,0.5544540229885058,44.06944444444447,8189.777777777842,110.67267267267354,0
247,32,2,0,144,0.013888888888888888,0.0,1.0,144,4000,2800,1200,0.7,52,28,24,221.93405521584884,0.46711404914529914,0.7122244358950873,0.12955053367508437,1049586.405451062,13787.793452236212,1063374.198903298,246,0,112.02083333333333,73,71,36,38.19244068883396,0.5562065972222222,43.8766891891892,8195.945945945969,112.27323213624615,0
248,32,4,1,147,0.02702702702702703,0.006756756756756757,0.9932432432432432,148,4700,3300,1400,0.7021276595744681,61,33,28,212.85153278262726,0.46813522706379845,0.716032452433933,0.12357277493986067,1047908.9546028492,10309.805440771492,1058218.7600436206,247,0,109.96621621621621,65,83,40,38.63417360468704,0.551097972972973,44.081439393939405,8189.39393939396,125.99067599067631,8
249,32,2,1,148,0.013422818791946308,0.006711409395973154,0.9932885906040269,149,4300,3000,1300,0.6976744186046512,56,30,26,209.83992037880782,0.46799798960033856,0.7140667508100085,0.12285932345100256,1050507.994125434,9987.702768916399,1060495.6968943505,248,0,110.0738255033557,72,77,42,38.387420875795904,0.5536912751677852,43.76426940639269,8199.543378995424,113.882546930492,0
250,32,3,1,150,0.019867549668874173,0.006622516556291391,0.9933774834437086,151,4350,2800,1550,0.6436781609195402,59,28,31,205.4889872200065,0.46854120676968364,0.7100643641870739,0.12187622690290029,1054453.1075963466,8785.700230192357,1063238.807826539,249,0,108.50331125827815,66,85,43,38.00834241763566,0.5568432671081678,43.28358208955224,8214.925373134329,124.46856625961104,0
251,32,1,3,148,0.006622516556291391,0.019867549668874173,0.9801324503311258,151,5450,3600,1850,0.6605504587155964,73,36,37,203.73968712827056,0.4684437086092715,0.7075900336515837,0.12143741701792592,1055954.8100597467,7377.980524633139,1063332.7905843798,250,0,109.45695364238411,68,83,42,37.866790072672416,0.5587748344370861,43.100845410628025,8220.77294685992,120.89371980676351,0
252,32,1,0,149,0.006711409395973154,0.0,1.0,149,4850,3400,1450,0.7010309278350515,63,34,29,208.2618059409781,0.46789973698530746,0.7095154946428126,0.12484712484972893,1057693.0069838269,9405.41115311908,1067098.418136946,251,0,111.45637583892618,68,81,43,37.53486289707006,0.5604725950782998,42.88949275362319,8227.536231884058,120.99317988064792,0
253,32,2,0,151,0.013245033112582781,0.0,1.0,151,4650,2700,1950,0.5806451612903226,66,27,39,236.26031550878866,0.4679359823399558,0.7455186879469229,0.1420874768325545,1058664.310401997,15174.072798693862,1073838.3832006908,252,0,110.96688741721854,65,86,40,36.69417515441566,0.564569536423841,42.771464646464636,8231.31313131311,126.63558663558632,8
254,32,0,1,150,0.0,0.006622516556291391,0.9933774834437086,151,4600,3500,1100,0.7608695652173914,57,35,22,237.92469063706415,0.4678016924208977,0.7481195785894226,0.14402888184144105,1060638.151752373,15670.400826710316,1076308.5525790832,253,1,111.96688741721854,58,93,40,36.40597499371417,0.5663631346578366,42.53177966101696,8238.98305084748,142.05143191116346,0
255,32,2,1,151,0.013157894736842105,0.006578947368421052,0.993421052631579,152,4550,3300,1250,0.7252747252747253,58,33,25,244.98233907870298,0.4676998010340421,0.7545135674097292,0.1448335588633286,1053474.1512345632,16666.51234567867,1070140.6635802418,254,0,111.8092105263158,56,96,40,37.116599007668015,0.5540707236842105,43.40277777777776,8211.111111111075,146.62698412698347,8
256,32,1,0,152,0.006578947368421052,0.0,1.0,152,5600,3700,1900,0.6607142857142857,75,37,38,239.42911793232608,0.46760812420123155,0.7479214546437762,0.14248247669713668,1055470.8526234524,14542.0910493825,1070012.943672835,255,0,112.76973684210526,59,93,42,37.01021810643958,0.555921052631579,43.15972222222221,8218.888888888856,139.30320150659077,0
257,32,2,3,151,0.012987012987012988,0.01948051948051948,0.9805194805194806,154,5150,3900,1250,0.7572815533980582,64,39,25,237.40343399803018,0.46794980618510035,0.7509550022777534,0.1426937248164834,1058492.496422993,14307.950702393013,1072800.447125386,256,0,112.29220779220779,61,93,43,36.68614050558491,0.5585768398268398,42.7923387096774,8230.645161290291,134.92860920148019,0
258,32,1,1,151,0.006578947368421052,0.006578947368421052,0.993421052631579,152,4800,3300,1500,0.6875,63,33,30,236.98846207600832,0.4678277855234112,0.7464235868806706,0.14305158641740506,1059775.5854472183,15030.917228167511,1074806.5026753857,257,0,114.13157894736842,57,95,41,36.537276110723425,0.5603070175438596,42.63649425287356,8235.632183908041,144.48477515628142,0
259,32,1,3,149,0.006578947368421052,0.019736842105263157,0.9802631578947368,152,5000,4000,1000,0.8,60,40,20,249.58717531631427,0.4674420166724759,0.7575976694834008,0.1453395192047052,1048840.9321551446,16955.44912254649,1065796.381277691,258,0,115.08552631578948,66,86,36,37.57742288073841,0.5481770833333333,43.96766169154229,8193.034825870645,124.13689130107038,8
260,32,3,3,149,0.019736842105263157,0.019736842105263157,0.9802631578947368,152,4000,2400,1600,0.6,56,24,32,240.8709923228798,0.4685203540722667,0.7485280591236279,0.14127844496077355,1051052.12673611,16233.593749999955,1067285.72048611,259,0,113.38815789473684,59,93,40,37.52434295197454,0.5506441885964912,43.697916666666664,8201.666666666659,139.01129943502812,0
261,32,1,1,149,0.006666666666666667,0.006666666666666667,0.9933333333333333,150,4600,2800,1800,0.6086956521739131,64,28,36,237.16038990786117,0.467889634601044,0.7393841729053006,0.140004571750101,1053028.7170410121,15347.340223524061,1068376.0572645362,260,0,114.54,63,87,42,37.372848200312966,0.5540277777777778,43.457031249999986,8209.374999999973,130.30753968253924,0
262,32,2,2,149,0.013245033112582781,0.013245033112582781,0.9867549668874173,151,3950,2700,1250,0.6835443037974683,52,27,25,237.04686341044155,0.4681144223693892,0.7413126131980248,0.14097519209209117,1055277.8115688672,15880.059051806924,1071157.8706206742,261,0,113.33112582781457,67,84,42,37.09544934884181,0.5565673289183223,43.18321078431372,8218.137254901956,122.65876499853665,0
263,32,1,2,148,0.006666666666666667,0.013333333333333334,0.9866666666666667,150,4700,3400,1300,0.723404255319149,60,34,26,236.96476884567522,0.46787938105891125,0.7387679414125998,0.14158832081642397,1056699.5765653776,15380.114180027416,1072079.6907454052,262,0,114.91333333333333,68,82,34,36.920514402083455,0.5585416666666667,43.01026570048308,8223.671497584517,120.93634555271349,0
264,32,1,4,145,0.006711409395973154,0.026845637583892617,0.9731543624161074,149,4000,2800,1200,0.7,52,28,24,226.36102478733426,0.46797153697321486,0.7272954806697254,0.12913604594601205,1042493.3596318195,13395.973044049868,1055889.3326758693,263,0,116.67114093959732,64,85,36,38.96557948267201,0.5466303131991052,44.74358974358974,8168.205128205114,127.62820512820491,8
265,32,1,0,146,0.00684931506849315,0.0,1.0,146,4400,2700,1700,0.6136363636363636,61,27,34,239.69564241133946,0.4673702960163754,0.7392707339547531,0.13326795930393825,1034431.1661752762,15989.728581338535,1050420.8947566147,264,0,119.05479452054794,61,85,37,39.63784635038102,0.5351740867579908,45.73252688172041,8136.559139784913,133.38621540631004,8
266,32,3,1,148,0.020134228187919462,0.006711409395973154,0.9932885906040269,149,3950,2500,1450,0.6329113924050633,54,25,29,239.17948061211985,0.46820583167059676,0.7424658856099,0.13438022629377316,1037722.9364350579,15890.406591164214,1053613.3430262222,265,0,117.63758389261746,65,84,40,39.23705792431005,0.5379614093959731,45.32828282828283,8149.4949494949515,125.37684537684541,0
267,32,2,3,147,0.013333333333333334,0.02,0.98,150,4150,3000,1150,0.7228915662650602,53,30,23,234.35762969691146,0.4683314690529456,0.738415159345392,0.13251598082862087,1039725.1094831341,14583.50243896593,1054308.6119221,266,0,116.08,67,83,37,39.10853965106266,0.5405555555555556,45.082720588235304,8157.352941176491,121.75153643547002,0
268,32,1,0,148,0.006756756756756757,0.0,1.0,148,4950,3600,1350,0.7272727272727273,63,36,27,233.90069812563092,0.4681467181467181,0.7350862148694888,0.1331084362377394,1041725.4218629851,14182.060685793875,1055907.482548779,267,0,118.44594594594595,67,81,38,38.8693567269016,0.5427927927927928,44.837622549019606,8165.196078431371,121.86859818554285,0
269,32,6,0,154,0.03896103896103896,0.0,1.0,154,4850,3500,1350,0.7216494845360825,62,35,27,221.29315613439024,0.46935655575361457,0.7293359138996718,0.1279536846066615,1046658.6800734036,10673.68054178001,1057332.3606151836,268,0,114.79220779220779,70,84,43,38.57423182087614,0.5470102813852814,44.234154929577485,8184.507042253565,116.92152917505092,0
270,32,1,5,150,0.0064516129032258064,0.03225806451612903,0.967741935483871,155,5300,3600,1700,0.6792452830188679,70,36,34,218.8161621748355,0.46942291579388357,0.7288279701768452,0.1271913258941092,1048286.1204937375,9576.389149517487,1057862.509643255,269,0,115.04516129032258,72,83,40,38.43446872561045,0.5491263440860215,44.03538812785389,8190.8675799087,113.76204972095417,0
271,32,0,1,149,0.0,0.006666666666666667,0.9933333333333333,150,3900,2300,1600,0.5897435897435898,55,23,32,218.9922664382278,0.46841629381058913,0.7206430167917934,0.12741567379395252,1048580.8075172468,12026.217516365765,1060607.0250336125,270,1,116.71333333333334,70,80,41,38.39319827306245,0.5503472222222222,43.999413145539904,8192.018779342718,117.02883970489597,0
272,32,1,0,150,0.006666666666666667,0.0,1.0,150,4350,3100,1250,0.7126436781609196,56,31,25,222.6298335087257,0.46821215510812825,0.7268102485211425,0.1302502603565518,1050278.7447498203,12414.676416281334,1062693.4211661017,271,0,117.6,73,77,42,38.08828040583851,0.5523611111111111,43.79222972972974,8198.648648648672,112.31025546094071,0
273,32,3,0,153,0.0196078431372549,0.0,1.0,153,4650,3400,1250,0.7311827956989247,59,34,25,243.32076584500626,0.4692982456140351,0.7499029712955916,0.13835805241203847,1041475.2776876759,15432.512435121549,1056907.7901227975,272,0,116.27450980392157,67,86,41,38.66037476233364,0.5428921568627452,44.868259803921596,8164.215686274571,121.85396546678464,8
274,32,2,3,152,0.012903225806451613,0.01935483870967742,0.9806451612903225,155,3900,2700,1200,0.6923076923076923,51,27,24,243.46459170160279,0.4699884792626728,0.7520740906215493,0.13968701843228604,1044262.3080610835,15948.17929229298,1060210.4873533766,273,0,115.76129032258065,62,93,41,38.307256272517414,0.5448924731182796,44.5271164021164,8175.132275132268,131.8569721795527,0
275,32,2,0,154,0.012987012987012988,0.0,1.0,154,5450,4200,1250,0.7706422018348624,67,42,25,240.9361451866048,0.4703503876297994,0.7482425457735655,0.1392056120524196,1046424.0795529232,14174.276791584321,1060598.3563445075,274,0,115.95454545454545,64,90,45,38.10118749216695,0.5470102813852814,44.262820512820504,8183.589743589723,127.86858974358942,0
276,32,5,4,155,0.031446540880503145,0.025157232704402517,0.9748427672955975,159,4900,3200,1700,0.6530612244897959,66,32,34,241.34912984875888,0.47186065334500965,0.7547130325458276,0.13768656662718637,1042493.3596318247,13620.973044050173,1056114.332675875,275,0,113.27672955974843,64,95,40,38.5829984932195,0.5441561844863732,44.74358974358976,8168.205128205156,127.62820512820556,8
277,32,2,1,156,0.012738853503184714,0.006369426751592357,0.9936305732484076,157,5300,3800,1500,0.7169811320754716,68,38,30,234.7414098300325,0.47116575480428985,0.7453111779027086,0.13522427693025868,1045506.250000004,12384.72222222246,1057890.9722222264,276,0,115.3312101910828,69,88,40,38.3744227112198,0.547306263269639,44.375000000000014,8180.000000000031,118.55072463768161,0
278,32,3,4,155,0.018867924528301886,0.025157232704402517,0.9748427672955975,159,5600,4500,1100,0.8035714285714286,67,45,22,229.13597822738495,0.4714426929915347,0.74166918384315,0.13285501359614693,1047510.7571676485,10604.480409463913,1058115.2375771124,277,0,114.79245283018868,73,86,36,38.26716684087949,0.54979035639413,44.13006756756759,8187.837837837901,112.16216216216303,0
279,32,0,0,155,0.0,0.0,1.0,155,4500,3300,1200,0.7333333333333333,57,33,24,236.59303089830124,0.4702171484429549,0.7428371339782016,0.1372984754110622,1047779.7067901293,14079.475308642319,1061859.1820987717,278,2,118.56129032258065,71,84,37,38.0427408412483,0.5503360215053763,44.09722222222224,8188.888888888935,115.33646322378782,0
280,32,3,2,156,0.0189873417721519,0.012658227848101266,0.9873417721518988,158,5600,4200,1400,0.75,70,42,28,239.36203476205168,0.47020546104437094,0.7469418933735203,0.14282691142568466,1056288.580599171,13367.076789626968,1069655.657388798,279,0,117.29113924050633,73,85,37,36.910085556712104,0.5576213080168777,43.06024774774772,8222.072072072,112.6311242749589,8
281,32,0,1,155,0.0,0.00641025641025641,0.9935897435897436,156,3750,2600,1150,0.6933333333333334,49,26,23,239.05922074152392,0.4694944168734491,0.7430517387060014,0.14305413611316206,1057153.7516351077,15594.470413972933,1072748.2220490805,280,1,119.73076923076923,75,81,38,36.81014716860399,0.5591613247863247,42.95504385964909,8225.438596491143,109.67251461988191,0
282,32,1,1,155,0.00641025641025641,0.00641025641025641,0.9935897435897436,156,4850,3600,1250,0.7422680412371134,61,36,25,243.23014681129567,0.46933329886958924,0.747533595280691,0.14642454838039876,1058964.1317846347,15464.400248374073,1074428.5320330088,281,0,120.61538461538461,77,79,41,36.47758340254706,0.5610977564102564,42.735042735042704,8232.478632478555,106.9153069153059,0
283,32,1,3,153,0.00641025641025641,0.019230769230769232,0.9807692307692307,156,5050,3600,1450,0.7128712871287128,65,36,29,244.35270252338697,0.46861300661703886,0.7492031384087294,0.14797215994679033,1060743.945133149,15589.12993572083,1076333.0750688699,282,0,121.57051282051282,65,91,37,36.22732009317151,0.5631009615384616,42.51893939393939,8239.393939393933,126.75990675990666,0
284,32,3,1,155,0.019230769230769232,0.00641025641025641,0.9935897435897436,156,4950,3600,1350,0.7272727272727273,63,36,27,234.23417946889492,0.46937551695616214,0.7376250447777988,0.1429670351219235,1063108.2908163236,13653.259637188039,1076761.5504535115,283,0,118.12179487179488,69,87,42,36.19433860601164,0.5665064102564102,42.23214285714285,8248.571428571406,119.5445134575566,0
285,32,1,1,155,0.00641025641025641,0.00641025641025641,0.9935897435897436,156,5450,4000,1450,0.7339449541284404,69,40,29,238.07882253575835,0.4691713192721257,0.7500896855579118,0.14155745718824814,1055210.3061039916,13594.64544096699,1068804.9515449586,284,0,119.00641025641026,68,88,41,37.077356808339694,0.5577590811965811,43.19142512077294,8217.874396135254,120.85109406081256,8
286,32,2,0,157,0.012738853503184714,0.0,1.0,157,5300,3700,1600,0.6981132075471698,69,37,32,241.35729603580543,0.46898306930154066,0.7554390217947828,0.14500198214357915,1058350.3762913647,14388.117016032063,1072738.4933073968,285,0,119.22929936305732,71,86,37,36.60212868688005,0.5610403397027601,42.809606481481474,8230.092592592577,115.91679707876868,0
287,32,1,3,155,0.006329113924050633,0.0189873417721519,0.9810126582278481,158,4800,3200,1600,0.6666666666666666,64,32,32,242.6542818002611,0.46903806874680853,0.7595595229384651,0.14678038724281484,1060409.5804988628,15062.585034013344,1075472.165532876,286,0,119.46835443037975,62,96,37,36.3126204238921,0.5630274261603376,42.559523809523796,8238.095238095211,132.87250384024534,0
288,32,0,1,154,0.0,0.0064516129032258064,0.9935483870967742,155,4500,3100,1400,0.6888888888888889,59,31,28,242.84040283974818,0.46816610808546294,0.7558293212883662,0.147474758838904,1061597.5104437887,16059.75341796847,1077657.2638617572,287,1,122.25806451612904,63,92,38,36.16016892034205,0.5651209677419355,42.415364583333314,8242.708333333296,130.8366402116396,0
289,32,0,1,153,0.0,0.006493506493506494,0.9935064935064936,154,5350,3600,1750,0.6728971962616822,71,36,35,240.61143197443226,0.46749179469767704,0.7527797309919528,0.1470078278075459,1063410.4577580513,15023.742603550123,1078434.2003616015,288,2,123.74675324675324,64,90,36,35.99244213754378,0.566693722943723,42.19551282051281,8249.74358974357,128.90224358974328,0
290,32,1,1,153,0.006493506493506494,0.006493506493506494,0.9935064935064936,154,4150,2500,1650,0.6024096385542169,58,25,33,241.56211755135487,0.46713369691310863,0.7546311712978382,0.14875140922899202,1065752.5951557083,16539.09073433284,1082291.685890041,289,0,124.56493506493507,67,87,38,35.677330642608425,0.568655303030303,41.91176470588235,8258.823529411755,123.26602282704111,0
291,32,0,2,151,0.0,0.013071895424836602,0.9869281045751634,153,5050,3500,1550,0.693069306930693,66,35,31,256.8633196111385,0.46661076711386307,0.7605222081411098,0.15174312393739542,1053244.2379538028,18457.962264423164,1071702.200218226,290,1,126.2483660130719,61,92,36,36.84045740292055,0.5565767973856209,43.430779569892444,8210.215053763386,134.59368940595715,8
292,32,2,0,153,0.013071895424836602,0.0,1.0,153,4450,2800,1650,0.6292134831460674,61,28,33,248.62545452863725,0.4669207229675496,0.7530706964676857,0.14796584328742865,1055492.8048980883,17434.475673898443,1072927.2805719867,291,0,125.87581699346406,64,89,41,36.77128179530376,0.5587554466230937,43.15705128205126,8218.97435897432,128.42147435897374,0
293,32,0,2,151,0.0,0.013071895424836602,0.9869281045751634,153,5400,3700,1700,0.6851851851851852,71,37,34,240.92380160398827,0.46660718380919625,0.7444900624658564,0.1442228144721337,1057264.8108957666,14944.051508625853,1072208.8624043926,292,1,126.87581699346406,66,87,35,36.74839220192734,0.5606617647058824,42.9415422885572,8225.870646766143,124.63440373888096,0
294,32,0,0,151,0.0,0.0,1.0,151,5550,4300,1250,0.7747747747747747,68,43,25,268.5116588675609,0.46611111111111114,0.7734380075897678,0.15434621725373637,1044842.0193750216,20360.452775383914,1065202.4721504054,293,2,128.71523178807948,58,93,33,37.5945661185574,0.5429773730684326,44.45621468926554,8177.401129943516,140.98967465419855,8
295,32,1,1,151,0.006578947368421052,0.006578947368421052,0.993421052631579,152,4300,3200,1100,0.7441860465116279,54,32,22,264.9258893430706,0.4664644330196352,0.77031937107614,0.15323828796956335,1046771.0139900564,20763.348363972695,1067534.362354029,294,0,128.86184210526315,61,91,38,37.44416710457172,0.5449561403508771,44.22043010752688,8184.946236559137,134.17944650096945,0
296,32,3,3,151,0.01948051948051948,0.01948051948051948,0.9805194805194806,154,4400,3000,1400,0.6818181818181818,58,30,28,265.0145420635158,0.46705323543558835,0.773528719680725,0.15490521450290748,1049997.030138651,20452.89642204935,1070449.9265607002,295,0,127.77922077922078,67,87,36,37.0376253263968,0.5482954545454546,43.82659313725491,8197.54901960786,122.35147790459494,0
297,32,4,3,152,0.025806451612903226,0.01935483870967742,0.9806451612903225,155,4350,3100,1250,0.7126436781609196,56,31,25,255.96891531363994,0.4675464320625611,0.7680649526387016,0.1513288227334235,1053474.1512345644,18581.327160493613,1072055.478395058,296,0,127.01290322580645,59,96,38,36.834686513306266,0.5519489247311828,43.402777777777764,8211.111111111084,139.17137476459465,0
298,32,1,4,149,0.006535947712418301,0.026143790849673203,0.9738562091503268,153,4450,2900,1550,0.651685393258427,60,29,31,241.71381393349623,0.4675065932805871,0.7502484219954937,0.13629899694581413,1038862.4732300292,15171.482111362871,1054033.9553413922,297,0,129.26797385620915,62,91,38,39.0293459217442,0.5326116557734204,45.18849206349205,8153.968253968226,131.51561699948752,8
299,32,3,1,151,0.019736842105263157,0.006578947368421052,0.993421052631579,152,4750,3500,1250,0.7368421052631579,60,35,25,233.17066493293228,0.4677170471709074,0.7393797169577421,0.13262987339754237,1041577.2559171587,13423.052268244504,1055000.3081854032,298,0,129.0328947368421,64,88,41,38.90655423654295,0.5363212719298245,44.855769230769226,8164.615384615376,127.57211538461524,0
300,32,2,0,153,0.013071895424836602,0.0,1.0,153,5200,3700,1500,0.7115384615384616,67,37,30,231.47467517746526,0.46806917211328974,0.745413307508165,0.1269771353278211,1030172.1360948327,11891.752115885254,1042063.8882107179,299,0,129.16339869281046,63,90,42,40.38299123369681,0.5234885620915033,46.25651041666666,8119.791666666648,128.88558201058171,8
301,32,3,2,154,0.019230769230769232,0.01282051282051282,0.9871794871794872,156,4400,3200,1200,0.7272727272727273,56,32,24,211.2861037731583,0.4696434725668597,0.7264954643818742,0.11513397847318066,1028054.7511200198,7842.736565926518,1035897.4876859463,300,0,127.66025641025641,66,90,40,41.161678115799816,0.522636217948718,46.51741293532338,8111.442786069636,122.90064827378237,7
302,32,3,2,155,0.01910828025477707,0.012738853503184714,0.9872611464968153,157,4350,2600,1750,0.5977011494252874,61,26,35,207.48145916337475,0.4696550574337199,0.7240583094443533,0.11403680199129845,1030788.9660493826,7023.919753086451,1037812.885802469,301,0,127.77707006369427,68,89,40,40.91427268581853,0.5252786624203822,46.18055555555556,8122.222222222221,119.44444444444443,0
303,32,2,0,157,0.012738853503184714,0.0,1.0,157,5550,3800,1750,0.6846846846846847,73,38,35,203.06795735286943,0.4698694131417061,0.717453796086948,0.11235915145025484,1032905.2131558633,4999.9903549382,1037905.2035108015,302,0,128.2420382165605,71,86,45,40.760591048855495,0.5273354564755839,45.920138888888886,8130.555555555548,114.51486697965561,0
304,32,4,2,159,0.024844720496894408,0.012422360248447204,0.9875776397515528,161,5350,3700,1650,0.6915887850467289,70,37,33,222.11469165444566,0.47087538819875774,0.7441124684931468,0.1205367176049439,1026738.8916015624,8060.758463541699,1034799.6500651041,303,0,126.03105590062111,63,98,41,41.05307118992545,0.5226449275362319,46.6796875,8106.249999999999,128.6706349206349,8
305,32,4,2,161,0.024539877300613498,0.012269938650306749,0.9877300613496932,163,5500,4000,1500,0.7272727272727273,70,40,30,216.44203533433586,0.471848254184655,0.7382364074746701,0.11519390554533791,1020486.7483615433,6075.245769418434,1026561.9941309617,304,0,125.4478527607362,73,90,37,41.98594234806684,0.5157208588957055,47.45213963963966,8081.53153153158,110.70591139084357,8
306,32,11,4,168,0.06395348837209303,0.023255813953488372,0.9767441860465116,172,5300,3700,1600,0.6981132075471698,69,37,32,212.5467995706162,0.47542173829276035,0.7443198764176411,0.1156269798737471,1027520.1111111154,3979.222222222439,1031499.3333333379,305,0,119.08720930232558,74,98,39,41.197043187548005,0.521984011627907,46.58333333333335,8109.333333333368,109.58558558558605,0
307,32,2,2,168,0.011764705882352941,0.011764705882352941,0.9882352941176471,170,5050,3500,1550,0.693069306930693,66,35,31,213.56319229681847,0.4753785241907414,0.7435617753559824,0.11673736328118302,1029045.62281183,4903.253645352574,1033948.8764571826,306,0,120.7764705882353,75,95,40,40.979221837900155,0.5238970588235294,46.39528508771931,8115.350877193009,108.20467836257346,0
308,32,3,2,169,0.017543859649122806,0.011695906432748537,0.9883040935672515,171,6250,4400,1850,0.704,81,44,37,211.4459033497756,0.4757066276803119,0.7422770214314416,0.11675336978086145,1032251.8189342743,3203.083667801252,1035454.9026020755,307,0,118.76608187134502,80,91,35,40.62979933505476,0.5275950292397661,46.00051440329218,8127.9835390946455,101.59979423868307,0
309,32,5,9,165,0.028735632183908046,0.05172413793103448,0.9482758620689655,174,4900,3100,1800,0.6326530612244898,67,31,36,234.56738443783678,0.4767921013000243,0.7657934426720183,0.12995521910466012,1033312.1131295671,8776.263936947378,1042088.3770665145,308,0,116.25862068965517,84,90,34,39.90903939817717,0.5310704022988506,45.87009803921569,8132.156862745111,96.81139122315608,8
310,32,5,1,169,0.029411764705882353,0.0058823529411764705,0.9941176470588236,170,3950,2700,1250,0.6835443037974683,52,27,25,239.4364468196232,0.47588104768534634,0.7704291962249146,0.1343424854311299,1037297.9678638942,11723.387943709346,1049021.3558076036,309,0,119.8,68,102,36,39.28391438396774,0.5333946078431373,45.380434782608695,8147.826086956522,119.82097186700767,0
311,32,4,4,169,0.023121387283236993,0.023121387283236993,0.976878612716763,173,6100,4000,2100,0.6557377049180327,82,40,42,235.4463027040878,0.47686180938298156,0.7704578941403148,0.13341957153231665,1040400.000000002,8291.6666666668,1048691.6666666688,310,0,117.9306358381503,74,99,37,38.99611928104577,0.5366088631984586,45.00000000000001,8160.0000000000155,110.27027027027047,0
312,32,4,5,168,0.023121387283236993,0.028901734104046242,0.9710982658959537,173,5900,4300,1600,0.7288135593220338,75,43,32,233.6298271323467,0.47639551687054715,0.769623123102732,0.133335526606866,1042616.3306040226,8217.254616876002,1050833.5852208985,311,0,118.88439306358381,65,108,41,38.764632537817924,0.5388367052023122,44.728535353535364,8168.686868686889,125.67210567210599,0
313,32,1,1,168,0.005917159763313609,0.005917159763313609,0.9940828402366864,169,4850,3000,1850,0.6185567010309279,67,30,37,234.17091241137194,0.4758969662815817,0.7650919748337892,0.13420049739609213,1043905.978981736,10240.483113967839,1054146.462095704,312,0,119.16568047337279,65,104,41,38.58929601252263,0.5401873767258383,44.570707070707066,8173.737373737369,125.74980574980567,0
314,32,1,1,168,0.005917159763313609,0.005917159763313609,0.9940828402366864,169,6150,4500,1650,0.7317073170731707,78,45,33,231.28051828128017,0.4759263172724711,0.7621743654994038,0.13335122169065103,1045786.0572758092,8423.98826761708,1054210.0455434264,313,0,120.11834319526628,66,103,39,38.4278966999108,0.5421597633136095,44.340796019900495,8181.094527363178,123.95597768732088,0
315,32,1,0,169,0.005917159763313609,0.0,1.0,169,5250,3500,1750,0.6666666666666666,70,35,35,229.30869849724257,0.47609508547008544,0.7592753501000533,0.1329835774252976,1047576.6191893388,8993.68622448956,1056570.3054138282,314,0,121.01183431952663,69,100,36,38.254519240089145,0.5442554240631163,44.122023809523796,8188.095238095209,118.66804692891608,0
316,32,3,2,170,0.01744186046511628,0.011627906976744186,0.9883720930232558,172,5000,3500,1500,0.7,65,35,30,225.51531728782305,0.47638010562582167,0.7602266140045784,0.13180117432599484,1049959.5209984863,7956.390903469074,1057915.9119019555,315,0,119.88372093023256,76,96,39,38.054169307139844,0.546875,43.831168831168846,8197.402597402632,107.8605604921399,0
317,32,1,4,167,0.005847953216374269,0.023391812865497075,0.9766081871345029,171,5200,3600,1600,0.6923076923076923,68,36,32,222.96100366424918,0.47588435959178993,0.7569195978451895,0.13081238076255006,1051142.7405366735,7472.768084888915,1058615.5086215623,316,0,120.36842105263158,65,106,40,37.97208538587849,0.5484283625730995,43.686868686868664,8202.02020202015,126.18492618492539,0
318,32,0,1,166,0.0,0.005988023952095809,0.9940119760479041,167,6300,4300,2000,0.6825396825396826,83,43,40,225.86303073226156,0.47491462857417693,0.7552494959313509,0.13310208071349905,1052494.320339623,7843.91140407964,1060338.2317437024,317,1,123.2814371257485,63,104,43,37.72924863561364,0.5500873253493014,43.52213541666665,8207.291666666635,130.2744708994704,0
319,32,1,3,164,0.005988023952095809,0.017964071856287425,0.9820359281437125,167,5950,3800,2150,0.6386554621848739,81,38,43,225.02302833069132,0.47489358632133327,0.7556422735054233,0.13351366347621033,1054571.0059171612,8110.552268244672,1062681.5581854058,318,0,124.23952095808383,64,103,45,37.49219725343319,0.5522080838323353,43.269230769230774,8215.384615384626,128.36538461538478,0
320,32,5,1,168,0.029585798816568046,0.005917159763313609,0.9940828402366864,169,5250,3500,1750,0.6666666666666666,70,35,35,214.02207836188686,0.47560052127359814,0.7453758923326164,0.12862161343556516,1058449.0362811794,6256.292517006886,1064705.3287981863,319,0,122.66863905325444,69,100,44,37.29292023451365,0.555103550295858,42.79761904761905,8230.476190476193,119.28226363008974,0
321,32,1,0,169,0.005917159763313609,0.0,1.0,169,6650,4700,1950,0.706766917293233,86,47,39,216.34259633602144,0.47534370010331545,0.7457875738539843,0.13079078377664785,1060239.846318219,5425.008218277889,1065664.854536497,320,0,123.66272189349112,64,105,41,37.01103986386935,0.5570759368836291,42.58012820512823,8237.435897435957,128.70993589743682,0
322,32,1,2,168,0.0058823529411764705,0.011764705882352941,0.9882352941176471,170,5600,3900,1700,0.6964285714285714,73,39,34,232.80376587579184,0.47572441698572915,0.7719222233133658,0.13444799051253312,1046288.6367538598,9115.98696586945,1055404.6237197293,321,0,123.92941176470588,60,110,38,38.326099053978865,0.5349877450980391,44.279371584699454,8183.0601092896195,136.384335154827,8
323,32,3,2,169,0.017543859649122806,0.011695906432748537,0.9883040935672515,171,5300,3600,1700,0.6792452830188679,70,36,34,221.91783970123532,0.4761609907120743,0.7615184854792345,0.12937897769143158,1049201.8711419748,7067.322530864146,1056269.1936728389,322,0,124.08771929824562,65,106,42,38.24081920903954,0.53807261208577,43.92361111111111,8194.44444444444,126.068376068376,0
324,32,2,1,170,0.011695906432748537,0.005847953216374269,0.9941520467836258,171,4200,2600,1600,0.6190476190476191,58,26,32,221.6768367329135,0.4765479876160991,0.7618579741907845,0.1270561472088569,1043944.6807484565,7883.670910493811,1051828.3516589503,323,0,125.03508771929825,59,112,40,38.9035914950497,0.5300316764132553,44.56597222222222,8173.888888888887,138.54048964218453,8
325,32,0,2,168,0.0,0.011764705882352941,0.9882352941176471,170,5850,4300,1550,0.7350427350427351,74,43,31,222.16997049659784,0.4764821905093399,0.7603095254399779,0.12808322460172974,1045749.7165532863,6616.836734693791,1052366.5532879801,324,1,126.38823529411765,62,108,42,38.665357004268536,0.5325980392156863,44.34523809523809,8180.952380952367,131.95084485407043,0
326,32,3,7,164,0.017543859649122806,0.04093567251461988,0.9590643274853801,171,4800,3400,1400,0.7083333333333334,62,34,28,217.6460876797116,0.47692925123265684,0.7568133434394153,0.12616420094910194,1047440.2281193502,6594.253545704103,1054034.4816650543,325,0,126.17543859649123,66,105,38,38.56996009803324,0.5347831384015594,44.13868159203979,8187.5621890547,124.05397256143485,0
327,32,2,3,163,0.012048192771084338,0.018072289156626505,0.9819277108433735,166,5200,3900,1300,0.75,65,39,26,219.1950770877849,0.4768878544480954,0.7505147444733471,0.12754833315776623,1048616.1572472074,7570.29988465946,1056186.4571318668,326,0,127.39156626506023,67,99,41,38.383596617201235,0.5377761044176708,43.99509803921567,8192.156862745058,122.27099795141878,0
328,32,0,4,159,0.0,0.024539877300613498,0.9754601226993865,163,5750,4200,1550,0.7304347826086957,73,42,31,240.99970280161324,0.4768266050645055,0.7657372778159901,0.1361457314862047,1039436.0442810857,11750.755550605396,1051186.7998316912,327,1,126.76687116564418,66,97,37,38.9755144158432,0.5320807770961145,45.11815920398011,8156.218905472665,123.57907432534341,8
329,32,0,0,159,0.0,0.0,1.0,159,5600,4000,1600,0.7142857142857143,72,40,32,249.24886913580292,0.4760667940450601,0.7648648497554165,0.1403428317206095,1038405.3048204139,14364.269586221293,1052769.5744066352,328,3,129.60377358490567,68,91,39,38.89481481481481,0.532625786163522,45.2445652173913,8152.1739130434635,119.88491048593329,8
330,32,3,0,162,0.018518518518518517,0.0,1.0,162,5650,4400,1250,0.7787610619469026,69,44,25,232.7484024891462,0.4767360312348235,0.751691663546364,0.1300728767186311,1036051.5229632187,10177.867373227238,1046229.390336446,329,0,128.1851851851852,65,97,38,39.610791519361605,0.5326003086419753,45.5334595959596,8142.929292929298,125.27583527583535,8
331,32,6,2,166,0.03571428571428571,0.011904761904761904,0.9880952380952381,168,4550,3200,1350,0.7032967032967034,59,32,27,216.96865026268904,0.477873122802015,0.7417445108048186,0.12257882528257441,1039458.3212858123,6955.97379474059,1046414.2950805529,330,0,124.57142857142857,73,95,35,39.58523177040186,0.5358382936507937,45.115427927927925,8156.306306306302,111.73022337405892,0
332,32,1,3,164,0.005988023952095809,0.017964071856287425,0.9820359281437125,167,5050,3300,1750,0.6534653465346535,68,33,35,229.99000517818106,0.4774021234639156,0.7621174793936589,0.12982230813057144,1039186.0685941069,9350.48185941059,1048536.5504535176,331,0,126.31137724550898,69,98,38,39.28748686208107,0.5344935129740519,45.14880952380953,8155.238095238115,118.19185645272631,8
333,32,4,0,168,0.023809523809523808,0.0,1.0,168,4950,3600,1350,0.7272727272727273,63,36,27,227.55035638574776,0.4782911854861705,0.762528708720762,0.1298835539370196,1042658.6015184093,8901.467272835904,1051560.0687912453,332,0,124.54166666666667,60,108,41,38.914531629763424,0.5373883928571428,44.72336065573771,8168.852459016396,136.1475409836066,0
334,32,3,1,170,0.017543859649122806,0.005847953216374269,0.9941520467836258,171,5150,3700,1450,0.7184466019417476,66,37,29,217.1575183502708,0.4786005045292971,0.7552782631796242,0.125034173609131,1045355.8877595147,6051.378075740063,1051407.2658352547,333,0,123.3391812865497,67,104,44,38.84269247672701,0.5400828460038987,44.393382352941174,8179.411764705876,122.08077260755039,0
335,32,5,3,172,0.02857142857142857,0.017142857142857144,0.9828571428571429,175,6000,4400,1600,0.7333333333333333,76,44,32,204.40226919596128,0.4790503557744937,0.7455821516948806,0.1188696918877061,1048433.0138838211,1860.4174275629748,1050293.431311384,334,0,121.44571428571429,73,102,41,38.7851136467785,0.5433333333333333,44.01745495495497,8191.4414414414805,112.21152659508877,0
336,32,1,1,172,0.005780346820809248,0.005780346820809248,0.9942196531791907,173,5350,3700,1650,0.6915887850467289,70,37,33,212.62415787763646,0.47876478693372765,0.7539283124344334,0.12139390376741264,1042735.6377317378,4392.157372342171,1047127.79510408,335,0,122.52023121387283,66,107,38,39.28593179049939,0.5404022157996147,44.7139303482587,8169.15422885571,123.77506407357137,8
337,32,3,1,174,0.017142857142857144,0.005714285714285714,0.9942857142857143,175,5600,3800,1800,0.6785714285714286,74,38,36,214.5108944688522,0.4786945812807882,0.7598307691028929,0.12400937582361811,1046602.0727040825,4301.509353741517,1050903.582057824,336,0,122.06857142857143,69,106,35,38.75476377494616,0.5431547619047619,44.24107142857143,8184.285714285721,118.6128364389235,0
338,32,4,4,174,0.02247191011235955,0.02247191011235955,0.9775280898876404,178,5900,4300,1600,0.7288135593220338,75,43,32,219.52590148001104,0.4791699729152119,0.7649337190158532,0.12410820766840254,1039671.5561224517,4146.967120181584,1043818.5232426332,337,0,120.95505617977528,76,102,37,39.493335279237215,0.5371605805243446,45.08928571428572,8157.142857142879,107.33082706766946,8
339,32,3,2,175,0.01694915254237288,0.011299435028248588,0.9887005649717514,177,4950,3500,1450,0.7070707070707071,64,35,29,222.71591701394573,0.47975785396336246,0.7688343702675997,0.12710367193089944,1042608.6336043675,6091.107583970763,1048699.7411883383,338,0,119.73446327683615,66,111,40,39.04419676391175,0.5397245762711864,44.729477611940304,8168.6567164179205,123.76752600633213,0
340,32,3,0,178,0.016853932584269662,0.0,1.0,178,4900,3400,1500,0.6938775510204082,64,34,30,216.93373929219896,0.47958986648045876,0.7640760185139754,0.12481865903998414,1045141.1033163292,4845.273526077289,1049986.3768424066,339,0,119.98314606741573,69,109,40,38.8752426006793,0.5420177902621723,44.41964285714287,8178.571428571449,118.53002070393404,0
341,32,1,1,178,0.00558659217877095,0.00558659217877095,0.994413407821229,179,5800,4100,1700,0.7068965517241379,75,41,34,213.00514113315006,0.4795629067018183,0.7608711032156024,0.1232048129981193,1046767.2464346039,2993.361012072403,1049760.6074466764,340,0,120.3072625698324,72,107,40,38.7726638772664,0.5438198324022346,44.22089041095891,8184.9315068493215,113.67960426179613,0
342,32,0,0,178,0.0,0.0,1.0,178,5750,4200,1550,0.7304347826086957,73,42,31,212.12791661070727,0.4791779079117205,0.7582382726310832,0.12328823704332537,1048247.6544001184,3122.518203991766,1051370.17260411,341,1,121.73595505617978,78,100,37,38.610460024727004,0.5461727528089888,44.04008438818567,8190.717299578095,105.00919614843711,0
343,32,0,4,174,0.0,0.02247191011235955,0.9775280898876404,178,5250,3800,1450,0.7238095238095238,67,38,29,226.02795578596823,0.47895572800947966,0.7731462931506379,0.12894603437531954,1042493.359631827,6276.528599605896,1048769.888231433,342,2,122.73595505617978,64,114,42,38.97408128243765,0.5389161985018727,44.743589743589766,8168.205128205175,127.62820512820586,7
344,32,3,2,175,0.01694915254237288,0.011299435028248588,0.9887005649717514,177,6150,4300,1850,0.6991869918699187,80,43,37,218.80221878595566,0.4786263054271529,0.7644021757002948,0.1261416818370042,1045749.71655329,4212.471655328925,1049962.188208619,343,0,122.44067796610169,69,108,45,38.75145518044239,0.5421374764595104,44.3452380952381,8180.952380952397,118.56452726017967,0
345,32,4,9,170,0.0223463687150838,0.05027932960893855,0.9497206703910615,179,5750,4100,1650,0.7130434782608696,74,41,33,214.56647429459287,0.47870504048710066,0.7627584764831281,0.12497734450618739,1048917.361111114,3462.5000000002165,1052379.8611111143,344,0,120.56424581005587,74,105,38,38.46453756441553,0.5448091247672253,43.95833333333334,8193.333333333358,110.72072072072105,0
346,32,2,1,171,0.011627906976744186,0.005813953488372093,0.9941860465116279,172,6250,4400,1850,0.704,81,44,37,218.12413246083642,0.47811763339226615,0.7593590470788429,0.12775842044134733,1050625.000000002,5183.333333333452,1055808.3333333356,345,0,122.51744186046511,73,99,41,38.160569105691074,0.5482679263565892,43.75000000000001,8200.000000000016,112.32876712328789,0
347,32,0,2,169,0.0,0.011695906432748537,0.9883040935672515,171,6250,4700,1550,0.752,78,47,31,214.92733768067876,0.4779254099300539,0.7536509375056517,0.12646438031992246,1052027.8311489795,4771.908182965681,1056799.739331945,346,1,123.81871345029239,66,105,39,38.067791386244664,0.5499512670565302,43.57898009950248,8205.472636815904,124.32534298205915,0
348,32,2,3,168,0.011695906432748537,0.017543859649122806,0.9824561403508771,171,5100,3200,1900,0.6274509803921569,70,32,38,212.58698908949674,0.4777749111340443,0.7498842786874418,0.12576544174436918,1053677.80966553,5499.638605442067,1059177.4482709721,347,0,124.38011695906432,69,102,40,37.92252585290423,0.5517787524366471,43.37797619047618,8211.90476190474,119.01311249137304,0
349,32,3,3,168,0.017543859649122806,0.017543859649122806,0.9824561403508771,171,5700,3700,2000,0.6491228070175439,77,37,40,207.57248839663902,0.4777548446279096,0.7439314980036924,0.12374619473818184,1056014.313713226,3939.9037759847124,1059954.2174892107,348,0,124.74853801169591,72,99,34,37.76093738428495,0.5546418128654971,43.093607305936075,8221.004566210051,114.1806189751396,0
350,32,0,1,167,0.0,0.005952380952380952,0.9940476190476191,168,5600,4300,1300,0.7678571428571429,69,43,26,210.84276327867101,0.47745134730538924,0.743732002003255,0.12595371356071425,1056635.8250142059,5356.803425046814,1061992.6284392527,349,1,126.69642857142857,73,95,34,37.59973889862694,0.5560515873015873,43.018018018018026,8223.423423423443,112.64963593730744,0
351,32,1,6,162,0.005952380952380952,0.03571428571428571,0.9642857142857143,168,4750,3600,1150,0.7578947368421053,59,36,23,212.35793095454449,0.4774624857428001,0.746140458260689,0.1274213761461431,1057974.8823188264,6583.871402220454,1064558.753721047,350,0,127.57142857142857,77,91,38,37.39456201852332,0.5579737103174602,42.855235042735025,8228.63247863243,106.86535686535623,0
352,32,0,1,161,0.0,0.006172839506172839,0.9938271604938271,162,4950,2900,2050,0.5858585858585859,70,29,41,217.67792763330968,0.4766266007208036,0.7429716288463684,0.13089898732891553,1058634.3305984696,8738.265441230058,1067372.5960396996,351,1,130.7037037037037,77,85,42,37.175888669677946,0.5596707818930041,42.77510683760683,8231.196581196553,106.89865689865653,0
353,32,0,1,160,0.0,0.006211180124223602,0.9937888198757764,161,5600,3900,1700,0.6964285714285714,73,39,34,219.15167836537168,0.47629076086956523,0.7430805310208661,0.1322104000386774,1059605.8593866674,8642.880498074155,1068248.7398847416,352,2,131.63975155279502,60,101,44,37.017391063923895,0.5608825051759834,42.65710382513662,8234.972677595653,137.24954462659423,0
354,32,1,1,160,0.006211180124223602,0.006211180124223602,0.9937888198757764,161,5300,4000,1300,0.7547169811320755,66,40,26,216.8250428306346,0.47605460662525884,0.7392703157832918,0.13171752601888242,1061692.4556213045,8540.302432610339,1070232.7580539149,353,0,132.40993788819875,64,97,45,36.81851644477627,0.562888198757764,42.40384615384617,8243.076923076946,128.79807692307728,0
355,32,1,0,161,0.006211180124223602,0.0,1.0,161,4100,3200,900,0.7804878048780488,50,32,18,215.18699532180716,0.4758168348861284,0.7372129043280438,0.1312498163519107,1062899.4486522651,9444.427736937478,1072343.8763892027,354,0,133.25465838509317,66,95,46,36.71117846945753,0.5643762939958592,42.25746268656718,8247.761194029883,124.96607869742247,0
356,32,0,2,159,0.0,0.012422360248447204,0.9875776397515528,161,4250,3000,1250,0.7058823529411765,55,30,25,209.20409698114108,0.47566802536231884,0.7313372117757171,0.12217519263698626,1049726.0695598635,7471.398891966724,1057197.4684518303,355,1,134.25465838509317,75,86,41,38.50108804223746,0.5478131469979296,43.859649122807014,8196.491228070166,109.28654970760222,8
357,32,2,0,161,0.012422360248447204,0.0,1.0,161,5100,3500,1600,0.6862745098039216,67,35,32,195.9261834995323,0.47585888975155277,0.7146357395690599,0.11420458568387246,1049144.9660493862,3810.9938271606734,1052955.9598765469,356,0,134.64596273291926,74,87,42,38.91348465947098,0.5437370600414079,43.930555555555564,8194.222222222248,110.73273273273308,8
358,32,2,0,163,0.012269938650306749,0.0,1.0,163,4600,2800,1800,0.6086956521739131,64,28,36,188.8553162394149,0.47606762351990706,0.7072872115751601,0.11091996439163977,1051467.3049053263,2515.038076659895,1053982.3429819862,357,0,133.98159509202455,70,93,44,38.80594345561721,0.546140081799591,43.64730046948355,8203.286384976482,117.18980549966402,0
359,32,1,0,164,0.006097560975609756,0.0,1.0,164,6650,5200,1450,0.7819548872180451,81,52,29,199.81340752588272,0.4760017644271535,0.7262262934508124,0.11356112837493942,1041317.3073686168,2163.8319002001963,1043481.139268817,358,0,134.15853658536585,75,89,42,39.79012204731456,0.537792174796748,44.887609649122815,8163.596491228097,108.84795321637462,8
360,32,2,2,164,0.012048192771084338,0.012048192771084338,0.9879518072289156,166,5050,3500,1550,0.693069306930693,66,35,31,202.2682053889026,0.47621090422295237,0.7259511013151954,0.11740979389679322,1047859.8030869121,4139.74437391185,1051999.547460824,359,0,133.53012048192772,70,96,39,38.91114391637525,0.5460592369477912,44.087441314554,8189.2018779342925,116.98859825620418,8
361,32,1,0,165,0.006060606060606061,0.0,1.0,165,6150,4400,1750,0.7154471544715447,79,44,35,222.57517149711782,0.4754311406750431,0.7554379847291519,0.12545214596786092,1038725.6741697959,7088.909013360544,1045814.5831831564,360,0,135.3030303030303,67,98,40,39.53417152648355,0.5324494949494949,45.20526960784316,8153.431372549063,121.69300556043378,8
362,32,3,3,165,0.017857142857142856,0.017857142857142856,0.9821428571428571,168,4850,3400,1450,0.7010309278350515,63,34,29,215.3365400119038,0.4763657209390742,0.7518849692416563,0.12242392149423388,1041420.2500000099,6401.166666667263,1047821.4166666771,361,0,133.86904761904762,74,94,45,39.381226522946314,0.5354662698412698,44.875000000000036,8164.000000000078,110.32432432432537,0
363,32,5,1,169,0.029411764705882353,0.0058823529411764705,0.9941176470588236,170,5000,3600,1400,0.72,64,36,28,212.95345167063826,0.4771362687086669,0.7519385977590312,0.12298499191703048,1046290.8548192894,5562.249797037839,1051853.1046163272,362,0,133.01764705882354,62,108,47,38.833435708435715,0.5392156862745099,44.27910052910051,8183.068783068747,131.98498037207656,0
364,32,2,2,169,0.011695906432748537,0.011695906432748537,0.9883040935672515,171,5650,4000,1650,0.7079646017699115,73,40,33,209.20663489608037,0.47756134617589724,0.7490182372029868,0.12162351825314452,1048331.4769436358,4013.580109402984,1052345.0570530389,363,0,132.9298245614035,66,105,41,38.67478539034663,0.5416057504873295,44.02985074626864,8191.04477611937,124.10673903211166,0
365,32,1,0,170,0.0058823529411764705,0.0,1.0,170,4700,2900,1800,0.6170212765957447,65,29,36,207.9659371395017,0.4774618575240747,0.745916114790288,0.12151818200676728,1049892.9846938716,4968.395691609621,1054861.3803854813,364,0,134.35294117647058,69,101,45,38.51201541381046,0.5435661764705882,43.839285714285694,8197.14285714281,118.79917184264941,0
366,32,2,3,169,0.011627906976744186,0.01744186046511628,0.9825581395348837,172,5150,3500,1650,0.6796116504854369,68,35,33,204.5482509752207,0.4773781393082189,0.7456472464549622,0.12061947267820392,1052692.5484521354,3515.2839201065144,1056207.832372242,365,0,133.77906976744185,61,111,46,38.25127999388657,0.5460876937984496,43.49798387096775,8208.06451612905,134.55843469064018,0
367,32,4,0,173,0.023121387283236993,0.0,1.0,173,4800,3000,1800,0.625,66,30,36,198.7705353490153,0.47638011381458084,0.7394737945060774,0.11831717967336808,1055548.6844454666,2562.395418834937,1058111.0798643015,366,0,131.8612716763006,65,108,52,38.044836344271054,0.5491329479768786,43.15025252525253,8219.191919191935,126.4491064491067,0
368,32,2,3,172,0.011428571428571429,0.017142857142857144,0.9828571428571429,175,4700,3400,1300,0.723404255319149,60,34,26,194.6903442017032,0.4767104542966612,0.7368945478185722,0.11674293884094786,1057774.6795573463,1487.7032901730672,1059262.3828475194,367,0,131.34285714285716,72,103,41,37.87367963445988,0.55125,42.87956621004565,8227.85388127852,114.27574835109054,0
369,32,3,1,174,0.017142857142857144,0.005714285714285714,0.9942857142857143,175,6350,5100,1250,0.8031496062992126,76,51,25,218.37184156711194,0.47714833059660644,0.7633202390515619,0.12509421281701177,1043776.9782739036,4236.300186205639,1048013.2784601093,368,0,132.30857142857144,65,110,36,39.00897804280212,0.539047619047619,44.58648989898991,8173.232323232346,125.7420357420361,8
370,32,4,4,174,0.02247191011235955,0.02247191011235955,0.9775280898876404,178,5450,3800,1650,0.6972477064220184,71,38,33,210.82041489351397,0.4775915698597093,0.758635642981131,0.12217227016938315,1047351.2984508282,3110.607055732978,1050461.905506561,369,0,131.03932584269663,72,106,34,38.755693437441934,0.5420177902621723,44.149543378995446,8187.214611872174,113.7113140537802,0
371,32,2,1,175,0.011363636363636364,0.005681818181818182,0.9943181818181818,176,5200,3800,1400,0.7307692307692307,66,38,28,210.51058801344007,0.4772477002164502,0.7569737764109339,0.12266870883553038,1049052.1242113004,3767.315904894052,1052819.4401161945,370,0,133.35227272727272,75,101,39,38.55159154979837,0.5440932765151515,43.941885964912295,8193.859649122844,109.25146198830458,0
372,32,4,4,175,0.0223463687150838,0.0223463687150838,0.9776536312849162,179,6200,4700,1500,0.7580645161290323,77,47,30,221.96782165162097,0.4768389199255121,0.7674199821698302,0.13099976985458023,1052944.7314342381,4743.969671201699,1057688.7011054398,371,0,131.62011173184356,69,110,37,37.77306059902934,0.5515013966480447,43.4672619047619,8209.047619047602,118.9717046238783,8
373,32,2,1,176,0.011299435028248588,0.005649717514124294,0.9943502824858758,177,6400,4500,1900,0.703125,83,45,38,223.7726165443372,0.4765584874165383,0.7662111880321487,0.13301955605030036,1055137.9377786308,5422.195430383839,1060560.1332090145,372,0,132.45762711864407,71,106,42,37.453755868544604,0.5540254237288136,43.20023148148147,8217.592592592559,115.74074074074026,0
374,32,2,5,173,0.011235955056179775,0.028089887640449437,0.9719101123595506,178,5850,4100,1750,0.7008547008547008,76,41,35,215.48088888888992,0.4765395215726105,0.7576359550561811,0.1287529211812193,1056702.843663428,4089.8536088022906,1060792.6972722302,373,0,132.68539325842696,75,103,37,37.472222222222186,0.5562382958801498,43.00986842105261,8223.68421052626,109.64912280701681,0
375,32,1,2,172,0.005747126436781609,0.011494252873563218,0.9885057471264368,174,6550,5000,1550,0.7633587786259542,81,50,31,195.6516130672823,0.47570413372311915,0.7259967255561071,0.11642949291718353,1055467.414336062,-49.21956903904447,1055418.194767023,374,0,136.07471264367817,82,92,47,38.135027282351984,0.5551364942528736,43.160140562249005,8218.875502008055,100.23018904887873,7
376,32,3,6,169,0.017142857142857144,0.03428571428571429,0.9657142857142857,175,6200,4800,1400,0.7741935483870968,76,48,28,189.90622538894218,0.47603037766830875,0.7192314601060483,0.11381123019192697,1057607.34804612,-1030.756117790569,1056576.5919283296,375,0,135.33142857142857,86,89,38,38.01741334078457,0.5577380952380953,42.89990421455938,8227.20306513407,95.66515192016361,0
377,32,1,1,169,0.0058823529411764705,0.0058823529411764705,0.9941176470588236,170,4850,3200,1650,0.6597938144329897,65,32,33,189.99367997253583,0.4750565610859729,0.7118320736115686,0.11412372052041547,1058297.0009248215,1363.9483419208532,1059660.9492667422,376,0,137.3764705882353,86,84,39,37.92976024208566,0.5593137254901961,42.81609195402298,8229.885057471236,95.69633787757252,0
378,32,3,3,169,0.01744186046511628,0.01744186046511628,0.9825581395348837,172,5100,4000,1100,0.7843137254901961,62,40,22,184.0891673616955,0.4748727843510585,0.7080227549796365,0.11168545469190423,1061301.3366503615,-425.1841232361612,1060876.1525271253,377,0,136.7325581395349,76,96,41,37.71010610358231,0.562015503875969,42.4512987012987,8241.558441558433,108.44155844155833,0
379,32,2,2,169,0.011695906432748537,0.011695906432748537,0.9883040935672515,171,4400,2800,1600,0.6363636363636364,60,28,32,182.11701942977805,0.4745499369338379,0.706890610377302,0.10784629702466116,1053979.4665429266,-210.4802026032021,1053768.9863403235,378,0,138.3859649122807,78,93,45,38.66705197362788,0.556712962962963,43.34124472573838,8213.080168776321,105.29589959969643,8
380,32,0,0,169,0.0,0.0,1.0,169,6200,4000,2200,0.6451612903225806,84,40,44,184.61848065043543,0.4736237320371936,0.7067025154731852,0.11003653210120048,1055944.2156826223,-1010.6366498119373,1054933.5790328104,379,1,140.9526627218935,81,88,40,38.35932477871731,0.5586785009861933,43.10213414634144,8220.731707317016,101.49051490514834,0
381,32,2,1,170,0.011695906432748537,0.005847953216374269,0.9941520467836258,171,4600,3200,1400,0.6956521739130435,60,32,28,180.81141760974063,0.4736283109735122,0.7052739874377321,0.10848685056584337,1057959.1836734586,-541.7800453520281,1057417.4036281067,380,0,140.29239766081872,83,88,45,38.20770640432099,0.5607943469785575,42.857142857142826,8228.571428571344,99.13941480206438,0
382,32,0,0,170,0.0,0.0,1.0,170,5150,3000,2150,0.5825242718446602,73,30,43,183.40399391151357,0.4732147000812159,0.7084971730907752,0.11041495234150366,1058979.837884215,-305.77365205406977,1058674.0642321608,381,1,142.04705882352943,83,87,46,38.01475786496991,0.5621323529411765,42.73313492063488,8232.539682539582,99.18722509083834,0
383,32,1,0,171,0.005847953216374269,0.0,1.0,171,5700,4400,1300,0.7719298245614035,70,44,26,182.54486746757772,0.4731882811604174,0.7076434255036508,0.11063396677357532,1060990.3528008563,-1164.331332718005,1059826.0214681383,382,0,142.21052631578948,75,96,45,37.78830459158327,0.5639010721247564,42.48903508771928,8240.35087719294,109.8713450292392,0
384,32,2,3,170,0.011560693641618497,0.017341040462427744,0.9826589595375722,173,4200,2700,1500,0.6428571428571429,57,27,30,179.09288608217375,0.4731818792848501,0.7056016299264736,0.10902907102236219,1062334.6619131512,-748.6838825688783,1061585.9780305822,383,0,141.5549132947977,78,95,47,37.71119042745543,0.5655105973025047,42.3259493670886,8245.569620253134,105.71243102888634,0
385,32,0,0,170,0.0,0.0,1.0,170,5900,4400,1500,0.7457627118644068,74,44,30,218.69636511944185,0.47272087829214526,0.7550278942662478,0.12753192527751803,1049276.748614965,5994.602185288082,1055271.350800253,384,1,144.8470588235294,75,95,39,38.31397630771428,0.5500612745098039,43.91447368421055,8194.736842105314,109.26315789473752,8
386,32,3,3,170,0.017341040462427744,0.017341040462427744,0.9826589595375722,173,6350,4800,1550,0.7559055118110236,79,48,31,219.8041442893425,0.47336251512300037,0.7609912661705298,0.12961745112447032,1052696.7273747597,5327.420671360211,1058024.1480461198,385,0,143.31791907514452,65,108,40,37.859442940356054,0.5532875722543353,43.497474747474755,8208.080808080826,126.27816627816655,0
387,32,2,0,172,0.011627906976744186,0.0,1.0,172,5550,3600,1950,0.6486486486486487,75,36,39,215.61214693877503,0.47343346253229973,0.7541295681063116,0.12799228532661372,1054719.3568295564,5532.060988781046,1060251.4178183374,386,0,143.4593023255814,70,102,43,37.71535714285714,0.5557170542635659,43.2511737089202,8215.96244131458,117.3708920187797,0
388,32,5,5,172,0.02824858757062147,0.02824858757062147,0.9717514124293786,177,4750,3400,1350,0.7157894736842105,61,34,27,206.2050825383502,0.4736172637390858,0.7497035152917435,0.12354976794104465,1057535.364275144,3463.8334155158527,1060999.19769066,387,0,140.37853107344634,77,100,39,37.607299620798926,0.5584392655367232,42.90865384615383,8226.923076923045,106.84315684315644,0
389,32,1,1,172,0.005780346820809248,0.005780346820809248,0.9942196531791907,173,5700,4300,1400,0.7543859649122807,71,43,28,215.30680152817044,0.47308666039342206,0.7570364415204323,0.12961705620333888,1058969.6289062477,5300.672743055444,1064270.3016493032,388,0,142.76300578034682,79,94,41,37.19527111381045,0.5602119460500963,42.73437499999999,8232.499999999982,104.20886075949345,0
390,32,5,1,176,0.02824858757062147,0.005649717514124294,0.9943502824858758,177,5700,4000,1700,0.7017543859649122,74,40,34,206.86063947061993,0.4735503873480568,0.7529967689250747,0.1260830670694277,1062689.9562476575,2865.7447816791505,1065555.7010293368,389,0,140.0677966101695,70,107,44,36.95171069110784,0.563382768361582,42.282863849765256,8246.948356807507,117.81354795439294,0
391,32,1,1,176,0.005649717514124294,0.005649717514124294,0.9943502824858758,177,4900,2800,2100,0.5714285714285714,70,28,42,205.5663285146448,0.47370019046396167,0.7503171691173114,0.12598570034709455,1064336.1111111138,3458.333333333443,1067794.4444444473,390,0,140.99435028248587,74,103,43,36.78143511039311,0.5650894538606404,42.08333333333334,8253.333333333356,111.53153153153184,0
392,32,0,5,171,0.0,0.028409090909090908,0.9715909090909091,176,6150,4400,1750,0.7154471544715447,79,44,35,216.3797571269866,0.47344291125541127,0.7590044975359616,0.12631954143805096,1049613.730306444,4073.0328081719144,1053686.7631146158,391,1,142.64772727272728,75,101,38,38.3312931449671,0.5493607954545454,43.873355263157904,8196.052631578976,109.28070175438634,8
393,32,3,2,172,0.017241379310344827,0.011494252873563218,0.9885057471264368,174,5000,3700,1300,0.74,63,37,26,237.59199811499087,0.47400158904170264,0.7732261826487434,0.13543002989608038,1042233.6196899412,9725.273640950527,1051958.8933308916,392,0,144.00574712643677,63,111,37,38.71145813404758,0.5434027777777778,44.775390625,8167.187499999998,129.6378968253968,8
394,32,6,3,175,0.033707865168539325,0.016853932584269662,0.9831460674157303,178,5650,3800,1850,0.672566371681416,75,38,37,224.38385172611578,0.47489367104678476,0.7658209579329804,0.13004420040716966,1047379.2712259481,5752.999019154051,1053132.2702451022,393,0,141.24719101123594,70,108,38,38.40517900491237,0.5474016853932584,44.146126760563384,8187.323943661979,116.96177062374255,0
395,32,1,1,175,0.005681818181818182,0.005681818181818182,0.9943181818181818,176,5600,3700,1900,0.6607142857142857,75,37,38,254.09401197751993,0.4743560606060606,0.7851656469959329,0.14430088509521,1041080.1111111019,12106.444444443969,1053186.555555546,394,0,143.77272727272728,74,102,30,38.43515191114011,0.5404829545454546,44.916666666666636,8162.666666666593,110.30630630630532,8
396,32,3,3,175,0.016853932584269662,0.016853932584269662,0.9831460674157303,178,5000,3800,1200,0.76,62,38,24,231.94853113898623,0.47507815971560974,0.7751807164314719,0.13221232308230152,1042231.5746219623,7748.816568047525,1049980.39119001,395,0,142.75280898876406,64,114,38,38.855749508141834,0.5452364232209738,44.775641025641036,8167.179487179512,127.61217948717987,8
397,32,2,0,177,0.011299435028248588,0.0,1.0,177,5450,3800,1650,0.6972477064220184,71,38,33,240.87357359498958,0.4753025487930149,0.7817951573755921,0.13892074078333352,1045871.4604591809,9534.559240362629,1055406.0196995435,396,0,143.88135593220338,69,108,39,38.17195108938168,0.5477871939736347,44.33035714285713,8181.42857142855,118.57142857142826,0
398,32,2,3,176,0.0111731843575419,0.01675977653631285,0.9832402234636871,179,4550,3400,1150,0.7472527472527473,57,34,23,237.59229663867163,0.47557565961542486,0.7833060817857467,0.1382981149552431,1048715.2326917916,9483.332131040372,1058198.564822832,397,0,143.26256983240222,75,104,41,37.90023778931778,0.550046554934823,43.98300438596492,8192.543859649139,109.23391812865518,0
399,32,2,1,177,0.011235955056179775,0.0056179775280898875,0.9943820224719101,178,5400,3500,1900,0.6481481481481481,73,35,38,236.01241280210334,0.47562104572673986,0.7796307099195985,0.13866511786648797,1051574.2884087807,8636.917009602344,1060211.205418383,398,0,143.19662921348313,62,116,39,37.58370955605721,0.5522003745318351,43.63425925925927,8203.703703703715,132.31780167264057,0
400,32,4,1,180,0.022099447513812154,0.0055248618784530384,0.994475138121547,181,5950,4500,1450,0.7563025210084033,74,45,29,228.8195054214415,0.4754361059954983,0.7767149185558606,0.13621886162492608,1055582.525263128,6157.5742724448555,1061740.099535573,399,0,141.77348066298342,68,113,44,37.268817836291674,0.5551910681399632,43.146135265700465,8219.323671497545,120.87240693378742,0
401,32,0,0,180,0.0,0.0,1.0,180,5250,2900,2350,0.5523809523809524,76,29,47,228.11683783597098,0.47535110180012413,0.7753371362806187,0.13634816646427222,1056803.0371227663,6964.913408778873,1063767.950531545,400,1,141.50555555555556,71,109,38,37.13502964797719,0.5566550925925926,42.99768518518517,8224.074074074037,115.83202921231037,0
402,32,0,1,179,0.0,0.005555555555555556,0.9944444444444445,180,5350,3500,1850,0.6542056074766355,72,35,37,226.3073735128684,0.475102808814401,0.7735586885731223,0.1355436715827065,1057422.489105725,6510.501240590984,1063932.990346316,401,2,142.50555555555556,72,108,40,37.104518206039046,0.5579282407407408,42.92237442922372,8226.484018264788,114.25672247589983,0
403,32,0,1,178,0.0,0.00558659217877095,0.994413407821229,179,5850,3800,2050,0.6495726495726496,79,38,41,227.3909880409281,0.47472171656937207,0.7739083934081106,0.13631677365976863,1057697.9753086395,6452.197530864005,1064150.1728395035,402,3,144.23463687150837,74,105,40,37.04241392970323,0.5590083798882681,42.88888888888888,8227.555555555535,111.1831831831829,0
404,32,2,1,179,0.011111111111111112,0.005555555555555556,0.9944444444444445,180,4700,3300,1400,0.7021276595744681,61,33,28,225.97781455733775,0.4745848851644941,0.7728668308526956,0.13638405132163486,1059728.6303924867,7195.031983986952,1066923.6623764737,403,0,144.20555555555555,62,118,41,36.8264803512153,0.5611111111111111,42.642195767195766,8235.449735449738,132.8298344427377,0
405,32,0,1,178,0.0,0.00558659217877095,0.994413407821229,179,5600,3600,2000,0.6428571428571429,76,36,40,227.63162977115314,0.474318937919779,0.7742822785945502,0.1376389830841993,1060290.9476529087,6871.151289166459,1067162.0989420752,404,1,145.9832402234637,61,118,43,36.71409302527955,0.5620344506517692,42.5739247311828,8237.634408602156,135.04318702626486,0
406,32,0,1,177,0.0,0.0056179775280898875,0.9943820224719101,178,5650,4400,1250,0.7787610619469026,69,44,25,222.18306984224887,0.47402082143083857,0.7666284217616972,0.13516787319918136,1062126.544784582,5947.307256235952,1068073.852040818,405,2,147.64606741573033,69,109,42,36.62667013207036,0.5637874531835205,42.35119047619048,8244.761904761917,119.48930296756402,0
407,32,1,0,178,0.0056179775280898875,0.0,1.0,178,5100,3700,1400,0.7254901960784313,65,37,28,220.67136006529915,0.47381054402336065,0.7637839064805358,0.1348547200399053,1063476.562500002,6235.763888889009,1069712.326388891,406,0,148.56741573033707,71,107,43,36.49831649831648,0.5655430711610487,42.18750000000001,8250.000000000016,116.19718309859178,0
408,32,0,3,175,0.0,0.016853932584269662,0.9831460674157303,178,5550,4100,1450,0.7387387387387387,70,41,29,227.1351521407876,0.4734547916798917,0.7709769475159991,0.1366278061968017,1058726.6697530854,6944.80864197526,1065671.4783950606,407,1,149.56741573033707,74,104,41,36.9211525655562,0.5575842696629214,42.763888888888886,8231.555555555547,111.23723723723712,8
409,32,2,3,174,0.011299435028248588,0.01694915254237288,0.9830508474576272,177,6250,4600,1650,0.736,79,46,33,220.01866192992804,0.4734246597329224,0.7646398490264386,0.12844388427005823,1049613.7303064407,4536.92169706065,1054150.6520035013,408,0,149.41242937853107,75,102,39,38.23809109719771,0.5449623352165724,43.8733552631579,8196.05263157895,109.280701754386,8
410,32,2,0,176,0.011363636363636364,0.0,1.0,176,4750,3100,1650,0.6526315789473685,64,31,33,213.04877428722415,0.4740212391774892,0.7560701792979081,0.12524753548455433,1051755.8188256894,4865.057610053673,1056620.876435743,409,0,149.9090909090909,67,109,41,38.149820258509116,0.5472892992424243,43.61213235294117,8204.411764705861,122.45390693590838,0
411,32,1,3,174,0.005649717514124294,0.01694915254237288,0.9830508474576272,177,6350,5000,1350,0.7874015748031497,77,50,27,210.30966129675258,0.474225838897449,0.754544987599955,0.12430232059543372,1053393.8406455887,2557.7803676515373,1055951.6210132402,410,0,150.05649717514123,70,107,39,38.016276897859576,0.5491407721280603,43.41255868544599,8210.798122065678,117.2971160295097,0
412,32,1,0,175,0.005714285714285714,0.0,1.0,175,5450,3800,1650,0.6972477064220184,71,38,33,209.74267174854162,0.4741392993979201,0.7525720401380855,0.12482606944525121,1055494.6342646135,3826.45292138173,1059321.0871859952,411,0,152.09714285714287,71,104,38,37.769731406898345,0.5511904761904762,43.15682870370369,8218.981481481449,115.76030255607675,0
413,32,1,3,173,0.005681818181818182,0.017045454545454544,0.9829545454545454,176,4750,3300,1450,0.6947368421052632,62,33,29,217.01928337418326,0.4738940746753247,0.7576650782380725,0.129241000778651,1055692.825026677,5871.140070111471,1061563.9650967885,412,0,152.22727272727272,80,96,36,37.55820066085913,0.5575875946969697,43.13271604938273,8219.753086419787,102.74691358024734,8
414,32,1,2,172,0.005747126436781609,0.011494252873563218,0.9885057471264368,174,5250,3800,1450,0.7238095238095238,67,38,29,222.2641932050903,0.4735676477753416,0.7636176285450673,0.13333851014508805,1057913.8326855674,6977.27290047251,1064891.1055860398,413,0,153.2183908045977,80,94,36,37.147411852963266,0.5597461685823755,42.86265432098766,8228.395061728404,102.85493827160505,0
415,32,2,0,174,0.011494252873563218,0.0,1.0,174,5000,3500,1500,0.7,65,35,30,216.56122359038153,0.47310256239895465,0.7579853690176186,0.13078362162078355,1059919.274376418,6107.482993197313,1066026.7573696154,414,0,153.5,69,105,38,37.04517422139993,0.5625,42.61904761904762,8236.19047619048,119.36507936507942,0
416,32,0,3,171,0.0,0.017241379310344827,0.9827586206896551,174,4800,3000,1800,0.625,66,30,36,211.96555118144343,0.47300082497287005,0.7537194124359472,0.12872636396031184,1061601.2895644642,5404.580495492741,1067005.870059957,415,1,154.5,70,104,40,36.95498946289228,0.5638769157088123,42.4149061032864,8242.723004694866,117.75318578135523,0
417,32,1,1,171,0.005813953488372093,0.005813953488372093,0.9941860465116279,172,5350,3300,2050,0.616822429906542,74,33,41,211.30168753170904,0.4722661385375584,0.7498378040209159,0.1290526128109487,1063299.9859260665,5185.416275724185,1068485.4022017906,416,0,154.40697674418604,72,100,39,36.76173475035982,0.5669815891472868,42.20890410958905,8249.315068493164,114.5738203957384,0
418,32,2,4,169,0.011560693641618497,0.023121387283236993,0.976878612716763,173,5850,4600,1250,0.7863247863247863,71,46,25,195.24672822590557,0.4724747389882153,0.7316140260347974,0.11780778666959486,1059654.0190206578,928.7960530428236,1060582.8150737006,417,0,153.1387283236994,72,101,44,37.62660567415209,0.5676782273603083,42.65125570776254,8235.15981735156,114.37721968543832,8
419,32,2,1,170,0.011695906432748537,0.005847953216374269,0.9941520467836258,171,5350,4000,1350,0.7476635514018691,67,40,27,198.75517334050033,0.4718753583304667,0.7338548557185323,0.12075762523675786,1061735.2994886746,2655.076698319777,1064390.3761869944,418,0,154.73099415204678,73,98,44,37.27868852459018,0.5695053606237817,42.39864864864864,8243.243243243218,112.92114031840025,0
420,32,2,0,172,0.011627906976744186,0.0,1.0,172,5500,3800,1700,0.6909090909090909,72,38,34,196.07046905394364,0.4720068906115418,0.7310453994502171,0.11975550579424023,1063313.3962906515,1796.8712724097477,1065110.2675630613,419,0,154.36046511627907,78,94,42,37.15272449832062,0.5710998062015504,42.20727848101264,8249.36708860754,105.76111652060948,0
421,32,0,1,171,0.0,0.005813953488372093,0.9941860465116279,172,5700,4400,1300,0.7719298245614035,70,44,26,212.9718350424313,0.47174764268552516,0.7509224670180943,0.1300019896670888,1063137.3625779084,5183.66300207754,1068321.025579986,420,1,155.36046511627907,75,97,39,36.738814005423514,0.5734011627906976,42.22861842105263,8248.684210526313,109.98245614035085,8
422,32,0,1,170,0.0,0.005847953216374269,0.9941520467836258,171,6200,5100,1100,0.8225806451612904,73,51,22,210.59648325381372,0.47101249856667815,0.7467664631343951,0.12928637792982026,1064839.4226320325,4450.287527265547,1069289.710159298,421,2,157.26315789473685,81,90,37,36.5894393014247,0.5755969785575048,42.02235772357724,8255.284552845538,101.91709324500664,0
423,32,0,2,168,0.0,0.011764705882352941,0.9882352941176471,170,5600,4200,1400,0.75,70,42,28,212.35373686950288,0.47013429632207915,0.748641164603032,0.13102489905599563,1066343.0748456744,5688.387345678835,1072031.4621913533,422,3,159.11764705882354,83,87,39,36.358159605469616,0.5773284313725491,41.840277777777764,8261.111111111075,99.53145917001295,0
424,32,1,1,168,0.005917159763313609,0.005917159763313609,0.9940828402366864,169,4950,3200,1750,0.6464646464646465,67,32,35,210.21535503324148,0.4695087231144923,0.7452979365702241,0.13006998839288328,1067177.0870891132,6117.402049155547,1073294.4891382686,423,0,160.94082840236686,85,84,40,36.31030547478346,0.5788954635108481,41.739341085271306,8264.341085271286,97.2275421796622,0
425,32,0,1,167,0.0,0.005952380952380952,0.9940476190476191,168,5550,4000,1550,0.7207207207207207,71,40,31,200.53865096492373,0.46891633399866933,0.729311134302771,0.12077497391667065,1059090.8082105976,3327.7283855810365,1062418.5365961785,424,1,162.67261904761904,91,77,40,37.560190482477374,0.5679563492063492,42.71965579710147,8232.971014492805,90.47220895047039,8
426,32,2,1,168,0.011834319526627219,0.005917159763313609,0.9940828402366864,169,5300,3900,1400,0.7358490566037735,67,39,28,194.64313425998873,0.4695865032403494,0.7225138219170286,0.1151961391025309,1053800.0141723303,1922.9875283443953,1055723.0017006746,425,0,161.9526627218935,69,100,43,38.367834087131314,0.5592948717948718,43.36309523809522,8212.38095238091,119.02001380262189,8
427,32,1,0,169,0.005917159763313609,0.0,1.0,169,5400,4000,1400,0.7407407407407407,68,40,28,195.42384109388365,0.4695028529163145,0.7215495237399987,0.11605467315654512,1054841.5509476368,2028.2375263230192,1056869.7884739598,426,0,162.75739644970415,72,97,42,38.21852654588565,0.5608974358974359,43.236301369862986,8216.438356164319,114.1171993911711,0
428,32,3,3,169,0.01744186046511628,0.01744186046511628,0.9825581395348837,172,5150,3500,1650,0.6796116504854369,68,35,33,189.46788149125092,0.46982878303640235,0.7181043617791247,0.11335680183593645,1057095.9375456478,507.145563955959,1057603.0831096037,427,0,160.90116279069767,77,95,41,38.092029493773886,0.5629239341085271,42.96207264957262,8225.213675213603,106.82095682095589,0
429,32,1,0,170,0.0058823529411764705,0.0,1.0,170,5600,4100,1500,0.7321428571428571,71,41,30,193.17432254401143,0.46928950574312567,0.7209622781326108,0.11625328363930061,1058866.4075598088,1309.160188994847,1060175.5677488036,428,0,161.44117647058823,80,90,47,37.77744451109773,0.5651348039215687,42.74691358024687,8232.098765431985,102.90123456789982,0
430,32,1,2,169,0.005847953216374269,0.011695906432748537,0.9883040935672515,171,4650,2700,1950,0.5806451612903226,66,27,39,187.5927433901076,0.46911478041508997,0.7145277004727757,0.11349927150383346,1060476.7545505704,937.5487375157277,1061414.303288086,429,0,161.49122807017545,72,99,46,37.72182038207144,0.5667641325536062,42.55136986301369,8238.356164383546,114.42161339421591,0
431,32,0,1,168,0.0,0.005917159763313609,0.9940828402366864,169,5700,4100,1600,0.7192982456140351,73,41,32,184.32007904621517,0.4684785033342726,0.7061994609164446,0.11210286774777962,1062044.7530864156,-348.76543209894726,1061695.9876543167,430,1,161.90532544378698,77,92,45,37.61230907457325,0.5685404339250493,42.3611111111111,8244.44444444441,107.07070707070663,0
432,32,0,1,167,0.0,0.005952380952380952,0.9940476190476191,168,5650,4100,1550,0.7256637168141593,72,41,31,197.81522237923116,0.46787154856952756,0.7198575517993451,0.11778997332581556,1055655.51710881,2514.9461745485755,1058170.4632833584,431,2,163.10119047619048,84,84,43,38.056118797709914,0.5613219246031746,43.1372549019608,8219.607843137299,97.85247432306308,8
433,32,0,3,164,0.0,0.017964071856287425,0.9820359281437125,167,4500,3100,1400,0.6888888888888889,59,31,28,202.8292832147181,0.46791657648558305,0.7223000806896813,0.12132878941389581,1057041.015625008,4979.774305555908,1062020.789930564,432,3,164.50898203592814,87,80,36,37.75540357987167,0.563248502994012,42.96875000000002,8225.000000000062,94.54022988505818,0
434,32,0,0,164,0.0,0.0,1.0,164,4150,2400,1750,0.5783132530120482,59,24,35,206.54345275149012,0.46743057633797197,0.722098494917202,0.12410885346748868,1058404.4995408661,6771.303948576804,1065175.803489443,433,4,167.65243902439025,87,77,38,37.490795287187055,0.5649771341463414,42.80303030303031,8230.303030303054,94.60118425635694,0
435,32,2,3,163,0.012048192771084338,0.018072289156626505,0.9819277108433735,166,5700,4400,1300,0.7719298245614035,70,44,26,204.39607271058384,0.46761515760009736,0.7272084288571288,0.1231361706329613,1059184.0277777766,4398.611111111043,1063582.6388888876,434,0,166.62048192771084,70,96,43,37.44939271255059,0.563441265060241,42.70833333333333,8233.333333333323,117.61904761904748,8
436,32,0,2,161,0.0,0.012269938650306749,0.9877300613496932,163,5750,4500,1250,0.782608695652174,70,45,25,231.9874210669667,0.46699455931732686,0.7589868483335347,0.13834688318771626,1056114.1161419249,10651.038031236698,1066765.1541731616,435,1,169.3435582822086,66,97,37,37.12128088754412,0.5596242331288344,43.08146766169153,8221.393034825853,124.56656113372505,8
437,32,1,2,160,0.006172839506172839,0.012345679012345678,0.9876543209876543,162,5400,3800,1600,0.7037037037037037,70,38,32,227.29928644287904,0.46646793446310353,0.7514666965324048,0.1363873534229489,1057976.430078907,10295.457526063943,1068271.887604971,436,0,170.6604938271605,70,92,38,37.010160514254174,0.5617283950617284,42.8550469483568,8228.63849765257,117.55197853789385,0
438,32,1,1,160,0.006211180124223602,0.006211180124223602,0.9937888198757764,161,5550,4200,1350,0.7567567567567568,69,42,27,227.28413395743848,0.4660552536231884,0.7499259261300919,0.13676496552018322,1058831.6027605734,10381.124768040558,1069212.727528614,437,0,170.50931677018633,72,89,41,36.904283152133715,0.5633410973084887,42.751141552511406,8231.963470319612,114.33282597666127,0
439,32,2,0,162,0.012345679012345678,0.0,1.0,162,4550,3400,1150,0.7472527472527473,57,34,23,223.07570674321124,0.46615801446719324,0.7468545534623736,0.13508749368258177,1060743.9451331513,10375.241046832012,1071119.1861799832,438,0,170.30246913580248,65,97,39,36.77516243717051,0.5657150205761317,42.5189393939394,8239.39393939395,126.75990675990694,0
440,32,1,2,161,0.006134969325153374,0.012269938650306749,0.9877300613496932,163,5850,4200,1650,0.717948717948718,75,42,33,217.23436744127108,0.46606831780655916,0.7417290510786039,0.13259557124704108,1063118.5197241516,7739.175829475352,1070857.6955536269,439,0,170.25153374233128,71,92,41,36.63127209968006,0.5680598159509203,42.23090277777778,8248.611111111113,116.17762128325512,0
441,32,1,0,162,0.006172839506172839,0.0,1.0,162,4800,3600,1200,0.75,60,36,24,214.71017976199317,0.46554696086700914,0.7373990581866248,0.13169080114067833,1064565.3827160497,8514.60493827166,1073079.9876543214,440,0,171.57407407407408,74,88,40,36.51722575202816,0.5698945473251029,42.05555555555556,8254.222222222224,111.54354354354358,0
442,32,1,0,163,0.006134969325153374,0.0,1.0,163,5450,3500,1950,0.6422018348623854,74,35,39,211.36244145806901,0.4653093362619607,0.7356099575897794,0.13029750769164714,1066078.8926640912,7015.807508079524,1073094.7001721708,441,0,171.51533742331287,75,88,41,36.41640781252763,0.5715746421267893,41.87225877192983,8260.087719298263,110.13450292397684,0
443,32,1,2,162,0.006097560975609756,0.012195121951219513,0.9878048780487805,164,5500,3900,1600,0.7090909090909091,71,39,32,207.3854094850031,0.46501695845179314,0.7266561186215204,0.1259037233827666,1061503.2388807726,5728.0567729891545,1067231.2956537618,442,0,171.46341463414635,73,91,37,37.08510948373229,0.5694867886178862,42.4268018018018,8242.342342342341,112.90879921016905,8
444,32,0,1,161,0.0,0.006172839506172839,0.9938271604938271,162,4950,3600,1350,0.7272727272727273,63,36,27,233.18633300791637,0.46454611098330906,0.7580025884083232,0.13926885161017524,1056565.0854123808,11925.307570301875,1068490.3929826827,443,1,174.24074074074073,71,91,35,37.03435236272192,0.5599279835390947,43.026620370370374,8223.148148148155,115.8189880020867,8
445,32,0,1,160,0.0,0.006211180124223602,0.9937888198757764,161,4900,3800,1100,0.7755102040816326,60,38,22,233.53143860282862,0.4642452769151139,0.7563994185982366,0.13987042546105585,1057422.4891057317,12288.279018369087,1069710.7681241008,444,2,176.30434782608697,72,89,35,36.91880365600949,0.5618530020703933,42.922374429223744,8226.48401826484,114.25672247590056,0
446,32,1,1,160,0.006211180124223602,0.006211180124223602,0.9937888198757764,161,4650,3000,1650,0.6451612903225806,63,30,33,231.88806378913196,0.4639250129399586,0.7559902144741557,0.1396454646823761,1059069.6790123472,12267.123456790245,1071336.8024691376,445,0,175.527950310559,74,87,37,36.756257647736284,0.56444099378882,42.72222222222223,8232.888888888901,111.25525525525542,0
447,32,0,2,158,0.0,0.0125,0.9875,160,5200,3900,1300,0.75,65,39,26,204.8115748063562,0.46341964753668763,0.7196805302183265,0.12088791561946485,1052978.369536039,5932.431620340824,1058910.8011563797,446,1,176.3875,68,92,46,38.20899291865277,0.5578776041666667,43.46316425120771,8209.178743961304,120.72321682296035,8
448,32,1,0,159,0.006289308176100629,0.0,1.0,159,5750,4200,1550,0.7304347826086957,73,42,31,200.083110813047,0.4630984130775151,0.7097605470294834,0.11884454654317037,1054900.1736111022,4663.541666666173,1059563.7152777684,447,0,178.1823899371069,71,88,47,38.091615956727516,0.5604035639412999,43.229166666666636,8216.666666666595,115.72769953051542,0
449,32,0,0,159,0.0,0.0,1.0,159,4750,3500,1250,0.7368421052631579,60,35,25,198.0829669147737,0.4630884616405275,0.7057816276853337,0.11807736509901814,1055984.5956790016,5284.512345678353,1061269.10802468,448,1,179.1823899371069,74,85,41,38.00841577913532,0.5621069182389937,43.097222222222186,8220.888888888803,111.09309309309194,0
450,32,0,4,155,0.0,0.025157232704402517,0.9748427672955975,159,5250,3700,1550,0.7047619047619048,68,37,31,200.91764774892374,0.46251459544091506,0.7062954049050625,0.12034689333827156,1057447.749759646,5441.982899819774,1062889.7326594656,449,2,180.1823899371069,78,81,44,37.75409892120155,0.5639412997903563,42.91930379746833,8226.58227848095,105.46900357026858,0
451,32,2,3,154,0.012738853503184714,0.01910828025477707,0.9808917197452229,157,5150,3400,1750,0.6601941747572816,69,34,35,225.06010879475937,0.4625302819968425,0.7406933563467568,0.13244526667248807,1052071.0100263003,10805.843195266363,1062876.8532215666,450,0,181.12738853503186,64,93,38,37.80258525508824,0.5577229299363058,43.573717948717956,8205.64102564104,128.21314102564125,8
452,32,1,3,152,0.0064516129032258064,0.01935483870967742,0.9806451612903225,155,4750,3400,1350,0.7157894736842105,61,34,27,221.81606906594064,0.4623079877112135,0.7337663073750866,0.13117428233369235,1053559.2598264902,10989.274708546869,1064548.5345350371,451,0,183.58064516129033,66,89,39,37.70044430980512,0.5598790322580645,43.392412935323385,8211.442786069658,124.41579978893421,0
453,32,3,2,153,0.01935483870967742,0.012903225806451613,0.9870967741935484,155,4650,3400,1250,0.7311827956989247,59,34,25,217.4489602476426,0.4627513615416841,0.7283435601435042,0.12934411579485644,1055334.3718639873,10246.272375084587,1065580.644239072,452,0,182.67096774193547,68,87,45,37.59172446900227,0.5627016129032258,43.17632850241546,8218.357487922704,120.85819835180446,0
454,32,3,4,152,0.019230769230769232,0.02564102564102564,0.9743589743589743,156,4950,3300,1650,0.6666666666666666,66,33,33,210.6203403965654,0.463433105872622,0.7204926549501347,0.1260831306778666,1057266.4936566954,8386.36575677096,1065652.8594134664,453,0,181.1153846153846,75,81,41,37.52715942415354,0.5655048076923077,42.941337719298225,8225.877192982403,109.67836257309871,0
455,32,3,0,155,0.01935483870967742,0.0,1.0,155,4000,3100,900,0.775,49,31,18,239.68292325832755,0.4635647954196341,0.7503136762860712,0.13742970491862494,1044064.7600263078,15048.898750822365,1059113.65877713,454,0,180.21935483870968,64,91,36,38.428612505227946,0.546505376344086,44.55128205128209,8174.358974359048,127.72435897436013,7
456,32,2,2,155,0.012738853503184714,0.012738853503184714,0.9872611464968153,157,5550,4400,1150,0.7927927927927928,67,44,23,242.98330016200688,0.4644254586531657,0.7567066925027204,0.14066798842655304,1047038.0908831012,13932.554143620651,1060970.6450267218,455,0,178.9108280254777,68,89,40,37.97199272155009,0.5494294055201698,44.18780193236715,8185.9903381642525,120.38221085535666,0
457,32,2,2,155,0.012738853503184714,0.012738853503184714,0.9872611464968153,157,4550,3500,1050,0.7692307692307693,56,35,21,241.83126064506163,0.4640239670096358,0.7576270960537987,0.14074644817786347,1048673.5260770982,14770.408163265329,1063443.9342403635,456,0,179.8343949044586,69,88,34,37.79692707122375,0.5509554140127388,43.98809523809524,8192.380952380958,118.7301587301588,0
458,32,2,1,156,0.012738853503184714,0.006369426751592357,0.9936305732484076,157,5100,3700,1400,0.7254901960784313,65,37,28,240.59482671806347,0.4637789890576515,0.7586468807215072,0.1408652884629294,1050506.3690897187,14049.27956747248,1064555.648657191,457,0,180.52866242038218,71,86,37,37.599573240735516,0.5528795116772824,43.76446759259259,8199.537037037024,115.48643714136654,0
459,32,1,2,155,0.006369426751592357,0.012738853503184714,0.9872611464968153,157,4600,3100,1500,0.6739130434782609,61,31,30,239.90168769817637,0.4637296532200991,0.7594636131687122,0.14153087201606399,1052830.4572782917,14515.160712220626,1067345.6179905124,458,0,181.12738853503186,61,96,38,37.327253078333754,0.5550690021231423,43.4811827956989,8208.602150537583,134.5672483694686,0
460,32,2,1,156,0.012738853503184714,0.006369426751592357,0.9936305732484076,157,4750,3400,1350,0.7157894736842105,61,34,27,233.54038991112546,0.46392869780608637,0.7525791361920182,0.13854004311795595,1054511.1627639995,13104.189623507547,1067615.352387507,459,0,179.96178343949043,65,92,41,37.28098487642933,0.5573248407643312,43.276515151515135,8215.151515151481,126.38694638694587,0
461,32,1,3,154,0.006369426751592357,0.01910828025477707,0.9808917197452229,157,4850,3700,1150,0.7628865979381443,60,37,23,221.0848899717677,0.4635476209918885,0.7349476900020171,0.13467409229261493,1062514.7931053694,10731.19322541528,1073245.9863307846,460,0,180.7388535031847,66,91,41,36.60683760683761,0.569400212314225,42.30410447761194,8246.268656716424,124.9434644957034,8
462,32,0,0,154,0.0,0.0,1.0,154,4950,3700,1250,0.7474747474747475,62,37,25,229.51916473757672,0.4625562346150582,0.7365515167610825,0.1364889344474611,1055256.829909334,12690.333236882541,1067947.1631462164,461,1,184.03246753246754,71,83,41,37.291384992394796,0.5597943722943723,43.18576388888888,8218.055555555535,115.7472613458526,8
463,32,1,1,154,0.0064516129032258064,0.0064516129032258064,0.9935483870967742,155,4900,3300,1600,0.673469387755102,65,33,32,216.9387551135045,0.46312142158916353,0.7177236109670506,0.125405116803532,1046582.8427977887,9508.87580794122,1056091.71860573,462,0,183.83870967741936,75,80,41,38.695069667738515,0.5539650537634409,44.2434210526316,8184.210526315827,109.12280701754436,8
464,32,5,2,157,0.031446540880503145,0.012578616352201259,0.9874213836477987,159,5850,4500,1350,0.7692307692307693,72,45,27,210.49057157016284,0.4643207812541464,0.7166969337846398,0.12290649996959682,1049676.1402606352,6539.3861454048865,1056215.52640604,463,0,180.0314465408805,80,79,42,38.47435607772256,0.5564727463312369,43.865740740740755,8196.29629629633,102.45370370370412,0
465,32,3,0,160,0.01875,0.0,1.0,160,5700,3800,1900,0.6666666666666666,76,38,38,208.291082711824,0.46366122903563944,0.717256352294839,0.12238326762967017,1051587.6617293674,6107.266525600758,1057694.9282549683,464,0,179.8125,70,90,45,38.29272538247298,0.558984375,43.632629107981195,8203.755868544544,117.1965124077792,0
466,32,3,4,159,0.018404907975460124,0.024539877300613498,0.9754601226993865,163,4800,3300,1500,0.6875,63,33,30,226.31346453872214,0.4649274786033477,0.7507775802445522,0.13025319613068617,1045230.5941524927,9909.951400903661,1055140.5455533965,465,0,177.48466257668713,67,96,40,38.62432574168416,0.5474821063394684,44.40870098039217,8178.9215686274765,122.0734562481713,8
467,32,3,5,157,0.018518518518518517,0.030864197530864196,0.9691358024691358,162,4750,3100,1650,0.6526315789473685,64,31,33,219.12456237408486,0.4643520116044271,0.7402094487324695,0.1271767082401789,1047817.1198109079,8770.493565328063,1056587.6133762358,466,0,178.82716049382717,75,87,40,38.48509497795156,0.5506044238683128,44.092653508771946,8189.035087719334,109.18713450292445,0
468,32,1,1,157,0.006329113924050633,0.006329113924050633,0.9936708860759493,158,5950,4300,1650,0.7226890756302521,76,43,33,217.26648788591336,0.4640879894649144,0.7310969967361991,0.12679080551643343,1049501.397064487,8054.296514312327,1057555.6935787993,467,0,183.60759493670886,75,83,42,38.3225855364087,0.5526107594936709,43.88706140350879,8195.614035087763,109.27485380117018,0
469,32,2,1,158,0.012578616352201259,0.006289308176100629,0.9937106918238994,159,4450,3300,1150,0.7415730337078652,56,33,23,220.7585997583365,0.46507709046519646,0.7442904448489185,0.12445864091638736,1038802.1065382058,9614.899693076994,1048417.0062312827,468,0,183.42138364779873,66,93,41,39.57087579067262,0.5363600628930818,45.195895522388064,8153.731343283593,123.54138398914534,8
470,32,2,2,158,0.0125,0.0125,0.9875,160,4950,3600,1350,0.7272727272727273,63,36,27,216.86358081824446,0.46577240566037736,0.7417422867513603,0.12318745673283821,1041155.6927297702,8207.750342935711,1049363.443072706,469,0,182.8875,71,89,44,39.3753781004235,0.5385416666666667,44.90740740740742,8162.96296296299,114.9713093375069,0
471,32,2,0,160,0.0125,0.0,1.0,160,4450,2700,1750,0.6067415730337079,62,27,35,213.0905138508316,0.4663390985324947,0.7370603975535164,0.12224666320916114,1044228.5156249984,8053.038194444364,1052281.5538194426,470,0,183.81875,59,101,47,39.08745327896705,0.5407552083333333,44.53124999999999,8174.999999999987,138.5593220338981,0
472,32,3,1,162,0.018404907975460124,0.006134969325153374,0.9938650306748467,163,4400,3200,1200,0.7272727272727273,56,32,24,209.24284011424655,0.46717128682875103,0.7364891741600297,0.12115137674079501,1047079.9186390534,6818.795200525943,1053898.7138395794,471,0,181.41717791411043,64,99,48,38.82989830650044,0.543392126789366,44.18269230769231,8186.153846153848,127.90865384615387,0
473,32,2,2,162,0.012195121951219513,0.012195121951219513,0.9878048780487805,164,5550,4300,1250,0.7747747747747747,68,43,25,206.64067373648084,0.4675918998453788,0.7352227566713654,0.12079182337431266,1050014.9695294758,5045.160147392152,1055060.129676868,472,0,179.51829268292684,69,95,44,38.53077500242038,0.5463668699186992,43.82440476190475,8197.619047619026,118.80607315389892,0
474,32,2,2,162,0.012195121951219513,0.012195121951219513,0.9878048780487805,164,5500,3600,1900,0.6545454545454545,74,36,38,205.54262449577823,0.4675872238016859,0.7336614315698042,0.12060264061065705,1051167.3980291714,4911.941155062936,1056079.3391842344,473,0,180.16463414634146,62,102,46,38.415473272265935,0.5486534552845528,43.68386243386244,8202.11640211641,132.29220003413565,0
475,32,0,2,160,0.0,0.012345679012345678,0.9876543209876543,162,5000,3700,1300,0.74,63,37,26,217.0220163756031,0.46721477775221737,0.745496233696824,0.1269047623029923,1050122.6090926551,8179.945213379381,1058302.5543060345,474,1,182.33333333333334,67,95,42,38.2514151319461,0.5471322016460906,43.811274509803916,8198.039215686262,122.35879426397406,8
476,32,1,1,160,0.006211180124223602,0.006211180124223602,0.9937888198757764,161,5000,3700,1300,0.74,63,37,26,232.62447811538541,0.46674915890269153,0.7555238099808002,0.13215112201902887,1041181.2276803849,11240.84794253721,1052422.075622922,475,0,183.48447204968943,73,88,36,38.97012838906672,0.5416666666666667,44.90427927927929,8163.063063063077,111.82278168579558,8
477,32,3,1,162,0.018404907975460124,0.006134969325153374,0.9938650306748467,163,5900,4100,1800,0.6949152542372882,77,41,36,226.65849480151223,0.46704505289201953,0.7527674046412378,0.13032863451086962,1044938.2716049395,8868.827160493875,1053807.0987654333,476,0,182.19018404907976,65,98,37,38.6520606884058,0.5447341513292434,44.44444444444445,8177.777777777787,125.81196581196596,0
478,32,1,2,161,0.006134969325153374,0.012269938650306749,0.9877300613496932,163,5100,3600,1500,0.7058823529411765,66,36,30,243.31257013570115,0.4667846953975107,0.7706167131522457,0.14180982338195897,1049110.089497343,13352.334446178911,1062462.423943522,477,0,183.15337423312883,61,102,41,37.704423922314824,0.5478655419222904,43.934811827957,8194.086021505394,134.32927904107203,8
479,32,2,2,161,0.012269938650306749,0.012269938650306749,0.9877300613496932,163,5500,4000,1500,0.7272727272727273,70,40,30,237.1947751610076,0.466843078593249,0.7640182615772766,0.13938142637495407,1051621.7640817887,11787.837577160346,1063409.6016589492,478,0,183.88957055214723,59,104,39,37.54747353332879,0.5506134969325154,43.628472222222214,8203.888888888878,139.04896421845555,0
480,32,4,0,165,0.024242424242424242,0.0,1.0,165,5500,4500,1000,0.8181818181818182,65,45,20,225.7705844827961,0.46682064547918206,0.755756769366349,0.13451631313295476,1055836.524963379,9175.365871853322,1065011.8908352323,479,0,181.95757575757577,63,102,39,37.31553200701175,0.554229797979798,43.115234375,8220.3125,130.48115079365078,0
481,32,0,1,164,0.0,0.006060606060606061,0.9939393939393939,165,4750,3200,1550,0.6736842105263158,63,32,31,224.87148254019542,0.46694536831731953,0.7552044830828859,0.13439518203291784,1056773.2916937945,9777.635362413246,1066550.9270562078,480,1,182.95757575757577,63,102,39,37.222134262191254,0.5556186868686869,43.001302083333336,8223.958333333341,130.53902116402128,0
482,32,1,1,164,0.006060606060606061,0.006060606060606061,0.9939393939393939,165,6050,4200,1850,0.6942148760330579,79,42,37,226.71297069913808,0.46696384577482136,0.7581801845952798,0.13788608545800005,1062044.7530864167,9105.864197530675,1071150.6172839475,481,0,182.73333333333332,65,100,36,36.52010332434861,0.5648358585858586,42.3611111111111,8244.44444444442,126.83760683760646,8
483,32,1,2,163,0.006060606060606061,0.012121212121212121,0.9878787878787879,165,4900,3300,1600,0.673469387755102,65,33,32,229.83154541779476,0.46666974624291696,0.7596724510266069,0.1406636904907575,1063925.5371154128,11004.730080938281,1074930.267196351,482,0,183.70909090909092,66,99,42,36.20648940873829,0.5668560606060606,42.13308457711441,8251.741293532297,125.02638323533783,0
484,32,1,2,162,0.006097560975609756,0.012195121951219513,0.9878048780487805,164,5300,3900,1400,0.7358490566037735,67,39,28,226.9774907543704,0.4664447104593745,0.7558278942934744,0.13973981619286574,1065687.5318877501,10277.416383219688,1075964.9482709698,483,0,185.73170731707316,69,95,34,36.061799669415144,0.5685975609756098,41.91964285714284,8258.57142857139,119.68944099378825,0
485,32,0,2,160,0.0,0.012345679012345678,0.9876543209876543,162,5600,3900,1700,0.6964285714285714,73,39,34,235.12347940739002,0.4654423229302456,0.7626015872809631,0.14516540595036687,1066530.1553128366,12153.256202011315,1078683.411514848,484,1,188.97530864197532,68,94,35,35.7471592016528,0.5699588477366255,41.81763285024152,8261.835748792222,121.4975845410621,0
486,32,2,2,160,0.012345679012345678,0.012345679012345678,0.9876543209876543,162,5150,3400,1750,0.6601941747572816,69,34,35,236.3560671699925,0.4652242606650819,0.7648475652729072,0.14725279665946356,1069213.4452160462,12993.016975308416,1082206.4621913545,485,0,189.47530864197532,59,103,38,35.38308708305351,0.572337962962963,41.49305555555554,8272.222222222197,140.2071563088508,0
487,32,0,1,159,0.0,0.00625,0.99375,160,5050,3600,1450,0.7128712871287128,65,36,29,236.51858380979078,0.4643958005765199,0.7622197920105656,0.14783631662398974,1070178.9440189288,13573.441652482776,1083752.3856714116,486,1,192.7375,60,100,38,35.25943655771984,0.5736328125,41.37636612021857,8275.956284152984,137.93260473588307,0
488,32,1,0,160,0.00625,0.0,1.0,160,5450,4200,1250,0.7706422018348624,67,42,25,234.77985982252417,0.46392328354297696,0.7609573708798332,0.14805348607138852,1072783.6310556105,12923.598103826775,1085707.2291594374,487,0,193.5875,61,99,39,34.98248118349335,0.5756510416666667,41.061827956989234,8286.021505376322,135.83641812092333,0
489,32,0,0,160,0.0,0.0,1.0,160,5000,3500,1500,0.7,65,35,30,235.17247662002086,0.46370299397274634,0.7612733572577652,0.14858708237422918,1073349.1288625924,13484.434582511636,1086833.563445104,488,1,194.5875,64,96,36,34.90247184754363,0.5764973958333333,40.99358974358975,8288.205128205143,129.50320512820537,0
490,32,1,0,161,0.006211180124223602,0.0,1.0,161,4200,3000,1200,0.7142857142857143,54,30,24,227.41741972971386,0.4640139751552795,0.7508532212264047,0.13845682286384192,1062353.0613083486,11919.518408941392,1074272.57971729,489,0,194.3726708074534,64,97,39,36.46371042975306,0.5628234989648033,42.32371794871794,8245.641025641016,128.83814102564088,8
491,32,2,1,162,0.012269938650306749,0.006134969325153374,0.9938650306748467,163,4200,2700,1500,0.6428571428571429,57,27,30,224.72057242736838,0.4640249059557171,0.7508832293714878,0.13785317738085456,1064614.274708045,11048.145845347899,1075662.4205533927,490,0,192.9754601226994,67,96,39,36.25295692539141,0.5647367075664622,42.049632352941174,8254.411764705881,123.20017559262509,0
492,32,1,0,163,0.006134969325153374,0.0,1.0,163,4300,2800,1500,0.6511627906976745,58,28,30,240.04309862536093,0.46439887399328433,0.7664591396768026,0.14319290205064936,1056203.0363894165,13806.849926486197,1070009.8863159027,491,0,192.6073619631902,68,95,33,36.90324049591633,0.5515081799591002,43.070652173913054,8221.739130434804,120.90792838874711,8
493,32,5,1,167,0.02976190476190476,0.005952380952380952,0.9940476190476191,168,4750,2900,1850,0.6105263157894737,66,29,37,233.92755484864705,0.4656624251497006,0.7689312092091716,0.14138829036842473,1060168.43217176,11250.521813132831,1071418.9539848927,492,0,187.8452380952381,60,108,38,36.56724050241031,0.5549355158730158,42.58879781420766,8237.158469945372,137.28597449908955,0
494,32,1,0,168,0.005952380952380952,0.0,1.0,168,5450,3900,1550,0.7155963302752294,70,39,31,228.9788479094038,0.46580648227354815,0.7631998360277887,0.13908313274020703,1061654.427003617,9569.281514641094,1071223.708518258,493,0,187.69642857142858,65,103,40,36.51015818066702,0.5571676587301587,42.40845959595958,8242.929292929253,126.8142968142962,0
495,32,1,0,169,0.005917159763313609,0.0,1.0,169,4850,3000,1850,0.6185567010309279,67,30,37,227.2426705787101,0.46582517375786603,0.76173784038354,0.1389275409473087,1063599.3339002256,9689.030612244824,1073288.3645124703,494,0,187.57988165680473,69,100,38,36.31368078802569,0.5589250493096647,42.172619047619044,8250.476190476182,119.57211870255335,0
496,32,2,0,171,0.011695906432748537,0.0,1.0,171,5100,3300,1800,0.6470588235294118,69,33,36,230.1909453831233,0.46594857241142074,0.770349582345683,0.13440964700075242,1049676.1402606303,9025.188614540468,1058701.3288751708,495,0,186.37426900584796,71,100,38,37.96976201235128,0.5466008771929824,43.86574074074074,8196.296296296292,115.44079290558157,8
497,32,1,0,172,0.005813953488372093,0.0,1.0,172,5550,4100,1450,0.7387387387387387,70,41,29,225.9179426527438,0.46604135500249333,0.7669123023857025,0.12733626364429315,1038725.6741697917,6983.353457804753,1045709.0276275965,496,0,186.28488372093022,67,105,37,39.448999478947485,0.5356104651162791,45.20526960784314,8153.43137254903,121.69300556043329,7
498,32,2,2,172,0.011494252873563218,0.011494252873563218,0.9885057471264368,174,6000,4600,1400,0.7666666666666667,74,46,28,218.74974557378866,0.4660300810577371,0.7615519906198367,0.12399469307931002,1040491.8939209462,4721.467413359176,1045213.3613343054,497,0,185.132183908046,73,101,39,39.41037388680357,0.5381345785440613,44.98873873873873,8160.360360360346,111.78575836110063,0
499,32,3,4,171,0.017142857142857144,0.022857142857142857,0.9771428571428571,175,6550,4700,1850,0.7175572519083969,84,47,37,213.44704055348993,0.46613984674329506,0.7585483019211519,0.12213654508695321,1043430.3283691405,2993.423122829864,1046423.7514919704,498,0,184.4,63,112,41,39.178085829615455,0.540952380952381,44.62890625,8171.874999999999,129.71230158730157,0
500,32,1,0,172,0.005813953488372093,0.0,1.0,172,5100,3500,1600,0.6862745098039216,67,35,32,189.82309642639422,0.46610793780316423,0.7159117682095559,0.10534402413808319,1033846.4640131916,-250.41259430790979,1033596.0514188837,499,0,186.16860465116278,71,101,47,40.97917852399925,0.5311288759689923,45.80439814814811,8134.259259259168,114.56703182055166,8
501,32,4,3,173,0.022727272727272728,0.017045454545454544,0.9829545454545454,176,6150,4800,1350,0.7804878048780488,75,48,27,191.0091240498254,0.46734104437229435,0.7218251610784296,0.10719063007948076,1037355.4773148841,-1721.1277899594597,1035634.3495249246,500,0,182.91477272727272,76,100,46,40.509775794283286,0.5341500946969697,45.37337662337659,8148.051948051878,107.21120984278787,0
502,32,3,2,174,0.017045454545454544,0.011363636363636364,0.9886363636363636,176,5950,4600,1350,0.773109243697479,73,46,27,190.19639706033948,0.4669967532467532,0.7223507770595536,0.10782145665255845,1040525.92973631,-1569.143423259255,1038956.7863130508,501,0,183.33522727272728,80,96,39,40.13426626323748,0.5372869318181819,44.984567901234534,8160.493827160409,102.00617283950511,0
503,32,1,2,173,0.005714285714285714,0.011428571428571429,0.9885714285714285,175,4950,3500,1450,0.7070707070707071,64,35,29,191.6970677647609,0.46683908045977013,0.7238351967281111,0.10900726407244177,1041485.8253294214,-20.04423315790018,1041465.7810962636,502,0,185.29142857142858,82,93,41,39.97614245658911,0.5389880952380952,44.86696787148592,8164.25702811238,99.56411009893147,0
504,32,4,2,175,0.022598870056497175,0.011299435028248588,0.9887005649717514,177,5050,3400,1650,0.6732673267326733,67,34,33,191.9235392737369,0.46764386449238143,0.7262733553817406,0.11013296989317976,1044311.4616714536,-364.409634376781,1043947.0520370768,503,0,183.21468926553672,76,101,43,39.61786250110321,0.5417843691148776,44.521103896103924,8175.3246753247395,107.57006151743079,0
505,32,5,3,177,0.027777777777777776,0.016666666666666666,0.9833333333333333,180,6050,4300,1750,0.7107438016528925,78,43,35,188.55744068137912,0.46923882681564244,0.7232726749463159,0.10693444008811687,1040648.7953598958,-2805.5852997559305,1037843.2100601399,504,0,180.49444444444444,81,99,40,40.16072258750079,0.5354166666666667,44.96951219512192,8160.975609756026,100.75278530562994,8
506,32,1,3,175,0.0056179775280898875,0.016853932584269662,0.9831460674157303,178,5250,3400,1850,0.6476190476190476,71,34,37,179.68521700970012,0.46859460631837324,0.7141921573741137,0.10135808305373542,1038974.0521461775,-3512.3443945335216,1035461.707751644,505,0,183.24719101123594,86,92,35,40.59597644442355,0.5349953183520599,45.17480842911876,8154.406130268171,94.81867593335083,8
507,32,4,2,177,0.0223463687150838,0.0111731843575419,0.9888268156424581,179,5500,3800,1700,0.6909090909090909,72,38,34,186.12965585549165,0.4681464858870546,0.7243751029153322,0.10602010793883213,1042011.1495844801,-2510.1646660514493,1039500.9849184287,506,0,183.1731843575419,94,85,41,40.05265174300364,0.5384078212290503,44.80263157894735,8166.315789473625,86.8756998880173,0
508,32,2,1,178,0.0111731843575419,0.00558659217877095,0.994413407821229,179,6100,4100,2000,0.6721311475409836,81,41,40,188.15030636587522,0.4679215575502689,0.7259409383231239,0.10797593334907381,1044334.9636501722,-2601.6113281250755,1041733.3523220471,507,0,184.13966480446928,79,100,43,39.711331821347905,0.5406191806331471,44.518229166666664,8175.416666666655,103.48628691983107,0
509,32,1,2,177,0.00558659217877095,0.0111731843575419,0.9888268156424581,179,5650,4000,1650,0.7079646017699115,73,40,33,199.61216521413067,0.46783132467097693,0.743140296212921,0.11129061813993323,1035306.2500000003,-118.05555555553246,1035188.1944444448,508,0,184.31843575418995,74,105,40,40.54736554736553,0.5313663873370578,45.625,8140.000000000003,110.00000000000004,8
510,32,6,5,178,0.03278688524590164,0.0273224043715847,0.9726775956284153,183,6250,4300,1950,0.688,82,43,39,194.16346438829964,0.46864553934226066,0.7427036126615196,0.10969862141388312,1039469.2558736342,-2484.6096308899123,1036984.6462427443,509,0,180.33333333333334,83,100,38,40.16513411825761,0.5356898907103825,45.11408730158727,8156.349206349115,98.26926754637488,0
511,32,4,2,180,0.02197802197802198,0.01098901098901099,0.989010989010989,182,5700,4000,1700,0.7017543859649122,74,40,34,208.07967354627843,0.46849450043510815,0.7590420783698104,0.11889646482174625,1042989.669191357,1304.9899754957332,1044294.6591668527,510,0,181.73076923076923,66,116,40,39.3702046035806,0.5382898351648351,44.68283582089553,8170.149253731346,123.7901402080507,0
512,32,1,1,180,0.0055248618784530384,0.0055248618784530384,0.994475138121547,181,6450,4600,1850,0.7131782945736435,83,46,37,223.9799158471936,0.46830494168201353,0.7700123834783896,0.12434998057905772,1033974.2382369612,3667.8925736961173,1037642.1308106573,511,0,183.22099447513813,69,112,35,40.094867704735705,0.5282573664825045,45.788690476190474,8134.761904761903,117.89510006901308,8
513,32,3,2,181,0.01639344262295082,0.01092896174863388,0.9890710382513661,183,5200,3300,1900,0.6346153846153846,71,33,38,224.47713830695304,0.46878065013310916,0.771957883513261,0.12554248233629706,1036282.1648057809,4724.330966827231,1041006.4957726081,512,0,182.1639344262295,72,111,38,39.792309129987856,0.5303392531876139,45.50513698630137,8143.835616438366,113.10882800608842,0
514,32,4,3,182,0.021621621621621623,0.016216216216216217,0.9837837837837837,185,5650,3900,1750,0.6902654867256637,74,39,35,212.86979276916367,0.46995691343517426,0.769498565133995,0.11856782226458137,1035002.5409333953,1414.1552808100168,1036416.6962142052,513,0,180.52972972972972,66,119,40,40.248232369541725,0.5246621621621621,45.66231343283583,8138.805970149275,123.31524197195871,8
515,32,2,3,181,0.010869565217391304,0.016304347826086956,0.9836956521739131,184,5050,3100,1950,0.6138613861386139,70,31,39,212.67534397200194,0.46993359962778175,0.7678761978491022,0.11944307156049228,1037601.8838908152,2284.467512495411,1039886.3514033107,514,0,182.125,67,117,42,39.92721366698752,0.5271173007246377,45.343137254901976,8149.019607843169,121.62715832601745,0
516,32,2,1,182,0.01092896174863388,0.00546448087431694,0.994535519125683,183,5300,3600,1700,0.6792452830188679,70,36,34,210.00595012468625,0.4698252567105026,0.7640238049897072,0.11877226581663992,1039792.9457199615,1772.5410997736103,1041565.4868197351,515,0,183.96174863387978,69,114,40,39.720815577997044,0.529143897996357,45.07440476190479,8157.619047619102,118.2263630089725,0
517,32,4,5,181,0.021505376344086023,0.026881720430107527,0.9731182795698925,186,6250,4300,1950,0.688,82,43,39,205.14117425032512,0.47056996512641674,0.7612164096190432,0.11263039470859147,1030450.5679012296,-1172.432098765631,1029278.135802464,516,0,180.66666666666666,74,112,38,41.01619508902511,0.5187612007168458,46.22222222222221,8120.888888888849,109.7417417417412,8
518,32,4,0,185,0.021621621621621623,0.0,1.0,185,6750,4600,2150,0.6814814814814815,89,46,43,206.12771322319674,0.4708627105366236,0.7628201422912304,0.11435511536080557,1033743.4938218909,-1133.3635118269399,1032610.130310064,517,0,182.35135135135135,63,122,44,40.57764241958551,0.5229166666666667,45.817057291666686,8133.854166666707,129.10879629629693,0
519,32,2,0,187,0.0106951871657754,0.0,1.0,187,6350,4700,1650,0.7401574803149606,80,47,33,218.19093030877303,0.471421999884998,0.7795509579380828,0.12125485852396099,1034283.6190546172,1384.2610089302839,1035667.8800635475,518,0,181.3903743315508,62,125,38,40.20317140317791,0.5278520499108734,45.75066137566137,8135.978835978832,131.22546509643277,8
520,32,3,2,188,0.015789473684210527,0.010526315789473684,0.9894736842105263,190,6200,4300,1900,0.6935483870967742,81,43,38,214.04361877082653,0.47216768773786316,0.7783160723354745,0.11994353914283058,1036901.4535531289,188.42788544832865,1037089.8814385772,519,0,179.51052631578946,66,124,41,39.98017690647775,0.5302631578947368,45.429104477611936,8146.26865671641,123.42831298055167,0
521,32,2,2,188,0.010526315789473684,0.010526315789473684,0.9894736842105263,190,6550,4900,1650,0.7480916030534351,82,49,33,210.0288301110112,0.47188051146384474,0.7682467869769947,0.11886496493309603,1040002.6353516561,-863.8926369449014,1039138.7427147112,520,0,180.37894736842105,76,114,39,39.69398899854965,0.5336074561403509,45.04870129870128,8158.4415584415165,107.34791524265154,8
522,32,2,2,188,0.010526315789473684,0.010526315789473684,0.9894736842105263,190,6550,5000,1550,0.7633587786259542,81,50,31,198.719755837127,0.47193504594820385,0.7587837949702809,0.11181063784181039,1038178.1106180171,-3288.6998685074977,1034889.4107495097,521,0,181.23157894736843,77,113,44,40.210495963091105,0.5329495614035088,45.272435897435905,8151.282051282073,105.86080586080614,8
523,32,6,4,190,0.030927835051546393,0.020618556701030927,0.979381443298969,194,5300,3600,1700,0.6792452830188679,70,36,34,193.43918982326977,0.4720456528319356,0.7582021454444139,0.11011153882247625,1041807.3721759773,-3794.72519487398,1038012.6469811033,522,0,178.11855670103094,86,108,45,39.89155170795792,0.5365120274914089,44.82758620689654,8165.517241379282,94.94787489975909,0
524,32,2,0,192,0.010416666666666666,0.0,1.0,192,6150,4500,1650,0.7317073170731707,78,45,33,194.21942048000642,0.4720461114746946,0.7574906266160983,0.11100166090685006,1043059.4438107624,-4033.5198593748173,1039025.9239513875,523,0,180.89583333333334,70,122,44,39.7153747438181,0.5378689236111112,44.67429577464792,8170.422535211352,116.72032193159073,0
525,32,2,2,192,0.010309278350515464,0.010309278350515464,0.9896907216494846,194,5700,3600,2100,0.631578947368421,78,36,42,190.53859307240552,0.47242791072414225,0.7543951899244821,0.10994424539949763,1046022.0482504341,-4638.486120728869,1041383.5621297052,524,0,180.02061855670104,75,119,44,39.440107656571094,0.5403243127147767,44.311951754386,8182.017543859735,109.09356725146314,0
526,32,1,2,191,0.0051813471502590676,0.010362694300518135,0.9896373056994818,193,6250,4200,2050,0.672,83,42,41,182.61325085531004,0.47251457253886014,0.7416162097109333,0.10378609058346464,1041318.5934770484,-6818.285293815391,1034500.308183233,525,0,181.88082901554404,86,107,47,40.228758936812625,0.5369710708117443,44.88745210727969,8163.601532567052,94.92559921589596,8
527,32,2,3,190,0.010362694300518135,0.015544041450777202,0.9844559585492227,193,5450,3400,2050,0.6238532110091743,75,34,41,179.43361465413145,0.47261464630109384,0.7377856166885361,0.1025717528545267,1043121.7777777878,-6615.777777777251,1036506.0000000105,526,0,182.279792746114,74,119,46,40.08512837249783,0.5390759930915372,44.6666666666667,8170.666666666745,110.41441441441548,0
528,32,4,3,191,0.020618556701030927,0.015463917525773196,0.9845360824742269,194,6200,4700,1500,0.7580645161290323,77,47,30,174.90306081984812,0.4728368765913502,0.7324237353057454,0.10106625776191759,1046462.464472214,-8394.10238614538,1038068.3620860686,527,0,182.18556701030928,81,113,48,39.785126498443674,0.5420962199312716,44.25813008130084,8183.73983739844,101.03382515306716,0
529,32,2,7,186,0.010362694300518135,0.03626943005181347,0.9637305699481865,193,6500,4400,2100,0.676923076923077,86,44,42,172.49574984783405,0.47298683074265974,0.7271444700668406,0.10027011007283834,1048296.7458677754,-8934.653351698493,1039362.0925160769,528,0,183.84974093264248,87,106,41,39.61878776667899,0.544743091537133,44.03409090909093,8190.909090909145,94.14838035527752,0
530,32,4,5,185,0.021052631578947368,0.02631578947368421,0.9736842105263158,190,5500,3900,1600,0.7090909090909091,71,39,32,174.79393541667366,0.4726521164021164,0.7287987230184696,0.10098599438575503,1046409.8588127678,-6918.780543861867,1039491.0782689059,529,0,186.60526315789474,82,108,48,39.794457803732975,0.5445723684210526,44.26455823293175,8183.534136546237,99.79919678714924,8
531,32,0,1,184,0.0,0.005405405405405406,0.9945945945945946,185,4850,3300,1550,0.6804123711340206,64,33,31,173.49441151101755,0.47167547982765373,0.7199547322838968,0.10061505584930734,1047576.6191893474,-5500.262188208366,1042076.357001139,530,1,191.33513513513515,83,102,41,39.68268391974415,0.5458896396396397,44.122023809523824,8188.095238095278,98.65174985656961,0
532,32,5,0,189,0.026455026455026454,0.0,1.0,189,5600,3700,1900,0.6607142857142857,75,37,38,190.60047888919337,0.47271356336072645,0.7467709794898731,0.1080673024010698,1040574.3662794922,-3733.2054934620846,1036841.1607860301,531,0,188.1851851851852,77,112,36,40.117913000977495,0.5354387125220459,44.97863247863247,8160.683760683743,105.98290598290575,8
533,32,1,1,189,0.005263157894736842,0.005263157894736842,0.9947368421052631,190,6150,4200,1950,0.6829268292682927,81,42,39,192.097353620715,0.47266197902162815,0.7509777248767211,0.10957560976172938,1042455.180603786,-4099.423707561399,1038355.7568962246,532,0,188.18947368421053,71,119,41,39.844945587485114,0.5375,44.74826388888891,8168.055555555597,115.0430359937408,0
534,32,2,1,190,0.010471204188481676,0.005235602094240838,0.9947643979057592,191,5300,3300,2000,0.6226415094339622,73,33,40,209.77032022856994,0.4727117204004776,0.7723123435464643,0.1162461721479027,1033391.0651037233,-145.04507036996074,1033246.0200333534,533,0,188.15183246073298,76,115,40,40.52929486497038,0.524596422338569,45.860389610389596,8132.4675324675,107.00615174299342,8
535,32,4,3,191,0.020618556701030927,0.015463917525773196,0.9845360824742269,194,5450,3800,1650,0.6972477064220184,71,38,33,207.9027769373785,0.4732363833840785,0.7744115454413163,0.11665543788387324,1037313.5600575272,-1117.926061848446,1036195.6339956787,534,0,185.91237113402062,70,124,38,40.08486987419571,0.5280283505154639,45.37852112676056,8147.887323943653,116.3983903420522,0
536,32,5,2,194,0.025510204081632654,0.01020408163265306,0.9897959183673469,196,5650,4100,1550,0.7256637168141593,72,41,31,203.00839876459523,0.4738711189604046,0.7701993126017523,0.1154598638253272,1041541.1021901019,-2561.681719374954,1038979.4204707269,535,0,183.10204081632654,75,121,42,39.68064508908587,0.5284332482993197,44.86019736842107,8164.473684210566,108.85964912280754,6
537,32,3,2,195,0.015228426395939087,0.01015228426395939,0.9898477157360406,197,7250,4800,2450,0.6620689655172414,97,48,49,194.10232428491892,0.47416174591664073,0.7622350656657277,0.11169419090610413,1045174.9105152667,-6075.824116940639,1039099.0863983261,536,0,182.75634517766497,71,126,42,39.454554888863754,0.5318845177664975,44.41550925925928,8178.703703703753,115.19300991132046,0
538,32,4,1,198,0.020100502512562814,0.005025125628140704,0.9949748743718593,199,6200,4700,1500,0.7580645161290323,77,47,30,213.41107871720033,0.47474324484374736,0.7785457901753652,0.12159468438538207,1042100.6944444486,-1520.833333333183,1040579.8611111154,537,0,181.64824120603015,80,119,42,39.34523809523808,0.5325586264656617,44.79166666666668,8166.6666666667,102.08333333333374,8
539,32,3,3,198,0.014925373134328358,0.014925373134328358,0.9850746268656716,201,5950,4300,1650,0.7226890756302521,76,43,33,223.57109661095598,0.47514303482587067,0.7911317506395052,0.1274875544655115,1042354.6485544948,458.0743669713693,1042812.7229214662,538,0,180.82089552238807,66,135,40,39.05415626078663,0.5299543946932006,44.7605721393035,8167.661691542317,123.75244987185329,8
540,32,3,1,200,0.014925373134328358,0.004975124378109453,0.9950248756218906,201,6000,4000,2000,0.6666666666666666,80,40,40,223.0831683325073,0.47544568822553895,0.7887344560430738,0.12817059427006225,1044691.3726108003,410.61226633084425,1045101.9848771312,539,0,181.33333333333334,68,133,42,38.774296939619525,0.5318718905472637,44.474637681159436,8176.811594202933,120.24722932651372,0
541,32,2,1,201,0.009900990099009901,0.0049504950495049506,0.995049504950495,202,7350,5100,2250,0.6938775510204082,96,51,45,220.63445045507615,0.47562517445774427,0.7881792949169386,0.12761770004540993,1046767.2464346066,-1559.4167657052676,1045207.8296689014,540,0,181.12871287128712,72,130,43,38.577522082752196,0.5348597359735974,44.220890410958916,8184.931506849343,113.67960426179644,0
542,32,5,2,204,0.024271844660194174,0.009708737864077669,0.9902912621359223,206,6550,4700,1850,0.7175572519083969,84,47,37,213.90383142684323,0.47560186281474465,0.7873994536367903,0.12515059201090525,1050292.2341457298,-2817.6933996736225,1047474.5407460561,541,0,178.5728155339806,76,130,42,38.31016685147052,0.5378236245954693,43.79058441558443,8198.70129870134,107.8776486671229,0
543,32,0,2,202,0.0,0.00980392156862745,0.9901960784313726,204,6250,4100,2150,0.656,84,41,43,220.50750861461972,0.4753407828648701,0.7906088563518565,0.12947748582755852,1051390.064602359,-682.1192544740261,1050707.945347885,542,1,181.3235294117647,66,138,43,38.00415453663268,0.5391646241830066,43.65671641791044,8202.985074626848,124.28765264586133,0
544,32,1,3,200,0.0049261083743842365,0.014778325123152709,0.9852216748768473,203,6500,4500,2000,0.6923076923076923,85,45,40,231.98922643871188,0.4752505730868653,0.7983472297167928,0.13130590216431107,1040032.4648973309,1155.2654005357836,1041187.7302978666,543,0,183.0985221674877,73,130,37,39.13036476737342,0.5286843185550082,45.04504504504505,8158.558558558567,111.7610761446379,8
545,32,0,2,198,0.0,0.01,0.99,200,7350,5700,1650,0.7755102040816326,90,57,33,234.17742681085537,0.4753873534338358,0.7981133799032776,0.13294819746644373,1040981.6602223783,1404.8813096338672,1042386.5415320122,544,1,185.93,75,125,39,38.9555346587856,0.530625,44.928728070175445,8162.280701754404,108.83040935672538,0
546,32,1,4,195,0.005025125628140704,0.020100502512562814,0.9798994974874372,199,5700,3600,2100,0.631578947368421,78,36,42,233.7419398821501,0.4751017291846438,0.7969887100284838,0.13345910761013124,1042755.1775147967,3247.123602893067,1046002.3011176898,545,0,187.49748743718592,64,135,40,38.74437643858546,0.5327680067001674,44.711538461538474,8169.2307692307995,127.64423076923124,0
547,32,4,3,196,0.020100502512562814,0.01507537688442211,0.9849246231155779,199,6450,4300,2150,0.6666666666666666,86,43,43,228.92181807570927,0.47496637226536725,0.7897031282949871,0.13202771924668583,1045871.4604591867,1634.5592403629835,1047506.0196995497,546,0,188.00502512562815,69,130,42,38.4775211958947,0.5359087102177554,44.33035714285715,8181.428571428596,118.57142857142892,0
548,32,2,3,195,0.010101010101010102,0.015151515151515152,0.9848484848484849,198,6050,4200,1850,0.6942148760330579,79,42,37,225.69200751404767,0.4748110333452973,0.785384516591298,0.13088968559967395,1047584.9648672924,1636.31075248672,1049221.2756197792,547,0,189.82323232323233,72,126,34,38.34602015019704,0.538141835016835,44.12100456621006,8188.127853881313,113.72399797057379,0
549,32,0,6,189,0.0,0.03076923076923077,0.9692307692307692,195,6550,4500,2050,0.6870229007633588,86,45,41,224.55829778687337,0.4742223984492026,0.7788607119833122,0.12724145156768887,1040379.7620031692,1175.181681468308,1041554.9436846374,548,1,193.4820512820513,83,112,36,39.27629925918718,0.535309829059829,45.00248015873012,8159.9206349205415,98.31229680627159,7
550,32,3,3,189,0.015625,0.015625,0.984375,192,6650,4600,2050,0.6917293233082706,87,46,41,227.11920032985353,0.4740577506908086,0.7795822331573046,0.12961350528413323,1042601.1630142283,2308.9484813534846,1044910.1114955818,549,0,196.140625,67,125,39,38.93272923667787,0.5372721354166667,44.730392156862756,8168.627450980416,121.91981270120024,0
551,32,3,3,189,0.015625,0.015625,0.984375,192,6550,4500,2050,0.6870229007633588,86,45,41,221.3898526275531,0.47419182209860383,0.7751846256530968,0.12721699317763463,1044738.3159481185,1308.8923604225765,1046047.208308541,550,0,196.72395833333334,70,122,41,38.81169738378213,0.5397677951388888,44.46889671361504,8176.9953051643515,116.81421864520502,0
552,32,3,3,189,0.015625,0.015625,0.984375,192,5950,4700,1250,0.7899159663865546,72,47,25,217.58043591550597,0.47403843531849915,0.7623124201788032,0.126196652830992,1047612.456747392,1237.9950019217422,1048850.4517493136,551,0,197.171875,84,108,28,38.550147669220955,0.5441080729166667,44.11764705882349,8188.235294117545,97.47899159663744,8
553,32,1,2,188,0.005263157894736842,0.010526315789473684,0.9894736842105263,190,6100,4400,1700,0.7213114754098361,78,44,34,217.0334264752296,0.47326533927411124,0.7601251923450423,0.12638161346648435,1048837.9698485618,1426.5796827111471,1050264.5495312728,552,0,200.2263157894737,85,105,29,38.41127353581226,0.5459429824561404,43.96802325581394,8193.023255813914,96.3885088919284,0
554,32,1,1,188,0.005291005291005291,0.005291005291005291,0.9947089947089947,189,4900,3800,1100,0.7755102040816326,60,38,22,215.751479967061,0.47298913655296637,0.7612794658270685,0.12628685133434484,1050426.3659786102,2626.2086112615098,1053052.5745898718,553,0,201.91534391534393,85,104,34,38.24611578582459,0.5476741622574957,43.77422480620156,8199.224806201575,96.46146830825383,0
555,32,2,0,190,0.010526315789473684,0.0,1.0,190,5650,4200,1450,0.7433628318584071,71,42,29,212.88171633819337,0.47296365914786964,0.7606090384188322,0.12550489246803964,1052622.7019733533,1166.8254905268582,1053789.5274638801,554,0,199.46315789473684,76,114,36,38.046215717299575,0.5506578947368421,43.50649350649351,8207.792207792223,107.99726589200293,0
556,32,1,2,189,0.005235602094240838,0.010471204188481676,0.9895287958115183,191,6000,4200,1800,0.7,78,42,36,198.24519152440973,0.47299301919720765,0.7572681578614684,0.11728693350779112,1053693.4765139888,-2422.066988092659,1051271.4095258962,555,0,199.41361256544502,77,114,37,38.28862232861507,0.5495200698080279,43.376068376068375,8211.965811965807,106.64890664890659,7
557,32,1,2,188,0.005263157894736842,0.010526315789473684,0.9894736842105263,190,6100,4600,1500,0.7540983606557377,76,46,30,197.26700527644482,0.47258655899006774,0.7490327215503825,0.11605938341025211,1051992.1111111075,-2595.3333333334854,1049396.777777774,556,0,200.20526315789473,74,116,42,38.525078539703166,0.55,43.58333333333332,8205.333333333305,110.8828828828825,8
558,32,2,1,189,0.010526315789473684,0.005263157894736842,0.9947368421052631,190,7200,5100,2100,0.7083333333333334,93,51,42,195.26869311363487,0.472694467650608,0.7470661396118481,0.11567560499543528,1054087.7641581616,-4033.9319731526266,1050053.832185009,557,0,201.16315789473686,78,112,40,38.316059625329665,0.5521929824561403,43.328059071729946,8213.50210970461,105.30130909877705,0
559,32,3,4,188,0.015625,0.020833333333333332,0.9791666666666666,192,5150,3300,1850,0.6407766990291263,70,33,37,191.55925180032514,0.47253297247673065,0.7424056831100803,0.11448848517495881,1056779.8211423352,-3062.809628858836,1053717.0115134763,558,0,200.03125,81,111,41,38.07744509251479,0.5545247395833333,43.00050813008128,8223.983739837342,101.530663454782,0
560,32,1,1,188,0.005291005291005291,0.005291005291005291,0.9947089947089947,189,6050,4600,1450,0.7603305785123967,75,46,29,193.2927321616027,0.4715913355097752,0.7421418629812981,0.11600960990015256,1058047.7028596222,-2947.4137513915557,1055100.2891082307,559,0,203.6931216931217,82,107,44,37.87579306979012,0.556712962962963,42.84638554216865,8228.915662650532,100.35263003232356,0
561,32,2,1,189,0.010526315789473684,0.005263157894736842,0.9947368421052631,190,5800,4200,1600,0.7241379310344828,74,42,32,191.51806538784015,0.4711129676041957,0.7433690117486023,0.11572886553090438,1060099.0401234545,-3194.376543210048,1056904.6635802444,560,0,203.6,74,116,43,37.66749401967661,0.5589912280701754,42.597222222222214,8236.888888888872,111.30930930930909,0
562,32,1,2,188,0.005263157894736842,0.010526315789473684,0.9894736842105263,190,6800,5100,1700,0.75,85,51,34,207.36030592500626,0.4712823725981621,0.7678850863047246,0.12220463224577127,1052510.0359537136,-1150.2393911000113,1051359.7965626135,561,0,204.35263157894738,67,123,44,38.20184803599513,0.5483552631578947,43.52022058823527,8207.352941176421,122.49780509218539,8
563,32,2,0,190,0.010526315789473684,0.0,1.0,190,6800,5400,1400,0.7941176470588235,82,54,28,201.71477173624447,0.47147614406386334,0.7593509582589404,0.11972007823516258,1054662.4362354148,-2251.801483196747,1052410.6347522181,562,0,204.58947368421053,71,119,44,38.07923851384344,0.5508771929824561,43.25810185185181,8215.740740740657,115.71465832029095,0
564,32,1,3,188,0.005235602094240838,0.015706806282722512,0.9842931937172775,191,6100,4300,1800,0.7049180327868853,79,43,36,201.37110410581823,0.47165885918985945,0.7598300219619614,0.12003742548002846,1055984.5956790016,-1771.0432098772012,1054213.5524691246,563,0,204.5130890052356,74,117,40,37.92394262132595,0.5525196335078534,43.097222222222186,8220.888888888803,111.09309309309194,0
565,32,1,1,188,0.005291005291005291,0.005291005291005291,0.9947089947089947,189,5600,4000,1600,0.7142857142857143,72,40,32,202.26510397364166,0.47147641562535175,0.7588210218722937,0.12118909170857549,1057535.3642751346,-619.4999178178746,1056915.8643573169,564,0,207.005291005291,77,112,42,37.70859306010075,0.5542879188712522,42.908653846153804,8226.923076922973,106.84315684315548,0
566,32,0,2,186,0.0,0.010638297872340425,0.9893617021276596,188,5750,4300,1450,0.7478260869565218,72,43,29,200.39738236728658,0.47092542287708117,0.7571150889481497,0.11752010530624102,1051001.8720263788,-1226.395196559387,1049775.4768298194,565,1,209.09574468085106,67,121,44,38.56794025063251,0.5515846631205674,43.70404411764704,8201.470588235252,122.41000877963063,8
567,32,2,2,186,0.010638297872340425,0.010638297872340425,0.9893617021276596,188,5700,3900,1800,0.6842105263157895,75,39,36,199.29714133775934,0.47026704782493267,0.7555588669759246,0.11771435470381292,1053189.0624999963,-1320.486111111345,1051868.576388885,566,0,209.69148936170214,69,119,46,38.32428271755311,0.5542996453900709,43.437499999999986,8209.99999999997,118.98550724637639,0
568,32,1,1,186,0.0053475935828877,0.0053475935828877,0.9946524064171123,187,5950,4100,1850,0.6890756302521008,78,41,37,198.04269506493242,0.47020609318996415,0.7505802765630507,0.11758902715218245,1054787.5578302867,-1571.4058652666645,1053216.15196502,567,0,208.94652406417111,75,112,48,38.15798546237475,0.5568181818181819,43.24287280701752,8216.228070175383,109.54970760233843,0
569,32,1,3,184,0.0053475935828877,0.016042780748663103,0.983957219251337,187,5900,4300,1600,0.7288135593220338,75,43,32,195.43562152120597,0.4700311942959002,0.7472136888610679,0.11650433998151229,1055997.770221517,-2024.0838903505146,1053973.6863311664,568,0,209.79679144385025,77,110,38,38.07479293375614,0.558545008912656,43.095619658119624,8220.940170940083,106.76545676545562,0
570,32,0,1,183,0.0,0.005434782608695652,0.9945652173913043,184,5700,3800,1900,0.6666666666666666,76,38,38,194.14674926194974,0.4694485279559674,0.7415521074822751,0.11594574020168838,1056546.7825443675,-1474.97534516823,1055071.8071991992,569,1,212.19021739130434,77,107,38,38.03983473651387,0.5605185688405797,43.02884615384612,8223.076923076835,106.79320679320564,0
571,32,1,2,182,0.005434782608695652,0.010869565217391304,0.9891304347826086,184,6050,4400,1650,0.7272727272727273,77,44,33,195.49431180900564,0.4693625267284391,0.743596587782059,0.11735600784887061,1058112.2504340226,-1479.0147569447208,1056633.235677078,570,0,213.17391304347825,79,105,41,37.81118143459913,0.5623867753623188,42.83854166666665,8229.166666666626,104.16666666666615,0
572,32,1,1,182,0.00546448087431694,0.00546448087431694,0.994535519125683,183,5350,3900,1450,0.7289719626168224,68,39,29,192.5933326162013,0.46930608098640886,0.7383393938835305,0.11607158321176352,1059303.1476391025,-1147.0553090706208,1058156.092330032,571,0,213.62295081967213,71,112,44,37.73832115078254,0.565004553734062,42.69386574074074,8233.796296296292,115.96896191966609,0
573,32,0,0,182,0.0,0.0,1.0,182,5900,4400,1500,0.7457627118644068,74,44,30,192.34825205930443,0.46868106571145246,0.7372704664246019,0.11636973807186991,1060459.2800148153,-1504.5022218162335,1058954.777792999,572,1,215.28021978021977,73,109,41,37.6015523903257,0.5665064102564102,42.553490990991,8238.288288288313,112.85326422312758,0
574,32,1,0,183,0.00546448087431694,0.0,1.0,183,6400,4800,1600,0.75,80,48,32,191.12920907260232,0.46848290598290593,0.7374424066623824,0.11622956140206099,1062007.0869161661,-2403.8850896429917,1059603.201826523,573,0,215.0983606557377,75,108,43,37.441535440052476,0.5682490892531876,42.365679824561404,8244.298245614033,109.9239766081871,0
575,32,0,0,183,0.0,0.0,1.0,183,6900,4900,2000,0.7101449275362319,89,49,40,195.3762510742115,0.46801877539582454,0.7425746605919605,0.11932980257917303,1063309.1583741007,-1950.9285807983524,1061358.2297933022,574,1,216.0983606557377,76,107,44,37.171144696333634,0.5699567395264117,42.20779220779223,8249.350649350707,108.54408749145666,0
576,32,0,1,182,0.0,0.00546448087431694,0.994535519125683,183,4800,2800,2000,0.5833333333333334,68,28,40,193.36519113375277,0.46781485818371066,0.740053144062784,0.11850797357603295,1064336.111111114,-238.88888888878455,1064097.2222222253,575,2,217.0983606557377,79,104,45,37.09612277867532,0.5710382513661203,42.08333333333334,8253.333333333358,104.47257383966276,0
577,32,1,1,182,0.00546448087431694,0.00546448087431694,0.994535519125683,183,5350,4000,1350,0.7476635514018691,67,40,27,192.87271799434018,0.46766848816029144,0.7405021061608319,0.11886505177212664,1065993.2936124383,-829.795219445833,1065163.4983929924,576,0,217.8415300546448,81,102,40,36.90424192463539,0.5732012750455373,41.88262195121953,8259.756097561016,101.97229750075329,0
578,32,1,6,177,0.00546448087431694,0.03278688524590164,0.9672131147540983,183,5050,3600,1450,0.7128712871287128,65,36,29,202.45676370225385,0.46748708941331896,0.7479404712752238,0.1210651726628075,1056939.0215576962,1146.8907470394865,1058085.9123047357,577,0,218.65573770491804,83,100,34,37.777630351571304,0.5618169398907105,42.98115079365079,8224.603174603166,99.09160451329116,8
579,32,0,1,176,0.0,0.005649717514124294,0.9943502824858758,177,5000,4100,900,0.82,59,41,18,202.73746016944472,0.46657785481938024,0.7410202361806943,0.12159499660279807,1057841.1638521953,2492.8061644167174,1060333.970016612,578,1,225.57627118644066,82,95,35,37.658527756084894,0.5638535781544256,42.8714859437751,8228.112449799191,100.34283475364867,0
580,32,2,0,178,0.011235955056179775,0.0,1.0,178,5600,4100,1500,0.7321428571428571,71,41,30,216.10718620021663,0.46711869696777336,0.7634447936805082,0.12721170339708673,1052155.4076631754,4275.668919086125,1056431.0765822616,579,0,224.23033707865167,66,112,40,38.02165433895154,0.5545411985018727,43.56343283582089,8205.97014925372,124.33288104929879,8
581,32,1,1,178,0.00558659217877095,0.00558659217877095,0.994413407821229,179,5800,4300,1500,0.7413793103448276,73,43,30,216.39032582454078,0.46708592262465215,0.763110024097784,0.1283711670971138,1054522.6032355297,4037.697940695628,1058560.3011762253,580,0,223.97206703910615,67,112,41,37.71984456113137,0.5566224394785848,43.27512254901959,8215.196078431336,122.61486684225875,0
582,32,2,0,180,0.011111111111111112,0.0,1.0,180,5900,4800,1100,0.8135593220338984,70,48,22,211.2703248342249,0.4671373887854335,0.7593050488672706,0.12619948943487438,1056612.6736111077,2746.1805555553774,1059358.854166663,581,0,223.65,69,111,38,37.59162613160385,0.5586805555555556,43.02083333333332,8223.333333333307,119.17874396135227,0
583,32,1,1,180,0.0055248618784530384,0.0055248618784530384,0.994475138121547,181,6750,5100,1650,0.7555555555555555,84,51,33,209.96147989141215,0.46682141395539184,0.7586901149650995,0.12638913457782955,1058945.8081490032,1517.5658007543643,1060463.3739497575,582,0,223.40883977900552,71,110,43,37.33574213624265,0.5608310313075506,42.73726851851851,8232.40740740739,115.94940010432944,0
584,32,1,0,181,0.0055248618784530384,0.0,1.0,181,6350,4700,1650,0.7401574803149606,80,47,33,209.03996217115116,0.4666692244730919,0.7584016558943498,0.12680878462306774,1061267.8890306156,1819.4798752836027,1063087.368905899,583,0,224.1767955801105,69,112,42,37.07164490283316,0.5631330570902394,42.45535714285715,8241.428571428598,119.44099378882026,0
585,32,1,3,179,0.005494505494505495,0.016483516483516484,0.9835164835164835,182,5350,4000,1350,0.7476635514018691,67,40,27,207.762757025663,0.4665384109444883,0.7575007077448557,0.1268142871506082,1063118.519724156,2425.286940586659,1065543.8066647428,584,0,223.93956043956044,71,111,43,36.87542094628725,0.565018315018315,42.23090277777779,8248.611111111148,116.1776212832556,0
586,32,1,2,178,0.005555555555555556,0.011111111111111112,0.9888888888888889,180,6500,4500,2000,0.6923076923076923,85,45,40,204.48856388275092,0.46630198634388575,0.7503189328482629,0.12545205668401205,1064638.1971075896,1041.2671962508325,1065679.4643038404,585,0,225.2277777777778,73,107,37,36.771884947703526,0.5670138888888889,42.046734234234265,8254.504504504575,113.07540417129556,0
587,32,0,0,178,0.0,0.0,1.0,178,4500,3300,1200,0.7333333333333333,57,33,24,209.72966666458206,0.46557005014917796,0.7528684479915637,0.12891833635016156,1065219.25219139,4581.615737359507,1069800.8679287494,586,2,228.4438202247191,73,105,39,36.5648299690853,0.5678838951310862,41.97635135135138,8256.75675675683,113.10625694187438,0
588,32,0,1,177,0.0,0.0056179775280898875,0.9943820224719101,178,6050,4300,1750,0.7107438016528925,78,43,35,213.40466073691974,0.46517197782432973,0.7574379942970888,0.1316479398976809,1066285.7067901231,3860.0679012345827,1070145.7746913577,587,3,229.4438202247191,74,104,39,36.338121626226226,0.5695224719101124,41.84722222222222,8260.888888888887,111.63363363363361,0
589,32,0,1,176,0.0,0.005649717514124294,0.9943502824858758,177,5200,4000,1200,0.7692307692307693,64,40,24,214.62018730489035,0.46437494649888716,0.7581100783670487,0.13306451612903225,1067777.7777777796,5233.333333333418,1073011.111111113,588,4,231.29943502824858,76,101,40,36.12231182795699,0.5722104519774012,41.66666666666667,8266.66666666668,108.77192982456158,0
590,32,1,1,176,0.005649717514124294,0.005649717514124294,0.9943502824858758,177,4550,3200,1350,0.7032967032967034,59,32,27,197.06106624789402,0.4642880071905496,0.7366440933032379,0.11782559212588692,1056905.454966252,1704.9831757726288,1058610.4381420247,589,0,231.85875706214688,78,99,46,37.920471646487435,0.5583215630885122,42.985232067510516,8224.47257383958,105.4419560748664,8
591,32,2,1,177,0.011235955056179775,0.0056179775280898875,0.9943820224719101,178,5100,3400,1700,0.6666666666666666,68,34,34,196.37078326358863,0.46417018451511877,0.735297761580227,0.11809904852612928,1058667.4408477203,878.2709149848652,1059545.7117627051,590,0,231.5,82,96,49,37.719859972677554,0.5604517790262172,42.77108433734937,8231.325301204755,100.38201586835068,0
592,32,1,4,174,0.0056179775280898875,0.02247191011235955,0.9775280898876404,178,5750,4200,1550,0.7304347826086957,73,42,31,209.35689321450536,0.4644327006496117,0.7429420926424346,0.12439565665602643,1055004.5545806088,2824.495174829928,1057829.0497554387,591,0,232.19101123595505,81,97,38,37.840523069819625,0.5564138576779026,43.216463414634156,8217.073170731725,101.44534778681141,8
593,32,1,1,174,0.005714285714285714,0.005714285714285714,0.9942857142857143,175,4100,2900,1200,0.7073170731707317,53,29,24,215.52815220707882,0.46431444991789816,0.745535846737448,0.1284593522571107,1055944.2156826318,6417.141127966232,1062361.3568105982,592,0,233.04,81,94,31,37.56526191300334,0.557797619047619,43.10213414634147,8220.731707317093,101.4905149051493,0
594,32,2,1,175,0.011363636363636364,0.005681818181818182,0.9943181818181818,176,6150,4300,1850,0.6991869918699187,80,43,37,211.92134051024686,0.46459956709956707,0.7444871819871821,0.12698936882503484,1057570.263840831,3474.3415993848403,1061044.6054402157,593,0,232.4375,84,92,36,37.45600759489648,0.5600142045454546,42.904411764705884,8227.058823529414,97.94117647058826,0
595,32,1,1,175,0.005681818181818182,0.005681818181818182,0.9943181818181818,176,5900,4400,1500,0.7457627118644068,74,44,30,213.22749235808826,0.4647558170995671,0.7479213966555724,0.1285080330232361,1059304.8254314677,4074.582313915127,1063379.4077453827,594,0,233.4090909090909,70,106,39,37.207183449272065,0.5623224431818181,42.693661971831006,8233.802816901454,117.62575452716364,0
596,32,0,1,174,0.0,0.005714285714285714,0.9942857142857143,175,5250,3500,1750,0.6666666666666666,70,35,35,217.02124954693937,0.4640749863163656,0.7530244412495106,0.12821850040800153,1053273.3805020957,5466.541030218366,1058739.921532314,595,1,235.00571428571428,70,105,43,37.85905573345531,0.5560119047619048,43.427230046948324,8210.32863849758,117.290409121394,8
597,32,0,1,173,0.0,0.005747126436781609,0.9942528735632183,174,5850,4100,1750,0.7008547008547008,76,41,35,215.6597148549914,0.4638112362412243,0.7485578563955093,0.1281688353569243,1055071.3611111054,4857.27777777747,1059928.638888883,596,2,237.2816091954023,74,100,40,37.67037157228623,0.5578903256704981,43.208333333333314,8217.333333333288,111.04504504504443,0
598,32,2,1,174,0.011428571428571429,0.005714285714285714,0.9942857142857143,175,5650,4000,1650,0.7079646017699115,73,40,33,208.44535744647123,0.4642966611932129,0.7411253186096269,0.12466671348549968,1056988.7741465068,3414.8805687752138,1060403.654715282,597,0,236.82857142857142,81,94,36,37.617536944595486,0.5602380952380952,42.97510162601626,8224.79674796748,101.54070059219111,0
599,32,1,1,174,0.005714285714285714,0.005714285714285714,0.9942857142857143,175,6500,4900,1600,0.7538461538461538,81,49,32,207.41695673117403,0.4638574165298303,0.7420972952123832,0.12466053606378599,1058469.449266969,2408.902391975026,1060878.351658944,598,0,237.78857142857143,83,92,37,37.46027393407584,0.5619047619047619,42.79513888888887,8230.555555555506,99.16331994645188,0
600,32,1,1,174,0.005714285714285714,0.005714285714285714,0.9942857142857143,175,5050,3500,1550,0.693069306930693,66,35,31,209.61731561630856,0.4636808976464149,0.7460391975487068,0.12664165938579464,1060041.8402777815,4390.625000000154,1064432.4652777817,599,0,238.75428571428571,69,106,39,37.20870430325105,0.5636904761904762,42.60416666666668,8236.666666666695,119.37198067632892,0
601,32,0,2,172,0.0,0.011494252873563218,0.9885057471264368,174,5050,3700,1350,0.7326732673267327,64,37,27,208.71102133568974,0.4631703596660244,0.7418029187653368,0.12653461102776856,1061090.7493141314,4442.266803841108,1065533.0161179726,600,1,239.32183908045977,71,103,40,37.102059925093656,0.5653136973180077,42.47685185185186,8240.74074074076,116.06677099634875,0
602,32,1,2,171,0.005780346820809248,0.011560693641618497,0.9884393063583815,173,4350,3400,950,0.7816091954022989,53,34,19,206.70242481044704,0.46288563651028364,0.7377331605450743,0.12576374820133232,1062159.2623456852,4960.179012346085,1067119.4413580312,601,0,241.41618497109826,74,99,38,37.02147682964085,0.5668352601156069,42.34722222222224,8244.888888888936,111.41741741741805,0
603,32,2,0,173,0.011560693641618497,0.0,1.0,173,5750,4300,1450,0.7478260869565218,72,43,29,208.57259091080394,0.46258597705784826,0.7439240825640709,0.1280265884532574,1064799.0887984908,4067.580950033006,1068866.6697485237,602,0,241.9942196531792,77,96,36,36.64663897085467,0.569364161849711,42.0272435897436,8255.128205128229,107.20945720945751,0
604,32,0,0,173,0.0,0.0,1.0,173,6050,4500,1550,0.743801652892562,76,45,31,226.7048899365464,0.46261258233633556,0.7642236272057821,0.13259225465158536,1050181.3239069784,6966.2482899498555,1057147.5721969283,603,1,242.9942196531792,76,97,40,37.99602650755095,0.5528660886319846,43.80411255411257,8198.26839826844,107.87195260879525,8
605,32,2,2,173,0.011428571428571429,0.011428571428571429,0.9885714285714285,175,5450,4200,1250,0.7706422018348624,67,42,25,220.62123787949537,0.4633292282430213,0.7604082607953571,0.129859336220209,1052132.893598613,5974.572279892184,1058107.4658785053,604,0,241.2057142857143,67,108,42,37.908701712465124,0.554702380952381,43.566176470588225,8205.882352941155,122.47585601404708,0
606,32,1,2,172,0.005747126436781609,0.011494252873563218,0.9885057471264368,174,5800,4500,1300,0.7758620689655172,71,45,26,215.47320804220212,0.4636645128784356,0.7545511882215055,0.1250723128731002,1047853.5617070517,4556.873699893207,1052410.435406945,605,0,242.9712643678161,76,98,37,38.57398988564078,0.548551245210728,44.08820346320346,8189.177489177487,107.7523353839143,8
607,32,1,0,173,0.005780346820809248,0.0,1.0,173,5800,4300,1500,0.7413793103448276,73,43,30,226.4851165755686,0.4636739929201954,0.7692955934106942,0.13271722134862896,1050767.36593364,7196.633873456615,1057963.9998070966,606,0,245.14450867052022,59,114,41,37.928564573312535,0.5490727360308285,43.73263888888888,8200.555555555538,138.9924670433142,8
608,32,2,0,175,0.011428571428571429,0.0,1.0,175,5350,4300,1050,0.8037383177570093,64,43,21,200.17892117328142,0.4645032840722496,0.7298388066079942,0.11694778371330404,1049839.706184586,1681.1559577812131,1051520.8621423673,607,0,243.33142857142857,86,89,38,38.71811800816432,0.5519047619047619,43.845785440613035,8196.934865900404,95.31319611512099,8
609,32,2,0,177,0.011299435028248588,0.0,1.0,177,4350,2800,1550,0.6436781609195402,59,28,31,198.87377783174676,0.4645782507276151,0.729836857022079,0.11678693342158865,1051422.373456784,2070.067901234289,1053492.4413580184,608,0,241.57062146892656,74,103,40,38.554703725777,0.5535546139359699,43.65277777777776,8203.111111111064,110.85285285285222,0
610,32,0,4,173,0.0,0.022598870056497175,0.9774011299435028,177,6650,5000,1650,0.7518796992481203,83,50,33,221.42904355872685,0.46439634694401644,0.7684534472463345,0.12969415408439797,1050625.0000000072,4477.777777778082,1055102.7777777852,609,1,242.57062146892656,79,98,39,38.075880758807585,0.5523775894538606,43.75000000000002,8200.000000000056,103.79746835443109,8
611,32,3,2,174,0.017045454545454544,0.011363636363636364,0.9886363636363636,176,5500,4000,1500,0.7272727272727273,70,40,30,212.46606793717578,0.4639042207792208,0.7585402750963965,0.12571217155809444,1053722.0858421444,4076.0376554880013,1057798.1234976323,610,0,242.82954545454547,68,108,40,37.920122752318754,0.5559895833333333,43.37258454106281,8212.077294685998,120.76584256891174,0
612,32,0,2,172,0.0,0.011494252873563218,0.9885057471264368,174,5050,3500,1550,0.693069306930693,66,35,31,211.66164897959146,0.4633226197594844,0.7549504105090306,0.12564717968598574,1054719.3568295562,4798.727655447708,1059518.084485004,611,1,246.1551724137931,70,104,44,37.816785714285714,0.5574113984674329,43.2511737089202,8215.962441314578,117.37089201877968,0
613,32,2,4,170,0.011494252873563218,0.022988505747126436,0.9770114942528736,174,5750,4500,1250,0.782608695652174,70,45,25,210.8588233552142,0.462815316811729,0.7531536533440648,0.12621523617911742,1057240.9382716066,4035.7160493827637,1061276.6543209893,612,0,247.05172413793105,74,100,36,37.524201246307896,0.5595067049808429,42.94444444444445,8225.77777777779,111.15915915915933,0
614,32,0,1,169,0.0,0.0058823529411764705,0.9941176470588236,170,5150,3300,1850,0.6407766990291263,70,33,37,209.20418182555073,0.46208521870286573,0.7456182602672692,0.12550895082042263,1057926.5308641968,5114.530864197437,1063041.0617283944,613,1,252.34117647058824,74,96,38,37.48165802455795,0.5612745098039216,42.86111111111111,8228.444444444438,111.19519519519511,0
615,32,1,0,170,0.0058823529411764705,0.0,1.0,170,6200,4900,1300,0.7903225806451613,75,49,26,207.8737395082614,0.4621026221139343,0.744792378325865,0.125137591102311,1058958.3453562616,3825.92624653725,1062784.271602799,614,0,253.31764705882352,75,95,40,37.38789735393359,0.5631127450980392,42.73574561403508,8232.456140350861,109.76608187134482,0
616,32,1,0,171,0.005847953216374269,0.0,1.0,171,7150,5400,1750,0.7552447552447552,89,54,35,205.6554493091205,0.4621947024423805,0.7425103441652694,0.12463487767680054,1060976.8670639326,2289.1348605231688,1063266.0019244559,615,0,252.83040935672514,66,105,40,37.19485197931131,0.5655458089668616,42.49067164179104,8240.298507462674,124.8530076888284,0
617,32,2,0,173,0.011560693641618497,0.0,1.0,173,5750,4100,1650,0.7130434782608696,74,41,33,216.3716807519209,0.4631278845722992,0.7569750883823394,0.12816936051429736,1054069.9835709522,5264.1787950793605,1059334.1623660317,616,0,250.89595375722544,66,107,41,37.77661679487957,0.5529865125240847,43.33022388059702,8213.432835820904,124.44595205789248,8
618,32,2,0,175,0.011428571428571429,0.0,1.0,175,5550,3300,2250,0.5945945945945946,78,33,45,215.8812150313012,0.46337164750957854,0.7584557306742099,0.1292263330564892,1057252.2020818216,5098.177995988615,1062350.3800778103,617,0,249.01714285714286,70,105,38,37.393698989783694,0.5560119047619048,42.9430751173709,8225.821596244159,117.51173708920227,0
619,32,1,0,176,0.005681818181818182,0.0,1.0,176,5550,3900,1650,0.7027027027027027,72,39,33,215.4484476757435,0.4637608225108225,0.7592616756683161,0.1295925647731272,1058714.1407862627,4869.663632951734,1063583.8044192144,618,0,248.5965909090909,72,104,43,37.22333166916291,0.5577651515151515,42.765410958904106,8231.50684931506,114.32648401826471,0
620,32,0,1,175,0.0,0.005681818181818182,0.9943181818181818,176,4850,3500,1350,0.7216494845360825,62,35,27,220.614147564765,0.46354640151515153,0.7535376422005595,0.13487212038705754,1063592.697427159,6878.719259800395,1070471.4166869593,619,1,249.5965909090909,73,103,44,36.48540438232512,0.5662286931818181,42.17342342342343,8250.450450450466,113.01986918425295,8
621,32,0,2,173,0.0,0.011428571428571429,0.9885714285714285,175,5850,5000,850,0.8547008547008547,67,50,17,218.13519868358983,0.46312807881773393,0.7492283945992113,0.1337288005820364,1064425.4347744628,5587.730739678924,1070013.1655141418,620,2,251.14285714285714,76,99,35,36.4462044127417,0.5676190476190477,42.07251082251083,8253.67965367967,108.6010480747325,0
622,32,1,2,172,0.005747126436781609,0.011494252873563218,0.9885057471264368,174,4050,2600,1450,0.6419753086419753,55,26,29,226.69849500398195,0.46272396075565303,0.7570547672799319,0.13984207722305392,1066271.3650173626,9494.422743055571,1075765.7877604181,621,0,252.93103448275863,79,95,37,35.99671307037893,0.5694444444444444,41.848958333333336,8260.833333333345,104.56751054852336,0
623,32,0,2,170,0.0,0.011627906976744186,0.9883720930232558,172,5800,4000,1800,0.6896551724137931,76,40,36,223.37469912824625,0.46162209868987714,0.749826991218814,0.1385489636121623,1067899.0644768456,7508.326445370193,1075407.3909222158,622,1,256.6918604651163,70,102,38,35.88115452325515,0.5711603682170543,41.65199530516432,8267.136150234743,118.10194500335346,0
624,32,2,0,172,0.011627906976744186,0.0,1.0,172,5050,3400,1650,0.6732673267326733,67,34,33,214.13685929120325,0.46162989029421103,0.7379165140974,0.1338232866645943,1070127.553948579,6380.750688705384,1076508.3046372843,623,0,254.22674418604652,76,96,40,35.844623459050425,0.5741279069767442,41.382575757575765,8275.757575757592,108.89154704944201,0
625,32,0,1,171,0.0,0.005813953488372093,0.9941860465116279,172,6400,4600,1800,0.71875,82,46,36,216.73841919635822,0.46105047826284057,0.7407663599119849,0.1361196966259471,1071583.4715428918,5650.66153183067,1077234.1330747225,624,1,255.22674418604652,76,96,40,35.5976650984492,0.5758236434108528,41.20670995670997,8281.385281385317,108.96559580770155,0
626,32,1,1,171,0.005813953488372093,0.005813953488372093,0.9941860465116279,172,5700,4400,1300,0.7719298245614035,70,44,26,213.8276668494419,0.46098602044516973,0.7370406175988553,0.13521575347434234,1073598.1879340312,5812.999131944668,1079411.187065976,625,0,256.06976744186045,79,93,37,35.42462551523076,0.5779433139534884,40.96354166666668,8289.166666666693,104.92616033755309,0
627,32,1,0,172,0.005813953488372093,0.0,1.0,172,5100,3900,1200,0.7647058823529411,63,39,24,212.47798656616126,0.460641064871481,0.7355755583094017,0.13473231109614983,1074403.879242684,6157.43460407187,1080561.3138467558,626,0,257.0639534883721,81,91,38,35.360342418746015,0.5794573643410852,40.8663617886179,8292.276422764262,102.37378299708965,0
628,32,0,3,169,0.0,0.01744186046511628,0.9825581395348837,172,4650,3400,1250,0.7311827956989247,59,34,25,213.2014349357472,0.4604044834307992,0.7448195281265835,0.13142118302755806,1066056.2500000042,6406.944444444681,1072463.194444449,627,1,258.0639534883721,74,98,42,36.37173796072103,0.5686773255813953,41.875000000000014,8260.000000000033,111.62162162162207,8
629,32,0,0,169,0.0,0.0,1.0,169,5700,4100,1600,0.7192982456140351,73,41,32,214.67519563972692,0.4593914365548981,0.7426635557568468,0.1326236826596402,1066716.3978284444,6299.510279185213,1073015.9081076295,628,2,263.03550295857985,72,97,43,36.25207239568944,0.5700197238658777,41.79509132420092,8262.557077625575,114.7577371892441,0
630,32,3,0,172,0.01744186046511628,0.0,1.0,172,4750,3400,1350,0.7157894736842105,61,34,27,207.44742181521522,0.4593703250373997,0.7391316254521885,0.12930424548305325,1069355.0421267853,5216.989298860608,1074572.0314256458,629,0,259.43023255813955,70,102,42,36.112923973289426,0.5725532945736433,41.47593896713616,8272.769953051664,118.18242790073805,0
631,32,2,1,173,0.011494252873563218,0.005747126436781609,0.9942528735632183,174,5550,4200,1350,0.7567567567567568,69,42,27,236.71715504184903,0.4601784488295351,0.7805140154270394,0.14177684853362893,1057419.0365484348,9711.845203767312,1067130.881752202,630,0,257.4367816091954,67,107,40,36.837335637389266,0.554477969348659,42.92279411764703,8226.47058823523,122.78314310798851,8
632,32,3,1,175,0.017045454545454544,0.005681818181818182,0.9943181818181818,176,5550,3600,1950,0.6486486486486487,75,36,39,232.6337732314951,0.4602272727272727,0.7795660655506587,0.1408816451938059,1060756.9492669762,8603.578317901292,1069360.5275848776,631,0,254.9318181818182,59,117,40,36.52744532847865,0.5575284090909092,42.517361111111114,8239.44444444445,139.65160075329578,0
633,32,1,0,176,0.005681818181818182,0.0,1.0,176,6000,4400,1600,0.7333333333333333,76,44,32,227.44870183795078,0.4603848755411255,0.774268506288406,0.1383748251381535,1062134.2129177495,7116.209581163022,1069250.4224989126,632,0,255.91477272727272,63,113,42,36.490050536955145,0.5592447916666667,42.35026041666666,8244.791666666648,130.8697089947087,0
634,32,1,2,175,0.005649717514124294,0.011299435028248588,0.9887005649717514,177,6050,3600,2450,0.5950413223140496,85,36,49,227.74150170168937,0.46107794042116074,0.7773308417962861,0.13587205982390282,1056241.9401747445,6660.0251231403045,1062901.9652978848,633,0,255.4632768361582,66,111,38,37.21446508532011,0.5500235404896422,43.065920398009936,8221.890547263652,124.57409920096443,8
635,32,1,2,174,0.005681818181818182,0.011363636363636364,0.9886363636363636,176,4900,3000,1900,0.6122448979591837,68,30,38,206.4711473655559,0.46042816558441557,0.7461791642816271,0.12112326878697913,1051106.2757609752,3304.623751900708,1054410.8995128758,634,0,256.8863636363636,70,106,41,38.39927971761115,0.5522608901515151,43.69131455399059,8201.877934272246,117.1696847753178,8
636,32,0,4,170,0.0,0.022988505747126436,0.9770114942528736,174,5050,3500,1550,0.693069306930693,66,35,31,207.79001155390995,0.4602005957522202,0.7451412332398777,0.12223312123620575,1051948.7735292776,3866.8895611538073,1055815.6630904314,635,1,259.9367816091954,70,104,40,38.26064255879157,0.5539990421455938,43.58861502347416,8205.164319248792,117.2166331321256,0
637,32,5,1,174,0.02857142857142857,0.005714285714285714,0.9942857142857143,175,4400,3000,1400,0.6818181818181818,58,30,28,200.67254939092064,0.46026409414340447,0.7394509540835383,0.11941577970900101,1055463.342687167,2960.5039531390685,1058423.846640306,636,0,256.9428571428571,75,100,43,38.00657496842587,0.5566666666666666,43.16063596491226,8218.85964912276,109.5847953216368,0
638,32,1,2,173,0.005714285714285714,0.011428571428571429,0.9885714285714285,175,5200,3400,1800,0.6538461538461539,70,34,36,201.04741053611878,0.46025451559934316,0.7405631036655984,0.12029521856940045,1057122.3561929078,2306.342466484516,1059428.6986593923,637,0,254.31428571428572,78,97,40,37.79111521493791,0.5584523809523809,42.95886075949364,8225.316455696124,105.45277507302723,0
639,32,0,0,173,0.0,0.0,1.0,173,5700,4000,1700,0.7017543859649122,74,40,34,207.86306720136923,0.4596369919792087,0.7464131610184812,0.12474865310872535,1058033.8490027399,3685.232211315833,1061719.0812140557,638,2,258.23121387283237,81,92,40,37.502830196446475,0.559971098265896,42.848069105691046,8228.86178861786,101.59088627923283,0
640,32,1,1,173,0.005747126436781609,0.005747126436781609,0.9942528735632183,174,5400,3900,1500,0.7222222222222222,69,39,30,215.13796279925015,0.4597694228511948,0.7566087094167357,0.12999358073373607,1060080.2579144025,5412.7014182814255,1065492.959332684,639,0,257.7413793103448,66,108,39,37.06184062172827,0.5618414750957854,42.59950248756217,8236.815920397967,124.80024121815102,0
641,32,1,0,174,0.005747126436781609,0.0,1.0,174,6050,4500,1550,0.743801652892562,76,45,31,213.29379522635992,0.4596898323477953,0.7526851116833493,0.1298278363971794,1062283.3210090876,4465.688228737956,1066749.0092378256,640,0,258.52298850574715,71,103,41,36.83628111547817,0.5644157088122606,42.332175925925924,8245.370370370369,116.13197704746997,0
642,32,1,2,173,0.005714285714285714,0.011428571428571429,0.9885714285714285,175,5300,4200,1100,0.7924528301886793,64,42,22,215.93796426296723,0.4595128626163109,0.7570684694378804,0.1322701251508468,1064173.467174946,5659.0904248843535,1069832.5575998304,641,0,258.04,73,102,45,36.53406609901204,0.5662499999999999,42.10304054054054,8252.702702702709,113.05072195483163,0
643,32,1,1,173,0.005747126436781609,0.005747126436781609,0.9942528735632183,174,5900,4500,1400,0.7627118644067796,73,45,28,218.57874473719167,0.45954726153301,0.7591480290876931,0.1348573613262153,1066324.448684436,5915.171895204536,1072239.6205796406,642,0,259.1609195402299,76,98,42,36.19975894775456,0.5686063218390804,41.84253246753248,8261.038961038988,108.69788106630249,0
644,32,0,0,173,0.0,0.0,1.0,173,5450,3700,1750,0.6788990825688074,72,37,35,220.0783955253013,0.4587870233454317,0.7601027415402448,0.13639717502614884,1067665.9480941189,6944.041762710933,1074609.9898568299,643,1,261.47398843930637,76,97,44,35.99513397922671,0.5702071290944124,41.68019480519482,8266.233766233807,108.7662337662343,0
645,32,1,4,170,0.005747126436781609,0.022988505747126436,0.9770114942528736,174,5550,4000,1550,0.7207207207207207,71,40,31,216.92803217984223,0.45887039620844683,0.7577856249162784,0.13521959100174705,1069368.1130834976,6045.184089414795,1075413.2971729124,644,0,260.9655172413793,64,110,46,35.86621311678646,0.5720785440613028,41.47435897435897,8272.820512820512,129.2628205128205,0
646,32,2,2,170,0.011627906976744186,0.011627906976744186,0.9883720930232558,172,5100,3400,1700,0.6666666666666666,68,34,34,202.99309255073217,0.4589495784033728,0.7420242577858716,0.12567769664255463,1067357.7648886265,3833.2507105560317,1071191.0155991826,645,0,257.7848837209302,81,91,43,36.47452291953572,0.5702519379844961,41.717479674796756,8265.040650406521,102.03753889390767,8
647,32,0,3,167,0.0,0.01764705882352941,0.9823529411764705,170,6250,4700,1550,0.752,78,47,31,205.5259875434529,0.45844790578953476,0.740717009809732,0.12797215918111537,1069044.4931036145,3693.2850346021223,1072737.7781382166,646,1,260.82941176470587,67,103,40,36.20091067124965,0.5721813725490197,41.513480392156865,8271.568627450984,123.45624817091021,0
648,32,3,1,169,0.01764705882352941,0.0058823529411764705,0.9941176470588236,170,4850,3200,1650,0.6597938144329897,65,32,33,216.7704370411333,0.4590185926441583,0.7528757039881002,0.12975379200379344,1057240.9382716047,6985.71604938265,1064226.6543209874,647,0,259.52941176470586,74,96,38,37.37223993228152,0.5568014705882354,42.94444444444444,8225.777777777776,111.15915915915913,8
649,32,1,1,169,0.0058823529411764705,0.0058823529411764705,0.9941176470588236,170,4950,3300,1650,0.6666666666666666,66,33,33,219.8623620840905,0.458532747418494,0.7570081741136359,0.13225566703827576,1058732.6869806072,7605.093875038338,1066337.7808556457,648,0,260.51176470588234,75,95,42,37.10748792270531,0.5586397058823529,42.763157894736835,8231.578947368404,109.75438596491205,0
650,32,1,1,169,0.0058823529411764705,0.0058823529411764705,0.9941176470588236,170,5100,3800,1300,0.7450980392156863,64,38,26,224.32442413430064,0.4587800208840933,0.7558615697741078,0.12786492175655206,1042227.6676319949,7659.424271676709,1049887.0919036716,649,0,260.79411764705884,66,104,38,39.050824398960394,0.5411764705882354,44.776119402985096,8167.164179104522,123.74491180461398,8
651,32,3,1,171,0.01744186046511628,0.005813953488372093,0.9941860465116279,172,5800,4600,1200,0.7931034482758621,70,46,24,220.4560444922479,0.4594609909787388,0.7523944894082724,0.12687227891745792,1045206.8908012892,5884.435364419302,1051091.3261657085,650,0,258.33720930232556,73,99,36,38.77699831102791,0.5440891472868217,44.41159909909915,8178.828828828947,112.03875107984858,0
652,32,1,0,172,0.005813953488372093,0.0,1.0,172,6850,5600,1250,0.8175182481751825,81,56,25,222.2908338139613,0.4596699476404189,0.7549404719829531,0.12895108067344005,1047665.975308651,5327.308641975849,1052993.2839506269,651,0,259.25,74,98,33,38.42293566362718,0.5463299418604651,44.11111111111114,8188.444444444516,110.65465465465563,0
653,32,0,0,172,0.0,0.0,1.0,172,4600,3400,1200,0.7391304347826086,58,34,24,223.16026943128523,0.4594659492724058,0.7574921567650983,0.12994494491821842,1048827.523853504,7811.326562019691,1056638.8504155239,652,1,260.25,75,97,35,38.25571020699502,0.5475411821705427,43.96929824561407,8192.982456140437,109.23976608187249,0
654,32,3,3,172,0.017142857142857144,0.017142857142857144,0.9828571428571429,175,5350,3400,1950,0.6355140186915887,73,34,39,225.43862065645243,0.46010673234811167,0.7662626964017947,0.1277397446491393,1040378.4811239269,6558.297949046469,1046936.7790729734,653,0,256.77142857142854,78,97,35,39.2540117551752,0.5387500000000001,45.00263713080168,8159.915611814325,104.61430271556826,8
655,32,3,2,173,0.017142857142857144,0.011428571428571429,0.9885714285714285,175,5800,3900,1900,0.6724137931034483,77,39,38,219.6550481227831,0.46070881226053645,0.762624467437613,0.12592227636627124,1044006.1044281102,5064.242221727283,1049070.3466498374,654,0,257.5885714285714,66,109,41,38.947555285047656,0.5418452380952381,44.55845771144279,8174.129353233847,123.85044474596738,0
656,32,0,3,170,0.0,0.017341040462427744,0.9826589595375722,173,5600,4200,1400,0.75,70,42,28,220.29791801172803,0.46020130393870146,0.7595292949080512,0.12695397294610825,1045627.9797335634,5869.933390022877,1051497.9131235862,655,1,259.7976878612717,69,104,40,38.728425694161466,0.5443159922928709,44.36011904761906,8180.476190476217,118.55762594893068,0
657,32,2,2,170,0.011627906976744186,0.011627906976744186,0.9883720930232558,172,4950,3600,1350,0.7272727272727273,63,36,27,221.04337567725287,0.46078768869849046,0.7589561038997577,0.12845099712174846,1048202.4116599759,6989.639893271939,1055192.0515532477,656,0,260.8720930232558,73,99,37,38.38790582778788,0.5470566860465116,44.04560810810813,8190.540540540581,112.19918548685727,0
658,32,1,1,170,0.005847953216374269,0.005847953216374269,0.9941520467836258,171,5150,3700,1450,0.7184466019417476,66,37,29,228.24008995168003,0.4610724114207086,0.7641016540029106,0.13320719552931634,1049530.1998867742,8558.973445832558,1058089.1733326067,657,0,262.7076023391813,77,94,38,38.03794278165953,0.5487329434697856,43.88354700854702,8195.726495726525,106.43800643800682,0
659,32,0,1,169,0.0,0.0058823529411764705,0.9941176470588236,170,5300,3500,1800,0.660377358490566,71,35,36,227.37788353493198,0.4609735758208609,0.7630320420851262,0.13317847464188934,1050625.0000000044,8477.777777778005,1059102.7777777824,658,1,264.5176470588235,79,91,39,37.923441734417366,0.5501838235294118,43.750000000000014,8200.000000000035,103.79746835443082,0
660,32,3,1,171,0.01744186046511628,0.005813953488372093,0.9941860465116279,172,5100,3600,1500,0.7058823529411765,66,36,30,222.53236838471523,0.4610972278888436,0.7592477900424024,0.13148770767822926,1053303.944363997,7378.844273656331,1060682.7886376535,659,0,262.4011627906977,66,106,42,37.71385000706941,0.5524467054263567,43.42350746268655,8210.447761193998,124.40072365445452,0
661,32,0,1,170,0.0,0.005847953216374269,0.9941520467836258,171,4650,3100,1550,0.6666666666666666,62,31,31,223.5575765503364,0.4609706455681688,0.758213872424863,0.1325984160878428,1054466.0646981215,8296.775595696216,1062762.8402938177,660,1,264.7602339181287,68,103,40,37.542879545231756,0.5542153996101364,43.282004830917856,8214.975845410592,120.80846831486166,0
662,32,2,2,170,0.011627906976744186,0.011627906976744186,0.9883720930232558,172,4800,3700,1100,0.7708333333333334,59,37,22,222.1744846864033,0.4609711455641688,0.7566551280974927,0.13250253715729274,1056131.6258261853,7729.099945788874,1063860.7257719743,661,0,264.15697674418607,72,100,36,37.37121632879752,0.5558381782945736,43.079337899543354,8221.461187214558,114.18696093353553,0
663,32,0,0,170,0.0,0.0,1.0,170,5250,4000,1250,0.7619047619047619,65,40,25,224.55835259089514,0.46019694860192595,0.7584602056372269,0.13425983688352522,1056890.181070772,8216.703586148904,1065106.8846569208,662,3,268.2647058823529,70,100,38,37.21564961753625,0.5569852941176471,42.98708920187792,8224.41314553988,117.49161636485543,0
664,32,2,1,171,0.011627906976744186,0.005813953488372093,0.9941860465116279,172,5550,4000,1550,0.7207207207207207,71,40,31,198.4275506234509,0.46136355909152726,0.7311164895296209,0.11479709080571422,1046832.1330589893,1594.0672153636979,1048426.200274353,663,0,266.1337209302326,80,92,44,39.137443438914005,0.548328488372093,44.212962962962976,8185.185185185221,102.31481481481526,8
665,32,1,2,170,0.005813953488372093,0.011627906976744186,0.9883720930232558,172,4850,3300,1550,0.6804123711340206,64,33,31,197.76707155955788,0.4612459766988531,0.73096644241497,0.11492941170264151,1048214.6193771657,2210.4671280278044,1050425.0865051935,664,0,267.1046511627907,84,88,40,38.982153116920415,0.5499031007751938,44.04411764705883,8190.588235294142,97.50700280112073,0
666,32,1,1,170,0.005847953216374269,0.005847953216374269,0.9941520467836258,171,5950,4500,1450,0.7563025210084033,74,45,29,197.0295781986745,0.46137914230019494,0.7290741988282485,0.11514763980009497,1049945.6590944964,1224.0700685835977,1051169.72916308,665,0,265.1812865497076,87,84,42,38.78560949124349,0.5526924951267056,43.83285984848485,8197.348484848488,94.22239637756883,0
667,32,0,0,170,0.0,0.0,1.0,170,6100,4900,1200,0.8032786885245902,73,49,24,194.9090565652891,0.4611998201647523,0.722356800089625,0.11252813033589296,1046192.4556324027,682.4769026073923,1046874.93253501,666,1,265.17058823529413,76,94,44,39.30712799351043,0.5479779411764706,44.29112554112558,8182.683982684078,107.66689450900103,8
668,32,3,3,170,0.017341040462427744,0.017341040462427744,0.9826589595375722,173,5600,4100,1500,0.7321428571428571,71,41,30,189.12993472236116,0.4621434892682708,0.7182234925570044,0.1100450499551425,1048592.2540312514,-535.9630889388263,1048056.2909423126,667,0,261.5549132947977,83,90,38,39.15625201834273,0.5505178227360308,43.9980158730159,8192.063492063566,98.69956014534417,0
669,32,2,2,170,0.011627906976744186,0.011627906976744186,0.9883720930232558,172,4650,3500,1150,0.7526881720430108,58,35,23,210.29192801584534,0.46161076544720975,0.7463529733784777,0.11882011893309188,1039493.5308642067,4669.4197530869415,1044162.9506172937,668,0,264.0639534883721,74,98,39,39.751003523685,0.538578003875969,45.11111111111114,8156.444444444518,110.22222222222322,8
670,32,3,0,173,0.017341040462427744,0.0,1.0,173,5250,4100,1150,0.780952380952381,64,41,23,210.0791336942936,0.4623759353855805,0.7477173528370877,0.1196962505932605,1042100.6944444464,3934.7222222223177,1046035.4166666687,669,0,263.1734104046243,79,94,42,39.43027210884351,0.5411247591522158,44.79166666666667,8166.666666666682,103.37552742616053,0
671,32,0,0,173,0.0,0.0,1.0,173,5200,3800,1400,0.7307692307692307,66,38,28,220.7067992475137,0.46247255455482367,0.7630057803468195,0.12239195230998504,1033611.1111111125,5825.000000000043,1039436.1111111125,670,1,264.1734104046243,64,109,39,40.22370218579232,0.5302866088631984,45.833333333333336,8133.333333333345,127.08333333333351,8
672,32,3,0,176,0.017045454545454544,0.0,1.0,176,4850,2900,1950,0.5979381443298969,68,29,39,211.0539390759878,0.4637966720779221,0.7565327399681534,0.118015452368542,1036229.1884431452,3690.0504012879396,1039919.2388444332,671,0,260.65340909090907,67,109,42,40.14056511968542,0.5324928977272727,45.51164215686274,8143.627450980379,121.54667837284147,0
673,32,5,4,177,0.027624309392265192,0.022099447513812154,0.9779005524861879,181,6300,4700,1600,0.746031746031746,79,47,32,202.27851428183993,0.46511279926335175,0.7530112431466744,0.11472185773890643,1040664.9519311868,-399.1679316353998,1040265.7839995514,672,0,254.4254143646409,76,105,40,39.80877360492258,0.5359116022099448,44.96753246753247,8161.03896103897,107.38209159261802,0
674,32,3,2,178,0.016666666666666666,0.011111111111111112,0.9888888888888889,180,5100,3600,1500,0.7058823529411765,66,36,30,206.46224388869817,0.46477213945789364,0.7561328499559967,0.11824401632054826,1043704.0683563208,1997.0967817218443,1045701.1651380426,673,0,256.3388888888889,68,112,43,39.32227016589824,0.5386574074074074,44.59541062801932,8172.94685990338,120.19039499857911,0
675,32,2,0,180,0.011111111111111112,0.0,1.0,180,5700,4600,1100,0.8070175438596491,68,46,22,204.05611599099242,0.4646311814607904,0.75286986394811,0.1177165964689826,1045949.8472717414,986.4926711285689,1046936.33994287,674,0,254.95,72,108,44,39.103485322022564,0.5409722222222222,44.32077625570776,8181.735159817349,113.63521055301874,0
676,32,0,0,180,0.0,0.0,1.0,180,5500,3400,2100,0.6181818181818182,76,34,42,204.82809620802422,0.46436284398924066,0.7534155551936117,0.11860197120577173,1047097.4104938271,1394.9938271605397,1048492.4043209876,675,1,255.95,74,106,44,38.94065457770058,0.5426504629629629,44.18055555555556,8186.222222222221,110.6246246246246,0
677,32,3,2,181,0.01639344262295082,0.01092896174863388,0.9890710382513661,183,5800,4300,1500,0.7413793103448276,73,43,30,204.86764256325543,0.46534533317320204,0.757743176805955,0.11970544359687542,1049886.9609349854,617.5733289301406,1050504.5342639156,676,0,252.7377049180328,80,103,43,38.59213146576971,0.5453096539162112,43.840020576131685,8197.119341563779,102.46399176954723,0
678,32,1,1,181,0.005494505494505495,0.005494505494505495,0.9945054945054945,182,5200,4100,1100,0.7884615384615384,63,41,22,207.00653344986367,0.46498960293849795,0.7588975256791481,0.12134917292992363,1050883.8543260884,1907.9647484949364,1052791.8190745835,677,0,255.03846153846155,65,117,45,38.413238494067386,0.546875,43.71843434343434,8201.010101010095,126.16938616938609,0
679,32,4,1,184,0.021621621621621623,0.005405405405405406,0.9945945945945946,185,6250,4300,1950,0.688,82,43,39,203.60063940825705,0.46528716216216215,0.7584538421500535,0.12081409254001632,1054598.8209184648,-306.6011483614925,1054292.2197701032,678,0,251.85945945945946,70,115,46,38.038721260262434,0.5499436936936937,43.26584507042252,8215.49295774645,117.36418511066357,0
680,32,2,0,186,0.010752688172043012,0.0,1.0,186,5950,4300,1650,0.7226890756302521,76,43,33,203.65442829587937,0.4659340792405309,0.7598771441039249,0.12179908962510476,1056983.1264964254,-98.14113099599172,1056884.9853654294,679,0,251.46236559139786,73,113,42,37.741376398853554,0.5524193548387097,42.97578828828828,8224.774774774747,112.66814759965408,0
681,32,0,0,186,0.0,0.0,1.0,186,5700,4100,1600,0.7192982456140351,73,41,32,205.7541754810504,0.4658129904097646,0.7623368657623975,0.12343223394129207,1057909.5427775735,633.8611415468986,1058543.4039191203,680,1,252.46236559139786,73,113,44,37.57247814820896,0.5535394265232976,42.86317567567567,8228.378378378367,112.71751203258037,0
682,32,2,1,187,0.010638297872340425,0.005319148936170213,0.9946808510638298,188,6400,4300,2100,0.671875,85,43,42,196.7213904249184,0.46645961334243563,0.7534629063455422,0.11885541129499916,1060054.2748955695,-2292.9298233327618,1057761.3450722368,681,0,250.7659574468085,68,120,45,37.539100684261975,0.5557956560283688,42.60265700483094,8236.714975845458,121.12816140949202,0
683,32,1,1,187,0.005319148936170213,0.005319148936170213,0.9946808510638298,188,5650,4000,1650,0.7079646017699115,73,40,33,200.27994633674592,0.46598849888117727,0.7577086799761097,0.12184283172433046,1062126.5447845887,-705.470521541491,1061421.0742630472,682,0,251.73936170212767,69,119,47,37.19100150167496,0.5574024822695036,42.3511904761905,8244.761904761968,119.48930296756475,0
684,32,1,0,188,0.005319148936170213,0.0,1.0,188,6650,4800,1850,0.7218045112781954,85,48,37,187.21733547257233,0.46622909318466266,0.7380134516703662,0.10927055997527506,1049545.29669633,-4951.3852189481895,1044593.9114773817,683,0,252.31914893617022,86,102,39,39.08672650491641,0.5478723404255319,43.88170498084294,8195.785440613106,95.29983070480357,8
685,32,4,1,191,0.020833333333333332,0.005208333333333333,0.9947916666666666,192,6350,4200,2150,0.6614173228346457,85,42,43,199.54379746914395,0.4669786667393834,0.7532674001248445,0.11839598649835845,1054571.0059171566,-2663.3793556871706,1051907.6265614694,684,0,248.04166666666666,77,115,41,38.14632750728254,0.5515407986111112,43.26923076923076,8215.384615384592,106.69330669330638,0
686,32,2,2,191,0.010362694300518135,0.010362694300518135,0.9896373056994818,193,5950,3800,2150,0.6386554621848739,81,38,43,196.22119344540147,0.46697116076568795,0.7512831918191485,0.11728597779845121,1056808.7712294983,-3076.3443331558756,1053732.4268963425,685,0,247.69430051813472,82,111,42,37.95404417749129,0.553972366148532,42.996987951807235,8224.096385542185,100.29385836027055,0
687,32,0,1,190,0.0,0.005235602094240838,0.9947643979057592,191,5250,3800,1450,0.7238095238095238,67,38,29,199.41541770825768,0.4661706622577386,0.7530358361231821,0.11956851563802778,1057755.1118827122,-1263.4645061729407,1056491.6473765392,686,1,251.2565445026178,83,108,46,37.754613999549896,0.5553010471204188,42.881944444444436,8227.777777777748,99.12985274431021,0
688,32,0,0,190,0.0,0.0,1.0,190,5700,4300,1400,0.7543859649122807,71,43,28,201.60609583082268,0.46586199294532626,0.7555333963808122,0.12117801204918138,1058494.0858912847,-1020.2279766883594,1057473.8579145963,687,2,253.42631578947368,86,104,46,37.60667845948547,0.5565241228070175,42.79214559386974,8230.651340996194,95.70524815111852,0
689,32,3,0,193,0.015544041450777202,0.0,1.0,193,5050,3700,1350,0.7326732673267327,64,37,27,194.53432518716923,0.4661784416378814,0.7502878447516232,0.11787401161473599,1060923.1983250116,-2372.8043076862377,1058550.3940173255,688,0,250.47150259067357,73,120,49,37.487871043568575,0.5586679620034543,42.497184684684676,8240.09009009007,112.87794643959,0
690,32,3,2,194,0.015306122448979591,0.01020408163265306,0.9897959183673469,196,5500,4000,1500,0.7272727272727273,70,40,30,190.72754235703036,0.46628510378510374,0.7497423732167074,0.1167233698652229,1063906.2934027729,-4116.753472222489,1059789.5399305504,689,0,247.62244897959184,79,117,47,37.217228842658,0.5611181972789115,42.13541666666665,8251.666666666628,104.45147679324846,0
691,32,3,3,194,0.015228426395939087,0.015228426395939087,0.9847715736040609,197,5600,3700,1900,0.6607142857142857,75,37,38,187.13257460763586,0.4661158879795573,0.7467555542331168,0.11526458346577975,1065830.9146864687,-5109.663367662195,1060721.2513188065,690,0,243.95939086294416,83,114,37,37.072432694309654,0.5630287648054145,41.902281746031726,8259.126984126924,99.5075540256256,0
692,32,1,3,192,0.005128205128205128,0.015384615384615385,0.9846153846153847,195,6450,4600,1850,0.7131782945736435,83,46,37,202.12790504001762,0.4654176579434311,0.7660034263860154,0.12195974464358428,1059654.019020667,-2612.8706136232704,1057041.148407044,691,0,247.44615384615383,72,123,43,37.449519452915666,0.559241452991453,42.65125570776257,8235.159817351634,114.37721968543936,8
693,32,0,2,190,0.0,0.010416666666666666,0.9895833333333334,192,5650,4300,1350,0.7610619469026548,70,43,27,200.18611514088147,0.46470797429464805,0.7605983460907586,0.12115830727752272,1060575.2500811676,-1587.5121743362506,1058987.7379068313,692,1,252.27604166666666,73,119,43,37.385410971386925,0.5607096354166667,42.53941441441443,8238.73873873878,112.85943477724358,0
694,32,0,2,188,0.0,0.010526315789473684,0.9894736842105263,190,6200,4800,1400,0.7741935483870968,76,48,28,201.71274202533388,0.4645142949967511,0.7590607645441303,0.12254065595623613,1061701.2623456854,-1368.2654320984066,1060332.996913587,693,2,254.81052631578947,74,116,42,37.206713574522404,0.5625,42.4027777777778,8243.111111111162,111.39339339339408,0
695,32,2,0,190,0.010526315789473684,0.0,1.0,190,6300,4500,1800,0.7142857142857143,81,45,36,200.37553198673746,0.46486180729601784,0.7584479982142571,0.1227160725581119,1064121.1914062544,-1655.2300347219716,1062465.9613715324,694,0,253.53157894736842,79,111,43,36.94187788212327,0.5647478070175438,42.109375000000014,8252.500000000035,104.46202531645613,0
696,32,1,2,189,0.005235602094240838,0.010471204188481676,0.9895287958115183,191,7050,5200,1850,0.7375886524822695,89,52,37,201.02990851342622,0.4646275374299624,0.7580835171190543,0.12394433927770274,1066118.4497024277,-2385.6611183688474,1063732.7885840589,695,0,253.19895287958116,82,109,37,36.67823398807213,0.5696989528795812,41.86746987951808,8260.240963855449,100.73464590067621,8
697,32,0,0,189,0.0,0.0,1.0,189,4700,2800,1900,0.5957446808510638,66,28,38,204.79217531104348,0.4642962681526512,0.7604096305823063,0.1265676663894071,1066832.8649654684,1195.8046219183966,1068028.6695873868,696,1,256.5925925925926,81,108,38,36.492872780046255,0.5707671957671958,41.780995934959364,8263.008130081338,102.01244605038688,0
698,32,0,3,186,0.0,0.015873015873015872,0.9841269841269842,189,6150,4200,1950,0.6829268292682927,81,42,39,214.51553118706954,0.46414030545236223,0.775287682782621,0.12862247031904814,1057755.1118827122,1430.9799382715078,1059186.0918209837,697,2,257.5925925925926,83,106,41,37.36636281791584,0.5597442680776015,42.881944444444436,8227.777777777748,99.12985274431021,8
699,32,0,2,184,0.0,0.010752688172043012,0.989247311827957,186,6250,3800,2450,0.608,87,38,49,212.98102233815806,0.4632198730989054,0.7702316760589385,0.12805685146629323,1058592.6352556504,1642.0283392787878,1060234.6635949293,698,3,262.494623655914,86,100,43,37.30187822929759,0.5616599462365591,42.78017241379311,8231.03448275864,95.70970328789116,0
700,32,2,0,186,0.010752688172043012,0.0,1.0,186,4650,3500,1150,0.7526881720430108,58,35,23,209.32310706226082,0.4634941393005909,0.7669774320848335,0.1267932290670111,1060824.2660575316,2561.0062836412403,1063385.272341173,699,0,263.23655913978496,67,119,45,37.119313562178995,0.5641801075268817,42.50919117647061,8239.705882352986,122.9806848112386,0
701,32,2,2,186,0.010638297872340425,0.010638297872340425,0.9893617021276596,188,5150,3600,1550,0.6990291262135923,67,36,31,203.56018160763318,0.4635440370538931,0.7630721453830986,0.1235588787303343,1061448.4504940445,463.7278699418466,1061912.1783639863,700,0,261.4255319148936,71,117,40,37.19041968582072,0.561114804964539,42.43344907407408,8242.129629629653,116.08633281168525,8
702,32,0,1,185,0.0,0.005376344086021506,0.9946236559139785,186,5350,3700,1650,0.6915887850467289,70,37,33,208.18056743269256,0.4630067567567568,0.7665746583533277,0.11889300315829754,1042829.9886621268,869.387755101754,1043699.3764172286,701,1,264.63440860215053,69,117,39,39.38758063262608,0.5372423835125448,44.702380952380935,8169.523809523772,118.39889579019959,8
703,32,3,0,188,0.015957446808510637,0.0,1.0,188,4550,2600,1950,0.5714285714285714,65,26,39,202.64522049457958,0.46368388990025405,0.7569765567995155,0.11160750092824208,1031439.8878661614,-346.72729929181605,1031093.1605668695,702,0,262.7925531914894,77,111,38,40.95527386212217,0.5236591312056738,46.100427350427324,8124.786324786257,105.51670551670463,8
704,32,2,1,189,0.010526315789473684,0.005263157894736842,0.9947368421052631,190,5850,4100,1750,0.7008547008547008,76,41,35,201.24259726779155,0.46424278288313375,0.7559670288856681,0.11176469403254162,1034081.8437071284,-2229.736796982387,1031852.1069101461,703,0,261.0157894736842,71,119,43,40.65938235070946,0.5260964912280701,45.77546296296295,8135.185185185148,114.58007303077673,0
705,32,2,0,191,0.010471204188481676,0.0,1.0,191,5750,3900,1850,0.6782608695652174,76,39,37,200.33697541793816,0.46446449894369435,0.7569086811595447,0.11229898346822012,1037002.7777777753,-2400.0000000001664,1034602.7777777752,704,0,260.6178010471204,74,117,41,40.316421167485,0.5285776614310645,45.41666666666666,8146.666666666647,110.09009009008983,0
706,32,2,2,191,0.010362694300518135,0.010362694300518135,0.9896373056994818,193,5050,3500,1550,0.693069306930693,66,35,31,198.89155166390074,0.4652789022020725,0.7581594111665291,0.11200734751598616,1038458.0498866203,-2341.8934240364033,1036116.1564625838,705,0,258.90673575129534,76,117,44,40.1710961838006,0.5301165803108808,45.238095238095234,8152.380952380944,107.26817042606505,0
707,32,0,1,190,0.0,0.005235602094240838,0.9947643979057592,191,6450,4800,1650,0.7441860465116279,81,48,33,236.95486203738537,0.4650753191880224,0.7905990371424616,0.12912139273587903,1028054.7511200131,4070.5143437038364,1032125.2654637169,706,1,260.29842931937173,66,125,38,40.51101979064442,0.518869982547993,46.51741293532335,8111.442786069582,122.90064827378156,8
708,32,6,2,194,0.030612244897959183,0.01020408163265306,0.9897959183673469,196,5700,4200,1500,0.7368421052631579,72,42,30,222.54832131324082,0.4660659776731206,0.7798716620754629,0.12271029876029152,1031804.4938271528,1025.2716049378641,1032829.7654320906,707,0,254.62244897959184,74,122,37,40.404064573762085,0.5217899659863945,46.05555555555553,8126.222222222161,109.81381381381298,0
709,32,2,0,196,0.01020408163265306,0.0,1.0,196,6100,4200,1900,0.6885245901639344,80,42,38,226.2568246219455,0.4659237092272806,0.7854484178992691,0.12557023362419567,1033864.0287369109,1483.7584465729706,1035347.7871834838,708,0,255.6122448979592,66,130,41,40.05084097859326,0.5237563775510203,45.80223880597014,8134.3283582089425,123.24739936680216,0
710,32,1,1,196,0.005076142131979695,0.005076142131979695,0.9949238578680203,197,6050,4700,1350,0.7768595041322314,74,47,27,213.8540276431633,0.46622919472357466,0.7800794442108856,0.12084221597106028,1039517.9085661081,-988.9816891882801,1038528.9268769198,709,0,255.30964467005077,78,119,37,39.65715689824631,0.529980964467005,45.10812236286918,8156.540084388147,104.57102672292497,8
711,32,2,4,194,0.010101010101010102,0.020202020202020204,0.9797979797979798,198,6350,3800,2550,0.5984251968503937,89,38,51,211.9635007409171,0.46665470269531184,0.7809300250797908,0.12106181300027893,1042851.4423539069,-1740.7115051900937,1041110.7308487168,710,0,254.75757575757575,67,131,40,39.28832153286133,0.5331439393939394,44.6997549019608,8169.607843137292,121.93444541995957,0
712,32,1,3,192,0.005128205128205128,0.015384615384615385,0.9846153846153847,195,6100,4400,1700,0.7213114754098361,78,44,34,192.19231441185235,0.4659309190237025,0.7575515744932821,0.10438588382937969,1027006.3990794551,-5623.452649027631,1021382.9464304275,711,0,259.43589743589746,72,123,42,41.777433586783104,0.5163995726495727,46.64668949771688,8107.305936073017,112.60147133434745,8
713,32,3,1,194,0.015384615384615385,0.005128205128205128,0.9948717948717949,195,6750,4300,2450,0.6370370370370371,92,43,49,186.24527852077262,0.46668979645783765,0.7506398292512533,0.10203499001168663,1029763.6880165235,-7392.27502295712,1022371.4129935664,712,0,260.0,76,119,42,41.58190245116338,0.5194978632478633,46.306818181818166,8118.181818181774,106.81818181818124,0
714,32,4,0,198,0.020202020202020204,0.0,1.0,198,5700,4200,1500,0.7368421052631579,72,42,30,183.060406828071,0.46789596472337586,0.7499889141791787,0.10116393423457953,1032514.9966359074,-7497.476931949344,1025017.5197039581,713,0,255.36363636363637,84,114,44,41.31781964076092,0.5227272727272727,45.968137254901954,8129.019607843123,96.77404295051336,0
715,32,2,3,197,0.01,0.015,0.985,200,6700,5000,1700,0.746268656716418,84,50,34,183.1089149810476,0.4685311976549414,0.7522746143057504,0.10202927194551917,1035120.413591246,-8792.044838514965,1026328.368752731,714,0,253.8,72,128,44,40.990416082281435,0.5252083333333333,45.64783105022829,8139.269406392652,113.04540842212016,0
716,32,4,2,199,0.01990049751243781,0.009950248756218905,0.9900497512437811,201,6750,4900,1850,0.725925925925926,86,49,37,176.91407429520513,0.46933043117744605,0.7441361061452489,0.0996023258258286,1038369.2845693617,-10209.571848767706,1028159.712720594,715,0,252.80597014925374,81,120,45,40.742079718094445,0.5281923714759535,45.24898373983737,8152.032520325137,100.64237679413749,0
717,32,4,5,198,0.019704433497536946,0.024630541871921183,0.9753694581280788,203,5450,3900,1550,0.7155963302752294,70,39,31,170.90523009666694,0.4707654570875807,0.7376498033277414,0.09679112183924925,1040222.1006287058,-10494.120508082937,1029727.9801206229,716,0,248.4679802955665,85,118,42,40.66409157126349,0.5305316091954023,45.02180232558136,8159.302325581297,95.99179206566231,0
718,32,0,2,196,0.0,0.010101010101010102,0.98989898989899,198,7350,5400,1950,0.7346938775510204,93,54,39,196.27308183870161,0.4698929865490779,0.7557699973574254,0.11044509958636285,1038209.5878493849,-6195.480919662714,1032014.1069297221,717,1,253.45959595959596,82,116,38,40.26888210080306,0.5303556397306397,45.26857429718874,8151.405622489922,99.407385640121,8
719,32,4,5,195,0.02,0.025,0.975,200,6000,4400,1600,0.7333333333333333,76,44,32,195.49673190024373,0.4707610971524288,0.7578420271022834,0.11097375076360505,1040940.979396234,-5299.888085399525,1035641.0913108345,718,0,251.775,87,113,36,39.94724955138913,0.5327083333333333,44.93371212121212,8162.121212121204,93.81748519679545,0
720,32,3,1,197,0.015151515151515152,0.005050505050505051,0.9949494949494949,198,6200,4600,1600,0.7419354838709677,78,46,32,212.32746052269152,0.47007832128390503,0.7693683485525107,0.11759132115990988,1033197.8732897147,-1924.7438693896302,1031273.129420325,719,0,253.45454545454547,81,117,36,40.48856895287613,0.5242003367003367,45.884146341463435,8131.70731707322,100.39144835892864,8
721,32,7,1,203,0.03431372549019608,0.004901960784313725,0.9950980392156863,204,6750,5100,1650,0.7555555555555555,84,51,33,205.82003903244458,0.47145201471393156,0.7698132530474036,0.11557054628695733,1037540.991225459,-4840.654537642932,1032700.3366878161,720,0,246.94607843137254,81,123,42,40.109415012138776,0.5283394607843137,45.350609756097555,8148.780487804862,100.60222824450447,0
722,32,1,2,202,0.004901960784313725,0.00980392156862745,0.9901960784313726,204,5600,3600,2000,0.6428571428571429,76,36,40,205.13150801072743,0.47147867767796775,0.7707199167900425,0.11565634565792283,1038823.4892380775,-3780.914219125455,1035042.5750189521,721,0,247.91666666666666,82,122,31,39.96638427818548,0.5298202614379085,45.19327309236948,8153.815261044183,99.43677147614858,0
723,32,0,2,200,0.0,0.009900990099009901,0.9900990099009901,202,7150,5600,1550,0.7832167832167832,87,56,31,207.20352387163268,0.47168191632596096,0.7722870983786605,0.11740771731530353,1040379.7620031763,-4435.929429642472,1035943.8325735338,722,1,250.91584158415841,83,119,33,39.718841689766386,0.5316109735973598,45.002480158730144,8159.920634920598,98.31229680627226,0
724,32,2,1,201,0.009900990099009901,0.0049504950495049506,0.995049504950495,202,5100,3400,1700,0.6666666666666666,68,34,34,215.57411756860378,0.4720549480321166,0.7916234891136344,0.12139573509003994,1038441.2006226442,-727.7909057783722,1037713.4097168657,723,0,251.83168316831683,71,131,45,39.74819931095844,0.5272277227722773,45.240162037037045,8152.314814814829,114.82133541992718,8
725,32,2,1,202,0.009852216748768473,0.0049261083743842365,0.9950738916256158,203,5550,3900,1650,0.7027027027027027,72,39,33,223.94660260142643,0.47284543725308487,0.7989589034847651,0.1240319645177141,1033212.4567474135,126.88389081171954,1033339.3406382252,724,0,249.6600985221675,84,119,38,40.19147456918729,0.5210899014778325,45.8823529411765,8131.764705882421,96.80672268907645,8
726,32,3,1,204,0.014634146341463415,0.004878048780487805,0.9951219512195122,205,6700,4400,2300,0.6567164179104478,90,44,46,218.61420647898547,0.4731537940379404,0.7962549627224873,0.1226656822968903,1037313.5600575355,-2345.703839625794,1034967.8562179097,725,0,248.15121951219513,70,135,39,39.812133871122626,0.5244918699186991,45.37852112676059,8147.88732394372,116.39839034205313,0
727,32,1,4,201,0.004878048780487805,0.01951219512195122,0.9804878048780488,205,7550,5700,1850,0.7549668874172185,94,57,37,217.6495482184874,0.4732962697274032,0.7952149930218639,0.12288828337874667,1039266.9753086478,-3310.8024691355586,1035956.1728395122,726,0,245.609756097561,74,131,39,39.591848319709364,0.5269817073170732,45.13888888888891,8155.555555555602,110.21021021021083,0
728,32,3,4,200,0.014705882352941176,0.0196078431372549,0.9803921568627451,204,6400,4500,1900,0.703125,83,45,38,213.2197983757528,0.47346028928812905,0.791546581116348,0.12031255542472548,1039073.0261306039,-2889.811774149956,1036183.2143564539,727,0,247.47549019607843,72,132,35,39.729034847042584,0.5255821078431373,45.162671232876704,8154.794520547927,113.2610350076101,8
729,32,0,4,196,0.0,0.02,0.98,200,6100,4200,1900,0.6885245901639344,80,42,38,232.0537634609043,0.4731270938023451,0.803111362386161,0.12935712517832582,1035255.6287282517,1946.992958095222,1037202.621686347,728,1,250.405,66,134,38,39.72849560947781,0.5210416666666666,45.63121890547264,8139.800995024894,123.33031810643779,8
730,32,3,3,196,0.01507537688442211,0.01507537688442211,0.9849246231155779,199,5850,4300,1550,0.7350427350427351,74,43,31,234.70594780475247,0.4732247094056139,0.8047527745835013,0.13224865313359296,1038628.9233838089,3104.477176045331,1041733.4005598542,729,0,247.7537688442211,70,129,39,39.23723079580791,0.5251256281407035,45.217136150234744,8153.051643192493,116.47216633132133,0
731,32,1,3,194,0.005076142131979695,0.015228426395939087,0.9847715736040609,197,6700,4700,2000,0.7014925373134329,87,47,40,242.86060293957092,0.4728732863703857,0.8105567870587136,0.1377372222152881,1040663.3969505662,4447.228008111544,1045110.6249586778,730,0,250.48223350253807,70,127,36,38.77399374868169,0.5271785109983079,44.967723004694854,8161.032863849807,116.58618376928295,0
732,32,4,3,195,0.020202020202020204,0.015151515151515152,0.9848484848484849,198,5600,3600,2000,0.6428571428571429,76,36,40,232.51084404640898,0.4733774932061734,0.8037430214396502,0.13289381269808562,1043077.1298038205,3305.3487712386104,1046382.4785750591,731,0,249.84343434343435,60,138,40,38.73548131799536,0.5298295454545454,44.672131147541,8170.491803278723,136.17486338797872,0
733,32,2,2,195,0.01015228426395939,0.01015228426395939,0.9898477157360406,197,7150,4900,2250,0.6853146853146853,94,49,45,208.69249783655488,0.4738110345661107,0.7687045928054941,0.11922293652708656,1042927.922587669,-3019.753354337742,1039908.1692333312,732,0,251.3451776649746,71,126,39,39.36227356868968,0.5288705583756346,44.69039351851854,8169.907407407456,115.06911841418952,8
734,32,1,1,195,0.00510204081632653,0.00510204081632653,0.9948979591836735,196,5350,3800,1550,0.7102803738317757,69,38,31,207.52526872144213,0.4738700287807431,0.7672399060990629,0.11920881891872318,1044631.3205097091,-1192.5208992770972,1043438.799610432,733,0,252.51020408163265,73,123,43,39.179337446746,0.530984268707483,44.48198198198202,8176.576576576657,112.00789830926928,0
735,32,0,1,194,0.0,0.005128205128205128,0.9948717948717949,195,6650,5000,1650,0.7518796992481203,83,50,33,242.4461718698538,0.47375980262578204,0.8022037590639937,0.13461666400409658,1034008.2846747474,4488.270060221175,1038496.5547349686,734,1,254.7948717948718,63,132,41,39.62114785410934,0.5185897435897435,45.78450520833332,8134.8958333333085,129.12533068783029,8
736,32,2,1,195,0.01020408163265306,0.00510204081632653,0.9948979591836735,196,5350,3800,1550,0.7102803738317757,69,38,31,230.46024188856393,0.47422106663178093,0.7944051803820937,0.1291942936130309,1037026.3504425961,3248.668713562937,1040275.019156159,735,0,252.29591836734693,71,125,39,39.54657280597072,0.5236500850340136,45.41377314814813,8146.759259259219,114.74308815858055,8
737,32,6,3,198,0.029850746268656716,0.014925373134328358,0.9850746268656716,201,6100,4400,1700,0.7213114754098361,78,44,34,239.4681084808736,0.4750010364842454,0.8041466834297561,0.13418214647174295,1036881.5511621336,3360.012755102188,1040241.5639172358,736,0,246.87562189054725,69,132,39,39.33544504199065,0.5242019071310116,45.43154761904763,8146.1904761904925,118.06073153899264,8
738,32,5,4,199,0.024630541871921183,0.019704433497536946,0.9802955665024631,203,6450,4600,1850,0.7131782945736435,83,46,37,231.13021968423058,0.4751540424978458,0.799317252780787,0.1310927771104762,1040683.3526234525,1056.674382715838,1041740.0270061684,737,0,243.27586206896552,77,126,36,39.0706546403449,0.5282738095238095,44.965277777777764,8161.111111111078,105.98845598845556,0
739,32,0,8,191,0.0,0.04020100502512563,0.9597989949748744,199,6000,4100,1900,0.6833333333333333,79,41,38,234.37577414037955,0.47467239395631355,0.7995872475148114,0.13335027077109238,1041658.8221032245,3027.9185641199547,1044686.7406673444,738,1,248.85427135678393,76,123,39,38.86558241874764,0.5298890284757118,44.84577922077923,8164.935064935089,107.43335611756696,0
740,32,3,2,192,0.015463917525773196,0.010309278350515464,0.9896907216494846,194,6300,4100,2200,0.6507936507936508,85,41,44,237.8812933587566,0.4748288463935331,0.8004924814498644,0.13670337868713334,1044760.8100043414,4605.810546875078,1049366.6205512164,739,0,254.1237113402062,63,131,40,38.38747346072185,0.5332903780068728,44.466145833333336,8177.083333333342,129.7949735449737,0
741,32,2,2,192,0.010309278350515464,0.010309278350515464,0.9896907216494846,194,5800,4100,1700,0.7068965517241379,75,41,34,233.98056715800615,0.4751604704164663,0.7962592646790463,0.13552172843285373,1047187.4229734652,4404.301429612437,1051591.7244030775,740,0,254.60309278350516,71,123,43,38.1836250447699,0.5354381443298969,44.16956018518518,8186.574074074073,115.30386019822637,0
742,32,2,1,193,0.010309278350515464,0.005154639175257732,0.9948453608247423,194,5450,3800,1650,0.6972477064220184,71,38,33,227.57133772772147,0.4753830368748108,0.7928018741555276,0.1304300450212932,1043933.7647929032,3263.880670611694,1047197.645463515,741,0,254.39175257731958,64,130,42,38.7543917435222,0.5347938144329897,44.56730769230771,8173.846153846184,127.71634615384663,8
743,32,3,1,195,0.015306122448979591,0.00510204081632653,0.9948979591836735,196,5000,3100,1900,0.62,69,31,38,218.0578794957152,0.47558869701726847,0.7857180080203279,0.12593455063010964,1046294.8936907502,1430.5691690799267,1047725.4628598301,742,0,252.77551020408163,66,130,41,38.70240049448764,0.5366709183673469,44.27860696517413,8183.084577114428,123.98612995627921,0
744,32,5,4,196,0.025,0.02,0.98,200,5950,3800,2150,0.6386554621848739,81,38,43,213.25747209539688,0.47618770938023447,0.784238542410941,0.12125847092969283,1041462.771267363,-1530.0564236110727,1039932.7148437519,743,0,248.485,79,121,39,39.42894933823278,0.5358854166666667,44.86979166666667,8164.166666666682,103.34388185654028,8
745,32,0,2,194,0.0,0.01020408163265306,0.9897959183673469,196,5700,3900,1800,0.6842105263157895,75,39,36,209.6210696049406,0.47550747863247866,0.7656406825025035,0.11624441132637836,1033611.1111111317,-1566.6666666658102,1032044.4444444659,744,1,254.43367346938774,98,98,37,40.50546448087437,0.5297087585034014,45.833333333333385,8133.333333333497,82.99319727891323,8
746,32,4,5,193,0.020202020202020204,0.025252525252525252,0.9747474747474747,198,6000,4100,1900,0.6833333333333333,79,41,38,200.9810181788822,0.4759486788357347,0.7586108883882947,0.11206927500794212,1035349.7333625407,-3982.871283513009,1031366.8620790277,745,0,252.74242424242425,77,121,42,40.507096108077796,0.5313026094276094,45.61965811965808,8140.170940170836,105.71650571650436,8
747,32,3,2,194,0.015306122448979591,0.01020408163265306,0.9897959183673469,196,5900,3900,2000,0.6610169491525424,79,39,40,204.313954032159,0.4760383961276819,0.7602759767683209,0.11493226194669204,1038107.2885921061,-2680.0390316292433,1035427.2495604769,746,0,255.89285714285714,82,114,46,40.07686243594794,0.5340667517006803,45.281124497991925,8151.00401606415,99.40248800078231,0
748,32,4,2,196,0.020202020202020204,0.010101010101010102,0.98989898989899,198,6700,4300,2400,0.6417910447761194,91,43,48,201.77631009591215,0.4768155326530961,0.7593727519787348,0.11446170922378113,1040732.2104233534,-4300.9789565631,1036431.2314667903,747,0,252.1919191919192,86,112,39,39.813173872901075,0.537037037037037,44.95929118773943,8161.302681992251,94.89886839525873,0
749,32,3,5,194,0.01507537688442211,0.02512562814070352,0.9748743718592965,199,6450,4500,1950,0.6976744186046512,84,45,39,198.5408635205443,0.4768772312742162,0.7594869511009865,0.11348934478441984,1043108.3392245763,-4830.0739169740455,1038278.2653076022,748,0,251.90954773869348,75,124,41,39.59893400969817,0.5394158291457287,44.668311403508795,8170.614035087776,108.94152046783701,0
750,32,5,2,197,0.02512562814070352,0.010050251256281407,0.9899497487437185,199,6700,4600,2100,0.6865671641791045,88,46,42,197.10710878964503,0.47686348408710216,0.7604337640546839,0.11363989688737615,1045765.1267825759,-5274.45187736952,1040490.6749052063,749,0,252.30150753768845,78,121,48,39.30418020527106,0.5428706030150754,44.343354430379776,8181.012658227919,104.8847776695887,0
751,32,1,1,197,0.005050505050505051,0.005050505050505051,0.9949494949494949,198,6800,5100,1700,0.75,85,51,34,198.0219200233091,0.476862533969133,0.7610812985922029,0.11483935631705967,1047576.619189349,-4911.373299319341,1042665.2458900297,750,0,253.92929292929293,83,115,37,39.05507899583215,0.5449284511784511,44.12202380952383,8188.09523809529,98.65174985656977,0
752,32,3,2,198,0.015,0.01,0.99,200,6550,4800,1750,0.732824427480916,83,48,35,195.94932831535118,0.4769545644891122,0.7619585674478073,0.11466257006552762,1050337.0983777398,-5387.43021363702,1044949.6681641027,751,0,252.375,88,112,45,38.76459884579661,0.5473958333333333,43.78511235955059,8198.876404494458,93.16905005107338,0
753,32,1,1,198,0.005025125628140704,0.005025125628140704,0.9949748743718593,199,5950,3900,2050,0.6554621848739496,80,39,41,194.37431234472243,0.47653989645195677,0.758631165177927,0.11410915512943084,1051327.1720773093,-4879.800775630351,1046447.3713016789,752,0,254.1105527638191,72,127,43,38.681877644177234,0.5488379396984925,43.664383561643824,8202.73972602737,113.92694063926903,0
754,32,2,2,198,0.01,0.01,0.99,200,6200,4500,1700,0.7258064516129032,79,45,34,192.71215952240968,0.47662845477386934,0.7562866958151162,0.1138495082639772,1053254.8487836954,-5604.996712688962,1047649.8520710064,753,0,252.77,77,123,47,38.48506141994588,0.5510937499999999,43.42948717948718,8210.256410256414,106.62670662670668,0
755,32,1,3,196,0.005025125628140704,0.01507537688442211,0.9849246231155779,199,6550,5000,1550,0.7633587786259542,81,50,31,199.87168620276773,0.4759434800263946,0.7630408735578345,0.11863749338749335,1054691.4271638934,-4189.409205829689,1050502.0179580636,754,0,254.88442211055278,81,118,41,38.12295903221019,0.5547529313232831,43.25457317073172,8215.853658536607,101.43029208069886,8
756,32,2,2,196,0.010101010101010102,0.010101010101010102,0.98989898989899,198,7100,5400,1700,0.7605633802816901,88,54,34,197.13767811909185,0.47550109812165653,0.7584885574871258,0.11777712564550905,1056663.0622837401,-5038.379469434694,1051624.6828143054,755,0,256.35858585858585,84,114,35,37.948557463042405,0.5571864478114479,43.01470588235295,8223.52941176473,97.89915966386583,0
757,32,1,3,194,0.005076142131979695,0.015228426395939087,0.9847715736040609,197,6000,4400,1600,0.7333333333333333,76,44,32,202.9915743337745,0.4748707224006354,0.7655009773581867,0.12188679599136618,1058187.00799231,-2439.3906616187905,1055747.617330691,756,0,258.5888324873096,85,112,37,37.60911203215272,0.5591159052453469,42.82945736434109,8229.457364341099,96.81714546283645,0
758,32,0,4,190,0.0,0.020618556701030927,0.979381443298969,194,6900,5400,1500,0.782608695652174,84,54,30,212.67420801912908,0.4743069280487153,0.7793438113068223,0.12515554908277185,1052069.1579051733,-950.4050122332505,1051118.75289294,757,1,262.04639175257734,70,124,36,38.120422817255985,0.5512242268041236,43.57394366197182,8205.633802816868,117.22334004024098,8
759,32,0,0,190,0.0,0.0,1.0,190,6400,4600,1800,0.71875,82,46,36,211.31023869437925,0.47360705003248865,0.7739063431196092,0.1247458080286936,1053032.480879011,103.30897749549877,1053135.7898565065,758,2,266.4,70,120,37,38.035547485607545,0.553015350877193,43.45657276995304,8209.389671361476,117.27699530516394,0
760,32,1,1,190,0.005235602094240838,0.005235602094240838,0.9947643979057592,191,5350,3500,1850,0.6542056074766355,72,35,37,209.40684659850228,0.47356365389914573,0.773188756070895,0.1244526900276339,1055071.3611111057,637.8333333330534,1055709.1944444387,759,0,266.0,74,117,38,37.83094001838932,0.5547011343804538,43.208333333333314,8217.33333333329,111.04504504504446,0
761,32,0,1,189,0.0,0.005263157894736842,0.9947368421052631,190,5900,4600,1300,0.7796610169491526,72,46,26,210.70282385607877,0.47321834679290825,0.7737560893431239,0.12566415632141836,1056139.3439567888,606.3084314401212,1056745.6523882288,760,1,264.4684210526316,75,115,36,37.66498844136212,0.5565241228070175,43.078399122807,8221.491228070132,109.6198830409351,0
762,32,1,1,189,0.005263157894736842,0.005263157894736842,0.9947368421052631,190,5700,4400,1300,0.7719298245614035,70,44,26,211.72716312214004,0.47311507936507935,0.7762434413713903,0.12714573423002049,1058219.4037543365,1110.7584635414782,1059330.162217878,761,0,261.62105263157895,79,111,38,37.380438543196114,0.5586074561403509,42.82552083333332,8229.583333333303,104.17194092826966,0
763,32,3,2,190,0.015625,0.010416666666666666,0.9895833333333334,192,6950,5400,1550,0.7769784172661871,85,54,31,205.858428316648,0.4730232420738802,0.7723965254106733,0.12498083254061207,1061513.1838151896,-1645.7128684809195,1059867.4709467087,762,0,259.75,69,123,40,37.12320902420703,0.5611979166666667,42.42559523809523,8242.380952380929,119.4547964113178,0
764,32,0,0,190,0.0,0.0,1.0,190,6550,4800,1750,0.732824427480916,83,48,35,204.6546424248836,0.4725442077415762,0.7684233837833434,0.12479649397293174,1062829.1867350521,-1047.4145660017748,1061781.7721690503,763,1,262.9736842105263,72,118,42,36.99133540028787,0.5634320175438596,42.265981735159805,8247.488584474859,114.54845256215081,0
765,32,0,1,189,0.0,0.005263157894736842,0.9947368421052631,190,5650,4100,1550,0.7256637168141593,72,41,31,207.8499638533153,0.4722506497725796,0.7723747980613895,0.12738527487643744,1064336.1111111077,594.4444444442515,1064930.555555552,764,2,263.9736842105263,74,116,38,36.722536348949916,0.5652960526315789,42.08333333333332,8253.333333333307,111.53153153153117,0
766,32,0,3,186,0.0,0.015873015873015872,0.9841269841269842,189,6300,4600,1700,0.7301587301587301,80,46,34,207.1550473912032,0.47167693909715186,0.7707295752164183,0.12756952853871398,1065765.7394913845,55.75045445154319,1065821.4899458361,765,3,266.0846560846561,76,113,41,36.563712129154,0.5676256613756614,41.910173160173144,8258.874458874425,108.66940077466349,0
767,32,0,0,186,0.0,0.0,1.0,186,7250,5800,1450,0.8,87,58,29,208.51372569779616,0.47101012302625206,0.7690836834745731,0.12879265270770648,1066659.7444763014,32.639474522505225,1066692.383950824,766,4,271.1236559139785,76,110,42,36.41816427398789,0.5694444444444444,41.801948051948045,8262.33766233765,108.71496924128486,0
768,32,0,1,185,0.0,0.005376344086021506,0.9946236559139785,186,5350,3800,1550,0.7102803738317757,69,38,31,214.04280633530698,0.4709386806161,0.7702079150718961,0.1283541845339598,1057790.8230251707,2732.5032552081384,1060523.3262803787,767,5,272.1236559139785,79,107,40,37.37408424908424,0.5589157706093191,42.87760416666666,8227.916666666642,104.15084388185623,8
769,32,1,3,183,0.005376344086021506,0.016129032258064516,0.9838709677419355,186,6450,4900,1550,0.7596899224806202,80,49,31,212.91940533363888,0.47058570667441635,0.7691654695050276,0.12827095882294862,1059184.0277777803,1454.1666666667938,1060638.194444447,768,0,273.09139784946234,65,121,43,37.230094466936556,0.5604278673835126,42.70833333333334,8233.333333333354,126.66666666666698,0
770,32,0,2,181,0.0,0.01092896174863388,0.9890710382513661,183,5600,4400,1200,0.7857142857142857,68,44,24,214.17059330436743,0.4702643667807602,0.7666336876514215,0.12924410612348514,1059696.1128746823,3191.1490433405716,1062887.2619180228,769,1,277.6775956284153,66,117,43,37.13438148170523,0.5614184881602915,42.64614427860697,8235.323383084586,124.77762701643312,0
771,32,1,1,181,0.005494505494505495,0.005494505494505495,0.9945054945054945,182,5300,3600,1700,0.6792452830188679,70,36,34,214.05824387117423,0.46985800801408534,0.763278388278388,0.13008154819863685,1061795.8412098316,3757.230623818633,1065553.0718336503,770,0,278.7912087912088,68,114,45,36.876977848101255,0.5635874542124542,42.39130434782609,8243.47826086958,121.22762148337618,0
772,32,1,1,181,0.005494505494505495,0.005494505494505495,0.9945054945054945,182,5600,4000,1600,0.7142857142857143,72,40,32,236.38878737470685,0.4697783225062231,0.7842841820317703,0.14158017950472243,1057419.03654844,7992.400759323245,1065411.4373077634,771,0,279.6978021978022,67,115,42,36.84577722162635,0.5548878205128205,42.92279411764705,8226.470588235274,122.78314310798916,8
773,32,0,1,180,0.0,0.0055248618784530384,0.994475138121547,181,5750,4200,1550,0.7304347826086957,73,42,31,194.781601949405,0.46905437896459995,0.7375535113208507,0.11858012664471215,1062334.6619131514,-565.3505492355525,1061769.311363916,772,1,281.0828729281768,78,103,43,37.30693293078159,0.5634783609576427,42.3259493670886,8245.569620253136,105.71243102888636,8
774,32,2,3,179,0.01098901098901099,0.016483516483516484,0.9835164835164835,182,5350,3800,1550,0.7102803738317757,69,38,31,192.70671059094158,0.4684641440511606,0.7363275462512864,0.1184157652246876,1065121.6812520074,-698.7808853665492,1064422.9003666409,773,0,280.5054945054945,80,102,35,37.01610759441091,0.5658768315018314,41.988168724279824,8256.378600823016,103.2047325102877,0
775,32,0,1,178,0.0,0.00558659217877095,0.994413407821229,179,6100,4300,1800,0.7049180327868853,79,43,36,195.19138934797311,0.4675815495993137,0.7343003880025138,0.12051852687499366,1066547.9733560053,-263.80385487538297,1066284.16950113,774,1,285.60893854748605,83,96,37,36.775936599423645,0.5680283985102421,41.81547619047618,8261.904761904732,99.54102122776786,0
776,32,0,0,178,0.0,0.0,1.0,178,5000,3300,1700,0.66,67,33,34,194.6401858016272,0.4674003893438287,0.7321965409157236,0.12039558840135603,1067085.0421492604,939.5261740136875,1068024.5683232741,775,2,288.0842696629214,86,92,38,36.72390545072404,0.5691713483146068,41.750478927203055,8263.984674329475,96.09284505034273,0
777,32,1,1,178,0.00558659217877095,0.00558659217877095,0.994413407821229,179,6850,5300,1550,0.7737226277372263,84,53,31,193.64937526879936,0.4672180026363693,0.731851762615739,0.12051677406793794,1068896.39671296,-1251.7761098927458,1067644.6206030673,776,0,287.46927374301674,76,103,37,36.52615670470009,0.5712290502793296,41.5313852813853,8270.995670995708,108.82889040783826,0
778,32,0,2,176,0.0,0.011235955056179775,0.9887640449438202,178,4900,3100,1800,0.6326530612244898,67,31,36,204.38276113951852,0.46686411582978904,0.7471150926207117,0.12197035745422835,1056327.160493823,2679.0123456788647,1059006.1728395019,777,1,289.2977528089888,80,98,38,37.804054054054056,0.5572916666666667,43.05555555555554,8222.22222222219,102.77777777777737,6
779,32,0,2,174,0.0,0.011363636363636364,0.9886363636363636,176,4900,3400,1500,0.6938775510204082,64,34,30,209.1145121333366,0.4664535984848485,0.7477537658959019,0.1251431397760811,1057173.2374807305,4114.053159240368,1061287.290639971,778,2,292.90909090909093,80,96,38,37.57744229871254,0.5587713068181819,42.95267489711932,8225.514403292134,102.81893004115167,0
780,32,0,1,173,0.0,0.005747126436781609,0.9942528735632183,174,6350,4700,1650,0.7401574803149606,80,47,33,205.12066413884773,0.4658446005802494,0.7396375217723592,0.1232804316112376,1058469.4492669671,2272.7912808637975,1060742.240547831,779,3,295.4597701149425,83,91,38,37.51933569580379,0.561242816091954,42.795138888888864,8230.555555555491,99.1633199464517,0
781,32,2,0,175,0.011428571428571429,0.0,1.0,175,5150,3300,1850,0.6407766990291263,70,33,37,205.33466714540216,0.4652887246852764,0.7434194188253105,0.12441825326567925,1060923.1983250184,3418.8623589808303,1064342.0606839992,780,0,294.66285714285715,73,102,40,37.20975919750723,0.5635714285714286,42.4971846846847,8240.090090090123,112.87794643959073,0
782,32,3,1,177,0.016853932584269662,0.0056179775280898875,0.9943820224719101,178,5100,3500,1600,0.6862745098039216,67,35,32,201.07626452199375,0.4655297139169259,0.7435887609791996,0.12290286880244237,1063532.3668034696,2070.2231030152684,1065602.5899064848,781,0,290.67977528089887,76,102,42,36.99660247665024,0.5659527153558053,42.18073593073593,8250.216450216441,108.55547960811107,0
783,32,0,2,175,0.0,0.011299435028248588,0.9887005649717514,177,5650,4200,1450,0.7433628318584071,71,42,29,200.4202965983151,0.4649607836843006,0.7417265726246223,0.12302252524276004,1064799.0887984885,1631.4698389218183,1066430.5586374104,782,1,292.8135593220339,77,100,37,36.85694595434073,0.5671492467043315,42.02724358974359,8255.12820512821,107.20945720945728,0
784,32,0,1,174,0.0,0.005714285714285714,0.9942857142857143,175,6000,4500,1500,0.75,75,45,30,227.8925129271899,0.464995894909688,0.7690255154394701,0.13834720636367726,1061489.385318432,7381.09669315109,1068870.4820115832,783,2,293.01142857142855,66,109,40,36.55862055089434,0.5623214285714286,42.42848258706467,8242.288557213924,124.88315995778673,8
785,32,1,0,175,0.005714285714285714,0.0,1.0,175,4750,3200,1550,0.6736842105263158,63,32,31,237.08040619463608,0.4651860974274767,0.766110908476866,0.1385917797406453,1050029.154272579,10038.267682230638,1060067.4219548095,784,0,293.1542857142857,85,90,35,37.74921197793538,0.5567857142857142,43.82267441860465,8197.674418604645,96.4432284541723,8
786,32,0,3,172,0.0,0.017142857142857144,0.9828571428571429,175,5100,3500,1600,0.6862745098039216,67,35,32,236.61315451177637,0.4650013683634373,0.7650349582678122,0.13874882595750165,1050980.9329185972,9635.182773919825,1060616.115692517,785,1,294.1542857142857,71,104,36,37.642358171041494,0.5580357142857143,43.70659722222223,8201.388888888901,115.51251956181551,0
787,32,4,1,175,0.022727272727272728,0.005681818181818182,0.9943181818181818,176,4600,3500,1100,0.7608695652173914,57,35,22,232.16544632839754,0.46519818722943723,0.7651261303529822,0.13787611272805428,1054846.003244676,9179.758630205391,1064025.7618748813,786,0,293.09659090909093,78,98,37,37.274581043838474,0.5613754734848485,43.2357594936709,8216.45569620256,105.33917559234051,0
788,32,2,1,176,0.011299435028248588,0.005649717514124294,0.9943502824858758,177,5450,3700,1750,0.6788990825688074,72,37,35,200.16966687503208,0.4656990990412601,0.7433458696557369,0.12017303488191387,1058138.3848899421,1511.441602220621,1059649.8264921627,787,0,291.7401129943503,81,96,43,37.687709938747275,0.5630296610169492,42.83536585365852,8229.268292682893,101.59590484793695,7
789,32,2,3,175,0.011235955056179775,0.016853932584269662,0.9831460674157303,178,5550,3600,1950,0.6486486486486487,75,36,39,197.40266956733066,0.4657221375822595,0.7409039035644207,0.11925266194473297,1060018.0074642077,700.0768925755206,1060718.0843567832,788,0,290.8707865168539,71,107,43,37.52605484046239,0.5647237827715356,42.60706018518519,8236.574074074088,116.00808555033926,0
790,32,3,1,177,0.016853932584269662,0.0056179775280898875,0.9943820224719101,178,5400,3900,1500,0.7222222222222222,69,39,30,191.26381423351492,0.46557600139655936,0.733185306000596,0.11416721086346868,1056395.95530717,-589.9360494186108,1055806.0192577515,789,0,287.40449438202245,82,96,41,38.13261127934616,0.5610369850187267,43.04718875502007,8222.489959839339,100.27426780291876,7
791,32,0,2,175,0.0,0.011299435028248588,0.9887005649717514,177,5850,3700,2150,0.6324786324786325,80,37,43,195.79063657381712,0.4652416645266222,0.7379124461339743,0.11751405009062915,1058061.2269502685,181.69623173327636,1058242.9231820018,790,1,289.7005649717514,83,94,42,37.809882898522744,0.5629708097928436,42.844742063492056,8228.968253968234,99.14419583094258,0
792,32,0,3,172,0.0,0.017142857142857144,0.9828571428571429,175,5100,3500,1600,0.6862745098039216,67,35,32,198.7442159077815,0.46516420361247945,0.7393361780899301,0.1195712191493334,1058780.4714532872,1985.2989234909924,1060765.7703767782,791,2,293.6514285714286,84,91,43,37.64480412240168,0.5645238095238095,42.75735294117647,8231.764705882353,97.99719887955182,0
793,32,1,2,171,0.005780346820809248,0.011560693641618497,0.9884393063583815,173,5000,3500,1500,0.7,65,35,30,196.30540288098953,0.46491603934220554,0.733253336285447,0.11859442107934232,1060029.7560008005,2017.9136635150917,1062047.6696643156,792,0,296.34104046242777,70,103,43,37.5528433272534,0.5665342003853564,42.605633802816925,8236.619718309914,117.6659959758559,0
794,32,2,0,173,0.011560693641618497,0.0,1.0,173,4400,3300,1100,0.75,55,33,22,195.19031712268324,0.4646695904467446,0.7312979981903702,0.11880481506758642,1062273.7777777822,2469.1111111113805,1064742.8888888936,793,0,295.8728323699422,74,99,42,37.30392949547221,0.5689426782273603,42.33333333333335,8245.333333333369,111.4234234234239,0
795,32,3,2,174,0.017045454545454544,0.011363636363636364,0.9886363636363636,176,5050,3300,1750,0.6534653465346535,68,33,35,193.29883513913836,0.46488906926406925,0.7324487987396593,0.11883432019812959,1065258.9397845264,932.6624363806986,1066191.602220907,794,0,291.8125,81,95,40,36.983884731521584,0.5713778409090908,41.97154471544717,8256.910569105743,101.93716751982399,0
796,32,1,2,173,0.005714285714285714,0.011428571428571429,0.9885714285714285,175,5650,4000,1650,0.7079646017699115,73,40,33,195.71230729109763,0.46401477832512317,0.734614839811689,0.12091846877498678,1066740.5465234474,1104.8507282142577,1067845.3972516616,795,0,293.2342857142857,82,93,42,36.738723631768245,0.5732738095238095,41.79216867469881,8262.650602409673,100.76403173670332,0
797,32,2,0,175,0.011428571428571429,0.0,1.0,175,5650,3800,1850,0.672566371681416,75,38,37,198.8033549616131,0.46321291735084835,0.7355414579513795,0.1243639529543214,1070420.1512345767,1910.623456790534,1072330.7746913673,796,0,293.74285714285713,74,101,43,36.20511822298591,0.5766071428571429,41.34722222222225,8276.888888888958,111.84984984985078,0
798,32,1,2,174,0.005681818181818182,0.011363636363636364,0.9886363636363636,176,5200,3500,1700,0.6730769230769231,69,35,34,201.42616093114896,0.4631175595238095,0.7393672698397418,0.1269159499662914,1072541.851819794,2807.597530009433,1075349.4493498034,797,0,293.0681818181818,75,101,42,35.87590435856714,0.5783025568181819,41.091008771929836,8285.087719298272,110.46783625731028,0
799,32,1,3,172,0.005714285714285714,0.017142857142857144,0.9828571428571429,175,4850,3500,1350,0.7216494845360825,62,35,27,200.92293048906737,0.46305829228243023,0.7357678004535124,0.12708980542983223,1073677.7181440482,3295.2947060635765,1076973.0128501118,798,0,294.7314285714286,75,100,37,35.7491181657848,0.5794642857142858,40.95394736842106,8289.473684210556,110.52631578947408,0
800,32,2,2,172,0.011494252873563218,0.011494252873563218,0.9885057471264368,174,5050,3400,1650,0.6732673267326733,67,34,33,214.9686665581329,0.4632534106260935,0.7536553956153433,0.13229340597550374,1065567.9613312657,5962.74475489014,1071530.706086156,799,0,291.36206896551727,73,101,38,36.386513845706304,0.5691451149425287,41.93412162162163,8258.108108108123,113.12476860422086,7
801,32,0,1,171,0.0,0.005813953488372093,0.9941860465116279,172,5300,3600,1700,0.6792452830188679,70,36,34,247.64770490830034,0.4629296715626275,0.7875123436744056,0.14604971370138248,1052724.000547177,12440.936527478572,1065164.9370746554,800,1,290.8779069767442,56,116,39,37.14184359266648,0.5492369186046512,43.494152046783626,8208.187134502923,146.57477025898078,8
802,32,1,2,170,0.005813953488372093,0.011627906976744186,0.9883720930232558,172,5350,4000,1350,0.7476635514018691,67,40,27,242.21747079593942,0.46303025409130055,0.7825439072799534,0.14363925990040843,1054409.1390083297,11329.262966944301,1065738.401975274,801,0,291.8546511627907,60,112,39,37.070943923368596,0.5509326550387597,43.2889344262295,8214.754098360645,136.91256830601074,0
803,32,3,0,173,0.017341040462427744,0.0,1.0,173,5450,3900,1550,0.7155963302752294,70,39,31,206.33636222209398,0.46391624098221085,0.7384073679097496,0.11836013293295872,1044197.6621391418,3041.189409321207,1047238.851548463,802,0,290.59537572254334,68,105,45,39.263852775479656,0.5389571290944124,44.53502415458938,8174.879227053157,120.21881216254643,8
804,32,2,1,174,0.011428571428571429,0.005714285714285714,0.9942857142857143,175,5200,3600,1600,0.6923076923076923,68,36,32,193.7984380483779,0.4644458128078817,0.7305455692210661,0.10724866440687639,1032959.504437862,-162.81229454349068,1032796.6921433185,803,0,288.2628571428571,77,98,39,40.98930411016498,0.5264880952380953,45.91346153846151,8130.769230769169,105.59440559440479,8
805,32,4,1,177,0.02247191011235955,0.0056179775280898875,0.9943820224719101,178,5000,3400,1600,0.68,66,34,32,187.40769233726462,0.46649050974417566,0.7246458692053745,0.10470128824078594,1035953.445411087,-1770.8710853340176,1034182.574325753,804,0,283.20786516853934,75,103,43,40.776831403178065,0.52937734082397,45.54550438596491,8142.543859649115,108.56725146198819,0
806,32,5,1,181,0.027472527472527472,0.005494505494505495,0.9945054945054945,182,6100,4000,2100,0.6557377049180327,82,40,42,181.29622453657896,0.46838319369396714,0.7227207581449129,0.10248560023830931,1039642.306676505,-4803.354986209932,1034838.9516902951,805,0,274.7142857142857,82,100,40,40.4715014852379,0.5329097985347986,45.092871485943775,8157.028112449797,99.47595259085118,0
807,32,3,3,181,0.016304347826086956,0.016304347826086956,0.9836956521739131,184,5600,4400,1200,0.7857142857142857,68,44,24,181.57808877859145,0.468957887859349,0.7281508609064709,0.10357051879494035,1042441.0000000085,-4543.111111110687,1037897.8888888978,806,0,272.67934782608694,74,110,46,40.115219283926415,0.5357789855072463,44.75000000000003,8168.000000000067,110.37837837837928,0
808,32,2,0,183,0.01092896174863388,0.0,1.0,183,7000,5000,2000,0.7142857142857143,90,50,40,188.86798581181378,0.468436618026782,0.7365223453586616,0.1085732273884719,1044864.5194992676,-4131.708551188699,1040732.8109480789,807,0,275.10928961748635,76,107,47,39.62700723486855,0.5379667577413478,44.45346320346323,8177.489177489239,107.59854180906893,0
809,32,2,0,185,0.010810810810810811,0.0,1.0,185,4450,2900,1550,0.651685393258427,60,29,31,225.42393927487916,0.46889321386603994,0.7808525239746249,0.12777784993440972,1040491.8939209544,5460.3563022484805,1045952.2502232029,808,0,273.12432432432433,73,112,40,39.24017443144183,0.5370495495495495,44.98873873873876,8160.3603603604115,111.78575836110153,8
810,32,4,3,186,0.021164021164021163,0.015873015873015872,0.9841269841269842,189,7050,5200,1850,0.7375886524822695,89,52,37,220.86273427301305,0.469308182295771,0.7814802126552718,0.1268591738179705,1044604.2387543271,1292.8296808920768,1045897.0684352191,809,0,268.32275132275134,67,122,44,38.841926458832916,0.5401234567901234,44.485294117647065,8176.470588235308,122.03687445127326,0
811,32,2,2,186,0.010638297872340425,0.010638297872340425,0.9893617021276596,188,5700,4000,1700,0.7017543859649122,74,40,34,216.8332246256007,0.4697224513596541,0.7771747944079459,0.12535192168315487,1046602.07270408,2087.620464852562,1048689.6931689326,810,0,269.81382978723406,69,119,46,38.69536810767829,0.5424977836879432,44.24107142857142,8184.285714285701,118.61283643892321,0
812,32,1,2,185,0.0053475935828877,0.0106951871657754,0.9893048128342246,187,6300,4300,2000,0.6825396825396826,83,43,40,211.4145354695401,0.4693088379046633,0.7703766933006657,0.12295933427703086,1048462.2253086457,632.0308641977244,1049094.2561728435,811,0,272.1818181818182,74,113,36,38.6019704121679,0.5447303921568627,44.0138888888889,8191.555555555586,110.6966966966971,0
813,32,3,2,186,0.015957446808510637,0.010638297872340425,0.9893617021276596,188,5400,3500,1900,0.6481481481481481,73,35,38,208.69477732864982,0.46958970967497254,0.7700247890664575,0.12239794715744955,1051031.7853993422,868.9688838496886,1051900.7542831919,812,0,271.1808510638298,62,126,42,38.35155796400234,0.5472628546099291,43.700396825396815,8201.58730158728,132.28366615463355,0
814,32,1,1,186,0.0053475935828877,0.0053475935828877,0.9946524064171123,187,5500,3400,2100,0.6181818181818182,76,34,42,212.66555126116222,0.4691926379544975,0.7668359807278406,0.12286765223230613,1046413.8603099772,1607.2360900290187,1048021.0964000062,813,0,273.572192513369,76,111,44,38.82544699534493,0.5431149732620321,44.264069264069306,8183.549783549886,107.6782866256564,8
815,32,3,2,187,0.015873015873015872,0.010582010582010581,0.9894179894179894,189,5000,3300,1700,0.66,67,33,34,220.5805129654214,0.47002232729183085,0.7823489650387825,0.12573415059579862,1042235.7296828129,3179.3783768647463,1045415.1080596776,814,0,270.9153439153439,62,127,41,39.14536905070399,0.53505291005291,44.77513227513225,8167.195767195714,131.72896398702764,8
816,32,2,0,189,0.010582010582010581,0.0,1.0,189,5550,4000,1550,0.7207207207207207,71,40,31,215.0565633781772,0.47042337423543096,0.7715374805486734,0.11971067660877734,1034804.7262447935,1158.3096387401938,1035963.0358835337,815,0,271.51851851851853,70,119,39,40.21744355986307,0.5287147266313933,45.68661971830986,8138.028169014091,116.25754527162987,8
817,32,2,2,189,0.010471204188481676,0.010471204188481676,0.9895287958115183,191,7000,5200,1800,0.7428571428571429,88,52,36,227.74913544835368,0.4711961513731974,0.786286047405905,0.12654678275983708,1034234.162491592,1909.1872717224974,1036143.3497633145,816,0,269.6649214659686,67,124,35,39.96637193468698,0.5278141361256545,45.75674019607844,8135.784313725509,121.42961662276879,8
818,32,3,5,187,0.015625,0.026041666666666668,0.9739583333333334,192,6300,4800,1500,0.7619047619047619,78,48,30,222.4028976043233,0.4719552156050029,0.7827264463513923,0.12522879908426415,1038410.1628626124,1489.0858244844958,1039899.2486870969,817,0,269.109375,75,117,40,39.578121357221,0.5310329861111112,45.24396929824562,8152.192982456147,108.69590643274863,0
819,32,4,4,187,0.020942408376963352,0.020942408376963352,0.9790575916230366,191,4950,3100,1850,0.6262626262626263,68,31,37,218.68540562160692,0.4724269771286856,0.7798328766674985,0.12430604804359432,1041365.6560653028,2396.2941794103313,1043761.9502447131,818,0,269.37696335078533,80,111,39,39.30262207211749,0.5343586387434556,44.88168724279836,8163.786008230461,102.04732510288076,0
820,32,3,5,185,0.015789473684210527,0.02631578947368421,0.9736842105263158,190,4850,3100,1750,0.6391752577319587,66,31,35,267.4912325236951,0.47212185556483804,0.8150176622766421,0.15218586041167012,1041647.040123463,12876.290123457162,1054523.3302469202,819,0,271.5052631578947,74,116,37,38.022109121259966,0.5329495614035088,44.84722222222224,8164.888888888938,110.336336336337,8
821,32,2,1,186,0.0106951871657754,0.0053475935828877,0.9946524064171123,187,6000,4600,1400,0.7666666666666667,74,46,28,229.33234834645373,0.47152023077070515,0.7818211949081351,0.1318838871928261,1044980.0294658297,4529.544826508982,1049509.5742923387,820,0,276.03208556149735,67,120,38,38.578505564546745,0.539382798573975,44.439338235294116,8177.941176470583,122.05882352941168,8
822,32,0,3,183,0.0,0.016129032258064516,0.9838709677419355,186,6100,4700,1400,0.7704918032786885,75,47,28,222.08506737065622,0.47110699409086504,0.7737969166882037,0.12605060034805732,1040901.3424327833,2933.728952077883,1043835.0713848613,821,1,278.43548387096774,77,109,33,39.274034853482725,0.5346102150537635,44.938568376068346,8161.965811965738,105.99955599955504,8
823,32,4,2,185,0.0213903743315508,0.0106951871657754,0.9893048128342246,187,6250,4500,1750,0.72,80,45,35,239.6660551325997,0.471923935752209,0.7902935169983583,0.13593414478370236,1040683.3526234571,6233.294753086475,1046916.6473765436,822,0,272.9197860962567,71,116,39,38.85296119809396,0.5344251336898396,44.96527777777778,8161.111111111113,114.94522691705794,7
824,32,1,2,184,0.005376344086021506,0.010752688172043012,0.989247311827957,186,5700,3900,1800,0.6842105263157895,75,39,36,237.29689409104068,0.47151203622977816,0.7880537167331183,0.13544286284069368,1042649.6018325794,6583.502428026201,1049233.1042606055,823,0,275.31720430107526,61,125,38,38.666853143784785,0.5367943548387097,44.724462365591386,8168.817204301056,133.9150361360829,0
825,32,2,3,183,0.010752688172043012,0.016129032258064516,0.9838709677419355,186,6050,4200,1850,0.6942148760330579,79,42,37,233.70545912162493,0.471978833672382,0.784724584789535,0.1346711568308587,1045606.4975009583,5622.789311803001,1051229.2868127613,824,0,273.88709677419354,67,119,39,38.38836289549379,0.5405465949820789,44.362745098039206,8180.392156862722,122.09540532630929,0
826,32,3,3,183,0.016129032258064516,0.016129032258064516,0.9838709677419355,186,5900,4200,1700,0.711864406779661,76,42,34,222.6823521779207,0.4717796425457716,0.7782270152345325,0.12785263173754005,1044478.9902020853,3417.407667723972,1047896.3978698093,825,0,274.78494623655916,67,119,38,38.811092291704135,0.5347782258064516,44.50061274509804,8175.98039215686,122.02955809189343,8
827,32,3,3,183,0.016129032258064516,0.016129032258064516,0.9838709677419355,186,6250,4400,1850,0.704,81,44,37,219.97262432513793,0.47183171074300106,0.7763831221831847,0.1276852589473507,1047856.5558802091,2649.951302654226,1050506.5071828633,826,0,273.3333333333333,73,113,37,38.45847084708473,0.5382504480286738,44.08783783783785,8189.1891891892255,112.18067382450994,0
828,32,2,1,184,0.010810810810810811,0.005405405405405406,0.9945945945945946,185,5350,3900,1450,0.7289719626168224,68,39,29,217.05870667157518,0.47103774970622797,0.7722457022699019,0.12655350171926394,1049219.879404125,3198.4620075133316,1052418.3414116383,827,0,275.64324324324326,78,107,39,38.36300482295799,0.5406531531531531,43.92141350210972,8194.514767932531,105.05788164016066,0
829,32,1,1,184,0.005405405405405406,0.005405405405405406,0.9945945945945946,185,6500,4700,1800,0.7230769230769231,83,47,36,223.2570821470461,0.4709875636506071,0.7748331095399614,0.13150802051019445,1052358.8065065658,3489.311302480557,1055848.1178090463,828,0,276.6108108108108,68,117,44,37.812966015226415,0.5452702702702703,43.538647342995155,8206.763285024124,120.68769536800183,8
830,32,2,0,186,0.010752688172043012,0.0,1.0,186,5800,4700,1100,0.8103448275862069,69,47,22,220.85898278038164,0.47114876973747943,0.7725233584534219,0.13100804349494952,1054489.8491743214,3578.7110881753492,1058068.5602624968,829,0,275.8010752688172,72,114,44,37.60919811757729,0.5474350358422939,43.27910958904107,8215.068493150624,114.09817351598089,0
831,32,0,3,183,0.0,0.016129032258064516,0.9838709677419355,186,6350,4500,1850,0.7086614173228346,82,45,37,219.82358265842603,0.4708829797539475,0.7719242433882643,0.13111830165626034,1056172.8451424325,2884.339745150168,1059057.1848875827,830,1,276.8010752688172,73,113,39,37.42649207392799,0.5487231182795699,43.0743243243243,8221.621621621565,112.62495372084337,0
832,32,0,2,181,0.0,0.01092896174863388,0.9890710382513661,183,5850,4300,1550,0.7350427350427351,74,43,31,217.01552113908028,0.4705008106647451,0.7656228164594572,0.12988923079386186,1057214.6925219079,3436.3994907065744,1060651.0920126145,831,2,280.76502732240436,73,110,42,37.369199843016965,0.5506033697632058,42.947635135135116,8225.675675675628,112.68048870788532,0
833,32,1,1,181,0.005494505494505495,0.005494505494505495,0.9945054945054945,182,6650,5000,1650,0.7518796992481203,83,50,33,216.80213992455293,0.4703905095824985,0.7648888711885045,0.13017147364493933,1058168.6462421038,2832.6453812706422,1061001.2916233744,832,0,283.2637362637363,75,107,44,37.256224573184795,0.5521405677655677,42.8316885964912,8229.385964912208,109.72514619882944,0
834,32,1,2,180,0.005494505494505495,0.01098901098901099,0.989010989010989,182,5750,4400,1350,0.7652173913043478,71,44,27,214.81622259365903,0.4704961245016494,0.7630246868657458,0.1297489984465702,1059963.8429752076,3389.4857667585775,1063353.3287419663,833,0,281.8791208791209,65,117,44,37.084559725288216,0.5542582417582418,42.61363636363637,8236.363636363645,126.71328671328685,0
835,32,2,2,180,0.01098901098901099,0.01098901098901099,0.989010989010989,182,5000,3300,1700,0.66,67,33,34,216.87353336132895,0.4701862364155182,0.7634650201940489,0.1318266488553641,1061873.8552263577,4658.466993391356,1066532.322219749,834,0,282.7802197802198,66,116,45,36.79478475155906,0.5559752747252747,42.38184079601991,8243.781094527378,124.90577415950573,0
836,32,0,2,178,0.0,0.011111111111111112,0.9888888888888889,180,5950,3900,2050,0.6554621848739496,80,39,41,213.9776007741175,0.46937719842747777,0.7569422801921211,0.13087151036403646,1063722.1123866271,3572.541099773642,1067294.6534864008,835,1,286.78333333333336,69,111,43,36.640491237182815,0.5576388888888889,42.157738095238116,8250.952380952427,119.57902001380329,0
837,32,2,3,177,0.011111111111111112,0.016666666666666666,0.9833333333333333,180,5750,4600,1150,0.8,69,46,23,236.27907209661447,0.4694405648665425,0.7877385496183211,0.1406934474757114,1055655.5171088048,8135.861207228069,1063791.378316033,836,0,282.68333333333334,67,113,42,37.068125795165415,0.5503472222222222,43.13725490196079,8219.607843137259,122.6807140766755,8
838,32,1,2,176,0.0056179775280898875,0.011235955056179775,0.9887640449438202,178,5800,4400,1400,0.7586206896551724,72,44,28,247.29483698138242,0.46945026344188406,0.7921997506257306,0.14078211259401274,1041838.9587442433,10128.279092701992,1051967.2378369453,837,0,286.36516853932585,64,114,38,38.51334024157925,0.5333567415730337,44.823717948717935,8165.641025640994,127.58814102564052,8
839,32,3,2,177,0.01675977653631285,0.0111731843575419,0.9888268156424581,179,5700,3600,2100,0.631578947368421,78,36,42,225.78480818641657,0.46998645199087735,0.773596876051901,0.12664674984921,1037208.511886545,5337.184981124525,1042545.6968676695,838,0,284.55307262569835,65,114,40,39.64273906934457,0.5290386405959031,45.39141414141415,8147.474747474769,125.34576534576568,8
840,32,3,0,180,0.016666666666666666,0.0,1.0,180,5900,3900,2000,0.6610169491525424,79,39,40,204.17477803045833,0.4703509724808608,0.7518947044453426,0.11343843310323239,1034207.8325784149,331.830930811876,1034539.6635092268,839,0,283.72222222222223,70,110,34,40.56903648989173,0.5268518518518519,45.75997652582161,8135.680751173728,116.22401073105326,8
841,32,1,0,181,0.0055248618784530384,0.0,1.0,181,5450,3900,1550,0.7155963302752294,70,39,31,201.43212253298924,0.4708947206875384,0.750609209424917,0.11261255402048082,1036165.9603636316,93.42173849604023,1036259.3821021277,840,0,283.1491712707182,72,109,38,40.39334978131659,0.5286602209944751,45.51940639269407,8143.378995433812,113.10248604769183,0
842,32,3,4,180,0.016304347826086956,0.021739130434782608,0.9782608695652174,184,5650,4300,1350,0.7610619469026548,70,43,27,195.27690889184913,0.47129353270768987,0.747070423754687,0.11017959714589792,1039049.1567134198,-1869.538498064136,1037179.6182153557,841,0,279.51630434782606,77,107,37,40.18927086608671,0.5313066123188406,45.16559829059829,8154.700854700857,105.90520590520593,0
843,32,6,0,186,0.03225806451612903,0.0,1.0,186,5300,4000,1300,0.7547169811320755,66,40,26,192.27056202505216,0.4719685411217669,0.7449023865028577,0.10999622408377464,1043365.6238586624,-2378.3010206148947,1040987.3228380475,842,0,272.8279569892473,73,113,42,39.72694219355785,0.536122311827957,44.636824324324344,8171.6216216216735,111.94002221399553,0
844,32,1,2,185,0.0053475935828877,0.0106951871657754,0.9893048128342246,187,5950,4400,1550,0.7394957983193278,75,44,31,191.72838693187236,0.47189039349855294,0.7453086145107888,0.11037526333610014,1045307.0711755803,-3266.9922790050637,1042040.0788965751,843,0,272.3636363636364,76,111,40,39.498760629476756,0.5380459001782532,44.39935064935066,8179.220779220799,107.62132604237894,0
845,32,3,0,188,0.015957446808510637,0.0,1.0,188,7050,5300,1750,0.75177304964539,88,53,35,192.51835064224912,0.4722232098835666,0.7456696209474869,0.1117212790734944,1047779.7067901255,-4306.635802469018,1043473.0709876565,844,0,271.21276595744683,80,108,39,39.170624151967445,0.54083554964539,44.09722222222223,8188.888888888905,102.36111111111131,0
846,32,1,1,188,0.005291005291005291,0.005291005291005291,0.9947089947089947,189,5950,4300,1650,0.7226890756302521,76,43,33,192.75819934768091,0.4721940785770573,0.7492200801002968,0.11252763847730379,1049608.3809681302,-3285.8756928695657,1046322.5052752607,845,0,270.7724867724868,83,106,42,38.93696943287819,0.5430445326278659,43.874007936507944,8196.031746031764,98.74737043411764,0
847,32,0,2,186,0.0,0.010638297872340425,0.9893617021276596,188,5650,4000,1650,0.7079646017699115,73,40,33,193.30773136206952,0.47206143095536085,0.7485229562619613,0.1132682014898326,1050747.027352601,-2626.4951814062592,1048120.5321711948,846,1,273.20212765957444,69,119,45,38.78132077115148,0.5444370567375887,43.73511904761902,8200.476190476138,118.8474810213933,0
848,32,4,1,189,0.021052631578947368,0.005263157894736842,0.9947368421052631,190,6050,4100,1950,0.6776859504132231,80,41,39,216.97834124870167,0.47272579597141,0.779669124585918,0.12383231091589615,1042616.330604019,1195.0323946535286,1043811.3629986725,847,0,267.56315789473683,65,125,42,39.18969745682371,0.5334429824561404,44.72853535353535,8168.68686868686,125.67210567210554,8
849,32,2,2,189,0.010471204188481676,0.010471204188481676,0.9895287958115183,191,5850,4300,1550,0.7350427350427351,74,43,31,212.19431353896186,0.4732880958941857,0.7756264670312989,0.12176888328314193,1044321.078817477,269.79888678859425,1044590.8777042655,848,0,266.0471204188482,68,123,43,39.09878567629852,0.5353403141361257,44.51992753623189,8175.362318840593,120.22591645353813,0
850,32,4,3,190,0.02072538860103627,0.015544041450777202,0.9844559585492227,193,5750,4200,1550,0.7304347826086957,73,42,31,210.5481831283496,0.474180969343696,0.7759394415979037,0.12216902078168758,1047741.2833018854,-229.99528244442172,1047511.288019441,849,0,263.7357512953368,73,120,37,38.71402671580763,0.538050518134715,44.10191441441442,8188.738738738757,112.17450327039393,0
851,32,2,0,192,0.010416666666666666,0.0,1.0,192,6650,5000,1650,0.7518796992481203,83,50,33,210.488306249172,0.47390095531559046,0.775795332302796,0.12269278856515944,1049144.9660493862,-883.4506172837691,1048261.5154321024,850,0,263.7552083333333,74,118,39,38.540593191227764,0.5400933159722222,43.930555555555564,8194.222222222248,110.73273273273308,0
852,32,0,5,187,0.0,0.026041666666666668,0.9739583333333334,192,5850,4100,1750,0.7008547008547008,76,41,35,207.94098807115859,0.47349533249709136,0.7720190703669996,0.12194618243874222,1051007.497493872,-540.4925001857223,1050467.0049936862,851,1,264.7552083333333,66,126,44,38.37390051562024,0.5418294270833333,43.703358208955216,8201.492537313417,124.26503844414269,0
853,32,1,2,186,0.005319148936170213,0.010638297872340425,0.9893617021276596,188,6500,4800,1700,0.7384615384615385,82,48,34,212.6621632337172,0.47305936397769943,0.7719795811754679,0.12523607220778865,1052282.9919123265,656.1554788246094,1052939.1473911512,852,0,271.11170212765956,66,122,44,38.09411943013031,0.5429964539007093,43.54788557213929,8206.467661691524,124.34041911653824,0
854,32,4,1,189,0.021052631578947368,0.005263157894736842,0.9947368421052631,190,5750,4300,1450,0.7478260869565218,72,43,29,209.45435230626208,0.4737097373062285,0.7698997897544024,0.12462707064993038,1055427.8508840457,462.79138258132525,1055890.642266627,853,0,268.9263157894737,72,118,45,37.78543252402909,0.5461622807017543,43.16495433789952,8218.721461187168,114.14890918315511,0
855,32,1,4,186,0.005263157894736842,0.021052631578947368,0.9789473684210527,190,5900,4100,1800,0.6949152542372882,77,41,36,207.24296323124852,0.4735745614035088,0.7681181145589473,0.1238171310515912,1056669.7808641947,-102.52469135822867,1056567.2561728365,854,0,269.7736842105263,74,116,38,37.68803257129471,0.5481907894736842,43.01388888888888,8223.555555555533,111.12912912912883,0
856,32,1,1,186,0.0053475935828877,0.0053475935828877,0.9946524064171123,187,5800,3800,2000,0.6551724137931034,78,38,40,210.36297007124898,0.4727133766507581,0.7686334603894105,0.1264392167480874,1058488.7590292979,1333.367827286681,1059822.1268565846,855,0,274.4919786096257,73,114,42,37.382105589608884,0.549520944741533,42.79279279279279,8230.630630630618,112.74836480315915,0
857,32,1,2,185,0.0053475935828877,0.0106951871657754,0.9893048128342246,187,5300,3900,1400,0.7358490566037735,67,39,28,213.3809224488636,0.47250134169014624,0.7705028535478353,0.1291135412105833,1060503.8831360922,2558.259368836165,1063062.1425049284,856,0,275.32620320855614,64,123,42,37.05454403983815,0.5513591800356505,42.54807692307691,8238.461538461519,128.72596153846123,0
858,32,1,1,185,0.005376344086021506,0.005376344086021506,0.9946236559139785,186,5500,3500,2000,0.6363636363636364,75,35,40,209.35451081289418,0.4724383657851399,0.7654087664357097,0.1274539350844621,1062339.4585315727,1781.111531622365,1064120.5700631952,857,0,275.26881720430106,67,119,40,36.93083298654462,0.5532594086021505,42.32536764705882,8245.588235294104,123.06848112379261,0
859,32,0,2,183,0.0,0.010810810810810811,0.9891891891891892,185,5700,4100,1600,0.7192982456140351,73,41,32,223.4495010959076,0.4722042694868782,0.7769170946060537,0.12972097882788075,1047898.1836473385,4130.465267061265,1052028.6489143998,858,1,274.2,71,114,36,38.36429654964482,0.5380630630630631,44.08275462962965,8189.35185185189,115.34298382889986,8
860,32,3,0,186,0.016129032258064516,0.0,1.0,186,6200,4300,1900,0.6935483870967742,81,43,38,219.77658800978173,0.47250375375375375,0.7755048518227108,0.1287262872628727,1050625.0000000044,2780.555555555791,1053405.5555555602,859,0,273.51612903225805,74,112,42,38.11822493224933,0.5408266129032258,43.750000000000014,8200.000000000035,110.81081081081128,0
861,32,4,0,190,0.021052631578947368,0.0,1.0,190,6400,4600,1800,0.71875,82,46,36,216.42748523856932,0.47359602710479903,0.7745684958999943,0.1254329981746562,1047379.2712259461,936.332352487304,1048315.6035784334,860,0,268.7368421052632,70,120,38,38.60874572318748,0.5334429824561404,44.14612676056338,8187.323943661963,116.96177062374234,8
862,32,2,3,189,0.010416666666666666,0.015625,0.984375,192,5850,4000,1850,0.6837606837606838,77,40,37,217.58823193254923,0.47397764870564285,0.7786534585908966,0.12706656660228222,1049714.0864197528,1431.086419753029,1051145.1728395058,861,0,266.9270833333333,74,118,40,38.28783031486097,0.5356987847222222,43.86111111111111,8196.444444444442,110.76276276276272,0
863,32,4,0,193,0.02072538860103627,0.0,1.0,193,6300,4200,2100,0.6666666666666666,84,42,42,210.74711933492384,0.4748961031951641,0.7730388221422482,0.12439130944280476,1052978.3695360413,-517.5683796590693,1052460.8011563823,862,0,264.7098445595855,68,125,41,38.05672433747228,0.5393458549222798,43.463164251207715,8209.178743961322,120.72321682296061,0
864,32,0,2,191,0.0,0.010362694300518135,0.9896373056994818,193,6850,4800,2050,0.7007299270072993,89,48,41,206.8784621941059,0.4744913104490501,0.7690396966213331,0.12285646307631587,1054839.8996285954,-1805.2687407704761,1053034.630887825,863,1,265.7098445595855,70,123,43,37.9246185932232,0.5418285837651122,43.23650234741782,8216.431924882585,117.37759892689407,0
865,32,2,0,193,0.010362694300518135,0.0,1.0,193,6400,4500,1900,0.703125,83,45,38,221.141578652514,0.47459813075705237,0.7886715833583644,0.12439587854648233,1038101.2711457171,913.4707804692134,1039014.7419261864,864,0,266.5492227979275,67,126,42,39.64898564670034,0.5262305699481865,45.28186274509805,8150.980392156895,121.65642376353574,8
866,32,0,0,193,0.0,0.0,1.0,193,6900,4800,2100,0.6956521739130435,90,48,42,223.307424787318,0.4745048035405872,0.7902670786895536,0.126050196338419,1039186.0685941105,911.5929705219082,1040097.6615646324,865,1,267.5492227979275,69,124,39,39.45779321888746,0.527795768566494,45.14880952380955,8155.2380952381445,118.19185645272674,0
867,32,1,0,194,0.005154639175257732,0.0,1.0,194,6150,4700,1450,0.7642276422764228,76,47,29,219.1791043008316,0.47464634189769067,0.7869373115501368,0.12400977063393898,1039917.6234934336,635.6426527883632,1040553.2661462219,866,0,267.16494845360825,73,121,41,39.4713502843576,0.5293170103092784,45.05912162162165,8158.108108108169,111.75490559052287,0
868,32,1,1,194,0.005128205128205128,0.005128205128205128,0.9948717948717949,195,6300,4400,1900,0.6984126984126984,82,44,38,217.61867786803268,0.47487774253238174,0.786389002313868,0.12365386127582739,1041250.1736111189,19.097222222590972,1041269.2708333415,867,0,266.7897435897436,79,116,42,39.3442901864707,0.5311431623931624,44.89583333333336,8163.333333333396,103.33333333333412,0
869,32,3,1,196,0.015228426395939087,0.005076142131979695,0.9949238578680203,197,7150,5400,1750,0.7552447552447552,89,54,35,210.55501378243116,0.4752581235539901,0.7822503142791892,0.12066651356426575,1043905.9789817359,-2590.07244158762,1041315.9065401483,868,0,264.65482233502536,65,132,44,39.192515241390666,0.5341053299492386,44.570707070707066,8173.737373737368,125.74980574980566,0
870,32,3,1,198,0.01507537688442211,0.005025125628140704,0.9949748743718593,199,6900,4900,2000,0.7101449275362319,89,49,40,204.40731586805057,0.4757023755139333,0.7774579396898436,0.11809824073238279,1046418.5381262538,-3920.8790694086424,1042497.6590568451,869,0,262.9497487437186,70,129,48,39.036056451150245,0.5364321608040201,44.26349765258216,8183.568075117371,116.90811535881959,0
871,32,4,3,199,0.019801980198019802,0.01485148514851485,0.9851485148514851,202,5850,3700,2150,0.6324786324786325,80,37,43,198.52332830009146,0.476345582319426,0.7738178470130324,0.11555678558172075,1048715.2326917935,-4611.112313403852,1044104.1203783896,870,0,257.68811881188117,75,127,43,38.9004697788961,0.5392945544554455,43.983004385964925,8192.543859649153,109.23391812865538,0
872,32,1,1,199,0.005,0.005,0.995,200,6150,4200,1950,0.6829268292682927,81,42,39,201.1470852334281,0.475660594639866,0.7751019168822946,0.11760180157658005,1050070.4195245595,-3906.2791645583475,1046164.1403600011,871,0,257.185,76,124,46,38.66460720635089,0.5410416666666666,43.817640692640694,8197.8354978355,107.8662565504671,0
873,32,4,5,198,0.019704433497536946,0.024630541871921183,0.9753694581280788,203,6500,4600,1900,0.7076923076923077,84,46,38,192.04688620339155,0.476377440699735,0.7680186594300968,0.11322651628836553,1052635.7650903466,-6668.9158016148795,1045966.8492887317,872,0,252.73891625615764,67,136,47,38.57899347029783,0.5439757799671593,43.5049019607843,8207.843137254877,122.50512145156533,0
874,32,0,2,196,0.0,0.010101010101010102,0.98989898989899,198,5800,3900,1900,0.6724137931034483,77,39,38,196.1358177613927,0.47559136201268176,0.766917824990313,0.11590835739473666,1053350.1948703574,-4080.0596279960864,1049270.1352423613,873,1,258.0656565656566,68,130,46,38.385379893308205,0.5454545454545454,43.41787439613526,8210.628019323662,120.7445296959362,0
875,32,1,1,196,0.005076142131979695,0.005076142131979695,0.9949238578680203,197,5800,4100,1700,0.7068965517241379,75,41,34,195.22812272422456,0.4755807779964778,0.7644072857569426,0.1159608006060753,1054900.1736111084,-4010.763888889062,1050889.4097222195,874,0,258.3299492385787,73,124,50,38.216277890466515,0.5481175972927241,43.22916666666666,8216.666666666644,112.55707762557047,0
876,32,1,4,193,0.005076142131979695,0.02030456852791878,0.9796954314720813,197,5300,3100,2200,0.5849056603773585,75,31,44,192.12967681627055,0.475284022238337,0.7602150863637149,0.1148857047085044,1056928.2856263446,-4086.5420129271843,1052841.7436134175,875,0,259.23857868020303,75,122,41,38.04438637656426,0.5498625211505922,42.98245614035087,8224.561403508756,109.66081871345008,0
877,32,4,2,195,0.02030456852791878,0.01015228426395939,0.9898477157360406,197,6800,5300,1500,0.7794117647058824,83,53,30,215.57599549634085,0.4755376135225664,0.7839354704123502,0.12848667269132005,1055941.3932513592,-672.8765928090388,1055268.5166585501,876,0,259.8274111675127,73,124,40,37.56438356164385,0.5453680203045685,43.10247747747748,8220.72072072072,112.6126126126126,7
878,32,0,4,191,0.0,0.020512820512820513,0.9794871794871794,195,6050,4300,1750,0.7107438016528925,78,43,35,216.7722327272001,0.47519715393426737,0.7830374961038549,0.12982422749810807,1057402.6706068057,793.1075598280531,1058195.7781666338,877,1,260.6820512820513,76,119,41,37.35210668490937,0.5469017094017095,42.924783549783534,8226.40692640689,108.24219640009065,0
879,32,0,3,188,0.0,0.015706806282722512,0.9842931937172775,191,5900,4100,1800,0.6949152542372882,77,41,36,218.70303769281634,0.47441788371452187,0.7809693358044527,0.13130088056556194,1058141.2102558608,2183.7393981818473,1060324.9496540427,878,2,266.9947643979058,73,118,43,37.210746346269644,0.5475021815008726,42.835022522522515,8229.279279279255,112.72985314081171,0
880,32,1,1,188,0.005291005291005291,0.005291005291005291,0.9947089947089947,189,5600,4100,1500,0.7321428571428571,71,41,30,214.6728142601963,0.47401520694960414,0.7744721761783839,0.1295539543105786,1059711.8713017767,2098.2659434583375,1061810.137245235,879,0,267.64550264550263,64,125,41,37.11950204454406,0.5492173721340388,42.644230769230774,8235.384615384628,128.6778846153848,0
881,32,2,1,189,0.010526315789473684,0.005263157894736842,0.9947368421052631,190,6250,4600,1650,0.736,79,46,33,233.61405055331693,0.4742516012252855,0.7925736595889379,0.1367266587918955,1050390.99476658,4827.21899042967,1055218.2137570097,880,0,267.18947368421055,72,118,41,37.79284547412193,0.5414473684210526,43.778538812785385,8199.086757990857,113.87620497209524,7
882,32,1,3,187,0.005263157894736842,0.015789473684210527,0.9842105263157894,190,6450,4600,1850,0.7131782945736435,83,46,37,229.44947966957295,0.47381706581267985,0.787909601546982,0.13520285245330793,1052465.5489809324,3847.5345167652285,1056313.0834976977,881,0,268.1421052631579,64,126,40,37.64085020411565,0.5434758771929824,43.52564102564102,8207.179487179477,128.23717948717933,0
883,32,2,2,187,0.010582010582010581,0.010582010582010581,0.9894179894179894,189,5100,3100,2000,0.6078431372549019,71,31,40,221.91114034035922,0.47427670831926155,0.7792230420869064,0.13162186750916627,1054466.0646981227,3899.5533734741457,1058365.6180715968,882,0,269.70899470899474,68,121,44,37.58514652553169,0.5460758377425043,43.28200483091786,8214.975845410601,120.80846831486178,0
884,32,2,1,188,0.010582010582010581,0.005291005291005291,0.9947089947089947,189,5600,4000,1600,0.7142857142857143,72,40,32,216.28068614459082,0.4739096682802357,0.773586673072681,0.12889975542517942,1055925.0947783687,2275.240803191333,1058200.3355815602,883,0,270.5978835978836,70,119,39,37.54830573005898,0.5477843915343915,43.1044600938967,8220.657276995273,117.43796109993247,0
885,32,1,1,188,0.005291005291005291,0.005291005291005291,0.9947089947089947,189,7050,5200,1850,0.7375886524822695,89,52,37,218.06039046488652,0.47379474839581226,0.7749859881771941,0.13040185103099322,1056952.993056853,1245.9164738012987,1058198.9095306543,884,0,271.5925925925926,72,117,41,37.37485195055143,0.5494929453262787,42.9794520547945,8224.65753424653,114.23135464231291,0
886,32,4,3,189,0.020833333333333332,0.015625,0.984375,192,5400,3900,1500,0.7222222222222222,69,39,30,246.64218120389148,0.47428044557155324,0.8019098874088164,0.14579355030668745,1053429.603576662,8164.0350341798,1061593.6386108417,885,0,268.109375,63,129,38,37.07956707897242,0.5437825520833333,43.40820312500001,8210.937500000015,130.3323412698415,8
887,32,1,2,188,0.005263157894736842,0.010526315789473684,0.9894736842105263,190,6100,4300,1800,0.7049180327868853,79,43,36,245.6253757170565,0.473651141743247,0.7992955086624525,0.14605367888184934,1055229.3926692992,7738.223208415704,1062967.615877715,886,0,271.82105263157894,64,126,40,36.88117524700991,0.5453399122807018,43.189102564102576,8217.948717948739,128.40544871794904,0
888,32,0,1,187,0.0,0.005319148936170213,0.9946808510638298,188,5500,3600,1900,0.6545454545454545,74,36,38,253.43863942742354,0.4733485512193272,0.8022316080234666,0.15148697206476333,1056810.3591387274,10467.315910585341,1067277.6750493129,887,1,275.43617021276594,64,124,38,36.48334060817693,0.546875,42.99679487179488,8224.102564102586,128.5016025641029,0
889,32,1,3,185,0.005319148936170213,0.015957446808510637,0.9840425531914894,188,6700,4600,2100,0.6865671641791045,88,46,42,252.83848000415085,0.47347951511358893,0.8029825296851327,0.15212601782358823,1058800.0451721482,9241.078809930408,1068041.1239820786,888,0,275.0159574468085,66,122,41,36.25083101655988,0.5495899822695036,42.754975124378106,8231.840796019893,124.72486054575596,0
890,32,2,1,186,0.0106951871657754,0.0053475935828877,0.9946524064171123,187,6300,4400,1900,0.6984126984126984,82,44,38,245.18751078743452,0.47331234546604567,0.7953084625520179,0.1487328592346891,1061259.9767675484,8341.538400393249,1069601.5151679416,889,0,276.6096256684492,61,126,42,36.14166775393046,0.5521390374331551,42.45631720430109,8241.397849462388,135.10488277807193,0
891,32,3,1,188,0.015873015873015872,0.005291005291005291,0.9947089947089947,189,5800,4000,1800,0.6896551724137931,76,40,36,237.94231074906662,0.4735567000637923,0.7898405442028777,0.14528268267157096,1063216.1617755892,6996.822071727647,1070212.9838473168,890,0,274.6190476190476,65,124,45,36.085366538092615,0.5544532627865961,42.219065656565675,8248.98989898994,126.90753690753753,0
892,32,1,1,188,0.005291005291005291,0.005291005291005291,0.9947089947089947,189,5700,3900,1800,0.6842105263157895,75,39,36,239.3042968253041,0.4729387125220459,0.7912888764577455,0.14681641994417327,1064648.7603305806,7455.004591368375,1072103.764921949,891,0,275.53968253968253,65,124,37,35.872491434165454,0.5561618165784832,42.045454545454554,8254.545454545472,126.99300699300727,0
893,32,2,3,187,0.010526315789473684,0.015789473684210527,0.9842105263157894,190,6600,4600,2000,0.696969696969697,86,46,40,238.3908895044625,0.4728899795785761,0.7918707294552174,0.14705931495405195,1066280.7183364877,6238.321781138688,1072519.0401176263,892,0,275.07894736842104,68,122,40,35.693713450292435,0.5579495614035088,41.84782608695654,8260.869565217421,121.48337595907972,0
894,32,0,2,185,0.0,0.0106951871657754,0.9893048128342246,187,5950,4900,1050,0.8235294117647058,70,49,21,246.00886282838363,0.4722761294155981,0.7955797879681517,0.15194134785534674,1066638.3760152366,9130.498786524557,1075768.8748017612,893,1,279.4652406417112,67,120,41,35.45269702363294,0.5592134581105169,41.8045343137255,8262.254901960801,123.31723734269853,0
895,32,0,1,184,0.0,0.005405405405405406,0.9945945945945946,185,6500,4700,1800,0.7230769230769231,83,47,36,249.29980680059634,0.4719459949079514,0.797630867330174,0.15436812495280425,1067397.909608085,9720.418528931274,1077118.3281370162,894,2,282.427027027027,67,118,42,35.27352321926341,0.5604166666666667,41.71262254901961,8265.196078431385,123.3611354989759,0
896,32,0,0,184,0.0,0.0,1.0,184,5450,4000,1450,0.7339449541284404,69,40,29,252.2558988018807,0.4713937643541617,0.7998160557966549,0.15678427136998446,1068507.657641484,11657.471911009077,1080165.129552493,895,3,284.9347826086956,58,126,39,35.05955227619502,0.5618772644927537,41.57838983050848,8269.49152542374,142.57744009351276,0
897,32,0,1,183,0.0,0.005434782608695652,0.9945652173913043,184,5750,3900,1850,0.6782608695652174,76,39,37,263.69885904035306,0.4711864952086798,0.8073199155648063,0.1596185338599364,1060613.9081790142,13386.535493827236,1074000.4436728414,896,4,285.9347826086956,59,125,35,35.74539222297146,0.5543478260869565,42.53472222222223,8238.888888888903,139.64218455743904,8
898,32,0,2,181,0.0,0.01092896174863388,0.9890710382513661,183,6200,3900,2300,0.6290322580645161,85,39,46,267.011032530021,0.47088612662383156,0.8079390169678367,0.1624727648125481,1062187.8906250019,13923.177083333441,1076111.0677083354,897,5,288.2295081967213,59,124,35,35.46404386496868,0.5561247723132969,42.34375000000001,8245.000000000015,139.74576271186464,0
899,32,0,1,180,0.0,0.0055248618784530384,0.994475138121547,181,4550,3200,1350,0.7032967032967034,59,32,27,262.088709204273,0.4703281665643544,0.8008115039618229,0.15983719871190188,1062862.8117913844,14962.868480725687,1077825.68027211,898,6,291.9281767955801,62,119,35,35.50688029253272,0.5574355432780846,42.261904761904766,8247.619047619057,133.0261136712751,0
900,32,0,1,179,0.0,0.005555555555555556,0.9944444444444445,180,5300,3700,1600,0.6981132075471698,69,37,32,258.64402138692645,0.47009621353196773,0.7971398333467294,0.15843378976242006,1064182.136580778,13748.869458676818,1077931.0060394548,899,7,292.55,66,114,37,35.431612209629435,0.5589120370370371,42.101990049751244,8252.736318407962,125.04145936981762,0
901,32,0,1,178,0.0,0.00558659217877095,0.994413407821229,179,6300,4000,2300,0.6349206349206349,86,40,46,253.69061771889952,0.4695169794739815,0.7927537969454557,0.1565630910722086,1066405.433178137,12007.41061635044,1078412.8437944874,900,8,294.9888268156425,68,111,36,35.2832680350077,0.5608705772811918,41.832729468599034,8261.35265700483,121.49048025007104,0
902,32,1,1,178,0.00558659217877095,0.00558659217877095,0.994413407821229,179,5800,4200,1600,0.7241379310344828,74,42,32,226.37669144820705,0.4696281359194861,0.768804710964978,0.13467288963098353,1055375.7287379913,6182.493141289109,1061558.2218792804,901,0,295.4804469273743,71,108,41,37.35729307495867,0.5526070763500931,43.171296296296276,8218.518518518473,115.75378195096441,8
903,32,1,3,176,0.00558659217877095,0.01675977653631285,0.9832402234636871,179,4900,3300,1600,0.673469387755102,65,33,32,231.65037869947676,0.46944897788379053,0.7742086178069914,0.13842147711936187,1056718.2841266834,8257.838139321404,1064976.1222660048,902,0,296.4078212290503,72,107,36,37.054761243753475,0.5541783054003724,43.0079908675799,8223.744292237421,114.21867072551974,0
904,32,1,1,176,0.005649717514124294,0.005649717514124294,0.9943502824858758,177,5900,4400,1500,0.7457627118644068,74,44,30,238.08667476255593,0.4687647128060264,0.7774211483873243,0.14283657474251318,1057926.5308641968,9075.641975308547,1067002.1728395054,903,0,295.24858757062145,74,103,38,36.73897681034169,0.5565560263653484,42.86111111111111,8228.444444444438,111.19519519519511,0
905,32,2,0,178,0.011235955056179775,0.0,1.0,178,5500,4000,1500,0.7272727272727273,70,40,30,238.25469536424347,0.469052852366745,0.7805946982037832,0.1438020229809579,1059746.488585806,9397.915360267694,1069144.4039460737,904,0,294.5056179775281,60,118,40,36.50830513347932,0.5585791198501873,42.64002732240438,8235.519125683073,137.2586520947179,0
906,32,0,0,178,0.0,0.0,1.0,178,5250,3700,1550,0.7047619047619048,68,37,31,213.85719547350195,0.4686534575424787,0.759323548788216,0.1294585419170039,1060635.9138724527,4514.924391847484,1065150.8382643003,905,1,295.5056179775281,64,114,39,37.02591393833768,0.5626755617977528,42.532051282051285,8238.974358974361,128.7339743589744,8
907,32,1,2,177,0.00558659217877095,0.0111731843575419,0.9888268156424581,179,5250,3500,1750,0.6666666666666666,70,35,35,210.95431206477264,0.46854011047642957,0.7580845488173777,0.12850304014970979,1062514.7931053678,3778.4154476373706,1066293.2085530052,906,0,294.8491620111732,66,113,41,36.86789844142785,0.5644203910614525,42.304104477611936,8246.268656716411,124.9434644957032,0
908,32,0,3,174,0.0,0.01694915254237288,0.9830508474576272,177,5400,3500,1900,0.6481481481481481,73,35,38,208.56934616730916,0.4680839111453518,0.7518936599400459,0.12758810507798382,1063779.1808558758,3574.3456435014323,1067353.5264993773,907,1,295.6497175141243,70,107,45,36.772878141299195,0.5663841807909604,42.15082159624415,8251.173708920229,117.87391012743184,0
909,32,1,0,175,0.005714285714285714,0.0,1.0,175,5450,4200,1250,0.7706422018348624,67,42,25,207.44699642343517,0.46722632731253416,0.7482080776686588,0.12748482888406432,1065148.2258444799,3742.360039437733,1068890.5858839175,908,0,296.58285714285716,71,104,36,36.632509065081706,0.5682738095238096,41.98495370370371,8256.48148148149,116.28847157016185,0
910,32,1,2,174,0.005681818181818182,0.011363636363636364,0.9886363636363636,176,5750,4100,1650,0.7130434782608696,74,41,33,205.6851897619444,0.46724499458874463,0.7471755971594565,0.12693480435906462,1066400.4444444461,2918.555555555623,1069319.0000000019,909,0,295.89204545454544,74,102,38,36.523227350979106,0.5698982007575757,41.833333333333336,8261.333333333345,111.6396396396398,0
911,32,0,3,171,0.0,0.017241379310344827,0.9827586206896551,174,5300,3700,1600,0.6981132075471698,69,37,32,204.93744991440224,0.4666481186189179,0.7441091488392129,0.12294918819556835,1057926.5308641968,3261.7530864196583,1061188.2839506164,910,1,299.6666666666667,74,100,44,37.5913722948399,0.5599856321839081,42.86111111111111,8228.444444444438,111.19519519519511,8
912,32,4,1,174,0.022857142857142857,0.005714285714285714,0.9942857142857143,175,5550,3900,1650,0.7027027027027027,72,39,33,196.50825030285807,0.4670114942528736,0.7345600169302526,0.11905130483484519,1060875.8217340042,1144.1703035112655,1062019.9920375154,911,0,297.98285714285714,70,105,47,37.44290448787343,0.5629761904761905,42.50293427230047,8239.906103286392,117.71294433266274,0
913,32,0,4,170,0.0,0.022988505747126436,0.9770114942528736,174,6300,4500,1800,0.7142857142857143,81,45,36,198.65819409393092,0.46690211613846255,0.7342585539386983,0.12098587104943911,1062447.9821023226,1112.799488637951,1063560.7815909607,912,1,299.1609195402299,70,104,46,37.19302740453959,0.5648347701149425,42.31220657276997,8246.00938967141,117.800134138163,0
914,32,2,1,171,0.011627906976744186,0.005813953488372093,0.9941860465116279,172,5250,3900,1350,0.7428571428571429,66,39,27,198.20231984540135,0.4663537275035133,0.7310838307718615,0.1217701714279553,1065066.4113811294,2569.7267050315977,1067636.138086161,913,0,295.20348837209303,72,100,43,36.88114134542709,0.5676477713178294,41.994863013698655,8256.164383561701,114.6689497716903,0
915,32,0,0,171,0.0,0.0,1.0,171,5100,3500,1600,0.6862745098039216,67,35,32,200.7252358995383,0.46596147230822155,0.7325914845302468,0.12343154308200124,1065335.4822305485,3467.9431965752938,1068803.425427124,914,1,297.90058479532166,73,98,44,36.78280644809341,0.5689571150097466,41.9622747747748,8257.207207207264,113.11242749598992,0
916,32,0,1,170,0.0,0.005847953216374269,0.9941520467836258,171,5200,3600,1600,0.6923076923076923,68,36,32,199.89029852473482,0.4658453732370141,0.7302261523213742,0.1232807587734006,1066212.6951331573,3225.1147842060936,1069437.8099173633,915,2,298.90058479532166,76,95,45,36.69601369528005,0.570114522417154,41.85606060606063,8260.60606060612,108.69218500797527,0
917,32,0,1,169,0.0,0.0058823529411764705,0.9941176470588236,170,5900,4400,1500,0.7457627118644068,74,44,30,204.60667090345268,0.46496475809258614,0.7308697544438356,0.1251023644952528,1063631.8769052012,3625.235480072488,1067257.1123852737,916,3,298.43529411764706,82,88,39,36.89327378634472,0.5710171568627451,42.16867469879515,8250.602409638475,100.61710255656678,8
918,32,1,1,169,0.0058823529411764705,0.0058823529411764705,0.9941176470588236,170,5550,4100,1450,0.7387387387387387,70,41,29,206.94545178679815,0.46478129713423827,0.7345587162237577,0.12710420234183387,1064978.4101264416,4528.4876453601655,1069506.8977718018,917,0,299.4,82,88,37,36.66644370936094,0.5727941176470588,42.00552208835339,8255.823293172627,100.68077186795887,0
919,32,0,1,168,0.0,0.005917159763313609,0.9940828402366864,169,5050,3500,1550,0.693069306930693,66,35,31,189.3075782221133,0.4642255447543909,0.7123624208367898,0.11205921484973233,1053856.6479319553,1050.609962654627,1054907.2578946098,918,1,298.2130177514793,81,88,40,38.49773754722894,0.5639176528599605,43.35619918699188,8212.601626016287,101.39014353106528,8
920,32,0,1,167,0.0,0.005952380952380952,0.9940476190476191,168,4450,2900,1550,0.651685393258427,60,29,31,200.88142097793946,0.4640317579127459,0.7234088160659777,0.11884659438152942,1053693.4765139862,4283.488567462811,1057976.9650814491,919,2,300.94642857142856,77,91,40,38.2209703719123,0.5629960317460317,43.37606837606837,8211.965811965787,106.64890664890632,8
921,32,1,0,168,0.005952380952380952,0.0,1.0,168,5750,4000,1750,0.6956521739130435,75,40,35,200.33460388110427,0.4635186472293508,0.7220469501481457,0.1191984997430305,1055422.1300978279,2937.5148721000214,1058359.6449699278,920,0,301.8809523809524,81,87,39,38.020369637616625,0.5646701388888888,43.16565040650407,8218.69918699189,101.46542206162826,0
922,32,0,1,167,0.0,0.005952380952380952,0.9940476190476191,168,4700,3000,1700,0.6382978723404256,64,30,34,203.73577710751306,0.46326246316890024,0.7257205126575268,0.12159821668792159,1056361.9771010964,4743.745662304109,1061105.7227634005,921,1,302.8809523809524,81,87,34,37.81635726174582,0.5656001984126984,43.05132113821138,8222.35772357723,101.5105891799658,0
923,32,2,0,169,0.011834319526627219,0.0,1.0,169,5000,3700,1300,0.74,63,37,26,189.82199157621127,0.46364586268432423,0.7149164265520482,0.11161998212164423,1051829.9392988912,1132.090775440277,1052962.0300743314,922,0,302.07100591715977,77,92,38,38.73612123895343,0.5591715976331362,43.6030982905983,8204.700854700866,106.55455655455671,8
924,32,2,0,171,0.011695906432748537,0.0,1.0,171,5250,3700,1550,0.7047619047619048,68,37,31,203.7768118943851,0.4638960554982227,0.7383525079264788,0.1178822958330143,1046807.2026969917,3213.006886734792,1050020.2095837265,923,0,299.5263157894737,75,96,43,39.00372414532206,0.5492202729044835,44.21600877192985,8185.08771929831,109.13450292397746,8
925,32,2,1,172,0.011560693641618497,0.005780346820809248,0.9942196531791907,173,6600,5100,1500,0.7727272727272727,81,51,30,193.92479356826797,0.4641472868217054,0.7287035886872593,0.11293821817408395,1048873.593761417,-519.4809701218214,1048354.1127912953,924,0,297.05202312138726,77,96,44,38.998496070658604,0.5500963391136802,43.963675213675224,8193.162393162416,106.4047064047067,8
926,32,1,0,173,0.005780346820809248,0.0,1.0,173,4800,3200,1600,0.6666666666666666,64,32,32,194.4735038999953,0.46452956266523276,0.7303354810355485,0.11374734431439758,1050197.960069452,1447.1354166670308,1051645.095486119,925,0,297.5202312138728,79,94,45,38.819712678728735,0.5521435452793835,43.80208333333336,8198.333333333394,103.77637130801764,0
927,32,2,1,174,0.011428571428571429,0.005714285714285714,0.9942857142857143,175,5950,4200,1750,0.7058823529411765,77,42,35,187.94301619666962,0.4648932676518884,0.7242658806375,0.11087360259475196,1052819.2751450706,-1375.9939838490523,1051443.2811612217,926,0,295.10857142857145,73,102,45,38.66147862591232,0.5547619047619048,43.48254504504502,8208.558558558503,112.44600765148634,0
928,32,1,0,175,0.005714285714285714,0.0,1.0,175,5300,3900,1400,0.7358490566037735,67,39,28,189.38567943089765,0.4650903119868637,0.7264676905244869,0.11249053007160456,1054900.173611102,-343.40277777826896,1054556.7708333237,927,0,295.62285714285713,75,100,44,38.366294793779545,0.5570833333333334,43.229166666666636,8216.666666666593,109.55555555555458,0
929,32,4,3,176,0.0223463687150838,0.01675977653631285,0.9832402234636871,179,5400,4000,1400,0.7407407407407407,68,40,28,182.5257609707164,0.46575989161592707,0.7221002343936738,0.10911688103499076,1056855.9189190257,-2619.3138325800855,1054236.6050864456,928,0,289.99441340782124,80,99,40,38.30018347093652,0.5595903165735567,42.9912551440329,8224.279835390886,102.80349794238607,0
930,32,1,2,175,0.005649717514124294,0.011299435028248588,0.9887005649717514,177,5900,4300,1600,0.7288135593220338,75,43,32,223.98053352293834,0.4650223099640472,0.7697767222963225,0.12823500875324298,1043602.4605920821,5449.327181853294,1049051.7877739354,929,0,294.26553672316385,67,110,37,38.887555982085715,0.5460805084745763,44.60784313725491,8172.549019607861,121.97834357623672,8
931,32,3,0,178,0.016853932584269662,0.0,1.0,178,5700,3500,2200,0.6140350877192983,79,35,44,217.77913220677863,0.46501129414503056,0.7648869194725212,0.12582326265022215,1046416.8934133998,4277.552594816719,1050694.4460082166,930,0,293.44943820224717,72,106,40,38.69429565152702,0.5486306179775281,44.26369863013699,8183.561643835627,113.66057838660593,0
932,32,4,5,177,0.02197802197802198,0.027472527472527472,0.9725274725274725,182,6450,5000,1450,0.7751937984496124,79,50,29,209.7779942946899,0.46617413433711774,0.7610907296524456,0.12222258839509792,1049003.7904582678,1161.5822339728593,1050165.3726922406,931,0,287.97802197802196,78,104,39,38.576372796402154,0.5510531135531136,43.947784810126606,8193.670886076012,105.04706264200016,0
933,32,1,0,178,0.0056179775280898875,0.0,1.0,178,5200,3700,1500,0.7115384615384616,67,37,30,214.5385660009503,0.46527843902748683,0.7618269896112659,0.1251659896623134,1049420.7512647063,4228.244621594193,1053648.9958863005,932,0,294.6685393258427,77,101,40,38.40250256383515,0.552375936329588,43.896901709401725,8195.299145299183,106.43245643245692,0
934,32,1,1,178,0.00558659217877095,0.00558659217877095,0.994413407821229,179,5700,4100,1600,0.7192982456140351,73,41,32,222.79355471317223,0.46556634862846025,0.7714277750734329,0.1268548782259242,1041890.6570178958,4925.304619891722,1046815.9616377875,933,0,294.01675977653633,80,99,39,39.132082682390056,0.5412011173184357,44.817386831275705,8165.843621399141,102.07304526748926,8
935,32,1,1,178,0.00558659217877095,0.00558659217877095,0.994413407821229,179,5700,4000,1700,0.7017543859649122,74,40,34,226.0328816331769,0.4655689640742368,0.7748658890343005,0.12944919629882537,1043696.3568793415,5681.939019097301,1049378.295898439,934,0,294.98324022346367,63,116,40,38.823391961933915,0.5431215083798883,44.59635416666667,8172.916666666677,129.72883597883614,0
936,32,3,1,180,0.016574585635359115,0.0055248618784530384,0.994475138121547,181,6000,4400,1600,0.7333333333333333,76,44,32,219.5527644235751,0.46570109474114996,0.7704650560925381,0.12682400862585372,1046358.5069444469,3746.1805555557144,1050104.6875000026,935,0,292.58011049723757,69,112,41,38.65622878479293,0.5455225598526703,44.27083333333334,8183.333333333353,118.5990338164254,0
937,32,4,2,182,0.021739130434782608,0.010869565217391304,0.9891304347826086,184,5600,3800,1800,0.6785714285714286,74,38,36,214.14973040167368,0.46662595529421086,0.7674158774194124,0.12497788828497242,1049515.9854575496,2550.713067596499,1052066.698525146,936,0,288.07065217391306,76,108,39,38.4005915909571,0.5489696557971014,43.8852813852814,8195.67099567104,107.83777625882948,0
938,32,3,0,185,0.016216216216216217,0.0,1.0,185,6150,5000,1150,0.8130081300813008,73,50,23,212.67420801912905,0.46674378182530357,0.7679065265059102,0.12515554908277182,1052069.157905173,1599.594987766775,1053668.7528929398,937,0,287.4918918918919,70,115,40,38.120422817256,0.5514076576576576,43.57394366197182,8205.633802816867,117.22334004024096,0
939,32,0,0,185,0.0,0.0,1.0,185,6450,4900,1550,0.7596899224806202,80,49,31,210.4198185009267,0.4668502741872307,0.7652383822563451,0.12433646915757972,1053317.933451134,877.793676111613,1054195.7271272456,938,1,288.4918918918919,72,113,40,38.02288990230425,0.5525337837837838,43.42180365296802,8210.502283104997,114.03475393201386,0
940,32,1,1,185,0.005376344086021506,0.005376344086021506,0.9946236559139785,186,5450,3500,1950,0.6422018348623854,74,35,39,181.97773335878358,0.4671522328780393,0.7335780346505789,0.10847192384195671,1055970.323350684,-4217.38281250056,1051752.9405381836,939,0,287.93548387096774,79,107,38,38.4239314073323,0.5555555555555556,43.0989583333333,8220.833333333252,104.06118143459813,8
941,32,1,1,185,0.005376344086021506,0.005376344086021506,0.9946236559139785,186,5100,3600,1500,0.7058823529411765,66,36,30,180.7480154027617,0.46665516322774386,0.732213861003578,0.10818471219986386,1057221.6677956728,-4081.856341027087,1053139.8114546456,940,0,288.9139784946237,82,104,41,38.30060134101486,0.5572916666666667,42.94678714859435,8225.702811244917,100.31344891762095,0
942,32,1,2,184,0.005376344086021506,0.010752688172043012,0.989247311827957,186,5950,4300,1650,0.7226890756302521,76,43,33,179.4693895709894,0.46634335948852074,0.7310475189413401,0.10804619721531362,1058979.837884217,-5139.1069853873,1053840.7308988296,941,0,289.8333333333333,83,103,45,38.115982197371345,0.5591397849462365,42.73313492063489,8232.539682539598,99.18722509083854,0
943,32,2,0,186,0.010752688172043012,0.0,1.0,186,6750,4900,1850,0.725925925925926,86,49,37,173.24791679172097,0.46687675578804616,0.721566590901108,0.1051757183242656,1061494.3139792879,-7169.664283366332,1054324.6496959215,942,0,289.4032258064516,77,109,44,37.965501373982434,0.5617719534050178,42.427884615384606,8242.307692307675,107.04295704295681,0
944,32,1,0,187,0.0053475935828877,0.0,1.0,187,5800,3700,2100,0.6379310344827587,79,37,42,172.24447474857058,0.4670471316581373,0.7204812007290908,0.10524184654936233,1063423.5153220154,-6566.235033616373,1056857.280288399,943,0,288.85026737967917,80,107,47,37.753362930446805,0.5636697860962567,42.19393004115225,8249.794238683087,103.12242798353859,0
945,32,0,1,186,0.0,0.0053475935828877,0.9946524064171123,187,5950,3800,2150,0.6386554621848739,81,38,43,212.95299284612724,0.4669177543940352,0.7651848721455536,0.12496490643683955,1051202.218899643,1421.3317202338167,1052623.550619877,944,1,289.85026737967917,73,114,37,38.221197850879605,0.5459001782531194,43.67961711711712,8202.252252252254,112.3596198938665,8
946,32,1,2,185,0.0053475935828877,0.0106951871657754,0.9893048128342246,187,6100,3900,2200,0.639344262295082,83,39,44,213.276864889842,0.46670811530868456,0.7683440752159485,0.12613647105328726,1053588.1975308568,1441.197530863772,1055029.3950617206,945,0,290.3582887700535,74,113,37,37.91596756152125,0.5480726381461676,43.388888888888864,8211.555555555497,110.96696696696617,0
947,32,0,1,184,0.0,0.005405405405405406,0.9945945945945946,185,4600,3200,1400,0.6956521739130435,60,32,28,213.54433989579215,0.46635086173129653,0.7661660699623223,0.12660563285559556,1054337.1548216683,3429.54635079985,1057766.7011724683,946,1,294.2972972972973,75,110,41,37.81596499190201,0.5493806306306306,43.29769736842103,8214.473684210467,109.52631578947289,0
948,32,1,2,183,0.005405405405405406,0.010810810810810811,0.9891891891891892,185,5300,3600,1700,0.6792452830188679,70,36,34,257.0822066303702,0.46613787700744225,0.8063084040730237,0.15231386077497375,1054128.5991295623,11899.541267281613,1066028.140396844,947,0,294.41621621621624,60,125,37,36.72438072428092,0.5505630630630631,43.32308743169398,8213.66120218577,136.89435336976285,8
949,32,0,2,181,0.0,0.01092896174863388,0.9890710382513661,183,6300,4600,1700,0.7301587301587301,80,46,34,251.24945971056468,0.46566934886607014,0.7994285996186385,0.1494396591881587,1055314.3607642464,10129.432593363172,1065443.7933576095,941,1,293.08743169398906,61,122,40,36.726143748091935,0.5528233151183971,43.1787634408602,8218.279569892444,134.7258945884007,0
950,32,4,2,183,0.021621621621621623,0.010810810810810811,0.9891891891891892,185,5250,3800,1450,0.7238095238095238,67,38,29,242.21949596351348,0.4661819428123776,0.7929488552113204,0.1453749974522524,1058049.2216034695,9006.029832276028,1067055.2514357455,942,0,289.36756756756756,67,118,37,36.61743462202893,0.5555743243243243,42.846200980392155,8228.921568627447,122.81972490488728,0
951,32,0,3,180,0.0,0.01639344262295082,0.9836065573770492,183,4950,3400,1550,0.6868686868686869,65,34,31,246.1726343979376,0.4654992093516684,0.794414300007698,0.14812082239197907,1058811.1741230807,10580.067212770293,1069391.241335851,943,1,293.4863387978142,68,115,38,36.42092136150236,0.5566370673952641,42.75362318840579,8231.884057970994,121.05711849957345,0
952,32,1,1,180,0.0055248618784530384,0.0055248618784530384,0.994475138121547,181,6700,5300,1400,0.7910447761194029,81,53,28,242.57050078228704,0.4651268671986904,0.7873800747431241,0.14712921028757395,1061227.009322246,8584.47341899713,1069811.4827412432,944,0,297.0718232044199,62,119,38,36.213164483821274,0.5593922651933702,42.460317460317455,8241.269841269832,132.92370711725536,0
953,32,1,1,180,0.0055248618784530384,0.0055248618784530384,0.994475138121547,181,7050,4900,2150,0.6950354609929078,92,49,43,242.76947669121972,0.46502583384489465,0.7870502887693134,0.14845460919790485,1063668.9685898838,8395.271775450956,1072064.2403653348,945,0,296.81767955801104,66,115,39,35.90471237337194,0.5622697974217311,42.164179104477604,8250.746268656696,125.01130710085903,0
954,32,1,4,177,0.0055248618784530384,0.022099447513812154,0.9779005524861879,181,6750,5200,1550,0.7703703703703704,83,52,31,244.2014375047957,0.46507826887661147,0.7882353891723046,0.15032854066058646,1065657.2535240038,9097.00663959491,1074754.2601635987,946,0,297.54696132596683,68,113,39,35.6210392902408,0.5646293738489871,41.92330917874396,8258.4541062802,121.44785450412058,0
955,32,0,2,175,0.0,0.011299435028248588,0.9887005649717514,177,5200,3500,1700,0.6730769230769231,69,35,34,243.0048554898413,0.46461971409005304,0.7778404651929562,0.14664452690205393,1059696.1128746795,10902.260154451527,1070598.373029131,947,1,302.1864406779661,66,111,35,36.392320626673936,0.5595574387947269,42.64614427860696,8235.323383084564,124.77762701643279,6
956,32,1,3,173,0.005681818181818182,0.017045454545454544,0.9829545454545454,176,6400,5000,1400,0.78125,78,50,28,258.03760853834507,0.46457521645021643,0.7873679156696696,0.15654671222422556,1061296.1908284,13170.866206442894,1074467.057034843,948,0,304.70454545454544,64,112,36,35.806214091635,0.5627367424242424,42.451923076923066,8241.538461538443,128.77403846153817,8
957,32,1,1,173,0.005747126436781609,0.005747126436781609,0.9942528735632183,174,4250,3200,1050,0.7529411764705882,53,32,21,254.4666395859606,0.4639413494119992,0.7827504562580021,0.15523700751133046,1062955.7929356683,15047.35773135388,1078003.1506670222,949,0,307.7816091954023,65,109,38,35.691769742616295,0.56459530651341,42.25063131313131,8247.979797979786,126.89199689199671,0
958,32,1,1,173,0.005747126436781609,0.005747126436781609,0.9942528735632183,174,6200,4700,1500,0.7580645161290323,77,47,30,249.08551706621614,0.46403201337674127,0.7884750668612832,0.15120428523708646,1061472.2993827187,11879.47530864211,1073351.7746913608,950,0,304.71264367816093,59,115,41,36.01487373056527,0.5590277777777778,42.430555555555564,8242.222222222243,139.69868173258038,8
959,32,1,1,173,0.005747126436781609,0.005747126436781609,0.9942528735632183,174,5450,3900,1550,0.7155963302752294,70,39,31,241.13813042239212,0.46331362257214365,0.7770504470379984,0.1426214937263614,1053603.7497768092,10562.807685440348,1064166.5574622496,951,0,305.6954022988506,65,109,36,37.1990769214999,0.5476532567049808,43.386994949494955,8211.616161616168,126.33255633255644,8
960,32,1,0,174,0.005747126436781609,0.0,1.0,174,5100,3600,1500,0.7058823529411765,66,36,30,226.9053593306779,0.46320842468938944,0.7597616242663521,0.13340852559995908,1051790.0955578536,7831.361914600668,1059621.4574724543,952,0,306.5689655172414,65,109,36,37.79028162511543,0.5502873563218391,43.607954545454554,8204.545454545474,126.22377622377653,8
961,32,1,1,174,0.005714285714285714,0.005714285714285714,0.9942857142857143,175,4750,3100,1650,0.6526315789473685,64,31,33,225.80306437337637,0.4637794198139025,0.7567454527115631,0.13344050354971856,1053350.1948703588,7819.940372004087,1061170.135242363,953,0,305.81142857142856,68,107,33,37.62417137365659,0.5519642857142857,43.41787439613527,8210.628019323673,120.74452969593636,0
962,32,4,6,172,0.02247191011235955,0.033707865168539325,0.9662921348314607,178,6400,4600,1800,0.71875,82,46,36,223.2898051243448,0.46470976427770366,0.7592982765058947,0.133504938411179,1056898.225308639,5198.919753086229,1062097.1450617253,954,0,301.07865168539325,74,104,33,37.24725299468612,0.5545997191011236,42.9861111111111,8224.44444444442,111.1411411411408,0
963,32,1,4,169,0.005780346820809248,0.023121387283236993,0.976878612716763,173,5350,3800,1550,0.7102803738317757,69,38,31,185.25419203265972,0.46337713402339026,0.7180225664893491,0.11301068796642823,1062946.8767592441,-566.9270344652905,1062379.9497247788,955,0,310.2485549132948,72,101,45,37.47681725073356,0.5661729287090559,42.251712328767134,8247.945205479471,114.55479452054821,8
964,32,0,1,168,0.0,0.005917159763313609,0.9940828402366864,169,5850,4700,1150,0.8034188034188035,70,47,23,184.20768934096392,0.46251878463416923,0.7099635484598921,0.11263608514247911,1063648.4444444482,-463.55555555530555,1063184.888888893,956,1,318.4852071005917,74,95,49,37.41717840982543,0.567430966469428,42.16666666666668,8250.666666666697,111.4954954954959,0
965,32,1,2,167,0.005917159763313609,0.011834319526627219,0.9881656804733728,169,4150,2600,1550,0.6265060240963856,57,26,31,184.3567980468217,0.46224582041889734,0.7098302043207176,0.11327489859371793,1065095.4817188657,1321.5185247657218,1066417.0002436314,957,0,319.42011834319527,76,93,40,37.23477698545865,0.5689102564102564,41.99134199134202,8256.277056277115,108.63522442469888,0
966,32,0,1,166,0.0,0.005988023952095809,0.9940119760479041,167,4500,3000,1500,0.6666666666666666,60,30,30,189.2828267392188,0.4615573070726018,0.7129905734315121,0.11674655522875302,1066232.7530316375,2463.9098911537826,1068696.6629227912,958,3,321.23952095808386,77,90,42,36.967365062941866,0.5706087824351298,41.8536324786325,8260.68376068381,107.28160728160793,0
967,32,0,0,166,0.0,0.0,1.0,166,6100,4300,1800,0.7049180327868853,79,43,36,192.30697908061126,0.4610335280516003,0.7160324228601314,0.1190595982692667,1067352.5800606327,1751.8700570714664,1069104.4501177042,959,5,324.1566265060241,80,86,46,36.75116593640046,0.572289156626506,41.71810699588479,8265.020576131727,103.31275720164658,0
968,32,1,0,167,0.005988023952095809,0.0,1.0,167,4650,3700,950,0.7956989247311828,56,37,19,192.06088502654194,0.4610387658418103,0.7174584747153154,0.11967294457249285,1069254.478458055,3022.392290249698,1072276.8707483048,960,0,323.20958083832335,69,98,46,36.52309271624837,0.5742265469061876,41.488095238095255,8272.380952380992,119.88957902001438,0
969,32,1,0,168,0.005952380952380952,0.0,1.0,168,4650,3300,1350,0.7096774193548387,60,33,27,187.55881293169332,0.4612018522478852,0.7119579584949964,0.11725138040129397,1070222.869617938,1895.9461995785196,1072118.8158175165,961,0,322.2797619047619,73,95,46,36.520244833904876,0.5757068452380952,41.371058558558595,8276.1261261262,113.37159076885206,0
970,32,2,1,169,0.011764705882352941,0.0058823529411764705,0.9941176470588236,170,5600,4100,1500,0.7321428571428571,71,41,30,185.37309884942576,0.46129481378350157,0.7124685874145986,0.11694642750735297,1072906.9888417171,177.61865975931323,1073084.6075014765,962,0,319.4764705882353,78,92,48,36.24664782660357,0.5783088235294118,41.04694092827007,8286.497890295417,106.23715243968483,0
971,32,2,1,170,0.011695906432748537,0.005847953216374269,0.9941520467836258,171,4950,3400,1550,0.6868686868686869,65,34,31,188.02361737188917,0.4612945763100562,0.7181352231598852,0.1195756108507936,1075260.7216012743,1284.8820986762616,1076545.6036999505,963,0,318.00584795321635,82,89,45,35.88878534082106,0.5804093567251463,40.76305220883537,8295.582329317345,101.16563816240665,0
972,32,2,4,168,0.011627906976744186,0.023255813953488372,0.9767441860465116,172,5650,4000,1650,0.7079646017699115,73,40,33,188.19021772659244,0.4616483068135455,0.7198338212667346,0.12044571379523454,1077116.9837211429,490.5759366981997,1077607.559657841,964,0,317.13953488372096,72,100,46,35.6565885717428,0.5821220930232558,40.53938356164382,8302.739726027354,115.31582952815769,0
973,32,1,2,167,0.005917159763313609,0.011834319526627219,0.9881656804733728,169,5400,4100,1300,0.7592592592592593,67,41,26,188.35859729354883,0.4611334178641871,0.7152515547875016,0.12161606540789154,1079664.9355334325,1472.8345608210766,1081137.7700942536,965,0,321.84615384615387,76,93,46,35.339743255910825,0.5848742603550297,40.23268398268395,8312.554112554039,109.37571200728998,0
974,32,0,3,164,0.0,0.017964071856287425,0.9820359281437125,167,5550,4100,1450,0.7387387387387387,70,41,29,209.7882618645018,0.46057283024312823,0.7384637151284541,0.12966521154064986,1066855.358028621,5812.7462443307195,1072668.1042729516,966,1,326.4251497005988,83,84,35,36.361085098208704,0.5716067864271457,41.77827380952379,8263.095238095182,99.55536431439978,8
975,32,0,0,164,0.0,0.0,1.0,164,6100,4800,1300,0.7868852459016393,74,48,26,212.40287448797028,0.4593831051424011,0.7352675487539189,0.13210422681568856,1068708.9116143156,6499.368963558052,1075208.2805778736,967,2,331.0670731707317,73,91,34,36.0645878721859,0.5741234756097561,41.55405405405405,8270.270270270259,113.29137356534602,0
976,32,0,1,163,0.0,0.006097560975609756,0.9939024390243902,164,5250,3600,1650,0.6857142857142857,69,36,33,213.6877445790549,0.4591804765823732,0.7366251275715732,0.13336321625304307,1069730.5216049415,7667.660493827305,1077398.1820987687,968,3,332.0670731707317,74,90,36,35.905243415516274,0.5756478658536586,41.430555555555564,8274.222222222246,111.81381381381414,0
977,32,0,0,163,0.0,0.0,1.0,163,5350,4300,1050,0.8037383177570093,64,43,21,210.44931539990088,0.45879250927819437,0.730570538350696,0.13171853878106443,1070575.4231789175,7110.3729783926665,1077685.7961573103,969,4,333.5828220858896,76,87,33,35.884738420236026,0.5771344580777096,41.328463203463215,8277.48917748921,108.91433128275276,0
978,32,0,1,162,0.0,0.006134969325153374,0.9938650306748467,163,5050,3400,1650,0.6732673267326733,67,34,33,213.12982876044987,0.4585731778131233,0.7375240769808586,0.12768861676891644,1057511.2470255834,7427.438198162623,1064938.685223746,970,5,334.5828220858896,81,82,39,37.43226438712654,0.5600715746421268,42.91158536585367,8226.82926829271,101.56579343571246,8
979,32,2,1,163,0.012195121951219513,0.006097560975609756,0.9939024390243902,164,5050,3700,1350,0.7326732673267327,64,37,27,210.6394557823131,0.4585889570552147,0.7379674796747973,0.12711001642036124,1059688.5813148771,6792.44521337938,1066481.0265282565,971,0,333.359756097561,67,97,41,37.226190476190474,0.5619918699186992,42.647058823529406,8235.294117647045,122.91483757682157,0
980,32,0,1,162,0.0,0.006134969325153374,0.9938650306748467,163,5450,3600,1850,0.6605504587155964,73,36,37,217.04515556662852,0.45804141735464166,0.7390625324212736,0.12851739184752897,1053949.3848593896,7700.921639231433,1061650.3064986211,972,1,336.07361963190186,71,92,38,37.77433295753477,0.55329754601227,43.34490740740738,8212.962962962909,115.67553468961843,8
981,32,2,0,164,0.012195121951219513,0.0,1.0,164,4800,3700,1100,0.7708333333333334,59,37,22,214.0506647423681,0.4589123834106439,0.735978916930462,0.12772366078922617,1056288.5805991753,7619.854567404975,1063908.4351665804,973,0,330.6646341463415,73,91,37,37.560435270914354,0.5557037601626016,43.06024774774773,8222.072072072033,112.63112427495935,0
982,32,1,1,164,0.006060606060606061,0.006060606060606061,0.9939393939393939,165,5300,4000,1300,0.7547169811320755,66,40,26,219.44319308235532,0.4594188839615669,0.746259659807899,0.12693339841399373,1046778.7613789119,7641.694769556156,1054420.456148468,974,0,329.6545454545454,70,95,44,38.60655424266756,0.5458333333333334,44.219483568075105,8184.976525821571,116.9282360831653,8
983,32,2,0,166,0.012048192771084338,0.0,1.0,166,4550,3300,1250,0.7252747252747253,58,33,25,213.09592598391677,0.4603839600827553,0.7395571548698339,0.12399646202845732,1048609.1854477394,6940.869073645098,1055550.0545213846,975,0,328.30120481927713,71,95,40,38.540607045304725,0.5476907630522088,43.995949074074055,8192.129629629584,115.3821074595716,0
984,32,1,0,167,0.005988023952095809,0.0,1.0,167,4700,3000,1700,0.6382978723404256,64,30,34,210.72533259264364,0.46071261092273286,0.7382266319175343,0.1231044443777677,1049827.9290123456,6145.067901234563,1055972.9969135802,976,0,327.3293413173653,74,93,41,38.44943429304705,0.5489645708582834,43.84722222222222,8196.888888888889,110.76876876876877,0
985,32,0,2,165,0.0,0.011976047904191617,0.9880239520958084,167,5500,4100,1400,0.7454545454545455,69,41,28,214.04213885316346,0.4608869610177236,0.7405356774136465,0.12557963637916786,1051142.7405366774,6097.76808488918,1057240.5086215667,977,1,328.3293413173653,65,102,43,38.20068760262725,0.5505239520958084,43.68686868686868,8202.020202020183,126.1849261849259,0
986,32,2,1,166,0.011976047904191617,0.005988023952095809,0.9940119760479041,167,4150,3000,1150,0.7228915662650602,53,30,23,231.46348136311633,0.4617301541495323,0.7623660676856117,0.12971409215336846,1036923.2220119932,10451.97177463131,1047375.1937866245,978,0,327.3832335329341,63,104,40,39.53398386718666,0.528879740518962,45.42643229166668,8146.354166666692,129.3072089947094,8
987,32,2,0,168,0.011904761904761904,0.0,1.0,168,4750,3600,1150,0.7578947368421053,59,36,23,204.9707992022085,0.4624686638627507,0.7381574631181862,0.11176480250403088,1028260.6186622896,3802.680159073201,1032063.2988213628,979,0,326.1488095238095,67,101,42,41.295861280641326,0.5194072420634921,46.492034313725476,8112.254901960754,121.07843137254856,7
988,32,4,1,171,0.023255813953488372,0.005813953488372093,0.9941860465116279,172,5050,3600,1450,0.7128712871287128,65,36,29,214.4832833971144,0.4638547474953534,0.7508872560912216,0.11617555954105854,1026134.744247237,4567.749830801025,1030702.494078038,980,0,319.5406976744186,68,104,41,41.322528564331826,0.5221051356589148,46.754227053140085,8103.86473429949,119.17448138675721,8
989,32,6,0,177,0.03389830508474576,0.0,1.0,177,5650,3800,1850,0.672566371681416,75,38,37,212.7742019333085,0.4658569273240883,0.7576112258584469,0.11704160956361159,1031048.7391553161,2826.1145256232285,1033874.8536809394,981,0,309.9039548022599,75,102,36,40.747271115670515,0.525894538606403,46.14857456140351,8123.2456140350805,108.30994152046775,0
990,32,4,3,178,0.022099447513812154,0.016574585635359115,0.9834254143646409,181,5650,3800,1850,0.672566371681416,75,38,37,208.70680574491573,0.46696465111520363,0.7597136167859022,0.11587656980424871,1033990.4991522509,1310.1708497315244,1035300.6700019825,982,0,304.03314917127074,66,115,42,40.48108678368298,0.5288328729281768,45.786691542288565,8134.825870646784,123.25493743404218,0
991,32,2,5,175,0.011111111111111112,0.027777777777777776,0.9722222222222222,180,6050,4700,1350,0.7768595041322314,74,47,27,230.75148075534392,0.4671710117939168,0.7806727999435437,0.12772083397896458,1033014.5618428886,5623.927957415838,1038638.4898003044,983,0,304.14444444444445,70,110,41,40.043449390842454,0.5255787037037036,45.90669014084507,8130.985915492959,116.15694164989941,8
992,32,2,3,174,0.011299435028248588,0.01694915254237288,0.9830508474576272,177,5850,4800,1050,0.8205128205128205,69,48,21,244.10697951140207,0.466642056154768,0.7878518417433455,0.13705765918538457,1037514.7016110962,9402.916001791586,1046917.6176128878,984,0,309.6271186440678,62,115,40,39.137745384498835,0.5294844632768362,45.353835978835974,8148.677248677241,131.43027820447162,0
993,32,5,5,174,0.027932960893854747,0.027932960893854747,0.9720670391061452,179,4900,3600,1300,0.7346938775510204,62,36,26,251.2961055239385,0.4668034544807817,0.7942518147779045,0.1435862313556393,1042980.9089708003,11719.408112035871,1054700.3170828363,985,0,305.0335195530726,57,122,38,38.26791408741323,0.5327630353817505,44.683908045977006,8170.114942528723,143.33534986892496,0
994,32,4,1,177,0.02247191011235955,0.0056179775280898875,0.9943820224719101,178,6050,4500,1550,0.743801652892562,76,45,31,244.0174683165836,0.4668647770794981,0.7873095654860744,0.14137160519408545,1047267.0317119035,9460.28994595227,1056727.3216578558,986,0,307.5561797752809,60,118,39,37.91688915587592,0.5359316479400749,44.159836065573764,8186.885245901624,136.44808743169375,0
995,32,0,1,176,0.0,0.005649717514124294,0.9943502824858758,177,5950,4600,1350,0.773109243697479,73,46,27,249.9603741042872,0.4664400894538607,0.7921424508903177,0.14548877695191473,1048697.121777084,11076.544976297813,1059773.6667533817,987,1,310.29378531073445,61,116,40,37.58585991162444,0.5370762711864407,43.98521505376344,8192.47311827957,134.3028380045831,0
996,32,4,0,180,0.022222222222222223,0.0,1.0,180,4900,3100,1800,0.6326530612244898,67,31,36,243.4176535147989,0.46771415270018624,0.7896774670809292,0.1434903122367456,1052586.2969930419,10343.61730717549,1062929.9143002173,988,0,306.0111111111111,60,120,42,37.26753217931648,0.5402777777777779,43.51092896174863,8207.650273224039,136.79417122040064,0
997,32,0,0,180,0.0,0.0,1.0,180,5900,4200,1700,0.711864406779661,76,42,34,245.80655684881714,0.4674322367059797,0.79199954912698,0.14573839278591658,1054348.0505332965,9933.132804370343,1064281.1833376668,989,1,307.0111111111111,61,119,41,36.98642744944044,0.5422453703703703,43.29637096774193,8214.516129032241,134.66419883659412,0
998,32,3,2,181,0.01639344262295082,0.01092896174863388,0.9890710382513661,183,5600,3600,2000,0.6428571428571429,76,36,40,239.30296061472592,0.46825146620228586,0.7883435866721138,0.14313156819401787,1057009.0468057736,8389.078859434241,1065398.1256652079,990,0,302.9617486338798,66,117,36,36.821895919025735,0.5450819672131147,42.9726368159204,8224.875621890558,124.6193276044024,0
999,32,2,1,182,0.01092896174863388,0.00546448087431694,0.994535519125683,183,4900,3100,1800,0.6326530612244898,67,31,36,239.93297424269744,0.4685667247142657,0.789245661157095,0.1409551152758145,1051545.073142669,8960.067389875047,1060505.1405325439,991,0,303.551912568306,64,119,40,37.486846492050596,0.5452527322404371,43.63782051282051,8203.58974358974,128.1810897435897,8
1000,32,0,2,180,0.0,0.01098901098901099,0.989010989010989,182,4100,2700,1400,0.6585365853658537,55,27,28,240.41992187500028,0.4684154473519115,0.7886195054945058,0.14142348345588232,1051939.5134779734,10081.443129519954,1062020.9566074933,992,1,305.84615384615387,64,118,41,37.42513020833332,0.546474358974359,43.589743589743584,8205.128205128192,128.205128205128,0
1001,32,3,3,180,0.01639344262295082,0.01639344262295082,0.9836065573770492,183,5350,3700,1650,0.6915887850467289,70,37,33,241.5569496695174,0.46866055165235493,0.7878733173533206,0.13832402828292203,1043660.88445216,8470.707947530802,1052131.5923996908,993,0,305.08743169398906,59,124,37,38.43134672467315,0.5365437158469946,44.60069444444444,8172.777777777774,138.52165725047075,8
1002,32,3,1,182,0.01639344262295082,0.00546448087431694,0.994535519125683,183,5700,4000,1700,0.7017543859649122,74,40,34,234.44520377258942,0.4691184271102304,0.7807303022118439,0.13574351787529332,1047079.9186390509,6796.572978303606,1053876.4916173546,994,0,300.4863387978142,64,119,42,38.185178224644474,0.5392759562841529,44.1826923076923,8186.1538461538275,127.90865384615356,0
1003,32,1,2,181,0.00546448087431694,0.01092896174863388,0.9890710382513661,183,4850,3100,1750,0.6391752577319587,66,31,35,232.02405005728752,0.4691797273764487,0.779465443769666,0.13516816697536138,1048968.3152954124,7227.1753793222015,1056195.4906747346,995,0,301.43169398907105,66,117,41,38.011187685955434,0.5409266848816029,43.95211442786069,8193.532338308449,124.14442936830983,0
1004,32,0,0,181,0.0,0.0,1.0,181,5900,4400,1500,0.7457627118644068,74,44,30,238.1879095896545,0.46875383670963783,0.782493903803791,0.139637661996935,1050905.073307653,7962.5765176625255,1058867.6498253155,996,1,305.6795580110497,60,121,41,37.61146832800285,0.5427601289134438,43.71584699453552,8201.092896174861,136.68488160291434,0
1005,32,2,1,182,0.01092896174863388,0.00546448087431694,0.994535519125683,183,5050,3500,1550,0.693069306930693,66,35,31,237.1356787358472,0.46927855841790267,0.7854187106106256,0.14044475929097883,1054017.2841255837,8339.02081408691,1062356.3049396707,997,0,303.327868852459,62,121,40,37.250236208636636,0.5450250455373407,43.33664021164021,8213.227513227508,132.4714115036695,0
1006,32,4,5,181,0.021505376344086023,0.026881720430107527,0.9731182795698925,186,6150,4500,1650,0.7317073170731707,78,45,33,227.05300459532077,0.47001598372566117,0.7785327010183445,0.13553690744063743,1056411.1309352177,4622.264273356417,1061033.3952085741,998,0,299.3225806451613,67,119,39,37.2111104487103,0.5479390681003584,43.0453431372549,8222.549019607848,122.72461223295295,0
1007,32,0,0,181,0.0,0.0,1.0,181,5750,4200,1550,0.7304347826086957,73,42,31,231.0455187995721,0.4694444444444445,0.7753573384047434,0.138236859631515,1057105.9235027065,6897.917304356848,1064003.8408070633,999,1,305.9944751381216,65,116,39,37.0220844078759,0.5492633517495396,42.960858585858595,8225.252525252547,126.54234654234688,0
1008,32,0,3,178,0.0,0.016574585635359115,0.9834254143646409,181,5200,3300,1900,0.6346153846153846,71,33,38,233.94825494572652,0.4691311131573563,0.7790957183846265,0.14045515350352525,1058144.72056423,8110.222171207135,1066254.9427354373,1000,2,306.9944751381216,65,116,40,36.81825620882943,0.5507596685082873,42.834595959595966,8229.292929292944,126.60450660450682,0
1009,32,1,0,179,0.00558659217877095,0.0,1.0,179,6000,3800,2200,0.6333333333333333,82,38,44,232.65624315310149,0.46772932228569036,0.7711273069250955,0.13607300595532604,1050181.3239069784,7066.248289949862,1057247.5721969283,1001,0,311.122905027933,76,103,38,37.84355528566902,0.5457402234636872,43.80411255411257,8198.26839826844,107.87195260879525,8
1010,32,1,2,178,0.005555555555555556,0.011111111111111112,0.9888888888888889,180,5650,4500,1150,0.7964601769911505,68,45,23,229.73389587404085,0.4677898044692737,0.7691764729307295,0.13527876014165702,1052258.6002078499,6697.893538542702,1058956.4937463927,1002,0,310.3888888888889,67,113,39,37.65935179101208,0.5478587962962963,43.550857843137244,8206.372549019585,122.48317237342664,0
1011,32,0,2,176,0.0,0.011235955056179775,0.9887640449438202,178,5250,3500,1750,0.6666666666666666,70,35,35,235.069802690921,0.4672602044055101,0.7672955837382471,0.1395450663087332,1054724.310507485,8736.767112861951,1063461.0776203468,1003,1,314.73595505617976,72,106,41,37.215167009392516,0.5578183520599251,43.25057077625567,8215.981735159734,114.11085743277408,8
1012,32,3,0,179,0.01675977653631285,0.0,1.0,179,5150,3400,1750,0.6601941747572816,69,34,35,247.8623328215699,0.46737754482874067,0.7915103007795619,0.14426943654891225,1048700.999030173,11036.695210385846,1059737.694240559,1004,0,313.9050279329609,70,109,39,37.63908787010505,0.5434706703910615,43.98474178403755,8192.488262910785,117.03554661301122,8
1013,32,3,1,181,0.016483516483516484,0.005494505494505495,0.9945054945054945,182,5350,3900,1450,0.7289719626168224,68,39,29,244.4453093803744,0.4683256430494,0.7915158101971289,0.1437660133312307,1051885.6238242404,9675.701349696843,1061561.3251739372,1005,0,309.7142857142857,60,122,42,37.32864357864357,0.5461309523809523,43.596311475409834,8204.918032786882,136.74863387978135,0
1014,32,1,0,182,0.005494505494505495,0.0,1.0,182,5200,3700,1500,0.7115384615384616,67,37,30,242.557766908416,0.46832121607674093,0.790753888968174,0.14366883116883117,1054044.4444444454,9533.333333333383,1063577.777777779,1006,0,310.63186813186815,64,118,39,37.107683982683966,0.5481341575091575,43.333333333333336,8213.333333333341,128.33333333333346,0
1015,32,2,1,183,0.010869565217391304,0.005434782608695652,0.9945652173913043,184,5450,4000,1450,0.7339449541284404,69,40,29,247.06108372528936,0.4684864278926111,0.7950246225250157,0.14660298081074283,1054598.8209184601,9860.065518304971,1064458.886436765,1007,0,308.2445652173913,70,114,39,36.92294321580279,0.5456295289855073,43.26584507042251,8215.492957746414,117.36418511066306,8
1016,32,1,2,182,0.005434782608695652,0.010869565217391304,0.9891304347826086,184,5700,4100,1600,0.7192982456140351,73,41,32,233.74807978895348,0.4682308990654946,0.7874977449034812,0.13349120196478156,1042821.7466245344,6251.5161671295755,1049073.2627916639,1008,0,309.2282608695652,58,126,42,38.73588059013369,0.5347033514492754,44.70338983050848,8169.4915254237385,140.85330216247826,8
1017,32,2,1,183,0.010869565217391304,0.005434782608695652,0.9945652173913043,184,5800,3800,2000,0.6551724137931034,78,38,40,208.37933316421586,0.46895479429001347,0.7611215712443151,0.12155351231303325,1049372.5956790145,1133.5123456791366,1050506.1080246936,1009,0,306.64130434782606,74,110,41,38.566240938590326,0.5439877717391304,43.902777777777786,8195.111111111128,110.74474474474496,8
1018,32,0,1,182,0.0,0.00546448087431694,0.994535519125683,183,5900,4400,1500,0.7457627118644068,74,44,30,216.4561045741696,0.46842285674252887,0.7621264688327003,0.12279709555059584,1040752.4688718651,2555.445047590546,1043307.9139194556,1010,1,309.2950819672131,81,102,34,39.43624337965501,0.5387067395264117,44.95680894308942,8161.38211382111,100.75780387433468,8
1019,32,3,0,185,0.016216216216216217,0.0,1.0,185,5250,3800,1450,0.7238095238095238,67,38,29,216.0678888999356,0.4692347238542891,0.7665892562129242,0.12369415756824459,1043575.7530864205,2846.64197530865,1046422.3950617291,1011,0,306.9189189189189,74,111,38,39.09297730403888,0.540990990990991,44.611111111111114,8172.44444444445,110.43843843843851,0
1020,32,3,0,188,0.015957446808510637,0.0,1.0,188,6250,4800,1450,0.768,77,48,29,208.59956348748625,0.4696969696969697,0.7679752502906847,0.11899464977889396,1042470.5944129383,-358.217811384151,1042112.3766015542,1012,0,303.00531914893617,68,120,44,39.421797374024145,0.5398936170212766,44.7463768115942,8168.115942028984,120.11935208866153,8
1021,32,1,0,189,0.005291005291005291,0.0,1.0,189,5800,4200,1600,0.7241379310344828,74,42,32,213.0409631923948,0.4696986753724342,0.7659172676341335,0.12345233301990188,1047334.4079127723,1025.0262092545354,1048359.4341220268,1013,0,302.3968253968254,82,107,35,38.70098760587334,0.5481701940035273,44.1516064257028,8187.148594377483,99.84327554118882,8
1022,32,4,1,192,0.02072538860103627,0.0051813471502590676,0.9948186528497409,193,5900,4200,1700,0.711864406779661,76,42,34,204.0570026351739,0.47020050734024177,0.7651254466110295,0.11828082896109654,1047424.3164062521,-1753.146701388805,1045671.1697048633,1014,0,297.1088082901554,79,114,38,38.919635284139105,0.5457145941278065,44.14062500000001,8187.500000000016,103.63924050632932,8
1023,32,0,2,190,0.0,0.010416666666666666,0.9895833333333334,192,6300,4400,1900,0.6984126984126984,82,44,38,202.19954103638463,0.4699083542393834,0.7613426710913025,0.11757191341050863,1048389.0876952639,-2303.2415280926853,1046085.8461671713,1015,1,295.9270833333333,83,109,40,38.846970577786394,0.54736328125,44.02281746031746,8191.269841269846,98.6899980875885,0
1024,32,2,0,192,0.010416666666666666,0.0,1.0,192,5750,4300,1450,0.7478260869565218,72,43,29,198.52369539492827,0.4699146033304247,0.7577096041868852,0.11594748298652811,1049751.6020467489,-2469.886542986552,1047281.7155037624,1016,0,293.890625,87,105,43,38.77147935055534,0.5495876736111112,43.8565340909091,8196.590909090934,94.21368861024061,0
1025,32,1,3,190,0.0051813471502590676,0.015544041450777202,0.9844559585492227,193,6150,4300,1850,0.6991869918699187,80,43,37,202.03391025462895,0.469889041810593,0.757813378255856,0.11829709540531126,1050529.0284090103,-2301.5025109063827,1048227.5258981038,1017,0,293.3626943005181,88,105,39,38.58482163248529,0.5525151122625216,43.76170411985019,8199.625468164788,93.17756213823623,8
1026,32,1,1,190,0.005235602094240838,0.005235602094240838,0.9947643979057592,191,5950,4200,1750,0.7058823529411765,77,42,35,202.67861720634622,0.468721870120327,0.7568724007744627,0.11930065821516475,1052139.2583097501,-1500.774003453505,1050638.4843062966,1018,0,297.35602094240835,78,113,39,38.368019847799246,0.5547011343804538,43.565400843881875,8205.90717299583,105.20393811533116,0
1027,32,3,4,189,0.015544041450777202,0.02072538860103627,0.9792746113989638,193,5600,3600,2000,0.6428571428571429,76,36,40,195.49129710713166,0.46882308757915947,0.7501983871686417,0.11580649306020128,1054085.1855788678,-2987.1039619548396,1051098.081616913,1019,0,295.1865284974093,83,110,41,38.31066608690051,0.55661701208981,43.328373015873034,8213.492063492115,98.95773570472427,0
1028,32,2,2,189,0.010471204188481676,0.010471204188481676,0.9895287958115183,191,6150,4500,1650,0.7317073170731707,78,45,33,205.36296858545816,0.46861623955175896,0.7634057319828151,0.11951744676903286,1048662.3159524968,-1278.7187504587364,1047383.597202038,1020,0,299.0157068062827,86,105,35,38.731955227138094,0.5477203315881327,43.98946360153257,8192.337164750963,95.25973447384841,8
1029,32,2,4,187,0.010471204188481676,0.020942408376963352,0.9790575916230366,191,5300,3900,1400,0.7358490566037735,67,39,28,203.345659310278,0.46854964636722696,0.7629184384525276,0.1190655792507341,1050530.0947359428,-775.8530521260905,1049754.2416838168,1021,0,299.8586387434555,89,102,41,38.551076908020555,0.550119982547993,43.76157407407408,8199.629629629655,92.13066999583882,0
1030,32,0,1,186,0.0,0.0053475935828877,0.9946524064171123,187,5250,3400,1850,0.6476190476190476,71,34,37,199.29025801028652,0.4679779291970943,0.7559721617351063,0.11584202240468408,1048287.5119087006,-867.3022565506685,1047420.2096521499,1022,1,305.8770053475936,83,104,40,38.93408951439693,0.5485182709447416,44.03521825396826,8190.87301587303,98.68521705871122,8
1031,32,1,1,186,0.0053475935828877,0.0053475935828877,0.9946524064171123,187,5400,3500,1900,0.6481481481481481,73,35,38,198.6798442734189,0.46778386330094107,0.7548616340745289,0.11596535717679998,1049557.5629340308,-1094.813368055417,1048462.7495659754,1023,0,306.81283422459893,87,100,41,38.791624300965964,0.5501893939393939,43.88020833333334,8195.833333333358,94.20498084291215,0
1032,32,1,0,187,0.0053475935828877,0.0,1.0,187,5450,4100,1350,0.7522935779816514,68,41,27,202.77448693798138,0.46749276445671134,0.759118664014689,0.11869438370790712,1050435.1937585776,-249.70850480098807,1050185.4852537767,1024,0,307.7860962566845,89,98,43,38.57752130574881,0.5515819964349375,43.77314814814816,8199.259259259292,92.12650853100328,0
1033,32,0,2,185,0.0,0.0106951871657754,0.9893048128342246,187,6150,4300,1850,0.6991869918699187,80,43,37,228.00174373852414,0.4674089088225711,0.7701427233514182,0.13287858463350993,1049092.4396413222,4288.981116224917,1053381.4207575473,1025,1,308.7860962566845,77,110,39,38.09868398178093,0.5466243315508021,43.93696581196583,8194.017094017128,106.41580641580686,8
1034,32,1,2,184,0.005376344086021506,0.010752688172043012,0.989247311827957,186,6250,4800,1450,0.768,77,48,29,226.55028539126445,0.46665274145112856,0.7689901137592243,0.13285472176467927,1050996.4096303205,4170.707309388186,1055167.1169397086,1026,0,311.2903225806452,68,118,43,37.898333038817235,0.5486671146953406,43.7047101449275,8201.449275362245,120.60954816709184,0
1035,32,0,1,183,0.0,0.005434782608695652,0.9945652173913043,184,5200,3400,1800,0.6538461538461539,70,34,36,228.56727604747468,0.46643662885087506,0.7760713323950377,0.12842089173593238,1037730.2862811844,5438.23696145152,1043168.5232426359,1027,1,310.8478260869565,69,115,46,39.50639827042189,0.5333446557971014,45.32738095238097,8149.523809523851,118.10904071773697,8
1036,32,4,2,185,0.0213903743315508,0.0106951871657754,0.9893048128342246,187,5300,3200,2100,0.6037735849056604,74,32,42,215.05933796255374,0.46716812335882546,0.7689811225694556,0.11883231780152496,1032474.9059133128,1708.6739457334688,1034183.5798590463,1028,0,306.668449197861,81,106,37,40.50998274741215,0.5290775401069518,45.97306910569106,8128.861788617891,100.35631837799865,8
1037,32,7,2,190,0.036458333333333336,0.010416666666666666,0.9895833333333334,192,5800,3800,2000,0.6551724137931034,78,38,40,218.9064714244437,0.4693453679464805,0.781833236899887,0.12210502979057569,1035453.7190191105,1133.503990758073,1036587.2230098686,1029,0,299.4895833333333,68,124,42,40.038054121417105,0.5247395833333333,45.606884057971,8140.5797101449025,119.71440750213092,8
1038,32,4,2,192,0.020618556701030927,0.010309278350515464,0.9896907216494846,194,5950,4400,1550,0.7394957983193278,75,44,31,220.38667313469708,0.46977936986984314,0.7868199491082561,0.12464717834070427,1039802.7884303185,1081.735451667712,1040884.5238819862,1030,0,297.1546391752577,73,121,35,39.454951224001476,0.5292633161512028,45.073198198198185,8157.657657657628,111.74873503640586,0
1039,32,1,1,192,0.0051813471502590676,0.0051813471502590676,0.9948186528497409,193,6450,5000,1450,0.7751937984496124,79,50,29,209.22587390535145,0.4700903137593552,0.7721857144746018,0.11477497270291726,1030179.2797865423,-1941.9679814951173,1028237.3118050472,1031,0,299.4611398963731,73,120,40,40.94664188764378,0.5188363557858376,46.25563063063063,8119.8198198198115,111.23040849068235,8
1040,32,2,2,192,0.010309278350515464,0.010309278350515464,0.9896907216494846,194,6050,4600,1450,0.7603305785123967,75,46,29,217.9447421326363,0.47031686786674504,0.7803583149928577,0.12229004202107659,1037313.5600575273,365.40727148488713,1037678.9673290121,1032,0,297.7783505154639,70,124,41,39.8291798713147,0.5287263745704467,45.37852112676056,8147.887323943654,116.39839034205221,7
1041,32,3,3,192,0.015384615384615385,0.015384615384615385,0.9846153846153847,195,5900,4000,1900,0.6779661016949152,78,40,38,222.7721331901359,0.4711263106881664,0.7886074804731211,0.12228783204664523,1030391.7907877662,1008.5154510790608,1031400.3062388453,1033,0,297.1333333333333,70,125,41,40.57615964232717,0.5168803418803418,46.229460093896726,8120.6572769953345,116.00938967136192,8
1042,32,3,2,193,0.015384615384615385,0.010256410256410256,0.9897435897435898,195,6100,4300,1800,0.7049180327868853,79,43,36,222.9932209128679,0.4710998766411138,0.7884161879670017,0.12356904992091372,1033379.008465209,987.3027042804515,1034366.3111694895,1034,0,297.6102564102564,72,123,45,40.19476417742843,0.5194444444444444,45.86187214611871,8132.420091324183,112.95027904616921,0
1043,32,5,1,197,0.025252525252525252,0.005050505050505051,0.9949494949494949,198,6600,4700,1900,0.7121212121212122,85,47,38,213.5106399746737,0.47165179715941136,0.7823646553110208,0.1197542825788393,1037188.419765899,-1909.8473442923423,1035278.5724216066,1035,0,293.9141414141414,63,135,48,39.95776865051459,0.5231481481481481,45.39388020833334,8147.395833333355,129.32374338624373,0
1044,32,8,4,201,0.03902439024390244,0.01951219512195122,0.9804878048780488,205,6300,4000,2300,0.6349206349206349,86,40,46,195.91926145716337,0.4733291487326638,0.7701933427143939,0.11181647852924173,1042624.2644641626,-6445.964825772874,1036178.2996383897,1036,0,283.390243902439,64,141,48,39.72628539142446,0.528150406504065,44.72756410256408,8168.717948717904,127.63621794871725,0
1045,32,1,3,199,0.0049504950495049506,0.01485148514851485,0.9851485148514851,202,6250,4500,1750,0.72,80,45,35,208.61657040131013,0.47285899298885115,0.7844689613655897,0.11680479334580722,1036639.1191893432,-3397.9804421769127,1033241.1387471663,1037,0,287.6831683168317,69,133,39,40.15121065965117,0.526144801980198,45.461309523809526,8145.238095238101,118.04692891649421,8
1046,32,1,1,199,0.005,0.005,0.995,200,7050,4800,2250,0.6808510638297872,93,48,45,202.42245436649898,0.4725104690117253,0.775793590232734,0.1141667620738447,1038927.1882716084,-4989.561728394923,1033937.6265432135,1038,0,291.365,74,126,41,40.022437819080274,0.5294791666666667,45.180555555555564,8154.22222222225,110.19219219219256,0
1047,32,4,4,199,0.019704433497536946,0.019704433497536946,0.9802955665024631,203,6550,4300,2250,0.6564885496183206,88,43,45,198.01142313307795,0.4731370612430701,0.7745448719836843,0.11249083085530301,1041189.4354095738,-5916.519628685107,1035272.9157808888,1039,0,286.7733990147783,83,120,45,39.85206723056729,0.5326354679802956,44.90327380952379,8163.095238095186,98.3505450372914,0
1048,32,1,0,200,0.005,0.0,1.0,200,6100,4100,2000,0.6721311475409836,81,41,40,200.64304312242118,0.4728371021775544,0.7746747869914794,0.11459619454003644,1042851.4423538997,-4251.822616301559,1038599.6197375981,1040,0,291.705,67,133,44,39.57733309332369,0.5347916666666667,44.69975490196077,8169.607843137233,121.9344454199587,0
1049,32,7,5,202,0.033816425120772944,0.024154589371980676,0.9758454106280193,207,6600,4500,2100,0.6818181818181818,87,45,42,187.48472478451518,0.4738628191298094,0.76766328455134,0.1090039221995148,1048355.6571462934,-8689.865628727492,1039665.791517566,1041,0,282.80676328502415,78,129,41,39.22779408987105,0.5391002415458936,44.02689873417722,8191.139240506351,105.01460564751731,0
1050,32,1,2,201,0.0049261083743842365,0.009852216748768473,0.9901477832512315,203,6400,4600,1800,0.71875,82,46,36,208.82742315829225,0.4738879676144954,0.7852042045301142,0.11855638636289864,1040981.660222376,-3522.8964681440084,1037458.763754232,1024,0,280.13793103448273,75,128,41,39.60214042629412,0.5303776683087028,44.92872807017544,8162.2807017543855,108.83040935672514,8
1051,32,3,1,203,0.014705882352941176,0.004901960784313725,0.9950980392156863,204,6400,4600,1800,0.71875,82,46,36,206.83049298581335,0.47428583502366467,0.7846253157055583,0.1186074725251521,1044103.2896001538,-4009.520376778132,1040093.7692233757,1025,0,278.7156862745098,67,137,42,39.263012712880794,0.5332924836601307,44.54656862745098,8174.509803921569,122.00760901375476,0
1052,32,3,1,205,0.014563106796116505,0.0048543689320388345,0.9951456310679612,206,5800,3800,2000,0.6551724137931034,78,38,40,205.92683484065546,0.47448052332465074,0.7853432944104104,0.11921976328637271,1047049.7809887615,-3876.870536076387,1043172.9104526851,1026,0,276.9757281553398,73,133,44,38.91848484014751,0.5358515372168284,44.18637387387388,8186.0360360360555,112.1374799456994,0
1053,32,1,3,203,0.0048543689320388345,0.014563106796116505,0.9854368932038835,206,5900,4100,1800,0.6949152542372882,77,41,36,209.51498220574538,0.474757281553398,0.7853349547171384,0.11929224626736736,1041885.339889448,-3441.8823105267466,1038443.4575789212,1027,0,277.93203883495147,78,128,43,39.47159355138746,0.5309466019417476,44.81803797468357,8165.822784810184,104.69003570269467,8
1054,32,3,2,204,0.014563106796116505,0.009708737864077669,0.9902912621359223,206,6100,4300,1800,0.7049180327868853,79,43,36,205.21378131798718,0.47484657431525773,0.7809123181005289,0.11787609549584728,1044618.3517379785,-4425.983601136892,1040192.3681368416,1028,0,278.8543689320388,70,136,43,39.24001875669879,0.5331209546925566,44.4835680751174,8176.525821596305,116.80751173709007,0
1055,32,3,1,206,0.014492753623188406,0.004830917874396135,0.9951690821256038,207,7350,5300,2050,0.7210884353741497,94,53,41,192.34643546376694,0.4750627315791942,0.769277349247687,0.10983286207702736,1042781.361111114,-8634.944444444338,1034146.4166666697,1029,0,278.3864734299517,74,133,37,39.79788912463958,0.5349738325281803,44.70833333333334,8169.333333333357,110.39639639639671,8
1056,32,2,3,205,0.009615384615384616,0.014423076923076924,0.9855769230769231,208,6800,5000,1800,0.7352941176470589,86,50,36,189.24443218441186,0.4753625123869689,0.7671339764754435,0.10891668864200278,1045225.8363154095,-8839.366020402525,1036386.470295007,1030,0,278.03365384615387,78,130,40,39.572370683725396,0.5371594551282051,44.409282700421954,8178.902953586531,104.8577301741863,0
1057,32,2,2,205,0.00966183574879227,0.00966183574879227,0.9903381642512077,207,5500,3700,1800,0.6727272727272727,73,37,36,192.15370692065918,0.4751067023122743,0.7695051388912584,0.1115717081869617,1047951.0007903136,-6626.466105385198,1041324.5346849284,1031,0,276.743961352657,82,125,36,39.1586365568197,0.5397544283413849,44.07630522088355,8189.558232931757,99.87266137721655,0
1058,32,1,3,203,0.0048543689320388345,0.014563106796116505,0.9854368932038835,206,6850,5100,1750,0.7445255474452555,86,51,35,196.71011656977043,0.4750138132449286,0.7750190640241987,0.11486857708361868,1049698.9993105028,-6752.717496491532,1042946.2818140113,1032,0,277.09708737864077,82,124,37,38.824476946445216,0.5416666666666667,43.86295180722894,8196.385542168735,99.95592124596018,0
1059,32,3,1,205,0.014563106796116505,0.0048543689320388345,0.9951456310679612,206,6450,4600,1850,0.7131782945736435,83,46,37,198.3293497910559,0.4748677875128266,0.7763545152105689,0.11682387403308231,1052357.1322589451,-5907.338842220818,1046449.7934167243,1033,0,277.79611650485435,73,133,40,38.45247406553596,0.5452063106796117,43.53885135135134,8206.756756756733,112.42132543502375,0
1060,32,0,1,204,0.0,0.004878048780487805,0.9951219512195122,205,6650,4200,2450,0.631578947368421,91,42,49,197.9079434794964,0.47440219990435195,0.774996633370036,0.11695941611772878,1053360.1111111068,-5956.333333333603,1047403.7777777732,1034,1,280.1268292682927,74,131,38,38.33867868355523,0.5466463414634146,43.41666666666665,8210.666666666631,110.95495495495447,0
1061,32,3,5,202,0.014492753623188406,0.024154589371980676,0.9758454106280193,207,5300,3000,2300,0.5660377358490566,76,30,46,224.51695658310436,0.4746933774213217,0.7970650000981343,0.13202823078248702,1051845.592403623,531.4342403625369,1052377.0266439856,1035,0,278.33816425120773,69,138,39,37.84460243760882,0.5430253623188406,43.60119047619046,8204.761904761865,118.90959282263572,8
1062,32,4,2,204,0.019417475728155338,0.009708737864077669,0.9902912621359223,206,7050,4900,2150,0.6950354609929078,92,49,43,220.90195804138386,0.4742999644802273,0.792936056243724,0.13121044013783312,1054900.173611104,-1644.0972222226073,1053256.0763888813,1036,0,280.3203883495146,73,133,42,37.55704868154156,0.5462682038834952,43.22916666666664,8216.66666666661,112.55707762557,0
1063,32,2,3,203,0.009708737864077669,0.014563106796116505,0.9854368932038835,206,6600,4900,1700,0.7424242424242424,83,49,34,219.9442845727172,0.47449236324887517,0.7916015850799798,0.13133435570476742,1056505.601671004,-1325.5262586806784,1055180.0754123232,1037,0,280.59223300970876,79,127,35,37.38203065619457,0.5481897249190939,43.03385416666666,8222.916666666642,104.08755274261573,0
1064,32,3,0,206,0.014563106796116505,0.0,1.0,206,5050,3200,1850,0.6336633663366337,69,32,37,225.11241975687977,0.4741628186912937,0.7876634894833208,0.13149382479657534,1049791.831912236,1014.2359045548528,1050806.067816791,1038,0,281.3009708737864,81,125,41,38.08540798783312,0.5403013754045307,43.851626016260205,8196.747967479789,101.19441935160233,8
1065,32,1,3,204,0.004830917874396135,0.014492753623188406,0.9855072463768116,207,6700,4500,2200,0.6716417910447762,89,45,44,221.22303398108514,0.47417354564357517,0.7861680199039964,0.1299934104867395,1051615.571541921,-1571.6825363489352,1050043.889005572,1039,0,280.93719806763283,68,139,40,37.95771503160208,0.5424718196457328,43.62922705314008,8203.864734299475,120.64506962205111,0
1066,32,2,2,204,0.009708737864077669,0.009708737864077669,0.9902912621359223,206,6200,4100,2100,0.6612903225806451,83,41,42,206.18813900311196,0.47404836609045703,0.7785129464148188,0.12229418685766136,1054461.2947667795,-3916.5175962453586,1050544.7771705342,1040,0,283.20388349514565,77,129,41,37.98937687492413,0.5504146440129449,43.28258547008546,8214.957264957233,106.68775668775628,8
1067,32,2,4,202,0.009708737864077669,0.019417475728155338,0.9805825242718447,206,5950,3900,2050,0.6554621848739496,80,39,41,202.0667170144959,0.4737227681742837,0.7745183827103894,0.12072191042148125,1056663.0622837401,-4446.712802768037,1052216.3494809722,1041,0,284.09223300970876,84,122,36,37.82188841201713,0.5526395631067962,43.01470588235295,8223.52941176473,97.89915966386583,0
1068,32,1,2,201,0.0049261083743842365,0.009852216748768473,0.9901477832512315,203,7050,5400,1650,0.7659574468085106,87,54,33,201.89129291784,0.4728840494886927,0.7710967343631414,0.12101492662916692,1057659.8851166058,-4943.535665294568,1052716.3494513112,1042,0,288.5911330049261,89,114,39,37.70276252213321,0.5554187192118227,42.89351851851854,8227.407407407467,92.44277985851086,0
1069,32,0,0,201,0.0,0.0,1.0,201,7050,5200,1850,0.7375886524822695,89,52,37,205.04496748074075,0.4721009535655058,0.7744560090769215,0.12318049008976763,1058335.983308517,-3848.7065437612237,1054487.2767647556,1043,1,292.4228855721393,90,111,40,37.537831582695404,0.556747512437811,42.81135531135533,8230.036630036679,91.44485144485199,0
1070,32,2,1,202,0.009852216748768473,0.0049261083743842365,0.9950738916256158,203,6350,4900,1450,0.7716535433070866,78,49,29,204.06140348085242,0.47226625371896797,0.7776009885433928,0.12351961688249122,1060613.9081790105,-3663.927469135852,1056949.9807098745,1044,0,290.5320197044335,71,132,42,37.28084962913011,0.5586514778325122,42.534722222222214,8238.888888888874,116.04068857589964,0
1071,32,2,2,202,0.00980392156862745,0.00980392156862745,0.9901960784313726,204,5500,3800,1700,0.6909090909090909,72,38,34,190.9609160046078,0.4723630831643002,0.7694953109924212,0.11161217437236867,1049976.3659669969,-6199.110274350358,1043777.2556926465,1045,0,289.94607843137254,78,126,45,38.93725121817307,0.542483660130719,43.829113924050645,8197.468354430415,105.09574813372328,7
1072,32,1,2,201,0.0049261083743842365,0.009852216748768473,0.9901477832512315,203,6700,4800,1900,0.7164179104477612,86,48,38,216.89997401639172,0.4723109626233559,0.7934179596837811,0.12379074475482259,1042624.2644641664,-2070.9648257726053,1040553.2996383938,1046,0,292.0541871921182,64,139,40,39.190705631238636,0.5352524630541872,44.727564102564095,8168.717948717933,127.6362179487177,8
1073,32,2,0,203,0.009852216748768473,0.0,1.0,203,6350,4900,1450,0.7716535433070866,78,49,29,186.20553748454793,0.47236075208506073,0.7500050284259123,0.10584215869328484,1041361.0914198637,-8168.559651333884,1033192.5317685299,1047,0,292.9655172413793,91,112,38,40.131812533286016,0.5376642036124795,44.88224637681158,8163.768115941981,89.71173753782396,8
1074,32,6,4,205,0.028708133971291867,0.019138755980861243,0.9808612440191388,209,7000,5000,2000,0.7142857142857143,90,50,40,180.14659631436052,0.4735998650472335,0.7490014733581623,0.10362700413910289,1045065.8937563914,-11146.987263112598,1033918.9064932788,1048,0,285.5263157894737,88,121,42,39.824811473407834,0.5412181020733653,44.42883895131084,8178.277153557984,92.934967654068,0
1075,32,2,1,206,0.00966183574879227,0.004830917874396135,0.9951690821256038,207,6350,4200,2150,0.6614173228346457,85,42,43,179.54496265750342,0.47311336241264484,0.7457758017623426,0.10409962251137037,1047504.5605786114,-10135.166557469898,1037369.3940211416,1049,0,285.4154589371981,92,115,32,39.536822214439944,0.544182769726248,44.13082437275985,8187.813620071653,88.99797413121361,0
1076,32,1,5,202,0.004830917874396135,0.024154589371980676,0.9758454106280193,207,7750,5900,1850,0.7612903225806451,96,59,37,181.91964092758712,0.47307427731657364,0.7506142272281524,0.10609057191825969,1049290.7884385812,-10972.679307725786,1038318.1091308554,1050,0,286.41062801932367,95,112,36,39.25403054955297,0.5465479066022545,43.91276041666666,8194.791666666635,86.26096491228037,0
1077,32,0,1,201,0.0,0.0049504950495049506,0.995049504950495,202,6500,4700,1800,0.7230769230769231,83,47,36,186.4854576750963,0.4720005582647817,0.752563932291108,0.10877533889125396,1049353.2219833022,-7762.176827121379,1041591.0451561807,1051,1,294.01485148514854,93,109,37,39.12934516082503,0.5476485148514851,43.905141843971634,8195.03546099292,88.11866087089162,0
1078,32,0,3,198,0.0,0.014925373134328358,0.9850746268656716,201,5700,3700,2000,0.6491228070175439,77,37,40,206.58295978171967,0.47205742122719735,0.7698471695226776,0.12199489875600758,1053132.049382713,-2388.172839506283,1050743.8765432066,1052,2,296.41293532338307,74,127,43,38.14444384293348,0.550580431177446,43.444444444444436,8209.777777777754,110.94294294294262,8
1079,32,0,2,196,0.0,0.010101010101010102,0.98989898989899,198,6250,4600,1650,0.736,79,46,33,206.98899969127308,0.4716662180177409,0.768114565052965,0.12278931688469123,1054511.1627639986,-2195.557851239957,1052315.6049127586,1053,4,301.479797979798,76,122,42,37.96262141891058,0.5520307239057238,43.276515151515135,8215.151515151474,108.09409888357203,0
1080,32,2,0,198,0.010101010101010102,0.0,1.0,198,5800,3900,1900,0.6724137931034483,77,39,38,204.09398732054035,0.47121756909193463,0.7652830663639867,0.12192556498135511,1056644.3996722985,-2269.0462581926977,1054375.3534141057,1054,0,302.25757575757575,80,118,43,37.7721062903468,0.5546611952861953,43.01697530864195,8223.456790123397,102.79320987654246,0
1081,32,1,0,199,0.005025125628140704,0.0,1.0,199,7150,5500,1650,0.7692307692307693,88,55,33,208.58232000217325,0.47106322860091704,0.7696449158093439,0.12522884029195747,1058150.9799237046,-2807.6827389883492,1055343.2971847162,1055,0,301.73366834170855,82,117,45,37.46980381630959,0.5568990787269682,42.83383534136544,8229.317269076257,100.35752767166167,0
1082,32,1,1,199,0.005,0.005,0.995,200,6600,4600,2000,0.696969696969697,86,46,40,189.6598544367136,0.47096157872696814,0.7590630586705676,0.11145912935521471,1051650.2499999998,-6708.833333333341,1044941.4166666664,1056,0,301.22,74,126,41,38.76259548187876,0.5493229166666667,43.625,8203.999999999998,110.86486486486484,8
1083,32,2,3,198,0.009950248756218905,0.014925373134328358,0.9850746268656716,201,5800,4100,1700,0.7068965517241379,75,41,34,206.55506380294293,0.4709950248756219,0.7742257939422625,0.11914280025294154,1045909.9073753553,-2792.4024699903084,1043117.504905365,1057,0,300.2437810945274,75,126,40,39.044574890104,0.5434286898839138,44.32565789473687,8181.578947368493,109.08771929824657,7
1084,32,2,3,197,0.01,0.015,0.985,200,5400,3500,1900,0.6481481481481481,73,35,38,200.95349069497425,0.47117881072026796,0.7646578061403959,0.11669610208114073,1047990.3369447436,-3280.5367152702383,1044709.8002294734,1058,0,302.25,80,120,38,38.92852955462877,0.5460416666666666,44.07150205761318,8189.711934156401,102.37139917695501,0
1085,32,1,1,197,0.005050505050505051,0.005050505050505051,0.9949494949494949,198,6150,4400,1750,0.7154471544715447,79,44,35,194.93261181009555,0.4712261147857595,0.75833993414907,0.11150719958961909,1043332.3264129355,-5074.100925284626,1038258.2254876508,1059,0,304.44444444444446,75,123,39,39.663117474460115,0.5391940235690236,44.64089912280702,8171.491228070181,108.95321637426908,8
1086,32,1,1,197,0.005050505050505051,0.005050505050505051,0.9949494949494949,198,6300,4700,1600,0.746031746031746,79,47,32,199.39885508535923,0.47129020748944606,0.7647270996364564,0.11485686082422097,1045484.4018235455,-4206.321453356611,1041278.0803701888,1060,0,305.2878787878788,77,121,39,39.28059096529267,0.541087962962963,44.377670940170944,8179.914529914538,106.23265623265634,0
1087,32,2,5,194,0.010050251256281407,0.02512562814070352,0.9748743718592965,199,6750,5000,1750,0.7407407407407407,85,50,35,198.0029868360793,0.47125145931678597,0.7648747017362512,0.11481135126337609,1047530.9271918464,-5067.1495225692015,1042463.7776692773,1061,0,304.73366834170855,79,120,33,39.06125430427632,0.5428706030150754,44.127604166666686,8187.916666666715,103.6445147679331,0
1088,32,1,2,193,0.005128205128205128,0.010256410256410256,0.9897435897435898,195,6000,4400,1600,0.7333333333333333,76,44,32,221.60918777099172,0.4702121332275972,0.786671960456621,0.12636729249282205,1042350.9137110716,1198.9078719722152,1043549.8215830438,1062,0,303.2307692307692,67,128,37,39.10469931580843,0.5374465811965812,44.7610294117647,8167.647058823521,121.9051799824406,8
1089,32,0,1,192,0.0,0.0051813471502590676,0.9948186528497409,193,5450,4000,1450,0.7339449541284404,69,40,29,221.15488310268782,0.469917152417962,0.7832417698555498,0.126457528492186,1043210.59126234,2092.2232724217474,1045302.8145347617,1063,1,306.42487046632124,68,125,35,39.00873536715144,0.5392379101899827,44.655797101449274,8171.014492753624,120.16197783461212,0
1090,32,5,2,195,0.025380710659898477,0.01015228426395939,0.9898477157360406,197,5850,4400,1450,0.7521367521367521,73,44,29,220.29390192212637,0.47055643323319174,0.7884542152480447,0.12769837197008885,1047438.5308642009,898.8641975310406,1048337.3950617319,1064,0,301.01015228426394,74,123,37,38.50242463720915,0.543094331641286,44.1388888888889,8187.555555555583,110.64264264264301,0
1091,32,1,3,193,0.00510204081632653,0.015306122448979591,0.9846938775510204,196,5750,4100,1650,0.7130434782608696,74,41,33,206.16330823487846,0.4702969649398221,0.7684586799352,0.11721537021409689,1041437.9210706382,-2008.7425741643383,1039429.1784964739,1065,0,303.39285714285717,76,120,43,39.613049472400476,0.5340136054421769,44.87283549783552,8164.069264069313,107.42196400091201,7
1092,32,2,3,192,0.010256410256410256,0.015384615384615385,0.9846153846153847,195,6650,4700,1950,0.706766917293233,86,47,39,201.24426368733643,0.47039386730108385,0.7604759037677113,0.11517266346421713,1043480.6554865756,-3651.1007629246214,1039829.5547236509,1066,0,304.8615384615385,73,122,44,39.48342703854777,0.5364316239316239,44.62274774774777,8172.072072072135,111.94619276811143,0
1093,32,0,2,190,0.0,0.010416666666666666,0.9895833333333334,192,5750,4200,1550,0.7304347826086957,73,42,31,201.92745891751224,0.4701367301119837,0.7586788568166996,0.11593812528859515,1044484.0000000099,-1967.9999999994989,1042516.0000000104,1067,1,304.6458333333333,74,118,47,39.340753424657564,0.5382486979166667,44.500000000000036,8176.000000000078,110.48648648648755,0
1094,32,3,2,191,0.015544041450777202,0.010362694300518135,0.9896373056994818,193,6100,4300,1800,0.7049180327868853,79,43,36,238.38042004784774,0.4705389590529649,0.7987130126370294,0.13500053094226502,1040211.1196845047,4893.192729767192,1045104.3124142719,1068,0,303.3316062176166,71,122,38,38.94499924345588,0.5297927461139896,45.02314814814817,8159.259259259302,114.91914449660989,8
1095,32,1,2,190,0.005208333333333333,0.010416666666666666,0.9895833333333334,192,6100,4600,1500,0.7540983606557377,76,46,30,230.73719283631783,0.4704770215241419,0.7906675170068032,0.1314665401044139,1042100.6944444459,3590.2777777778538,1045690.9722222238,1069,0,305.5989583333333,76,116,38,38.903061224489775,0.5352647569444444,44.79166666666667,8166.666666666679,107.45614035087735,8
1096,32,3,0,193,0.015544041450777202,0.0,1.0,193,5450,3800,1650,0.6972477064220184,71,38,33,233.66226009602613,0.4710247103483017,0.786127867857475,0.13426524838655984,1044729.4948157019,4772.770989523564,1049502.2658052254,1070,0,304.9481865284974,67,126,38,38.49920318526066,0.5353518998272884,44.4699754901961,8176.960784313773,122.04419081065332,8
1097,32,3,1,195,0.015306122448979591,0.00510204081632653,0.9948979591836735,196,5800,4100,1700,0.7068965517241379,75,41,34,226.14849106448443,0.4716951203558346,0.7903545695238232,0.12808819756434886,1040247.4414904299,2050.0778453502226,1042297.5193357802,1071,0,301.265306122449,77,119,37,39.25233287941477,0.5293898809523809,45.01869658119658,8159.401709401707,105.96625596625594,8
1098,32,3,4,194,0.015151515151515152,0.020202020202020204,0.9797979797979798,198,5700,3900,1800,0.6842105263157895,75,39,36,224.09408773045152,0.4720593199336854,0.7928056791693161,0.12818181818181829,1043316.3265306124,1460.2040816327126,1044776.5306122451,1072,0,299.17171717171715,62,136,39,38.92045454545457,0.532354797979798,44.642857142857146,8171.4285714285725,131.79723502304148,0
1099,32,4,2,196,0.020202020202020204,0.010101010101010102,0.98989898989899,198,6650,4500,2150,0.6766917293233082,88,45,43,216.9589504077569,0.4721757550120494,0.7869274028039606,0.12352608601926637,1041873.8549382732,-1041.2283950616256,1040832.6265432115,1073,0,297.72222222222223,74,124,42,39.28307389466428,0.5311973905723906,44.81944444444445,8165.777777777791,110.34834834834852,8
1100,32,3,2,197,0.01507537688442211,0.010050251256281407,0.9899497487437185,199,6750,4600,2150,0.6814814814814815,89,46,43,212.17272383051764,0.4723047053449063,0.7834921489100521,0.12188251367195194,1044641.6278371785,-2221.1080790082037,1042420.5197581704,1074,0,293.0251256281407,66,133,43,39.059299259709974,0.5341289782244556,44.48072139303481,8176.6169154228555,123.88813508216448,0
1101,32,2,0,199,0.010050251256281407,0.0,1.0,199,7050,5300,1750,0.75177304964539,88,53,35,209.34778764504156,0.4728323858348984,0.7802500286730134,0.12128261531409439,1047259.1554806164,-3001.722541823556,1044257.4329387929,1075,0,291.7638190954774,70,129,40,38.804861031463886,0.5369556113902847,44.160798122065735,8186.854460093911,116.9550637156273,0
1102,32,2,3,198,0.009950248756218905,0.014925373134328358,0.9850746268656716,201,6100,4500,1600,0.7377049180327869,77,45,32,212.830958486746,0.47287209784411277,0.778963283393237,0.1225933694640383,1045482.9053814622,-1797.7742332308417,1043685.1311482313,1076,0,289.85074626865674,72,129,41,38.93742324438988,0.5343594527363185,44.37785388127856,8179.908675799137,113.60984271943246,8
1103,32,4,4,198,0.019801980198019802,0.019801980198019802,0.9801980198019802,202,6100,4100,2000,0.6721311475409836,81,41,40,214.190841181977,0.47360608262318765,0.7849743258189843,0.11819405262364473,1032051.0277200554,-2288.824445984057,1029762.2032740713,1077,0,287.0990099009901,75,127,41,40.58531210649396,0.5218131188118812,46.025219298245574,8127.192982456043,108.36257309941391,8
1104,32,2,1,199,0.01,0.005,0.995,200,6400,4300,2100,0.671875,85,43,42,212.52515083649445,0.47370236599664994,0.7816916413018038,0.11803575022401343,1034095.294784575,-2445.7482993200374,1031649.546485255,1078,0,285.875,69,131,43,40.37086357605557,0.5244270833333333,45.773809523809504,8135.238095238052,117.90200138026162,0
1105,32,1,6,194,0.005,0.03,0.97,200,6400,5100,1300,0.796875,77,51,26,208.87506661656167,0.47417294807370186,0.7785047384063255,0.11673046264409696,1036049.7624371852,-3119.0073705721934,1032930.755066613,1079,0,286.75,72,128,42,40.218508757173005,0.52625,45.533675799086744,8142.922374429197,113.0961440892944,0
1106,32,6,2,198,0.03,0.01,0.99,200,6450,5000,1450,0.7751937984496124,79,50,29,222.47496124371662,0.47488117671691793,0.7918039646269805,0.12399869738654867,1035207.9431550283,-388.4305934797094,1034819.5125615486,1080,0,287.21,68,132,38,39.97813915761566,0.52484375,45.63707729468597,8139.613526570012,119.70019892014724,8
1107,32,1,2,197,0.005025125628140704,0.010050251256281407,0.9899497487437185,199,6050,4100,1950,0.6776859504132231,80,41,39,220.61479749749913,0.4748225555386359,0.7898728866222009,0.1234273759110146,1036396.7155612212,-121.10969387779824,1036275.6058673435,1081,0,289.29145728643215,69,130,40,39.8762278547623,0.5263819095477387,45.491071428571416,8144.285714285688,118.03312629399548,0
1108,32,4,1,200,0.01990049751243781,0.004975124378109453,0.9950248756218906,201,6700,5000,1700,0.746268656716418,84,50,34,217.98715286268717,0.4751254145936982,0.7894383007798031,0.1231816190151135,1039527.8144477125,-1579.2582813944377,1037948.556166318,1082,0,285.9950248756219,75,126,34,39.55056595149756,0.5296952736318408,45.106907894736835,8156.5789473684035,108.75438596491205,0
1109,32,4,1,203,0.0196078431372549,0.004901960784313725,0.9950980392156863,204,6650,5100,1550,0.7669172932330827,82,51,31,210.0618130015764,0.47569142599568565,0.7857164896498274,0.12006131204134113,1043073.1434240398,-3628.032879818468,1039445.1105442214,1083,0,282.45098039215685,69,135,38,39.30916579243887,0.5326797385620915,44.67261904761906,8170.476190476219,118.41269841269883,0
1110,32,2,5,200,0.00975609756097561,0.024390243902439025,0.975609756097561,205,5500,3500,2000,0.6363636363636364,75,35,40,204.31184876564234,0.4757452574525745,0.7806157360747157,0.11727577656851434,1044401.1367786753,-3823.2945783618757,1040577.8422003133,1084,0,282.0536585365854,73,132,43,39.29017447199267,0.5345020325203251,44.51013513513515,8175.675675675713,111.99555720103717,0
1111,32,5,7,198,0.024390243902439025,0.03414634146341464,0.9658536585365853,205,6450,4700,1750,0.7286821705426356,82,47,35,225.30735766836162,0.4751404830224773,0.795336478227511,0.13447364406993437,1056363.2992620468,151.28473891282374,1056514.5840009595,1085,0,281.41951219512197,78,127,33,37.261913925522975,0.548729674796748,43.05116033755274,8222.3628691983,105.41490857946538,8
1112,32,0,2,196,0.0,0.010101010101010102,0.98989898989899,198,5250,3500,1750,0.6666666666666666,70,35,35,230.92930352414044,0.47398904442051654,0.7969439946539179,0.13385725115779842,1047424.3164062519,3526.193576389018,1050950.5099826409,1086,1,287.9141414141414,71,127,35,38.23208227311281,0.5397727272727273,44.14062500000001,8187.500000000015,115.3169014084509,8
1113,32,0,3,193,0.0,0.015306122448979591,0.9846938775510204,196,5600,3900,1700,0.6964285714285714,73,39,34,204.71519168924402,0.47327751613465896,0.7729379453630922,0.1171662227586314,1043499.5654020981,-2075.9572882132898,1041423.6081138848,1087,2,291.80102040816325,72,124,41,39.39242610493379,0.5361394557823129,44.62043378995434,8172.146118721466,113.50202942668703,8
1114,32,3,3,193,0.015306122448979591,0.015306122448979591,0.9846938775510204,196,6600,4700,1900,0.7121212121212122,85,47,38,203.85699698841285,0.473433411826269,0.7734937834226023,0.11786300871752123,1046635.2884128892,-3127.214632409264,1043508.07378048,1088,0,292.40816326530614,76,120,43,39.02310553968756,0.538796768707483,44.237012987012996,8184.415584415611,107.68967874231068,0
1115,32,3,1,195,0.015306122448979591,0.00510204081632653,0.9948979591836735,196,6200,4400,1800,0.7096774193548387,80,44,36,200.97393705566247,0.47351463021105883,0.7702256820747067,0.11694791479003509,1048622.354421759,-3250.847389455895,1045371.5070323031,1089,0,293.32142857142856,80,116,40,38.84929505534067,0.5410820578231292,43.99434156378603,8192.181069958908,102.40226337448635,0
1116,32,5,1,199,0.025,0.005,0.995,200,7100,5300,1800,0.7464788732394366,89,53,36,192.9796957780321,0.474151486599665,0.7657745552313948,0.11369996838206162,1052430.3523606395,-6480.462154775483,1045949.890205864,1090,0,288.395,70,130,43,38.58057796083368,0.5446354166666667,43.52992957746478,8207.0422535211,117.24346076458714,0
1117,32,1,3,197,0.005,0.015,0.985,200,5500,3700,1800,0.6727272727272727,73,37,36,219.3049627883491,0.4740761097152429,0.7848331957060275,0.1265864203702057,1046128.1329894119,384.21825541776116,1046512.3512448297,1091,0,289.295,73,127,39,38.69133636113406,0.54015625,44.2989864864865,8182.432432432462,112.08811551277344,8
1118,32,5,3,199,0.024752475247524754,0.01485148514851485,0.9851485148514851,202,6950,4900,2050,0.7050359712230215,90,49,41,211.11038459210755,0.47382928591366597,0.7792333132395797,0.12347382981753102,1050187.0114690706,-3008.923223025384,1047178.0882460452,1092,0,287.009900990099,77,125,38,38.39484292465946,0.5438325082508251,43.80341880341883,8198.29059829066,106.47130647130727,0
1119,32,2,1,200,0.009950248756218905,0.004975124378109453,0.9950248756218906,201,6050,4200,1850,0.6942148760330579,79,42,37,206.578028200183,0.47350953565505804,0.7730544270797071,0.12168267364303689,1052357.132258947,-2771.2277311096577,1049585.9045278374,1093,0,289.3681592039801,73,128,40,38.24092751157215,0.5461235489220564,43.53885135135135,8206.756756756748,112.42132543502395,0
1120,32,4,6,198,0.0196078431372549,0.029411764705882353,0.9705882352941176,204,5900,4400,1500,0.7457627118644068,74,44,30,205.85376078193482,0.47362227937151874,0.7776370178952798,0.12262610989905529,1055778.2052423418,-3232.8171798526882,1052545.3880624892,1094,0,286.078431372549,77,127,33,37.83440559743522,0.5490706699346406,43.12232905982904,8220.085470085423,106.75435675435615,0
1121,32,1,0,199,0.005025125628140704,0.0,1.0,199,5500,3500,2000,0.6363636363636364,75,35,40,209.9518572079861,0.4726705920173257,0.778438284581886,0.1255775394147051,1057012.4567901185,-915.6543209879237,1056096.8024691306,1095,0,293.8994974874372,74,125,37,37.57587629237364,0.5507223618090452,42.97222222222221,8224.88888888885,111.14714714714663,0
1122,32,1,4,196,0.005,0.02,0.98,200,7950,6100,1850,0.7672955974842768,98,61,37,195.82725370106996,0.4729894262981575,0.7617937907244139,0.11328454654237131,1046809.8423683258,-6951.220684351863,1039858.6216839739,1096,0,293.425,84,116,43,39.20673230484223,0.5431770833333334,44.21568627450982,8185.0980392157335,97.44164332399683,8
1123,32,1,0,197,0.005076142131979695,0.0,1.0,197,6600,4600,2000,0.696969696969697,86,46,40,199.82673542411626,0.4727729289685418,0.7644342404543345,0.11622131674014241,1048466.1484711104,-4097.686469663948,1044368.4620014464,1097,0,298.6903553299492,86,111,37,38.89811350171501,0.5454737732656514,44.013409961685845,8191.570881226113,95.25082420030364,0
1124,32,2,1,198,0.010050251256281407,0.005025125628140704,0.9949748743718593,199,6000,3900,2100,0.65,81,39,42,199.0792189466942,0.47285988020912645,0.767516108255915,0.11653367995456969,1050441.3162729174,-3975.7926414099074,1046465.5236315075,1098,0,296.678391959799,92,107,42,38.67144241417497,0.5476863484087102,43.77240143369176,8199.28315412188,89.12264297958565,0
1125,32,0,3,195,0.0,0.015151515151515152,0.9848484848484849,198,6300,4300,2000,0.6825396825396826,83,43,40,199.53362184926428,0.4723765788169341,0.7651628789264622,0.11766672030217738,1052703.7299123404,-3890.0424072724322,1048813.687505068,1099,1,299.0656565656566,73,125,42,38.37851681118061,0.5497159090909092,43.49662162162161,8208.108108108074,112.43983709737087,0
1126,32,1,0,196,0.00510204081632653,0.0,1.0,196,5800,4200,1600,0.7241379310344828,74,42,32,199.48287776811682,0.47177252311180884,0.7647705315163038,0.11874510022018495,1055558.6630917112,-2886.824046680078,1052671.8390450312,1100,0,302.0255102040816,77,119,43,38.02530156501844,0.5519238945578231,43.149038461538446,8219.230769230731,106.74325674325625,0
1127,32,0,1,195,0.0,0.00510204081632653,0.9948979591836735,196,6700,5000,1700,0.746268656716418,84,50,34,198.22315248102083,0.4717316413744985,0.7631397096653787,0.1184304304397831,1056675.3523861463,-4008.496100204864,1052666.8562859416,1101,1,303.0255102040816,81,115,38,37.91913824353269,0.5535714285714286,43.01321138211382,8223.577235772362,101.52564488607854,0
1128,32,1,1,195,0.00510204081632653,0.00510204081632653,0.9948979591836735,196,6150,4600,1550,0.7479674796747967,77,46,31,193.47202637412886,0.4716907596371882,0.7564620339701695,0.11620503564646453,1058276.134179162,-4400.634371395616,1053875.4998077664,1102,0,301.6887755102041,84,112,41,37.842887321706556,0.5558567176870748,42.818627450980394,8229.80392156863,97.97385620915036,0
1129,32,0,2,193,0.0,0.010256410256410256,0.9897435897435898,195,6700,4700,2000,0.7014925373134329,87,47,40,196.05027829318962,0.4713796369724205,0.7601616228707426,0.11833262725644286,1059755.8641975285,-4146.913580247065,1055608.9506172815,1103,1,304.07179487179485,74,121,39,37.59331714337108,0.5576923076923077,42.63888888888888,8235.555555555537,111.29129129129103,0
1130,32,0,1,192,0.0,0.0051813471502590676,0.9948186528497409,193,6900,5200,1700,0.7536231884057971,86,52,34,208.7406094189154,0.47052883923431205,0.7692833398332324,0.12286630807569054,1052132.893598615,-1575.427720107742,1050557.4658785071,1104,2,307.979274611399,67,126,42,38.213361210673035,0.5518134715025906,43.56617647058823,8205.88235294117,122.47585601404731,8
1131,32,2,1,193,0.010309278350515464,0.005154639175257732,0.9948453608247423,194,5650,3400,2250,0.6017699115044248,79,34,45,215.2066601949264,0.4707085848334313,0.7813724521531364,0.12212778454325246,1040853.3827160553,349.71604938299606,1041203.0987654383,1105,0,307.3144329896907,74,120,38,39.45547901691717,0.5376396048109966,44.944444444444464,8161.777777777825,110.29429429429493,8
1132,32,1,2,192,0.005154639175257732,0.010309278350515464,0.9896907216494846,194,5550,4300,1250,0.7747747747747747,68,43,25,212.93889150532348,0.470946174527714,0.7801906416439983,0.12128471191250433,1041995.6730850684,26.28071601570582,1042021.9538010841,1106,0,307.57216494845363,80,114,39,39.37042262984616,0.5393041237113403,44.804526748971206,8166.255144032949,102.07818930041186,0
1133,32,0,2,190,0.0,0.010416666666666666,0.9895833333333334,192,6600,4900,1700,0.7424242424242424,83,49,34,215.6399925307763,0.4709309327734148,0.7705983218438828,0.1245197399571569,1046249.2238293564,122.634962378821,1046371.8587917351,1107,1,311.4114583333333,77,115,39,38.769932455957104,0.5467122395833333,44.28418803418805,8182.905982906017,106.27150627150671,8
1134,32,1,0,191,0.005235602094240838,0.0,1.0,191,5750,3800,1950,0.6608695652173913,77,38,39,213.82160186322574,0.4711525213557454,0.7702477089426352,0.12407007575387517,1047745.4496701674,856.1220786762724,1048601.5717488436,1108,0,312.5602094240838,82,109,33,38.62974088605526,0.5453206806282722,44.10140562248996,8188.755020080327,99.86286609854058,7
1135,32,2,6,187,0.010362694300518135,0.031088082901554404,0.9689119170984456,193,6700,4800,1900,0.7164179104477612,86,48,38,210.51234344388382,0.47164089486183075,0.7696371811824043,0.12291057980136982,1049654.5802485095,-1106.9509010558827,1048547.6293474537,1109,0,310.31088082901556,87,106,38,38.47648427149769,0.5476575993091537,43.86837121212122,8196.212121212136,94.20933472657629,0
1136,32,3,2,188,0.015789473684210527,0.010526315789473684,0.9894736842105263,190,6500,4700,1800,0.7230769230769231,83,47,36,205.0470832536332,0.4716443887496519,0.7614232947272779,0.12067398177389854,1052086.582530205,-1354.5429843795614,1050732.0395458254,1110,0,312.5736842105263,75,115,41,38.313835141732156,0.5507675438596491,43.57182017543861,8205.701754385991,109.40935672514655,0
1137,32,0,2,186,0.0,0.010638297872340425,0.9893617021276596,188,6300,4300,2000,0.6825396825396826,83,43,40,209.8634216583836,0.47143387093715633,0.7628837233714505,0.12396850208345002,1053221.539016188,306.53518844932205,1053528.0742046372,1111,1,316.70212765957444,78,110,43,38.04915287628053,0.5523603723404256,43.43354430379748,8210.126582278517,105.25803310613483,0
1138,32,0,2,184,0.0,0.010752688172043012,0.989247311827957,186,6200,4100,2100,0.6612903225806451,83,41,42,212.39777493157405,0.4709338370628693,0.7633585551427402,0.1258227354479016,1054087.7641581728,1377.179137959035,1055464.943296132,1112,2,320.4516129032258,78,108,40,37.87640415767666,0.5535394265232976,43.32805907172998,8213.502109704697,105.30130909877818,0
1139,32,2,3,183,0.010752688172043012,0.016129032258064516,0.9838709677419355,186,5550,4000,1550,0.7207207207207207,71,40,31,199.9720476381187,0.47120931415286255,0.7531887216393842,0.11923990546834962,1056077.3681640537,-512.8092447921704,1055564.5589192614,1113,0,319.0860215053763,79,107,34,37.948374385484726,0.5569556451612903,43.08593749999997,8221.24999999993,104.06645569620166,8
1140,32,3,0,186,0.016129032258064516,0.0,1.0,186,5650,4100,1550,0.7256637168141593,72,41,31,197.61624147475248,0.47124927346701545,0.7513795050363221,0.1186855808997831,1058254.262028024,-1024.3540426771292,1057229.9079853469,1114,0,317.14516129032256,82,104,38,37.73901603877935,0.559643817204301,42.821285140562225,8229.718875501947,100.36242531099936,0
1141,32,0,3,183,0.0,0.016129032258064516,0.9838709677419355,186,6800,4900,1900,0.7205882352941176,87,49,38,198.82122142869628,0.47096653104717623,0.7529200334944586,0.11982498892271648,1059303.1476391025,-1877.6108646261664,1057425.5367744763,1115,1,318.14516129032256,71,115,41,37.57807375128858,0.5613799283154122,42.69386574074074,8233.796296296292,115.96896191966609,0
1142,32,1,0,184,0.005434782608695652,0.0,1.0,184,5200,3800,1400,0.7307692307692307,66,38,28,203.61386344092082,0.47032895778886513,0.7569066138354572,0.12334647860862913,1060852.315350656,1200.8476937588453,1062053.1630444147,1116,0,322.2173913043478,71,113,39,37.26284788553022,0.5631793478260869,42.50578703703705,8239.81481481485,116.05372978612465,0
1143,32,2,2,184,0.010752688172043012,0.010752688172043012,0.989247311827957,186,5800,3900,1900,0.6724137931034483,77,39,38,205.92218836525137,0.47018490264458007,0.7615877762764101,0.12593654770894377,1063702.72583872,807.9986149584502,1064510.7244536786,1117,0,319.741935483871,75,111,44,36.850591820823595,0.5656922043010753,42.16008771929825,8250.87719298246,110.01169590643279,0
1144,32,0,2,182,0.0,0.010869565217391304,0.9891304347826086,184,6600,5300,1300,0.803030303030303,79,53,26,208.0497017811656,0.4695895947176685,0.7605818364688173,0.12798931510720996,1065460.660133137,933.7545200526401,1066394.4146531895,1118,1,323.8804347826087,77,107,37,36.578332815815344,0.5679913949275363,41.94711538461539,8257.692307692314,107.24275724275732,0
1145,32,0,1,181,0.0,0.005494505494505495,0.9945054945054945,182,6450,5000,1450,0.7751937984496124,79,50,29,209.11813783310362,0.46901119138688196,0.7589643871629657,0.12903637001684068,1066361.2296150953,1749.0949189056514,1068110.324534001,1119,2,327.8901098901099,78,104,38,36.439446175323894,0.5694826007326007,41.838080168776386,8261.181434599197,105.9125824948615,0
1146,32,0,0,181,0.0,0.0,1.0,181,5100,3700,1400,0.7254901960784313,65,37,28,226.06579317058527,0.46832284632698995,0.7721167836453895,0.13528160819339088,1057160.014923051,6497.543456361262,1063657.5583794122,1120,3,330.646408839779,71,110,42,37.14335800454024,0.5549608655616942,42.9542824074074,8225.46296296294,115.85159102764705,7
1147,32,1,3,179,0.005494505494505495,0.016483516483516484,0.9835164835164835,182,5650,3900,1750,0.6902654867256637,74,39,35,247.37879162149662,0.46849639770910484,0.7875520158976845,0.14845697230682633,1058019.653169403,10296.32466256843,1068315.9778319716,1121,0,329.8241758241758,80,102,32,36.488443522037734,0.5606684981684982,42.84979423868313,8228.80658436215,102.86008230452687,8
1148,32,1,1,179,0.005555555555555556,0.005555555555555556,0.9944444444444445,180,6100,4200,1900,0.6885245901639344,80,42,38,241.75727569133892,0.4678208410924891,0.785181929181926,0.14138760981948642,1050163.339014703,8676.92557422349,1058840.2645889265,1122,0,334.26666666666665,73,107,34,37.612637362637365,0.5492476851851852,43.80630630630635,8198.198198198297,112.30408490682599,8
1149,32,0,0,179,0.0,0.0,1.0,179,5150,3600,1550,0.6990291262135923,67,36,31,236.60977206361665,0.46755670286443624,0.7795592547252035,0.13888342400578177,1051282.1540105205,8798.726166995511,1060080.880177516,1123,1,336.66480446927375,64,115,35,37.60485047410653,0.5507448789571694,43.6698717948718,8202.564102564113,128.16506410256426,0
1150,32,1,1,179,0.005555555555555556,0.005555555555555556,0.9944444444444445,180,3950,2700,1250,0.6835443037974683,52,27,25,233.63873627469766,0.46738438857852266,0.777883709981168,0.13784685440207162,1052854.442344045,9247.516278092813,1062101.9586221378,1124,0,335.7888888888889,68,112,40,37.484919373822976,0.5520833333333333,43.47826086956522,8208.695652173912,120.7161125319693,0
1151,32,1,1,179,0.005555555555555556,0.005555555555555556,0.9944444444444445,180,5850,3800,2050,0.6495726495726496,79,38,41,188.0392295965693,0.46723114525139664,0.7289322396872902,0.10922626553957318,1048073.8685574274,-2434.1994392327856,1045639.6691181946,1125,0,336.15555555555557,86,94,41,39.248651135229544,0.5527199074074074,44.06130268199236,8190.038314176304,95.23300365321283,8
1152,32,0,3,176,0.0,0.01675977653631285,0.9832402234636871,179,5650,4000,1650,0.7079646017699115,73,40,33,205.65392433527003,0.466972150733371,0.7515892947696814,0.11731233003401721,1042465.3096655369,1427.4163832201466,1043892.726048757,1126,1,339.02793296089385,69,110,43,39.49764618434095,0.5434706703910615,44.747023809523824,8168.095238095269,118.37819185645318,7
1153,32,4,1,179,0.022222222222222223,0.005555555555555556,0.9944444444444445,180,5550,3400,2150,0.6126126126126126,77,34,43,200.93585926190883,0.468440280364163,0.7458462696396648,0.11575865843332445,1045528.3821517624,466.82877007570096,1045995.2109218381,1127,0,335.44444444444446,76,104,46,39.235817104149056,0.5458912037037037,44.372294372294384,8180.086580086609,107.63271815903433,0
1154,32,1,1,179,0.005555555555555556,0.005555555555555556,0.9944444444444445,180,6350,4400,1950,0.6929133858267716,83,44,39,200.41049148909997,0.4688282381543554,0.744181509754029,0.11616714329677917,1047424.3164062501,-367.03559027773144,1047057.2808159724,1128,0,332.9111111111111,79,101,39,39.012934690415584,0.5482060185185185,44.140625,8187.500000000001,103.63924050632913,0
1155,32,1,1,179,0.005555555555555556,0.005555555555555556,0.9944444444444445,180,6300,4500,1800,0.7142857142857143,81,45,36,199.97378090136283,0.4688275915580385,0.7435486127929802,0.11639297171436828,1048693.8445806585,-357.74537824386925,1048336.0992024146,1129,0,333.6,83,97,41,38.865998627593385,0.5498842592592592,43.98561507936508,8192.460317460334,98.7043411742209,0
1156,32,1,1,179,0.005555555555555556,0.005555555555555556,0.9944444444444445,180,4650,3500,1150,0.7526881720430108,58,35,23,218.27525569014296,0.46874353403683017,0.761978564451836,0.12338444147190568,1039629.2125811225,4735.066439817213,1044364.2790209397,1130,0,332.78333333333336,85,95,33,39.530519917636816,0.5384259259259259,45.09447674418604,8156.976744186028,95.9644322845415,8
1157,32,7,0,186,0.03763440860215054,0.0,1.0,186,6450,4700,1750,0.7286821705426356,82,47,35,217.033030019238,0.47005109948658336,0.7725048894701363,0.12476306608515737,1044861.5296039351,1703.89274409583,1046565.422348031,1131,0,322.96774193548384,73,113,36,38.90763284491943,0.5426747311827957,44.453828828828854,8177.4774774775315,112.02023941750043,0
1158,32,3,4,185,0.015873015873015872,0.021164021164021163,0.9788359788359788,189,5450,3400,2050,0.6238532110091743,75,34,41,198.25733758575825,0.470633278922286,0.7507002463938703,0.11659855715739684,1051878.1512345695,-1541.487654320852,1050336.6635802486,1132,0,318.8253968253968,74,115,41,38.513849015040705,0.5507605820105821,43.59722222222223,8204.888888888901,110.87687687687705,8
1159,32,0,3,182,0.0,0.016216216216216217,0.9837837837837837,185,6650,4900,1750,0.7368421052631579,84,49,35,200.9779857604301,0.46937793772032904,0.7516539276392034,0.11868495373934294,1053132.049382711,-1318.7283950620508,1051813.320987649,1133,1,326.6756756756757,74,111,44,38.288242565324076,0.552195945945946,43.44444444444443,8209.77777777774,110.94294294294242,0
1160,32,0,0,182,0.0,0.0,1.0,182,5000,3200,1800,0.64,68,32,36,207.12764598286967,0.4689618622629672,0.7547941262698559,0.12263735245489978,1053930.3734567822,2259.6234567896304,1056189.9969135718,1134,2,332.0659340659341,74,108,42,38.03123365261462,0.5536858974358974,43.34722222222219,8212.888888888825,110.98498498498412,0
1161,32,1,1,182,0.00546448087431694,0.00546448087431694,0.994535519125683,183,6150,4400,1750,0.7154471544715447,79,44,35,221.3963364635166,0.4689482875958286,0.7636137696373899,0.12619301012841877,1042220.5140073635,3398.7607176707343,1045619.2747250343,1135,0,331.24590163934425,70,113,34,39.126451483099586,0.5403005464480874,44.77699530516433,8167.1361502347545,116.6733735747822,8
1162,32,3,1,184,0.016216216216216217,0.005405405405405406,0.9945945945945946,185,6450,4600,1850,0.7131782945736435,83,46,37,219.11960982546694,0.46943179592636114,0.7662384734128349,0.1260729627877913,1045132.7673787046,2351.8168407665585,1047484.5842194712,1136,0,328.62702702702705,72,113,35,38.82041762045667,0.5431306306306306,44.420662100456624,8178.538812785398,113.59081684424163,0
1163,32,1,1,184,0.005405405405405406,0.005405405405405406,0.9945945945945946,185,5000,3400,1600,0.68,66,34,32,217.6598241925259,0.4693424402663533,0.7657555883060971,0.1257074241854707,1046301.6790123507,3547.5679012348046,1049849.2469135856,1137,0,329.38378378378377,74,111,39,38.71173238467666,0.5451013513513514,44.27777777777779,8183.111111111151,110.58258258258313,0
1164,32,2,4,182,0.010752688172043012,0.021505376344086023,0.978494623655914,186,5850,4400,1450,0.7521367521367521,73,44,29,214.87265524535235,0.46962062869320936,0.7621658545343339,0.12482674864435289,1048107.8129565773,1991.9417506760929,1050099.7547072533,1138,0,327.9516129032258,77,109,36,38.557646317071075,0.5469870071684588,44.05715811965814,8190.17094017099,106.36585636585701,0
1165,32,1,0,183,0.00546448087431694,0.0,1.0,183,5500,3400,2100,0.6181818181818182,76,34,42,215.8669899022651,0.46921600712584316,0.7609030797346068,0.1259915989141111,1049544.0545496682,3212.383165091418,1052756.4377147597,1139,0,332.39890710382514,78,105,39,38.35311127127952,0.548554189435337,43.88185654008441,8195.780590717344,105.07411013740185,0
1166,32,4,0,187,0.0213903743315508,0.0,1.0,187,5700,3900,1800,0.6842105263157895,75,39,36,211.39257950474172,0.4696358748778104,0.757047360654757,0.1229065864190064,1048362.1635135002,1223.1964000585067,1049585.3599135587,1140,0,326.26737967914437,82,105,36,38.61500621036808,0.5462901069518716,44.02610441767071,8191.164658634605,99.89225193456835,7
1167,32,3,2,188,0.015789473684210527,0.010526315789473684,0.9894736842105263,190,4950,3900,1050,0.7878787878787878,60,39,21,209.42267440311593,0.469957300659055,0.7613390295107227,0.12280853664435956,1050991.1033163192,1070.2735260767004,1052061.3768423959,1141,0,322.1,69,121,44,38.337966188623746,0.5487938596491229,43.70535714285712,8201.428571428512,118.86128364389148,0
1168,32,0,1,187,0.0,0.005319148936170213,0.9946808510638298,188,5200,3600,1600,0.6923076923076923,68,36,32,209.15684352500307,0.46967622880873816,0.7597883114019712,0.12300276421151776,1051863.287357925,1200.881000723126,1053064.1683586482,1142,1,326.03723404255317,68,120,39,38.23623214005336,0.5499224290780143,43.5990338164251,8204.830917874346,120.65927820403449,0
1169,32,3,3,187,0.015789473684210527,0.015789473684210527,0.9842105263157894,190,5250,3700,1550,0.7047619047619048,68,37,31,203.22454041916302,0.4698818806274947,0.7526857903224491,0.12053641902121408,1054461.2947667774,-391.5175962454705,1054069.777170532,1143,0,323.5736842105263,77,113,44,38.06545761154169,0.5524122807017544,43.28258547008545,8214.957264957216,106.68775668775606,0
1170,32,2,1,188,0.010582010582010581,0.005291005291005291,0.9947089947089947,189,6050,4600,1450,0.7603305785123967,75,46,29,202.25526329977885,0.46989685354047056,0.7521456047829085,0.12079780694689152,1056570.8887938694,-1110.5953384230052,1055460.2934554464,1144,0,325.56613756613757,81,108,38,37.828478504457316,0.5550595238095238,43.02591463414633,8223.17073170729,101.52062631737395,0
1171,32,2,3,187,0.010526315789473684,0.015789473684210527,0.9842105263157894,190,6600,4700,1900,0.7121212121212122,85,47,38,197.5118425150384,0.4702038661468486,0.7487108459407621,0.11898884171027942,1059184.0277777791,-2759.7222222221653,1056424.305555557,1145,0,324.0473684210526,73,117,43,37.626518218623474,0.5575109649122807,42.708333333333336,8233.333333333343,112.78538812785402,0
1172,32,1,0,188,0.005319148936170213,0.0,1.0,188,5950,4100,1850,0.6890756302521008,78,41,37,232.29875297550177,0.46955830204422194,0.7871645268618226,0.13819596055030453,1055375.7287379915,5482.493141289113,1060858.2218792806,1146,0,328.4255319148936,71,117,40,37.2051975364278,0.5536347517730497,43.171296296296276,8218.518518518475,115.75378195096444,8
1173,32,0,4,184,0.0,0.02127659574468085,0.9787234042553191,188,6250,4600,1650,0.736,79,46,33,235.53344354986044,0.4693556339363598,0.7885058032238386,0.1405254593502756,1056252.0318751868,5906.535664819627,1062158.5675400065,1147,1,329.4255319148936,75,113,34,37.013007219317885,0.555186170212766,43.06469298245612,8221.929824561359,109.62573099415145,0
1174,32,2,2,184,0.010752688172043012,0.010752688172043012,0.989247311827957,186,4900,3200,1700,0.6530612244897959,66,32,34,239.52829982972665,0.46881478252445996,0.7919218357774316,0.14414350639237733,1058854.1923487773,8625.108892175826,1067479.3012409532,1148,0,332.758064516129,77,109,36,36.58649353683224,0.5582437275985663,42.74839743589742,8232.051282051232,106.90975690975627,0
1175,32,1,0,185,0.005405405405405406,0.0,1.0,185,6550,4800,1750,0.732824427480916,83,48,35,239.66810150710626,0.468697365844105,0.7911571765940704,0.14521067326607007,1060899.9999999984,7302.777777777643,1068202.7777777761,1149,0,335.34054054054053,64,121,38,36.328546386191995,0.5606418918918918,42.49999999999999,8239.999999999987,128.7499999999998,0
1176,32,0,1,184,0.0,0.005405405405405406,0.9945945945945946,185,4750,3600,1150,0.7578947368421053,59,36,23,240.16428059910206,0.4686080101840971,0.7930955770746788,0.14621739749159296,1062353.061308352,9277.85174227495,1071630.913050627,1150,1,336.34054054054053,64,121,39,36.13525405808818,0.5622184684684685,42.323717948717956,8245.641025641044,128.8381410256413,0
1177,32,1,2,183,0.005405405405405406,0.010810810810810811,0.9891891891891892,185,6200,4300,1900,0.6935483870967742,81,43,38,238.69511424552675,0.4686484038386212,0.7914421006500862,0.14620396689337845,1064161.6818653853,7602.038845713903,1071763.7207110992,1151,0,337.25405405405405,68,117,42,35.94862826591738,0.5641328828828829,42.10446859903381,8252.657004830899,121.3626030122191,0
1178,32,2,1,184,0.010810810810810811,0.005405405405405406,0.9945945945945946,185,5100,3400,1700,0.6666666666666666,68,34,34,234.90222570059112,0.4689482961222092,0.7882508019615806,0.1446918751584308,1065838.127355679,7973.549670479555,1073811.6770261584,1152,0,337.2108108108108,70,115,37,35.838615090192505,0.5656531531531532,41.90140845070421,8259.15492957743,117.98792756539184,0
1179,32,1,1,184,0.005405405405405406,0.005405405405405406,0.9945945945945946,185,6100,4500,1600,0.7377049180327869,77,45,32,236.42878481134701,0.4689495201723463,0.7887705711519841,0.14624606868869552,1067089.0000000002,7358.111111111136,1074447.1111111115,1153,0,337.8810810810811,74,111,40,35.64422663224695,0.5672860360360361,41.75,8264.000000000002,111.6756756756757,0
1180,32,1,1,184,0.005405405405405406,0.005405405405405406,0.9945945945945946,185,5800,4500,1300,0.7758620689655172,71,45,26,234.13705267767028,0.46877203290246766,0.7873898445929193,0.14594663577265013,1069368.1130835002,7275.739644970544,1076643.8527284707,1154,0,337.54594594594596,64,121,39,35.42131581122408,0.5692567567567568,41.474358974358985,8272.820512820534,129.26282051282084,0
1181,32,1,0,185,0.005405405405405406,0.0,1.0,185,5700,3500,2200,0.6140350877192983,79,35,44,233.39186448317298,0.46843052291421855,0.7859751819126821,0.14622140907379522,1070864.582559838,7286.216306527081,1078150.798866365,1155,0,338.5135135135135,66,119,43,35.255533854166664,0.5708896396396397,41.29353233830846,8278.606965174133,125.43343886627474,0
1182,32,0,1,184,0.0,0.005405405405405406,0.9945945945945946,185,6050,3900,2150,0.6446280991735537,82,39,43,227.42157793586242,0.4680792205248727,0.7760258799109021,0.13853738530073795,1062521.9157235932,5278.082133058923,1067799.9978566521,1156,1,339.5135135135135,71,114,38,36.44266037877087,0.5623873873873874,42.30324074074074,8246.296296296292,116.14501825769425,8
1183,32,0,0,184,0.0,0.0,1.0,184,5500,3900,1600,0.7090909090909091,71,39,32,224.51489462946722,0.4676375524669359,0.7820650339284063,0.13472409645996428,1057993.1975522954,5207.046253429238,1063200.2438057247,1157,2,342.2880434782609,71,113,39,37.07967630621506,0.5578577898550725,42.85300925925925,8228.703703703686,115.8972352634322,8
1184,32,0,2,182,0.0,0.010869565217391304,0.9891304347826086,184,5650,3800,1850,0.672566371681416,75,38,37,217.87042492370287,0.46768890571790606,0.7754564995789563,0.12498882271938788,1044228.5156250035,3051.302083333599,1047279.8177083371,1158,3,343.2880434782609,63,121,40,38.96534148827727,0.5420629528985508,44.531250000000014,8175.000000000027,129.76190476190519,8
1185,32,2,1,183,0.010869565217391304,0.005434782608695652,0.9945652173913043,184,5500,4000,1500,0.7272727272727273,70,40,30,212.84727988138803,0.4674129593331749,0.7676487000323862,0.12308469444891734,1046695.0197416461,2257.237563480785,1048952.2573051269,1159,0,343.70108695652175,75,109,42,38.785713966739905,0.5445538949275363,44.229714912280684,8184.649122806977,109.1286549707597,0
1186,32,2,1,184,0.010810810810810811,0.005405405405405406,0.9945945945945946,185,6600,4800,1800,0.7272727272727273,84,48,36,213.38512690107783,0.46794212690951825,0.7625360374207606,0.1182524391497787,1033399.3164062415,502.40885416621586,1033901.7252604077,1160,0,340.6972972972973,79,106,40,40.4363920483656,0.5280405405405406,45.85937499999997,8132.499999999932,102.94303797468268,8
1187,32,2,0,186,0.010752688172043012,0.0,1.0,186,6500,4800,1700,0.7384615384615385,82,48,34,212.16689542502257,0.46791630340017437,0.7633225947025621,0.11876080786549202,1036554.9480506235,284.5290530691982,1036839.4771036927,1161,0,339.8494623655914,71,115,40,40.07139439928762,0.5311379928315412,45.47164351851851,8144.907407407389,114.71700573813223,0
1188,32,2,1,187,0.010638297872340425,0.005319148936170213,0.9946808510638298,188,5100,3800,1300,0.7450980392156863,64,38,26,207.6004532339433,0.4682457001175712,0.7610112560279447,0.11683338179698546,1038247.7808641983,408.14197530871024,1038655.922839507,1162,0,337.22340425531917,74,114,45,39.97555567671704,0.5328568262411347,45.26388888888889,8151.555555555562,110.15615615615624,0
1189,32,4,2,189,0.020942408376963352,0.010471204188481676,0.9895287958115183,191,6700,4700,2000,0.7014925373134329,87,47,40,214.26414245344407,0.46906631762652706,0.7742543835751796,0.12179639889307936,1041374.6183860406,-274.15208374672875,1041100.4663022938,1163,0,331.4712041884817,81,110,39,39.41429525801256,0.5386125654450262,44.88058943089429,8163.821138211334,100.78791528655968,8
1190,32,1,0,190,0.005263157894736842,0.0,1.0,190,6600,5000,1600,0.7575757575757576,82,50,32,211.76743034334552,0.4685950988582568,0.7706260465287453,0.12122590525525362,1043559.5379818621,-401.61564625833216,1043157.9223356037,1164,0,332.18947368421055,69,121,39,39.20483238161831,0.5410087719298246,44.61309523809525,8172.380952380973,118.44030365769527,0
1191,32,3,1,192,0.015544041450777202,0.0051813471502590676,0.9948186528497409,193,5850,4600,1250,0.7863247863247863,71,46,25,212.54463505986791,0.4693257052389177,0.772173655018145,0.12245591918423962,1045552.3090658318,-4.693206719717637,1045547.6158591121,1165,0,328.0103626943005,73,120,42,38.93607745961824,0.54301597582038,44.3693693693694,8180.180180180253,112.05726274219525,0
1192,32,2,3,191,0.010309278350515464,0.015463917525773196,0.9845360824742269,194,6600,4700,1900,0.7121212121212122,85,47,38,212.84939549867994,0.46921738956252335,0.7749286039726861,0.12379443272053305,1048463.66545604,-767.0285210700677,1047696.6369349699,1166,0,327.24226804123714,78,116,36,38.56506043748495,0.545801116838488,44.01371308016879,8191.561181434643,105.02001514659798,0
1193,32,1,5,187,0.005208333333333333,0.026041666666666668,0.9739583333333334,192,4500,3600,900,0.8,54,36,18,207.81388647605047,0.46899371455061084,0.7682189604059884,0.12072130673223494,1048095.6599603755,661.76649900948,1048757.426459385,1167,0,326.21875,80,112,38,38.739825143201685,0.5458441840277778,44.05864197530865,8190.123456790152,102.3765432098769,8
1194,32,1,2,186,0.005319148936170213,0.010638297872340425,0.9893617021276596,188,5550,4300,1250,0.7747747747747747,68,43,25,209.7042575233984,0.46778288201160545,0.7654465062714622,0.12270313606592698,1050316.2877413302,901.1594571057317,1051217.447198436,1168,0,333.8989361702128,82,106,42,38.4147685525349,0.5483156028368794,43.78765060240965,8198.795180722918,99.9853070819868,0
1195,32,1,1,186,0.0053475935828877,0.0053475935828877,0.9946524064171123,187,5650,4100,1550,0.7256637168141593,72,41,31,209.91291623787023,0.46763651697238034,0.7663584814957003,0.12348956844297487,1051967.6906179104,1114.3211451244833,1053082.0117630349,1169,0,336.63101604278074,69,118,43,38.20385497069236,0.5497994652406417,43.58630952380951,8205.238095238068,118.91649413388504,0
1196,32,1,1,186,0.0053475935828877,0.0053475935828877,0.9946524064171123,187,5900,4100,1800,0.6949152542372882,77,41,36,206.53290228457735,0.46739812738389586,0.7609672274986685,0.12201094671899557,1053246.077160492,205.99382716039963,1053452.0709876525,1170,0,337.5882352941176,74,113,43,38.13155235569026,0.5515819964349375,43.43055555555555,8210.222222222208,110.94894894894875,0
1197,32,1,2,185,0.0053475935828877,0.0106951871657754,0.9893048128342246,187,5100,3500,1600,0.6862745098039216,67,35,32,204.81287177584005,0.46794079313054643,0.7592754954253829,0.12151884387815168,1054562.3443030512,697.5884406738455,1055259.9327437251,1171,0,337.19251336898395,75,112,43,38.01213006958163,0.5531417112299466,43.27028508771929,8215.350877192954,109.53801169590605,0
1198,32,0,2,183,0.0,0.010810810810810811,0.9891891891891892,185,5100,3400,1700,0.6666666666666666,68,34,34,202.52059013473232,0.46788826870348604,0.7542715394156172,0.12056022424157756,1055575.994536774,655.1746691286417,1056231.1692059026,1172,1,339.5567567567568,75,110,46,37.945126289576656,0.5550112612612612,43.14692982456138,8219.298245613983,109.59064327485311,0
1199,32,0,0,183,0.0,0.0,1.0,183,6600,4800,1800,0.7272727272727273,84,48,36,206.9541981537849,0.4674633199223363,0.7560303843657361,0.12385312501165482,1057180.1063744982,557.5722437730851,1057737.6786182714,1173,2,343.27322404371586,76,107,36,37.63212023928562,0.5569785974499089,42.9518398268398,8225.541125541065,108.23080428343508,0
1200,32,2,1,184,0.010810810810810811,0.005405405405405406,0.9945945945945946,185,5100,3700,1400,0.7254901960784313,65,37,28,204.27944780559625,0.46762999412455936,0.7563283512268801,0.12302217644592323,1059076.8256293305,1169.525824652294,1060246.3514539828,1174,0,340.55135135135134,79,106,41,37.4656801963662,0.5590653153153153,42.721354166666636,8232.91666666659,104.21413502109607,0
1201,32,1,1,184,0.005405405405405406,0.005405405405405406,0.9945945945945946,185,4950,3200,1750,0.6464646464646465,67,32,35,201.97733865232516,0.46729827653740696,0.7532349519988577,0.12235509439530567,1060852.3153506503,903.6254715362197,1061755.9408221866,1175,0,341.5243243243243,71,114,41,37.3049874517736,0.5606418918918918,42.50578703703703,8239.814814814805,116.05372978612401,0
1202,32,1,0,185,0.005405405405405406,0.0,1.0,185,4450,3600,850,0.8089887640449438,53,36,17,202.9363741357831,0.4670277614571093,0.7554539753243852,0.12350596925412335,1062240.834349785,1663.4606763829593,1063904.295026168,1176,0,342.4864864864865,72,113,43,37.10841594210925,0.5621058558558558,42.33732876712329,8245.20547945206,114.51674277016751,0
1203,32,0,2,183,0.0,0.010810810810810811,0.9891891891891892,185,6350,4500,1850,0.7086614173228346,82,45,37,224.03282475178935,0.466853946337642,0.7769745342952503,0.13549937111493787,1060371.8606180162,4161.62064431307,1064533.4812623293,1177,1,343.4864864864865,64,121,41,36.796693434594914,0.5616554054054055,42.56410256410257,8237.948717948731,128.71794871794893,8
1204,32,3,2,184,0.016129032258064516,0.010752688172043012,0.989247311827957,186,5700,4300,1400,0.7543859649122807,71,43,28,215.75234261156646,0.46665697956020535,0.7685468178899244,0.1316384841084819,1062999.1855281217,2968.9128943759124,1065968.0984224975,1178,0,342.5967741935484,71,115,43,36.684253854213445,0.5642921146953406,42.245370370370374,8248.148148148155,116.17110067814303,0
1205,32,3,2,185,0.016042780748663103,0.0106951871657754,0.9893048128342246,187,5450,3800,1650,0.6972477064220184,71,38,33,217.54609332229683,0.4663702968968624,0.7718426752851246,0.13301560308077773,1063635.711972253,3427.9587715283287,1067063.6707437814,1179,0,340.3529411764706,80,107,39,36.559180008978,0.5685717468805704,42.16820987654319,8250.61728395056,103.132716049382,7
1206,32,1,0,186,0.005376344086021506,0.0,1.0,186,6450,4900,1550,0.7596899224806202,80,49,31,218.44807672625493,0.46645294488036426,0.7784985709545438,0.1263577893047617,1046778.7613789117,2083.361436222813,1048862.1228151345,1180,0,343.0752688172043,70,116,41,38.63200738021491,0.545866935483871,44.219483568075105,8184.976525821569,116.92823608316527,8
1207,32,0,1,185,0.0,0.005376344086021506,0.9946236559139785,186,5350,3800,1550,0.7102803738317757,69,38,31,217.37249364378326,0.4665625302722077,0.7774251907617329,0.12614451009091968,1047779.7067901215,3001.6975308640694,1050781.4043209855,1181,1,344.0752688172043,71,115,38,38.53459972862956,0.5472670250896057,44.097222222222214,8188.888888888874,115.33646322378696,0
1208,32,3,0,188,0.015957446808510637,0.0,1.0,188,5650,3500,2150,0.6194690265486725,78,35,43,215.6968544393477,0.4671813962528919,0.7791200392730036,0.12656427735871897,1051176.1475315078,2097.0776968435994,1053273.2252283513,1182,0,340.6755319148936,61,127,41,38.154114228281756,0.550144060283688,43.682795698924735,8202.150537634418,134.46148422351504,0
1209,32,2,1,189,0.010526315789473684,0.005263157894736842,0.9947368421052631,190,5800,3600,2200,0.6206896551724138,80,36,44,220.9079503965198,0.4676274018379281,0.7850309765235861,0.12645992884610677,1043563.3383856865,2306.287638346254,1045869.6260240327,1183,0,338.07894736842104,63,127,40,38.97092016654984,0.5371710526315789,44.61263020833333,8172.395833333321,129.7205687830686,8
1210,32,1,1,189,0.005263157894736842,0.005263157894736842,0.9947368421052631,190,5800,3800,2000,0.6551724137931034,78,38,40,229.67235700457084,0.46800450199573,0.7881818997853829,0.13058861109848455,1041454.6975422354,4038.6710196013837,1045493.3685618368,1184,0,338.88947368421054,78,112,36,39.01116767447067,0.5385964912280702,44.87078059071729,8164.13502109702,104.66839770637206,8
1211,32,0,0,189,0.0,0.0,1.0,189,5400,4000,1400,0.7407407407407407,68,40,28,229.2931160839446,0.46778021689369204,0.7872471299153136,0.13059855705381526,1041993.0143851538,4584.365041214631,1046577.3794263684,1185,1,338.7936507936508,78,111,36,38.95340325858563,0.5399029982363316,44.80485232067509,8166.244725738355,104.69544520177378,0
1212,32,1,1,189,0.005263157894736842,0.005263157894736842,0.9947368421052631,190,6300,4900,1400,0.7777777777777778,77,49,28,223.5663218113955,0.46831198366286086,0.7852025546594557,0.12891030506898196,1045802.6478155894,2461.250262550154,1048263.8980781396,1186,0,338.0052631578947,68,122,36,38.62304399173311,0.5408991228070175,44.338768115942045,8181.159420289891,120.31116794543958,8
1213,32,3,1,191,0.015625,0.005208333333333333,0.9947916666666666,192,6250,4200,2050,0.672,83,42,41,195.82550961308374,0.46854207569808026,0.7515373373042145,0.11165748868881889,1042330.6245434644,-3827.0148526903413,1038503.609690774,1187,0,335.4479166666667,73,119,40,39.76533200970665,0.5389539930555556,44.76351351351352,8167.567567567583,111.8844872269532,8
1214,32,5,1,195,0.025510204081632654,0.00510204081632653,0.9948979591836735,196,6350,4900,1450,0.7716535433070866,78,49,29,192.95984812338594,0.4694111939647654,0.7528276560972444,0.11140429695316584,1046196.6593005087,-5175.210302835809,1041021.4489976729,1188,0,328.76020408163265,78,118,41,39.35644734354323,0.5423575680272108,44.29061181434601,8182.700421940966,104.90641566590982,0
1215,32,2,3,194,0.01015228426395939,0.015228426395939087,0.9847715736040609,197,6450,4500,1950,0.6976744186046512,84,45,39,195.66948474074792,0.4691492713836804,0.7576652942601116,0.11388769417741076,1048693.8445806613,-4810.523156021402,1043883.3214246399,1189,0,328.07106598984774,83,114,37,38.976194801001064,0.5445219966159052,43.9856150793651,8192.460317460358,98.70434117422118,0
1216,32,2,3,193,0.01020408163265306,0.015306122448979591,0.9846938775510204,196,6300,4400,1900,0.6984126984126984,82,44,38,223.52373917484738,0.46883176347462063,0.7896797580661319,0.12584016034208237,1038360.9999999979,919.6666666665633,1039280.6666666644,1190,0,330.69897959183675,74,122,36,39.55573274452078,0.5316751700680272,45.24999999999999,8151.999999999984,110.16216216216193,7
1217,32,3,2,194,0.015306122448979591,0.01020408163265306,0.9897959183673469,196,5450,3800,1650,0.6972477064220184,71,38,33,217.3583635774016,0.4690808695272981,0.783807420794735,0.12317802204562056,1040420.9877601571,578.8406662258758,1040999.828426383,1191,0,328.5204081632653,80,116,35,39.45473380738646,0.5339604591836735,44.99742798353907,8160.082304526684,102.00102880658355,0
1218,32,5,3,196,0.02512562814070352,0.01507537688442211,0.9849246231155779,199,5900,4100,1800,0.6949152542372882,77,41,36,209.18883283635856,0.4698936602202934,0.7826061676753535,0.11948138518281208,1042862.64959407,-2068.9559045567435,1040793.6936895133,1192,0,323.99497487437185,66,133,41,39.357758358199874,0.535751675041876,44.69838308457712,8169.651741293537,123.78260214081116,8
1219,32,3,1,198,0.01507537688442211,0.005025125628140704,0.9949748743718593,199,6100,4100,2000,0.6721311475409836,81,41,40,220.98481379096378,0.4697117743600156,0.7857973004997867,0.1287687628736288,1049043.8052507278,464.54999237931725,1049508.355243107,1193,0,324.79396984924625,80,119,39,38.28442820551456,0.5419807370184255,43.94290123456791,8193.827160493856,102.4228395061732,8
1220,32,3,6,195,0.014925373134328358,0.029850746268656716,0.9701492537313433,201,6800,4700,2100,0.6911764705882353,89,47,42,221.07312522806356,0.4697636815920398,0.786274137407829,0.1300718117115127,1052007.1944985043,-485.89634996192854,1051521.2981485424,1194,0,322.547263681592,67,134,41,37.91277107354078,0.5446724709784412,43.58149509803919,8205.392156862697,122.46853965466713,0
1221,32,1,1,195,0.00510204081632653,0.00510204081632653,0.9948979591836735,196,7350,5700,1650,0.7755102040816326,90,57,33,218.21026775491055,0.46894187162044304,0.7777540134161178,0.1291957599714698,1053922.225765298,-554.6697845809595,1053367.5559807168,1195,0,330.2908163265306,69,127,41,37.7478087976653,0.5469812925170068,43.348214285714256,8212.857142857078,119.02691511387069,0
1222,32,0,1,194,0.0,0.005128205128205128,0.9948717948717949,195,6650,4600,2050,0.6917293233082706,87,46,41,217.51563862968794,0.4687979117102829,0.7758584118501859,0.12932723296786797,1055201.569353516,254.5686481954067,1055456.1380017113,1196,1,331.04102564102567,70,125,42,37.6065232708714,0.5482371794871794,43.19248826291077,8217.840375586797,117.39771965123995,0
1223,32,1,1,194,0.005128205128205128,0.005128205128205128,0.9948717948717949,195,5850,3700,2150,0.6324786324786325,80,37,43,217.56942657051033,0.46869768261520833,0.7759469885929038,0.1300356805316762,1056783.9999999916,1134.7777777773135,1057918.777777769,1197,0,331.96923076923076,74,121,35,37.40846573713787,0.5501602564102563,42.99999999999997,8223.999999999935,111.13513513513425,0
1224,32,0,3,191,0.0,0.015463917525773196,0.9845360824742269,194,7200,5200,2000,0.7222222222222222,92,52,40,210.9944452142382,0.46805447981767356,0.7707039801141795,0.12496462997141629,1054022.507236654,-1521.4211684561546,1052501.0860681979,1198,3,334.680412371134,77,117,39,37.9205365350261,0.5511705326460481,43.33600427350429,8213.247863247894,106.66555666555706,8
1225,32,1,1,191,0.005208333333333333,0.005208333333333333,0.9947916666666666,192,5950,4000,1950,0.6722689075630253,79,40,39,212.3128483704115,0.4677438963423502,0.7704453620993541,0.12635630838396764,1055496.139440799,469.07836172997577,1055965.217802529,1199,0,338.9010416666667,78,114,40,37.703531153207756,0.5533311631944444,43.15664556962027,8218.987341772185,105.37163258682288,0
1226,32,3,0,194,0.015463917525773196,0.0,1.0,194,5550,3000,2550,0.5405405405405406,81,30,51,208.35252882957698,0.4677300892046365,0.7710600846456344,0.12510093898393937,1058175.2811418704,-255.3008458284903,1057919.9802960418,1200,0,336.2474226804124,84,110,37,37.472698753077566,0.5560567010309279,42.83088235294118,8229.411764705897,97.9691876750702,0
1227,32,0,0,194,0.0,0.0,1.0,194,5800,3900,1900,0.6724137931034483,77,39,38,213.66880018937775,0.4677261942916155,0.7797662105968564,0.1264822846698022,1053862.9707746638,435.5273058870389,1054298.498080551,1201,1,337.2474226804124,65,129,40,37.87173554311953,0.5496670962199313,43.35542929292929,8212.626262626247,126.3480963480961,8
1228,32,1,4,191,0.005128205128205128,0.020512820512820513,0.9794871794871794,195,7050,4600,2450,0.6524822695035462,95,46,49,213.90576628802137,0.4675279760331306,0.7810206883057722,0.12768880155570378,1056411.1309352193,-855.5135044212448,1055555.617430798,1202,0,336.5128205128205,67,128,37,37.5489348595048,0.5517628205128204,43.04534313725491,8222.54901960786,122.72461223295315,0
1229,32,0,1,190,0.0,0.005235602094240838,0.9947643979057592,191,6400,4900,1500,0.765625,79,49,30,216.13797455334833,0.4666379627078167,0.7796676434626899,0.12972847986405014,1058065.66372611,1137.6339004412453,1059203.2976265512,1203,1,343.39267015706804,68,123,39,37.286089585534825,0.5541012216404886,42.84420289855073,8228.985507246394,121.01449275362344,0
1230,32,1,1,190,0.005235602094240838,0.005235602094240838,0.9947643979057592,191,5300,3400,1900,0.6415094339622641,72,34,38,220.12477365911516,0.4667734453935887,0.7796106515602481,0.12882905654097765,1050384.403447284,2743.125812779394,1053127.5292600633,1204,0,344.17277486910996,70,121,42,38.13929130401587,0.5416121291448517,43.77934272300468,8199.06103286382,117.12944332662599,8
1231,32,2,1,191,0.010416666666666666,0.005208333333333333,0.9947916666666666,192,6800,5100,1700,0.75,85,51,34,217.68676923387278,0.4675564236111111,0.7776990239223653,0.12809695544160507,1052049.093364193,603.4336419749843,1052652.5270061682,1205,0,337.296875,65,127,43,37.99438614308279,0.54443359375,43.57638888888887,8205.55555555552,126.2393162393157,0
1232,32,2,0,193,0.010362694300518135,0.0,1.0,193,6550,4600,1950,0.7022900763358778,85,46,39,209.67931999977498,0.4680191242084053,0.7704861037074955,0.1242733530730367,1054237.254512987,-939.6498710577034,1053297.6046419295,1206,0,335.95854922279796,70,123,42,37.92759773662551,0.5471718480138169,43.309859154929555,8214.084507042202,117.34406438631717,0
1233,32,1,2,192,0.005154639175257732,0.010309278350515464,0.9896907216494846,194,6600,4700,1900,0.7121212121212122,85,47,38,211.1893375196547,0.4676265958015063,0.7736631264071914,0.125902411678935,1056014.3137132174,-796.2073351268673,1055218.1063780906,1207,0,335.2216494845361,72,122,39,37.66801821817373,0.5491838487972509,43.09360730593605,8221.004566209984,114.18061897513866,0
1234,32,1,2,191,0.0051813471502590676,0.010362694300518135,0.9896373056994818,193,6200,4500,1700,0.7258064516129032,79,45,34,215.55702009409876,0.4672398981721359,0.7782635270765788,0.1294060165268431,1058126.9286503561,817.3375242381167,1058944.2661745942,1208,0,337.8860103626943,72,121,42,37.29342377834497,0.551543609671848,42.83675799086756,8229.223744292194,114.29477422628048,0
1235,32,0,2,189,0.0,0.010471204188481676,0.9895287958115183,191,5950,4400,1550,0.7394957983193278,75,44,31,238.88336365884697,0.4667125930008267,0.7957727807749984,0.14032589181940622,1051517.6024417728,6088.012363555513,1057605.6148053284,1209,1,341.34031413612564,66,125,34,37.51718317262012,0.5476112565445026,43.64116915422886,8203.48258706469,124.29519071310135,8
1236,32,0,0,189,0.0,0.0,1.0,189,5500,3900,1600,0.7090909090909091,71,39,32,234.23154083297263,0.46578436339074636,0.7897674013035989,0.13808445103234587,1052606.609839204,6010.733622721714,1058617.3434619256,1210,2,345.9100529100529,68,121,35,37.500613105748485,0.5489969135802469,43.5084541062802,8207.729468599042,120.7019039499859,0
1237,32,1,0,190,0.005263157894736842,0.0,1.0,190,6350,4500,1850,0.7086614173228346,82,45,37,228.452766472039,0.4661944212382809,0.7862555050176896,0.13540005427489124,1054237.2545129925,3818.683462275932,1058055.9379752683,1211,0,345.0842105263158,70,120,40,37.44570187471423,0.5508771929824561,43.309859154929576,8214.084507042246,117.3440643863178,0
1238,32,1,2,189,0.005235602094240838,0.010471204188481676,0.9895287958115183,191,6000,4500,1500,0.75,75,45,30,224.04292868000778,0.46640603472030867,0.7816291087586995,0.13345165751809143,1055756.2499999981,3106.944444444311,1058863.1944444424,1212,0,344.27225130890054,74,117,34,37.3698972695323,0.5525741710296684,43.12499999999999,8219.999999999985,111.08108108108088,0
1239,32,4,2,191,0.02072538860103627,0.010362694300518135,0.9896373056994818,193,5000,3200,1800,0.64,68,32,36,208.24566820868083,0.4662504047927461,0.7665399884397472,0.12225245698368403,1051327.1720773093,186.86589103631468,1051514.0379683457,1213,0,341.4974093264249,72,121,39,38.32630538855488,0.5428000863557858,43.664383561643824,8202.73972602737,113.92694063926903,8
1240,32,0,3,188,0.0,0.015706806282722512,0.9842931937172775,191,5550,4000,1550,0.7207207207207207,71,40,31,210.20970767784772,0.4658399926517865,0.7640044986723917,0.12413662788443747,1053132.049382716,525.7160493827096,1053657.7654320986,1214,1,338.9947643979058,74,117,39,38.051397610798304,0.5449934554973822,43.44444444444444,8209.777777777777,110.94294294294293,0
1241,32,0,3,185,0.0,0.015957446808510637,0.9840425531914894,188,6000,3700,2300,0.6166666666666667,83,37,46,206.4192817086276,0.46543323567337963,0.7580056967761442,0.12260807937632866,1054900.173611104,-49.65277777824576,1054850.5208333258,1215,2,340.22340425531917,73,115,39,37.928921568627445,0.547373670212766,43.22916666666664,8216.66666666661,112.55707762557,0
1242,32,0,1,184,0.0,0.005405405405405406,0.9945945945945946,185,5250,3300,1950,0.6285714285714286,72,33,39,212.7278135369911,0.46478040540540544,0.7600250436537319,0.1266726222785101,1055662.4164685837,2663.7515377074396,1058326.1680062911,1216,3,346.3027027027027,72,113,44,37.67221265485253,0.5490427927927928,43.13641552511414,8219.634703196305,114.16159309994867,0
1243,32,0,0,184,0.0,0.0,1.0,184,6200,4600,1600,0.7419354838709677,78,46,32,214.77526591816437,0.4641820355191257,0.7636732516486602,0.12843732037576233,1056952.9930568552,2401.4720293569385,1059354.4650862121,1217,4,349.1576086956522,72,112,39,37.45928640165812,0.5504415760869565,42.97945205479451,8224.657534246546,114.23135464231314,0
1244,32,1,0,185,0.005405405405405406,0.0,1.0,185,5900,4100,1800,0.6949152542372882,77,41,36,228.45695107438266,0.46457843713278496,0.772781284037652,0.1335747849059348,1050084.4577302511,5079.818716730293,1055164.2764469814,1218,0,348.2648648648649,78,107,37,37.96322507591748,0.5492680180180181,43.81592827004222,8197.890295358717,105.10115763280406,8
1245,32,5,0,190,0.02631578947368421,0.0,1.0,190,5800,4200,1600,0.7241379310344828,74,42,32,219.47729234540998,0.46555277081592866,0.7721503450200635,0.13004680473983665,1054158.5216049333,2472.771604938057,1056631.2932098713,1219,0,340.0736842105263,74,116,40,37.68588911133959,0.5527412280701754,43.31944444444443,8213.77777777774,110.99699699699647,0
1246,32,2,2,190,0.010416666666666666,0.010416666666666666,0.9895833333333334,192,5650,4200,1450,0.7433628318584071,71,42,29,204.26902365990168,0.4660009680410122,0.7616831778018227,0.12121710761968706,1054614.8919752992,-964.969135802975,1053649.9228394963,1220,0,337.5208333333333,74,118,43,38.01956541339823,0.5507269965277778,43.26388888888886,8215.555555555482,111.02102102102003,8
1247,32,2,4,188,0.010416666666666666,0.020833333333333332,0.9791666666666666,192,5900,3900,2000,0.6610169491525424,79,39,40,207.018330159119,0.4664577197862129,0.758707694523773,0.12264407395802548,1054107.8198826453,-656.0718640448276,1053451.7480186005,1221,0,334.4479166666667,80,112,41,38.011987073500656,0.5519205729166667,43.325617283950635,8213.580246913623,102.66975308642029,8
1248,32,0,1,187,0.0,0.005319148936170213,0.9946808510638298,188,6500,4300,2200,0.6615384615384615,87,43,44,206.82071887770525,0.4657473119808852,0.7547909169349916,0.12314237148725635,1055630.9488399827,-434.7296582717954,1055196.2191817109,1222,1,341.48936170212767,81,107,43,37.82785196175409,0.5535793439716312,43.140243902439046,8219.512195122003,101.47545919903708,0
1249,32,2,3,186,0.010582010582010581,0.015873015873015872,0.9841269841269842,189,5500,4100,1400,0.7454545454545455,69,41,28,210.23004460487607,0.4657949172576832,0.76209714354094,0.12618062040437933,1058061.2269502687,1187.2517872888238,1059248.4787375575,1223,0,340.6507936507937,83,106,38,37.438565928855,0.5555555555555556,42.844742063492056,8228.968253968236,99.1441958309426,0
1250,32,4,1,189,0.021052631578947368,0.005263157894736842,0.9947368421052631,190,5400,3200,2200,0.5925925925925926,76,32,44,206.25207233980373,0.4662820245057087,0.7600910789218158,0.12486939637607042,1060671.1234567885,353.12345679005375,1061024.2469135786,1224,0,339.4,74,116,42,37.217359837451,0.5580592105263158,42.52777777777777,8239.111111111099,111.33933933933918,0
1251,32,1,1,189,0.005263157894736842,0.005263157894736842,0.9947368421052631,190,6400,4800,1600,0.75,80,48,32,206.17615310658653,0.46572797735078436,0.7603390860980228,0.12541120523522634,1062081.9307406151,-604.8066471768407,1061477.1240934383,1225,0,340.37368421052633,76,114,43,37.044609258773065,0.5596491228070175,42.35660173160173,8244.588744588738,108.48143084985182,0
1252,32,3,1,191,0.015625,0.005208333333333333,0.9947916666666666,192,6600,4800,1800,0.7272727272727273,84,48,36,205.63277767572598,0.46634580424665506,0.7643651579707993,0.12653888223301984,1065546.4344231011,-1177.745389422611,1064368.6890336785,1226,0,337.125,80,112,37,36.63010165944088,0.5629340277777778,41.936728395061714,8258.024691357985,103.2253086419748,0
1253,32,2,0,193,0.010362694300518135,0.0,1.0,193,6250,4800,1450,0.768,77,48,29,201.45220884776606,0.46678900402993667,0.7609568541106662,0.12485721399904201,1067675.2670107349,-1832.891825711975,1065842.3751850228,1227,0,336.30051813471505,83,110,40,36.47513521514411,0.5647128670120898,41.67906746031745,8266.269841269806,99.59361254541936,0
1254,32,0,5,188,0.0,0.025906735751295335,0.9740932642487047,193,6600,5000,1600,0.7575757575757576,82,50,32,216.14304388727027,0.46656636801957396,0.7745776062690517,0.13214165061365077,1063599.333900232,777.9195011341235,1064377.2534013663,1228,1,337.30051813471505,69,124,44,36.599859555965985,0.5595315198618307,42.172619047619065,8250.47619047623,119.57211870255406,8
1255,32,3,3,188,0.015706806282722512,0.015706806282722512,0.9842931937172775,191,6150,4500,1650,0.7317073170731707,78,45,33,211.9214042742519,0.4657848810507945,0.7670272716759208,0.1305199512048514,1065800.4657951922,823.1862774939764,1066623.6520726862,1229,0,335.24607329842934,73,118,38,36.436403508771946,0.56228184991274,41.90596846846849,8259.009009009049,113.13710971245273,0
1256,32,0,3,185,0.0,0.015957446808510637,0.9840425531914894,188,6050,4000,2050,0.6611570247933884,81,40,41,213.34664907193232,0.4647084897788903,0.7719427954804805,0.12868977945276078,1059562.431666906,1560.8188557284661,1061123.2505226345,1230,1,341.5691489361702,67,121,37,37.17216550588328,0.5586214539007093,42.66237745098039,8234.80392156862,122.9075212174421,8
1257,32,0,1,184,0.0,0.005405405405405406,0.9945945945945946,185,6000,4300,1700,0.7166666666666667,77,43,34,213.28093116127297,0.464094937328633,0.7674813274813272,0.12916081234921808,1060754.9345367984,2247.760034384763,1063002.694571183,1231,2,347.52972972972975,70,115,37,37.025997150997135,0.5606418918918918,42.517605633802816,8239.436619718312,117.70623742454731,0
1258,32,1,1,184,0.005405405405405406,0.005405405405405406,0.9945945945945946,185,6100,4100,2000,0.6721311475409836,81,41,40,213.51661109640116,0.46407780062671367,0.765970560622413,0.12830316421546198,1058414.491676702,2097.815079625444,1060512.3067563274,1232,0,348.4864864864865,77,108,38,37.3102077816432,0.5585022522522523,42.80181623931621,8230.341880341808,106.88755688755595,8
1259,32,2,2,184,0.010752688172043012,0.010752688172043012,0.989247311827957,186,5200,3700,1500,0.7115384615384616,67,37,30,213.84025623864576,0.4641207739998063,0.7670867081115846,0.1296149083786258,1061022.6225907037,2977.869897959221,1064000.492488663,1233,0,342.2204301075269,69,117,39,36.978414234806934,0.561211917562724,42.48511904761905,8240.476190476196,119.42719116632169,0
1260,32,1,0,185,0.005405405405405406,0.0,1.0,185,5350,3200,2150,0.5981308411214953,75,32,43,212.91367076761458,0.46389174500587543,0.765657967411256,0.12982486825319955,1062810.9536522718,2907.3962948267254,1065718.3499470984,1234,0,344.86486486486484,70,115,41,36.78072996717331,0.5635698198198198,42.268192488262905,8247.417840375572,117.82025486250818,0
1261,32,0,3,182,0.0,0.016216216216216217,0.9837837837837837,185,5200,3500,1700,0.6730769230769231,69,35,34,215.67771366047614,0.46365427927927927,0.7687638483337405,0.13204344036956392,1064021.3065363988,3697.136535960462,1067718.4430723593,1235,1,345.86486486486484,70,115,44,36.559613889362964,0.564695945945946,42.121478873239425,8252.112676056317,117.88732394366167,0
1262,32,0,0,182,0.0,0.0,1.0,182,6200,4400,1800,0.7096774193548387,80,44,36,213.76725616747794,0.46355969076963555,0.7642095455016034,0.1312636953160627,1064909.336419751,2928.5493827159,1067837.885802467,1236,2,349.532967032967,71,111,36,36.498990578734826,0.5669642857142857,42.01388888888888,8255.555555555538,116.27543035993716,0
1263,32,1,2,181,0.00546448087431694,0.01092896174863388,0.9890710382513661,183,6100,4800,1300,0.7868852459016393,74,48,26,213.7597398210546,0.4637002341920375,0.7652455070500912,0.13182550555958547,1066192.1095914121,2881.78958910431,1069073.8991805164,1237,0,348.6174863387978,75,108,37,36.34052776892856,0.5685336976320583,41.858552631578945,8260.52631578947,110.14035087719293,0
1264,32,0,1,180,0.0,0.0055248618784530384,0.994475138121547,181,5900,4300,1600,0.7288135593220338,75,43,32,212.82138728557928,0.4631113157356251,0.7630742020199366,0.13185109778596016,1067556.991471254,3339.7919862663703,1070896.7834575204,1238,1,352.7292817679558,77,104,40,36.19605866335781,0.5705570902394107,41.69337606837607,8265.811965811965,107.34820734820734,0
1265,32,0,1,179,0.0,0.005555555555555556,0.9944444444444445,180,6800,5000,1800,0.7352941176470589,86,50,36,215.28852194096686,0.46275217256362505,0.7648624529929733,0.13387882984393878,1068664.3996599887,3214.235810746015,1071878.6354707347,1239,2,355.52222222222224,67,113,39,35.995507577104725,0.572337962962963,41.559436274509814,8270.098039215703,123.4342990927717,0
1266,32,0,2,177,0.0,0.0111731843575419,0.9888268156424581,179,5750,4000,1750,0.6956521739130435,75,40,35,216.9650821145051,0.4622211934802168,0.7660291763384841,0.13521058810060577,1069297.9262783588,4850.062475971052,1074147.9887543297,1240,3,358.46927374301674,67,112,40,35.873923520581485,0.5733822160148976,41.48284313725492,8272.549019607877,123.47088088966981,0
1267,32,0,1,176,0.0,0.005649717514124294,0.9943502824858758,177,6200,4500,1700,0.7258064516129032,79,45,34,218.0384175283972,0.46193262069851054,0.7592482587902487,0.13340105986256456,1063824.9863038727,4790.943308173092,1068615.9296120456,1241,4,363.0960451977401,73,104,41,36.52304654802198,0.5661487758945386,42.145270270270274,8251.35135135136,113.0322102924844,8
1268,32,2,0,178,0.011235955056179775,0.0,1.0,178,4850,3800,1050,0.7835051546391752,59,38,21,216.20025889106643,0.4621586629001883,0.7608922650145005,0.12678979963782372,1051007.4974938722,4995.618610925389,1056003.1161047975,1242,0,361.9550561797753,66,112,41,38.16221817814173,0.5459386704119851,43.703358208955216,8201.49253731342,124.26503844414272,8
1269,32,2,0,180,0.011111111111111112,0.0,1.0,180,6300,4500,1800,0.7142857142857143,81,45,36,242.2098733628173,0.46245344506517694,0.7800940278894122,0.13923470542024927,1044858.2870462216,8314.99867751113,1053173.2857237328,1243,0,358.9222222222222,70,110,35,38.264654380525904,0.5396990740740741,44.45422535211268,8177.464788732399,116.82092555331998,8
1270,32,1,0,181,0.0055248618784530384,0.0,1.0,181,6600,5000,1600,0.7575757575757576,82,50,32,227.1246851094086,0.4623618784530387,0.7638365471879873,0.13074055614852892,1045279.0401234634,4681.734567901603,1049960.774691365,1244,0,357.9337016574586,74,107,38,38.597533916571585,0.5424723756906078,44.4027777777778,8179.111111111163,110.52852852852924,8
1271,32,0,1,180,0.0,0.0055248618784530384,0.994475138121547,181,5650,4000,1650,0.7079646017699115,73,40,33,225.1940219262398,0.46201785348884794,0.7631735886847226,0.13008266443033437,1046358.506944449,5276.736111111321,1051635.2430555604,1245,1,358.9337016574586,77,104,40,38.511965376782115,0.5438535911602209,44.27083333333335,8183.333333333369,106.27705627705674,0
1272,32,1,0,181,0.0055248618784530384,0.0,1.0,181,5250,3700,1550,0.7047619047619048,68,37,31,224.52036885957958,0.46217387968078577,0.7611500237149298,0.13018736407375694,1047530.9271918462,5588.406032986423,1053119.3332248325,1246,0,359.91160220994476,79,102,35,38.38274769731823,0.545695211786372,44.127604166666686,8187.916666666713,103.64451476793307,0
1273,32,1,2,180,0.005494505494505495,0.01098901098901099,0.989010989010989,182,5600,3800,1800,0.6785714285714286,74,38,36,228.61727898761202,0.46257374071600593,0.7675915214857547,0.1332697255590608,1049167.1727311886,5971.548846586481,1055138.721577775,1247,0,358.92857142857144,81,101,37,38.07359361047724,0.5479052197802198,43.927845528455315,8194.30894308951,101.16430793937667,0
1274,32,1,1,180,0.0055248618784530384,0.0055248618784530384,0.994475138121547,181,6150,5000,1150,0.8130081300813008,73,50,23,229.67429779147378,0.4623695518723143,0.7657685668982106,0.1345763488602373,1050745.3086083014,5915.838182459421,1056661.1467907608,1248,0,361.72375690607737,70,111,39,37.84958779412609,0.5502992633517496,43.735328638497656,8200.46948356808,117.14956405097257,0
1275,32,0,0,180,0.0,0.0,1.0,180,6000,4000,2000,0.6666666666666666,80,40,40,230.69642514683164,0.4618605162424995,0.7669634183791787,0.1360165254881333,1052642.750262557,6568.183888460089,1059210.934151017,1249,1,364.7,71,109,39,37.586781074322666,0.5521412037037037,43.50405092592592,8207.870370370347,115.60380803338516,0
1276,32,2,0,182,0.01098901098901099,0.0,1.0,182,6150,4700,1450,0.7642276422764228,76,47,29,226.33296166616566,0.46204819581891404,0.7633127521565646,0.13443632542339745,1054900.1736111126,5201.736111111173,1060101.9097222239,1250,0,361.68131868131866,77,105,40,37.41759634888436,0.5543727106227105,43.22916666666667,8216.666666666679,106.70995670995687,0
1277,32,0,0,182,0.0,0.0,1.0,182,5250,3700,1550,0.7047619047619048,68,37,31,225.8668014696369,0.4621108058608059,0.7614730406878216,0.13471119151012784,1056146.4759253324,6059.685280136786,1062206.1612054692,1251,1,362.68131868131866,78,104,37,37.27450603027972,0.5559180402930404,43.07753164556962,8221.518987341771,105.40408958130476,0
1278,32,3,1,184,0.016216216216216217,0.005405405405405406,0.9945945945945946,185,5650,4200,1450,0.7433628318584071,71,42,29,222.10902271726687,0.4626909518213866,0.7632511555224404,0.13353254387182123,1058564.138582443,4373.329260818419,1062937.4678432613,1252,0,357.7837837837838,82,103,42,37.07062698219077,0.5583896396396396,42.78363453815261,8230.923694779121,100.37711822901367,0
1279,32,2,2,184,0.010752688172043012,0.010752688172043012,0.989247311827957,186,5650,3800,1850,0.672566371681416,75,38,37,194.0979827589916,0.4633003971713649,0.7435946372383715,0.11784142154227957,1061514.698068542,-1642.4276871756479,1059872.2703813664,1253,0,356.83870967741933,80,106,40,37.425940719290324,0.5651881720430108,42.42541152263371,8242.386831275631,103.0298353909454,8
1280,32,2,1,185,0.010752688172043012,0.005376344086021506,0.9946236559139785,186,5950,4200,1750,0.7058823529411765,77,42,35,186.44551750061558,0.4631096822629081,0.7336588781225739,0.1140352816340965,1063729.3348711939,-3484.4867358712386,1060244.8481353226,1254,0,357.7903225806452,84,102,43,37.349493029150814,0.567372311827957,42.15686274509801,8250.980392156787,98.22595704948556,0
1281,32,2,1,186,0.0106951871657754,0.0053475935828877,0.9946524064171123,187,5550,4000,1550,0.7207207207207207,71,40,31,183.1226885348124,0.46288789220478027,0.7301342115267717,0.11262676802437524,1065387.142061032,-3930.6884430731875,1061456.4536179588,1255,0,356.85561497326205,89,98,36,37.23064775360694,0.5691844919786097,41.95601851851849,8257.407407407323,92.77985851019464,0
1282,32,2,0,188,0.010638297872340425,0.0,1.0,188,6650,4500,2150,0.6766917293233082,88,45,43,183.8507070375322,0.4627784019797474,0.7338626028024284,0.11370337718501378,1067037.165504033,-5014.89253735211,1062022.2729666808,1256,0,355.92021276595744,92,96,39,37.00844321073323,0.5710882092198581,41.75627240143367,8263.799283154063,89.8239052516746,0
1283,32,2,4,186,0.010526315789473684,0.021052631578947368,0.9789473684210527,190,5700,4200,1500,0.7368421052631579,72,42,30,177.52984770851222,0.4629101689408707,0.7278150045646274,0.11065574060385726,1069353.5619712165,-5731.564999338929,1063621.9969718775,1257,0,353.16315789473686,81,109,40,36.88654734411087,0.5730811403508772,41.47611788617887,8272.764227642294,102.13289169928758,0
1284,32,1,1,186,0.0053475935828877,0.0053475935828877,0.9946524064171123,187,5300,3600,1700,0.6792452830188679,70,36,34,177.7488315106515,0.4617402679546892,0.7239232061255405,0.1111636395447575,1070342.1462624422,-4649.586837049604,1065692.5594253927,1258,0,359.1016042780749,83,104,44,36.75929144491857,0.5745320855614973,41.35664682539683,8276.587301587317,99.71791929623274,0
1285,32,2,0,188,0.010638297872340425,0.0,1.0,188,6650,5000,1650,0.7518796992481203,83,50,33,179.02125476884072,0.46207261918306974,0.7276921254496906,0.11274013846285265,1072388.6879544556,-5853.926296496272,1066534.7616579593,1259,0,357.50531914893617,85,103,43,36.47480583886967,0.5765735815602837,41.109496124031025,8284.496124031053,97.46466028271827,0
1286,32,1,3,186,0.005291005291005291,0.015873015873015872,0.9841269841269842,189,5500,3800,1700,0.6909090909090909,72,38,34,182.42165633208216,0.46191813013621524,0.733488970818448,0.11558244498796993,1074173.0929736805,-4109.513038476798,1070063.5799352038,1260,0,356.6084656084656,88,101,37,36.167543740777575,0.5784281305114638,40.894194756554334,8291.38576779034,94.22029281579931,0
1287,32,1,1,186,0.0053475935828877,0.0053475935828877,0.9946524064171123,187,5950,4100,1850,0.6890756302521008,78,41,37,183.49473716713948,0.46122275889828074,0.7340185842964684,0.11661600833130796,1075061.762688625,-3896.3648834014457,1071165.3978052235,1261,0,360.8449197860963,89,98,41,36.030615586116596,0.5798239750445633,40.78703703703707,8294.814814814896,93.20016645859434,0
1288,32,2,2,186,0.010638297872340425,0.010638297872340425,0.9893617021276596,188,5150,4000,1150,0.7766990291262136,63,40,23,194.2124426622326,0.4608417956157318,0.7518354411545887,0.1213403499681025,1070051.3633026853,-1186.5421917866452,1068864.8211108986,1262,0,359.8936170212766,71,117,44,36.36928904428904,0.5710882092198581,41.39178240740741,8275.462962962976,116.55581637976023,8
1289,32,0,3,183,0.0,0.016129032258064516,0.9838709677419355,186,5700,4600,1100,0.8070175438596491,68,46,22,192.38948170551706,0.46061706868158486,0.7400470456765307,0.11253222352195173,1050208.3746447305,-2490.1910238610462,1047718.1836208694,1263,1,364.71505376344084,81,105,48,38.87181012825599,0.545586917562724,43.800813008130106,8198.373983739903,101.21449362641854,8
1290,32,2,1,184,0.010810810810810811,0.005405405405405406,0.9945945945945946,185,5800,4700,1100,0.8103448275862069,69,47,22,188.34381260719283,0.4605047982765374,0.7327491919996254,0.11089222436158169,1052220.049382714,-3164.1728395063033,1049055.8765432078,1264,0,365.8702702702703,74,111,47,38.72558311669558,0.5480292792792794,43.55555555555555,8206.222222222206,110.89489489489468,0
1291,32,4,1,187,0.02127659574468085,0.005319148936170213,0.9946808510638298,188,5250,4100,1150,0.780952380952381,64,41,23,180.95689619092897,0.46170639435658206,0.7257396928999502,0.1073534180879502,1054530.371492322,-4685.091407136394,1049845.2800851858,1265,0,360.96276595744683,80,108,52,38.628546143699175,0.5503102836879432,43.27417695473252,8215.226337448577,102.69032921810722,0
1292,32,3,3,187,0.015789473684210527,0.015789473684210527,0.9842105263157894,190,5200,3800,1400,0.7307692307692307,66,38,28,179.9681627641925,0.46211013645224175,0.7260788220610437,0.10731809672171236,1056094.7945774056,-5187.312023015178,1050907.4825543903,1266,0,358.08947368421053,85,105,33,38.46014450049502,0.5521929824561403,43.08381782945738,8221.317829457414,96.72138622891075,0
1293,32,1,3,185,0.005319148936170213,0.015957446808510637,0.9840425531914894,188,5600,3900,1700,0.6964285714285714,73,39,34,179.43077435496463,0.46166728296734555,0.7242870243726551,0.10740128709736597,1057235.7452364627,-5259.874311294456,1051975.8709251683,1267,0,359.04787234042556,87,101,38,38.33271934671827,0.5535239361702128,42.94507575757578,8225.757575757632,94.54893765238658,0
1294,32,1,2,184,0.005376344086021506,0.010752688172043012,0.989247311827957,186,4550,3000,1550,0.6593406593406593,61,30,31,179.75843374529472,0.46144834350479513,0.7236030442168444,0.1078701280119505,1058001.407880833,-3713.064803804822,1054288.3430770282,1268,0,363.2043010752688,86,100,43,38.22955952879828,0.5548275089605734,42.852011494252885,8228.735632183934,95.68297246725506,0
1295,32,2,2,184,0.010752688172043012,0.010752688172043012,0.989247311827957,186,5200,3500,1700,0.6730769230769231,69,35,34,179.3120157944408,0.46163179308340596,0.7227766181115678,0.10818861415353898,1059641.4845678972,-4398.709876543469,1055242.7746913538,1269,0,361.13440860215053,74,112,47,38.03823286020111,0.5565636200716846,42.652777777777764,8235.111111111079,111.28528528528484,0
1296,32,1,2,183,0.005405405405405406,0.010810810810810811,0.9891891891891892,185,5900,3900,2000,0.6610169491525424,79,39,40,206.0037620139671,0.4613995789267529,0.7438606118809183,0.12150521292440483,1052761.5017361029,474.5659722218106,1053236.0677083246,1270,0,363.82702702702704,75,110,42,38.20537225042301,0.5505067567567568,43.48958333333331,8208.333333333268,109.44444444444358,8
1297,32,3,4,182,0.016129032258064516,0.021505376344086023,0.978494623655914,186,6500,4600,1900,0.7076923076923077,84,46,38,215.77825318206789,0.4617425893635571,0.7702417261712533,0.1274537776679884,1053200.7777152231,1751.5648130770169,1054952.3425283001,1271,0,362.0860215053763,72,114,37,37.899981460882444,0.5539314516129032,43.436073059360716,8210.045662100425,114.02841197361701,8
1298,32,2,1,183,0.010869565217391304,0.005434782608695652,0.9945652173913043,184,6950,4900,2050,0.7050359712230215,90,49,41,214.77849611982393,0.46120292824899023,0.7711332144797436,0.12600847996553122,1051135.0121284158,1402.2394247669185,1052537.2515531827,1272,0,366.94565217391306,66,118,40,38.18277629503825,0.5482336956521738,43.68781094527365,8201.99004975127,124.27257651138288,8
1299,32,1,2,182,0.005434782608695652,0.010869565217391304,0.9891304347826086,184,6500,4600,1900,0.7076923076923077,84,46,38,210.05884578499786,0.461313678031203,0.7654107205444782,0.12425225808675719,1053634.781596468,965.0612202166376,1054599.8428166846,1273,0,367.51630434782606,70,114,37,37.99275341604253,0.5506680253623188,43.38321596244133,8211.737089201906,117.31052984574151,0
1300,32,2,3,181,0.010869565217391304,0.016304347826086956,0.9836956521739131,184,5450,4000,1450,0.7339449541284404,69,40,29,206.7039326260566,0.46194476617565533,0.7620763681070484,0.12310487475718955,1055709.9667234824,1393.8803668534924,1057103.8470903358,1274,0,366.80434782608694,73,111,40,37.8210397486483,0.5532721920289856,43.13063063063064,8219.819819819837,112.60027150438133,0
1301,32,0,1,180,0.0,0.0055248618784530384,0.994475138121547,181,5250,4100,1150,0.780952380952381,64,41,23,207.4361419317661,0.4604895641497851,0.7591541530465429,0.1238999753131147,1056590.1316991737,2384.9961045704827,1058975.1278037443,1275,1,371.95580110497235,75,106,37,37.692954735363685,0.5548457642725598,43.0235745614035,8223.245614035064,109.64327485380086,0
1302,32,1,2,179,0.0055248618784530384,0.011049723756906077,0.988950276243094,181,5300,3500,1800,0.660377358490566,71,35,36,236.1385622008856,0.4607466236955187,0.7792534840335705,0.13878562520535484,1051676.5450361576,8168.277449046517,1059844.822485204,1276,0,372.88950276243094,64,117,40,37.56771679793307,0.5460980662983426,43.62179487179486,8204.102564102543,128.18910256410223,8
1303,32,4,0,183,0.02185792349726776,0.0,1.0,183,5550,3900,1650,0.7027027027027027,72,39,33,228.1032278599716,0.4609467263155788,0.7753413856939668,0.135783856176284,1055563.301070111,6005.479236923722,1061568.7803070347,1277,0,369.7431693989071,70,113,40,37.28960796633727,0.5491234061930783,43.148474178403745,8219.248826291056,117.41784037558651,0
1304,32,1,0,184,0.005434782608695652,0.0,1.0,184,4950,3500,1450,0.7070707070707071,64,35,29,225.9078190854082,0.46144113308782764,0.7725198528213126,0.13106584780374728,1047704.8827523898,5586.945021545402,1053291.8277739352,1278,0,368.7282608695652,75,109,35,38.32552222817355,0.5434216485507246,44.10635964912282,8188.596491228105,109.18128654970806,8
1305,32,1,0,185,0.005405405405405406,0.0,1.0,185,5850,4100,1750,0.7008547008547008,76,41,35,224.70147890018802,0.4614926067371719,0.7728006188463119,0.13111426757390165,1049465.3407551406,4313.282824434173,1053778.6235795747,1279,0,367.72972972972974,80,105,38,38.1366641559963,0.5453828828828828,43.89146090534981,8195.473251028847,102.44341563786058,0
1306,32,0,2,183,0.0,0.010810810810810811,0.9891891891891892,185,6050,3800,2250,0.628099173553719,83,38,45,222.09002577830458,0.46113273599686644,0.7695451549110068,0.13008130081300825,1050625.000000011,3616.666666667301,1054241.6666666782,1280,1,368.72972972972974,81,104,40,38.05894308943093,0.5474099099099099,43.750000000000036,8200.000000000087,101.23456790123565,0
1307,32,1,0,184,0.005434782608695652,0.0,1.0,184,5400,3800,1600,0.7037037037037037,70,38,32,220.99302032998546,0.460943068424804,0.7664106987817529,0.12999983225537337,1051948.7735292776,4294.667338931593,1056243.4408682093,1281,0,371.6576086956522,70,114,40,37.92210238217848,0.5487998188405797,43.58861502347416,8205.164319248792,117.2166331321256,0
1308,32,1,1,184,0.005405405405405406,0.005405405405405406,0.9945945945945946,185,4800,3200,1600,0.6666666666666666,64,32,32,221.79273919825994,0.46144609283196236,0.7660017768477649,0.13095604788326753,1053083.628495022,4913.260513750478,1057996.8890087723,1282,0,370.64324324324326,72,113,42,37.76025733726385,0.5502252252252252,43.45034246575341,8209.58904109585,114.02207001522012,0
1309,32,1,1,184,0.005405405405405406,0.005405405405405406,0.9945945945945946,185,5150,3800,1350,0.7378640776699029,65,38,27,226.09774708238388,0.4612380043086565,0.7692301765003136,0.13419449427385557,1054668.8612176317,5541.65068784981,1060210.5119054816,1283,0,371.5945945945946,73,112,41,37.452425662956664,0.5518018018018018,43.257319819819806,8215.76576576573,112.54473651733876,0
1310,32,0,1,183,0.0,0.005434782608695652,0.9945652173913043,184,5750,3900,1850,0.6782608695652174,76,39,37,234.04517722908903,0.46078838995802646,0.7745314692613696,0.1395856457893491,1056139.3439567862,6886.863986995587,1063026.2079437817,1284,1,374.2771739130435,75,109,37,37.06527296167868,0.5542346014492754,43.07839912280699,8221.491228070112,109.61988304093482,0
1311,32,2,0,185,0.010810810810810811,0.0,1.0,185,4750,3500,1250,0.7368421052631579,60,35,25,232.90370132991612,0.46119638660399526,0.7764680123161141,0.13981301219652953,1058112.2504340226,7537.651909721946,1065649.9023437446,1285,0,372.33513513513515,79,106,39,36.849156118143426,0.55625,42.83854166666665,8229.166666666626,104.16666666666615,0
1312,32,2,1,186,0.0106951871657754,0.0053475935828877,0.9946524064171123,187,5550,3600,1950,0.6486486486486487,75,36,39,228.24697422302765,0.4616264638797845,0.7749879000365942,0.13786117243070883,1059963.8429752076,5436.7079889807865,1065400.5509641883,1286,0,369.3422459893048,65,122,43,36.73887049300958,0.5582107843137255,42.61363636363637,8236.363636363645,126.71328671328685,0
1313,32,4,2,188,0.021052631578947368,0.010526315789473684,0.9894736842105263,190,6900,5200,1700,0.7536231884057971,86,52,34,228.52117426889487,0.46166979949874687,0.7795357721729008,0.14004286606021282,1064312.2300722317,3743.5761209705934,1068055.8061932023,1287,0,364.4684210526316,71,119,45,36.19235102185823,0.5613486842105263,42.086226851851855,8253.240740740748,116.24282733437674,0
1314,32,0,2,186,0.0,0.010638297872340425,0.9893617021276596,188,5250,3600,1650,0.6857142857142857,69,36,33,225.92441713660475,0.4616317271589487,0.7739820417723997,0.1389715658458799,1065430.5842516073,5291.35674931133,1070721.9410009186,1288,1,369.031914893617,76,112,37,36.120795107033636,0.563386524822695,41.95075757575758,8257.57575757576,108.65231259968105,0
1315,32,3,0,189,0.015873015873015872,0.0,1.0,189,6850,5100,1750,0.7445255474452555,86,51,35,225.87792953477768,0.4616073773875193,0.7753724943160489,0.14016225112611314,1068027.3897873976,3598.763098322268,1071626.15288572,1289,0,367.66137566137564,68,121,41,35.80061158505706,0.566192680776014,41.63647342995171,8267.632850241582,121.58283603296444,0
1316,32,0,2,187,0.0,0.010582010582010581,0.9894179894179894,189,5900,4200,1700,0.711864406779661,76,42,34,225.19828166243923,0.4614561052947577,0.77543755471813,0.14049623496893698,1069623.813066897,4475.488945578438,1074099.3020124754,1290,1,368.66137566137564,69,120,40,35.62080335731415,0.5677358906525574,41.443452380952394,8273.809523809552,119.91028295376162,0
1317,32,1,0,188,0.005319148936170213,0.0,1.0,188,4350,2800,1550,0.6436781609195402,59,28,31,219.25181180953845,0.46142254048621384,0.7788258931344394,0.13356064541557758,1062521.9157235904,4641.9710219476465,1067163.886745538,1291,0,364.1329787234043,71,117,39,36.65319260423681,0.5615580673758865,42.303240740740726,8246.296296296268,116.14501825769392,8
1318,32,0,1,187,0.0,0.005319148936170213,0.9946808510638298,188,5800,4000,1800,0.6896551724137931,76,40,36,218.04205255676106,0.4612441688474229,0.7779215027088209,0.1333543397620655,1063715.2911736956,2986.933084704945,1066702.2242584005,1292,1,365.1329787234043,71,117,40,36.53653723861895,0.5627216312056738,42.15856481481481,8250.925925925914,116.2102243088157,0
1319,32,0,1,186,0.0,0.0053475935828877,0.9946524064171123,187,5950,4100,1850,0.6890756302521008,78,41,37,217.85475447746242,0.4607304065321143,0.7780951212264133,0.13405591135504966,1065537.705766144,3076.49105523243,1068614.1968213764,1293,2,368.06951871657753,72,115,36,36.3157773477099,0.5644496434937611,41.93778538812786,8257.990867579914,114.69431760527658,0
1320,32,0,3,183,0.0,0.016129032258064516,0.9838709677419355,186,6950,5500,1450,0.7913669064748201,84,55,29,220.1013690729241,0.4605740821466628,0.7794227382868273,0.13601278354544238,1066796.9904440164,2810.6956239205847,1069607.686067937,1294,3,369.241935483871,78,108,38,36.10199748080816,0.5669242831541219,41.78533755274261,8262.86919831223,105.93422049118243,0
1321,32,0,1,182,0.0,0.00546448087431694,0.994535519125683,183,5700,4000,1700,0.7017543859649122,74,40,34,223.23557774590665,0.4600409836065574,0.7791344044775914,0.13872059756836677,1068450.62679715,5403.238593207709,1073853.8653903576,1295,4,373.75409836065575,63,120,37,35.816550670781666,0.5685336976320583,41.58528645833335,8269.270833333363,131.25826719576767,0
1322,32,1,0,183,0.00546448087431694,0.0,1.0,183,4450,2900,1550,0.651685393258427,60,29,31,218.8887309204711,0.4597695109990192,0.7735527163091447,0.13691933650458016,1070400.1588426863,5809.706469229522,1076209.8653119158,1296,0,373.40437158469945,68,115,40,35.688072725150306,0.5701275045537341,41.34963768115944,8276.811594202947,121.71781756180805,0
1323,32,0,0,183,0.0,0.0,1.0,183,6400,4500,1900,0.703125,83,45,38,218.17910859735846,0.4596293961048059,0.7717679936515862,0.1371217141974669,1071792.1983486605,3768.5332874628944,1075560.7316361233,1297,1,374.40437158469945,72,111,40,35.53462803690228,0.5716643897996356,41.18150684931508,8282.191780821935,115.03044140030465,0
1324,32,0,2,181,0.0,0.01092896174863388,0.9890710382513661,183,4850,3700,1150,0.7628865979381443,60,37,23,220.49171973657778,0.45927910886927276,0.7738422662177196,0.1389898798092743,1072670.7577509973,5853.00401753124,1078523.7617685285,1298,2,375.40437158469945,73,110,41,35.366378529230545,0.5729735883424407,41.07545045045046,8285.58558558561,113.50117240528233,0
1325,32,0,2,179,0.0,0.011049723756906077,0.988950276243094,181,5550,4000,1550,0.7207207207207207,71,40,31,209.27538185539674,0.4588142009412728,0.7539091924356953,0.1287218968842413,1065411.03515625,2842.8602430555266,1068253.8953993055,1299,3,380.21546961325964,79,102,34,36.552839169778316,0.5656077348066298,41.953125,8257.5,104.5253164556962,7
1326,32,1,2,178,0.005555555555555556,0.011111111111111112,0.9888888888888889,180,5000,3300,1700,0.66,67,33,34,209.03055553209117,0.45826608731636664,0.7522649635714718,0.12927843515095447,1067042.8094429555,3608.910246876799,1070651.7196898323,1300,0,383.18888888888887,81,99,36,36.357492170462564,0.5674768518518518,41.755589430894304,8263.82113821137,102.02248318779469,0
1327,32,0,3,175,0.0,0.016853932584269662,0.9831460674157303,178,6100,4700,1400,0.7704918032786885,75,47,28,223.19805372950782,0.45798088723840963,0.7683603833427981,0.13507521676022138,1060551.7194100253,5642.615930360293,1066194.3353403856,1301,1,386.80337078651684,68,110,39,36.79586411789999,0.5592813670411985,42.54227053140098,8238.6473429952,121.15657857345883,8
1328,32,2,4,173,0.011299435028248588,0.022598870056497175,0.9774011299435028,177,6200,4500,1700,0.7258064516129032,79,45,34,236.90728839253006,0.4570292437082691,0.7749143617439807,0.14158521297595705,1056766.4274234711,8471.133757030782,1065237.561180502,1302,0,388.6553672316384,77,100,33,36.91367006166423,0.5562029190207156,43.00213675213673,8223.931623931563,106.80430680430601,8
1329,32,1,0,174,0.005747126436781609,0.0,1.0,174,5600,3800,1800,0.6785714285714286,74,38,36,258.74074065918325,0.45753396784266825,0.7932187807539504,0.14719529672240317,1041621.4850724082,13501.982906830734,1055123.467979239,1303,0,391.9022988505747,70,104,36,38.248591225346445,0.5374161877394636,44.85035211267606,8164.788732394381,116.63983903420545,8
1330,32,2,0,176,0.011363636363636364,0.0,1.0,176,6150,5100,1050,0.8292682926829268,72,51,21,249.70214596169035,0.4580472132034632,0.787813160137864,0.14344715785574425,1044654.3402777809,10820.486111111324,1055474.8263888923,1304,0,388.4375,59,117,41,38.09875662454137,0.5400686553030303,44.47916666666668,8176.6666666666915,138.58757062146935,0
1331,32,5,3,178,0.027624309392265192,0.016574585635359115,0.9834254143646409,181,5200,3800,1400,0.7307692307692307,66,38,28,240.0420578108613,0.4586530591364846,0.7846877581875291,0.1396220963479748,1048490.6684027814,8936.371527778,1057427.0399305595,1305,0,378.6795580110497,67,114,31,37.865590030518845,0.543335635359116,44.01041666666668,8191.666666666695,122.26368159204023,0
1332,32,2,1,179,0.011111111111111112,0.005555555555555556,0.9944444444444445,180,5800,4400,1400,0.7586206896551724,72,44,28,238.34900180626298,0.4589366076970826,0.7836588217319969,0.139547208722904,1050499.3910094697,8277.09624903899,1058776.4872585088,1306,0,380.25,67,113,35,37.65799057412166,0.5455439814814815,43.76531862745099,8199.509803921586,122.38074334211323,0
1333,32,0,1,178,0.0,0.00558659217877095,0.994413407821229,179,5900,4000,1900,0.6779661016949152,78,40,38,241.36553125710017,0.45829933253823785,0.786841741048381,0.1417534748237424,1051451.7754942747,9056.843276679268,1060508.618770954,1307,1,383.3631284916201,61,118,36,37.461768689649155,0.5471950651769087,43.64919354838709,8203.225806451595,134.4791115811737,0
1334,32,1,4,175,0.00558659217877095,0.0223463687150838,0.9776536312849162,179,5500,3800,1700,0.6909090909090909,72,38,34,244.9883942001856,0.4581358671772017,0.792982044583012,0.14382718251951204,1051336.9261188228,10213.069058641715,1061549.9951774646,1308,0,384.1899441340782,59,120,36,37.383240207698385,0.5478933891992551,43.66319444444443,8202.777777777745,139.03013182674144,8
1335,32,4,0,179,0.0223463687150838,0.0,1.0,179,4850,3700,1150,0.7628865979381443,60,37,23,233.67779513652877,0.4588211139706651,0.7821091686321162,0.13873979457230073,1054770.4953576145,8645.288746046206,1063415.7841036606,1309,0,384.1117318435754,65,114,44,37.24515408573067,0.5510358472998138,43.24494949494949,8216.1616161616,126.40248640248616,0
1336,32,2,4,177,0.011049723756906077,0.022099447513812154,0.9779005524861879,181,5800,4000,1800,0.6896551724137931,76,40,36,231.8151512086142,0.4592477491303458,0.782697635660248,0.13868182587764782,1057072.058274403,7009.0638054562805,1064081.1220798593,1310,0,380.8563535911602,68,113,37,37.00651454638003,0.5531767955801106,42.96497584541062,8225.12077294684,120.95765842568883,0
1337,32,0,0,177,0.0,0.0,1.0,177,5850,3900,1950,0.6666666666666666,78,39,39,236.92747119405885,0.45826110683102206,0.7846499183605931,0.14181689538175787,1057235.7452364536,8847.638314967757,1066083.3835514213,1311,1,390.26553672316385,65,112,37,36.854738441701976,0.5539077212806026,42.94507575757575,8225.757575757561,126.55011655011633,0
1338,32,2,1,178,0.0111731843575419,0.00558659217877095,0.994413407821229,179,5100,3100,2000,0.6078431372549019,71,31,40,256.4917278122809,0.4589989642834725,0.8028917108435507,0.15145509217685668,1053106.302029132,13122.61099549053,1066228.9130246225,1312,0,386.89385474860336,61,118,37,36.86722331368697,0.5442853817504656,43.447580645161274,8209.677419354804,134.58487572712795,6
1339,32,0,1,177,0.0,0.0056179775280898875,0.9943820224719101,178,5600,3700,1900,0.6607142857142857,75,37,38,258.9795208258106,0.45849996826001393,0.8036141991173904,0.1535486262591214,1054348.0505332986,13410.910582148224,1067758.9611154469,1313,1,390.0449438202247,61,117,35,36.648272683639874,0.5458801498127341,43.296370967741936,8214.516129032258,134.66419883659438,0
1340,32,1,1,177,0.0056179775280898875,0.0056179775280898875,0.9943820224719101,178,5350,3600,1750,0.6728971962616822,71,36,35,258.03873863111676,0.45870561691952855,0.8027028528174633,0.15347128748060251,1055301.4161851646,13511.729261610075,1068813.1454467745,1314,0,386.1292134831461,63,115,38,36.55339639182881,0.5478113295880149,43.18033854166666,8218.229166666646,130.4480820105817,0
1341,32,4,6,175,0.022099447513812154,0.03314917127071823,0.9668508287292817,181,5850,4300,1550,0.7350427350427351,74,43,31,251.56532558832592,0.4602478514426028,0.8005837834682252,0.15105447026426236,1058189.8972263043,11190.777206002353,1069380.6744323066,1315,0,380.6629834254144,68,113,35,36.359578319146856,0.5507021178637201,42.82910628019323,8229.4685990338,121.02159704461471,0
1342,32,4,1,178,0.0223463687150838,0.00558659217877095,0.994413407821229,179,5550,3200,2350,0.5765765765765766,79,32,47,252.2091681088171,0.45919904588538074,0.800435701867668,0.1530850997125613,1061442.1745152364,12191.089566020411,1073633.264081257,1316,0,385.64245810055866,56,123,40,35.938165176670935,0.5531308193668529,42.434210526315795,8242.105263157902,147.18045112781968,0
1343,32,3,1,180,0.016574585635359115,0.0055248618784530384,0.994475138121547,181,5400,3900,1500,0.7222222222222222,69,39,30,222.7965936004033,0.46055990382647843,0.7727608524072618,0.1308369257720489,1051425.9338378902,5250.823296440931,1056676.7571343312,1317,0,381.3425414364641,63,118,40,37.94100529100529,0.5439686924493554,43.65234375,8203.124999999996,130.2083333333333,8
1344,32,0,2,178,0.0,0.011111111111111112,0.9888888888888889,180,5750,4200,1550,0.7304347826086957,73,42,31,225.53312660307805,0.45992266708048835,0.7744602388910049,0.13290766675434906,1052494.320339624,5724.466959635252,1058218.7872992593,1318,1,384.4555555555556,63,117,44,37.73770994627068,0.5457175925925926,43.52213541666666,8207.291666666644,130.27447089947054,0
1345,32,0,0,178,0.0,0.0,1.0,178,5150,3300,1850,0.6407766990291263,70,33,37,221.1455346601449,0.4593688503777058,0.7681307456588351,0.13098620129870128,1054044.4444444452,5869.444444444485,1059913.8888888897,1319,2,389.55056179775283,64,114,40,37.65726461038959,0.5474016853932584,43.333333333333336,8213.33333333334,128.33333333333343,0
1346,32,2,1,179,0.011111111111111112,0.005555555555555556,0.9944444444444445,180,4750,3000,1750,0.631578947368421,65,30,35,225.7639221686502,0.4598625336230085,0.7750290669840101,0.1327936524095543,1051919.5904754612,6747.098510356091,1058666.6889858174,1320,0,386.2111111111111,65,115,42,37.80340801838401,0.5482060185185185,43.592171717171716,8205.050505050502,126.23154623154618,7
1347,32,1,1,179,0.005555555555555556,0.005555555555555556,0.9944444444444445,180,6250,4400,1850,0.704,81,44,37,225.47342829990998,0.4602718290916615,0.7739226223163627,0.13324570192577423,1053350.1948703572,5250.49592755947,1058600.6907979166,1321,0,386.0388888888889,68,112,39,37.63262924609712,0.5501157407407408,43.41787439613526,8210.62801932366,120.74452969593618,0
1348,32,1,1,179,0.005555555555555556,0.005555555555555556,0.9944444444444445,180,4850,3200,1650,0.6597938144329897,65,32,33,223.31106910312957,0.4603448944754811,0.7723123993558776,0.132375118282783,1054288.9030612248,6236.876417233571,1060525.7794784585,1322,0,387.0,69,111,41,37.57125603864736,0.5514467592592592,43.30357142857143,8214.285714285717,119.0476190476191,0
1349,32,0,3,176,0.0,0.01675977653631285,0.9832402234636871,179,5700,3900,1800,0.6842105263157895,75,39,36,221.87083435393527,0.46044792124369677,0.7699536418136164,0.1322313924280943,1055925.094778374,5355.796358747235,1061280.8911371212,1323,1,387.8994413407821,70,109,36,37.404697315819554,0.553072625698324,43.10446009389672,8220.657276995315,117.43796109993306,0
1350,32,2,1,177,0.011235955056179775,0.0056179775280898875,0.9943820224719101,178,5850,4000,1850,0.6837606837606838,77,40,37,220.08634757098505,0.46033493620262805,0.766826742075013,0.12855428378192785,1049783.0326048604,4758.582677599141,1054541.6152824594,1324,0,390.32022471910113,70,108,40,38.21524715046681,0.5424274344569289,43.852699530516425,8196.713615023458,117.0959087860494,8
1351,32,6,2,181,0.03278688524590164,0.01092896174863388,0.9890710382513661,183,5400,4000,1400,0.7407407407407407,68,40,28,217.4586055754693,0.46171986028543405,0.7718025876010439,0.12921866732582732,1055026.0454212313,3884.898536620509,1058910.9439578517,1325,0,380.60655737704917,67,116,46,37.62981218556743,0.5465050091074681,43.213848039215684,8217.15686274509,122.64413227977747,0
1352,32,1,2,180,0.005494505494505495,0.01098901098901099,0.989010989010989,182,5250,3200,2050,0.6095238095238096,73,32,41,214.66646219954356,0.46119505494505497,0.7676326337857677,0.1280729487331481,1056245.5924036242,3698.100907029255,1059943.6933106536,1326,0,383.2087912087912,69,113,38,37.5499536661647,0.548592032967033,43.065476190476176,8221.90476190473,119.15804002760478,0
1353,32,0,3,177,0.0,0.016666666666666666,0.9833333333333333,180,6200,4500,1700,0.7258064516129032,79,45,34,224.14672056092166,0.4607716480446928,0.7740408483492174,0.13437914773947268,1057714.2998866206,5216.638321995455,1062930.938208616,1327,2,388.43333333333334,69,111,40,37.12379905081605,0.5498263888888889,42.88690476190476,8227.619047619042,119.24085576259482,0
1354,32,2,2,177,0.0111731843575419,0.0111731843575419,0.9888268156424581,179,5650,3800,1850,0.672566371681416,75,38,37,225.79027738957976,0.46018245349737413,0.7742973000568885,0.13640012025269538,1060014.1634871063,6418.178402127334,1066432.3418892336,1328,0,390.9664804469274,61,118,40,36.79585509138382,0.5517923649906891,42.607526881720425,8236.559139784931,135.02555966860544,0
1355,32,0,1,176,0.0,0.005649717514124294,0.9943502824858758,177,5350,4100,1250,0.7663551401869159,66,41,25,224.3268749859183,0.4598086265194316,0.7706618007354744,0.13612542780115486,1061363.2780787195,6868.461479241758,1068231.7395579612,1329,1,395.71751412429376,62,115,41,36.66610494104555,0.5533780602636535,42.44378306878306,8241.79894179893,132.93224099675695,0
1356,32,1,1,176,0.005649717514124294,0.005649717514124294,0.9943502824858758,177,5100,3500,1600,0.6862745098039216,67,35,32,222.94857509636188,0.4603048493408663,0.7691421418273203,0.13589127595179099,1062695.4559802532,6885.287534435004,1069580.7435146882,1330,0,393.71751412429376,65,112,43,36.53641527343989,0.5551435969868173,42.282196969696955,8246.969696969665,126.87645687645639,0
1357,32,1,1,176,0.005649717514124294,0.005649717514124294,0.9943502824858758,177,5950,4300,1650,0.7226890756302521,76,43,33,220.45105983470526,0.4604880906522855,0.7663534370321547,0.12950993772221023,1051545.0731426708,5012.845167652933,1056557.9183103237,1331,0,393.50847457627117,64,113,38,37.98628909587215,0.5494350282485876,43.63782051282052,8203.589743589755,128.18108974358992,8
1358,32,3,2,177,0.01675977653631285,0.0111731843575419,0.9888268156424581,179,5750,4300,1450,0.7478260869565218,72,43,29,214.46761552110564,0.4610494737723097,0.7628684453794479,0.1272587672558243,1054590.0866998066,3685.08424934068,1058275.1709491473,1332,0,389.05027932960894,68,111,39,37.76081481045906,0.5516759776536313,43.26690821256039,8215.458937198071,120.81557260585399,0
1359,32,0,1,176,0.0,0.005649717514124294,0.9943502824858758,177,5350,4100,1250,0.7663551401869159,66,41,25,218.09977661775312,0.4607355332990926,0.7540068800126822,0.12878808357061144,1053113.2859094937,5186.754482009943,1058300.0403915036,1333,1,391.20338983050846,78,99,37,37.85130886913026,0.5566148775894539,43.44672995780593,8209.704641350261,105.25262360705463,8
1360,32,0,0,176,0.0,0.0,1.0,176,6150,4500,1650,0.7317073170731707,78,45,33,223.64408905414155,0.46061147186147183,0.7661394029637272,0.13542680683554115,1060733.1084158514,6095.337952246113,1066828.4463680976,1334,2,392.97159090909093,71,105,36,36.76187231930473,0.5654592803030303,42.520254629629626,8239.351851851845,116.0472091810119,8
1361,32,0,2,174,0.0,0.011363636363636364,0.9886363636363636,176,6300,4600,1700,0.7301587301587301,80,46,34,200.95672445915048,0.46061891233766233,0.7415718326535992,0.1180637184968307,1051561.2815620978,763.6621421568593,1052324.9437042547,1335,3,393.97159090909093,72,104,41,38.48403465805781,0.5546283143939394,43.63584474885843,8203.652968036491,113.93962455606237,8
1362,32,4,1,177,0.02247191011235955,0.0056179775280898875,0.9943820224719101,178,5850,3900,1950,0.6666666666666666,78,39,39,193.65271567857968,0.46085335597452337,0.7352188019481889,0.11500455420582416,1054846.0032446696,-595.2413697948823,1054250.7618748748,1336,0,390.17977528089887,78,100,43,38.263450247351024,0.5578768726591761,43.23575949367088,8216.455696202509,105.33917559233986,0
1363,32,0,0,177,0.0,0.0,1.0,177,5300,3900,1400,0.7358490566037735,67,39,28,193.85024955883245,0.46039580123266566,0.7337185927845138,0.11551443255370451,1055880.0488096988,236.5221931904798,1056116.5710028892,1337,1,393.361581920904,82,95,39,38.13011953034672,0.5596162900188324,43.10993975903615,8220.48192771086,100.24977960622999,0
1364,32,0,3,174,0.0,0.01694915254237288,0.9830508474576272,177,5350,4100,1250,0.7663551401869159,66,41,25,219.64983943482002,0.46029548664612224,0.7578780068946962,0.13195485547782937,1058337.1463741912,5742.716853799075,1064079.8632279902,1338,2,394.361581920904,80,97,42,37.16206643665514,0.5609110169491525,42.81121399176953,8230.041152263324,102.87551440329155,8
1365,32,1,3,172,0.005714285714285714,0.017142857142857144,0.9828571428571429,175,5550,4400,1150,0.7927927927927928,67,44,23,218.8607372202574,0.45920771756978657,0.755995685377745,0.13218677507046214,1059952.2018328775,5846.384062275796,1065798.5858951532,1339,0,399.69142857142856,66,109,39,36.98190375515959,0.5628571428571428,42.61504975124379,8236.318407960214,124.79270315091233,0
1366,32,0,2,170,0.0,0.011627906976744186,0.9883720930232558,172,5650,4100,1550,0.7256637168141593,72,41,31,216.24914310714672,0.458744871707693,0.7481352187728678,0.13109860601421777,1061076.7230452285,5841.386425894197,1066918.1094711227,1340,1,405.90697674418607,67,105,43,36.909674716951216,0.5646196705426356,42.47855392156865,8240.686274509846,122.9953175299977,0
1367,32,1,1,170,0.005847953216374269,0.005847953216374269,0.9941520467836258,171,5300,3600,1700,0.6792452830188679,70,36,34,210.81318453932974,0.4583462332301342,0.7387605648228566,0.12852245275097982,1062760.5372299412,5308.78665123471,1068069.3238811758,1341,0,408.60233918128654,71,100,41,36.8411081172112,0.5670687134502924,42.274305555555564,8247.222222222244,116.15805946791893,0
1368,32,0,1,169,0.0,0.0058823529411764705,0.9941176470588236,170,5500,3900,1600,0.7090909090909091,71,39,32,214.70086986932407,0.45790767490428125,0.7422217998669587,0.13158399846446683,1064336.1111111096,6202.777777777665,1070538.8888888874,1342,1,411.88235294117646,74,96,34,36.545840064620364,0.5690563725490196,42.08333333333333,8253.333333333321,111.53153153153137,0
1369,32,0,0,169,0.0,0.0,1.0,169,4850,3700,1150,0.7628865979381443,60,37,23,222.44292661217793,0.45733539964309194,0.7523525938045406,0.13220220962063178,1055076.0513750687,8288.8409332579,1063364.8923083267,1343,2,415.2130177514793,72,97,41,37.49560087426833,0.5577539447731755,43.2077625570776,8217.351598173462,114.12988330796475,8
1370,32,2,2,169,0.011695906432748537,0.011695906432748537,0.9883040935672515,171,4450,3000,1450,0.6741573033707865,59,30,29,218.5073431067467,0.4580380690287811,0.7502349027144197,0.1305886742467765,1056766.4274234711,7532.24486814189,1064298.672291613,1344,0,411.34502923976606,77,94,37,37.386544723896606,0.5593932748538012,43.00213675213673,8223.931623931563,106.80430680430601,0
1371,32,0,0,169,0.0,0.0,1.0,169,5800,4200,1600,0.7241379310344828,74,42,32,190.2945069634365,0.4573236592467362,0.7168012315938286,0.10965811726484206,1045612.7631293462,194.87304687529968,1045807.6361762215,1345,1,409.9526627218935,79,90,39,39.497328053107864,0.5482618343195267,44.361979166666686,8180.416666666713,103.54957805907232,8
1372,32,1,2,168,0.0058823529411764705,0.011764705882352941,0.9882352941176471,170,5350,3800,1550,0.7102803738317757,69,38,31,191.94924090581793,0.45730798236454345,0.7210824221792667,0.1113786289718168,1047745.4496701709,872.788745342993,1048618.238415514,1346,0,408.5352941176471,82,88,38,39.189451528527016,0.5504901960784314,44.10140562248997,8188.755020080355,99.86286609854092,0
1373,32,1,0,169,0.005917159763313609,0.0,1.0,169,5750,4100,1650,0.7130434782608696,74,41,33,181.25969756739022,0.4572385413731568,0.7029585798816576,0.09984644357525704,1031494.1406249976,-2156.3368055556693,1029337.8038194419,1347,0,410.8816568047337,79,90,42,41.491452991452995,0.5267504930966469,46.09374999999999,8124.999999999981,102.84810126582255,8
1374,32,3,1,171,0.01744186046511628,0.005813953488372093,0.9941860465116279,172,4900,2900,2000,0.5918367346938775,69,29,40,181.55796661552685,0.45847712384967587,0.709558577351979,0.10082831725327202,1034069.1197954686,-1751.3026540054943,1032317.8171414632,1348,0,404.69767441860466,73,99,46,41.161406423034315,0.5291303294573644,45.77702702702702,8135.135135135116,111.44020733061802,0
1375,32,2,1,172,0.011560693641618497,0.005780346820809248,0.9942196531791907,173,5500,3800,1700,0.6909090909090909,72,38,34,179.33856802023348,0.4593597369718152,0.7079357449664772,0.10014844974241503,1035812.8595790898,-2947.7610052287027,1032865.0985738611,1349,0,403.01734104046244,76,97,43,40.99972972493978,0.531852119460501,45.56277056277055,8141.991341991314,107.1314650262015,0
1376,32,1,0,173,0.005780346820809248,0.0,1.0,173,4550,2700,1850,0.5934065934065934,64,27,37,179.490501001584,0.45944795447416764,0.7088508911342419,0.10058523668397266,1036914.6122636365,-1926.7353497873164,1034987.8769138493,1350,0,403.98265895953756,76,97,46,40.85815442661282,0.5333574181117533,45.42748917748917,8146.320346320333,107.18842560947806,0
1377,32,5,4,174,0.028089887640449437,0.02247191011235955,0.9775280898876404,178,5200,3500,1700,0.6730769230769231,69,35,34,218.6368920465278,0.46151526693328254,0.75566345235876,0.11671196411179359,1021455.3279298022,3865.5636525876525,1025320.89158239,1351,0,393.60674157303373,81,97,37,41.808069381598806,0.5142790262172285,47.33231707317073,8085.365853658524,99.81933152664845,8
1378,32,3,3,174,0.01694915254237288,0.01694915254237288,0.9830508474576272,177,5050,3400,1650,0.6732673267326733,67,34,33,219.90591389526497,0.46224158962506423,0.7591008760995586,0.11815598050073257,1023549.7370244355,4566.928067523153,1028116.6650919587,1352,0,386.6497175141243,83,94,37,41.51140746551611,0.516184086629002,47.07341269841269,8093.650793650762,97.51386498374413,0
1379,32,5,1,178,0.027932960893854747,0.00558659217877095,0.994413407821229,179,4750,2800,1950,0.5894736842105263,67,28,39,219.9338246310186,0.46305682840583345,0.7665201629979961,0.11959715079047684,1027390.9223615904,4641.602989234878,1032032.5253508253,1353,0,382.877094972067,67,112,43,41.026125418127585,0.5189711359404097,46.59926470588235,8108.823529411755,121.02721685689187,0
1380,32,3,2,179,0.016574585635359115,0.011049723756906077,0.988950276243094,181,4700,3000,1700,0.6382978723404256,64,30,34,219.38638815701535,0.46362031921424185,0.7670170985720735,0.12020372065941387,1029796.1713945619,4284.652516035074,1034080.823910597,1354,0,379.6022099447514,70,111,45,40.737046032847545,0.5207757826887661,46.30281690140844,8118.309859154909,115.97585513078441,0
1381,32,3,2,180,0.016483516483516484,0.01098901098901099,0.989010989010989,182,5200,3700,1500,0.7115384615384616,67,37,30,201.3187918917233,0.46471513063363895,0.7540498350233897,0.11215582760799675,1035064.0022675757,75.56689342416666,1035139.5691609998,1355,0,371.7362637362637,69,113,37,40.534314299087306,0.5264995421245422,45.65476190476191,8139.047619047636,117.95721187025559,8
1382,32,4,1,183,0.021739130434782608,0.005434782608695652,0.9945652173913043,184,5550,3600,1950,0.6486486486486487,75,36,39,195.89756940557112,0.4649486220004752,0.7500231241786406,0.11026930990770242,1038310.5096228014,-1669.4989753265,1036641.0106474749,1356,0,368.67391304347825,73,111,43,40.26582444604079,0.5289855072463768,45.2561936936937,8151.801801801826,111.66851783290173,0
1383,32,5,1,187,0.026595744680851064,0.005319148936170213,0.9946808510638298,188,6200,4900,1300,0.7903225806451613,75,49,26,197.36659924961398,0.46701487655023327,0.7568554644768481,0.10872831527196945,1031521.6198393941,-3082.4171679691754,1028439.202671425,1357,0,361.7925531914894,76,112,40,41.07903990622834,0.5218306737588653,46.09036796536796,8125.108225108212,106.90931875142384,8
1384,32,0,1,186,0.0,0.0053475935828877,0.9946524064171123,187,5650,3600,2050,0.6371681415929203,77,36,41,200.30207899101836,0.4666302493626972,0.7588342684547089,0.11069570443251381,1032525.2141317779,-1686.6105997519917,1030838.6035320258,1358,1,364.72192513368987,77,110,42,40.8785441418708,0.5230614973262032,45.96688034188032,8129.0598290597745,105.57220557220487,0
1385,32,0,2,184,0.0,0.010752688172043012,0.989247311827957,186,5100,3900,1200,0.7647058823529411,63,39,24,200.03117351583833,0.46651712196067036,0.7578228317248044,0.111057789377562,1033984.9194120014,-934.1566344677076,1033050.7627775337,1359,2,367.2795698924731,67,119,44,40.7023325298785,0.5246975806451613,45.78737745098038,8134.8039215685985,121.41498390400893,0
1386,32,5,0,189,0.026455026455026454,0.0,1.0,189,5250,3800,1450,0.7238095238095238,67,38,29,196.1933056431354,0.4682152707418665,0.7574891299546267,0.11039870669410921,1038205.3252797044,-2312.2130594137197,1035893.1122202907,1360,0,362.37566137566137,71,118,44,40.271447435678965,0.5281635802469136,45.269097222222214,8151.3888888888705,114.8082942097024,0
1387,32,1,0,190,0.005263157894736842,0.0,1.0,190,7150,5500,1650,0.7692307692307693,88,55,33,192.3719864939642,0.469048199201708,0.7485860820775985,0.10711774312883711,1034905.8836216107,-5332.619866683965,1029573.2637549267,1361,0,361.46315789473687,71,119,42,40.78167368261369,0.5275767543859649,45.6741898148148,8138.425925925903,114.62571726656202,8
1388,32,5,3,192,0.02564102564102564,0.015384615384615385,0.9846153846153847,195,5300,3700,1600,0.6981132075471698,69,37,32,210.58048040789637,0.4703619261608953,0.771821036106751,0.11576790313156005,1030865.1895138327,-883.9826312802506,1029981.2068825525,1362,0,353.16923076923075,73,122,36,40.82603149955633,0.5238782051282052,46.17117117117115,8122.5225225224785,111.26743181537641,8
1389,32,3,2,193,0.015384615384615385,0.010256410256410256,0.9897435897435898,195,6400,4600,1800,0.71875,82,46,36,210.6269652710783,0.47066481628337303,0.773693114140183,0.11703300109153289,1034234.1624915897,-1832.4793949442346,1032401.6830966454,1363,0,353.96923076923076,67,128,37,40.401691570765834,0.5272435897435898,45.75674019607843,8135.7843137254895,121.4296166227685,0
1390,32,4,1,196,0.02030456852791878,0.005076142131979695,0.9949238578680203,197,6700,4500,2200,0.6716417910447762,89,45,44,201.5711418180241,0.47123519458544844,0.7658307311681269,0.11319190046835911,1037560.8437063429,-4271.535205688135,1033289.3085006548,1364,0,351.01522842639594,72,125,41,40.21512757293881,0.5301395939086294,45.34817351598173,8148.858447488569,113.17858954845235,0
1391,32,3,4,195,0.01507537688442211,0.020100502512562814,0.9798994974874372,199,6950,5300,1650,0.762589928057554,86,53,33,199.2451195703406,0.4717040590156168,0.7638320917160164,0.11266469425719187,1039733.0183241637,-5317.654088554286,1034415.3642356094,1365,0,348.4321608040201,78,121,38,40.002629355678586,0.532715661641541,45.08175105485232,8157.383966244719,104.58184572108614,0
1392,32,1,1,195,0.00510204081632653,0.00510204081632653,0.9948979591836735,196,6250,4200,2050,0.672,83,42,41,211.2424842315609,0.4705117303331589,0.778765895468041,0.11884303769358934,1038142.3220168451,-1590.0473822481395,1036552.274634597,1366,0,354.67857142857144,72,124,39,39.89599088753197,0.5316751700680272,45.27682648401826,8151.141552511401,113.21029934043612,8
1393,32,2,5,192,0.01015228426395939,0.025380710659898477,0.9746192893401016,197,6600,4800,1800,0.7272727272727273,84,48,36,205.9016565769337,0.4707485151420974,0.7747831288542542,0.1135953525710332,1031982.4796597544,-3502.619575937346,1028479.860083817,1367,0,352.55837563451774,77,120,40,40.80444470736709,0.5235300338409475,46.03365384615382,8126.923076923006,105.54445554445462,8
1394,32,4,1,195,0.02040816326530612,0.00510204081632653,0.9948979591836735,196,6250,4000,2250,0.64,85,40,45,188.82025808001995,0.4704550409907553,0.7537320457961012,0.10542512367473006,1035758.5216049403,-6335.561728394945,1029422.9598765454,1368,0,355.1224489795918,74,122,43,40.76528012810017,0.53125,45.56944444444445,8141.777777777794,110.02402402402424,8
1395,32,6,2,199,0.029850746268656716,0.009950248756218905,0.9900497512437811,201,5200,3200,2000,0.6153846153846154,72,32,40,179.35768420391227,0.47181902985074625,0.7466640934895787,0.1010977557586675,1038740.1974039943,-8138.792740821309,1030601.404663173,1369,0,346.3731343283582,85,116,39,40.633517145211364,0.5342039800995024,45.203488372093,8153.488372092961,95.92339261285836,0
1396,32,2,3,198,0.009950248756218905,0.014925373134328358,0.9850746268656716,201,6000,4100,1900,0.6833333333333333,79,41,38,182.32593218821077,0.4719776119402985,0.7519370922857498,0.10328010292907801,1040285.3964145888,-8265.799071385733,1032019.597343203,1370,0,347.363184079602,88,113,42,40.36498974876835,0.5359141791044777,45.01404494382021,8159.5505617977105,92.72216547497398,0
1397,32,1,3,196,0.005025125628140704,0.01507537688442211,0.9849246231155779,199,6000,4200,1800,0.7,78,42,36,186.76028859857874,0.47165224269495626,0.7553042641650323,0.10764302050017881,1045674.5695312433,-6741.903122829877,1038932.6664084134,1371,0,351.75879396984925,80,119,44,39.579979710582364,0.542713567839196,44.35442386831278,8180.658436214044,102.25823045267555,8
1398,32,5,2,199,0.024875621890547265,0.009950248756218905,0.9900497512437811,201,6950,5200,1750,0.7482014388489209,87,52,35,184.16183019864283,0.47187085406301826,0.7553959664025569,0.10728802986875476,1048975.553206072,-8513.748457586982,1040461.804748485,1372,0,348.7213930348259,87,114,42,39.235790069807244,0.5454498341625207,43.95123106060608,8193.56060606065,94.17885754092701,0
1399,32,1,1,199,0.005,0.005,0.995,200,5700,3400,2300,0.5964912280701754,80,34,46,177.65696048114043,0.47135311976549416,0.7445353971907751,0.10033918062515272,1039364.6255376372,-8769.927959073219,1030594.6975785639,1373,0,351.305,86,114,39,40.59891796244972,0.5368229166666667,45.126915708812234,8155.938697317936,94.83649648044111,7
1400,32,1,3,197,0.005,0.015,0.985,200,6000,4600,1400,0.7666666666666667,74,46,28,177.47299234928963,0.47136149497487434,0.7448644508402209,0.10055558130427074,1040361.3639950575,-9072.791121442035,1031288.5728736155,1374,0,352.295,87,113,42,40.479257574350854,0.5386979166666667,45.00473484848483,8159.848484848431,93.79136189480955,0
1401,32,3,3,197,0.015,0.015,0.985,200,6050,3800,2250,0.628099173553719,83,38,45,179.73351110310324,0.47159128978224457,0.7488442953020138,0.10259076445894279,1042660.4369854209,-8569.795754462762,1034090.6412309582,1375,0,353.025,75,125,46,40.13495525727068,0.54125,44.72313596491229,8168.8596491228245,108.918128654971,0
1402,32,4,3,198,0.01990049751243781,0.014925373134328358,0.9850746268656716,201,6650,4800,1850,0.7218045112781954,85,48,37,201.8812259114001,0.4727155887230514,0.7754227433967134,0.11486830728686957,1041675.3906249977,-4791.059027777891,1036884.3315972198,1376,0,350.6517412935323,79,122,42,39.69262434510445,0.5320273631840796,44.84374999999999,8164.999999999982,103.3544303797466,8
1403,32,3,1,200,0.014925373134328358,0.004975124378109453,0.9950248756218906,201,5550,3900,1650,0.7027027027027027,72,39,33,198.12512194377618,0.47318718905472634,0.7713382333323902,0.11384840807966885,1044738.3159481186,-4352.218750688529,1040386.0971974301,1377,0,351.18407960199005,70,131,45,39.406183613710745,0.5346185737976783,44.46889671361504,8176.995305164352,116.81421864520503,0
1404,32,1,1,200,0.004975124378109453,0.004975124378109453,0.9950248756218906,201,7200,5600,1600,0.7777777777777778,88,56,32,198.86538302015464,0.4729000829187396,0.7730252875783994,0.11489572516077451,1046416.8934134028,-5780.78073851642,1040636.1126748864,1378,0,352.1044776119403,72,129,47,39.17798887772941,0.5374689054726368,44.263698630137,8183.561643835652,113.66057838660628,0
1405,32,4,2,202,0.0196078431372549,0.00980392156862745,0.9901960784313726,204,5850,3600,2250,0.6153846153846154,81,36,45,190.99105077118116,0.473115179980038,0.7667263213747875,0.11150737786120256,1049639.6542159824,-6555.643902037835,1043084.0103139445,1379,0,347.80392156862746,77,127,42,38.978342197194856,0.5400837418300654,43.87019230769233,8196.153846153895,106.44355644355707,0
1406,32,3,3,202,0.014634146341463415,0.014634146341463415,0.9853658536585366,205,6850,5100,1750,0.7445255474452555,86,51,35,190.04772743429857,0.47299936234656464,0.7668164172311325,0.11198802049977045,1052472.6584692742,-7845.9926142363,1044626.6658550379,1380,0,345.5170731707317,73,132,43,38.65052140504939,0.5427337398373984,43.524774774774755,8207.20720720716,112.42749598913919,0
1407,32,3,2,203,0.014634146341463415,0.00975609756097561,0.9902439024390244,205,6150,4400,1750,0.7154471544715447,79,44,35,208.17210045336265,0.47302427068388336,0.7862738272008414,0.11930798344847977,1043924.4083049882,-3686.812641723336,1040237.5956632649,1381,0,346.42439024390245,69,136,40,39.25108020196137,0.5327235772357723,44.56845238095238,8173.80952380952,118.46100759144232,8
1408,32,2,1,204,0.00975609756097561,0.004878048780487805,0.9951219512195122,205,6400,4900,1500,0.765625,79,49,30,206.08628540308095,0.473344093735055,0.7838157742740546,0.11864663190707557,1045322.0238819959,-4314.6934096254445,1041007.3304723705,1382,0,347.40487804878046,73,132,42,39.129906010206724,0.5345020325203251,44.39752252252254,8179.279279279325,112.04492163396336,0
1409,32,1,2,203,0.004878048780487805,0.00975609756097561,0.9902439024390244,205,5750,4000,1750,0.6956521739130435,75,40,35,224.40560954374058,0.4737545831340666,0.7980958768341122,0.12529504606561992,1035761.8971374488,-263.84402613782913,1035498.0531113109,1383,0,348.3853658536585,66,139,44,39.85945615643142,0.5237296747967479,45.569029850746276,8141.791044776133,123.36047037539596,8
1410,32,3,5,201,0.014563106796116505,0.024271844660194174,0.9757281553398058,206,6400,4500,1900,0.703125,83,45,38,218.6240290166285,0.4738717538874418,0.7940820463863136,0.12334540829913185,1039031.0061942742,-2168.5710305212306,1036862.435163753,1384,0,346.9805825242718,71,135,38,39.59658037167403,0.5260416666666667,45.167824074074076,8154.629629629639,114.85393844548787,0
1411,32,2,1,202,0.009852216748768473,0.0049261083743842365,0.9950738916256158,203,6850,4800,2050,0.7007299270072993,89,48,41,222.87388142093812,0.4738960965062023,0.7965743786141743,0.1264650081434238,1040819.2203039974,-1055.7161026667181,1039763.5042013307,1385,0,352.8768472906404,72,131,40,39.264201260676586,0.5272988505747127,44.9486301369863,8161.643835616442,113.35616438356169,0
1412,32,3,2,203,0.014634146341463415,0.00975609756097561,0.9902439024390244,205,7050,5200,1850,0.7375886524822695,89,52,37,216.42009946272032,0.474551649928264,0.7937515731381037,0.12426344994022595,1044494.6458604576,-2840.0729709202697,1041654.5728895373,1386,0,350.14146341463413,63,142,43,38.96913619569372,0.5308434959349593,44.49869791666666,8176.041666666647,129.77843915343885,0
1413,32,2,1,204,0.00975609756097561,0.004878048780487805,0.9951219512195122,205,5800,3900,1900,0.6724137931034483,77,39,38,214.47325420927643,0.47446098358042404,0.7919658500460593,0.12394167657657307,1046487.6670747861,-1911.276910519418,1044576.3901642667,1387,0,349.45365853658535,65,140,44,38.77000534847362,0.5332317073170731,44.2550505050505,8183.838383838367,125.90520590520565,0
1414,32,4,6,202,0.019230769230769232,0.028846153846153848,0.9711538461538461,208,6200,4400,1800,0.7096774193548387,80,44,36,210.4385528273032,0.47547089836492007,0.7896877748460862,0.12270186387930451,1049240.3214024839,-3639.877039201404,1045600.4443632824,1388,0,343.03846153846155,73,135,38,38.52998570800352,0.5360576923076923,43.91891891891892,8194.594594594597,112.25472047389859,0
1415,32,1,0,203,0.0049261083743842365,0.0,1.0,203,6900,5200,1700,0.7536231884057971,86,52,34,211.16140401281152,0.47484717683591016,0.7821371754568978,0.12249823956405077,1047674.3996511418,-3254.320564276917,1044420.079086865,1389,0,351.01477832512313,80,123,34,38.70667487519683,0.5474137931034483,44.11008230452676,8188.477366255181,102.35596707818976,8
1416,32,4,2,205,0.01932367149758454,0.00966183574879227,0.9903381642512077,207,6350,4700,1650,0.7401574803149606,80,47,33,211.49656346562566,0.47481258696433876,0.7848047389992565,0.1263303276990132,1056602.353187858,-3056.4466702146747,1053545.9065176432,1390,0,345.21256038647346,82,125,33,37.587093833431005,0.5540962157809983,43.02208835341367,8223.29317269081,100.28406308159525,8
1417,32,1,4,202,0.0048543689320388345,0.019417475728155338,0.9805825242718447,206,7050,5100,1950,0.723404255319149,90,51,39,211.07517412883553,0.47479181466571946,0.7828597117225322,0.12656668272069513,1057771.9170511402,-3596.1216839674616,1054175.7953671727,1391,0,347.86407766990294,84,122,35,37.45273501421925,0.5557241100323624,42.87990196078433,8227.84313725495,97.95051353874939,0
1418,32,0,1,201,0.0,0.0049504950495049506,0.995049504950495,202,7100,5800,1300,0.8169014084507042,84,58,26,219.80432194612771,0.474190516066532,0.7840967111344812,0.12820819858483104,1049349.0466412771,-1369.708863639522,1047979.3377776376,1392,1,352.6089108910891,86,116,37,38.27658687487337,0.5458952145214522,43.90565134099619,8195.019157088174,95.29092043125785,8
1419,32,1,2,200,0.0049504950495049506,0.009900990099009901,0.9900990099009901,202,5900,4200,1700,0.711864406779661,76,42,34,220.6242316070549,0.4736502101702708,0.7856197264861535,0.12914276148379186,1050435.19375858,50.29149519909333,1050485.485253779,1393,0,353.5990099009901,89,113,41,38.12016291745718,0.5474938118811881,43.77314814814817,8199.25925925931,92.12650853100348,0
1420,32,3,3,200,0.014778325123152709,0.014778325123152709,0.9852216748768473,203,7550,6300,1250,0.8344370860927153,88,63,25,225.35234244539419,0.47358719862133997,0.7895650875144007,0.1317653071281106,1050097.8027782089,-821.6000694334216,1049276.2027087754,1394,0,350.86206896551727,80,123,38,38.04109566119508,0.5454125615763548,43.81430041152266,8197.942386831337,102.47427983539171,7
1421,32,1,1,200,0.004975124378109453,0.004975124378109453,0.9950248756218906,201,6400,4300,2100,0.671875,85,43,42,230.90539625878066,0.47254042288557213,0.7958723592039252,0.13450401333053652,1048939.8210266684,1841.1730051557279,1050780.9940318242,1395,0,355.21890547263683,75,126,37,38.04338855878522,0.5415630182421227,43.95559210526318,8193.42105263163,109.2456140350884,8
1422,32,2,4,198,0.009900990099009901,0.019801980198019802,0.9801980198019802,202,5750,4200,1550,0.7304347826086957,73,42,31,225.73838982872104,0.472888240316569,0.7939436582649273,0.1306474785781218,1046950.5563325199,1117.386563357386,1048067.9428958773,1396,0,354.3712871287129,71,131,45,38.42407339328468,0.540016501650165,44.198495370370374,8185.648148148156,115.2908189880022,8
1423,32,1,4,195,0.005025125628140704,0.020100502512562814,0.9798994974874372,199,6800,4700,2100,0.6911764705882353,89,47,42,227.81455544915607,0.4727488452362824,0.7918710504189714,0.13258442623852212,1048663.6414708665,1180.1682594759577,1049843.8097303424,1397,0,360.40201005025125,73,126,37,38.15700546177672,0.5419807370184255,43.989301801801815,8192.342342342374,112.2238677033202,0
1424,32,3,2,196,0.015151515151515152,0.010101010101010102,0.98989898989899,198,6750,4800,1950,0.7111111111111111,87,48,39,226.63172304690173,0.4728006588729939,0.7911373923200464,0.13350697773579248,1052384.314326218,1350.734092656452,1053735.0484188746,1398,0,361.67676767676767,67,131,39,37.72324095090192,0.5449810606060606,43.53553921568626,8206.862745098018,122.49048873280624,0
1425,32,3,3,196,0.01507537688442211,0.01507537688442211,0.9849246231155779,199,5750,3500,2250,0.6086956521739131,80,35,45,220.6214084505747,0.4730375361656769,0.7867796889420717,0.13106907378897562,1054958.7979034993,999.2991701587825,1055958.0970736581,1399,0,360.6532663316583,72,127,44,37.556960266740774,0.5473722780569514,43.2220319634703,8216.894977168904,114.12354134956811,0
1426,32,0,4,192,0.0,0.02040816326530612,0.9795918367346939,196,7100,5200,1900,0.7323943661971831,90,52,38,240.75795446680252,0.472108843537415,0.7968132801548089,0.14026290674542755,1048983.0138478011,4210.2009368838535,1053193.214784685,1400,1,363.8265306122449,77,119,33,37.785720805299135,0.5391156462585034,43.950320512820525,8193.589743589773,106.41025641025679,8
1427,32,0,3,189,0.0,0.015625,0.984375,192,5400,4000,1400,0.7407407407407407,68,40,28,237.6690533988047,0.47123713823443864,0.7914304426024374,0.13890822005776665,1049968.0514464239,6108.982577252159,1056077.034023676,1401,2,371.7239583333333,77,115,37,37.74176311125013,0.5406901041666667,43.830128205128226,8197.435897435953,106.46020646020717,0
1428,32,3,1,191,0.015625,0.005208333333333333,0.9947916666666666,192,6150,4500,1650,0.7317073170731707,78,45,33,229.77960635396553,0.47052360565735896,0.7838113770488497,0.135203533628111,1052027.8311489811,3796.9081829657844,1055824.739331947,1402,0,372.40625,66,126,38,37.686947998140624,0.54296875,43.57898009950249,8205.472636815917,124.32534298205935,0
1429,32,2,2,191,0.010362694300518135,0.010362694300518135,0.9896373056994818,193,7450,6000,1450,0.8053691275167785,89,60,29,237.78007722012703,0.4711461481721359,0.800483689090163,0.13537359774803273,1041857.6530612266,3496.598639455878,1045354.2517006824,1403,0,371.43523316062175,69,124,40,38.75379052950782,0.531034110535406,44.82142857142858,8165.714285714303,118.34368530020728,8
1430,32,4,2,193,0.020512820512820513,0.010256410256410256,0.9897435897435898,195,5550,4200,1350,0.7567567567567568,69,42,27,226.63010487835538,0.47164287602431937,0.7931248238940545,0.13063894800069792,1045712.8258596098,2848.001479441139,1048560.827339051,1404,0,365.57948717948716,65,130,43,38.55594312054989,0.5344017094017094,44.34974747474749,8180.8080808081095,125.8585858585863,0
1431,32,6,0,199,0.03015075376884422,0.0,1.0,199,5950,4000,1950,0.6722689075630253,79,40,39,206.73037255413394,0.4731030996734514,0.7812256972786462,0.1179807433773485,1042608.6336043637,-2642.2257493627712,1039966.4078550009,1405,0,358.8994974874372,66,133,40,39.45226059240312,0.5308835845896147,44.72947761194029,8168.6567164178905,123.76752600633168,8
1432,32,3,2,200,0.01485148514851485,0.009900990099009901,0.9900990099009901,202,6300,4600,1700,0.7301587301587301,80,46,34,200.42938623143232,0.4742012913977965,0.7775545350172228,0.11530646988611473,1045098.249906324,-4806.319843946261,1040291.9300623777,1406,0,354.55445544554453,70,132,40,39.30240623804059,0.5330548679867987,44.424882629107984,8178.403755868546,116.83433936955066,0
1433,32,1,2,199,0.004975124378109453,0.009950248756218905,0.9900497512437811,201,6600,5000,1600,0.7575757575757576,82,50,32,199.0151220343574,0.4739925373134328,0.775017470989394,0.11500339494657165,1046473.7034331656,-5147.1816411003465,1041326.5217920652,1407,0,356.1940298507463,73,128,45,39.16707948040511,0.5347740464344942,44.256756756756765,8183.783783783805,112.10662717512062,0
1434,32,1,4,196,0.005,0.02,0.98,200,7400,5700,1700,0.7702702702702703,91,57,34,199.3098267715125,0.4734238902847571,0.7700263968323802,0.11586476630477013,1048317.7096015019,-5611.995779562797,1042705.7138219392,1408,0,356.065,73,127,37,38.92982842058954,0.5372395833333333,44.03153153153156,8190.990990991058,112.2053560409734,8
1435,32,0,2,194,0.0,0.01020408163265306,0.9897959183673469,196,6500,4600,1900,0.7076923076923077,84,46,38,204.65050036044607,0.47283435810221525,0.7718934991967927,0.1195470592896309,1049806.0957079686,-2731.3314463836946,1047074.7642615848,1409,1,361.25,72,124,39,38.60776094182311,0.5389562074829932,43.84988584474885,8196.803652968016,113.84449518011132,0
1436,32,0,3,191,0.0,0.015463917525773196,0.9845360824742269,194,5850,4400,1450,0.7521367521367521,73,44,29,205.12327404207775,0.4723277558178873,0.7715352191356448,0.12034689199578591,1051142.7405366835,-1527.2319151104575,1049615.508621573,1410,2,365.41752577319585,65,129,44,38.42928981937605,0.5404317010309279,43.6868686868687,8202.02020202023,126.18492618492662,0
1437,32,3,0,194,0.015463917525773196,0.0,1.0,194,6700,4300,2400,0.6417910447761194,91,43,48,202.06527606015752,0.4717629934298382,0.7695739385381188,0.11967492754994515,1054019.281195938,-2903.860594482681,1051115.4206014553,1411,0,366.3298969072165,67,127,39,38.15011688053318,0.5428479381443299,43.33639705882354,8213.235294117676,122.58560140474144,0
1438,32,3,4,193,0.015228426395939087,0.02030456852791878,0.9796954314720813,197,5700,4000,1700,0.7017543859649122,74,40,34,195.9459136243576,0.4723639455782313,0.7655300197175308,0.11698135703805773,1056446.1196041247,-3698.739979852441,1052747.3796242722,1412,0,361.73604060913704,71,126,37,38.00608308466119,0.5454737732656514,43.04108796296297,8222.685185185193,115.81246739697455,0
1439,32,2,2,193,0.010256410256410256,0.010256410256410256,0.9897435897435898,195,6500,4700,1800,0.7230769230769231,83,47,36,195.31540040854992,0.47173869944488506,0.7631490279322075,0.11703544859126518,1057562.089116145,-4188.3674214754765,1053373.7216946695,1413,0,366.18461538461537,73,122,41,37.8839520367937,0.5470619658119658,42.90540540540541,8227.027027027041,112.69900037023343,0
1440,32,0,1,192,0.0,0.0051813471502590676,0.9948186528497409,193,5900,4200,1700,0.711864406779661,76,42,34,197.29784676174143,0.4716060377086932,0.763605750322754,0.11863190371429132,1058604.621302049,-2727.9175290152157,1055876.7037730338,1414,1,370.74093264248705,73,120,41,37.70379567303311,0.5485751295336787,42.77871621621623,8231.08108108111,112.75453535727549,0
1441,32,1,1,192,0.0051813471502590676,0.0051813471502590676,0.9948186528497409,193,6250,4300,1950,0.688,82,43,39,203.1041484342311,0.4711630145365573,0.7703564923429553,0.1230262209380539,1060824.2660575276,-1758.4381608034405,1059065.8278967242,1415,0,371.68911917098444,67,126,41,37.279446030896175,0.550626079447323,42.509191176470594,8239.705882352955,122.98068481123813,0
1442,32,1,3,190,0.0051813471502590676,0.015544041450777202,0.9844559585492227,193,5400,3700,1700,0.6851851851851852,71,37,34,197.29797544446586,0.4711641389608521,0.763450053784283,0.12006053516132119,1062206.0355088338,-2085.7799378426857,1060120.2555709912,1416,0,372.5854922279793,70,123,42,37.25800022776451,0.5525151122625216,42.34154929577467,8245.07042253526,117.7867203219323,0
1443,32,0,0,190,0.0,0.0,1.0,190,6000,4500,1500,0.75,75,45,30,198.69216520912673,0.4708083867075095,0.7619833769782527,0.12110432248659048,1062689.9562476638,-1770.366329431668,1060919.589918232,1417,1,378.5684210526316,70,120,43,37.162226270446695,0.5540021929824561,42.28286384976528,8246.948356807556,117.81354795439366,0
1444,32,1,0,191,0.005235602094240838,0.0,1.0,191,5500,3900,1600,0.7090909090909091,71,39,32,196.91452004594575,0.47084825939193536,0.7613184124273427,0.12074039566996343,1064477.440003339,-1777.7871604009815,1062699.652842938,1418,0,377.5811518324607,72,119,40,36.98711920041309,0.5557918848167539,42.06621004566211,8253.881278538836,114.63723997970607,0
1445,32,1,1,191,0.005208333333333333,0.005208333333333333,0.9947916666666666,192,6100,4100,2000,0.6721311475409836,81,41,40,194.17404406118658,0.47062699970913324,0.7591656820314021,0.11961044892758312,1065852.4768438397,-3107.822839719683,1062744.65400412,1419,0,376.609375,75,117,41,36.88803258810829,0.5574001736111112,41.89967105263159,8259.210526315814,110.12280701754418,0
1446,32,1,6,186,0.005208333333333333,0.03125,0.96875,192,5800,4200,1600,0.7241379310344828,74,42,32,195.66020166251084,0.4704275968949971,0.7613702826978377,0.12126475832870144,1067668.779153093,-2419.9422724277906,1065248.8368806653,1420,0,377.5,78,114,43,36.625555101832454,0.5592990451388888,41.67985232067511,8266.244725738406,105.97749648382572,0
1447,32,2,3,185,0.010638297872340425,0.015957446808510637,0.9840425531914894,188,5500,3700,1800,0.6727272727272727,73,37,36,202.33661207799537,0.4701443802859635,0.7581499659876796,0.12118671553182021,1057422.4891057278,-308.94320385340507,1057113.5459018743,1421,0,379.968085106383,72,116,43,37.72075284931911,0.5488142730496454,42.92237442922373,8226.48401826481,114.25672247590013,8
1448,32,1,0,186,0.005376344086021506,0.0,1.0,186,5850,4500,1350,0.7692307692307693,72,45,27,200.2586153832071,0.4700728954761213,0.7531600526030799,0.12032830347953445,1058394.2445031095,-659.4868132505699,1057734.757689859,1422,0,383.85483870967744,75,111,45,37.65371036504127,0.5502912186379929,42.80427631578945,8230.263157894684,109.73684210526245,0
1449,32,0,1,185,0.0,0.005376344086021506,0.9946236559139785,186,6200,4400,1800,0.7096774193548387,80,44,36,202.15024980344037,0.46985796280151115,0.752955686912608,0.12217451370311296,1060150.6018702218,-538.058200533359,1059612.5436696885,1423,1,384.85483870967744,70,116,43,37.38743231689939,0.5521393369175627,42.59096244131456,8237.08920187795,117.67270288397071,0
1450,32,0,1,184,0.0,0.005405405405405406,0.9945945945945946,185,6000,4400,1600,0.7333333333333333,76,44,32,215.53526978021677,0.469939776733255,0.7741743267270313,0.1264623483047264,1051158.9219835077,2312.3643663194794,1053471.2863498272,1424,2,387.1675675675676,63,122,43,38.16040132080264,0.5438626126126126,43.684895833333336,8202.08333333334,130.19179894179905,7
1451,32,7,3,188,0.03664921465968586,0.015706806282722512,0.9842931937172775,191,6200,4600,1600,0.7419354838709677,78,46,32,203.2031693687774,0.4711640029392854,0.7684538980633,0.12129857901584087,1056407.5828208695,-1466.926205117974,1054940.6566157516,1425,0,375.94240837696333,70,121,40,37.82438335046252,0.5479930191972077,43.04577464788733,8222.535211267612,117.46478873239445,0
1452,32,0,0,188,0.0,0.0,1.0,188,6500,4300,2200,0.6615384615384615,87,43,44,212.65931824854087,0.47035771513634467,0.7753959557219532,0.12705031064592362,1056663.062283741,841.8492887353186,1057504.9115724764,1426,1,382.9414893617021,67,121,41,37.54967413765696,0.5489250886524824,43.014705882352956,8223.529411764737,122.7392449517125,0
1453,32,1,1,188,0.005291005291005291,0.005291005291005291,0.9947089947089947,189,6150,3800,2350,0.6178861788617886,85,38,47,210.46158417754634,0.47058168223948366,0.7742747652366755,0.12658153663258823,1058686.9041576274,612.5845994074853,1059299.4887570348,1427,0,381.9100529100529,68,121,43,37.35498953381457,0.5509259259259259,42.7687198067633,8231.400966183608,121.05001420858247,0
1454,32,1,0,189,0.005291005291005291,0.0,1.0,189,6300,4700,1600,0.746031746031746,79,47,32,205.50663445148263,0.470806831400803,0.7685398492928064,0.12417961101405106,1060093.8400737196,-528.7365447402021,1059565.1035289795,1428,0,382.46560846560845,65,124,44,37.308068653299806,0.5530753968253967,42.59785353535354,8236.868686868707,126.72105672105704,0
1455,32,2,1,190,0.010471204188481676,0.005235602094240838,0.9947643979057592,191,6100,4500,1600,0.7377049180327869,77,45,32,196.5072484843895,0.4710847800128594,0.7577475764659269,0.11533695285731949,1051262.5344978992,-2983.858382218802,1048278.6761156805,1429,0,379.4502617801047,66,125,47,38.63523786417582,0.5424301919720769,43.67226368159201,8202.487562188982,124.28011457862094,8
1456,32,2,3,189,0.010416666666666666,0.015625,0.984375,192,6050,3800,2250,0.628099173553719,83,38,45,223.7956241377304,0.4715058491492146,0.7840821359297645,0.1271203268333505,1041143.8829210022,2150.6890190969484,1043294.5719400991,1430,0,377.59375,79,113,36,39.20002594728868,0.5340169270833333,44.90885416666665,8162.91666666663,103.32805907172948,8
1457,32,3,2,190,0.015625,0.010416666666666666,0.9895833333333334,192,6200,4800,1400,0.7741935483870968,76,48,28,220.38469178022288,0.47142347476730656,0.7802631478774593,0.12577324485017338,1042608.6336043692,1354.9964728597456,1043963.630077229,1431,0,377.5520833333333,66,126,40,39.103706072233386,0.5363498263888888,44.72947761194031,8168.656716417934,123.76752600633233,0
1458,32,3,1,192,0.015544041450777202,0.0051813471502590676,0.9948186528497409,193,5000,3100,1900,0.62,69,31,38,214.8531337453038,0.4718129317789292,0.7752379445022262,0.12341300057085186,1044618.351737976,1287.9052877518538,1045906.2570257278,1432,0,375.8238341968912,70,123,43,38.99371746286943,0.5383743523316062,44.48356807511739,8176.525821596284,116.80751173708977,0
1459,32,2,0,194,0.010309278350515464,0.0,1.0,194,6250,4300,1950,0.688,82,43,39,208.96897275405,0.47209406103662555,0.7707074678760062,0.12115008644014358,1047480.4266697504,-1271.8182517694236,1046208.608417981,1433,0,374.4587628865979,75,119,35,38.786961645596776,0.5410760309278351,44.13377192982458,8187.71929824566,109.16959064327547,0
1460,32,1,3,192,0.005128205128205128,0.015384615384615385,0.9846153846153847,195,6450,5200,1250,0.8062015503875969,77,52,25,206.6356470995898,0.4718664640056393,0.7585019275533997,0.12007746834814359,1048199.7913258994,-2130.911565943633,1046068.8797599558,1434,0,373.53333333333336,87,108,35,38.7570045013797,0.5462072649572649,44.045928030303024,8190.53030303029,94.14402647161253,7
1461,32,1,3,190,0.0051813471502590676,0.015544041450777202,0.9844559585492227,193,5450,3500,1950,0.6422018348623854,74,35,39,192.88555104543272,0.47108880253310303,0.7539476198812962,0.11105097733934474,1045333.6832817105,-3724.0472947708513,1041609.6359869397,1435,0,378.3626943005181,78,115,42,39.46586707935688,0.5428000863557858,44.39609704641352,8179.324894514824,104.86313967326699,8
1462,32,2,1,191,0.010416666666666666,0.005208333333333333,0.9947916666666666,192,5950,4700,1250,0.7899159663865546,72,47,25,194.8068422870357,0.4708900296320535,0.7547734965172157,0.1128860797857743,1047334.4079127841,-3544.4182351893473,1043789.9896775947,1436,0,377.1822916666667,82,110,37,39.167504660060835,0.5449761284722222,44.15160642570284,8187.148594377577,99.84327554118997,0
1463,32,3,0,194,0.015463917525773196,0.0,1.0,194,5950,4000,1950,0.6722689075630253,79,40,39,190.1642513326977,0.4713440120720047,0.7522333194042896,0.11091428319799346,1049334.2145341423,-4840.828939065663,1044493.3855950766,1437,0,374.2783505154639,85,109,41,39.03749664979742,0.5469823883161512,43.907461240310106,8194.961240310155,96.41130870953123,0
1464,32,1,2,193,0.005128205128205128,0.010256410256410256,0.9897435897435898,195,6300,4500,1800,0.7142857142857143,81,45,36,189.0919901037917,0.4712078156665786,0.7534019111571739,0.11092326343057768,1051093.088655359,-5549.3432163636335,1045543.7454389954,1438,0,373.3538461538462,72,123,45,38.84636083583862,0.5488782051282051,43.6929223744292,8201.826484018211,113.91425672247516,0
1465,32,3,1,195,0.015306122448979591,0.00510204081632653,0.9948979591836735,196,6750,5000,1750,0.7407407407407407,85,50,35,182.6292347072161,0.47146727280655853,0.7450820376256349,0.10808271078935941,1053790.9617436356,-7459.3926230757625,1046331.5691205598,1439,0,368.5408163265306,80,116,46,38.67727751052316,0.5524553571428572,43.364197530864196,8212.345679012338,102.65432098765423,0
1466,32,0,0,195,0.0,0.0,1.0,195,6250,4300,1950,0.688,82,43,39,186.64767055825186,0.47109547096660503,0.7492507097137564,0.11090229314122545,1055004.5545806026,-5867.171491837078,1049137.3830887654,1440,1,371.35897435897436,81,114,47,38.42365852049736,0.5536858974358974,43.216463414634134,8217.073170731674,101.44534778681079,0
1467,32,2,4,193,0.01015228426395939,0.02030456852791878,0.9796954314720813,197,6700,5100,1600,0.7611940298507462,83,51,32,190.0471246622369,0.47126001415794744,0.7556576635050485,0.11360619148038206,1056837.0324113402,-5930.232150730841,1050906.8002606092,1441,0,368.5786802030457,83,114,39,38.109217933252935,0.555520304568528,42.993551587301575,8224.206349206317,99.08682348441346,0
1468,32,1,4,190,0.005154639175257732,0.020618556701030927,0.979381443298969,194,6150,4900,1250,0.7967479674796748,74,49,25,191.53749483666027,0.47069578726207645,0.7543412855378795,0.11508858535905693,1058395.5411143368,-4405.51390173383,1053990.027212603,1442,0,372.7113402061856,86,108,41,37.87785329671183,0.5584192439862543,42.80411877394635,8230.268199233686,95.70079301434518,0
1469,32,1,1,190,0.005235602094240838,0.005235602094240838,0.9947643979057592,191,6050,4200,1850,0.6942148760330579,79,42,37,188.11179430292583,0.46974832368880315,0.7465997795566113,0.11354400578542051,1059763.5927735153,-4379.193805291801,1055384.3989682235,1443,0,378.9842931937173,73,118,43,37.79666675782604,0.5604275741710296,42.63795045045045,8235.585585585573,112.81624089843251,0
1470,32,1,1,190,0.005235602094240838,0.005235602094240838,0.9947643979057592,191,5450,3900,1550,0.7155963302752294,70,39,31,180.86719332270764,0.4694543951501791,0.7359488403856027,0.1097408921448819,1061329.210069442,-5258.072916666757,1056071.1371527752,1444,0,379.5445026178011,75,116,49,37.78964442197504,0.5616273996509599,42.44791666666666,8241.666666666646,109.88888888888862,0
1471,32,0,1,189,0.0,0.005263157894736842,0.9947368421052631,190,5700,4100,1600,0.7192982456140351,73,41,32,180.67501900749477,0.4691363826232247,0.7346570791028586,0.1099666819157913,1062264.9686792248,-5315.051318577305,1056949.9173606476,1445,1,381.4315789473684,77,113,46,37.6790280225286,0.5632127192982457,42.33440170940169,8245.299145299092,107.08180708180639,0
1472,32,3,0,192,0.015625,0.0,1.0,192,5300,3600,1700,0.6792452830188679,70,36,34,212.0094906096278,0.4695930591913903,0.7684299080419528,0.12700874218690575,1057490.6036723673,1139.6088418089575,1058630.2125141763,1446,0,378.0833333333333,80,112,41,37.46362946659328,0.5556640625,42.91409465020574,8226.748971193365,102.83436213991706,8
1473,32,0,1,191,0.0,0.005208333333333333,0.9947916666666666,192,5450,3000,2450,0.5504587155963303,79,30,49,209.71324932350043,0.4693413912521815,0.7649324305321206,0.1260406405163343,1058469.449266969,545.0135030861693,1059014.462770055,1447,1,379.0833333333333,83,109,41,37.401212172347876,0.5569118923611112,42.79513888888887,8230.555555555506,99.16331994645188,0
1474,32,2,4,189,0.010362694300518135,0.02072538860103627,0.9792746113989638,193,6150,3900,2250,0.6341463414634146,84,39,45,211.18626683834154,0.46947525367012094,0.7686826168550414,0.1280133056839169,1061039.1937545626,65.3812596378666,1061104.5750142005,1448,0,378.0880829015544,73,120,45,37.04470500346197,0.5590997409326425,42.4831081081081,8240.54054054052,112.88411699370575,0
1475,32,0,1,188,0.0,0.005291005291005291,0.9947089947089947,189,5650,3900,1750,0.6902654867256637,74,39,35,211.36327559130925,0.4690560621411685,0.7656467995228782,0.12851729800239686,1061967.3854597847,1442.181032383769,1063409.5664921685,1449,1,386.3809523809524,73,116,45,36.92515389939169,0.560626102292769,42.3704954954955,8244.14414414415,112.93348142663218,0
1476,32,1,1,188,0.005291005291005291,0.005291005291005291,0.9947089947089947,189,5450,3700,1750,0.6788990825688074,72,37,35,211.01169156358378,0.46876876243010995,0.7665244500544304,0.12887752573582373,1063304.694444446,1623.9444444445112,1064928.6388888904,1450,0,386.43386243386243,74,115,44,36.76862776790041,0.562334656084656,42.208333333333336,8249.333333333345,111.47747747747763,0
1477,32,1,0,189,0.005291005291005291,0.0,1.0,189,6400,4400,2000,0.6875,84,44,40,212.72760410222836,0.468329017974408,0.7693133898439546,0.1308048459266894,1065318.8775510208,1124.546485260761,1066443.4240362816,1451,0,387.36507936507934,76,113,38,36.475153787005,0.564373897707231,41.964285714285715,8257.14285714286,108.64661654135342,0
1478,32,1,1,189,0.005263157894736842,0.005263157894736842,0.9947368421052631,190,7250,5500,1750,0.7586206896551724,90,55,35,210.80053407358767,0.4680671586373341,0.7696905060211017,0.13051146342217348,1067357.7648886233,-250.08262277755875,1067107.6822658456,1452,0,386.32105263157894,81,109,41,36.272870352154214,0.5667763157894736,41.71747967479674,8265.040650406494,102.03753889390734,0
1479,32,3,1,191,0.015625,0.005208333333333333,0.9947916666666666,192,6800,5100,1700,0.75,85,51,34,217.66394404333485,0.46795182064426993,0.7764022990716533,0.13037769330300678,1057447.7497596464,833.6495664864628,1058281.3993261328,1453,0,383.1197916666667,78,114,39,37.32358397018342,0.5528971354166667,42.91930379746833,8226.582278480953,105.46900357026864,8
1480,32,0,0,191,0.0,0.0,1.0,191,6050,4100,1950,0.6776859504132231,80,41,39,223.85896227449203,0.4676506383760448,0.782497808574788,0.13467220518425996,1058760.544738263,3152.6073684564453,1061913.1521067193,1454,1,385.64921465968587,80,111,40,37.00122065023578,0.5548102094240838,42.759773662551424,8231.687242798313,102.89609053497891,0
1481,32,2,1,192,0.010362694300518135,0.0051813471502590676,0.9948186528497409,193,5050,3400,1650,0.6732673267326733,67,34,33,217.27936795006696,0.4675907185521013,0.7790026888219217,0.13174109656744482,1061117.6167923037,2461.7930194626674,1063579.4098117664,1455,0,382.64248704663214,70,123,40,36.87807402343378,0.5568329015544041,42.473591549295776,8240.84507042254,117.72635814889342,0
1482,32,0,1,191,0.0,0.005208333333333333,0.9947916666666666,192,4900,3200,1700,0.6530612244897959,66,32,34,216.96427729416683,0.4667735829333915,0.7769492944831193,0.132167158247733,1062521.915723598,2805.8599108369945,1065327.775634435,1456,1,385.109375,71,121,41,36.71214162736733,0.5589735243055556,42.303240740740755,8246.296296296328,116.14501825769477,0
1483,32,1,1,191,0.005208333333333333,0.005208333333333333,0.9947916666666666,192,6500,5100,1400,0.7846153846153846,79,51,28,217.98185070367487,0.4668264161576498,0.7810400328799565,0.1324608997462919,1061784.5277267685,1389.9512804819087,1063174.4790072504,1457,0,385.8229166666667,65,127,44,36.777304660376586,0.5558810763888888,42.39267676767679,8243.43434343439,126.82206682206754,8
1484,32,0,1,190,0.0,0.005235602094240838,0.9947643979057592,191,6700,4500,2200,0.6716417910447762,89,45,44,217.6645307729571,0.46663451823275465,0.7788949869063957,0.13304491254619133,1063538.836962364,1398.9363812462298,1064937.77334361,1458,1,385.75392670157066,68,123,45,36.56812370691341,0.5576461605584642,42.179951690821284,8250.24154589378,121.32708155726147,0
1485,32,1,1,190,0.005235602094240838,0.005235602094240838,0.9947643979057592,191,6150,4500,1650,0.7317073170731707,78,45,33,219.1656519479688,0.46646459079636265,0.7789683761533828,0.1344511686165108,1064626.741277087,2315.922766647025,1066942.664043734,1459,0,386.23560209424085,70,121,38,36.39470291586091,0.5598276614310645,42.04812206572771,8254.460093896741,117.92085848423916,0
1486,32,0,1,189,0.0,0.005263157894736842,0.9947368421052631,190,6050,4400,1650,0.7272727272727273,77,44,33,223.41572387589787,0.4658474890931031,0.7813917882861117,0.13731485789000653,1065184.225203813,3545.7809470195143,1068730.0061508326,1460,3,389.2684210526316,72,118,39,36.216034361980604,0.5610745614035088,41.98059360730594,8256.621004566223,114.67529173008643,0
1487,32,0,1,188,0.0,0.005291005291005291,0.9947089947089947,189,5200,3800,1400,0.7307692307692307,66,38,28,222.2908967696516,0.46526605125895903,0.7801500199821692,0.13718270880326341,1066400.4444444475,4410.222222222412,1070810.66666667,1461,4,391.76190476190476,74,115,41,36.09452334839682,0.562665343915344,41.83333333333334,8261.333333333358,111.63963963963997,0
1488,32,2,0,190,0.010526315789473684,0.0,1.0,190,5850,4300,1550,0.7350427350427351,74,43,31,236.6788638791641,0.4659861459203565,0.7966222896691266,0.1406119924336611,1054966.0133136078,6087.6314924391045,1061053.644806047,1462,0,390.55263157894734,64,126,39,37.14374128856435,0.5479714912280702,43.22115384615384,8216.923076923063,128.38942307692287,8
1489,32,3,2,191,0.015544041450777202,0.010362694300518135,0.9896373056994818,193,6250,4100,2150,0.656,84,41,43,228.9858654061634,0.4666563219631548,0.7928555896313081,0.1371137201002239,1057347.0273526039,3573.504818593932,1060920.5321711977,1463,0,385.46632124352334,69,124,38,37.04504341534008,0.5503022452504318,42.931547619047606,8226.190476190446,119.22015182884705,0
1490,32,0,0,191,0.0,0.0,1.0,191,5700,4000,1700,0.7017543859649122,74,40,34,201.41097238332372,0.4661327730320566,0.7638923015858015,0.11870391351102208,1052524.0054869626,-1502.023319616249,1051021.9821673464,1464,1,390.5026178010471,71,120,42,38.35270006016844,0.5532831588132635,43.5185185185185,8207.407407407361,115.5972874282727,8
1491,32,2,3,190,0.010362694300518135,0.015544041450777202,0.9844559585492227,193,6700,4500,2200,0.6716417910447762,89,45,44,214.85952047764638,0.4661525798791019,0.7767804511548639,0.12926467206462516,1058775.6676744719,197.60644998707357,1058973.274124459,1465,0,387.44559585492226,83,110,40,37.230845867078024,0.5579123488773747,42.75793650793649,8231.74603174599,99.17766303308422,8
1492,32,1,1,190,0.005235602094240838,0.005235602094240838,0.9947643979057592,191,7100,5500,1600,0.7746478873239436,87,55,32,217.98820266733213,0.46603632773032055,0.7785535379420669,0.13165484475975997,1059940.9031382187,910.9224817379181,1060851.8256199567,1466,0,391.36649214659684,67,124,38,37.00576320279333,0.5597731239092496,42.61642156862746,8236.274509803941,122.92947029558121,0
1493,32,0,3,187,0.0,0.015789473684210527,0.9842105263157894,190,5600,3900,1700,0.6964285714285714,73,39,34,216.56457517990123,0.4658892601875058,0.7762341809580122,0.13129596179162967,1061090.74931413,2358.9334705076067,1063449.6827846377,1467,1,394.31052631578945,71,119,41,36.899812734082374,0.5609649122807018,42.476851851851855,8240.74074074075,116.0667709963486,0
1494,32,0,3,184,0.0,0.016042780748663103,0.983957219251337,187,5950,4100,1850,0.6890756302521008,78,41,37,217.22693763422515,0.4653065282809116,0.7729209499121004,0.13228730273892664,1062431.6334916025,2807.754037821755,1065239.3875294242,1468,2,399.1016042780749,73,114,42,36.716559233766745,0.5623885918003565,42.3141891891892,8245.945945945969,112.95816364309546,0
1495,32,0,1,183,0.0,0.005434782608695652,0.9945652173913043,184,5750,3800,1950,0.6608695652173913,77,38,39,220.3987279817243,0.4649900758295715,0.7713892542060263,0.1347390468659154,1063589.6411636278,4332.760801400442,1067922.4019650284,1469,3,405.6902173913044,75,109,40,36.491337072280416,0.5641417572463768,42.17379385964912,8250.43859649123,110.00584795321642,0
1496,32,3,3,183,0.016129032258064516,0.016129032258064516,0.9838709677419355,186,5900,4700,1200,0.7966101694915254,71,47,24,219.05251605331594,0.4649266201685556,0.7717666246716084,0.13473565372888321,1065411.03515625,3576.1935763888605,1068987.2287326388,1470,0,402.2795698924731,79,107,37,36.300543277155455,0.5660842293906809,41.953125,8257.5,104.5253164556962,0
1497,32,0,2,181,0.0,0.01092896174863388,0.9890710382513661,183,5500,3800,1700,0.6909090909090909,72,38,34,220.10760565592412,0.4641681178566424,0.7694644028224245,0.13540717173159586,1065460.6601331371,4803.198964497093,1070263.8590976342,1471,1,409.62841530054646,77,106,37,36.26717512808568,0.5675091074681239,41.94711538461539,8257.692307692316,107.24275724275735,0
1498,32,1,0,182,0.005494505494505495,0.0,1.0,182,6100,4100,2000,0.6721311475409836,81,41,40,220.4790796166977,0.4641370944893044,0.7686546893686463,0.13614635313700937,1066579.0989024222,4531.675612882697,1071110.774515305,1472,0,412.45604395604397,78,104,38,36.119197180940695,0.5690819597069596,41.8117088607595,8262.025316455718,105.92340149302203,0
1499,32,1,1,182,0.00546448087431694,0.00546448087431694,0.994535519125683,183,6250,4400,1850,0.704,81,44,37,218.90960167267377,0.46398546808382873,0.7694893219778383,0.13595271198220238,1068277.030969221,3921.219865107894,1072198.2508343288,1473,0,411.1967213114754,68,115,41,35.949793565474806,0.5709244080145719,41.60628019323673,8268.599033816452,121.59704461494782,0
1500,32,1,1,182,0.00546448087431694,0.00546448087431694,0.994535519125683,183,4550,3200,1350,0.7032967032967034,59,32,27,197.7542004835999,0.46388413499069237,0.7471722431729366,0.1196335463500001,1060442.271604937,791.3827160492515,1061233.6543209862,1474,0,412.07650273224044,74,109,40,37.46448352754997,0.5618738615664844,42.55555555555555,8238.222222222212,111.32732732732718,8
1501,32,1,2,181,0.00546448087431694,0.01092896174863388,0.9890710382513661,183,7600,6100,1500,0.8026315789473685,91,61,30,198.80068091882063,0.4638140775435857,0.7477351334651186,0.12110502624952399,1062528.1133458898,-1953.7375142894252,1060574.3758316005,1475,0,413.0655737704918,76,107,40,37.179445115229164,0.5638661202185793,42.30248917748918,8246.32034632035,108.50421508316249,0
1502,32,0,2,179,0.0,0.011049723756906077,0.988950276243094,181,5950,4400,1550,0.7394957983193278,75,44,31,202.96522666384791,0.4635947411499897,0.7472112492962322,0.12435483684429655,1064247.9362992174,1051.0647235006036,1065299.001022718,1476,1,413.646408839779,77,104,45,36.85942246616956,0.5660681399631675,42.09401709401709,8252.991452991446,107.18170718170708,0
1503,32,0,4,175,0.0,0.0223463687150838,0.9776536312849162,179,6400,4700,1700,0.734375,81,47,34,203.35173625225016,0.46272205134643146,0.7467559096022733,0.125135212860285,1065546.434423104,1136.1434994664178,1066682.5779225703,1477,2,418.87150837988827,80,99,38,36.68896696068171,0.568086592178771,41.93672839506172,8258.024691358007,103.22530864197509,0
1504,32,0,2,173,0.0,0.011428571428571429,0.9885714285714285,175,5250,4100,1150,0.780952380952381,64,41,23,205.44311555412253,0.4619813902572523,0.7447001525065173,0.12696996685523393,1066832.8649654624,3584.693510806932,1070417.5584762692,1478,3,424.48,81,94,40,36.47606426591886,0.5698809523809524,41.78099593495934,8263.008130081289,102.01244605038629,0
1505,32,2,0,175,0.011428571428571429,0.0,1.0,175,5550,4200,1350,0.7567567567567568,69,42,27,232.92437179184392,0.4621483305966065,0.7685379107206338,0.1452807667074182,1069551.3894896177,9274.917099192491,1078826.3065888102,1479,0,425.0,67,108,38,35.429997630050956,0.5757738095238095,41.452205882352935,8273.529411764692,123.48551360842823,8
1506,32,1,0,176,0.005681818181818182,0.0,1.0,176,5850,3700,2150,0.6324786324786325,80,37,43,229.69641246633054,0.46214691558441556,0.7678506538322791,0.14402205277865412,1071101.7892573662,8155.647675736813,1079257.436933103,1480,0,423.57954545454544,69,107,39,35.32182808995226,0.5771780303030303,41.26488095238094,8279.523809523784,119.9930986887505,0
1507,32,0,4,172,0.0,0.022727272727272728,0.9772727272727273,176,4500,2800,1700,0.6222222222222222,62,28,34,223.42634163072066,0.4618377976190476,0.7679101235944008,0.13985581158961372,1070607.178658945,8140.369050271117,1078747.5477092161,1481,1,424.57954545454544,66,110,42,35.545137636735184,0.5734493371212122,41.32462686567165,8277.611940298515,125.41836273179568,8
1508,32,0,1,171,0.0,0.005813953488372093,0.9941860465116279,172,5700,4300,1400,0.7543859649122807,71,43,28,225.35816259182718,0.46080327190715803,0.7651790433403802,0.14165370220057724,1071833.910034603,8209.30411380245,1080043.2141484055,1482,3,429.1337209302326,67,105,40,35.343671085858595,0.5757630813953488,41.1764705882353,8282.352941176478,123.61720807726086,0
1509,32,0,0,171,0.0,0.0,1.0,171,5800,4600,1200,0.7931034482758621,70,46,24,225.99283706515354,0.46041308336199976,0.7644626112538047,0.1424477452592598,1072650.4739025452,8482.264755303671,1081132.738657849,1483,4,432.4736842105263,68,103,43,35.226444522185275,0.5776072124756335,41.07789855072465,8285.50724637684,121.8456947996594,0
1510,32,1,0,172,0.005813953488372093,0.0,1.0,172,4900,3400,1500,0.6938775510204082,64,34,30,229.2748293030029,0.46043635817580125,0.7694995986692648,0.1453353695905784,1074307.5715702947,9962.337018140566,1084269.9085884353,1484,0,430.95348837209303,69,103,41,34.936960412718456,0.5793968023255813,40.87797619047619,8291.904761904761,120.17253278122843,0
1511,32,1,1,172,0.005780346820809248,0.005780346820809248,0.9942196531791907,173,5050,3700,1350,0.7326732673267327,64,37,27,226.04570737069707,0.4604099453331541,0.7682778857418324,0.1440206139895352,1075797.474597194,8985.880226586498,1084783.3548237805,1485,0,429.4566473988439,70,103,43,34.83695447172872,0.5811657032755299,40.69835680751174,8297.65258215964,118.537894030852,0
1512,32,0,2,170,0.0,0.011627906976744186,0.9883720930232558,172,5150,4000,1150,0.7766990291262136,63,40,23,223.50917760419208,0.4598718210254318,0.7594018860126974,0.13698235736336145,1064336.1111111126,8027.777777777786,1072363.8888888904,1486,1,432.6279069767442,74,98,35,36.318659127625175,0.5703730620155039,42.083333333333336,8253.333333333345,111.53153153153168,7
1513,32,0,0,170,0.0,0.0,1.0,170,4550,3400,1150,0.7472527472527473,57,34,23,221.1963715788978,0.45951821557025174,0.7529943760449918,0.1358777711127518,1065024.000000002,8565.888888888981,1073589.888888891,1487,2,438.25882352941176,74,96,35,36.293133613264445,0.571078431372549,42.00000000000001,8256.000000000016,111.56756756756779,0
1514,32,0,0,170,0.0,0.0,1.0,170,5150,4100,1050,0.7961165048543689,62,41,21,223.46312428954926,0.45942032138299105,0.7550949258810578,0.1378708955970734,1066324.448684436,8506.838561871189,1074831.2872463071,1488,3,439.25882352941176,76,94,35,36.07366504218415,0.5722426470588236,41.84253246753248,8261.038961038988,108.69788106630249,0
1515,32,0,1,169,0.0,0.0058823529411764705,0.9941176470588236,170,4500,3400,1100,0.7555555555555555,56,34,22,218.6145561148535,0.45957260122984106,0.7554803788903919,0.1292449255751016,1053474.1512345697,7560.956790123547,1061035.1080246933,1489,4,440.25882352941176,65,105,38,37.793188994136244,0.556188725490196,43.402777777777786,8211.111111111126,126.32478632478656,8
1516,32,1,0,170,0.0058823529411764705,0.0,1.0,170,4950,3300,1650,0.6666666666666666,66,33,33,220.3270248507052,0.4596240863209189,0.7573345073699422,0.12651482621930452,1044514.5076854553,7076.954778347177,1051591.4624638024,1490,0,441.15294117647056,66,104,40,38.866830960204446,0.5438725490196079,44.496268656716424,8176.11940298509,123.88059701492561,8
1517,32,2,0,172,0.011627906976744186,0.0,1.0,172,5700,4400,1300,0.7719298245614035,70,44,26,219.9123718867846,0.46020544335645314,0.7600464064574657,0.1277166729703618,1048016.6672025035,5994.36621227716,1054011.0334147806,1491,0,437.01162790697674,71,101,36,38.44003203316376,0.5463299418604651,44.06828703703704,8189.814814814816,115.3495044340115,0
1518,32,0,2,170,0.0,0.011627906976744186,0.9883720930232558,172,5050,3600,1450,0.7128712871287128,65,36,29,221.93061373227567,0.4600956525681128,0.7616662597016415,0.12935404660057118,1049124.9727345593,7116.589816167569,1056241.5625507268,1492,1,438.01162790697674,73,99,37,38.25008474886852,0.547843992248062,43.9329954954955,8194.144144144148,112.24854991978285,0
1519,32,3,1,172,0.017341040462427744,0.005780346820809248,0.9942196531791907,173,5100,3400,1700,0.6666666666666666,68,34,34,217.56774100037464,0.4599114464309719,0.7587061808320164,0.12801800757471135,1052027.8311489755,6077.463738520977,1058105.2948874964,1493,0,436.15606936416185,66,107,40,38.00008589502618,0.5505178227360308,43.578980099502466,8205.472636815874,124.32534298205869,0
1520,32,3,0,175,0.017142857142857144,0.0,1.0,175,6500,4500,2000,0.6923076923076923,85,45,40,213.29730654515376,0.4604912424740011,0.757221008013776,0.12674443256691298,1055022.448979585,3506.689342403194,1058529.138321988,1494,0,431.81714285714287,69,106,42,37.73711559264407,0.5540476190476191,43.21428571428569,8217.142857142802,119.08902691511308,0
1521,32,2,3,174,0.011299435028248588,0.01694915254237288,0.9830508474576272,177,5050,3700,1350,0.7326732673267327,64,37,27,211.07491641067594,0.4611073660332135,0.7559559604148571,0.12647874912482185,1057562.0891161384,4194.965911857514,1061757.055027996,1495,0,427.9265536723164,73,104,40,37.47878339903633,0.5561440677966102,42.90540540540539,8227.02702702699,112.69900037023274,0
1522,32,2,1,175,0.011363636363636364,0.005681818181818182,0.9943181818181818,176,5900,3700,2200,0.6271186440677966,81,37,44,215.27261324366546,0.4605810335497835,0.7557909884874943,0.12386288550954697,1045141.1033163336,3898.0513038552745,1049039.154620189,1496,0,426.0511363636364,69,107,41,38.91769771955361,0.5405421401515151,44.41964285714288,8178.571428571485,118.53002070393457,8
1523,32,4,2,177,0.0223463687150838,0.0111731843575419,0.9888268156424581,179,4450,3000,1450,0.6741573033707865,59,30,29,214.7793503304976,0.46129140250664324,0.7594509624889834,0.12482398761402608,1048234.6944444521,4777.833333333753,1053012.527777786,1497,0,419.87150837988827,74,105,36,38.54421021216562,0.5433542830540037,44.04166666666669,8190.666666666727,110.6846846846855,0
1524,32,2,0,179,0.0111731843575419,0.0,1.0,179,5450,3900,1550,0.7155963302752294,70,39,31,199.6669933425864,0.46133194191618015,0.745846465754654,0.11464558816555104,1044498.3944157971,460.37079283252797,1044958.7652086297,1498,0,420.86033519553075,70,109,43,39.39671260407694,0.5407355679702048,44.49823943661974,8176.056338028221,116.80080482897459,8
1525,32,3,2,180,0.016483516483516484,0.01098901098901099,0.989010989010989,182,5450,3800,1650,0.6972477064220184,71,38,33,196.32008610905868,0.46212408677878286,0.7438494003108604,0.11382807672103307,1047510.7571676488,-720.5195905360943,1046790.2375771126,1499,0,414.9065934065934,73,109,35,39.106826850782106,0.5433836996336996,44.13006756756759,8187.837837837903,112.16216216216306,0
1526,32,1,1,180,0.0055248618784530384,0.0055248618784530384,0.994475138121547,181,5600,4200,1400,0.75,70,42,28,207.59480987401938,0.46247570083896056,0.7584400086069005,0.1138040069009277,1029966.5671349878,963.1427361968299,1030929.7098711847,1500,0,417.74585635359114,71,110,41,41.01477115051986,0.5247467771639043,46.2818287037037,8118.98148148148,114.35185185185183,8
1527,32,2,0,182,0.01098901098901099,0.0,1.0,182,5400,3900,1500,0.7222222222222222,69,39,30,209.43961762350912,0.46305185376317975,0.7624248155405422,0.11577582202957765,1032608.0651017614,1453.8076619728477,1034061.8727637342,1501,0,416.2967032967033,75,107,38,40.63601519647514,0.5270718864468864,45.956688596491226,8129.385964912275,108.391812865497,0
1528,32,2,1,183,0.010869565217391304,0.005434782608695652,0.9945652173913043,184,4700,2900,1800,0.6170212765957447,65,29,36,211.50397391758702,0.4638287499010058,0.7675376065354853,0.11789269845255243,1035231.4351751746,2291.1124927913447,1037522.547667966,1502,0,412.7608695652174,67,117,41,40.25425323697682,0.53125,45.634191176470594,8139.705882352954,121.48814749780529,8
1529,32,3,0,186,0.016129032258064516,0.0,1.0,186,5750,4200,1550,0.7304347826086957,73,42,31,204.96660537269253,0.46485275598178827,0.7631583637663097,0.11545877966512179,1038540.0212290001,-376.7954610015295,1038163.2257679985,1503,0,409.01612903225805,73,113,40,40.00606617308506,0.5338261648745519,45.22804054054054,8152.702702702709,111.680858941133,0
1530,32,0,3,183,0.0,0.016129032258064516,0.9838709677419355,186,6300,4200,2100,0.6666666666666666,84,42,42,203.68536327932088,0.46502954567470695,0.7609344100855937,0.11527490559645935,1040002.6353516649,-1133.337081388881,1038869.2982702759,1504,1,410.01612903225805,76,110,38,39.85571650925043,0.5355062724014337,45.04870129870131,8158.4415584415865,107.34791524265245,0
1531,32,2,4,181,0.010810810810810811,0.021621621621621623,0.9783783783783784,185,5950,3800,2150,0.6386554621848739,81,38,43,207.86714093581324,0.46544628867998433,0.7654575379088515,0.11868164506307069,1042745.259571731,400.4951663097536,1043145.7547380407,1505,0,410.3135135135135,65,120,41,39.406169500257626,0.5377815315315315,44.71275252525254,8169.191919191948,125.67987567987612,0
1532,32,2,3,180,0.01092896174863388,0.01639344262295082,0.9836065573770492,183,4500,2800,1700,0.6222222222222222,62,28,34,204.5150833218519,0.4656906163053704,0.7579477788990392,0.11748840735093789,1044654.3402777826,1629.5138888891643,1046283.8541666718,1506,0,414.327868852459,69,114,43,39.25338021470312,0.5400159380692168,44.479166666666686,8176.666666666705,118.50241545893776,0
1533,32,3,1,182,0.01639344262295082,0.00546448087431694,0.994535519125683,183,5650,4000,1650,0.7079646017699115,73,40,33,197.55397917136366,0.4664362277067195,0.7490516333140522,0.1142016623469469,1046588.9062626924,-898.4394022394881,1045690.4668604529,1507,0,412.120218579235,73,110,43,39.1900925569193,0.5421220400728597,44.242680180180216,8184.23423423432,112.11279772923726,0
1534,32,2,5,179,0.010869565217391304,0.02717391304347826,0.9728260869565217,184,7100,5300,1800,0.7464788732394366,89,53,36,190.9192874323076,0.4670008958976796,0.741904532917179,0.11102976036112008,1048435.970487266,-3866.6703192337222,1044569.3001680323,1508,0,409.7608695652174,77,107,40,39.129886616583185,0.5442142210144927,44.01709401709406,8191.452991453098,106.38250638250776,0
1535,32,2,0,181,0.011049723756906077,0.0,1.0,181,5350,4000,1350,0.7476635514018691,67,40,27,200.71277381271648,0.4649682832003274,0.7510760292885359,0.11730546558387722,1049959.5209984886,598.0575701358416,1050557.5785686246,1509,0,417.43093922651934,76,105,43,38.68953316434307,0.5457527624309393,43.83116883116885,8197.40259740265,107.86056049214012,0
1536,32,2,1,182,0.01092896174863388,0.00546448087431694,0.994535519125683,183,5500,4100,1400,0.7454545454545455,69,41,28,200.07773725204842,0.4651451690386117,0.7531040115770646,0.11784482993170803,1052334.0277777694,9.72222222168648,1052343.7499999912,1510,0,413.85792349726773,69,114,42,38.41050636339016,0.5482695810564663,43.541666666666636,8206.6666666666,118.9371980676319,0
1537,32,2,1,183,0.010869565217391304,0.005434782608695652,0.9945652173913043,184,6650,4900,1750,0.7368421052631579,84,49,35,199.1779435422498,0.46496408984715293,0.7517307522709245,0.11830689899557634,1054900.1736111022,-1427.4305555560422,1053472.7430555462,1511,0,411.9891304347826,73,111,44,38.114858012170366,0.5510076992753623,43.229166666666636,8216.666666666595,112.55707762556979,0
1538,32,2,3,182,0.010810810810810811,0.016216216216216217,0.9837837837837837,185,5700,4200,1500,0.7368421052631579,72,42,30,218.18550357955908,0.46585879357618487,0.7718360468477863,0.12675129360722265,1048107.8129565772,3036.3861951205367,1051144.1991516978,1512,0,410.66486486486485,77,108,37,38.472856335333546,0.5445382882882883,44.05715811965814,8190.1709401709895,106.36585636585701,8
1539,32,4,1,185,0.021505376344086023,0.005376344086021506,0.9946236559139785,186,6050,4500,1550,0.743801652892562,76,45,31,212.32017325874764,0.4667017824275889,0.7692467120166846,0.12049079815401666,1040856.1475477495,948.9515169538508,1041805.0990647033,1513,0,408.97849462365593,81,105,39,39.528754524022986,0.5361783154121864,44.94410569105689,8161.788617886127,100.7628224430386,8
1540,32,1,1,185,0.005376344086021506,0.005376344086021506,0.9946236559139785,186,5150,3700,1450,0.7184466019417476,66,37,29,212.14024503047884,0.4665746391552843,0.7697207861989144,0.12111045048836612,1042717.2308571981,1890.4577703097098,1044607.6886275079,1514,0,409.9623655913978,68,118,41,39.30058643800509,0.5381944444444444,44.71618357487923,8169.08212560388,120.1335606706453,0
1541,32,4,3,186,0.021164021164021163,0.015873015873015872,0.9841269841269842,189,6250,4100,2150,0.656,84,41,43,211.65768576083306,0.4675879019850651,0.7738423656517712,0.12233281850665677,1046533.6712380939,251.37898500892697,1046785.0502231028,1515,0,403.4708994708995,72,117,43,38.83627182949286,0.5412808641975309,44.24942922374431,8184.018264840219,113.66692034500304,0
1542,32,2,1,187,0.010638297872340425,0.005319148936170213,0.9946808510638298,188,6050,4000,2050,0.6611570247933884,81,40,41,212.0835423348622,0.4680039206204725,0.773446882079666,0.12361692186003,1049130.7400173647,850.6727430557276,1049981.4127604205,1516,0,405.5159574468085,79,109,41,38.50151700057633,0.5442708333333333,43.93229166666668,8194.166666666695,103.72362869198348,0
1543,32,2,1,188,0.010582010582010581,0.005291005291005291,0.9947089947089947,189,6650,4800,1850,0.7218045112781954,85,48,37,215.32105909609902,0.46807807047168754,0.7788320827107096,0.12661264068461486,1051826.5151977483,846.0798475474103,1052672.5950452958,1517,0,404.35449735449737,63,126,44,38.08275936858587,0.5470127865961198,43.60351562499998,8204.687499999956,130.23313492063423,0
1544,32,1,1,188,0.005291005291005291,0.005291005291005291,0.9947089947089947,189,6250,4400,1850,0.704,81,44,37,213.97029989940876,0.4676559157942137,0.7771974658237939,0.12688302497219683,1054396.7614619355,1071.918252595014,1055468.6797145305,1518,0,405.32275132275134,67,122,40,37.79761904761904,0.5490520282186948,43.29044117647058,8214.705882352924,122.60755048287946,0
1545,32,3,1,190,0.015706806282722512,0.005235602094240838,0.9947643979057592,191,5850,4600,1250,0.7863247863247863,71,46,25,209.47842287537898,0.46813630935978695,0.7737951705144117,0.12525695666042014,1056922.0230248978,230.4716971018056,1057152.4947219996,1519,0,401.5759162303665,71,120,41,37.59927056947182,0.5518106457242583,42.98321759259257,8224.537037036975,115.83854981742218,0
1546,32,1,0,191,0.005235602094240838,0.0,1.0,191,6050,4500,1550,0.743801652892562,76,45,31,207.16943915501489,0.46783549187103884,0.7720976366135326,0.1244293384636195,1058269.4104938207,-401.7839506176647,1057867.626543203,1520,0,402.57068062827227,74,117,43,37.49144929884247,0.5536103839441535,42.81944444444442,8229.777777777726,111.21321321321253,0
1547,32,2,2,191,0.010362694300518135,0.010362694300518135,0.9896373056994818,193,5950,4400,1550,0.7394957983193278,75,44,31,213.38622915687642,0.4681349399107657,0.7721017061364948,0.12645751994395898,1054206.3125202837,440.62195641548533,1054646.9344766992,1521,0,399.38860103626945,73,120,44,37.83629238643632,0.5530548359240068,43.3136261261261,8213.96396396391,112.52005430087547,7
1548,32,5,3,193,0.025510204081632654,0.015306122448979591,0.9846938775510204,196,6400,4200,2200,0.65625,86,42,44,243.90770132475257,0.4685990101168673,0.7950138621944784,0.14706251137305082,1059436.2895280668,6080.934015763186,1065517.22354383,1522,0,393.3775510204082,67,129,38,36.401406913521456,0.5567070578231292,42.677696078431374,8234.313725490201,122.90020485806271,0
1549,32,1,0,194,0.005154639175257732,0.0,1.0,194,5500,3600,1900,0.6545454545454545,74,36,38,250.37147153018088,0.4680522541530901,0.79719770163447,0.15159379299277018,1060698.0488273792,8813.70626682082,1069511.7550942001,1523,0,397.8298969072165,67,127,39,36.0780580675869,0.5584729381443299,42.52450980392159,8239.21568627455,122.97336845185896,0
1550,32,0,2,192,0.0,0.010309278350515464,0.9896907216494846,194,6600,5100,1500,0.7727272727272727,81,51,30,192.47823985554783,0.4678630726634973,0.7496299239572404,0.1147542537532791,1056031.8426953577,-4747.369937316986,1051284.4727580408,1524,1,398.8298969072165,86,108,39,38.1465450280406,0.556969501718213,43.09147509578546,8221.072796934921,95.5938697318014,8
1551,32,0,3,189,0.0,0.015625,0.984375,192,5650,4500,1150,0.7964601769911505,68,45,23,195.56497949887506,0.46734963550756253,0.7484867890858831,0.11702103967534029,1057138.3781888557,-2702.1509484042062,1054436.2272404516,1525,2,403.5260416666667,87,105,39,37.930050272469096,0.55810546875,42.9569128787879,8225.378787878843,94.54458376872233,0
1552,32,2,0,191,0.010471204188481676,0.0,1.0,191,6100,4800,1300,0.7868852459016393,74,48,26,191.7751353550788,0.4674083769633508,0.7430567168787066,0.1153484927431288,1058702.2629718487,-3693.446043569067,1055008.8169282796,1526,0,406.4450261780105,88,103,44,37.83376179209513,0.5598276614310645,42.766853932584276,8231.460674157317,93.53932584269678,0
1553,32,0,0,191,0.0,0.0,1.0,191,6450,4900,1550,0.7596899224806202,80,49,31,190.34996177305942,0.46722352346835677,0.7427038369288486,0.11483957353708732,1059618.3198249848,-4310.33866545642,1055307.9811595283,1527,1,407.4450261780105,78,113,45,37.757040870352334,0.5615728621291449,42.65559071729955,8235.021097046354,105.57719355187633,0
1554,32,1,2,190,0.005208333333333333,0.010416666666666666,0.9895833333333334,192,6150,4200,1950,0.6829268292682927,81,42,39,189.92919643052468,0.46734565881326356,0.7440857429418037,0.11510721033065383,1060984.7753560531,-4247.602838321153,1056737.172517732,1528,0,406.3177083333333,80,112,47,37.598839725662515,0.5631510416666667,42.489711934156354,8240.32921810694,103.00411522633674,0
1555,32,3,0,193,0.015544041450777202,0.0,1.0,193,6700,4700,2000,0.7014925373134329,87,47,40,189.54851935544644,0.46657086571675305,0.7452853246448505,0.11579651796674177,1063376.6375217722,-4987.706568115375,1058388.9309536568,1529,0,405.0,85,108,43,37.31304422727558,0.5659002590673575,42.199612403100744,8249.612403100686,97.05426356589042,0
1556,32,3,4,192,0.015306122448979591,0.02040816326530612,0.9795918367346939,196,5350,3300,2050,0.616822429906542,74,33,41,188.39870443030634,0.4672717163788593,0.7529269206453288,0.1145982548085043,1062083.4379565374,-4530.971258420532,1057552.4666981169,1530,0,399.7857142857143,73,123,47,37.502447230872924,0.5642006802721089,42.35641891891892,8244.594594594591,112.93965198074783,7
1557,32,0,2,190,0.0,0.010416666666666666,0.9895833333333334,192,5500,3900,1600,0.7090909090909091,71,39,32,186.96699007093284,0.46633444226294357,0.7462097109245165,0.11415110528041103,1063197.562943911,-4143.430361125198,1059054.1325827858,1531,1,405.7083333333333,76,116,46,37.401709962389575,0.5661892361111112,42.22132034632035,8248.917748917753,108.53839143312833,0
1558,32,2,2,190,0.010416666666666666,0.010416666666666666,0.9895833333333334,192,5600,3500,2100,0.625,77,35,42,185.23680900356135,0.4661435609365911,0.7441884264046876,0.11367796556165957,1064734.5562537168,-4554.393672747761,1060180.162580969,1532,0,398.9583333333333,81,111,38,37.25660076164212,0.5682508680555556,42.03506097560975,8254.87804878048,101.91207467630223,0
1559,32,0,4,186,0.0,0.021052631578947368,0.9789473684210527,190,5800,3900,1900,0.6724137931034483,77,39,38,179.6866961715039,0.4656618397846468,0.7339079183481771,0.1127841701175118,1071412.056357969,-5296.301470943563,1066115.7548870256,1533,1,403.38947368421054,82,108,43,36.57761045637524,0.574890350877193,41.22740963855424,8280.722891566322,100.98442550690636,8
1560,32,1,0,187,0.0053475935828877,0.0,1.0,187,6600,5300,1300,0.803030303030303,79,53,26,181.76829369625094,0.46446677400187836,0.7337300173665224,0.11488799807308517,1073458.5159554053,-4975.855440215134,1068482.66051519,1534,0,409.72192513368987,84,103,39,36.27223694171082,0.5775958110516934,40.980392156862756,8288.62745098042,98.67413632119549,0
1561,32,0,0,187,0.0,0.0,1.0,187,5650,3800,1850,0.672566371681416,75,38,37,213.735977308812,0.4642044256607824,0.7720445836422085,0.13708729316895876,1077736.7891190005,3020.225180802134,1080757.0142998027,1535,1,410.72192513368987,64,123,43,34.91754142224968,0.5795454545454546,40.46474358974359,8305.128205128205,129.7676282051282,8
1562,32,2,2,187,0.010582010582010581,0.010582010582010581,0.9894179894179894,189,6500,4700,1800,0.7230769230769231,83,47,36,205.9092513446095,0.46417196705317276,0.7644650844697327,0.13289101945368953,1079541.0773880407,157.499008145091,1079698.576396186,1536,0,407.36507936507934,68,121,43,34.8990420008524,0.5816798941798942,40.247584541062814,8312.077294686018,122.23643080420615,0
1563,32,0,1,186,0.0,0.0053475935828877,0.9946524064171123,187,6150,5000,1150,0.8130081300813008,73,50,23,228.4001303938307,0.46374920936116387,0.7845813358679423,0.14308959520348666,1070855.3890306149,5366.702097505862,1076222.0911281207,1537,1,412.11764705882354,69,118,35,35.38580912664176,0.5723596256684492,41.29464285714287,8278.57142857145,119.97929606625289,8
1564,32,2,3,185,0.010638297872340425,0.015957446808510637,0.9840425531914894,188,7200,5400,1800,0.75,90,54,36,227.08642373778943,0.46330462794402094,0.7834365940701822,0.14049503939711738,1067147.7894275938,3666.955020160184,1070814.744447754,1538,0,410.9095744680851,81,107,42,35.87821774061323,0.5683178191489362,41.7428861788618,8264.227642276457,102.02750175649948,8
1565,32,2,1,186,0.0106951871657754,0.0053475935828877,0.9946524064171123,187,5450,3900,1550,0.7155963302752294,70,39,31,212.93715695537898,0.46356951871657753,0.7724122710563943,0.12819379678203563,1058977.3778850338,2249.1264253802383,1061226.5043104142,1539,0,409.572192513369,82,105,42,37.25527261492428,0.5614973262032086,42.73343373493976,8232.530120481926,100.39670878636495,8
1566,32,3,1,188,0.015873015873015872,0.005291005291005291,0.9947089947089947,189,6100,4800,1300,0.7868852459016393,74,48,26,207.0283591948461,0.4638694228676498,0.7660826381313803,0.12607089058497506,1062418.1755992044,90.13833461733157,1062508.3139338216,1540,0,406.1005291005291,68,121,42,36.98102798445527,0.5638227513227514,42.315821256038674,8245.893719806822,121.2631429383356,0
1567,32,3,2,189,0.015706806282722512,0.010471204188481676,0.9895287958115183,191,5050,3100,1950,0.6138613861386139,70,31,39,208.6318676719183,0.46404312482777627,0.7696265594763689,0.12832988758431943,1065419.872396329,1206.1075665648605,1066625.9799628938,1541,0,402.8219895287958,72,119,39,36.56835231880852,0.5661540139616056,41.95205479452057,8257.534246575397,114.6879756468805,0
1568,32,0,1,188,0.0,0.005291005291005291,0.9947089947089947,189,6100,4200,1900,0.6885245901639344,80,42,38,214.0559350061147,0.4631986659912192,0.7731352316277242,0.13204970673609964,1066285.7067901324,1748.956790123928,1068034.6635802563,1542,1,407.9470899470899,74,115,41,36.32130880005738,0.5674603174603174,41.84722222222225,8260.88888888896,111.63363363363459,0
1569,32,1,2,187,0.005291005291005291,0.010582010582010581,0.9894179894179894,189,5750,3900,1850,0.6782608695652174,76,39,37,213.53403543110954,0.4632514353259034,0.7733071330026817,0.1323430718187375,1067670.1416015648,2046.7827690973554,1069716.924370662,1543,0,408.7142857142857,79,110,43,36.16366962380496,0.5694444444444444,41.67968750000001,8266.250000000018,104.63607594936732,0
1570,32,2,0,189,0.010582010582010581,0.0,1.0,189,5400,3000,2400,0.5555555555555556,78,30,48,208.6105433390981,0.4628281079965477,0.7677198525539755,0.13022729184778048,1069804.8827374107,1434.515570934368,1071239.3983083451,1544,0,407.0687830687831,67,122,45,36.02734992101107,0.5717041446208113,41.42156862745099,8274.509803921585,123.50014632718784,0
1571,32,0,1,188,0.0,0.005291005291005291,0.9947089947089947,189,5750,3900,1850,0.6782608695652174,76,39,37,230.38467903180586,0.46277651131374536,0.78682305403042,0.13720821223800195,1055709.966723477,5093.880366853162,1060803.8470903302,1545,1,408.0687830687831,73,116,38,37.21275390910419,0.5542328042328042,43.13063063063062,8219.819819819793,112.60027150438073,8
1572,32,0,1,187,0.0,0.005319148936170213,0.9946808510638298,188,6350,4700,1650,0.7401574803149606,80,47,33,231.22104827337975,0.4628269949178898,0.786667295108729,0.13840359513077946,1057240.9382716017,4941.271604938128,1062182.20987654,1546,2,411.2340425531915,74,114,34,37.00077894243932,0.5561281028368794,42.944444444444436,8225.777777777754,111.15915915915883,0
1573,32,1,1,187,0.005319148936170213,0.005319148936170213,0.9946808510638298,188,6400,5100,1300,0.796875,77,51,26,231.6051730072607,0.46273099423521824,0.7887199586527691,0.13952799447022815,1059184.0277777805,5062.500000000136,1064246.5277777808,1547,0,411.6595744680851,69,119,38,36.74932523616734,0.5577903368794326,42.70833333333334,8233.333333333356,119.32367149758487,0
1574,32,1,0,188,0.005319148936170213,0.0,1.0,188,6050,4100,1950,0.6776859504132231,80,41,39,225.61902405828116,0.46273692020328444,0.7830295507570928,0.13654947559767847,1060571.8391063537,4207.036656574377,1064778.875762928,1548,0,412.4468085106383,67,121,38,36.731037167053394,0.5594525709219857,42.53982843137255,8238.72549019608,122.96605209247882,0
1575,32,2,0,190,0.010526315789473684,0.0,1.0,190,5300,3600,1700,0.6792452830188679,70,36,34,221.24772406361393,0.4629699248120301,0.7793954174228659,0.13507755784936482,1063190.1234567945,3745.6790123458777,1066935.8024691404,1549,0,409.09473684210525,74,116,39,36.518947557471265,0.5617324561403509,42.222222222222236,8248.888888888923,111.47147147147193,0
1576,32,0,1,189,0.0,0.005263157894736842,0.9947368421052631,190,4800,2800,2000,0.5833333333333334,68,28,40,219.4500762467089,0.46274424487143784,0.7686171315527219,0.1356419054442467,1066866.2077085653,4024.7741253359973,1070890.9818339013,1550,1,410.09473684210525,84,106,37,36.11025421985981,0.5672697368421052,41.7769607843137,8263.137254901896,98.37068160597495,8
1577,32,0,2,187,0.0,0.010582010582010581,0.9894179894179894,189,5950,4500,1450,0.7563025210084033,74,45,29,217.27557410111552,0.4626862171188412,0.7646109431998831,0.13486956924673624,1068126.9054104825,2665.577317182335,1070792.482727665,1551,2,413.25925925925924,73,116,40,36.01056705711435,0.5686728395061729,41.62443693693695,8268.018018018052,113.26052079476784,0
1578,32,1,4,184,0.005319148936170213,0.02127659574468085,0.9787234042553191,188,5700,4000,1700,0.7017543859649122,74,40,34,217.40708667869387,0.46240625118519363,0.7666130209886555,0.13589584964900925,1070190.250000007,3233.388888889205,1073423.6388888962,1552,0,416.1436170212766,74,114,43,35.75230922077225,0.5707557624113475,41.37500000000002,8276.000000000055,111.83783783783858,0
1579,32,1,1,184,0.005405405405405406,0.005405405405405406,0.9945945945945946,185,5650,4100,1550,0.7256637168141593,72,41,31,221.9051393843293,0.46167131805718764,0.7663746505125795,0.139896718307513,1072704.0816326614,4957.709750567353,1077661.7913832287,1553,0,423.04324324324324,76,109,38,35.32567049808431,0.5731418918918919,41.0714285714286,8285.714285714352,109.02255639097831,0
1580,32,0,0,184,0.0,0.0,1.0,184,5350,3800,1550,0.7102803738317757,69,38,31,219.88308618443034,0.4614306149520868,0.7641008531608608,0.13927364528449798,1074079.784064771,5084.395545694166,1079164.1796104652,1554,1,426.3097826086956,77,107,36,35.208397763001926,0.5748414855072463,40.90544871794875,8291.025641025726,107.67565767565878,0
1581,32,0,1,183,0.0,0.005434782608695652,0.9945652173913043,184,4950,3600,1350,0.7272727272727273,63,36,27,222.2179049865235,0.4613142967450701,0.766995584930366,0.14108253037516613,1074765.261977257,6016.416973776108,1080781.6789510332,1555,2,427.3097826086956,78,106,36,35.06340303215307,0.5758605072463768,40.82278481012661,8293.670886076026,106.32911392405163,0
1582,32,0,2,181,0.0,0.01092896174863388,0.9890710382513661,183,6800,5200,1600,0.7647058823529411,84,52,32,227.29732212632274,0.46060019215756925,0.7704988925539309,0.14525312882979807,1076672.2920775802,5544.945759368806,1082217.237836949,1556,3,429.9726775956284,64,119,43,34.6966959082391,0.5776411657559198,40.592948717948715,8301.025641025639,129.7035256410256,0
1583,32,0,0,181,0.0,0.0,1.0,181,5900,3800,2100,0.6440677966101694,80,38,42,231.32874221738084,0.4604460814405566,0.7709164604866867,0.1483607580742053,1077716.6233037487,7761.366187123993,1085477.9894908727,1557,4,432.72375690607737,65,116,38,34.463431444093075,0.5795925414364641,40.46717171717173,8305.050505050536,127.77000777000825,0
1584,32,0,4,177,0.0,0.022099447513812154,0.9779005524861879,181,5200,3600,1600,0.6923076923076923,68,36,32,220.0633282801111,0.4601749539594844,0.7689757756056099,0.1392436103719291,1073776.517538335,5859.766855702729,1079636.2843940377,1558,5,433.72375690607737,68,113,35,35.241113053613084,0.5741827808471455,40.94202898550726,8289.855072463788,121.90963341858512,8
1585,32,1,1,177,0.0056179775280898875,0.0056179775280898875,0.9943820224719101,178,5950,5000,950,0.8403361344537815,69,50,19,217.7810658845809,0.4591942804545166,0.7630297071176935,0.13847413550461057,1075205.7747127928,5281.8919324417375,1080487.6666452347,1559,0,441.2022471910112,71,107,38,35.12413029728021,0.5764279026217228,40.76967592592593,8295.370370370381,116.83620239958283,0
1586,32,2,0,179,0.0111731843575419,0.0,1.0,179,5300,3800,1500,0.7169811320754716,68,38,30,241.2727272727272,0.4590408114158977,0.7857099325255748,0.15128664495114005,1071113.7125679275,10586.105330095957,1081699.8178980234,1560,0,439.6368715083799,61,118,40,35.02083333333331,0.5714036312849162,41.263440860215056,8279.569892473122,135.73065397496921,8
1587,32,0,3,176,0.0,0.01675977653631285,0.9832402234636871,179,5300,3800,1500,0.7169811320754716,68,38,30,249.76241886840072,0.4588825769464147,0.786993339878097,0.15127264419977424,1060792.711046008,11889.230685763947,1072681.941731772,1561,1,440.6368715083799,63,116,39,36.0819637589549,0.5631401303538175,42.513020833333336,8239.583333333341,130.78703703703715,8
1588,32,1,2,175,0.005649717514124294,0.011299435028248588,0.9887005649717514,177,4700,3400,1300,0.723404255319149,60,34,26,223.32207370484292,0.45907699880157504,0.765117156385458,0.13018294857554183,1049167.1727311814,6760.437735475074,1055927.6104666565,1562,0,446.2542372881356,81,96,36,38.20918907299005,0.5539077212806026,43.92784552845529,8194.308943089454,101.16430793937597,8
1589,32,1,1,175,0.005681818181818182,0.005681818181818182,0.9943181818181818,176,5450,3800,1650,0.6972477064220184,71,38,33,225.064445766408,0.4589718614718615,0.7657058388765703,0.13182346109175386,1050625.0000000044,6641.666666666907,1057266.6666666714,1563,0,449.60227272727275,83,93,39,37.9827235772358,0.5558712121212122,43.750000000000014,8200.000000000035,98.79518072289198,0
1590,32,0,0,175,0.0,0.0,1.0,175,7400,6000,1400,0.8108108108108109,88,60,28,226.64455530916797,0.45872605363984675,0.764547885310686,0.13361176248101192,1052606.6098392028,5313.511400499374,1057920.1212397022,1564,1,452.9085714285714,68,107,34,37.69521287031585,0.5578571428571428,43.50845410628019,8207.729468599033,120.70190394998578,0
1591,32,2,1,176,0.011299435028248588,0.005649717514124294,0.9943502824858758,177,4650,3400,1250,0.7311827956989247,59,34,25,219.89185306122494,0.45915190035952747,0.7608916868442295,0.13053281643729397,1054719.3568295504,6334.838766558467,1061054.195596109,1565,0,448.77966101694915,70,107,40,37.60547619047617,0.5596751412429379,43.25117370892018,8215.962441314532,117.37089201877903,0
1592,32,0,0,176,0.0,0.0,1.0,176,5000,3600,1400,0.72,64,36,28,207.78731059059947,0.45871482683982684,0.7460109582259549,0.1204014410437834,1047317.7110460086,3323.866102430584,1050641.5771484391,1566,1,452.0568181818182,79,97,35,38.8374832476631,0.5518465909090908,44.153645833333336,8187.083333333347,103.63396624472591,8
1593,32,2,2,176,0.011235955056179775,0.011235955056179775,0.9887640449438202,178,5650,3800,1850,0.672566371681416,75,38,37,204.57330364590914,0.45903888677288984,0.7448889876295774,0.11947684097452711,1049741.565101069,1699.819989430533,1051441.3850904994,1567,0,447.96629213483146,86,92,38,38.6177721684663,0.5538974719101124,43.85775862068965,8196.551724137922,95.30874097834793,0
1594,32,0,0,176,0.0,0.0,1.0,176,5500,4300,1200,0.7818181818181819,67,43,24,205.12778658280433,0.4583313041125541,0.7447100996025418,0.12028995125351115,1050991.103316321,2417.495748298982,1053408.59906462,1568,1,452.97727272727275,69,107,40,38.44804186262559,0.5554569128787878,43.705357142857125,8201.428571428527,118.8612836438917,0
1595,32,1,2,175,0.005649717514124294,0.011299435028248588,0.9887005649717514,177,4500,3000,1500,0.6666666666666666,60,30,30,209.11250311872197,0.4586102015921931,0.7526545483873839,0.11819654357061657,1039606.8179012387,3578.9567901236387,1043185.7746913623,1569,0,451.4124293785311,74,103,36,39.76688643091956,0.5370174199623352,45.097222222222236,8156.888888888921,110.22822822822867,8
1596,32,4,0,179,0.0223463687150838,0.0,1.0,179,5700,4100,1600,0.7192982456140351,73,41,32,205.88137383983042,0.4593206641139916,0.7503138958727336,0.11744612572040784,1042476.0346080902,1425.2796400426691,1043901.3142481329,1570,0,446.1340782122905,67,112,43,39.49050041009024,0.5411429236499069,44.74571078431375,8168.137254902014,121.91249634182111,0
1597,32,3,1,181,0.016483516483516484,0.005494505494505495,0.9945054945054945,182,4500,3100,1400,0.6888888888888889,59,31,28,200.96142485822253,0.46060879728006804,0.7482978977544184,0.11555281929347842,1044938.2716049438,1098.4567901238115,1046036.7283950676,1571,0,439.7637362637363,71,111,45,39.30876358695651,0.5433836996336996,44.444444444444464,8177.777777777821,115.17996870109607,0
1598,32,4,2,183,0.021621621621621623,0.010810810810810811,0.9891891891891892,185,5500,4000,1500,0.7272727272727273,70,40,30,195.2654370292809,0.46136530552291427,0.7462366120606168,0.11332921898581656,1047817.119810908,-1579.5064346719419,1046237.613376236,1572,0,433.5783783783784,75,110,38,39.09566752361059,0.5460585585585586,44.092653508771946,8189.035087719335,109.18713450292447,0
1599,32,1,2,182,0.005434782608695652,0.010869565217391304,0.9891304347826086,184,5300,4100,1200,0.7735849056603774,65,41,24,194.42946279902347,0.4611150708798606,0.7437753715030946,0.11363321936920742,1049959.520998486,-1271.3868743087123,1048688.1341241773,1573,0,435.1630434782609,76,108,40,38.85049200816786,0.5484601449275363,43.831168831168846,8197.40259740263,107.86056049213987,0
1600,32,2,0,184,0.010869565217391304,0.0,1.0,184,4600,3400,1200,0.7391304347826086,58,34,24,226.43476012754368,0.4609795725429635,0.7791162315783233,0.1262348332402496,1035280.5557149764,5484.7008596060405,1040765.2565745824,1574,0,436.125,65,119,39,39.86829383053089,0.5274569746376812,45.62815656565656,8139.898989898977,125.22921522921503,8
1601,32,4,1,187,0.02127659574468085,0.005319148936170213,0.9946808510638298,188,5850,3700,2150,0.6324786324786325,80,37,43,234.06802428316624,0.46222313877194976,0.790035365865478,0.12950103488553671,1032879.0734178395,4902.79280766817,1037781.8662255077,1575,0,427.8244680851064,80,108,40,39.97623205277453,0.5247118794326241,45.92335390946502,8130.45267489712,101.630658436214,8
1602,32,2,2,187,0.010582010582010581,0.010582010582010581,0.9894179894179894,189,6250,4800,1450,0.768,77,48,29,232.55897084557324,0.46298407069683667,0.7887890118779353,0.12962634809740212,1035225.4976064496,4100.195263290452,1039325.6928697401,1576,0,426.5238095238095,62,127,39,39.71943252730107,0.5272266313932981,45.63492063492063,8139.682539682537,131.28520225294415,0
1603,32,2,3,186,0.010582010582010581,0.015873015873015872,0.9841269841269842,189,6450,4700,1750,0.7286821705426356,82,47,35,237.80830537229204,0.4628128635220834,0.7964457432051539,0.13249565959949153,1035090.9172825487,4980.643389042749,1040071.5606715914,1577,0,427.2010582010582,62,127,36,39.60283538104833,0.5295414462081129,45.65145502645502,8139.1534391534215,131.27666837344228,8
1604,32,4,1,189,0.021052631578947368,0.005263157894736842,0.9947368421052631,190,6450,4900,1550,0.7596899224806202,80,49,31,231.11143855908819,0.4636492852501624,0.7918519315545789,0.1301596456036644,1038475.8904327701,3550.73138936963,1042026.6218221397,1578,0,423.2157894736842,67,123,42,39.348017256929836,0.5336074561403509,45.23590686274511,8152.450980392187,121.67837284167445,0
1605,32,1,2,188,0.005263157894736842,0.010526315789473684,0.9894736842105263,190,5900,4300,1600,0.7288135593220338,75,43,32,233.4691155038918,0.46392369813422446,0.7946653828219146,0.13236008368195182,1040543.6669311628,4686.9619123189,1045230.6288434818,1579,0,424.17894736842106,70,120,39,39.028520883672755,0.5356359649122807,44.98239436619718,8160.563380281677,116.57947686116682,0
1606,32,3,2,189,0.015706806282722512,0.010471204188481676,0.9895287958115183,191,5750,3800,1950,0.6608695652173913,77,38,39,228.2722203437773,0.4636228988702122,0.7922072056142391,0.1305298092084326,1043216.6578951332,3677.476559467548,1046894.1344546007,1580,0,422.9319371727749,60,131,41,38.82623888182975,0.537903577661431,44.65505464480876,8171.038251366148,136.18397085610246,0
1607,32,5,0,194,0.02577319587628866,0.0,1.0,194,6550,4600,1950,0.7022900763358778,85,46,39,205.41438032530885,0.46474547299823726,0.7746269410569664,0.1168254540735586,1041533.6419753141,-2560.80246913549,1038972.8395061786,1581,0,416.96907216494844,74,120,42,39.62019143531121,0.5351159793814433,44.86111111111113,8164.444444444488,110.33033033033092,8
1608,32,4,2,196,0.020202020202020204,0.010101010101010102,0.98989898989899,198,5650,3700,1950,0.6548672566371682,76,37,39,243.89706483007285,0.46666538481259295,0.8084789615946111,0.1353672734547849,1033880.0880434482,5182.063772010901,1039062.151815459,1582,0,409.52525252525254,62,136,37,39.60040761458739,0.522516835016835,45.80026455026455,8134.391534391537,131.19986345792802,8
1609,32,5,3,198,0.024875621890547265,0.014925373134328358,0.9850746268656716,201,5950,4200,1750,0.7058823529411765,77,42,35,230.3267244798384,0.46723466003316755,0.8002089661135015,0.12953360102670844,1038030.9276433294,1667.2526945714385,1039698.1803379008,1583,0,404.3731343283582,70,131,40,39.42385231265481,0.5259121061359867,45.290492957746494,8150.7042253521495,116.43863179074499,0
1610,32,6,8,196,0.029411764705882353,0.0392156862745098,0.9607843137254902,204,6650,4900,1750,0.7368421052631579,84,49,35,222.43227935213986,0.4685226101935027,0.7973743859383025,0.12655254622308734,1041653.0086180315,-1110.5493998156726,1040542.4592182159,1584,0,397.44117647058823,75,129,39,39.17105357398648,0.5295138888888888,44.84649122807016,8164.912280701717,108.86549707602289,0
1611,32,4,1,199,0.02,0.005,0.995,200,6150,4600,1550,0.7479674796747967,77,46,31,223.29157407626752,0.4669304857621441,0.7953096724862989,0.12798896871997617,1043962.4192979615,471.60237630212623,1044434.0216742636,1585,0,405.9,63,137,44,38.860127012446334,0.531875,44.563802083333336,8173.958333333345,129.74537037037055,0
1612,32,4,1,202,0.019704433497536946,0.0049261083743842365,0.9950738916256158,203,5000,3400,1600,0.68,66,34,32,214.67804880435995,0.4675433676372563,0.7899642102434439,0.12393376927908134,1046173.2041587895,-681.9155639571882,1045491.2885948323,1586,0,400.85714285714283,68,135,48,38.80402054551895,0.5339696223316913,44.29347826086956,8182.6086956521685,120.33248081841424,0
1613,32,2,3,201,0.00980392156862745,0.014705882352941176,0.9852941176470589,204,6450,4700,1750,0.7286821705426356,82,47,35,210.5078436874151,0.4675843757043047,0.7859395849680597,0.1223490397673374,1048253.654406722,-3116.8767146776227,1045136.7776920444,1587,0,399.78921568627453,71,133,38,38.651179440801876,0.5358966503267975,44.039351851851855,8190.7407407407445,115.36254564423584,0
1614,32,1,5,197,0.0049504950495049506,0.024752475247524754,0.9752475247524752,202,6500,4400,2100,0.676923076923077,86,44,42,233.31390202508155,0.4674502898050999,0.8074175132945425,0.13413627153774518,1044893.9047919427,1857.6548258467137,1046751.5596177893,1588,0,404.6831683168317,63,139,38,38.487529987474275,0.5348597359735974,44.449869791666686,8177.604166666704,129.80324074074133,8
1615,32,4,4,197,0.01990049751243781,0.01990049751243781,0.9800995024875622,201,5500,3900,1600,0.7090909090909091,71,39,32,205.56983257437554,0.46719941956882255,0.7819330199614507,0.12006613251923728,1049760.1991311968,-2540.1943242712546,1047220.0048069255,1589,0,406.78109452736317,78,123,43,38.58992673049867,0.540992951907131,43.85548523206752,8196.624472573867,105.0849291355624,7
1616,32,2,1,198,0.010050251256281407,0.005025125628140704,0.9949748743718593,199,6400,4400,2000,0.6875,84,44,40,206.80259740634528,0.46659645026479196,0.7808919667572884,0.1217954115714282,1052308.123055046,-2675.9893760840528,1049632.133678962,1590,0,411.62311557788945,65,134,45,38.241263564937306,0.5435510887772195,43.54482323232323,8206.56565656566,126.25485625485632,0
1617,32,3,0,201,0.014925373134328358,0.0,1.0,201,5850,3700,2150,0.6324786324786325,80,37,43,202.23769215407214,0.46681902985074625,0.7772086263534634,0.12019580053557637,1055081.005890586,-3374.5704666182187,1051706.4354239677,1591,0,408.4726368159204,70,131,42,38.01384048448835,0.5461753731343284,43.207159624413144,8217.370892018778,117.3910127431254,0
1618,32,2,2,201,0.009852216748768473,0.009852216748768473,0.9901477832512315,203,6600,5000,1600,0.7575757575757576,82,50,32,201.17379314256996,0.46729645255165914,0.7791094064222623,0.12039683420831417,1057187.7280498748,-4664.306936886179,1052523.4211129886,1592,0,405.4384236453202,72,131,41,37.77975926131528,0.5480808702791462,42.950913242009136,8225.570776255716,114.24403855910717,0
1619,32,4,3,202,0.01951219512195122,0.014634146341463415,0.9853658536585366,205,5350,3600,1750,0.6728971962616822,71,36,35,193.0753131671167,0.467251514426909,0.7715225167984461,0.11659622096009388,1059908.9170193297,-5421.550783574648,1054487.3662357552,1593,0,402.2926829268293,70,135,44,37.650938645993676,0.5509654471544716,42.62030516431925,8236.150234741779,117.6592890677397,0
1620,32,2,0,204,0.00980392156862745,0.0,1.0,204,6550,4300,2250,0.6564885496183206,88,43,45,195.39609472067136,0.46709186548182496,0.7726329022514009,0.11902856495091016,1062521.9157235983,-5827.47342249631,1056694.442301102,1594,0,403.46078431372547,71,133,45,37.26794670259751,0.5529003267973855,42.303240740740755,8246.29629629633,116.14501825769479,0
1621,32,1,3,202,0.004878048780487805,0.014634146341463415,0.9853658536585366,205,6000,4500,1500,0.75,75,45,30,196.35693171508598,0.4670203650565918,0.7734935300561856,0.12036962394832841,1064405.8194596681,-5199.307838243374,1059206.5116214247,1595,0,402.4878048780488,73,132,41,37.0103490148993,0.5547256097560975,42.074887387387406,8253.60360360365,113.0630630630637,0
1622,32,1,2,201,0.0049261083743842365,0.009852216748768473,0.9901477832512315,203,7150,5100,2050,0.7132867132867133,92,51,41,197.14581381847947,0.4667823001511974,0.7713720075321826,0.12170485934852786,1066498.131366173,-5698.8715911852705,1060799.2597749878,1596,0,406.92118226600985,73,130,44,36.73162813732442,0.5568555008210181,41.82150900900904,8261.711711711787,113.17413303714777,0
1623,32,1,3,199,0.0049504950495049506,0.01485148514851485,0.9851485148514851,202,5650,3800,1850,0.672566371681416,75,38,37,203.08698384942485,0.4666621512897558,0.7773992143813493,0.12620007994431737,1068450.6267971431,-2652.316962348235,1065798.3098347948,1597,0,409.9059405940594,63,139,44,36.337219982784305,0.5588902640264026,41.58528645833332,8269.270833333308,131.2582671957668,0
1624,32,1,1,199,0.005,0.005,0.995,200,6500,5100,1400,0.7846153846153846,79,51,28,197.20649378191752,0.4669147822445561,0.7717241944292739,0.12028150903220908,1062895.9829762212,-4578.001988474865,1058317.9809877463,1598,0,410.955,73,127,41,37.175040961223374,0.5578125,42.25788288288289,8247.747747747762,112.98284585955838,8
1625,32,5,2,202,0.024509803921568627,0.00980392156862745,0.9901960784313726,204,7200,5500,1700,0.7638888888888888,89,55,34,189.62488362857675,0.46772070897324447,0.7672022297291026,0.11716704686375691,1066764.946174547,-7542.964244521372,1059221.9819300256,1599,0,403.84313725490193,84,120,42,36.89289669356117,0.560968137254902,41.78921568627451,8262.745098039208,98.36601307189532,0
1626,32,1,2,201,0.0049261083743842365,0.009852216748768473,0.9901477832512315,203,6850,5100,1750,0.7445255474452555,86,51,35,189.7777381752906,0.46751390040481877,0.7671831472223505,0.11780875466348112,1068146.8572845787,-6907.90107709762,1061238.9562074812,1600,0,406.7783251231527,69,134,46,36.718585017950026,0.5626026272577997,41.6220238095238,8268.095238095224,119.82746721877136,0
1627,32,1,1,201,0.0049504950495049506,0.0049504950495049506,0.995049504950495,202,6800,4900,1900,0.7205882352941176,87,49,38,201.35739456290378,0.46701260611135736,0.7742369199845065,0.12316371131303,1063748.5340000677,-4361.273344727715,1059387.26065534,1601,0,409.73762376237624,78,124,41,36.96262677916985,0.5617264851485149,42.15453586497889,8251.054852320647,105.78275451693138,7
1628,32,0,2,199,0.0,0.009950248756218905,0.9900497512437811,201,6500,4800,1700,0.7384615384615385,82,48,34,202.92735378025435,0.4662437810945274,0.775696399636504,0.12478508592095595,1065334.0472531253,-3462.916179783131,1061871.1310733422,1602,1,412.771144278607,80,121,37,36.72616081069853,0.5635364842454395,41.96244855967077,8257.201646090507,103.21502057613134,0
1629,32,0,2,197,0.0,0.010050251256281407,0.9899497487437185,199,6400,4800,1600,0.75,80,48,32,202.20155432004486,0.46592389557213676,0.7722042445791757,0.12472549756227583,1066258.710592073,-3080.1662821995396,1063178.5443098734,1603,2,417.321608040201,84,115,38,36.63066698314742,0.5654313232830821,41.85049019607841,8260.784313725435,98.34267040149328,0
1630,32,1,3,195,0.005050505050505051,0.015151515151515152,0.9848484848484849,198,5650,4200,1450,0.7433628318584071,71,42,29,199.6552232707941,0.46570613068074995,0.768443521285544,0.12383616957091277,1067897.3798921925,-2607.7420374655194,1065289.637854727,1604,0,420.30808080808083,71,127,42,36.4941502865356,0.5672348484848485,41.65219907407408,8267.129629629651,116.43844548774157,0
1631,32,0,3,192,0.0,0.015384615384615385,0.9846153846153847,195,5900,4000,1900,0.6779661016949152,78,40,38,197.58203181281775,0.4654705260375363,0.7619173590156938,0.12297664254302822,1068926.2345679032,-2659.876543209758,1066266.3580246936,1605,1,426.0051282051282,74,121,40,36.42083109439372,0.5691773504273504,41.527777777777786,8271.111111111126,111.77177177177197,0
1632,32,1,0,193,0.0051813471502590676,0.0,1.0,193,6650,5200,1450,0.7819548872180451,81,52,29,199.1380715255763,0.46450979598445596,0.7636335574909039,0.12123690883033851,1062346.1064943117,-2939.2890120034454,1059406.8174823083,1606,0,431.2746113989637,75,118,41,37.193262411347504,0.561582469775475,42.32456140350879,8245.614035087763,109.94152046783684,8
1633,32,0,2,191,0.0,0.010362694300518135,0.9896373056994818,193,5450,3600,1850,0.6605504587155964,73,36,37,200.56780258815596,0.4643827360391479,0.7655359813324913,0.12224558807342298,1062685.1801756315,-1421.913713834972,1061263.2664617966,1607,1,432.2746113989637,75,118,43,37.11447862929676,0.5625539723661486,42.283442982456144,8246.929824561408,109.95906432748544,0
1634,32,0,1,190,0.0,0.005235602094240838,0.9947643979057592,191,5800,3700,2100,0.6379310344827587,79,37,42,200.8738325605156,0.46403393956094424,0.7635439112466795,0.12295741919830985,1063966.1362361785,-1255.4088999270675,1062710.7273362514,1608,2,437.18324607329845,78,113,43,36.948194167476274,0.5645724258289704,42.12816455696202,8251.898734177203,105.79357351509235,0
1635,32,1,0,191,0.005235602094240838,0.0,1.0,191,5800,4200,1600,0.7241379310344828,74,42,32,203.92411623888486,0.46396849453476624,0.7663738040268178,0.12552099328741279,1065626.0850694424,-538.628472222254,1065087.4565972202,1609,0,436.9633507853403,83,108,38,36.66435418768921,0.5668630017452008,41.92708333333333,8258.333333333318,99.4979919678713,0
1636,32,2,0,193,0.010362694300518135,0.0,1.0,193,5600,4400,1200,0.7857142857142857,68,44,24,199.75214448303885,0.4642759157311456,0.7654170200257144,0.12368491370515418,1067390.7966165869,-1557.2798748755445,1065833.5167417114,1610,0,433.42487046632124,88,105,42,36.554154582804664,0.5690306563039724,41.71348314606741,8265.168539325827,93.92236976506621,0
1637,32,0,1,192,0.0,0.0051813471502590676,0.9948186528497409,193,6750,5200,1550,0.7703703703703704,83,52,31,199.00738549618094,0.46397119674726545,0.7651127670246334,0.12364462495601161,1068401.8624997048,-2826.027736936832,1065575.834762768,1611,1,434.42487046632124,68,125,42,36.44865728028666,0.5705418825561313,41.59118357487922,8269.082125603838,121.6041489059388,0
1638,32,0,2,190,0.0,0.010416666666666666,0.9895833333333334,192,6400,4500,1900,0.703125,83,45,38,184.1186957015394,0.4635621182373473,0.7432183782547215,0.11201998385606839,1062150.7799666342,-5687.63675083427,1056463.1432158,1612,2,437.625,80,112,42,37.60440063222695,0.5632595486111112,42.34825102880657,8244.85596707816,103.060699588477,8
1639,32,2,2,190,0.010416666666666666,0.010416666666666666,0.9895833333333334,192,7100,5400,1700,0.7605633802816901,88,54,34,190.65354848535273,0.4632292121146015,0.7457260112906512,0.11428982981357229,1057688.6741519475,-5169.580216032544,1052519.093935915,1613,0,437.8489583333333,85,107,43,37.98812636422168,0.5544704861111112,42.89001937984497,8227.519379844987,96.79434564523514,8
1640,32,1,1,190,0.005235602094240838,0.005235602094240838,0.9947643979057592,191,6000,4100,1900,0.6833333333333333,79,41,38,194.91327398134297,0.4631475613116561,0.7511145215737427,0.11751491373137858,1059419.0103677916,-2901.034434228188,1056517.9759335634,1614,0,435.5759162303665,72,119,47,37.6642821493928,0.556664485165794,42.67979452054792,8234.24657534241,114.36453576864457,0
1641,32,0,0,190,0.0,0.0,1.0,190,6100,4700,1400,0.7704918032786885,75,47,28,192.94824151867766,0.4625058015408892,0.7470681813089559,0.11711509543342966,1061442.174515233,-3139.319790704989,1058302.854724528,1615,1,438.7631578947368,75,115,46,37.46452391088406,0.5588815789473685,42.43421052631578,8242.105263157875,109.894736842105,0
1642,32,0,2,188,0.0,0.010526315789473684,0.9894736842105263,190,5400,3900,1500,0.7222222222222222,69,39,30,191.62064282480796,0.462139144156688,0.7453482642777152,0.1166602359166573,1062346.1064943024,-2686.5112342261214,1059659.5952600762,1616,2,439.7631578947368,75,115,45,37.38696808510639,0.5603070175438596,42.32456140350876,8245.614035087692,109.9415204678359,0
1643,32,0,1,187,0.0,0.005319148936170213,0.9946808510638298,188,4600,2800,1800,0.6086956521739131,64,28,36,189.7454011753688,0.4618758770432738,0.7390124297962612,0.11587228416008459,1063261.7296006917,-1850.1953125000978,1061411.5342881917,1617,3,445.281914893617,79,109,45,37.322162171263095,0.5618351063829787,42.21354166666666,8249.166666666644,104.4198312236284,0
1644,32,1,1,187,0.005319148936170213,0.005319148936170213,0.9946808510638298,188,6100,4600,1500,0.7540983606557377,76,46,30,192.97288413393915,0.4616489124663405,0.7445876245464391,0.11863393530655418,1065258.939784514,-2586.7820080642314,1062672.1577764498,1618,0,444.96276595744683,81,107,37,36.99229519495863,0.5636635638297872,41.97154471544714,8256.910569105645,101.93716751982278,0
1645,32,0,1,186,0.0,0.0053475935828877,0.9946524064171123,187,5700,4500,1200,0.7894736842105263,69,45,24,193.32558425107675,0.46124671765089226,0.7445664086256254,0.11915275071297188,1066014.7845397587,-1882.4137917133598,1064132.3707480454,1619,1,445.8663101604278,82,105,39,36.88990048783651,0.5650623885918004,41.880020080321266,8259.839357429666,100.72974826133739,0
1646,32,1,0,187,0.0053475935828877,0.0,1.0,187,5500,3700,1800,0.6727272727272727,73,37,36,202.30798700754968,0.4615030763038353,0.7575254396528508,0.12049636315242604,1055734.0098573833,-183.31553006899367,1055550.6943273144,1620,0,446.63101604278074,76,111,43,37.93097394845866,0.5548128342245989,43.127705627705616,8219.913419913395,108.15675552517625,8
1647,32,0,2,185,0.0,0.0106951871657754,0.9893048128342246,187,7150,5700,1450,0.7972027972027972,86,57,29,205.17318395840485,0.46096520230770704,0.7601646549426995,0.12278447907067587,1057173.2374807303,-1169.280174092978,1056003.9573066372,1621,1,447.63101604278074,80,107,39,37.67875308518445,0.5561497326203209,42.95267489711932,8225.514403292133,102.81893004115166,0
1648,32,2,0,187,0.0106951871657754,0.0,1.0,187,6250,5100,1150,0.816,74,51,23,211.70658097885888,0.4610706208191977,0.7673942015098991,0.12522691267843095,1053634.7815964594,962.2834424383877,1054597.0650388978,1622,0,447.475935828877,70,117,44,37.95046976540315,0.5500222816399287,43.3832159624413,8211.737089201837,117.31052984574053,7
1649,32,4,4,187,0.020942408376963352,0.020942408376963352,0.9790575916230366,191,5550,3800,1750,0.6846846846846847,73,38,35,209.75164353542814,0.4622232938366859,0.7691240979199103,0.1251743679163032,1056327.1604938211,563.2716049379783,1056890.432098759,1623,0,439.08376963350787,74,117,38,37.66610360360362,0.5526287085514834,43.055555555555536,8222.222222222175,111.11111111111047,0
1650,32,0,0,187,0.0,0.0,1.0,187,5850,4400,1450,0.7521367521367521,73,44,29,212.7357883777092,0.46142521035784795,0.7668911505573339,0.12693907634057897,1056288.5805991753,1692.0767896271736,1057980.6573888024,1624,1,449.1764705882353,73,114,38,37.59421967165212,0.553475935828877,43.06024774774773,8222.072072072033,112.63112427495935,0
1651,32,0,2,185,0.0,0.0106951871657754,0.9893048128342246,187,6300,4500,1800,0.7142857142857143,81,45,36,197.00685251681801,0.4613269794721408,0.7504813715453984,0.11543320727610742,1050740.4310983233,-2299.3869714310845,1048441.0441268922,1625,2,450.1764705882353,73,114,41,38.6873455094754,0.5479055258467023,43.73592342342341,8200.450450450413,112.33493767740292,8
1652,32,0,1,184,0.0,0.005405405405405406,0.9945945945945946,185,6100,4300,1800,0.7049180327868853,79,43,36,196.81230989709243,0.461087446141794,0.7489472475308157,0.11450737179059278,1048571.6793293547,-1825.6371397028688,1046746.0421896518,1626,3,455.6054054054054,78,107,38,38.96214267319086,0.5467905405405405,44.00052742616037,8191.983122362943,105.02542464567875,8
1653,32,1,2,183,0.005405405405405406,0.010810810810810811,0.9891891891891892,185,4550,3200,1350,0.7032967032967034,59,32,27,198.00075811851013,0.4615684978456718,0.7512432798776403,0.11570301726885683,1049913.3150077232,26.72646604981219,1049940.041473773,1627,0,456.1837837837838,83,102,40,38.76475488534963,0.5483671171171172,43.83680555555558,8197.222222222279,98.76171352075035,0
1654,32,2,2,183,0.010810810810810811,0.010810810810810811,0.9891891891891892,185,5500,4000,1500,0.7272727272727273,70,40,30,199.9790854728818,0.4619491774383078,0.7538218936868712,0.11779563395507323,1052357.1322589424,-410.11661999872695,1051947.0156389435,1628,0,456.68108108108106,73,112,43,38.410164754743235,0.5503941441441442,43.53885135135133,8206.756756756711,112.42132543502345,0
1655,32,2,1,184,0.010810810810810811,0.005405405405405406,0.9945945945945946,185,5100,3700,1400,0.7254901960784313,65,37,28,198.9722726843865,0.4626468860164512,0.7533478593382514,0.11800983747240441,1054449.7465566245,-138.74749923095624,1054310.9990573935,1629,0,453.5891891891892,75,110,45,38.17605445808863,0.5519707207207207,43.28399122807015,8214.912280701688,109.53216374268918,0
1656,32,3,0,187,0.016042780748663103,0.0,1.0,187,5350,3900,1450,0.7289719626168224,68,39,29,195.68499034249834,0.46284237057481836,0.7522184693645189,0.11691908221260769,1056688.5759938671,-1394.3812423227273,1055294.1947515444,1630,0,449.6898395721925,78,109,42,37.982726184368055,0.5544786096256684,43.0116033755274,8223.628691983055,105.43113707670582,0
1657,32,1,1,187,0.005319148936170213,0.005319148936170213,0.9946808510638298,188,7100,5100,2000,0.7183098591549296,91,51,40,193.79309108391547,0.46284655061250807,0.7520766060846291,0.11649996108556394,1058540.8962673505,-3672.4175347227533,1054868.4787326278,1631,0,448.2925531914894,79,109,46,37.801837602510865,0.5566267730496454,42.7864583333333,8230.83333333325,104.18776371307912,0
1658,32,1,1,187,0.005319148936170213,0.005319148936170213,0.9946808510638298,188,6150,4700,1450,0.7642276422764228,76,47,29,232.5929181859161,0.4626255120036409,0.78847983601346,0.13508762842575311,1048031.6655984704,5002.9486905592885,1053034.6142890297,1632,0,449.27659574468083,78,110,38,38.11362270307404,0.5411679964539007,44.06645569620256,8189.8734177215865,104.99837715027675,8
1659,32,2,0,189,0.010582010582010581,0.0,1.0,189,5800,4000,1800,0.6896551724137931,76,40,36,228.9183420351736,0.46301338699388345,0.7869753326908486,0.13368600913319875,1049720.7828719767,4460.068242983675,1054180.8511149604,1633,0,447.7724867724868,84,105,40,37.99678643765054,0.5434854497354498,43.86029411764707,8196.470588235328,97.57703081232533,0
1660,32,2,0,191,0.010471204188481676,0.0,1.0,191,6050,4600,1450,0.7603305785123967,75,46,29,222.70304594530694,0.4637239368053642,0.7824127714525853,0.13082118007097052,1051517.602441764,2585.2345857771084,1054102.8370275411,1634,0,444.0732984293194,66,125,40,37.93197990579575,0.5454842931937173,43.64116915422883,8203.482587064618,124.29519071310028,0
1661,32,0,1,190,0.0,0.005235602094240838,0.9947643979057592,191,5150,3300,1850,0.6407766990291263,70,33,37,219.13758911659357,0.4637193441719482,0.7776547542137675,0.1295873484078818,1053552.2644700855,2824.580648860252,1056376.8451189457,1635,1,445.0732984293194,72,119,41,37.77004671078238,0.5472840314136126,43.39326484018263,8211.415525114116,114.04743784880718,0
1662,32,3,2,191,0.015544041450777202,0.010362694300518135,0.9896373056994818,193,6100,4200,1900,0.6885245901639344,80,42,38,204.3770585877615,0.4636709754605642,0.7644407425100488,0.12385601114988894,1060966.8841710154,-1332.5417908214686,1059634.342380194,1636,0,441.419689119171,76,117,38,37.22900796777862,0.5569408462867012,42.49188311688309,8240.259740259673,108.42447026657464,8
1663,32,0,2,189,0.0,0.010471204188481676,0.9895287958115183,191,5600,3700,1900,0.6607142857142857,75,37,38,204.28148569503486,0.46296730045007806,0.7623303886794646,0.124166368722966,1061858.8745759954,-416.37830063178444,1061442.4962753635,1637,1,447.0314136125655,76,115,41,37.121033100526866,0.5580824607329843,42.38365800865799,8243.722943722898,108.47003873319602,0
1664,32,0,0,189,0.0,0.0,1.0,189,6350,4400,1950,0.6929133858267716,83,44,39,204.76731137636958,0.46184308041577543,0.760148398293665,0.12504575048208982,1063261.72960069,-605.7508680558221,1062655.9787326343,1638,2,452.6507936507937,79,110,44,36.934917668451334,0.560736331569665,42.21354166666665,8249.166666666631,104.41983122362825,0
1665,32,4,3,190,0.02072538860103627,0.015544041450777202,0.9844559585492227,193,5150,3700,1450,0.7184466019417476,66,37,29,208.69423489101055,0.4621237676309729,0.7716903734872558,0.12882472101656092,1066476.4948958794,763.499226308053,1067239.9941221874,1639,0,444.24870466321244,85,108,40,36.436146297599464,0.5634715025906736,41.82412790697671,8261.627906976664,97.19562243501957,0
1666,32,1,1,190,0.005235602094240838,0.005235602094240838,0.9947643979057592,191,6100,4900,1200,0.8032786885245902,73,49,24,211.6004589409638,0.4613977679801598,0.774738816309827,0.13152420683193244,1068526.7013232522,920.148078134881,1069446.8494013872,1640,0,446.27748691099475,68,123,39,36.107825096389774,0.5655541012216405,41.57608695652174,8269.565217391311,121.61125319693105,0
1667,32,0,1,189,0.0,0.005263157894736842,0.9947368421052631,190,6650,5200,1450,0.7819548872180451,81,52,29,208.2910024833799,0.46127239394783254,0.7697881782985139,0.13001864471241217,1069784.0465430235,-84.72170096538866,1069699.3248420581,1641,1,447.92105263157896,72,118,41,36.0381831392675,0.5669956140350877,41.424086757990864,8274.429223744284,114.9226281075595,0
1668,32,0,1,188,0.0,0.005291005291005291,0.9947089947089947,189,5450,3800,1650,0.6972477064220184,71,38,33,211.69999994123725,0.46067511914143117,0.7663890518476175,0.12636800122199424,1056401.316036055,1478.0317085510883,1057879.3477446062,1642,2,451.24867724867727,76,113,34,37.60683198202939,0.5482253086419753,43.04653679653679,8222.510822510812,108.19093187514227,8
1669,32,1,1,188,0.005291005291005291,0.005291005291005291,0.9947089947089947,189,4950,3000,1950,0.6060606060606061,69,30,39,214.35898014567923,0.46078065781079963,0.7723952795686784,0.12136246724224069,1040123.2742172848,1841.9528573999287,1041965.2270746847,1643,0,452.1798941798942,85,104,37,39.56848772763261,0.5326829805996472,45.03391472868214,8158.914728682092,95.98723210214226,8
1670,32,1,0,189,0.005291005291005291,0.0,1.0,189,5750,4000,1750,0.6956521739130435,75,40,35,241.8807521704147,0.46075955007692593,0.7969686869035164,0.1378765668375533,1042237.9077422328,6869.457813042543,1049107.3655552752,1644,0,453.0687830687831,61,128,38,38.60146084304305,0.5364307760141094,44.774865591397884,8167.204301075334,133.88859509959565,8
1671,32,4,4,189,0.02072538860103627,0.02072538860103627,0.9792746113989638,193,6350,4200,2150,0.6614173228346457,85,42,43,235.3980612325312,0.46179318688831317,0.794677247448899,0.13597699772373328,1046358.5069444483,4312.152777777996,1050670.6597222264,1645,0,444.6580310880829,67,126,40,38.251018329938915,0.5398855785837651,44.27083333333335,8183.333333333364,122.13930348258752,0
1672,32,4,0,193,0.02072538860103627,0.0,1.0,193,6100,4700,1400,0.7704918032786885,75,47,28,240.27646969319002,0.46310089234312035,0.8007297612466757,0.13685494128209275,1041994.3603515582,5373.345269096979,1047367.7056206552,1646,0,443.9378238341969,79,114,40,38.672944623024975,0.5370790155440415,44.804687499999986,8166.249999999966,103.37025316455653,8
1673,32,9,3,199,0.04455445544554455,0.01485148514851485,0.9851485148514851,202,6400,4500,1900,0.703125,83,45,38,230.1644634650572,0.4666621512897558,0.7983716492703854,0.13049113686555786,1040554.5511937569,1099.73599632701,1041654.2871900839,1647,0,425.11386138613864,76,126,38,39.1114308701572,0.5313531353135313,44.98106060606061,8160.60606060607,107.3763955342904,8
1674,32,1,2,198,0.005,0.01,0.99,200,6450,4900,1550,0.7596899224806202,80,49,31,233.51936624717305,0.4663641122278057,0.8047815275310835,0.13226499315609455,1040252.1791640372,2133.8059231251136,1042385.9850871623,1648,0,430.205,68,132,36,39.06379514505624,0.52875,45.01811594202897,8159.420289855041,119.99147485080942,8
1675,32,3,0,201,0.014925373134328358,0.0,1.0,201,5850,4100,1750,0.7008547008547008,76,41,35,227.28277777253538,0.4670252902155887,0.800507466490664,0.13027669519219076,1043962.4192979638,1404.935709635639,1045367.3550075995,1649,0,425.90547263681594,63,138,37,38.75817722271783,0.5315091210613598,44.56380208333335,8173.958333333363,129.74537037037084,0
1676,32,1,4,198,0.0049504950495049506,0.019801980198019802,0.9801980198019802,202,5900,4000,1900,0.6779661016949152,78,40,38,223.81344307270157,0.46691101013086383,0.7988265493215974,0.1291231402342514,1045971.0743801701,520.4775022958847,1046491.551882466,1650,0,424.7920792079208,65,137,39,38.59567901234566,0.5334674092409242,44.318181818181834,8181.81818181822,125.87412587412646,0
1677,32,2,3,197,0.01,0.015,0.985,200,6050,3900,2150,0.6446280991735537,82,39,43,227.1664613693245,0.4670194723618091,0.8001607005956244,0.13214619847134296,1048521.585247033,1587.7876379847007,1050109.3728850177,1651,0,429.615,68,132,37,38.19133199661892,0.5355208333333333,44.006642512077306,8191.7874396135485,120.46746234725806,0
1678,32,0,2,195,0.0,0.01015228426395939,0.9898477157360406,197,6550,5000,1550,0.7633587786259542,81,50,31,236.08077701247058,0.4662054542629235,0.7965711734485017,0.13156861280695012,1035175.8053911917,2927.0216962526247,1038102.8270874444,1652,1,437.0,64,133,37,39.63609921034949,0.5229483925549916,45.64102564102565,8139.487179487193,127.1794871794874,8
1679,32,2,3,194,0.01015228426395939,0.015228426395939087,0.9847715736040609,197,6650,4500,2150,0.6766917293233082,88,45,43,236.93089027398207,0.46683673469387754,0.7999108879099783,0.13388022594999757,1039513.2325141821,3208.559126234235,1042721.7916404164,1653,0,437.6040609137056,68,129,37,39.069533285951216,0.5283946700507614,45.10869565217393,8156.52173913047,119.94884910485986,8
1680,32,2,2,194,0.01020408163265306,0.01020408163265306,0.9897959183673469,196,6750,4400,2350,0.6518518518518519,91,44,47,230.91489196986794,0.4666464983429269,0.7908511819661641,0.1330092096065307,1045481.1888756759,2333.4351571513134,1047814.6240328272,1654,0,439.96938775510205,67,129,41,38.47537254549451,0.5399128401360545,44.37806372549021,8179.901960784338,122.08808896693043,8
1681,32,2,3,193,0.01020408163265306,0.015306122448979591,0.9846938775510204,196,6200,4700,1500,0.7580645161290323,77,47,30,225.7926165364575,0.46675442612942614,0.7870532942810211,0.1310144901377685,1047741.2833018898,1914.449162000221,1049655.73246389,1655,0,440.2448979591837,73,123,37,38.32392458331043,0.5424638605442177,44.10191441441444,8188.738738738793,112.17450327039442,0
1682,32,1,5,189,0.005154639175257732,0.02577319587628866,0.9742268041237113,194,5550,3900,1650,0.7027027027027027,72,39,33,226.2050828498986,0.4662728353186261,0.7863076586360287,0.13169078783223276,1048764.179382173,3097.1576174302763,1051861.3369996033,1656,0,445.42783505154637,77,117,39,38.185660198563795,0.5442976804123711,43.97702991452993,8192.735042735081,106.3991563991569,0
1683,32,1,0,190,0.005263157894736842,0.0,1.0,190,5400,3300,2100,0.6111111111111112,75,33,42,199.11383936655864,0.4655353661932609,0.7519366723090719,0.11329746678517487,1041685.7628560977,-1917.1896688482575,1039768.5731872494,1657,0,454.55263157894734,81,109,36,39.76194032327655,0.5337719298245613,44.84247967479673,8165.040650406452,100.80297099267224,8
1684,32,2,1,191,0.010416666666666666,0.005208333333333333,0.9947916666666666,192,4900,3200,1700,0.6530612244897959,66,32,34,195.29743568184594,0.4660549374636416,0.7471220975839357,0.11174379309121046,1043409.8660420766,-2544.9457593688367,1040864.9202827078,1658,0,450.8072916666667,77,115,39,39.644127183349035,0.5358072916666667,44.631410256410255,8171.794871794864,106.12720612720602,0
1685,32,2,1,192,0.010362694300518135,0.0051813471502590676,0.9948186528497409,193,6750,4400,2350,0.6518518518518519,91,44,47,213.31149547439023,0.4662065522452505,0.7751873673078966,0.12062573743776797,1039751.4169023169,-991.8140677900174,1038759.6028345268,1659,0,449.43523316062175,75,118,36,39.64174821226946,0.5318436960276338,45.07949561403509,8157.456140350883,108.76608187134511,8
1686,32,3,1,194,0.015384615384615385,0.005128205128205128,0.9948717948717949,195,6100,4300,1800,0.7049180327868853,79,43,36,211.392823021578,0.4666259141774605,0.7764031976712409,0.12064159753880134,1042608.6336043745,-1020.0035271398147,1041588.6300772347,1660,0,445.8051282051282,66,129,42,39.333241975759826,0.5344017094017094,44.72947761194033,8168.656716417976,123.76752600633297,0
1687,32,2,0,196,0.01020408163265306,0.0,1.0,196,6150,4400,1750,0.7154471544715447,79,44,35,204.68821463998364,0.4671070992499564,0.7703527161263173,0.11783665970994837,1045308.6747940505,-2557.5267217434725,1042751.148072307,1661,0,444.21938775510205,68,128,42,39.167306518614765,0.5366709183673469,44.399154589372,8179.227053140147,120.28275078147276,0
1688,32,2,0,198,0.010101010101010102,0.0,1.0,198,6550,4900,1650,0.7480916030534351,82,49,33,191.0981100215192,0.46731485754328395,0.7616575549750175,0.10900562415485561,1042455.1806037879,-6307.757040894692,1036147.4235628932,1662,0,440.72222222222223,71,127,44,39.87045145383439,0.5315656565656566,44.748263888888914,8168.055555555611,115.043035993741,8
1689,32,2,3,197,0.01,0.015,0.985,200,5850,3500,2350,0.5982905982905983,82,35,47,185.72972282747548,0.4678993927973199,0.7574319330471175,0.10683378023596103,1045051.8549382776,-7030.56172839465,1038021.2932098829,1663,0,437.305,74,126,43,39.6838713475717,0.53359375,44.43055555555558,8178.22222222227,110.51651651651716,0
1690,32,2,1,198,0.010050251256281407,0.005025125628140704,0.9949748743718593,199,5900,4000,1900,0.6779661016949152,78,40,38,225.88102491308382,0.4672827521445612,0.7962654669551072,0.12852394204984827,1041675.3906249956,1358.9409722219398,1043034.3315972175,1664,0,440.36683417085425,79,120,39,39.0802544737021,0.5328203517587939,44.843749999999986,8164.999999999965,103.3544303797464,8
1691,32,7,0,205,0.03414634146341464,0.0,1.0,205,5750,4300,1450,0.7478260869565218,72,43,29,211.0172183302953,0.4685058982942771,0.7898330219984313,0.12214742244130436,1047000.8476939576,-2562.958706032106,1044437.8889879255,1665,0,428.42926829268293,72,133,43,38.794369758836744,0.5366869918699186,44.19235159817351,8185.844748858431,113.69228817858931,0
1692,32,0,4,201,0.0,0.01951219512195122,0.9804878048780488,205,5600,4200,1400,0.75,70,42,28,206.63287051492838,0.4685198469631755,0.7861693074703386,0.11811805194802165,1043116.6965235985,-3491.560543056001,1039625.1359805425,1666,1,429.42926829268293,66,139,42,39.39127544703564,0.5340955284552846,44.66728855721392,8170.646766169135,123.79767827528993,8
1693,32,1,0,202,0.0049504950495049506,0.0,1.0,202,6400,4800,1600,0.75,80,48,32,228.30335248772224,0.46800188414363825,0.7979517789760544,0.13013371565311863,1042229.5915276561,788.9019615348607,1043018.4934891909,1667,0,436.6782178217822,65,137,38,38.94903170284258,0.536355198019802,44.77588383838386,8167.171717171764,125.64879564879637,8
1694,32,3,2,203,0.014634146341463415,0.00975609756097561,0.9902439024390244,205,6550,4900,1650,0.7480916030534351,82,49,33,192.86485961804553,0.4686563446516818,0.76613961312027,0.10863364734312705,1038516.5158626401,-7491.331591426366,1031025.1842712137,1668,0,431.2731707317073,82,123,41,40.31732348111658,0.5311483739837398,45.230923694779094,8152.610441767011,99.42207855813429,8
1695,32,3,1,205,0.014563106796116505,0.0048543689320388345,0.9951456310679612,206,5500,3900,1600,0.7090909090909091,71,39,32,199.92234889444393,0.46946335543452516,0.7800291340801633,0.11076236604579688,1033315.5896017371,-5383.424035514639,1027932.1655662225,1669,0,430.13106796116506,85,121,43,40.78903730359214,0.5246258090614886,45.86967054263566,8132.170542635663,95.6725946192431,8
1696,32,4,1,208,0.019138755980861243,0.004784688995215311,0.9952153110047847,209,7800,5600,2200,0.717948717948718,100,56,44,197.16515355799112,0.46999792970187704,0.7804926047688205,0.11060072200199175,1037229.0864197524,-8698.913580247015,1028530.1728395055,1670,0,424.1291866028708,74,135,43,40.3688450069096,0.5276614832535885,45.388888888888886,8147.55555555555,110.10210210210202,0
1697,32,8,5,211,0.037037037037037035,0.023148148148148147,0.9768518518518519,216,6700,4900,1800,0.7313432835820896,85,49,36,201.41549725838527,0.4720041989664083,0.7882094488319333,0.11523439063094876,1043382.9569858889,-7869.300577552396,1035513.6564083365,1671,0,411.25,72,144,41,39.49125037252272,0.5326003086419753,44.63470319634705,8171.689497716931,113.49568746829071,0
1698,32,2,2,211,0.009389671361502348,0.009389671361502348,0.9906103286384976,213,6950,5100,1850,0.7338129496402878,88,51,37,201.67572286169624,0.47083074969734545,0.7863698485782948,0.11597791411321272,1044976.6436622526,-7400.716003164776,1037575.9276590878,1672,0,417.92488262910797,73,140,44,39.2857224823281,0.534673317683881,44.43975225225228,8177.927927928001,112.02640997161645,0
1699,32,4,3,212,0.018604651162790697,0.013953488372093023,0.986046511627907,215,6950,5000,1950,0.7194244604316546,89,50,39,199.80889925603222,0.47181228718394547,0.7852955097661796,0.11595209350527266,1047779.7067901274,-8078.858024691157,1039700.8487654363,1673,0,414.8325581395349,80,135,39,38.984056987788335,0.5379360465116279,44.097222222222236,8188.8888888889205,102.36111111111151,0
1700,32,1,1,212,0.004694835680751174,0.004694835680751174,0.9953051643192489,213,6300,4200,2100,0.6666666666666666,84,42,42,204.76801146155202,0.4707209451678625,0.7899318885921967,0.11927008819253518,1048917.361111119,-5943.055555555107,1042974.3055555638,1674,0,419.7230046948357,79,134,41,38.71541903986981,0.5393681533646322,43.95833333333336,8193.333333333396,103.71308016877717,0
1701,32,0,2,210,0.0,0.009433962264150943,0.9905660377358491,212,6850,5000,1850,0.7299270072992701,87,50,37,204.24197961396987,0.4700987734358699,0.7884339678790457,0.11922196852857236,1049583.5915295198,-6376.193899133767,1043207.3976303859,1675,1,422.688679245283,81,131,42,38.64592633005983,0.5406839622641509,43.87703252032522,8195.934959349648,101.18438221419319,0
1702,32,4,2,212,0.018691588785046728,0.009345794392523364,0.9906542056074766,214,5100,3700,1400,0.7254901960784313,65,37,28,199.70589494728998,0.4700215179968701,0.7861473342909306,0.11759677760508565,1052258.6002078543,-5871.550905901493,1046387.0493019528,1676,0,419.6682242990654,67,147,46,38.42941729884712,0.5426888629283488,43.55085784313726,8206.37254901962,122.48317237342715,0
1703,32,1,1,212,0.004694835680751174,0.004694835680751174,0.9953051643192489,213,6250,4900,1350,0.784,76,49,27,198.38911244258685,0.4699163271030797,0.7840544922677037,0.11765429181755464,1054424.7256515694,-7012.7229080937195,1047412.0027434757,1677,0,421.53521126760563,71,142,44,38.194131349564195,0.5449921752738653,43.28703703703701,8214.81481481475,115.7016171100669,0
1704,32,1,1,212,0.004694835680751174,0.004694835680751174,0.9953051643192489,213,7550,5800,1750,0.7682119205298014,93,58,35,199.63071595343314,0.46966257713998877,0.7769181016247144,0.11539571873918084,1046571.625434036,-8364.431423610637,1038207.1940104254,1678,0,422.46478873239437,79,134,42,39.139132131826386,0.5414221439749609,44.24479166666669,8184.1666666667315,103.59704641350294,8
1705,32,0,1,211,0.0,0.0047169811320754715,0.9952830188679245,212,7150,5300,1850,0.7412587412587412,90,53,37,205.78571551338297,0.46934614295508065,0.7798224663641409,0.11943397404255626,1047814.3822501563,-6424.9535246873165,1041389.4287254689,1679,1,425.4481132075472,81,131,38,38.82678704393149,0.5431407232704403,44.09298780487807,8189.024390243962,101.09906654622176,0
1706,32,3,2,212,0.014018691588785047,0.009345794392523364,0.9906542056074766,214,6350,4000,2350,0.6299212598425197,87,40,47,210.49492305952936,0.46952241747473417,0.7876003751808547,0.12317413420732895,1050337.0983777344,-4931.874658081645,1045405.2237196527,1680,0,419.06542056074767,88,126,43,38.39191905349229,0.5458041277258567,43.785112359550574,8198.876404494416,93.16905005107292,0
1707,32,6,2,216,0.027522935779816515,0.009174311926605505,0.9908256880733946,218,6600,4700,1900,0.7121212121212122,85,47,38,200.33790952903394,0.47042702476077736,0.780486516400519,0.11862002207049593,1053937.5027126793,-7971.2727864580975,1045966.2299262212,1681,0,412.22935779816515,79,139,45,38.20460867874114,0.548881880733945,43.346354166666686,8212.916666666712,103.96097046413558,0
1708,32,1,2,215,0.004608294930875576,0.009216589861751152,0.9907834101382489,217,6100,3800,2300,0.6229508196721312,84,38,46,196.18736818075283,0.4705705609603459,0.7751369932003598,0.11689160163085459,1055839.788237827,-8071.514145019267,1047768.2740928077,1682,0,414.7695852534562,81,136,38,38.0750750008242,0.5505472350230415,43.114837398374,8220.325203252076,101.48549633644538,0
1709,32,0,2,213,0.0,0.009302325581395349,0.9906976744186047,215,6800,4800,2000,0.7058823529411765,88,48,40,195.39411126347372,0.4704131348257625,0.7729780071507415,0.11671207182703931,1056602.3531878577,-8509.224447992488,1048093.1287398651,1683,1,419.2604651162791,82,133,41,38.00089128736081,0.551889534883721,43.02208835341367,8223.293172690808,100.28406308159522,0
1710,32,1,4,210,0.004672897196261682,0.018691588785046728,0.9813084112149533,214,7200,5000,2200,0.6944444444444444,94,50,44,195.9689194607032,0.47011612771123107,0.7739625199748197,0.11759242962551532,1057987.6603719739,-8533.46027882936,1049454.2000931446,1684,0,421.7289719626168,85,129,42,37.81441356570893,0.5538356697819314,42.85368217054264,8228.682170542645,96.80802553579582,0
1711,32,1,1,210,0.004739336492890996,0.004739336492890996,0.995260663507109,211,6350,4400,1950,0.6929133858267716,83,44,39,198.89710425645882,0.46966448506732866,0.7763101098672622,0.11996166159393958,1059531.747752816,-6402.440700836262,1053129.3070519797,1685,0,428.58293838862556,73,138,44,37.54780692157612,0.5552428909952607,42.66610360360359,8234.68468468465,112.80389979020067,0
1712,32,2,1,211,0.009433962264150943,0.0047169811320754715,0.9952830188679245,212,6500,4700,1800,0.7230769230769231,83,47,36,197.04669215531328,0.469908752868938,0.7752814345607801,0.11988715962637789,1062154.8580292524,-7041.1797337279795,1055113.6782955243,1686,0,427.2877358490566,77,135,42,37.270804177681015,0.5578812893081762,42.347756410256395,8244.871794871759,107.07625707625661,0
1713,32,1,1,211,0.0047169811320754715,0.0047169811320754715,0.9952830188679245,212,5850,4400,1450,0.7521367521367521,73,44,29,198.56031239045123,0.4700666376046976,0.7775473222486036,0.12151694766935998,1063906.2934027761,-6000.086805555612,1057906.2065972206,1687,0,425.16509433962267,79,133,46,37.01524944455667,0.5599941037735849,42.135416666666664,8251.666666666655,104.4514767932488,0
1714,32,1,5,207,0.0047169811320754715,0.02358490566037736,0.9764150943396226,212,6000,3800,2200,0.6333333333333333,82,38,44,192.7489028524664,0.4699064241855197,0.7713628766580691,0.11683383217593563,1061030.3837525975,-7497.511527711359,1053532.8722248862,1688,0,426.10849056603774,78,134,44,37.520587984297634,0.5589131289308176,42.48417721518985,8240.506329113874,105.64751703992147,8
1715,32,0,0,207,0.0,0.0,1.0,207,7300,5000,2300,0.684931506849315,96,50,46,192.8547414554159,0.46885504119569127,0.7666328577546382,0.11720756026071066,1061824.5603221515,-7744.419789612349,1054080.1405325392,1689,1,428.64251207729467,77,130,44,37.41964748574392,0.5607387278582932,42.3878205128205,8243.589743589704,107.05960705960655,0
1716,32,1,1,207,0.004807692307692308,0.004807692307692308,0.9951923076923077,208,6350,4500,1850,0.7086614173228346,82,45,37,189.643617421341,0.4689590301003344,0.7643226502042646,0.11601525456354311,1063790.9912254564,-7601.765648754343,1056189.225576702,1690,0,427.5769230769231,81,127,43,37.25941800505796,0.5630008012820513,42.149390243902424,8251.219512195084,101.86690755796401,0
1717,32,0,1,206,0.0,0.004830917874396135,0.9951690821256038,207,6850,4700,2150,0.6861313868613139,90,47,43,186.80538724110949,0.4687241061238529,0.7585834333483459,0.11182773078276251,1057268.8924884396,-8749.295024143285,1048519.5974642963,1691,1,430.59420289855075,93,114,40,38.1390463565691,0.5583735909822867,42.9410460992908,8225.886524822761,88.45039274002968,8
1718,32,0,0,206,0.0,0.0,1.0,206,6300,4400,1900,0.6984126984126984,82,44,38,187.9333797685475,0.4680504578104034,0.761473718366307,0.11298157925706366,1058552.1775931148,-7712.542320713765,1050839.635272401,1692,4,433.6796116504854,94,112,43,37.951160940119905,0.5600222491909386,42.78508771929827,8230.877192982527,87.56252332960135,0
1719,32,0,2,204,0.0,0.009708737864077669,0.9902912621359223,206,7000,4700,2300,0.6714285714285714,93,47,46,188.4349024358122,0.4680400978767069,0.7627192821044331,0.11388935496445515,1060161.3100642632,-8245.721394363813,1051915.5886698994,1693,5,434.6796116504854,78,128,41,37.73915326298532,0.5616909385113269,42.58966244725736,8237.130801687706,105.6042410472783,0
1720,32,1,0,205,0.004878048780487805,0.0,1.0,205,5500,3900,1600,0.7090909090909091,71,39,32,167.5090855353297,0.46764606249003665,0.7337615598378204,0.09989111482167995,1056102.6267201165,-11118.642953330536,1044983.9837667859,1694,0,437.5609756097561,88,117,43,38.77926973714182,0.5546239837398375,43.08286516853934,8221.348314606785,93.4244126659862,8
1721,32,0,1,204,0.0,0.004878048780487805,0.9951219512195122,205,6500,4700,1800,0.7230769230769231,83,47,36,205.20523656354555,0.4674049497847919,0.7767993340064117,0.11983359234436096,1049710.0207270442,-4418.801374716398,1045291.2193523278,1695,1,438.5609756097561,83,122,39,38.60551319293154,0.5453252032520326,43.86160714285715,8196.428571428598,98.75215146299516,8
1722,32,0,1,203,0.0,0.004901960784313725,0.9950980392156863,204,6850,4900,1950,0.7153284671532847,88,49,39,203.53527116144687,0.46718594046814127,0.7755946040640616,0.1194582845438253,1051253.1575896186,-4856.580702134469,1046396.576887484,1696,2,441.59313725490193,67,137,38,38.45625659873703,0.5471303104575164,43.67340686274506,8202.450980392076,122.42464149838919,0
1723,32,1,4,200,0.004901960784313725,0.0196078431372549,0.9803921568627451,204,5800,4200,1600,0.7241379310344828,74,42,32,203.16281243730955,0.4667135532373869,0.7753645388008685,0.11991475066853716,1052978.3695360392,-3814.790601881309,1049163.578934158,1697,0,442.5147058823529,68,136,44,38.251289746758474,0.5486111111111112,43.46316425120771,8209.178743961305,120.72321682296037,0
1724,32,2,0,202,0.009900990099009901,0.0,1.0,202,6000,3900,2100,0.65,81,39,42,197.01860725215494,0.46703313055186113,0.7661689023504412,0.11691156931664691,1054607.0765830458,-4844.556514668737,1049762.520068377,1698,0,446.43564356435644,72,130,46,38.206679820661044,0.5506910066006601,43.26484018264836,8215.525114155162,114.10451547437725,0
1725,32,0,3,199,0.0,0.01485148514851485,0.9851485148514851,202,7900,6000,1900,0.759493670886076,98,60,38,197.7370168888901,0.46671140994696486,0.7652821122112226,0.11815070320798787,1056702.8436634259,-6510.146391197886,1050192.697272228,1699,1,447.43564356435644,75,127,36,37.92822222222219,0.5527021452145214,43.0098684210526,8223.684210526244,109.64912280701658,0
1726,32,0,0,199,0.0,0.0,1.0,199,5650,3700,1950,0.6548672566371682,76,37,39,198.14056871779997,0.4662580579666007,0.7624397648064378,0.11861239598794479,1057266.493656694,-3552.5231321180518,1053713.9705245758,1700,2,452.5075376884422,75,124,38,37.84796276548475,0.554177135678392,42.94133771929822,8225.87719298239,109.67836257309854,0
1727,32,0,2,197,0.0,0.010050251256281407,0.9899497487437185,199,6850,5300,1550,0.7737226277372263,84,53,31,190.48725352344826,0.46598099927245656,0.7533872163255042,0.11165299894612633,1050849.7927246825,-6615.301823638038,1044234.4909010445,1701,3,453.5075376884422,75,124,42,38.84082967875351,0.5489949748743719,43.72258771929824,8200.87719298244,109.34502923976586,8
1728,32,1,0,198,0.005050505050505051,0.0,1.0,198,6100,4200,1900,0.6885245901639344,80,42,38,187.10598162885447,0.4660212531405425,0.7491785829978257,0.11037873756532643,1052816.312367592,-6302.354079918306,1046513.9582876737,1702,0,454.35858585858585,77,121,45,38.683317714841024,0.5510311447811448,43.482905982905976,8208.54700854699,106.60450660450635,0
1729,32,2,0,200,0.01,0.0,1.0,200,6450,4900,1550,0.7596899224806202,80,49,31,187.7268954846991,0.4664625209380235,0.7537004206730784,0.11156341217376368,1055058.6800792525,-6837.421886907618,1048221.2581923448,1703,0,450.805,80,120,45,38.389235276442335,0.5533333333333333,43.209876543209866,8217.283950617255,102.71604938271568,0
1730,32,1,2,199,0.004975124378109453,0.009950248756218905,0.9900497512437811,201,6200,4300,1900,0.6935483870967742,81,43,38,190.66538074623335,0.4664427860696518,0.7584243881925039,0.11391496315700808,1056675.352386144,-6105.718322427178,1050569.6340637167,1704,0,449.55721393034827,81,120,38,38.113362992255716,0.5550373134328358,43.013211382113816,8223.577235772344,101.52564488607831,0
1731,32,1,2,198,0.005,0.01,0.99,200,6800,4300,2500,0.6323529411764706,93,43,50,189.62290848112454,0.4663766750418761,0.7562125976748628,0.11396923262319092,1058477.8546712764,-6657.670126874443,1051820.184544402,1705,0,452.7,84,116,43,37.91690489803696,0.5570833333333334,42.79411764705881,8230.588235294086,97.98319327731055,0
1732,32,0,1,197,0.0,0.005050505050505051,0.9949494949494949,198,5750,3900,1850,0.6782608695652174,76,39,37,189.11057176031656,0.46592831872019685,0.7539563379913132,0.11405731359294002,1059527.1111111022,-5276.44444444494,1054250.6666666572,1706,1,458.06060606060606,74,124,47,37.80022128670117,0.5586069023569024,42.666666666666636,8234.666666666595,111.27927927927831,0
1733,32,0,1,196,0.0,0.005076142131979695,0.9949238578680203,197,7100,4900,2200,0.6901408450704225,93,49,44,189.937455838631,0.4653982786007804,0.753290744095438,0.11497740647330776,1060632.4843987087,-6209.232866700973,1054423.2515320077,1707,2,461.20304568527916,76,121,46,37.6421947246742,0.5603320642978004,42.5324675324675,8238.961038960964,108.40738209159163,0
1734,32,0,2,194,0.0,0.01020408163265306,0.9897959183673469,196,4700,3100,1600,0.6595744680851063,63,31,32,188.01516511820304,0.465288134484563,0.7490164676018543,0.11406732675335601,1061301.336650351,-3991.850789903364,1057309.4858604476,1708,3,463.8826530612245,76,120,47,37.608992541233306,0.5621279761904762,42.45129870129866,8241.558441558349,108.44155844155722,0
1735,32,0,4,190,0.0,0.020618556701030927,0.979381443298969,194,5550,4300,1250,0.7747747747747747,68,43,25,188.4525599613884,0.46491684917116255,0.7477400369287603,0.11478474106739013,1062485.207100582,-4304.388560158341,1058180.8185404236,1709,4,468.80927835051546,77,117,45,37.451414800995025,0.5636812714776632,42.30769230769228,8246.15384615377,107.09290709290609,0
1736,32,1,0,191,0.005235602094240838,0.0,1.0,191,5700,4000,1700,0.7017543859649122,74,40,34,192.3917191241164,0.46416138513823824,0.7472123528020336,0.11518823785819252,1057311.8513380615,-3216.391054153614,1054095.4602839078,1710,0,466.6910994764398,86,105,35,37.99012187548514,0.5592822862129145,42.935823754789276,8226.053639846754,95.65178650984598,8
1737,32,5,1,195,0.025510204081632654,0.00510204081632653,0.9948979591836735,196,5400,3800,1600,0.7037037037037037,70,38,32,187.82888469864594,0.4650003270538985,0.750646786023917,0.11369397388085359,1060613.9081790105,-4757.214506173015,1055856.6936728375,1711,0,455.76020408163265,77,119,40,37.69878062485949,0.5623405612244898,42.534722222222214,8238.888888888874,106.99855699855681,0
1738,32,1,1,195,0.00510204081632653,0.00510204081632653,0.9948979591836735,196,5050,3300,1750,0.6534653465346535,68,33,35,184.7932574923549,0.46467926914355484,0.7470406788258053,0.11250995139393201,1062362.849603715,-4986.5016765739,1057376.347927141,1712,0,456.7244897959184,80,116,39,37.56082497379847,0.5637755102040816,42.32253086419752,8245.679012345647,103.07098765432059,0
1739,32,2,1,196,0.01015228426395939,0.005076142131979695,0.9949238578680203,197,6000,4400,1600,0.7333333333333333,76,44,32,185.40509081039087,0.46414327152180673,0.7497519332803038,0.11362945664517979,1064336.1111111073,-5933.333333333538,1058402.7777777738,1713,0,454.21319796954316,84,113,38,37.30142703284868,0.5658312182741116,42.08333333333332,8253.333333333303,98.2539682539679,0
1740,32,0,1,195,0.0,0.00510204081632653,0.9948979591836735,196,6150,4400,1750,0.7154471544715447,79,44,35,189.16696075396726,0.46402570643642077,0.7530989743097705,0.11636835210623103,1065448.9835640127,-5040.450788158449,1060408.5327758542,1714,1,457.53061224489795,84,112,42,37.06704817083791,0.567123724489796,41.9485294117647,8257.64705882352,98.30532212885143,0
1741,32,0,3,192,0.0,0.015384615384615385,0.9846153846153847,195,4550,3200,1350,0.7032967032967034,59,32,27,189.40998584861788,0.46378094986342405,0.752668510262055,0.11681710891930551,1066212.6951331457,-3159.7337006429516,1063052.9614325026,1715,2,460.35897435897436,87,108,43,36.96655661530937,0.568215811965812,41.856060606060595,8260.606060606031,94.9494949494946,0
1742,32,0,0,192,0.0,0.0,1.0,192,6500,4900,1600,0.7538461538461538,81,49,32,189.66784459680454,0.4626832687972659,0.7499537414657742,0.11744079670488936,1067390.7966165824,-4410.057652653601,1062980.7389639288,1715,3,458.9114583333333,88,104,44,36.814618452057246,0.5704752604166667,41.7134831460674,8265.168539325792,93.92236976506582,0
1743,32,1,1,192,0.0051813471502590676,0.0051813471502590676,0.9948186528497409,193,6750,4600,2150,0.6814814814814815,89,46,43,198.15209141507944,0.4629535927605066,0.7628944889307592,0.11736700799200775,1054044.4444444366,-3577.777777778159,1050466.6666666584,1716,0,457.5284974093264,74,119,39,38.247429653679625,0.5534326424870466,43.33333333333331,8213.333333333272,110.99099099099017,8
1744,32,2,1,193,0.010309278350515464,0.005154639175257732,0.9948453608247423,194,5650,3700,1950,0.6548672566371682,76,37,39,221.28009510806203,0.4635814504210958,0.7843146217991133,0.12725182536227003,1044976.6436622435,1796.5062190569938,1046773.1498813005,1717,0,455.4639175257732,73,121,36,38.78471265950612,0.5426331615120275,44.439752252252255,8177.927927927929,112.02640997161546,8
1745,32,2,2,193,0.010256410256410256,0.010256410256410256,0.9897435897435898,195,5100,3800,1300,0.7450980392156863,64,38,26,224.36404841141956,0.46420059036038414,0.7858334279424399,0.13000675869171305,1047317.7110460082,2896.088324652811,1050213.799370661,1718,0,453.44102564102565,79,116,34,38.413373454119764,0.5449252136752136,44.153645833333336,8187.083333333343,103.63396624472585,0
1746,32,0,0,193,0.0,0.0,1.0,193,6650,4800,1850,0.7218045112781954,85,48,37,223.71574286509215,0.4637092058865861,0.7842235242845397,0.1299588649883554,1048095.6599603703,1645.099832342647,1049740.759792713,1719,1,458.75129533678756,80,113,36,38.33283087126925,0.5462543177892919,44.05864197530864,8190.12345679011,102.37654320987637,0
1747,32,0,2,191,0.0,0.010362694300518135,0.9896373056994818,193,6450,5000,1450,0.7751937984496124,79,50,29,223.7965385379015,0.46362712291306846,0.7856579749026857,0.13077694756937572,1049913.3150077164,1943.3931327160326,1051856.7081404324,1720,2,459.75129533678756,83,110,36,38.10396193380776,0.5479274611398963,43.83680555555556,8197.222222222224,98.7617135207497,0
1748,32,2,0,193,0.010362694300518135,0.0,1.0,193,5600,4000,1600,0.7142857142857143,72,40,32,216.55449192552652,0.4638722474093264,0.7792169596662992,0.1273811901890505,1051930.3820783994,1360.049886402424,1053290.4319648019,1721,0,459.59067357512953,71,122,36,38.03820130151024,0.5499784110535406,43.59085648148147,8205.092592592559,115.56468440271209,0
1749,32,2,0,195,0.010256410256410256,0.0,1.0,195,6050,3700,2350,0.6115702479338843,84,37,47,211.48148472996144,0.46442968543484003,0.77750548697416,0.1253560231167137,1054272.6049382677,-458.1728395064147,1053814.4320987612,1722,0,455.8666666666667,74,121,40,37.876943332251194,0.5520833333333333,43.30555555555554,8214.222222222192,111.00300300300259,0
1750,32,1,1,195,0.00510204081632653,0.00510204081632653,0.9948979591836735,196,6600,4900,1700,0.7424242424242424,83,49,34,212.03924742707267,0.4643527603349032,0.779248768472907,0.1265999036108696,1056471.7192757553,-997.3063433567095,1055474.4129323987,1723,0,454.5357142857143,78,118,33,37.589371237000535,0.5539434523809523,43.0379746835443,8222.784810126568,105.42031807854575,0
1751,32,2,0,197,0.01015228426395939,0.0,1.0,197,6050,3800,2250,0.628099173553719,83,38,45,214.0738423360398,0.46466987810352567,0.7835880965901252,0.1285149992552922,1058125.47894545,-146.60260969706223,1057978.876335753,1724,0,453.2182741116751,80,117,35,37.331745595172634,0.5558904399323181,42.8369341563786,8229.218106995868,102.86522633744835,0
1752,32,3,1,199,0.015,0.005,0.995,200,6150,4500,1650,0.7317073170731707,78,45,33,203.10997943927794,0.4653229690117253,0.7708745387453881,0.1201807956944198,1053733.3562901733,-3345.2479338843978,1050388.1083562889,1725,0,447.405,76,124,44,38.15882533825338,0.5481770833333333,43.37121212121212,8212.121212121203,108.05422647527898,8
1753,32,1,1,199,0.005,0.005,0.995,200,5450,3500,1950,0.6422018348623854,74,35,39,211.54835141376566,0.46551821608040206,0.7788436123348004,0.12188191820031778,1045552.3090658319,-1213.0265400529988,1044339.282525779,1726,0,447.245,73,127,43,38.961545521292244,0.5383333333333333,44.3693693693694,8180.180180180254,112.05726274219526,8
1754,32,2,1,200,0.009950248756218905,0.004975124378109453,0.9950248756218906,201,6900,4800,2100,0.6956521739130435,90,48,42,207.49054767340826,0.46617433665008295,0.7752526262157164,0.12059300932443809,1048247.6544001227,-3599.7040182302535,1044647.9503818925,1727,0,444.39800995024876,78,123,38,38.72915808091221,0.540992951907131,44.04008438818568,8190.717299578128,105.00919614843754,0
1755,32,2,3,199,0.009900990099009901,0.01485148514851485,0.9851485148514851,202,4300,3000,1300,0.6976744186046512,56,30,26,204.95312599078375,0.46659082885900527,0.7744048998315132,0.11988093517929685,1050208.3746447302,-1651.302134972153,1048557.072509758,1728,0,443.1039603960396,81,121,43,38.54993058310197,0.5431621287128713,43.800813008130106,8198.3739837399,101.21449362641853,0
1756,32,3,2,200,0.01485148514851485,0.009900990099009901,0.9900990099009901,202,7700,6400,1300,0.8311688311688312,90,64,26,194.10184761808034,0.4660089609707239,0.7597813361583079,0.11459365639259807,1053050.3846329402,-7220.194941563427,1045830.1896913768,1729,0,443.8910891089109,73,129,44,38.4747942386831,0.5457405115511551,43.45439189189188,8209.459459459431,112.45834875971823,0
1757,32,1,1,200,0.004975124378109453,0.004975124378109453,0.9950248756218906,201,6350,4800,1550,0.7559055118110236,79,48,31,192.18768279206347,0.46627072968490874,0.7579679321469315,0.11406804902194685,1054668.8612176296,-6011.127089928081,1048657.7341277015,1730,0,446.62189054726366,73,128,51,38.32304174205459,0.5477819237147595,43.2573198198198,8215.765765765713,112.54473651733854,0
1758,32,1,3,198,0.004975124378109453,0.014925373134328358,0.9850746268656716,201,6550,4900,1650,0.7480916030534351,82,49,33,192.19477782852402,0.466103855721393,0.7587842776638141,0.11455677435541947,1055956.4218249253,-6160.138022151086,1049796.2838027743,1731,0,447.59203980099505,76,125,40,38.163177988414944,0.5494402985074627,43.10064935064934,8220.779220779197,108.16814764183154,0
1759,32,4,2,200,0.019801980198019802,0.009900990099009901,0.9900990099009901,202,7250,5300,1950,0.7310344827586207,92,53,39,197.18402202953752,0.4659745825328801,0.766805627931215,0.11879134985681811,1059184.02777777,-5879.166666667197,1053304.8611111029,1732,0,440.9059405940594,73,129,44,37.634952766531704,0.5524958745874587,42.70833333333331,8233.333333333272,112.78538812785304,0
1760,32,3,1,202,0.014778325123152709,0.0049261083743842365,0.9950738916256158,203,6700,4300,2400,0.6417910447761194,91,43,48,194.9523238616081,0.46577736591393126,0.770120189787109,0.1147403492335623,1052106.0771604879,-6277.895061728752,1045828.1820987591,1733,0,437.99014778325125,74,129,42,38.57027117297656,0.5495689655172413,43.56944444444442,8205.77777777773,110.88888888888825,8
1761,32,1,2,201,0.0049261083743842365,0.009852216748768473,0.9901477832512315,203,6000,3800,2200,0.6333333333333333,82,38,44,230.8051465924189,0.4655040319302866,0.8023604587517967,0.131278059569762,1041562.349783688,1479.5901653936644,1043041.9399490816,1734,0,438.9802955665025,78,125,37,38.96877691645131,0.5334051724137931,44.85759493670886,8164.556962025313,104.67380720545273,8
1762,32,2,0,203,0.009852216748768473,0.0,1.0,203,7150,5200,1950,0.7272727272727273,91,52,39,225.07737771142362,0.4659450243053862,0.7958764578818605,0.12931635081953735,1044691.3726108002,-722.7210670024797,1043968.6515437977,1735,0,439.5566502463054,68,135,39,38.72333983221081,0.5363300492610837,44.474637681159436,8176.811594202932,120.2472293265137,0
1763,32,4,5,202,0.01932367149758454,0.024154589371980676,0.9758454106280193,207,5850,4100,1750,0.7008547008547008,76,41,35,219.1917684945595,0.4665109125588231,0.79437384240157,0.12708927514914276,1047510.7571676456,-1328.8529238695528,1046181.9042437761,1736,0,432.04347826086956,73,134,34,38.52160926812275,0.5387479871175523,44.130067567567586,8187.8378378378775,112.1621621621627,0
1764,32,2,3,201,0.00980392156862745,0.014705882352941176,0.9852941176470589,204,5200,3200,2000,0.6153846153846154,72,32,40,219.18293693889999,0.4655972302714189,0.7920106449971103,0.1274175999135859,1048317.7096014962,-45.32911289658841,1048272.3804885997,1737,0,439.01960784313724,73,131,35,38.4211394632644,0.5398794934640523,44.03153153153154,8190.990990991013,112.20535604097277,0
1765,32,3,1,203,0.014705882352941176,0.004901960784313725,0.9950980392156863,204,5750,3900,1850,0.6782608695652174,76,39,37,213.3353126647871,0.4659654810199942,0.7867833296951929,0.1251051330953398,1050996.4096303289,-1707.0704683890208,1049289.33916194,1738,0,439.9166666666667,68,136,38,38.23702656535311,0.5423304738562091,43.70471014492753,8201.44927536231,120.60954816709281,0
1766,32,0,2,201,0.0,0.009852216748768473,0.9901477832512315,203,7150,5600,1550,0.7832167832167832,87,56,31,214.01857702682364,0.4658037848119787,0.7870754319769051,0.12606614377710368,1052358.806506567,-2705.1331419637518,1049653.6733646032,1739,1,443.0689655172414,68,135,39,38.049897967192535,0.5439757799671593,43.53864734299516,8206.763285024133,120.68769536800197,0
1767,32,1,2,200,0.0049504950495049506,0.009900990099009901,0.9900990099009901,202,6300,4700,1600,0.746031746031746,79,47,32,213.35029428753379,0.4655959066055859,0.7854803149254792,0.1264775900950119,1054305.8804065918,-1712.7060292353399,1052593.1743773564,1740,0,445.4257425742574,71,131,40,37.82483467658606,0.5462046204620462,43.301504629629626,8214.351851851843,115.69509650495554,0
1768,32,2,3,199,0.009900990099009901,0.01485148514851485,0.9851485148514851,202,7100,5600,1500,0.7887323943661971,86,56,30,223.32893755452437,0.4659894627522454,0.7910833385901936,0.1342161175027151,1058452.0235351021,-223.40682629372895,1058228.6167088083,1741,0,445.65841584158414,81,121,35,37.05317454437698,0.5517223597359736,42.79725609756099,8230.487804878081,101.61096055405038,8
1769,32,0,4,195,0.0,0.020100502512562814,0.9798994974874372,199,6350,4700,1650,0.7401574803149606,80,47,33,208.61515009997206,0.46509589191749995,0.7764425216925179,0.12493363277996127,1057389.7301844896,-2032.4965446785122,1055357.2336398112,1742,1,453.26633165829145,85,114,36,37.563410918457116,0.5568990787269682,42.926356589147304,8226.35658914733,96.78066575467447,8
1770,32,2,0,197,0.01015228426395939,0.0,1.0,197,6650,5200,1450,0.7819548872180451,81,52,29,207.59622171725906,0.46490944093373393,0.7732689641589208,0.12494690645082279,1058901.3085510437,-2085.217834667852,1056816.090716376,1743,0,456.56852791878174,90,107,39,37.40210910385338,0.5602791878172588,42.74267399267402,8232.23443223451,91.46927146927234,0
1771,32,0,1,196,0.0,0.005076142131979695,0.9949238578680203,197,5700,3900,1800,0.6842105263157895,75,39,36,209.88087553213558,0.46455117580026933,0.7760899153405638,0.12674069164007798,1059898.8474151257,-609.500385802321,1059289.3470293235,1744,1,457.56852791878174,71,126,38,37.219645868465435,0.5616539763113367,42.621527777777786,8236.111111111128,116.00156494522714,0
1772,32,0,0,196,0.0,0.0,1.0,196,5950,4100,1850,0.6890756302521008,78,41,37,208.6549128648333,0.4645026600383743,0.7669335808421389,0.12217346223383964,1050527.937847941,-1310.4369332528959,1049217.500914688,1745,2,459.0459183673469,87,109,41,38.415301966400264,0.5466624149659864,43.761837121212125,8199.621212121223,94.24851967955429,8
1773,32,1,1,196,0.005076142131979695,0.005076142131979695,0.9949238578680203,197,6450,4800,1650,0.7441860465116279,81,48,33,208.58817005317704,0.4645166442211402,0.7698561081721498,0.12282027414443313,1052241.612389411,-1952.9695235779582,1050288.6428658331,1746,0,457.71065989847716,73,124,40,38.2037453800271,0.548804991539763,43.55292792792791,8206.306306306264,112.41515488090772,0
1774,32,4,2,198,0.02,0.01,0.99,200,5150,3400,1750,0.6601941747572816,69,34,35,203.91867766175457,0.46502250837520936,0.7692208759049142,0.12127401785703787,1055279.4051211518,-2111.763828802422,1053167.6412923494,1747,0,451.735,78,122,44,37.94603891769778,0.5511979166666667,43.18301687763713,8218.143459915607,105.36081358866163,0
1775,32,0,0,198,0.0,0.0,1.0,198,6650,4900,1750,0.7368421052631579,84,49,35,205.25275546887337,0.46438101403202925,0.7692908771244378,0.12260079991192127,1056602.353187855,-2875.8911146592372,1053726.462073196,1748,1,457.24747474747477,82,116,34,37.7475459074038,0.5528724747474747,43.022088353413665,8223.293172690788,100.28406308159498,0
1776,32,1,3,196,0.005025125628140704,0.01507537688442211,0.9849246231155779,199,6400,4400,2000,0.6875,84,44,40,216.88926781341675,0.4647701893304908,0.7856729865230878,0.1235367098727188,1042000.6151480224,-1000.2499038829601,1041000.3652441395,1749,0,455.94472361809045,84,115,42,39.2689925086439,0.533500837520938,44.80392156862746,8166.27450980394,97.21755368814215,8
1777,32,4,1,199,0.02,0.005,0.995,200,5500,4000,1500,0.7272727272727273,70,40,30,211.99599756869094,0.46587468592964826,0.782648101116296,0.12204366660440367,1045308.6747940461,-1179.7489439658448,1044128.9258500802,1750,0,440.935,68,132,42,38.98051896914932,0.5361979166666666,44.39915458937199,8179.227053140112,120.28275078147223,0
1778,32,6,3,202,0.02926829268292683,0.014634146341463415,0.9853658536585366,205,6000,4200,1800,0.7,78,42,36,211.7641219125184,0.467019368723099,0.7868613834229774,0.12398838433214941,1050514.072192244,-2507.761989092798,1048006.3102031512,1751,0,427.8780487804878,76,129,42,38.33735899195751,0.5402439024390244,43.76352813852816,8199.567099567148,107.88904078377827,0
1779,32,3,2,203,0.014634146341463415,0.00975609756097561,0.9902439024390244,205,6100,4100,2000,0.6721311475409836,81,41,40,209.07062687615397,0.4671967160848079,0.7843739254596849,0.12306055885748265,1052132.8935986129,-3105.983275663373,1049026.9103229495,1752,0,428.8536585365854,67,138,46,38.204898446833916,0.5419715447154472,43.566176470588225,8205.882352941153,122.47585601404705,0
1780,32,2,1,204,0.00975609756097561,0.004878048780487805,0.9951219512195122,205,5950,3600,2350,0.6050420168067226,83,36,47,208.17745276719057,0.46760720548381957,0.7808238806298546,0.12312249015443895,1053592.949593825,-3083.1407000177524,1050509.8088938072,1753,0,428.6048780487805,71,134,46,38.04623339159194,0.5444105691056911,43.38831018518515,8211.57407407399,115.65597287428155,0
1781,32,1,6,199,0.004878048780487805,0.02926829268292683,0.9707317073170731,205,6400,4800,1600,0.75,80,48,32,208.135774871352,0.4675962458153993,0.7832312131873354,0.12467939135497479,1057469.444444443,-3380.5555555555984,1054088.8888888876,1754,0,428.50243902439024,74,131,39,37.56584278768234,0.5520833333333333,42.916666666666664,8226.666666666657,111.17117117117104,7
1782,32,1,2,198,0.005,0.01,0.99,200,6850,5000,1850,0.7299270072992701,87,50,37,212.208545370911,0.46588358458961476,0.7833345446994087,0.12765649596922174,1058744.2586200577,-1915.0841916868485,1056829.1744283708,1755,0,439.995,77,123,40,37.30293669746994,0.5539583333333333,42.76175213675213,8231.623931623915,106.90420690420669,0
1783,32,1,1,198,0.005025125628140704,0.005025125628140704,0.9949748743718593,199,6800,4500,2300,0.6617647058823529,91,45,46,219.83611414154666,0.46559819298512767,0.7889093860615541,0.13325335790797904,1061032.0553911931,50.63280736376328,1061082.688198557,1756,0,442.69849246231155,64,135,42,36.82284211836457,0.5556951423785594,42.48397435897437,8240.512820512846,128.75801282051322,0
1784,32,1,1,198,0.005025125628140704,0.005025125628140704,0.9949748743718593,199,6600,4800,1800,0.7272727272727273,84,48,36,214.28362103782533,0.46570817048203983,0.7792298696033868,0.1260104706649049,1051845.5924036233,-1321.3435374152796,1050524.248866208,1757,0,440.7889447236181,69,130,40,38.10698394273554,0.545749581239531,43.60119047619046,8204.761904761866,118.90959282263574,8
1785,32,1,1,198,0.005025125628140704,0.005025125628140704,0.9949748743718593,199,6550,4300,2250,0.6564885496183206,88,43,45,245.151949509932,0.465901688577568,0.8104830920766752,0.1409822624895382,1044981.9567718634,4885.872781065273,1049867.8295529287,1758,0,441.5829145728643,64,135,36,38.173977341610765,0.5342336683417086,44.439102564102576,8177.94871794874,127.78044871794906,7
1786,32,2,1,199,0.01,0.005,0.995,200,6700,5200,1500,0.7761194029850746,82,52,30,236.0536398543761,0.46590713986599663,0.8024620620397234,0.13648469163709137,1046650.4555784898,2713.1299389086585,1049363.5855173985,1759,0,440.335,72,128,42,38.19773767016288,0.5366145833333333,44.235159817351594,8184.47488584474,113.67326230339917,0
1787,32,0,1,198,0.0,0.005025125628140704,0.9949748743718593,199,7350,5500,1850,0.7482993197278912,92,55,37,235.68488680290076,0.46570817048203983,0.7985792415894732,0.1369877143182128,1048266.1281596273,2262.0967509234315,1050528.2249105508,1760,1,443.5326633165829,75,124,34,38.00518741633198,0.5384212730318259,44.037828947368425,8190.789473684221,109.21052631578961,0
1788,32,4,0,202,0.019801980198019802,0.0,1.0,202,4650,2500,2150,0.5376344086021505,68,25,43,222.41783667079022,0.46640713511649673,0.7944580576148055,0.1264604271356785,1041446.4168310377,1277.251808021363,1042723.6686390591,1761,0,437.9207920792079,77,125,41,39.19728852596317,0.5336736798679869,44.87179487179489,8164.102564102608,106.0273060273066,8
1789,32,2,3,201,0.00980392156862745,0.014705882352941176,0.9852941176470589,204,5600,3800,1800,0.6785714285714286,74,38,36,210.2072347415786,0.46661293827875977,0.7804468429398721,0.11910970978206255,1040379.7620031735,-2660.9294296425005,1037718.832573531,1762,0,434.61764705882354,83,121,40,39.64224780755076,0.5331903594771241,45.00248015873014,8159.920634920575,98.31229680627199,8
1790,32,3,1,203,0.014705882352941176,0.004901960784313725,0.9950980392156863,204,6800,4400,2400,0.6470588235294118,92,44,48,218.34331104441225,0.46645044512057693,0.7960769995978567,0.1281658145970352,1051292.4236721478,-1691.466267903555,1049600.9574042442,1763,0,433.0049019607843,63,141,39,38.07179556373946,0.5460069444444444,43.66861979166667,8202.604166666679,130.20006613756632,8
1791,32,1,4,200,0.004901960784313725,0.0196078431372549,0.9803921568627451,204,6400,4900,1500,0.765625,79,49,30,210.18659359706052,0.466068611352587,0.78724313052837,0.12427868566641569,1053514.3076770443,-2913.0832727194397,1050601.2244043248,1764,0,429.45588235294116,70,134,40,38.00445492662476,0.548406862745098,43.39788732394365,8211.267605633773,117.30382293762533,0
1792,32,1,3,198,0.004975124378109453,0.014925373134328358,0.9850746268656716,201,6350,4500,1850,0.7086614173228346,82,45,37,211.2536331577677,0.46635675787728026,0.7849981035033777,0.12555219228227138,1055076.0513750722,-1972.2701778530077,1053103.7811972192,1765,0,433.3880597014925,72,129,44,37.78293324442467,0.5500103648424544,43.207762557077615,8217.351598173489,114.12988330796513,0
1793,32,1,2,197,0.005025125628140704,0.010050251256281407,0.9899497487437185,199,7150,5300,1850,0.7412587412587412,90,53,37,212.11514079736986,0.46605713753954964,0.7835357614259932,0.12681441083085923,1056876.2584237275,-2114.108727810981,1054762.1496959166,1766,0,438.66331658291455,77,122,40,37.53718498311249,0.5527638190954773,42.98878205128203,8224.35897435892,106.8098568098561,0
1794,32,0,2,195,0.0,0.01015228426395939,0.9898477157360406,197,6600,4800,1800,0.7272727272727273,84,48,36,218.8503689942055,0.46539288304154147,0.7885372964834738,0.12637113169576414,1046243.3167965272,-205.85281227168025,1046037.4639842556,1767,3,444.11167512690355,73,124,41,38.68857572754961,0.5416137901861252,44.28490990990991,8182.882882882891,112.09428606688891,8
1795,32,2,1,196,0.01015228426395939,0.005076142131979695,0.9949238578680203,197,5550,3800,1750,0.6846846846846847,73,38,35,215.93037015073668,0.46574251528022376,0.7851945636492759,0.12519058359053056,1047491.7909567594,287.05803023033286,1047778.8489869897,1768,0,441.005076142132,78,119,34,38.607425062269186,0.5438346023688663,44.13238396624474,8187.7637130801995,104.97132965487435,0
1796,32,1,4,193,0.005076142131979695,0.02030456852791878,0.9796954314720813,197,6300,5200,1100,0.8253968253968254,74,52,22,217.31788759121974,0.46543388929175733,0.7871610783882217,0.12641525044976157,1048517.0049450502,-127.69987637358827,1048389.3050686766,1769,0,442.0,80,117,36,38.44402022840685,0.5455795262267343,44.00720164609055,8191.769547325139,102.39711934156423,0
1797,32,0,1,192,0.0,0.0051813471502590676,0.9948186528497409,193,5700,4500,1200,0.7894736842105263,69,45,24,221.5601647277904,0.4645232890759931,0.7868165814148427,0.12921318728589723,1049303.4912170945,2196.770872701247,1051500.2620897957,1770,1,451.69948186528495,83,110,36,38.237302874759926,0.5472258203799655,43.91121031746034,8194.841269841316,98.73302734748573,0
1798,32,1,1,192,0.0051813471502590676,0.0051813471502590676,0.9948186528497409,193,5650,4100,1550,0.7256637168141593,72,41,31,216.4885034134554,0.4643568742803685,0.7802785138827297,0.12583474275877418,1048277.3546007043,1137.9991319449132,1049415.3537326492,1771,0,452.6476683937824,79,114,33,38.495141926950886,0.5455526770293609,44.036458333333364,8190.833333333411,103.6814345991571,8
1799,32,1,0,193,0.0051813471502590676,0.0,1.0,193,6000,4200,1800,0.7,78,42,36,211.7320860352581,0.4643006530656304,0.7757992452759912,0.1237336802309946,1049929.8630829032,-139.23197974858158,1049790.6311031547,1772,0,453.63212435233163,85,108,35,38.410947326114716,0.5476036269430051,43.83478682170544,8197.286821705471,96.4386684906526,0
1800,32,1,1,193,0.005154639175257732,0.005154639175257732,0.9948453608247423,194,5600,4300,1300,0.7678571428571429,69,43,26,211.37017727377042,0.46435542527998863,0.7778691932542052,0.12435477869743662,1051987.156205514,71.74233937789586,1052058.898544892,1773,0,452.2886597938144,68,126,37,38.164066333038946,0.5495597079037801,43.58393719806764,8205.314009661848,120.66638249502718,0
1801,32,1,1,193,0.005154639175257732,0.005154639175257732,0.9948453608247423,194,5550,3500,2050,0.6306306306306306,76,35,41,208.49425715305702,0.46413007674091483,0.7736149200205449,0.12334081317896592,1053669.4397531284,-413.1945747589084,1053256.2451783696,1774,0,453.05670103092785,72,122,37,38.028594862099624,0.5507946735395188,43.37899543378994,8211.872146118689,114.05377980720401,0
1802,32,0,0,193,0.0,0.0,1.0,193,6150,4400,1750,0.7154471544715447,79,44,35,209.21707145472766,0.4642489295480714,0.7707490357229192,0.12426989906889215,1054900.1736111082,-609.3750000001583,1054290.798611108,1775,1,451.5958549222798,77,116,41,37.85708248816766,0.5528929188255614,43.22916666666666,8216.666666666642,106.7099567099564,0
1803,32,0,1,192,0.0,0.0051813471502590676,0.9948186528497409,193,6100,4800,1300,0.7868852459016393,74,48,26,206.02586539971318,0.46405103087219346,0.7666796010134436,0.12277961477400563,1055904.2490135306,-1191.282663550658,1054712.9663499799,1776,2,452.5958549222798,80,113,37,37.81433553597653,0.5544581174438687,43.10699588477366,8220.576131687238,102.75720164609046,0
1804,32,1,1,192,0.0051813471502590676,0.0051813471502590676,0.9948186528497409,193,6150,4300,1850,0.6991869918699187,80,43,37,205.7595212721869,0.4637204501295337,0.7680734250346559,0.12333079371310336,1057653.0833687629,-1225.561578798227,1056427.5217899645,1777,0,453.3834196891192,83,110,38,37.60415159407706,0.5564011226252159,42.894345238095234,8227.380952380941,99.12507171543302,0
1805,32,1,0,193,0.0051813471502590676,0.0,1.0,193,5700,4500,1200,0.7894736842105263,69,45,24,208.65773902211106,0.46334489241508353,0.7717899771349452,0.12570356472795502,1059184.0277777805,-98.61111111097625,1059085.4166666695,1778,0,454.3316062176166,74,119,39,37.339743589743584,0.5578583765112263,42.70833333333334,8233.333333333356,111.26126126126157,0
1806,32,2,0,195,0.010256410256410256,0.0,1.0,195,5850,4400,1450,0.7521367521367521,73,44,29,201.05865554256047,0.4633469909243105,0.7656119657197995,0.12214329788234109,1061701.2623456812,-2157.154320987496,1059544.1080246938,1779,0,450.66153846153844,74,121,42,37.223562660627984,0.5599358974358974,42.402777777777786,8243.111111111128,111.39339339339362,0
1807,32,0,3,192,0.0,0.015384615384615385,0.9846153846153847,195,6300,5000,1300,0.7936507936507936,76,50,26,200.409766731581,0.46310798308220985,0.7654789029104363,0.12224150708360038,1062911.2593538456,-2696.4404913047547,1060214.8188625409,1780,1,451.66153846153844,75,120,43,37.09058982540106,0.5613247863247863,42.256030701754405,8247.807017543906,109.97076023391875,0
1808,32,0,1,191,0.0,0.005208333333333333,0.9947916666666666,192,7050,5200,1850,0.7375886524822695,89,52,37,199.37635952662163,0.4626662258216987,0.7612311429853631,0.12215597256275793,1064247.9362992216,-3012.824165388102,1061235.1121338336,1781,2,454.0572916666667,77,115,44,36.951981496824075,0.5634223090277778,42.094017094017104,8252.991452991479,107.18170718170751,0
1809,32,1,0,192,0.005208333333333333,0.0,1.0,192,5400,3800,1600,0.7037037037037037,70,38,32,199.50732947473844,0.46213902977748694,0.7622597573580066,0.12291054943201155,1065888.370430962,-1269.4915394275145,1064618.8788915344,1782,0,453.6510416666667,81,111,38,36.745947763887514,0.5651584201388888,41.895325203252035,8259.349593495946,101.96727893204873,0
1810,32,1,3,190,0.0051813471502590676,0.015544041450777202,0.9844559585492227,193,6850,5100,1750,0.7445255474452555,86,51,35,200.9393653604993,0.46206304871905585,0.7661063496207285,0.12449735282388599,1067575.1730103795,-2546.424452133859,1065028.7485582456,1783,0,452.2953367875648,84,109,42,36.50073536388652,0.5670876511226253,41.69117647058823,8265.882352941167,98.40336134453771,0
1811,32,2,1,191,0.010416666666666666,0.005208333333333333,0.9947916666666666,192,5300,4200,1100,0.7924528301886793,64,42,22,239.14398017623554,0.46188565754072136,0.7970998092159651,0.14770066358948233,1066636.8511193283,7315.956395864203,1073952.8075151925,1784,0,453.4739583333333,82,110,35,35.630134156418606,0.5679796006944444,41.80471887550198,8262.24899598387,100.75913409736427,8
1812,32,1,0,192,0.005208333333333333,0.0,1.0,192,6600,4600,2000,0.696969696969697,86,46,40,239.43971280080615,0.46201347985747526,0.7963192797866037,0.14883374926122403,1068537.7168637123,6170.072808535631,1074707.7896722478,1785,0,452.234375,67,125,34,35.38702825528555,0.5697699652777778,41.57475490196081,8269.607843137303,123.42698273339258,0
1813,32,1,3,190,0.0051813471502590676,0.015544041450777202,0.9844559585492227,193,6250,4700,1550,0.752,78,47,31,238.56612444041986,0.4620720441134139,0.7940363796714802,0.1489453752484029,1069840.5884249194,6195.544589918379,1076036.1330148377,1786,0,450.8860103626943,70,123,33,35.24834515366431,0.5714054404145077,41.417253521126774,8274.647887323974,118.20925553319962,0
1814,32,2,1,191,0.010416666666666666,0.005208333333333333,0.9947916666666666,192,5800,4100,1700,0.7068965517241379,75,41,34,239.84613010944884,0.46222254035776617,0.7949524045856124,0.15092005985752657,1072145.1975308715,7229.975308642371,1079375.1728395137,1787,0,453.3072916666667,74,118,36,34.93020531530568,0.5740017361111112,41.138888888888914,8283.555555555613,111.93993993994071,0
1815,32,0,1,190,0.0,0.005235602094240838,0.9947643979057592,191,5200,3500,1700,0.6730769230769231,69,35,34,243.18754772422557,0.46152521355745385,0.7969822852021791,0.15362335331847535,1073296.0000000084,8802.444444444911,1082098.4444444533,1788,1,456.63350785340316,74,117,32,34.70144251394254,0.575261780104712,41.00000000000003,8288.000000000065,112.00000000000088,0
1816,32,2,2,190,0.010416666666666666,0.010416666666666666,0.9895833333333334,192,5200,3700,1500,0.7115384615384616,67,37,30,214.20272135833082,0.46189417902850494,0.7708018947015414,0.13475791457606398,1072087.6736111122,2328.8194444444607,1074416.4930555567,1789,0,453.9375,75,117,42,35.60110663983901,0.5750868055555556,41.145833333333336,8283.333333333341,110.44444444444456,8
1817,32,0,1,189,0.0,0.005263157894736842,0.9947368421052631,190,5500,4100,1400,0.7454545454545455,69,41,28,214.91951207458615,0.4610438132367957,0.7705814106934696,0.13569983968192195,1073152.4896459943,2628.281891268818,1075780.7715372632,1790,1,459.67894736842106,76,114,39,35.451272809583486,0.5764254385964912,41.01731601731601,8287.445887445874,109.04534062428782,0
1818,32,0,1,188,0.0,0.005291005291005291,0.9947089947089947,189,5350,4200,1150,0.7850467289719626,65,42,23,215.3718764589012,0.4605074299223235,0.7700868621064048,0.1363281774698612,1073890.5802132855,3107.1658744147776,1076997.7460877004,1791,2,463.0952380952381,78,111,39,35.348593580347405,0.5773809523809523,40.92827004219409,8290.295358649793,106.28583793140761,0
1819,32,3,0,191,0.015706806282722512,0.0,1.0,191,5900,4600,1300,0.7796610169491526,72,46,26,208.67987647569433,0.46081105906126574,0.7652049435642578,0.1330947421934492,1076101.124567474,812.1299500192445,1076913.2545174933,1792,0,458.9267015706806,84,107,43,35.24989761522225,0.5798974694589878,40.661764705882355,8298.823529411766,98.79551820728292,0
1820,32,1,4,188,0.005208333333333333,0.020833333333333332,0.9791666666666666,192,5300,3700,1600,0.6981132075471698,69,37,32,208.29182805665863,0.4607983156995346,0.7710034285106135,0.1335260245121103,1077585.5501033026,1190.452823691276,1078776.0029269939,1793,0,457.53125,65,127,43,35.077426564495546,0.57958984375,40.48295454545453,8304.545454545429,127.76223776223736,8
1821,32,1,0,189,0.005291005291005291,0.0,1.0,189,5850,4200,1650,0.717948717948718,75,42,33,203.64683971941358,0.46034091335509775,0.7625383965422912,0.13110587087291178,1078823.3529471802,289.7932886388212,1079113.146235819,1794,0,465.1058201058201,67,122,44,35.045928952077546,0.5807980599647267,40.33394607843136,8309.313725490169,124.01960784313684,0
1822,32,0,2,187,0.0,0.010582010582010581,0.9894179894179894,189,6350,4500,1850,0.7086614173228346,82,45,37,207.82473478076545,0.46002195204322865,0.7608331919313454,0.12867127081191765,1067362.824793146,214.87919549675962,1067577.7039886427,1795,1,466.1058201058201,82,107,42,36.349105118237745,0.5677358906525574,41.71686746987951,8265.060240963836,100.79341757272971,8
1823,32,0,0,187,0.0,0.0,1.0,187,5500,3700,1800,0.6727272727272727,73,37,36,209.9442449604767,0.4592832978743795,0.7595435052182458,0.13037863336544184,1068262.9659018319,1955.132359100127,1070218.098260932,1796,2,471.71122994652404,70,117,43,36.18318949201304,0.5690173796791445,41.607981220657294,8268.544600939003,118.12206572770005,0
1824,32,1,1,187,0.005319148936170213,0.005319148936170213,0.9946808510638298,188,4850,3600,1250,0.7422680412371134,61,36,25,210.93713699148844,0.45915704289452725,0.7601210550563007,0.13168283092731037,1069811.924645283,2682.6129008063313,1072494.5375460894,1797,0,470.1968085106383,71,117,45,35.96632024095938,0.5705895390070922,41.42071759259262,8274.537037037091,116.5427751695365,0
1825,32,1,0,188,0.005319148936170213,0.0,1.0,188,5250,3400,1850,0.6476190476190476,71,34,37,210.30797923717674,0.4587955588424925,0.7588214668422533,0.13215046159448962,1071737.8992167949,2229.0063712366377,1073966.9055880315,1798,0,471.17021276595744,73,115,38,35.74504151709634,0.5721409574468085,41.1880630630631,8281.981981982064,113.45180797235705,0
1826,32,0,1,187,0.0,0.005319148936170213,0.9946808510638298,188,5600,4100,1500,0.7321428571428571,71,41,30,211.66304627391023,0.4584364451776843,0.7572816652584662,0.13351159620205488,1072862.1635072087,2217.0547519913002,1075079.2182592,1799,1,472.17021276595744,77,111,40,35.5713855939488,0.5736923758865249,41.05235042735047,8286.324786324889,107.61460761460894,0
1827,32,0,2,185,0.0,0.0106951871657754,0.9893048128342246,187,5950,4300,1650,0.7226890756302521,76,43,33,219.4664769548221,0.45815963237689994,0.7654283830380217,0.13907564458688357,1074218.5441480316,3800.9918727418744,1078019.5360207735,1800,2,475.3529411764706,78,109,33,35.202088952216215,0.5758132798573975,40.88871308016882,8291.561181434708,106.30206642865011,0
1828,32,0,1,184,0.0,0.005405405405405406,0.9945945945945946,185,6100,4100,2000,0.6721311475409836,81,41,40,221.87858780255965,0.4574556893850372,0.7672875354292983,0.1410055493068954,1075052.5092337301,4606.226512476049,1079658.7357462063,1801,3,479.25945945945944,82,103,35,35.03679674639298,0.5776463963963965,40.78815261044179,8294.779116465927,101.15584288373081,0
1829,32,1,4,181,0.005405405405405406,0.021621621621621623,0.9783783783783784,185,5100,3800,1300,0.7450980392156863,64,38,26,235.754921773675,0.45723903251077164,0.7753762177324606,0.14125483968456218,1057535.3642751393,7763.83341551566,1065299.197690655,1802,0,480.23783783783784,77,108,38,36.84759882603498,0.559740990990991,42.90865384615382,8226.923076923009,106.84315684315597,8
1830,32,1,1,181,0.005494505494505495,0.005494505494505495,0.9945054945054945,182,5850,4000,1850,0.6837606837606838,77,40,37,215.20911650265916,0.45730311355311354,0.7543014258094596,0.125254802338599,1048679.6987662325,2887.086293151522,1051566.785059384,1803,0,487.2362637362637,78,104,38,38.47771597308065,0.5471039377289377,43.98734177215193,8192.405063291211,105.03083414475911,8
1831,32,0,0,181,0.0,0.0,1.0,181,4350,2600,1750,0.5977011494252874,61,26,35,217.54802771361938,0.4567398199304276,0.753741129697995,0.12688341724486318,1049327.9322224078,5105.8444159593955,1054433.7766383672,1804,1,488.97237569060775,78,103,38,38.33700185356814,0.5486302946593002,43.90822784810129,8194.93670886082,105.06329113924127,0
1832,32,2,1,182,0.01092896174863388,0.00546448087431694,0.994535519125683,183,5100,3400,1700,0.6666666666666666,68,34,34,211.51151906712656,0.4573925619007586,0.7535186475338504,0.12239551771032509,1046905.008126968,2586.4937175836785,1049491.5018445516,1805,0,484.6174863387978,77,106,41,38.79368104138388,0.5488957194899817,44.204059829059844,8185.470085470123,106.30480630480679,8
1833,32,3,1,184,0.016216216216216217,0.005405405405405406,0.9945945945945946,185,5750,4300,1450,0.7478260869565218,72,43,29,209.08812761801866,0.45847654719937325,0.7527329973657375,0.12202026277747847,1049506.746130171,1137.8800941675904,1050644.6262243385,1806,0,480.2756756756757,83,102,35,38.531377604544986,0.5512950450450451,43.88640873015875,8195.634920634968,98.74258940524058,0
1834,32,2,1,185,0.010752688172043012,0.005376344086021506,0.9946236559139785,186,4550,3100,1450,0.6813186813186813,60,31,29,206.67710976330065,0.4591555264942362,0.7533911801856221,0.12128209770157711,1051202.2188996414,1701.8872757892113,1052904.1061754306,1807,0,477.247311827957,73,113,33,38.38206152635141,0.5533154121863799,43.67961711711711,8202.252252252241,112.35961989386632,0
1835,32,4,1,188,0.021164021164021163,0.005291005291005291,0.9947089947089947,189,5350,4100,1250,0.7663551401869159,66,41,25,198.8926696072261,0.4597029907313595,0.7537397438846716,0.11790029383933448,1054288.903061219,-1211.9331065763117,1053076.9699546427,1808,0,470.25925925925924,76,113,39,38.19806763285022,0.554783950617284,43.30357142857141,8214.28571428567,108.08270676691671,8
1836,32,1,0,189,0.005291005291005291,0.0,1.0,189,5100,3800,1300,0.7450980392156863,64,38,26,196.437455991298,0.45953061090472436,0.7508925176276313,0.11694992795569889,1055604.5149459618,-1427.9469102175917,1054176.5680357441,1809,0,471.24867724867727,78,111,43,38.09783538672142,0.5561618165784832,43.1434599156118,8219.409282700384,105.37704208590236,0
1837,32,1,5,185,0.005263157894736842,0.02631578947368421,0.9736842105263158,190,5800,3800,2000,0.6551724137931034,78,38,40,235.4812075958264,0.4596711686623967,0.792197935837988,0.1350637429534391,1044164.0043107861,5376.2001326396,1049540.2044434256,1810,0,469.7631578947368,65,125,42,38.523518266814925,0.5406798245614035,44.53914141414142,8174.747474747487,125.76534576534596,8
1838,32,3,0,188,0.015957446808510637,0.0,1.0,188,5750,4000,1750,0.6956521739130435,75,40,35,235.1063178160384,0.4590657829863087,0.7894093547708341,0.1360766869783741,1046967.474489799,5879.733560090894,1052847.20804989,1811,0,474.25531914893617,69,119,43,38.18232499515223,0.5437721631205674,44.196428571428584,8185.71428571431,118.63354037267116,0
1839,32,2,2,188,0.010526315789473684,0.010526315789473684,0.9894736842105263,190,6400,4800,1600,0.75,80,48,32,222.94020010143393,0.45961663417803766,0.7804559915164375,0.1267989195993077,1041548.3686587579,2040.6003448211063,1043588.969003579,1812,0,470.2526315789474,76,114,37,39.17119565217392,0.5341008771929825,44.85930735930736,8164.502164502162,107.42766005923897,7
1840,32,4,3,189,0.020833333333333332,0.015625,0.984375,192,6000,4400,1600,0.7333333333333333,76,44,32,219.6828379789673,0.4599717313845259,0.7811338399562251,0.12641423504027519,1045174.9105152641,1521.398105281468,1046696.3086205457,1813,0,465.1927083333333,71,121,37,38.800756632325786,0.5373263888888888,44.415509259259274,8178.703703703732,115.19300991132016,0
1841,32,4,3,190,0.02072538860103627,0.015544041450777202,0.9844559585492227,193,6600,5300,1300,0.803030303030303,79,53,26,218.0108526013374,0.461017334124928,0.7818949130134989,0.12677324378987487,1048407.5565487964,512.8450553778571,1048920.4016041742,1814,0,462.4507772020725,76,117,35,38.439933234682776,0.540587219343696,44.02056277056279,8191.341991342038,107.78081567555314,0
1842,32,1,2,189,0.005235602094240838,0.010471204188481676,0.9895287958115183,191,5800,4300,1500,0.7413793103448276,73,43,30,217.72203931066974,0.46020023881693767,0.780314200832616,0.1268510135425717,1049003.7904582648,1678.2489006394462,1050682.0393589041,1815,0,467.5916230366492,78,113,37,38.37296376401122,0.5418302792321117,43.9477848101266,8193.670886075988,105.04706264199984,0
1843,32,2,0,191,0.010471204188481676,0.0,1.0,191,4950,3200,1750,0.6464646464646465,67,32,35,220.1070791195717,0.4602277946174336,0.7838930745328399,0.1289198606271777,1050625.0,3100.000000000002,1053725.0,1816,0,468.5340314136126,64,127,40,38.109756097560975,0.543466404886562,43.75,8200.0,128.125,0
1844,32,2,2,191,0.010362694300518135,0.010362694300518135,0.9896373056994818,193,6300,4300,2000,0.6825396825396826,83,43,40,215.2778868018307,0.46097123272884283,0.7808364117213633,0.12687073772344412,1052510.0359537187,416.42727556696263,1052926.4632292856,1817,0,464.6683937823834,67,126,39,37.99877809631885,0.5453367875647668,43.52022058823529,8207.352941176463,122.49780509218601,0
1845,32,1,0,192,0.005208333333333333,0.0,1.0,192,5650,3800,1850,0.672566371681416,75,38,37,214.5397427303969,0.46119314463350786,0.775379709064542,0.12732345567263514,1054642.3873203672,1202.5412896566727,1055844.9286100238,1818,0,466.46875,82,110,38,37.75246044548729,0.5543619791666667,43.260542168674704,8215.66265060242,100.19100793417586,8
1846,32,0,1,191,0.0,0.005208333333333333,0.9947916666666666,192,6300,4500,1800,0.7142857142857143,81,45,36,217.0850146130955,0.4612028023196626,0.7796375736074894,0.12946365379257702,1056123.2461734728,1153.7060657598895,1057276.9522392328,1819,1,467.46875,83,109,34,37.50301670045369,0.5559353298611112,43.08035714285715,8221.4285714286,99.05335628227229,0
1847,32,1,1,191,0.005208333333333333,0.005208333333333333,0.9947916666666666,192,6250,4100,2150,0.656,84,41,43,218.05213091399474,0.46117496545956954,0.7825898044341848,0.13080047152227203,1057887.993603903,1484.9462547324329,1059372.9398586354,1820,0,468.296875,85,107,37,37.258928431234004,0.5579427083333333,42.86579457364342,8228.294573643436,96.80346557227571,0
1848,32,0,1,190,0.0,0.005235602094240838,0.9947643979057592,191,5150,2800,2350,0.5436893203883495,75,28,47,218.82099455540222,0.4605986497657757,0.7826504723606944,0.13157111819836506,1058599.3546975488,2978.7527261252294,1061578.107423674,1821,1,471.72774869109946,87,104,37,37.15082834790616,0.5590095986038395,42.77935606060608,8231.060606060646,94.60989202368559,0
1849,32,0,2,188,0.0,0.010526315789473684,0.9894736842105263,190,5300,4100,1200,0.7735849056603774,65,41,24,221.77055844219618,0.45999779541446206,0.7858725761772851,0.13360323886639686,1059184.0277777829,3679.1666666669594,1062863.1944444499,1822,2,475.18947368421055,87,103,38,37.00236167341434,0.5601425438596491,42.70833333333335,8233.333333333374,94.63601532567097,0
1850,32,2,1,189,0.010526315789473684,0.005263157894736842,0.9947368421052631,190,5750,4000,1750,0.6956521739130435,75,40,35,214.03595798646919,0.4599508029332591,0.7771950095934266,0.12994557687786035,1061513.1838151938,1690.398242630405,1063203.5820578241,1823,0,475.7473684210526,69,121,39,36.912576790494356,0.562719298245614,42.42559523809524,8242.380952380961,119.45479641131828,0
1851,32,2,2,189,0.010471204188481676,0.010471204188481676,0.9895287958115183,191,5550,3600,1950,0.6486486486486487,75,36,39,212.24267458529363,0.45992238449526957,0.7673545135979059,0.12377553388477007,1049294.2528251058,791.0037293158857,1050085.2565544217,1824,0,473.848167539267,76,115,36,38.477064624053554,0.5470658813263525,43.91233766233769,8194.805194805263,107.82638414217452,8
1852,32,1,1,189,0.005263157894736842,0.005263157894736842,0.9947368421052631,190,5800,4400,1400,0.7586206896551724,72,44,28,208.92059260718284,0.4595980692471921,0.7619543205494868,0.12220158096582678,1050208.3746447335,82.03119836124097,1050290.4058430947,1825,0,474.4421052631579,81,109,38,38.44828441094803,0.5491228070175438,43.80081300813011,8198.373983739926,101.21449362641884,0
1853,32,0,3,186,0.0,0.015873015873015872,0.9841269841269842,189,4650,2900,1750,0.6236559139784946,64,29,35,208.5398902769499,0.4597944575781456,0.7608723706284652,0.12214479287650014,1050625.0000000081,1369.4444444447454,1051994.4444444529,1826,1,475.57142857142856,82,107,40,38.406165311653076,0.5498236331569665,43.75000000000002,8200.000000000064,100.00000000000078,0
1854,32,1,1,186,0.0053475935828877,0.0053475935828877,0.9946524064171123,187,5150,3400,1750,0.6601941747572816,69,34,35,204.58774930360238,0.45965585647748836,0.7531350022924477,0.12016478545015831,1051479.3402777726,473.95833333303017,1051953.2986111057,1827,0,480.7914438502674,69,118,41,38.401141135039964,0.5514705882352942,43.645833333333314,8203.333333333292,118.88888888888829,0
1855,32,1,2,185,0.0053475935828877,0.0106951871657754,0.9893048128342246,187,5250,3700,1550,0.7047619047619048,68,37,31,203.40202455824232,0.45963189772487684,0.7523794679534055,0.12005126715390864,1052966.4857905312,185.1030003540236,1053151.5887908852,1828,0,481.72727272727275,72,115,41,38.24663014054214,0.5528631907308378,43.464611872146094,8209.132420091268,114.01572805682316,0
1856,32,1,2,184,0.005376344086021506,0.010752688172043012,0.989247311827957,186,5450,4300,1150,0.7889908256880734,66,43,23,212.3475342798608,0.4596301947108399,0.7610782331290082,0.1281233538516306,1059647.6670927657,2352.7138625110274,1062000.3809552768,1829,0,484.35483870967744,73,113,38,37.18730627575393,0.5636200716845878,42.65202702702702,8235.135135135113,112.81007034431661,8
1857,32,1,1,184,0.005405405405405406,0.005405405405405406,0.9945945945945946,185,4650,3100,1550,0.6666666666666666,62,31,31,215.1100626997148,0.4593676556991774,0.7619653103332631,0.13008368718235533,1060327.8549382652,3967.4382716044956,1064295.2932098696,1830,0,487.95675675675676,74,111,39,37.031854149806655,0.5645270270270271,42.56944444444442,8237.777777777726,111.32132132132062,0
1858,32,3,2,185,0.016042780748663103,0.0106951871657754,0.9893048128342246,187,4950,3500,1450,0.7070707070707071,64,35,29,230.67982058641948,0.4597480976750426,0.7816812565511233,0.1352838427772792,1051013.2934458202,6139.5115932046365,1057152.805039025,1831,0,483.42245989304814,65,122,37,37.7903888786255,0.5500779857397504,43.70265151515151,8201.51515151514,126.177156177156,7
1859,32,4,1,188,0.021164021164021163,0.005291005291005291,0.9947089947089947,189,5200,3400,1800,0.6538461538461539,70,34,36,225.9893531473341,0.46047225036586736,0.7792802067903508,0.13409927740675415,1054598.8209184627,4665.621073860674,1059264.4419923234,1832,0,479.2116402116402,70,119,40,37.463926510086296,0.5523037918871252,43.265845070422515,8215.492957746434,117.36418511066334,0
1860,32,3,1,190,0.015706806282722512,0.005235602094240838,0.9947643979057592,191,5500,3700,1800,0.6727272727272727,73,37,36,251.75809545846175,0.46111646918342974,0.8094048200562767,0.14536260291645653,1046221.0226615815,8978.922418776878,1055199.9450803583,1833,0,475.15706806282725,61,130,39,37.84986859395532,0.5387761780104712,44.28763440860216,8182.795698924749,134.14419178565163,8
1861,32,2,0,192,0.010416666666666666,0.0,1.0,192,6600,4700,1900,0.7121212121212122,85,47,38,239.49588819908647,0.4615749072862129,0.8003137943579985,0.1354918789919211,1039887.7343049531,4809.76731093997,1044697.5016158931,1834,0,473.6666666666667,72,120,31,38.9571439232807,0.5348307291666667,45.06278538812784,8157.990867579885,113.3054287163873,8
1862,32,2,1,193,0.010309278350515464,0.005154639175257732,0.9948453608247423,194,5300,3700,1600,0.6981132075471698,69,37,32,233.34671744551224,0.4624552641418727,0.7990491909009156,0.13330028353962886,1042911.0371000298,4571.973418997545,1047483.0105190274,1835,0,469.77319587628864,62,132,33,38.73494268505927,0.5370489690721649,44.69246031746034,8169.841269841306,131.77163338453718,0
1863,32,2,1,194,0.010256410256410256,0.005128205128205128,0.9948717948717949,195,6550,4100,2450,0.6259541984732825,90,41,49,224.9208184331106,0.4626971539342673,0.79230828902693,0.13007870212746628,1046723.8662131494,1535.997732426128,1048259.8639455755,1836,0,468.2769230769231,69,126,42,38.47330501900552,0.5377136752136752,44.22619047619047,8184.7619047618855,118.61973775017225,8
1864,32,3,2,195,0.015228426395939087,0.01015228426395939,0.9898477157360406,197,6150,4600,1550,0.7479674796747967,77,46,31,190.45537093636426,0.46292603335750543,0.7516653432097422,0.11039220528621414,1047411.7743175762,-5652.960399845885,1041758.8139177304,1837,0,464.497461928934,84,113,36,39.269206820576734,0.5439403553299492,44.14215686274512,8187.450980392205,97.46965452847863,8
1865,32,1,2,194,0.00510204081632653,0.01020408163265306,0.9897959183673469,196,5250,3600,1650,0.6857142857142857,69,36,33,191.00697347512036,0.4624754709576138,0.7530801495465698,0.11115427839675614,1048639.50483746,-4390.508382909169,1044248.9964545508,1838,0,467.80102040816325,85,111,39,39.10232147363109,0.5453337585034014,43.992248062015534,8192.248062015584,96.37938896488922,0
1866,32,3,0,197,0.015228426395939087,0.0,1.0,197,5450,4200,1250,0.7706422018348624,67,42,25,189.4063920465151,0.46342134569563864,0.7529542979908734,0.1109798315805217,1050740.4310983282,-5046.609193653125,1045693.8219046751,1839,0,466.2690355329949,73,124,44,38.88211800787328,0.5478003384094754,43.73592342342342,8200.450450450451,112.33493767740345,0
1867,32,2,1,198,0.010050251256281407,0.005025125628140704,0.9949748743718593,199,5800,3900,1900,0.6724137931034483,77,39,38,186.10870519204988,0.46372540310982524,0.7521169057696762,0.10998789765779232,1053364.4971555558,-6391.939467821271,1046972.5576877345,1840,0,462.57286432160805,77,122,43,38.64088334287546,0.5497801507537688,43.416132478632456,8210.683760683703,106.63225663225589,0
1868,32,2,4,196,0.01,0.02,0.98,200,5300,3400,1900,0.6415094339622641,72,34,38,181.41707081379562,0.46419074539363486,0.7463653261236911,0.10801068662736807,1055613.5464891936,-6998.7364969137325,1048614.8099922799,1841,0,461.02,83,117,49,38.48252506477414,0.5523958333333333,43.1423611111111,8219.444444444413,99.0294511378845,0
1869,32,3,5,194,0.01507537688442211,0.02512562814070352,0.9748743718592965,199,6150,4200,1950,0.6829268292682927,81,42,39,189.94740089176022,0.46462848755562325,0.7508674737911532,0.11299255408710242,1055353.3472702804,-5857.674932718255,1049495.672337562,1842,0,454.4824120603015,84,115,45,38.2956768621463,0.5549099664991625,43.174019607843135,8218.431372549017,97.83846872082164,8
1870,32,1,5,190,0.005128205128205128,0.02564102564102564,0.9743589743589743,195,5650,4200,1450,0.7433628318584071,71,42,29,190.3634307838766,0.4641278967309895,0.746714833185202,0.11375168926350605,1056720.9817824194,-4417.793705318313,1052303.188077101,1843,0,458.7794871794872,86,109,35,38.11546853646415,0.5561431623931624,43.00766283524905,8223.754789272052,95.62505568920992,0
1871,32,1,1,190,0.005235602094240838,0.005235602094240838,0.9947643979057592,191,5850,3900,1950,0.6666666666666666,78,39,39,197.56679886358978,0.4635298980435381,0.752764343030464,0.11882312630792936,1058679.5943867706,-2218.0123029605484,1056461.5820838101,1844,0,468.24083769633506,84,107,38,37.68758932825151,0.5583006108202444,42.769607843137244,8231.37254901958,97.99253034547118,0
1872,32,0,2,188,0.0,0.010526315789473684,0.9894736842105263,190,6300,4400,1900,0.6984126984126984,82,44,38,195.01899011955558,0.46327798663324976,0.7483220816674323,0.11774454816992638,1059843.8527284607,-2962.0644312956356,1056881.788297165,1845,1,471.0,77,113,36,37.60896637608964,0.5598135964912281,42.6282051282051,8235.897435897377,106.9597069597062,0
1873,32,0,2,186,0.0,0.010638297872340425,0.9893617021276596,188,5850,3800,2050,0.6495726495726496,79,38,41,194.38515298978194,0.4621235825084386,0.7460480875031332,0.11782563742676655,1061030.3837525973,-2200.289305489166,1058830.094447108,1846,2,476.75,78,110,38,37.47845195425838,0.561613475177305,42.48417721518985,8240.506329113872,105.64751703992144,0
1874,32,2,1,187,0.010638297872340425,0.005319148936170213,0.9946808510638298,188,5150,3500,1650,0.6796116504854369,68,35,33,197.24708477938796,0.4619932112109834,0.7505033701243713,0.12078770244617568,1064090.490362805,-772.2505668937465,1063318.2397959114,1847,0,477.45212765957444,83,105,41,37.02635122138873,0.5643838652482269,42.11309523809522,8252.3809523809,99.42627653470963,0
1875,32,1,1,187,0.005319148936170213,0.005319148936170213,0.9946808510638298,188,5350,3500,1850,0.6542056074766355,72,35,37,198.1868792074025,0.46201810027686124,0.7540969528975257,0.12205104110263887,1065776.1327444185,-705.430863530205,1065070.7018808883,1848,0,478.36170212765956,85,103,39,36.793888054564796,0.5660460992907801,41.90891472868215,8258.914728682108,97.16370269037775,0
1876,32,0,2,185,0.0,0.0106951871657754,0.9893048128342246,187,5750,3900,1850,0.6782608695652174,76,39,37,197.8108282425399,0.4618349050275046,0.7517878838305174,0.12211265071267868,1066491.4476629754,-957.2886848405706,1065534.1589781349,1849,1,481.6898395721925,86,101,40,36.71528389679851,0.5674019607843137,41.822318007662815,8261.685823754739,96.06611422970626,0
1877,32,1,2,184,0.005376344086021506,0.010752688172043012,0.989247311827957,186,5300,3900,1400,0.7358490566037735,67,39,28,202.22288860734287,0.46173774581032645,0.7588803413502154,0.12081263723908967,1056656.6021303535,236.0300697637067,1056892.6322001172,1850,0,484.81182795698925,77,109,38,37.818676488420046,0.5563956093189963,43.015491452991434,8223.50427350422,106.79875679875612,8
1878,32,2,2,184,0.010752688172043012,0.010752688172043012,0.989247311827957,186,4650,3100,1550,0.6666666666666666,62,31,31,198.4921259334053,0.4615185750266395,0.7536810709142288,0.11933400178953121,1058564.1385824357,173.32926081802452,1058737.4678432536,1851,0,484.89784946236557,82,104,40,37.67809221761402,0.5594198028673836,42.78363453815259,8230.923694779065,100.37711822901299,0
1879,32,2,3,183,0.010752688172043012,0.016129032258064516,0.9838709677419355,186,5750,4500,1250,0.782608695652174,70,45,25,217.9081994328918,0.4618552019761697,0.7665965404394575,0.12529721467391314,1044938.2716049417,2590.123456790283,1047528.3950617319,1852,0,485.36021505376345,71,115,40,38.87567934782609,0.5420586917562724,44.44444444444446,8177.777777777805,115.17996870109585,8
1880,32,3,2,184,0.016129032258064516,0.010752688172043012,0.989247311827957,186,5350,4300,1050,0.8037383177570093,64,43,21,222.56424795965833,0.4624745713455391,0.7696780029471404,0.12915736279233764,1047779.7067901272,4089.6604938273886,1051869.3672839545,1853,0,481.9569892473118,77,109,39,38.401741293532346,0.5454749103942652,44.097222222222236,8188.888888888919,106.34920634920674,0
1881,32,3,0,187,0.016042780748663103,0.0,1.0,187,5800,3800,2000,0.6551724137931034,78,38,40,219.82280977355458,0.4629034653939777,0.7690839767882955,0.12854254093192147,1050122.6090926647,2968.1805074974764,1053090.789600162,1854,0,480.14973262032083,84,103,42,38.1796619628478,0.5482954545454546,43.811274509803944,8198.039215686336,97.59570494864685,0
1882,32,0,0,187,0.0,0.0,1.0,187,5800,4100,1700,0.7068965517241379,75,41,34,219.8893658321817,0.46246262434592605,0.7714649261337883,0.12895089308581145,1051001.872026374,3020.827025662589,1054022.6990520367,1855,1,481.14973262032083,67,120,42,38.06836859721474,0.5498551693404634,43.70404411764702,8201.470588235215,122.41000877963008,0
1883,32,2,0,189,0.010582010582010581,0.0,1.0,189,5850,4300,1550,0.7350427350427351,74,43,31,210.9940025000179,0.46274367706105296,0.7624989221177423,0.1244601798841529,1052790.003086419,776.4753086419369,1053566.478395061,1856,0,477.04761904761904,74,115,44,38.07382189975994,0.5519731040564374,43.48611111111111,8208.444444444438,110.92492492492484,0
1884,32,2,0,191,0.010471204188481676,0.0,1.0,191,6700,5100,1600,0.7611940298507462,83,51,32,205.78446243638217,0.46345641590888215,0.7590550693889677,0.12233730069640099,1055164.3576732865,-1472.7139748345544,1053691.6436984518,1857,0,473.0418848167539,80,111,45,37.91241006894017,0.5544284467713787,43.197016460905346,8217.695473251015,102.72119341563769,0
1885,32,2,3,190,0.010362694300518135,0.015544041450777202,0.9844559585492227,193,5950,4500,1450,0.7563025210084033,74,45,29,200.4727298747448,0.4638778695308002,0.7551602268728121,0.1198704072281696,1056917.9199512675,-2173.3558667662655,1054744.5640845012,1858,0,469.1295336787565,86,107,38,37.83124087704586,0.5564011226252159,42.9837164750958,8224.521072796968,95.63396596275544,0
1886,32,2,1,191,0.010416666666666666,0.005208333333333333,0.9947916666666666,192,4800,3400,1400,0.7083333333333334,62,34,28,203.68375213783736,0.4633098821989529,0.7584833749568767,0.12243613805137064,1058517.0803326506,-79.4538751712762,1058437.6264574793,1859,0,471.546875,89,103,40,37.55038886138988,0.5579427083333333,42.78935185185186,8230.740740740765,92.48023304203106,0
1887,32,1,4,188,0.005208333333333333,0.020833333333333332,0.9791666666666666,192,5650,4200,1450,0.7433628318584071,71,42,29,198.77652133766102,0.463248527486911,0.7529768941782264,0.12032807742043118,1060632.4843987152,-1884.2328667005968,1058748.2515320147,1860,0,469.9583333333333,76,116,40,37.41461748633879,0.5602213541666667,42.53246753246752,8238.961038961015,108.40738209159231,0
1888,32,1,1,188,0.005291005291005291,0.005291005291005291,0.9947089947089947,189,5250,3500,1750,0.6666666666666666,70,35,35,202.99190468473768,0.46264282899921194,0.75506183811005,0.1233684260040511,1061824.560322154,58.35798816558963,1061882.9183103198,1861,0,473.2116402116402,77,112,42,37.158501814411615,0.5614528218694885,42.387820512820504,8243.589743589724,107.0596070596068,0
1889,32,1,2,187,0.005291005291005291,0.010582010582010581,0.9894179894179894,189,6100,4400,1700,0.7213114754098361,78,44,34,198.90122346475778,0.462862114901122,0.7503695673598099,0.12150817065002373,1063371.7632526925,-1598.8110582325935,1061772.95219446,1862,0,468.9047619047619,81,108,44,37.07253375381887,0.5638778659611994,42.200203252032516,8249.59349593495,101.84683328314753,0
1890,32,0,1,186,0.0,0.0053475935828877,0.9946524064171123,187,5450,3800,1650,0.6972477064220184,71,38,33,198.5837914652304,0.4622505893853142,0.7475779166687266,0.12163035263245948,1064149.673493169,-585.4246302479123,1063564.248862921,1863,1,474.6363636363636,82,105,45,36.98456534786769,0.5652295008912656,42.105923694779115,8252.610441767065,100.64159075325689,0
1891,32,0,1,185,0.0,0.005376344086021506,0.9946236559139785,186,5900,4000,1900,0.6779661016949152,78,40,38,197.05205354833163,0.4620356243340114,0.7438489680360811,0.12117780489233862,1065347.789311804,-1114.2060745866866,1064233.5832372175,1864,2,477.1666666666667,84,102,39,36.87606857902732,0.5668122759856631,41.96078431372549,8257.25490196079,98.30065359477132,0
1892,32,1,1,185,0.005376344086021506,0.005376344086021506,0.9946236559139785,186,6300,5000,1300,0.7936507936507936,76,50,26,200.67630053307383,0.46213128451031676,0.7522222715238658,0.12384691891981651,1066408.2676911093,-699.4267963731554,1065708.8408947361,1865,0,478.0430107526882,87,99,38,36.651574201436645,0.5717405913978495,41.832386363636346,8261.363636363587,94.95820271682284,8
1893,32,0,1,184,0.0,0.005405405405405406,0.9945945945945946,185,4800,3600,1200,0.75,60,36,24,200.32547693848298,0.4617325205640423,0.7515431097060956,0.1239563600636357,1067190.7372732952,957.0986857205389,1068147.8359590156,1866,1,480.9135135135135,87,98,40,36.56403733920003,0.5729729729729729,41.73768939393938,8264.393939393893,94.99303378613669,0
1894,32,0,1,183,0.0,0.005434782608695652,0.9945652173913043,184,4950,3700,1250,0.7474747474747475,62,37,25,198.50133841667926,0.46104515621287717,0.7490071912903247,0.12327529471628097,1068269.8979591834,660.6009070294326,1068930.4988662128,1867,2,483.7717391304348,69,115,41,36.47801005912611,0.5751245471014492,41.607142857142854,8268.571428571426,119.83436853002067,0
1895,32,0,2,181,0.0,0.01092896174863388,0.9890710382513661,183,5700,4200,1500,0.7368421052631579,72,42,30,196.08283540656305,0.46066649652715225,0.7452564516444131,0.12222057455603294,1069355.0421267836,-363.5662566950341,1068991.4758700887,1868,3,487.224043715847,70,113,42,36.40672587632177,0.5763319672131147,41.47593896713615,8272.769953051651,118.18242790073788,0
1896,32,1,0,182,0.005494505494505495,0.0,1.0,182,5350,3300,2050,0.616822429906542,74,33,41,197.47874208213966,0.4602141642887499,0.7443172844157133,0.12368186995344109,1070769.840025935,540.85621356313,1071310.6962394982,1869,0,489.66483516483515,71,111,45,36.19630007643124,0.5779532967032968,41.304976851851855,8278.240740740745,116.59494001043302,0
1897,32,0,3,179,0.0,0.016483516483516484,0.9835164835164835,182,5350,3700,1650,0.6915887850467289,70,37,33,197.0185439998591,0.4599580322991925,0.743198437370068,0.12372923931073093,1071570.027777782,473.83333333358314,1072043.8611111154,1870,1,490.66483516483515,74,108,47,36.10965759673701,0.5793841575091575,41.20833333333335,8281.333333333367,111.90990990991035,0
1898,32,1,2,178,0.005555555555555556,0.011111111111111112,0.9888888888888889,180,5100,3800,1300,0.7450980392156863,64,38,26,205.28381372600668,0.45949785330022763,0.7462844765940333,0.12502562299522738,1062459.125043288,2521.132223376705,1064980.2572666649,1871,0,496.3333333333333,75,105,41,37.02091422442068,0.5685763888888888,42.31085526315791,8246.052631578992,109.94736842105323,7
1899,32,1,1,178,0.00558659217877095,0.00558659217877095,0.994413407821229,179,6950,4800,2150,0.6906474820143885,91,48,43,200.65993482794545,0.4595521310652188,0.7381571097448674,0.12308369947336209,1064590.858862981,-25.85352842536031,1064565.0053345556,1872,0,498.77653631284915,80,99,40,36.87649566257851,0.5707635009310987,42.052469135802475,8254.320987654342,103.17901234567928,0
1900,32,0,0,178,0.0,0.0,1.0,178,5500,3900,1600,0.7090909090909091,71,39,32,202.22973765603533,0.45954804904885843,0.7412127332344147,0.12454384904388224,1065783.4524134125,2006.6215959416413,1067790.0740093542,1873,1,502.438202247191,81,97,42,36.68864128562287,0.5722729400749064,41.90802845528456,8258.943089430904,101.9622603633445,0
1901,32,2,0,180,0.011111111111111112,0.0,1.0,180,5550,4100,1450,0.7387387387387387,70,41,29,199.40965750630392,0.4600332350506931,0.7429939792008751,0.1209693376850919,1061274.1782863983,775.6640824749074,1062049.8423688733,1874,0,497.84444444444443,77,103,41,37.3188898971567,0.5679976851851851,42.45459401709402,8241.452991452994,107.03185703185706,8
1902,32,0,1,179,0.0,0.005555555555555556,0.9944444444444445,180,6500,4700,1800,0.7230769230769231,83,47,36,197.1563205760772,0.4601082402234637,0.7396044696801762,0.120331217950101,1063095.8608173549,-580.7863323185952,1062515.0744850363,1875,1,498.84444444444443,78,102,42,37.15162327143757,0.5697337962962963,42.233649789029535,8248.523206751055,105.75029752244943,0
1903,32,0,2,177,0.0,0.0111731843575419,0.9888268156424581,179,6350,4900,1450,0.7716535433070866,78,49,29,195.3381379963516,0.4596214403782981,0.7354094675396847,0.11969160884561035,1064272.428936136,-571.4010821522129,1063701.0278539837,1876,2,502.53072625698326,80,99,46,37.05310396409875,0.5713454376163873,42.091049382716044,8253.086419753072,103.1635802469134,0
1904,32,1,0,178,0.0056179775280898875,0.0,1.0,178,5700,3800,1900,0.6666666666666666,76,38,38,195.9586023078252,0.4588206743689032,0.7361250252454024,0.11801622576288132,1059089.7838425436,207.5507520568235,1059297.3345946004,1877,0,506.0842696629214,90,88,41,37.678152992822,0.566186797752809,42.719780219780255,8232.967032967132,91.47741147741257,8
1905,32,1,0,179,0.00558659217877095,0.0,1.0,179,5550,3800,1750,0.6846846846846847,73,38,35,192.36849974803533,0.45861057058565063,0.7326658765834515,0.11645640566441624,1060651.5496354622,-542.8105282395127,1060108.7391072228,1878,0,504.2513966480447,75,104,40,37.57724469878453,0.5681447858472999,42.530153508771924,8239.03508771928,109.8538011695904,0
1906,32,1,0,180,0.005555555555555556,0.0,1.0,180,5400,3600,1800,0.6666666666666666,72,36,36,190.85942298259758,0.4585305452100145,0.7292680153288087,0.11619236273912449,1062334.6619131472,-848.6838825690538,1061485.9780305782,1879,0,502.44444444444446,78,102,38,37.40799730495,0.5696180555555556,42.32594936708858,8245.569620253103,105.71243102888594,0
1907,32,1,1,180,0.0055248618784530384,0.0055248618784530384,0.994475138121547,181,6150,4700,1450,0.7642276422764228,76,47,29,192.8254507510507,0.4582195109474115,0.7303987154015745,0.11804453106894747,1064000.6361953772,-1316.719545244695,1062683.9166501325,1880,0,500.6629834254144,81,100,40,37.151477832512285,0.5710750460405156,42.12398373983737,8252.032520325132,101.876944695372,0
1908,32,0,3,177,0.0,0.016666666666666666,0.9833333333333333,180,6150,4900,1250,0.7967479674796748,74,49,25,193.84563586726415,0.45761173184357545,0.7315754745187817,0.11930750529648673,1065601.3655847553,-837.5651414401236,1064763.8004433152,1881,1,496.05555555555554,86,94,35,36.92750378893319,0.5731481481481482,41.93007662835245,8258.237547892619,96.02601799875139,0
1909,32,2,1,178,0.0111731843575419,0.00558659217877095,0.994413407821229,179,5350,3900,1450,0.7289719626168224,68,39,29,225.25622818253322,0.4574388508777436,0.7734351344802832,0.13295516101096908,1052978.369536049,6287.987175896968,1059266.356711946,1882,0,498.76536312849163,68,111,38,37.68451225014222,0.5553421787709497,43.46316425120774,8209.178743961382,120.72321682296149,8
1910,32,2,0,180,0.011111111111111112,0.0,1.0,180,5600,3700,1900,0.6607142857142857,75,37,38,221.57184643962336,0.4577507500517277,0.7722648077172334,0.13204097820101088,1055897.008115969,5191.409947665846,1061088.4180636348,1883,0,496.96666666666664,72,108,35,37.415870503064326,0.5576967592592592,43.10787671232877,8220.547945205477,114.17427701674274,0
1911,32,2,2,180,0.01098901098901099,0.01098901098901099,0.989010989010989,182,6000,4500,1500,0.75,75,45,30,221.82719957010613,0.4582909608807399,0.7747893284348544,0.13317526180596725,1058138.3848899438,4544.774935554111,1062683.1598254978,1884,0,492.4945054945055,81,101,38,37.13075479154318,0.5600389194139195,42.83536585365853,8229.268292682906,101.5959048479371,0
1912,32,1,0,181,0.0055248618784530384,0.0,1.0,181,5550,3400,2150,0.6126126126126126,77,34,43,229.82416330395645,0.4578396766932678,0.7824413411730238,0.1387094772848706,1059737.415452657,6960.652965661027,1066698.0684183182,1885,0,495.97237569060775,61,120,38,36.72640031335683,0.5619244935543278,42.64112903225808,8235.48387096777,135.00793231094704,0
1913,32,4,0,185,0.021621621621621623,0.0,1.0,185,5250,3500,1750,0.6666666666666666,70,35,35,215.17369890816232,0.4589600470035253,0.7711476312450622,0.1313141113877386,1063064.5732991446,3498.7072830010798,1066563.2805821458,1886,0,486.227027027027,72,113,41,36.691070637732516,0.5644144144144144,42.23744292237445,8248.401826484063,114.56113647894533,0
1914,32,0,0,185,0.0,0.0,1.0,185,6450,4600,1850,0.7131782945736435,83,46,37,212.58969254954226,0.4586099686643165,0.7676736003810372,0.13032910219130506,1064425.434774465,1807.175184123435,1066232.6099585884,1887,1,487.227027027027,76,109,39,36.58923826007904,0.565990990990991,42.072510822510836,8253.679653679686,108.60104807473272,0
1915,32,0,1,184,0.0,0.005405405405405406,0.9945945945945946,185,4700,3200,1500,0.6808510638297872,62,32,30,220.5252168672056,0.458367606737172,0.7727174643036885,0.13296933560783775,1059447.9331032217,5026.997041420146,1064474.9301446418,1888,2,488.227027027027,64,121,41,37.00164518071039,0.5595157657657658,42.67628205128205,8234.358974358975,128.66185897435898,8
1916,32,0,2,182,0.0,0.010869565217391304,0.9891304347826086,184,5950,4400,1550,0.7394957983193278,75,44,31,219.09550142204463,0.45762799952482774,0.7709351369786359,0.13290707777713484,1061264.1726609538,3753.64121008062,1065017.8138710344,1889,3,491.8695652173913,65,119,44,36.813130694121014,0.5611413043478262,42.45580808080808,8241.414141414149,126.7909867909869,0
1917,32,1,1,182,0.00546448087431694,0.00546448087431694,0.994535519125683,183,5800,3500,2300,0.603448275862069,81,35,46,220.0999897969595,0.45707855441462003,0.7712755975051055,0.13450554932036413,1063476.5625,4414.236111111088,1067890.798611111,1890,0,495.08743169398906,65,118,42,36.51304713804715,0.5631261384335156,42.1875,8250.0,126.92307692307692,0
1918,32,1,1,182,0.00546448087431694,0.00546448087431694,0.994535519125683,183,5100,3400,1700,0.6666666666666666,68,34,34,218.035650382006,0.4570047438899898,0.7681030625043328,0.13406872970297845,1065318.877551023,4755.498866213331,1070074.3764172362,1891,0,495.79234972677597,69,114,38,36.33818723567856,0.5653460837887068,41.96428571428572,8257.142857142877,119.66873706004169,0
1919,32,1,0,183,0.00546448087431694,0.0,1.0,183,5350,3600,1750,0.6728971962616822,71,36,35,225.68164222734939,0.45643677815808964,0.7759746480407874,0.1398098556671443,1067538.5936428334,6234.772590878003,1073773.3662337114,1892,0,496.3825136612022,71,112,40,35.86614577498973,0.5674521857923498,41.695601851851855,8265.740740740746,116.41888367240487,0
1920,32,1,0,184,0.005434782608695652,0.0,1.0,184,4950,3300,1650,0.6666666666666666,66,33,33,222.75892859374036,0.4569467955571395,0.7732356647763081,0.1388923218442183,1069449.243985296,5895.873555109948,1075345.1175404058,1893,0,494.67934782608694,66,118,42,35.70544430412731,0.5694633152173914,41.464552238805965,8273.134328358197,125.35052012663935,0
1921,32,2,0,186,0.010752688172043012,0.0,1.0,186,5250,3300,1950,0.6285714285714286,72,33,39,222.4043857361312,0.4573028673835125,0.7726776828222923,0.1393915879743464,1070978.5856009042,5188.066893423864,1076166.652494328,1894,0,490.3494623655914,69,117,43,35.525710341654154,0.5714605734767024,41.27976190476189,8279.047619047597,119.9861973775014,0
1922,32,2,0,188,0.010638297872340425,0.0,1.0,188,5750,3800,1950,0.6608695652173913,77,38,39,218.07830510103136,0.45761747639094325,0.7701124652336409,0.13725202649218246,1072207.516852064,3415.0395983366207,1075622.5564504007,1895,0,486.1223404255319,71,117,47,35.486002440432955,0.5731382978723405,41.13136574074073,8283.796296296281,116.6731872717786,0
1923,32,1,4,185,0.005291005291005291,0.021164021164021163,0.9788359788359788,189,5850,4300,1550,0.7350427350427351,74,43,31,203.52425538053197,0.4579358043453788,0.7612574434762092,0.12623739184213753,1067900.797193882,-181.25708616759584,1067719.5401077145,1896,0,484.5449735449736,69,120,42,36.39377292014671,0.5711529982363316,41.65178571428573,8267.142857142891,119.8136645962738,8
1924,32,2,1,186,0.0106951871657754,0.0053475935828877,0.9946524064171123,187,6150,4200,1950,0.6829268292682927,81,42,39,198.68190161251763,0.45757503881317924,0.7535102219403205,0.12099845444728652,1062443.387923051,-1332.3454663605717,1061111.0424566902,1897,0,489.524064171123,78,109,36,37.192984700404246,0.5675133689839572,42.31276371308016,8245.991561181412,105.71784052796683,8
1925,32,1,6,181,0.0053475935828877,0.03208556149732621,0.9679144385026738,187,5650,3900,1750,0.6902654867256637,74,39,35,198.54251395622865,0.4573857646675483,0.7524285361125214,0.12164724692309128,1064253.2479314804,-790.0969339206304,1063463.1509975598,1898,0,489.55080213903744,82,105,42,36.97283049472829,0.5692401960784313,42.09337349397589,8253.012048192735,100.64648839259434,0
1926,32,0,0,181,0.0,0.0,1.0,181,5900,4200,1700,0.711864406779661,76,42,34,223.93879359286626,0.45567577245754043,0.7694526785519766,0.13242800263084278,1053555.6122448952,5086.39455782298,1058642.0068027182,1899,1,500.01657458563534,69,112,38,37.64642774298304,0.5511625230202578,43.39285714285713,8211.428571428549,119.0062111801239,8
1927,32,1,1,181,0.005494505494505495,0.005494505494505495,0.9945054945054945,182,6100,4400,1700,0.7213114754098361,78,44,34,226.44750291920207,0.4557625270677757,0.7731493166871983,0.13453103177501277,1054960.4493156124,5278.631885208002,1060239.0812008204,1900,0,498.2637362637363,70,112,38,37.40715346817508,0.5529418498168498,43.221830985915496,8216.901408450709,117.38430583501012,0
1928,32,3,2,182,0.016304347826086956,0.010869565217391304,0.9891304347826086,184,5350,3800,1550,0.7102803738317757,69,38,31,228.96058846795688,0.45661887720757105,0.7782168350792642,0.13731779538551306,1057830.2939365902,6290.28931979046,1064120.5832563806,1901,0,493.35869565217394,75,109,35,36.98560767590618,0.5556499094202898,42.87280701754384,8228.070175438552,109.7076023391807,0
1929,32,1,1,182,0.00546448087431694,0.00546448087431694,0.994535519125683,183,5650,3800,1850,0.672566371681416,75,38,37,227.35507898406013,0.4560014211653556,0.7768945727705865,0.1368197899746757,1058858.3671598146,5897.365539710217,1064755.7326995248,1902,0,497.04371584699453,78,105,39,36.89913292328721,0.557035519125683,42.74789029535863,8232.06751054847,105.53932705831372,0
1930,32,0,0,182,0.0,0.0,1.0,182,4900,3500,1400,0.7142857142857143,63,35,28,197.50126438035375,0.4559035577681987,0.7426692386134326,0.1175094395405879,1055413.7777777682,389.1111111106238,1055802.8888888787,1903,1,500.010989010989,74,108,45,38.09417585983125,0.5563186813186813,43.166666666666636,8218.666666666591,111.06306306306205,8
1931,32,3,6,179,0.016216216216216217,0.032432432432432434,0.9675675675675676,185,5800,4300,1500,0.7413793103448276,73,43,30,194.47633107339735,0.45645319232275755,0.7419685487756822,0.11649698667212127,1057469.4444444326,-1669.4444444450605,1055799.9999999877,1904,0,492.8864864864865,79,106,37,37.917004321988095,0.5585022522522523,42.91666666666663,8226.666666666573,104.13502109704523,0
1932,32,1,3,177,0.005555555555555556,0.016666666666666666,0.9833333333333333,180,5300,3900,1400,0.7358490566037735,67,39,28,198.52773735180375,0.45480550382785023,0.741839699222423,0.11925726877261794,1058315.7107345602,721.0046911992977,1059036.7154257596,1905,0,504.6111111111111,78,102,39,37.707959497564715,0.5605324074074074,42.813818565400815,8229.957805907105,105.5122795629116,0
1933,32,0,2,175,0.0,0.011299435028248588,0.9887005649717514,177,5800,4400,1400,0.7586206896551724,72,44,28,201.44929554190577,0.45404923172401984,0.7428402644450054,0.12122997396738261,1058858.3671598108,1461.2544285988452,1060319.6215884096,1906,1,513.728813559322,78,99,42,37.56556466769176,0.561617231638418,42.747890295358616,8232.06751054844,105.53932705831335,0
1934,32,2,1,176,0.011299435028248588,0.005649717514124294,0.9943502824858758,177,5600,4100,1500,0.7321428571428571,71,41,30,197.84426071880193,0.4544973035439137,0.7384516073692073,0.11993602194129059,1061064.6182575428,985.1089948083154,1062049.7272523511,1907,0,512.7344632768362,72,105,45,37.38513788071886,0.5637358757062148,42.48002283105023,8240.639269406394,114.45332318619992,0
1935,32,0,1,175,0.0,0.005681818181818182,0.9943181818181818,176,5400,3600,1800,0.6666666666666666,72,36,36,205.5294011590866,0.4541105248917749,0.7464083043038547,0.12258425651555654,1056153.0860640144,2814.102262211558,1058967.1883262258,1908,1,516.5056818181819,81,95,37,37.79619901112483,0.5607836174242424,43.07672764227642,8221.54471544714,101.50055204255729,8
1936,32,3,2,176,0.016853932584269662,0.011235955056179775,0.9887640449438202,178,6000,4400,1600,0.7333333333333333,76,44,32,196.69775599280197,0.4545007300196788,0.7338034462997487,0.11804038815435441,1058014.8430325985,21.829086317733527,1058036.6721189162,1909,0,511.67977528089887,87,91,38,37.79230344319647,0.5637874531835205,42.85037878787879,8228.787878787878,94.58376872169974,8
1937,32,1,2,175,0.005649717514124294,0.011299435028248588,0.9887005649717514,177,5450,4000,1450,0.7339449541284404,69,40,29,199.55510294563194,0.4541268083376134,0.7346572116009786,0.12018262931973489,1059090.8082105923,1419.3950522474452,1060510.2032628397,1910,0,514.3841807909605,91,86,39,37.58549523977177,0.5657956685499058,42.71965579710145,8232.971014492761,90.4722089504699,0
1938,32,2,1,176,0.011299435028248588,0.005649717514124294,0.9943502824858758,177,4950,3300,1650,0.6666666666666666,66,33,33,200.55011360119306,0.45369746190720767,0.7368088416070073,0.11768081815048345,1051187.0268976986,1813.135532086685,1053000.1624297854,1911,0,515.2485875706215,75,102,39,38.54099825321279,0.5547904896421846,43.68146929824561,8202.192982456134,109.36257309941512,8
1939,32,0,0,176,0.0,0.0,1.0,176,5600,3700,1900,0.6607142857142857,75,37,38,200.01702451530173,0.4530742694805195,0.7356594025700041,0.11792048460230498,1052622.7019733533,1308.4921571935383,1053931.1941305469,1912,1,519.1704545454545,76,100,43,38.376186708860736,0.5561671401515151,43.50649350649351,8207.792207792223,107.99726589200293,0
1940,32,2,0,178,0.011235955056179775,0.0,1.0,178,5500,4200,1300,0.7636363636363637,68,42,26,213.52677401589276,0.4541350589305741,0.7609935077808581,0.12265484175907397,1044627.723693844,3511.1975775822207,1048138.9212714263,1913,0,514.3258426966293,63,115,44,39.02643745886147,0.5441830524344569,44.482421874999986,8176.562499999972,129.7867063492059,8
1941,32,3,1,180,0.016574585635359115,0.0055248618784530384,0.994475138121547,181,5250,3700,1550,0.7047619047619048,68,37,31,216.04129158244223,0.45493528749744216,0.7685085191098346,0.12424049870630383,1044980.0294658284,3701.767048731108,1048681.7965145595,1914,0,506.78453038674036,67,114,37,38.91817269076304,0.5435082872928176,44.43933823529411,8177.941176470573,122.05882352941154,8
1942,32,3,2,181,0.01639344262295082,0.01092896174863388,0.9890710382513661,183,6150,4700,1450,0.7642276422764228,76,47,29,199.4363292935825,0.45592385756320186,0.7501803981123645,0.1120772637397312,1037796.4360675432,-1355.1376473453065,1036441.2984201979,1915,0,502.224043715847,76,107,42,40.24000495768262,0.5364867941712204,45.31926406926408,8149.783549783576,107.23399407609968,8
1943,32,2,0,183,0.01092896174863388,0.0,1.0,183,5400,4200,1200,0.7777777777777778,66,42,24,197.85367235327578,0.45564612982645775,0.7478053867677814,0.11181245640842208,1039550.1736111151,-864.2361111109494,1038685.9375000042,1916,0,503.2021857923497,79,104,40,40.060958997411774,0.5387067395264117,45.10416666666668,8156.666666666699,103.24894514767973,0
1944,32,3,3,183,0.016129032258064516,0.016129032258064516,0.9838709677419355,186,5500,3500,2000,0.6363636363636364,75,35,40,199.625257106048,0.45675796764506443,0.7554296409859016,0.11400325234336639,1042819.7151414067,-1065.3692499277836,1041754.3458914789,1917,0,496.0698924731183,70,116,41,39.60727831733811,0.5416666666666667,44.70363849765262,8169.483568075201,116.70690811536002,0
1945,32,4,1,186,0.0213903743315508,0.0053475935828877,0.9946524064171123,187,6100,4300,1800,0.7049180327868853,79,43,36,224.73915362252944,0.4579787437946831,0.7815864846019593,0.1278305867992301,1041569.0782335101,3316.2706163195644,1044885.3488498298,1918,0,491.73262032085563,79,108,42,39.122703495789764,0.5379901960784313,44.85677083333334,8164.5833333333585,103.34915611814378,8
1946,32,2,1,187,0.010638297872340425,0.005319148936170213,0.9946808510638298,188,5700,4100,1600,0.7192982456140351,73,41,32,220.31876897513152,0.45842103766071224,0.7784154794828595,0.12599990679564008,1043261.0551538124,2669.998278237035,1045931.0534320495,1919,0,487.1329787234043,65,123,42,39.02377310093331,0.5402260638297872,44.64962121212122,8171.212121212134,125.7109557109559,0
1947,32,2,1,188,0.010582010582010581,0.005291005291005291,0.9947089947089947,189,5650,4200,1450,0.7433628318584071,71,42,29,214.07327904702285,0.458994708994709,0.7711920915474753,0.12342215053963969,1045766.6250053627,1324.138106567496,1047090.7631119302,1920,0,485.0952380952381,71,118,46,38.870241733159794,0.5425485008818343,44.34317129629631,8181.018518518553,115.22561293688102,0
1948,32,3,3,188,0.015706806282722512,0.015706806282722512,0.9842931937172775,191,5550,4400,1150,0.7927927927927928,67,44,23,214.7373292110492,0.4600475337558556,0.7656850022861168,0.12091945684112768,1038428.0957340479,847.8551711288992,1039275.9509051768,1921,0,480.9738219895288,80,111,42,39.77115934713108,0.5340859511343805,45.24176954732509,8152.263374485568,101.9032921810696,8
1949,32,4,2,190,0.020833333333333332,0.010416666666666666,0.9895833333333334,192,6100,4400,1700,0.7213114754098361,78,44,34,223.72536178596863,0.4610647542175683,0.7718734815354726,0.125168304667959,1036398.3757636402,1873.7203144221548,1038272.0960780623,1922,0,479.4010416666667,72,120,42,39.796852807056915,0.5283203125,45.490867579908674,8144.292237442914,113.1151699644849,8
1950,32,5,3,192,0.02564102564102564,0.015384615384615385,0.9846153846153847,195,6150,4300,1850,0.6991869918699187,80,43,37,215.44575677713652,0.4629681029165565,0.7664598567392653,0.12179559862622025,1039656.3829210083,-352.08875868053474,1039304.2941623278,1923,0,472.37948717948717,79,116,42,39.59924273382026,0.5317307692307692,45.091145833333336,8157.083333333344,103.25421940928284,0
1951,32,2,2,192,0.010309278350515464,0.010309278350515464,0.9896907216494846,194,5800,4300,1500,0.7413793103448276,73,43,30,223.4915434850832,0.46356086302369887,0.7831018550710382,0.12385209916996755,1033396.6355997019,1591.0818244936618,1034987.7174241956,1924,0,467.2680412371134,78,116,41,40.17988395420428,0.5240012886597938,45.85970464135019,8132.489451476745,104.26268527534288,8
1952,32,8,3,197,0.04,0.015,0.985,200,6500,4700,1800,0.7230769230769231,83,47,36,205.84382220086866,0.465569514237856,0.7715345522684665,0.11600369768894447,1038677.1027574212,-3738.9470271773744,1034938.1557302439,1925,0,454.125,71,129,48,39.966557359983334,0.5283333333333333,45.21122685185187,8153.240740740783,114.83437663015187,0
1953,32,1,5,193,0.005050505050505051,0.025252525252525252,0.9747474747474747,198,6350,4600,1750,0.7244094488188977,81,46,35,231.07688206299719,0.4654278615255773,0.7931846201887136,0.12899432571738007,1035699.5240554075,1915.2433545709373,1037614.7674099784,1926,0,459.59090909090907,68,130,36,39.69755632033864,0.5268834175084175,45.57669082125605,8141.5458937198355,119.72861608411523,8
1954,32,0,0,193,0.0,0.0,1.0,193,5400,3500,1900,0.6481481481481481,73,35,38,236.2335620488077,0.46447718767990787,0.7915680463829935,0.13259738739025803,1037420.9761313018,5014.730507129863,1042435.7066384318,1927,1,472.4041450777202,68,125,39,39.35001284559594,0.5282275474956822,45.36533816425122,8148.30917874399,119.82807615799985,0
1955,32,3,0,196,0.015306122448979591,0.0,1.0,196,5750,3700,2050,0.6434782608695652,78,37,41,214.17621871344983,0.465413505145648,0.7732126925493545,0.11684317681994338,1028421.3456790105,-897.3209876544288,1027524.0246913561,1928,0,466.15816326530614,74,122,39,41.042260143895376,0.514296343537415,46.472222222222214,8112.888888888874,109.63363363363344,7
1956,32,6,3,199,0.0297029702970297,0.01485148514851485,0.9851485148514851,202,4400,2900,1500,0.6590909090909091,59,29,30,204.16963997454602,0.46720399651905486,0.7685615073368017,0.11226521040097344,1030926.5421541409,-2703.2198096371003,1028223.3223445038,1929,0,453.2821782178218,81,121,39,40.98104961131688,0.5168110561056105,46.16361788617886,8122.764227642275,100.2810398474355,0
1957,32,2,2,199,0.009950248756218905,0.009950248756218905,0.9900497512437811,201,6700,5000,1700,0.746268656716418,84,50,34,207.48623158538535,0.46786691542288555,0.7717764583841875,0.11466689683900647,1032527.7388115217,-4052.9420933235097,1028474.7967181981,1930,0,452.72636815920396,85,116,42,40.695725853875615,0.5185012437810945,45.96656976744187,8129.069767441875,95.63611491108088,0
1958,32,6,2,203,0.02926829268292683,0.00975609756097561,0.9902439024390244,205,6050,4300,1750,0.7107438016528925,78,43,35,197.40044158809715,0.46944842977841544,0.7653949520993886,0.11037437568564787,1036210.8919753012,-6140.302469136192,1030070.589506165,1931,0,444.78536585365856,74,131,48,40.49032181775183,0.5219004065040651,45.513888888888864,8143.555555555496,110.04804804804724,0
1959,32,1,2,202,0.004901960784313725,0.00980392156862745,0.9901960784313726,204,5900,4200,1700,0.711864406779661,76,42,34,199.50627125569054,0.4688013136288998,0.7641483049341926,0.11211706806236957,1037797.8316553553,-5290.5648578400405,1032507.2667975152,1932,0,447.8970588235294,78,126,47,40.238049011994086,0.5233864379084967,45.3190928270042,8149.789029535816,104.48447473763866,0
1960,32,7,4,205,0.03349282296650718,0.019138755980861243,0.9808612440191388,209,6800,4500,2300,0.6617647058823529,91,45,46,198.70983422388127,0.4704302002821739,0.7715273877930189,0.11334930150252846,1042460.1737970964,-7170.5823359557,1035289.5914611407,1933,0,436.2392344497608,70,139,46,39.67553741809406,0.5284589314194577,44.74765258215966,8168.075117370974,116.68678739101392,0
1961,32,1,5,201,0.0048543689320388345,0.024271844660194174,0.9757281553398058,206,6200,4600,1600,0.7419354838709677,78,46,32,199.83179685670552,0.46973468703133636,0.770324089792805,0.1148478428050692,1044788.829255163,-5643.594182825146,1039145.2350723378,1934,0,443.4757281553398,75,131,45,39.356271901594766,0.5302892394822006,44.46271929824564,8177.1929824562,109.02923976608267,0
1962,32,0,2,199,0.0,0.009950248756218905,0.9900497512437811,201,7350,4900,2450,0.6666666666666666,98,49,49,202.69007814137126,0.4684328358208955,0.7686443404866201,0.1166857506521359,1045307.0711755868,-5175.325612338109,1040131.7455632486,1935,1,455.1243781094527,76,125,41,39.21857909036382,0.5315091210613598,44.39935064935068,8179.220779220852,107.62132604237964,0
1963,32,3,3,199,0.01485148514851485,0.01485148514851485,0.9851485148514851,202,6150,4500,1650,0.7317073170731707,78,45,33,222.7301726430615,0.46872588378240804,0.7977704014329143,0.1271249957647408,1042640.8878880808,-104.48300719442159,1042536.4048808863,1936,0,451.65346534653463,62,140,40,39.03979640304857,0.5297029702970297,44.725529100529116,8168.783068783098,131.75456562553384,8
1964,32,4,3,200,0.019704433497536946,0.014778325123152709,0.9852216748768473,203,6750,5000,1750,0.7407407407407407,85,50,35,225.11008483932994,0.4697361361751939,0.7967156033174871,0.1296544428896795,1045454.6092235484,-281.52484440376884,1045173.0843791447,1937,0,449.23152709359607,65,138,42,38.627078702560276,0.5308394909688012,44.38131313131313,8179.797979797979,125.84304584304583,8
1965,32,5,5,200,0.024390243902439025,0.024390243902439025,0.975609756097561,205,6300,4500,1800,0.7142857142857143,81,45,36,213.67350186885972,0.4703341702534672,0.7884095084781839,0.12464174947674542,1049372.5956790175,-2455.3765432096534,1046917.2191358078,1938,0,445.6439024390244,74,131,40,38.43065874866676,0.5342987804878049,43.90277777777779,8195.111111111151,110.74474474474529,0
1966,32,2,1,201,0.009900990099009901,0.0049504950495049506,0.995049504950495,202,5700,3600,2100,0.631578947368421,78,36,42,213.46038583722725,0.4696700080455807,0.7862513686406827,0.12497971705998862,1050509.575242472,-1251.5641486080485,1049258.011093864,1939,0,452.28712871287127,73,129,44,38.29445466864436,0.5356848184818481,43.76407657657658,8199.549549549549,112.3225965691719,0
1967,32,0,3,198,0.0,0.014925373134328358,0.9850746268656716,201,5750,3900,1850,0.6782608695652174,76,39,37,217.2895966415673,0.4695024875621891,0.7851062025933433,0.1212135818416697,1035480.8284373792,-950.1576917533048,1034530.6707456259,1940,1,455.4875621890547,67,134,38,40.07578380602555,0.5199523217247097,45.603553921568626,8140.686274509799,121.50278021656416,8
1968,32,5,3,200,0.024630541871921183,0.014778325123152709,0.9852216748768473,203,6350,4300,2050,0.6771653543307087,84,43,41,211.59678673906527,0.4701984668910241,0.7804238075010259,0.11929793022479658,1038813.9382716017,-2988.0617283952215,1035825.8765432065,1941,0,451.7733990147783,74,129,31,39.80284076456269,0.5230911330049262,45.194444444444436,8153.777777777752,110.18618618618584,0
1969,32,2,3,199,0.009900990099009901,0.01485148514851485,0.9851485148514851,202,5850,4100,1750,0.7008547008547008,76,41,35,214.80994150842176,0.4704771316683907,0.7833724408956879,0.1215077650416565,1039840.5815485389,-1576.3810998951194,1038264.2004486438,1942,0,454.8910891089109,78,124,39,39.59238474535358,0.5260416666666667,45.06856540084387,8157.805907172979,104.5872552201664,8
1970,32,2,0,201,0.009950248756218905,0.0,1.0,201,5950,4200,1750,0.7058823529411765,77,42,35,217.32222765074013,0.4701803482587064,0.7904181823563452,0.1233648844655056,1040945.7505630885,-905.87012481172,1040039.8804382767,1943,0,458.05970149253733,80,121,37,39.38995748042085,0.5277777777777778,44.93312757201645,8162.139917695447,102.02674897119309,8
1971,32,2,1,202,0.009852216748768473,0.0049261083743842365,0.9950738916256158,203,6150,4200,1950,0.6829268292682927,81,42,39,210.7395103482778,0.470492123103936,0.785802111488922,0.12035852277945758,1042840.560018908,-2796.4582020581724,1040044.1018168498,1944,0,454.53694581280786,68,135,39,39.32093016379871,0.5300184729064039,44.701086956521756,8169.5652173913395,120.14066496163734,0
1972,32,5,4,203,0.024154589371980676,0.01932367149758454,0.9806763285024155,207,7000,5000,2000,0.7142857142857143,90,50,40,202.2141935697956,0.47118255866672926,0.7806212304574123,0.11680843416796471,1046358.5069444488,-6082.291666666442,1040276.2152777824,1945,0,437.97584541062804,75,132,44,39.099626612355756,0.5331622383252819,44.27083333333335,8183.333333333368,109.11111111111157,0
1973,32,3,5,201,0.014563106796116505,0.024271844660194174,0.9757281553398058,206,6950,5200,1750,0.7482014388489209,87,52,35,204.42590428059808,0.4710647051858868,0.7814339829419354,0.11936980909382353,1049687.7091389128,-5233.328169409346,1044454.3809695035,1946,0,440.1650485436893,81,125,40,38.62825265750801,0.5363572006472492,43.86432926829271,8196.341463414692,101.18940078289744,0
1974,32,2,2,201,0.009852216748768473,0.009852216748768473,0.9901477832512315,203,7250,5600,1650,0.7724137931034483,89,56,33,238.78577909978287,0.4707014420653888,0.8074308655422147,0.1369455195947132,1044133.1936400089,2014.831625454785,1046148.0252654637,1947,0,447.4679802955665,66,137,38,38.44295843223175,0.5292487684729064,44.542910447761194,8174.626865671642,123.8579828132067,8
1975,32,2,2,201,0.009852216748768473,0.009852216748768473,0.9901477832512315,203,6850,5100,1750,0.7445255474452555,86,51,35,195.88039928054582,0.470718715960266,0.7670500514697896,0.11545877221557069,1052562.0030864172,-6214.746913580372,1046347.2561728369,1948,0,446.54679802955667,74,129,45,38.489828703452986,0.5438218390804598,43.51388888888888,8207.555555555535,110.91291291291263,8
1976,32,3,6,198,0.014705882352941176,0.029411764705882353,0.9705882352941176,204,5500,3900,1600,0.7090909090909091,71,39,32,185.4814866268944,0.47121104188801954,0.7566978795129065,0.10912703929931132,1051996.3319658283,-7274.831284187511,1044721.5006816408,1949,0,445.13235294117646,80,124,38,38.8267549358878,0.546875,43.582818930041164,8205.34979423871,102.56687242798387,8
1977,32,3,2,199,0.014925373134328358,0.009950248756218905,0.9900497512437811,201,6100,4200,1900,0.6885245901639344,80,42,38,183.7346857422791,0.4704270315091211,0.75128673687472,0.10899123045921144,1054502.1168537098,-7550.276989062864,1046951.8398646469,1950,0,450.8557213930348,85,116,40,38.560735629472404,0.5501140132669984,43.27761627906978,8215.116279069807,96.64842681258597,0
1978,32,1,1,199,0.005,0.005,0.995,200,6150,4800,1350,0.7804878048780488,75,48,27,181.9958149303189,0.470195770519263,0.7489131821080433,0.10863339100000642,1056391.3173841727,-7698.240261470738,1048693.077122702,1951,0,454.015,88,112,36,38.37132944641829,0.5528124999999999,43.047752808988776,8222.471910112392,93.43718079673172,0
1979,32,0,5,194,0.0,0.02512562814070352,0.9748743718592965,199,6650,5100,1550,0.7669172932330827,82,51,31,183.70525157311678,0.46986193594233794,0.7500187167099845,0.11021818995949063,1057945.5782750347,-7579.9682784636025,1050365.609996571,1952,1,456.5678391959799,89,110,37,38.13497734467599,0.5546482412060301,42.8587962962963,8228.518518518522,92.4552642530171,0
1980,32,2,3,193,0.01020408163265306,0.015306122448979591,0.9846938775510204,196,6450,4800,1650,0.7441860465116279,81,48,33,187.77175548527902,0.46880723443223443,0.7529057241537918,0.11329515623042433,1059647.6670927634,-5855.619470822434,1053792.047621941,1953,0,464.1224489795918,73,123,42,37.81975896145572,0.5567070578231292,42.65202702702701,8235.135135135095,112.81007034431637,0
1981,32,1,1,193,0.005154639175257732,0.005154639175257732,0.9948453608247423,194,6550,4000,2550,0.6106870229007634,91,40,51,192.1455577549464,0.4684022399088368,0.7553881826977611,0.11641760263976128,1060899.999999996,-4580.5555555557185,1056319.4444444403,1954,0,469.6185567010309,74,120,41,37.552251887810115,0.5585266323024055,42.499999999999986,8239.999999999969,111.35135135135093,0
1982,32,0,0,193,0.0,0.0,1.0,193,6700,4700,2000,0.7014925373134329,87,47,40,190.18171704217787,0.4680359905728267,0.7506451506345155,0.11571037107835769,1062154.8580292524,-4899.513067061408,1057255.344962191,1955,1,472.69948186528495,77,116,41,37.447681801689725,0.5602871329879102,42.347756410256395,8244.871794871759,107.07625707625661,0
1983,32,0,0,193,0.0,0.0,1.0,193,6000,4100,1900,0.6833333333333333,79,41,38,188.4429844306155,0.46772115177029366,0.7500803208228204,0.11532524300568303,1063906.2934027752,-4502.864583333484,1059403.4288194417,1956,2,473.69948186528495,79,114,41,37.27613950043761,0.5620682210708117,42.13541666666666,8251.666666666646,104.45147679324869,0
1984,32,1,2,192,0.005154639175257732,0.010309278350515464,0.9896907216494846,194,6450,4800,1650,0.7441860465116279,81,48,33,189.60659590605883,0.4674707992806652,0.7520461910496297,0.11675774590004602,1065752.5951557024,-4835.255670896118,1060917.3394848064,1957,0,472.2525773195876,84,110,36,37.018241532130425,0.564110824742268,41.911764705882334,8258.82352941171,98.31932773109178,0
1985,32,0,4,188,0.0,0.020833333333333332,0.9791666666666666,192,5950,4400,1550,0.7394957983193278,75,44,31,203.23713829899557,0.4671229639325189,0.7656071681668419,0.12625802186814802,1068367.661355061,-923.6027710013236,1067444.0585840596,1958,1,473.328125,72,120,37,36.34357685865222,0.5699869791666667,41.5953196347032,8268.94977168951,114.84652460679874,7
1986,32,0,2,186,0.0,0.010638297872340425,0.9893617021276596,188,5950,4100,1850,0.6890756302521008,78,41,37,200.91293637537277,0.46581842359767894,0.7584634998178734,0.1254758149816008,1069931.640625,-557.3784722222522,1069374.2621527778,1959,2,484.0,75,113,40,36.21076703591811,0.5718639184397163,41.40625,8275.0,110.33333333333333,0
1987,32,0,1,185,0.0,0.005376344086021506,0.9946236559139785,186,4800,3200,1600,0.6666666666666666,64,32,32,204.00204471504384,0.46530139009977717,0.7576621671997494,0.12393140921486795,1061701.2623456793,1317.8456790123937,1063019.1080246917,1960,7,490.1505376344086,74,112,42,37.147741773152916,0.5633400537634409,42.40277777777778,8243.111111111113,111.39339339339342,8
1988,32,0,0,185,0.0,0.0,1.0,185,6100,4200,1900,0.6885245901639344,80,42,38,214.6150396920233,0.4650350078339209,0.7586490578208436,0.1285286549707603,1057394.1100108803,2286.535778019903,1059680.6457889,1961,8,492.2,90,95,33,37.408625730994224,0.5628378378378378,42.92582417582421,8226.373626373721,91.40415140415246,8
1989,32,3,1,187,0.015957446808510637,0.005319148936170213,0.9946808510638298,188,7300,5400,1900,0.7397260273972602,92,54,38,214.20969757449203,0.46530997553760384,0.7626454063105812,0.12938706692670854,1059974.1056142226,511.3465200829078,1060485.4521343054,1962,0,485.32978723404256,75,113,34,37.09889814864121,0.5654366134751774,42.61239035087718,8236.403508771891,109.81871345029188,0
1990,32,1,0,188,0.005319148936170213,0.0,1.0,188,5400,3800,1600,0.7037037037037037,70,38,32,216.08217647035875,0.4650403439905943,0.7645523115441628,0.13130940845105402,1061791.115317164,2886.8270309243553,1064677.9423480884,1963,0,486.27659574468083,78,110,37,36.82542526146969,0.567043439716312,42.39187763713079,8243.459915611784,105.68538353348441,0
1991,32,2,2,188,0.010526315789473684,0.010526315789473684,0.9894736842105263,190,5800,3900,1900,0.6724137931034483,77,39,38,212.73197602465547,0.46533753364893715,0.7645569095151681,0.13023097446623916,1064000.6361953819,1469.3915658666715,1065470.0277612486,1964,0,482.14736842105265,81,109,38,36.63813628899836,0.5690241228070175,42.123983739837385,8252.032520325169,101.87694469537246,0
1992,32,2,2,188,0.010526315789473684,0.010526315789473684,0.9894736842105263,190,6600,4400,2200,0.6666666666666666,88,44,44,210.5042587808153,0.46517567065812676,0.7649625753493687,0.12985462423720653,1066276.3679503857,291.1432981788316,1066567.5112485646,1965,0,481.0736842105263,85,105,33,36.41415059666244,0.5717105263157894,41.84835271317827,8260.852713178232,97.1865025079792,0
1993,32,0,3,185,0.0,0.015957446808510637,0.9840425531914894,188,4900,3600,1300,0.7346938775510204,62,36,26,209.5633876173335,0.4646806377289794,0.7635492899723748,0.12957510868170288,1066967.4740484385,2219.463667819852,1069186.9377162582,1966,1,487.18617021276594,84,104,36,36.35303957858768,0.5725288120567376,41.76470588235293,8263.529411764672,98.37535014005562,0
1994,32,0,2,183,0.0,0.010810810810810811,0.9891891891891892,185,5900,4400,1500,0.7457627118644068,74,44,30,210.6977731683277,0.4638097336466902,0.7615791847396718,0.13073804146073675,1068016.9887045636,2105.760245199023,1070122.7489497627,1967,2,495.15675675675675,71,114,38,36.1940960167245,0.5744932432432432,41.63773148148149,8267.592592592611,116.44496609285368,0
1995,32,0,1,182,0.0,0.00546448087431694,0.994535519125683,183,6400,4700,1700,0.734375,81,47,34,216.7170679011343,0.46341374927440504,0.7565375717279454,0.1328971561843878,1064510.239188871,3139.5075575492287,1067649.7467464204,1968,3,501.3497267759563,78,105,34,36.472284701632375,0.5695582877959927,42.06223628691981,8254.008438818524,105.8206210104939,8
1996,32,2,1,183,0.010869565217391304,0.005434782608695652,0.9945652173913043,184,6050,4800,1250,0.7933884297520661,73,48,25,212.22046004025214,0.4636159123307199,0.7541012630265866,0.1310128522683911,1066502.4386526376,2416.727632982375,1068919.16628562,1969,0,499.4728260869565,80,104,39,36.341900777047194,0.5720108695652174,41.820987654320966,8261.728395061675,103.27160493827094,0
1997,32,0,1,182,0.0,0.00546448087431694,0.994535519125683,183,5200,3800,1400,0.7307692307692307,66,38,28,217.5468262226845,0.46313226846013733,0.7623832187555089,0.13487903225806455,1067777.7777777794,4658.3333333334085,1072436.1111111129,1970,1,503.1639344262295,78,105,40,36.04670698924731,0.5737704918032787,41.66666666666667,8266.666666666679,105.98290598290613,0
1998,32,0,3,179,0.0,0.016483516483516484,0.9835164835164835,182,4550,3100,1450,0.6813186813186813,60,31,29,218.39009967218223,0.46261358346993703,0.7608620803648614,0.13595748325175,1068990.9547268017,5741.408230289771,1074732.3629570915,1971,2,506.8131868131868,70,112,37,35.87500473001099,0.575091575091575,41.51995305164321,8271.361502347463,118.16230717639233,0
1999,32,2,2,179,0.011049723756906077,0.011049723756906077,0.988950276243094,181,4900,3300,1600,0.673469387755102,65,33,32,214.04074029586872,0.46211888684264374,0.7555071901613377,0.13280806707751058,1068007.4197530919,4619.419753086683,1072626.8395061786,1972,0,509.585635359116,74,107,39,36.108908540300334,0.5747007366482504,41.63888888888891,8267.555555555598,111.7237237237243,8
2000,32,1,0,180,0.005555555555555556,0.0,1.0,180,5850,4000,1850,0.6837606837606838,77,40,37,218.16116563002277,0.4614693254707221,0.7601004211208287,0.13614324808502784,1069704.8160251272,4823.609908818284,1074528.4259339455,1973,0,513.2888888888889,75,105,41,35.79274891774894,0.5765046296296297,41.43366228070177,8274.122807017575,110.32163742690099,0
2001,31.75562175127824,0,0,180,0.0,0.0,1.0,180,6000,4400,1600,0.7333333333333333,76,44,32,220.48217429324595,0.46130250362093933,0.762503226472562,0.13808471381294782,1062583.4207947159,4856.140596954918,1067439.5613916707,1974,1,514.2888888888889,77,103,37,35.60235016261422,0.5783564814814814,41.30608974358975,8214.985963461702,106.68812939560652,0
2002,32.000697578618926,1,2,179,0.0055248618784530384,0.011049723756906077,0.988950276243094,181,5950,4800,1150,0.8067226890756303,71,48,23,217.50324947363873,0.4613157356251279,0.7614910978576876,0.13680954391891886,1072057.7817323229,4485.21023005626,1076542.991962379,1975,0,512.4419889502763,80,101,42,35.52224099099098,0.5800529465930018,41.1522633744856,8283.308138663098,103.54135173328874,0
2003,31.909456806325483,1,2,178,0.005555555555555556,0.011111111111111112,0.9888888888888889,180,5350,3700,1650,0.6915887850467289,70,37,33,236.6931106610469,0.46120228119180634,0.7818329534163311,0.1421205317014053,1055187.7310705215,8601.133279690664,1063788.8643502123,1976,0,514.6333333333333,76,104,37,36.74305190250743,0.5623263888888889,42.83008658008657,8206.152244159173,107.97568742314702,8
2004,31.609191782168796,1,1,178,0.00558659217877095,0.00558659217877095,0.994413407821229,179,5800,4100,1700,0.7068965517241379,75,41,34,235.80507270837438,0.46088208524260876,0.7816997888796327,0.1421886021102939,1046521.7676302819,7755.028301391044,1054276.795931673,1977,0,518.4581005586592,61,118,41,36.60687081048144,0.5640712290502794,42.6747311827957,8133.843772441157,133.34170118755995,0
2005,31.577048176148278,2,1,179,0.011111111111111112,0.005555555555555556,0.9944444444444445,180,5000,3300,1700,0.66,67,33,34,228.32530999657456,0.4612449565487275,0.7756562068284978,0.13904764402514314,1048392.6857593101,6874.9169948273575,1055267.6027541375,1978,0,516.5555555555555,65,115,40,36.43013362324169,0.5666087962962962,42.313762626262644,8136.9707318809205,125.18416510586032,0
2006,31.549901399262865,1,3,177,0.005555555555555556,0.016666666666666666,0.9833333333333333,180,5100,4000,1100,0.7843137254901961,62,40,22,198.85940567625946,0.4613516449410304,0.7389858843129875,0.11813874515373603,1040115.7992843168,267.3619360332841,1040383.1612203501,1979,0,515.0111111111111,78,102,45,38.116313203930005,0.556712962962963,43.22257383966244,8101.302476915127,103.86285226814266,8
2007,31.274479895669366,1,0,178,0.0056179775280898875,0.0,1.0,178,6350,4700,1650,0.7401574803149606,80,47,33,198.91793417447562,0.460928077191646,0.7387752944525032,0.11890897564943702,1032875.8913483514,-858.4922868734061,1032017.399061478,1980,0,521.438202247191,83,95,37,37.881232408524326,0.5593398876404494,42.99355158730157,8037.74300394027,96.84027715590686,0
2008,30.821870501657504,2,1,179,0.011111111111111112,0.005555555555555556,0.9944444444444445,180,5800,4000,1800,0.6896551724137931,76,40,36,197.71554648064682,0.46154562383612663,0.738883657176342,0.11895418629336954,1019804.3499781251,-1473.7651281471335,1018330.584849978,1981,0,516.6333333333333,85,95,41,37.67068462190414,0.5613425925925926,42.75678294573641,7928.717123476222,93.2790249820732,0
2009,31.09093605723578,2,3,178,0.011049723756906077,0.016574585635359115,0.9834254143646409,181,5700,4000,1700,0.7017543859649122,74,40,34,193.82124646895903,0.46167382852465727,0.7321706252930875,0.11765395365210124,1031310.6913971559,-1922.015259328171,1029388.6761378277,1982,0,512.3977900552486,78,103,43,37.43920855943484,0.5637085635359116,42.43143459915609,8008.047797231524,102.6672794516862,0
2010,30.660576629976944,1,0,179,0.00558659217877095,0.0,1.0,179,5650,3900,1750,0.6902654867256637,74,39,35,203.6385270762676,0.4612234009164522,0.7417536698150835,0.12471443003316451,1019580.2916466737,75.16576538384788,1019655.4574120576,1983,0,517.1284916201117,79,100,35,36.8577282978222,0.565933426443203,42.109374999999986,7907.075269965116,100.08956037930527,0
2011,30.610353008790945,1,2,178,0.005555555555555556,0.011111111111111112,0.9888888888888889,180,4850,3500,1350,0.7216494845360825,62,35,27,201.6904323385728,0.46119387543968554,0.7423935157839476,0.12416796434516451,1019399.8840568032,270.64066826131693,1019670.5247250645,1984,0,515.25,81,99,39,36.71551978735974,0.5673611111111111,41.92073170731706,7899.89750668946,97.52959884801803,0
2012,30.394519662954504,1,1,178,0.00558659217877095,0.00558659217877095,0.994413407821229,179,5700,4100,1600,0.7192982456140351,73,41,32,208.54915370854292,0.46053946184587696,0.7491352644375695,0.12375701785882508,1001703.5334683758,280.88483433723695,1001984.4183027131,1985,0,519.072625698324,74,105,41,37.90967901902438,0.5560405027932961,43.26388888888887,7803.370777357106,105.4509564507717,8
2013,30.23271971461947,1,3,176,0.00558659217877095,0.01675977653631285,0.9832402234636871,179,5950,4400,1550,0.7394957983193278,75,44,31,213.75602838600875,0.46013145230473085,0.7592083974750379,0.1270414860726763,996811.5102284031,864.8938951766386,997676.4041235797,1986,0,520.0446927374302,70,109,46,37.71805785674836,0.5576117318435754,43.20715962441315,7763.545967796145,110.90779953994493,8
2014,30.773724834143795,0,2,174,0.0,0.011363636363636364,0.9886363636363636,176,5250,4000,1250,0.7619047619047619,65,40,25,212.03615903165394,0.4597375541125541,0.7533905424867993,0.12655338660829052,1015883.6686381386,2630.8142242031413,1018514.4828623417,1987,1,528.3352272727273,75,101,36,37.60273866040785,0.5596590909090908,43.05098684210525,7907.278227325822,105.43037636434428,0
2015,30.33896976457411,1,2,173,0.005714285714285714,0.011428571428571429,0.9885714285714285,175,5000,3700,1300,0.74,63,37,26,232.38978742028496,0.4597071702244116,0.767484521456465,0.13976402900721813,1003720.8136274125,6650.893301637812,1010371.7069290504,1988,0,532.32,83,92,40,36.79258263831973,0.5629166666666667,42.77033730158729,7804.082959158708,94.02509589347841,8
2016,30.71180587488711,3,0,176,0.017045454545454544,0.0,1.0,176,5250,3800,1450,0.7238095238095238,67,38,29,225.78370511181498,0.4599526515151515,0.7641508457381836,0.1375057211020778,1019678.0055778727,5595.33562407972,1025273.3412019524,1989,0,525.1477272727273,70,106,41,36.494036096561175,0.5661695075757576,42.31220657276996,7914.057488065112,113.05796411521588,0
2017,30.603408516414788,1,0,177,0.005649717514124294,0.0,1.0,177,5450,4300,1150,0.7889908256880734,66,43,23,253.4726598685155,0.4604279019003595,0.7936018301684091,0.15252594201834466,1012625.0570671993,10484.553332866144,1023109.6104000654,1990,0,523.1751412429378,73,104,33,36.22999316005472,0.5591454802259888,42.75056306306307,7872.709609198778,107.84533711231202,8
2018,30.662173873438977,0,0,177,0.0,0.0,1.0,177,5600,3700,1900,0.6607142857142857,75,37,38,255.31941245171222,0.4602981617017634,0.7945884494997439,0.15388611627289617,1015037.3738213227,10831.749180117895,1025869.1230014405,1991,1,524.1751412429378,60,117,33,36.12166511813114,0.5603813559322034,42.6912568306011,7889.645422216175,131.4940903702696,0
2019,30.801540921619537,0,4,173,0.0,0.022598870056497175,0.9774011299435028,177,5450,4000,1450,0.7339449541284404,69,40,29,251.61974111529415,0.4600319936654682,0.7912418309055473,0.15253362237265042,1021322.252335496,10546.968145589268,1031869.2204810852,1992,2,525.1751412429378,63,114,35,36.00076897147432,0.5621468926553672,42.48046874999999,7931.998379913143,125.9047361890975,0
2020,31.115472189580846,1,1,173,0.005747126436781609,0.005747126436781609,0.9942528735632183,174,4550,3100,1450,0.6813186813186813,60,31,29,248.08134390237882,0.4599057648439749,0.7857908732201058,0.1511040912859941,1033116.5285431079,11909.387361746854,1045025.9159048548,1993,0,523.5,64,110,35,35.91482690713099,0.5640565134099618,42.3076923076923,8018.217833468898,125.28465364795153,0
2021,31.583164425431526,1,1,173,0.005747126436781609,0.005747126436781609,0.9942528735632183,174,5550,4000,1550,0.7207207207207207,71,40,31,245.44137240219112,0.45953272761499786,0.7829083197322062,0.1501529015599528,1049940.107188134,11189.748169671544,1061129.8553578055,1994,0,524.0747126436781,66,108,39,35.819892473118266,0.5659123563218391,42.148631840796,8143.7621578945755,123.39033572567538,0
2022,31.759672132248358,3,2,174,0.017045454545454544,0.011363636363636364,0.9886363636363636,176,4600,3100,1500,0.6739130434782609,61,31,30,247.2108360626628,0.46042207792207795,0.7860848560766647,0.14933376348418592,1052040.11617919,12215.143338423699,1064255.2595176138,1995,0,519.0056818181819,62,114,35,36.24614569281171,0.5620265151515151,42.60912698412698,8174.649736817295,131.84918930350474,8
2023,31.404838462384866,2,2,174,0.011363636363636364,0.011363636363636364,0.9886363636363636,176,5500,3900,1600,0.7090909090909091,71,39,32,225.083109198594,0.4600446428571428,0.7629109893747985,0.1376343271070323,1043875.3656236745,6291.742582079381,1050167.1082057538,1996,0,519.9772727272727,70,106,42,36.36207370737073,0.5677083333333333,42.165492957746494,8097.2510436906405,115.67501490986629,8
2024,31.71362673481295,0,0,174,0.0,0.0,1.0,174,6200,4500,1700,0.7258064516129032,79,45,34,231.22543522199095,0.45880880007972896,0.766828208883306,0.1352791432489704,1040879.6274532406,7135.568974316053,1048015.1964275566,1997,1,526.9022988505748,73,101,40,37.8680544109298,0.5501077586206897,43.79222972972974,8125.2775929100835,111.30517250561758,8
2025,31.408082629118976,0,1,173,0.0,0.005747126436781609,0.9942528735632183,174,4900,3200,1700,0.6530612244897959,66,32,34,226.72791041564568,0.4589458341638429,0.7623087793561814,0.13331201171407286,1032352.2926192713,7112.61562367385,1039464.9082429452,1998,2,527.9022988505748,64,110,41,37.792596412275785,0.5513050766283525,43.60576923076924,8052.851185629418,125.82579977545966,0
2026,31.072067326289773,0,1,172,0.0,0.005780346820809248,0.9942196531791907,173,4900,3600,1300,0.7346938775510204,62,36,26,214.07637114496515,0.45875481695568404,0.7425377153979758,0.12135125119751475,1010333.7605535501,3757.7170209099213,1014091.47757446,1999,3,531.7861271676301,79,94,40,39.527752957195105,0.538716281310212,44.98697916666666,7923.781752413852,100.30103484068167,7
2027,31.581491513065455,2,1,173,0.011494252873563218,0.005747126436781609,0.9942528735632183,174,5650,3900,1750,0.6902654867256637,74,39,35,213.31107147575528,0.45916038247735474,0.7441286827850431,0.12177206836214463,1029063.0254757953,3452.1073160652045,1032515.1327918605,2000,0,529.6954022988506,70,104,41,39.272868773946364,0.5407686781609196,44.71830985915496,8062.176530624162,115.17395043748803,0
2028,31.644763760755612,3,1,175,0.017045454545454544,0.005681818181818182,0.9943181818181818,176,5150,3900,1250,0.7572815533980582,64,39,25,212.9965981627007,0.45980519480519483,0.7491527735939443,0.1228785451450068,1034349.395044838,3712.58049123974,1038061.9755360777,2001,0,524.5965909090909,74,102,44,38.87353558947619,0.5433238636363636,44.31944444444446,8090.950778774331,109.33717268613961,8
2029,31.67098447869791,1,2,174,0.005681818181818182,0.011363636363636364,0.9886363636363636,176,5200,4000,1200,0.7692307692307693,64,40,24,260.561243383268,0.4603212932900433,0.7980020663788014,0.1501238036895677,1034809.3400777039,13526.241663053239,1048335.5817407572,2002,0,524.0625,63,113,35,37.70772316312239,0.5399502840909092,44.36848958333334,8096.101598672371,128.50954918527574,8
2030,31.55606496665009,3,4,173,0.01694915254237288,0.022598870056497175,0.9774011299435028,177,5150,3500,1650,0.6796116504854369,68,35,33,251.59970285802575,0.4611702298407807,0.7918567318900873,0.1459685725488054,1033163.7801706158,11438.740018920013,1044602.5201895358,2003,0,521.9322033898305,69,108,35,37.668886175079464,0.5423140301318268,44.10714285714284,8074.971624501672,117.02857426814016,0
2031,31.875108744342757,2,0,175,0.011428571428571429,0.0,1.0,175,4500,3000,1500,0.6666666666666666,60,30,30,251.2294704977804,0.46000136836343736,0.7905236703586378,0.1462864694580165,1044727.8037964653,12993.282592418851,1057721.086388884,2004,0,528.1314285714286,70,105,38,37.537844058602175,0.5439285714285714,43.9700704225352,8160.981847088083,116.58545495840119,0
2032,31.76619023072777,3,0,178,0.016853932584269662,0.0,1.0,178,5750,4100,1650,0.7130434782608696,74,41,33,215.68282820130287,0.46096378467593474,0.7648789007902739,0.121982916141186,1032195.6410721539,3175.3750246999457,1035371.0160968539,2005,0,520.2134831460675,69,109,39,39.57609742571944,0.5321863295880149,45.074404761904766,8098.014953014856,117.36253555093994,8
2033,32.040663353988336,0,1,177,0.0,0.0056179775280898875,0.9943820224719101,178,4800,3200,1600,0.6666666666666666,64,32,32,214.10659627752517,0.460795166000127,0.7629086315811553,0.12156347024819722,1042330.070357877,4233.948712407914,1046564.0190702849,2006,1,521.2134831460675,69,109,39,39.46428397798654,0.5332982209737828,44.925595238095255,8172.753133195185,118.44569758253891,0
2034,31.70427719994445,1,0,178,0.0056179775280898875,0.0,1.0,178,5750,4500,1250,0.782608695652174,70,45,25,221.33760387811606,0.46063448232082777,0.7705056179775278,0.1266691106531391,1033830.1455713797,4415.097447546756,1038245.2430189265,2007,0,522.1966292134831,61,117,38,38.97121710526317,0.5355805243445693,44.62365591397851,8096.5224032116475,132.72987546248604,0
2035,31.74609978347298,1,0,179,0.00558659217877095,0.0,1.0,179,5300,3800,1500,0.7169811320754716,68,38,30,215.37362880477662,0.4607408511706735,0.7652330793868718,0.12399487801256193,1037031.5011729319,3569.847518496019,1040601.3486914278,2008,0,520.2737430167598,65,114,40,38.89208346197387,0.5373021415270018,44.39709595959597,8114.39529661216,124.83685071711015,0
2036,31.67930136059439,3,1,181,0.016483516483516484,0.005494505494505495,0.9945054945054945,182,4750,3200,1550,0.6736842105263158,63,32,31,209.87299311371697,0.46199001274968127,0.7569822306136285,0.12199292775352744,1037780.3726015437,2410.414598510901,1040190.7872000546,2009,0,512.6813186813187,72,110,38,38.66338220537409,0.5465888278388278,44.035388127853885,8108.7800771452985,112.62194551590693,8
2037,32.07394766279541,2,2,181,0.01092896174863388,0.01092896174863388,0.9890710382513661,183,6350,4500,1850,0.7086614173228346,82,45,37,208.20939916716316,0.4619200244200244,0.7547203340885869,0.12195121951219481,1053052.851975756,901.1003202276979,1053953.9522959837,2010,0,510.8688524590164,68,115,43,38.41463414634144,0.5488387978142076,43.74999999999997,8218.949088591266,120.86689836163626,0
2038,32.4565211146139,1,1,181,0.005494505494505495,0.005494505494505495,0.9945054945054945,182,5200,3300,1900,0.6346153846153846,71,33,38,212.20230257908065,0.461097029121891,0.7596192649158757,0.12519935852165714,1067874.763704826,3721.0967448509764,1071595.8604496769,2011,0,513.5494505494505,68,114,42,38.0348104990584,0.5505952380952381,43.478260869565204,8325.803242444405,122.43828297712359,0
2039,32.74740922821679,1,0,182,0.005494505494505495,0.0,1.0,182,5900,4900,1000,0.8305084745762712,69,49,20,217.41413093874905,0.46135758808410743,0.7573712959295524,0.12434087162508557,1067633.4457503515,4123.719553791135,1071757.1653041427,2012,0,509.03846153846155,72,110,38,39.09728043215052,0.5404075091575091,44.64897260273974,8362.08459102371,116.14006376421818,8
2040,32.703110033737126,3,1,184,0.016216216216216217,0.005405405405405406,0.9945945945945946,185,5900,4100,1800,0.6949152542372882,77,41,36,210.78602105217362,0.46235556208382295,0.7558254412736354,0.12152026314350246,1068727.126505996,2154.547717344787,1070881.6742233408,2013,0,501.76756756756754,76,109,41,38.9563930927435,0.5428490990990991,44.34523809523812,8360.705809220366,110.00928696342586,0
2041,32.741866060644725,1,1,184,0.005405405405405406,0.005405405405405406,0.9945945945945946,185,5400,3700,1700,0.6851851851851852,71,37,34,208.198495474752,0.46249387974931455,0.7537547319306279,0.12059799643537603,1071488.9355380996,2216.476859375519,1073705.4123974752,2014,0,502.37297297297295,79,106,47,38.84025515743762,0.5448198198198198,44.16666666666669,8376.460733848337,106.03114852972578,0
2042,33.12496100389534,5,5,184,0.026455026455026454,0.026455026455026454,0.9735449735449735,189,5400,4000,1400,0.7407407407407407,68,40,28,203.45626169762156,0.46340974332995605,0.7531357206540861,0.1189787590359805,1087057.4293734687,1033.72816619058,1088091.1575396594,2015,0,492.1005291005291,87,102,43,38.596823068274574,0.5476741622574957,43.809185606060616,8486.310736355463,97.54380156730417,0
2043,32.78158507321267,1,1,184,0.005405405405405406,0.005405405405405406,0.9945945945945946,185,5950,4200,1750,0.7058823529411765,77,42,35,207.13293629562895,0.4624987759498629,0.7553394356035577,0.12165026510514554,1077136.916576247,1672.1064645714177,1078809.0230408183,2016,0,502.44864864864866,71,114,42,38.33884765882195,0.5492680180180181,43.64872685185184,8403.601069332377,118.36057844130109,0
2044,32.727486726082375,2,0,186,0.010752688172043012,0.0,1.0,186,5750,4100,1650,0.7130434782608696,74,41,33,203.54755643217203,0.463041872517679,0.7502619244554734,0.1202781015281015,1077270.327873339,905.148571100618,1078175.4764444395,2017,0,500.6774193548387,75,111,45,38.198450854700866,0.5509072580645161,43.421052631578945,8397.18409419218,111.96245458922907,0
2045,32.93975942787087,6,5,187,0.03125,0.026041666666666668,0.9739583333333334,192,5850,4200,1650,0.717948717948718,75,42,33,197.2751916722082,0.4644279013961605,0.7506033876156017,0.11792697858109366,1087873.6750654578,-1327.902447262467,1086545.7726181953,2018,0,486.0,83,109,38,37.92345195014074,0.5539279513888888,42.99355158730159,8465.73058212579,101.99675400151555,0
2046,33.3267161192164,3,2,188,0.015789473684210527,0.010526315789473684,0.9894736842105263,190,4850,3300,1550,0.6804123711340206,64,33,31,199.15841095545878,0.4640356678733872,0.7506414019033874,0.11946088561084714,1101732.0268229402,1033.8399521587216,1102765.866775099,2019,0,491.06315789473683,84,106,42,37.74663997712328,0.5558662280701754,42.86764705882353,8569.376931536739,102.01639204210403,0
2047,33.326023697496225,0,2,186,0.0,0.010638297872340425,0.9893617021276596,188,5550,4200,1350,0.7567567567567568,69,42,27,198.32762941537317,0.46383500208594075,0.7465923776608119,0.11932425421420599,1102664.1320022237,587.7526682723437,1103251.884670496,2020,1,495.72872340425533,86,102,43,37.65437126677525,0.5576241134751774,42.75622605363985,8572.912106569767,99.6850244949973,0
2048,33.67655425666674,1,3,184,0.0053475935828877,0.016042780748663103,0.983957219251337,187,6250,4500,1750,0.72,80,45,35,197.28628945366955,0.463401807448297,0.7428385612759609,0.11926526860294988,1115775.1305171899,375.42707288374004,1116150.5575900737,2021,0,498.80748663101605,73,114,49,37.50313291773754,0.5595476827094474,42.58164414414412,8668.96322764162,118.75292092659753,0
2049,33.48768341620478,1,1,184,0.005405405405405406,0.005405405405405406,0.9945945945945946,185,5450,3700,1750,0.6788990825688074,72,37,35,195.86716063121582,0.4628672150411281,0.7380283529668981,0.11883107087626073,1110641.349091939,1057.6335052518707,1111698.982597191,2022,0,505.04324324324324,76,109,44,37.40676541653532,0.5606418918918918,42.451298701298676,8624.709373345533,113.48301807033596,0
2050,33.883111416932785,1,1,184,0.005405405405405406,0.005405405405405406,0.9945945945945946,185,6000,4200,1800,0.7,78,42,36,197.4674005857756,0.4627803074813945,0.7388087605715481,0.12040832113443475,1125359.3639313309,1444.3576640761048,1126803.721595407,2023,0,505.85945945945946,77,108,44,37.17825405461423,0.5625,42.26762820512818,8732.774669275926,113.4126580425445,0
2051,33.84649302151787,1,2,183,0.005405405405405406,0.010810810810810811,0.9891891891891892,185,6150,4500,1650,0.7317073170731707,78,45,33,204.2535687532159,0.4627962201331766,0.7448387477005094,0.11919366821695536,1110052.0896903505,2196.4201642443677,1112248.509854595,2024,0,506.53513513513514,82,103,41,38.65687427516705,0.5454391891891892,43.88805220883538,8668.491253641118,105.71330797123314,7
2052,33.539792011985526,3,1,185,0.016129032258064516,0.005376344086021506,0.9946236559139785,186,6500,4900,1600,0.7538461538461538,81,49,32,207.29104453739905,0.4637756708321224,0.748416891602872,0.1223802813959863,1103721.5899603213,2058.320252270746,1105779.910212592,2025,0,501.994623655914,73,113,42,38.13643118427067,0.548891129032258,43.45439189189189,8604.48633753429,117.86967585663412,0
2053,33.86249657619819,2,2,185,0.0106951871657754,0.0106951871657754,0.9893048128342246,187,5100,3300,1800,0.6470588235294118,69,33,36,200.90882726694252,0.46399119276254003,0.7397475340743918,0.11926958500779793,1116122.1156351247,2347.757067790319,1118469.872702915,2026,0,499.72727272727275,76,111,43,38.09111386269034,0.5506907308377897,43.249458874458874,8694.214319800665,114.39755683948243,0
2054,34.068653849753694,0,1,184,0.0,0.005405405405405406,0.9945945945945946,185,5800,4300,1500,0.7413793103448276,73,43,30,251.00930908913466,0.46362490207598905,0.7916810873737536,0.14470939362923962,1113352.6595853772,13092.376371015347,1126445.0359563925,2027,1,505.05945945945945,69,116,40,37.92806558013196,0.5381756756756757,44.3452380952381,8709.813588374545,126.2291824402108,8
2055,34.1908069250148,1,1,184,0.005405405405405406,0.005405405405405406,0.9945945945945946,185,5350,3600,1750,0.6728971962616822,71,36,35,247.47284904794523,0.4639749804151978,0.7883992866758227,0.14335834282974566,1118930.9918905275,13031.008090238685,1131961.9999807663,2028,0,506.0486486486486,72,113,40,37.8325617714318,0.5397522522522522,44.163812785388146,8747.245681486773,121.48952335398296,0
2056,33.62965293130873,5,1,188,0.026455026455026454,0.005291005291005291,0.9947089947089947,189,5900,4200,1700,0.711864406779661,76,42,34,248.3394558655558,0.46567999737325977,0.7942453509882872,0.1455213876418483,1104274.6056359075,11146.990937954288,1115421.5965738618,2029,0,492.66137566137564,61,128,39,37.36908313118731,0.5435405643738977,43.73319892473117,8618.163577977999,141.28137013078688,0
2057,33.36491064010847,1,3,186,0.005291005291005291,0.015873015873015872,0.9841269841269842,189,6050,4400,1650,0.7272727272727273,77,44,33,247.33966296967347,0.4650713910465683,0.7936698947529284,0.1457725247714877,1097417.7934262988,10436.989432596443,1107854.7828588951,2030,0,493.65608465608466,62,127,40,37.17471419975932,0.5456349206349207,43.5185185185185,8557.48171047222,138.02389855600356,0
2058,33.678171049825146,3,4,185,0.015873015873015872,0.021164021164021163,0.9788359788359788,189,6700,4900,1800,0.7313432835820896,85,49,36,230.06623871991445,0.4660271023302938,0.7740697650684789,0.13318722951205017,1101940.9021718963,6203.879730863645,1108144.78190276,2031,0,491.94179894179894,75,114,44,38.30323974853552,0.5434854497354498,44.18859649122808,8615.26020386429,114.87013605152387,8
2059,33.553236984725714,3,4,184,0.015957446808510637,0.02127659574468085,0.9787234042553191,188,6150,4500,1650,0.7317073170731707,78,45,33,229.4561145886258,0.466837097508249,0.7774230280458494,0.13099604651227797,1093329.3235940177,6424.219711538875,1099753.5433055565,2032,0,495.0,68,120,42,38.858540311452785,0.5331338652482269,44.71618357487924,8565.59839087732,125.9646822187841,8
2060,33.70362408042416,0,3,181,0.0,0.016304347826086956,0.9836956521739131,184,6100,4500,1600,0.7377049180327869,77,45,32,228.22531927859828,0.46666122198463605,0.7721292290233335,0.13074964553063698,1099373.013635155,7280.951408631921,1106653.965043787,2033,1,506.1141304347826,69,115,41,38.7540783034258,0.534759963768116,44.58333333333336,8608.467317208393,124.76039590157092,0
2061,33.77332301353603,6,2,185,0.03208556149732621,0.0106951871657754,0.9893048128342246,187,5150,3300,1850,0.6407766990291263,70,33,37,199.46895504395283,0.4680857435838461,0.7480041977845993,0.11396233305658054,1100748.1252432752,1363.0156617734729,1102111.1409050487,2034,0,496.86096256684493,69,118,44,39.59480824153407,0.5370432263814617,44.68750000000002,8622.751531893466,124.9674135057024,8
2062,33.942951807769504,3,1,187,0.015957446808510637,0.005319148936170213,0.9946808510638298,188,5400,3700,1700,0.6851851851851852,71,37,34,193.55838107080413,0.4689414087685364,0.7416536421196738,0.11148436710841621,1108938.939140789,-71.11484670654409,1108867.8242940824,2035,0,491.11170212765956,75,113,42,39.43275245755137,0.5402814716312057,44.38048245614037,8676.480965116565,115.68641286822087,0
2063,34.300283957168915,6,2,191,0.031088082901554404,0.010362694300518135,0.9896373056994818,193,6250,4100,2150,0.656,84,41,43,209.62922519343607,0.4708706642199194,0.7708345557200491,0.11646583541967277,1108541.8129340634,1626.5522679788542,1110168.3652020423,2036,0,479.19170984455957,71,122,40,40.431402814924425,0.5252050949913645,45.76099537037037,8720.470051784267,122.82352185611643,8
2064,34.6299748482724,2,0,193,0.010362694300518135,0.0,1.0,193,5550,4200,1350,0.7567567567567568,69,42,27,205.80863338802743,0.47071099597006333,0.7657720402149124,0.11504664422970823,1121287.650580254,2004.1358001588214,1123291.7863804128,2037,0,480.1502590673575,73,120,42,40.28630563852936,0.5273100172711571,45.52364864864865,8812.509646777435,120.71931022982787,0
2065,34.31210643605691,5,1,197,0.025252525252525252,0.005050505050505051,0.9949494949494949,198,6400,4400,2000,0.6875,84,44,40,195.44520314349427,0.4716987984754482,0.7637617697378667,0.10954131572683312,1111881.7873439346,-2537.6076402027743,1109344.1797037318,2038,0,469.0,75,123,45,40.44654714475433,0.5275673400673401,45.42214912280701,8735.102315560835,116.46803087414446,7
2066,34.14675836799141,2,0,199,0.010050251256281407,0.0,1.0,199,6350,4500,1850,0.7086614173228346,82,45,37,190.89529627049717,0.47158350675938615,0.7602286930257254,0.10773364298172354,1108836.3633661424,-3815.6707799438846,1105020.6925861984,2039,0,467.61306532663315,79,120,47,40.291402684106565,0.529784338358459,45.15625,8702.08795284281,110.1530120613014,0
2067,33.68402264894061,1,2,198,0.005,0.01,0.99,200,6750,4900,1850,0.725925925925926,86,49,37,189.79274620880585,0.4718985552763819,0.7592321179804975,0.10786010368082696,1096099.3543902475,-5143.658682515374,1090955.695707732,2040,0,466.27,84,116,39,40.04789755168048,0.53203125,44.88970588235292,8593.14092503667,102.29929672662703,0
2068,33.279593530143096,2,2,198,0.01,0.01,0.99,200,6300,4600,1700,0.7301587301587301,80,46,34,189.5676645680407,0.4722597361809045,0.7620500414708322,0.10623895921019606,1078398.1601922226,-5414.115859577614,1072984.044332645,2041,0,466.435,73,127,43,40.59919592664271,0.5241145833333334,45.42511261261262,8472.148775234227,116.05683253745516,8
2069,33.112230230433084,4,4,198,0.019801980198019802,0.019801980198019802,0.9801980198019802,202,6150,4400,1750,0.7154471544715447,79,44,35,187.34666047946402,0.47269017946570774,0.7598420922166704,0.10590016492365456,1075759.9252157805,-6241.994106637267,1069517.9311091432,2042,0,462.68811881188117,78,124,37,40.31937547417059,0.5271245874587458,45.09493670886075,8440.475142599296,108.21121977691405,0
2070,33.37462344946207,4,4,198,0.019801980198019802,0.019801980198019802,0.9801980198019802,202,7100,4600,2500,0.647887323943662,96,46,50,188.1588095627158,0.47229816265208613,0.7602689079909168,0.10736755803085904,1087352.4080618168,-6581.013064787107,1080771.3949970298,2043,0,463.61386138613864,72,130,41,39.931545456239405,0.5297029702970297,44.7345890410959,8519.386970425638,118.32481903368941,0
2071,33.59419440923938,5,2,201,0.024630541871921183,0.009852216748768473,0.9901477832512315,203,6250,4600,1650,0.736,79,46,33,183.3845537328605,0.4729013233835699,0.7587144845594835,0.10475372488245617,1094850.3616256162,-6694.271005805071,1088156.090619811,2044,0,461.6896551724138,74,129,43,40.01253490733688,0.5325841543513957,44.69444444444444,8576.784467092195,115.90249279854318,8
2072,33.41540158892681,3,4,200,0.014705882352941176,0.0196078431372549,0.9803921568627451,204,6550,4500,2050,0.6870229007633588,86,45,41,179.251255515359,0.47291747158633574,0.7546800762763686,0.1030081218566966,1090964.718869421,-8238.640883939106,1082726.0779854818,2045,0,460.37745098039215,76,128,46,39.88653007923486,0.5346200980392157,44.466991341991346,8538.738103534077,112.35181715176417,0
2073,33.758633198733335,1,0,201,0.004975124378109453,0.0,1.0,201,6400,5000,1400,0.78125,78,50,28,179.30241031521507,0.47250103648424546,0.7509231197831598,0.10355541827436877,1103806.6166127748,-7016.962623889127,1096789.6539888857,2046,0,467.09452736318406,78,123,48,39.69225877419135,0.5364842454394694,44.277426160337576,8632.844570889229,110.67749449857986,0
2074,33.89328656596552,4,2,203,0.01951219512195122,0.00975609756097561,0.9902439024390244,205,6450,4500,1950,0.6976744186046512,84,45,39,177.3237575409362,0.4732424677187948,0.7533493178999593,0.10338045153078333,1111278.1151300743,-8038.79779042505,1103239.3173396492,2047,0,458.9609756097561,83,122,42,39.382768361581995,0.5391768292682927,43.92361111111113,8679.270431388784,104.5695232697444,0
2075,33.52811816504899,1,2,202,0.004901960784313725,0.00980392156862745,0.9901960784313726,204,6200,4000,2200,0.6451612903225806,84,40,44,182.66570935427205,0.4730130557970314,0.759274916375599,0.10707641857728252,1101055.6462483609,-6774.977867903624,1094280.6683804572,2048,0,462.20588235294116,68,136,44,39.038446434181594,0.5408496732026145,43.71980676328499,8592.592602202098,126.36165591473673,0
2076,33.64728787858133,1,7,196,0.0049261083743842365,0.034482758620689655,0.9655172413793104,203,6750,4900,1850,0.725925925925926,86,49,37,182.2772271897762,0.47235567152774394,0.7573863051901282,0.10761847249149752,1107276.4037013026,-6983.745480132062,1100292.6582211705,2049,0,464.9310344827586,69,134,45,38.776102088167015,0.5435139573070608,43.45238095238093,8632.131592659805,125.1033564153595,0
2077,33.712153390152146,1,1,196,0.005076142131979695,0.005076142131979695,0.9949238578680203,197,5850,4300,1550,0.7350427350427351,74,43,31,207.15425027709406,0.4713797955730516,0.7716529370108027,0.11843996622281801,1098994.41243575,282.27271336915965,1099276.6851491192,2050,0,472.20304568527916,70,127,46,39.37014000612888,0.536008883248731,44.65962441314558,8608.073908483191,122.97248440690274,8
2078,33.330167793823236,1,3,194,0.005076142131979695,0.015228426395939087,0.9847715736040609,197,6550,4800,1750,0.732824427480916,83,48,35,202.73363657844885,0.4708898787941573,0.7660560582652829,0.11657184103260891,1088373.9977118906,-1819.9962972884605,1086554.0014146022,2051,0,473.10659898477155,74,123,45,39.26347373188407,0.5379124365482233,44.44444444444447,8517.70954731045,115.10418307176283,0
2079,33.03474271127879,1,2,193,0.005128205128205128,0.010256410256410256,0.9897435897435898,195,5900,4200,1700,0.711864406779661,76,42,34,200.48961012057424,0.47055247158339947,0.7622792677359,0.11589425063142615,1080418.9032952746,-1577.4470622860445,1078841.4562329885,2052,0,478.574358974359,77,118,44,39.11648434372446,0.5399038461538461,44.24412393162396,8448.829562816582,109.7250592573582,0
2080,33.06721222973989,4,4,193,0.02030456852791878,0.02030456852791878,0.9796954314720813,197,5250,3800,1450,0.7238095238095238,67,38,29,200.20995366663826,0.47045715494319557,0.7657846631366609,0.11695149268277372,1084813.1616292929,-1211.9214346476515,1083601.2401946452,2053,0,471.75634517766497,82,115,39,38.72203168381514,0.5427241962774958,43.85040160642573,8470.153132643025,103.29455039808568,0
2081,33.43278490542786,2,1,194,0.010256410256410256,0.005128205128205128,0.9948717948717949,195,6000,4100,1900,0.6833333333333333,79,41,38,203.38527614069167,0.4704962992334127,0.7679499652944402,0.11945381277332061,1098546.257499678,-314.37321302114015,1098231.884286657,2054,0,476.0769230769231,70,125,44,38.43346401114094,0.544818376068376,43.64730046948355,8570.584663329484,122.43692376184977,0
2082,33.47220892483299,0,1,193,0.0,0.005154639175257732,0.9948453608247423,194,5950,3600,2350,0.6050420168067226,83,36,47,206.75712857277193,0.4703402373448711,0.7694352315967439,0.12180736517811583,1100822.7807599935,770.5914434857605,1101593.3722034793,2055,1,479.5154639175258,71,123,44,38.23034777458115,0.5461232817869416,43.532986111111086,8584.517471216872,120.90869677770242,0
2083,33.24570957750146,1,6,188,0.005154639175257732,0.030927835051546393,0.9690721649484536,194,4600,3300,1300,0.717391304347826,59,33,26,225.9400963709246,0.47037751722664384,0.7850523045126858,0.1306137679413085,1087337.6127685143,5734.63300332992,1093072.2457718442,2056,0,480.41237113402065,71,123,44,38.46329713014294,0.5367268041237113,44.24189814814816,8502.859576259725,119.75858558112289,8
2084,33.05074161406463,6,6,188,0.030927835051546393,0.030927835051546393,0.9690721649484536,194,5500,4000,1500,0.7272727272727273,70,40,30,221.09855244893836,0.470869945515731,0.7799849132511938,0.12950058072009302,1085122.98150865,3683.8240881279476,1088806.805596778,2057,0,477.4639175257732,78,116,41,38.08434959349595,0.5407538659793815,43.750000000000014,8469.252538604096,108.58016075133456,0
2085,33.388541200830204,1,3,186,0.005291005291005291,0.015873015873015872,0.9841269841269842,189,5200,3700,1500,0.7115384615384616,67,37,30,224.4364718191964,0.46997073060902844,0.7791057427829005,0.13194944230910366,1097411.1303785492,6259.816447455367,1103670.9468260047,2058,0,488.18518518518516,66,123,40,37.85574960079236,0.542879188712522,43.61007462686566,8560.485586798652,129.70432707270683,0
2086,32.97317031299542,3,0,189,0.015873015873015872,0.0,1.0,189,5200,3500,1700,0.6730769230769231,69,35,34,220.29122042225737,0.47035184247063677,0.7719658897675628,0.1296650854384168,1084129.9091416155,4764.860156215288,1088894.7692978308,2059,0,485.4550264550264,67,122,42,37.917164476304265,0.5470679012345678,43.56617647058822,8455.436137247869,126.2005393619085,8
2087,33.1928784120034,1,0,190,0.005263157894736842,0.0,1.0,190,5900,4200,1700,0.711864406779661,76,42,34,219.8367278794919,0.4704771187227328,0.7705376081549202,0.13005435239388738,1092956.231926684,4154.384348451936,1097110.616275136,2060,0,483.89473684210526,69,121,44,37.73648158886632,0.5485745614035088,43.37797619047617,8518.023634151714,123.44961788625672,0
2088,32.86409720857071,3,3,190,0.015544041450777202,0.015544041450777202,0.9844559585492227,193,6350,5000,1350,0.7874015748031497,77,50,27,212.88054453547875,0.4707750881548647,0.766672445814885,0.12699378243669132,1084733.924662484,1233.7497116510785,1085967.6743741352,2061,0,477.35751295336786,74,119,34,37.599892786997486,0.551543609671848,43.06944444444442,8443.7907536298,114.10528045445676,0
2089,32.417334338135284,1,0,191,0.005235602094240838,0.0,1.0,191,6850,4800,2050,0.7007299270072993,89,48,41,212.39410824379075,0.4704050702672913,0.764404605186028,0.12719233378737266,1071169.2625018856,452.0080574489866,1071621.2705593347,2062,0,480.9947643979058,75,116,37,37.4675659344565,0.5531195462478184,42.92763157894734,8333.600916201489,111.11467888268652,0
2090,32.01652879538559,1,4,188,0.005208333333333333,0.020833333333333332,0.9791666666666666,192,6350,4900,1450,0.7716535433070866,78,49,29,211.4636259526972,0.4704622509453171,0.7663256992741241,0.12764951570757754,1060335.4918135717,94.47756504670451,1060429.9693786183,2063,0,479.484375,70,122,37,37.192642420096554,0.5552300347222222,42.634976525821585,8239.934684986094,117.71335264265849,0
2091,31.765012443024585,0,0,188,0.0,0.0,1.0,188,6300,4200,2100,0.6666666666666666,84,42,42,211.54948929003825,0.46975208119998485,0.7617325579250851,0.128226406730792,1053231.1502788828,662.1023891714121,1053893.2526680543,2064,1,490.0159574468085,69,119,39,37.03740489261288,0.5570146276595744,42.485119047619044,8179.963397716373,118.55019416980251,0
2092,31.290801572107387,3,0,191,0.015706806282722512,0.0,1.0,191,6250,4500,1750,0.72,80,45,35,215.60345473908825,0.46966450812896116,0.7697469463750115,0.13216801944410517,1040815.9777783924,430.7041113325822,1041246.6818897249,2065,0,483.30366492146595,73,118,34,36.513932853062634,0.5596095113438045,42.07488738738738,8070.683519224689,110.55730848252999,0
2093,30.927275113953968,4,1,194,0.020512820512820513,0.005128205128205128,0.9948717948717949,195,6100,4200,1900,0.6885245901639344,80,42,38,209.03055553209148,0.47014825094722007,0.768260070557282,0.12927843515095447,1031272.7039377681,-1986.4987581613768,1029286.2051796068,2066,0,474.3692307692308,81,114,39,36.357492170462535,0.5624465811965812,41.7555894308943,7986.795932311585,98.60241891742697,0
2094,31.47721342408076,1,2,193,0.005128205128205128,0.010256410256410256,0.9897435897435898,195,5150,3700,1450,0.7184466019417476,66,37,29,208.2701807844883,0.46997532822275095,0.7683510505655786,0.1290834207808351,1050233.756506632,-403.52513327860106,1049830.2313733534,2067,0,475.3025641025641,84,111,40,36.298863798092874,0.5636752136752137,41.67892156862743,8131.227717722963,96.80032997289241,0
2095,31.19797745159548,1,4,190,0.005154639175257732,0.020618556701030927,0.979381443298969,194,7000,5500,1500,0.7857142857142857,85,55,30,210.8582882615536,0.46956848815056174,0.7734062475940158,0.12679505037966957,1032094.6026491537,-2274.859752282521,1029819.7428968712,2068,0,476.9329896907216,76,118,45,37.35219224431121,0.551331615120275,42.775974025974,8024.869362346211,105.59038634666068,8
2096,31.359889995087578,2,1,191,0.010416666666666666,0.005208333333333333,0.9947916666666666,192,5400,3400,2000,0.6296296296296297,74,34,40,205.38781651125345,0.46956124563699825,0.7650770437485352,0.12419407968616666,1039093.2779610829,-1116.5800976103665,1037976.6978634725,2069,0,482.265625,68,124,47,37.28521581046217,0.5530598958333333,42.57246376811595,8072.899217938321,118.71910614615179,0
2097,31.036998298689248,5,1,195,0.025510204081632654,0.00510204081632653,0.9948979591836735,196,6000,3700,2300,0.6166666666666667,83,37,46,219.96654373299762,0.47020320948892375,0.7866879051013538,0.13314709565552454,1028696.0019911916,55.740821991087614,1028751.7428131828,2070,0,473.35714285714283,65,131,44,36.87134749381886,0.5537840136054422,42.53472222222222,7990.949388360437,122.93768289785288,8
2098,30.852159852656243,0,2,193,0.0,0.010256410256410256,0.9897435897435898,195,5450,3900,1550,0.7155963302752294,70,39,31,220.00554609781574,0.4699808353158869,0.7853585085524255,0.13367333675448137,1023660.8680356398,592.2136582289836,1024253.0816938687,2071,1,473.8051282051282,66,129,40,36.729987728086606,0.555982905982906,42.39738805970149,7947.596962043858,120.41813578854331,0
2099,30.59241197049254,1,3,191,0.005154639175257732,0.015463917525773196,0.9845360824742269,194,7450,5700,1750,0.7651006711409396,92,57,35,224.52269539742184,0.4695851806349376,0.7846325054011338,0.13644071489535617,1015090.4938389605,-667.8292501953538,1014422.6645887652,2072,0,477.10309278350513,68,126,37,36.60740447726208,0.5575601374570447,42.39130434782608,7880.87134457252,115.89516683194881,8
2100,30.682180445939128,2,0,193,0.010362694300518135,0.0,1.0,193,6300,4700,1600,0.746031746031746,79,47,32,228.01374365551058,0.4696990141047783,0.7844919023321884,0.13945619965827877,1019916.0561431852,1610.975635114417,1021527.0317782997,2073,0,470.9222797927461,69,124,43,36.278580154287134,0.5594775474956822,42.1577380952381,7911.162806351018,114.65453342537707,0
2101,31.18082588796261,1,2,192,0.005154639175257732,0.010309278350515464,0.9896907216494846,194,5650,4300,1350,0.7610619469026548,70,43,27,232.53159532656463,0.4695028310453502,0.7918918087144149,0.14331393621336413,1038720.1337299529,3857.0499588098355,1042577.1836887627,2074,0,469.4896907216495,72,122,37,35.87861868170342,0.5615335051546392,41.88070776255709,8048.372709579867,111.78295429972037,0
2102,30.871420861086428,0,5,187,0.0,0.026041666666666668,0.9739583333333334,192,6200,4000,2200,0.6451612903225806,84,40,44,237.64335642990068,0.46853525850785344,0.7954005524861871,0.14710481365872835,1029664.1359137908,4338.568250809469,1034002.7041646002,2075,1,475.0625,72,120,38,35.585980662983424,0.5634765625,41.723744292237456,7973.3549883799415,110.74104150527697,0
2103,30.999078260514263,1,0,188,0.005319148936170213,0.0,1.0,188,5050,3400,1650,0.6732673267326733,67,34,33,242.1176937718767,0.46710139568399894,0.7961482869706884,0.15073778999345885,1035570.98962981,7496.011949246003,1043067.001579056,2076,0,485.72872340425533,62,126,38,35.25954711187874,0.5654920212765957,41.517857142857146,8012.708175374006,129.2372286350646,0
2104,31.087921328204967,2,1,189,0.010526315789473684,0.005263157894736842,0.9947368421052631,190,7450,6000,1450,0.8053691275167785,89,60,29,237.13849629894716,0.4673744546551564,0.7939007474763022,0.1485922871304418,1040387.7792465185,3893.198707664331,1044280.9779541829,2077,0,481.60526315789474,65,125,40,35.1528184480234,0.5677631578947369,41.2878787878788,8042.822070895488,123.73572416762289,0
2105,31.2046341633701,0,1,188,0.0,0.005291005291005291,0.9947089947089947,189,5550,3800,1750,0.6846846846846847,73,38,35,236.27644274329506,0.46708717963150587,0.7911642247244501,0.14845260320371803,1045069.5655693568,6035.06387440178,1051104.6294437586,2078,1,485.1058201058201,67,122,41,35.076760875998836,0.5690035273368607,41.191789215686285,8076.015536000902,120.5375453134463,0
2106,31.208314225817816,1,1,188,0.005291005291005291,0.005291005291005291,0.9947089947089947,189,6700,5100,1600,0.7611940298507462,83,51,32,238.73675580786755,0.4669206630642801,0.7989674610741642,0.14554073187650218,1036456.9083665616,4988.071967617043,1041444.9803341787,2079,0,484.43386243386243,64,125,37,36.12281329022098,0.5608465608465609,42.27564102564103,8043.14277851927,125.6741059143636,8
2107,31.321960012421105,0,4,184,0.0,0.02127659574468085,0.9787234042553191,188,6200,4300,1900,0.6935483870967742,81,43,38,236.56641515711965,0.466648059126939,0.7956909319425469,0.14477932415975459,1041369.5459869254,5470.6120695846785,1046840.15805651,2080,1,488.0,68,120,37,36.034433971469255,0.5625554078014184,42.13466183574878,8076.847810570099,118.77717368485439,0
2108,31.6399807489461,1,1,184,0.005405405405405406,0.005405405405405406,0.9945945945945946,185,5150,3500,1650,0.6796116504854369,68,35,33,229.5415142363462,0.46585879357618487,0.7795281711774416,0.13574121644346804,1041702.4777928897,5672.792827266371,1047375.2706201561,2081,0,495.62702702702705,69,116,39,37.50265792932805,0.552195945945946,43.39285714285712,8119.045060042006,117.66731971075372,8
2109,32.1099754081188,4,2,186,0.02127659574468085,0.010638297872340425,0.9893617021276596,188,4950,3800,1150,0.7676767676767676,61,38,23,208.2007265502098,0.4664933913604126,0.7661759833533217,0.11899235612982947,1046644.1590615433,1032.4148712294013,1047676.5739327727,2082,0,488.63829787234044,70,118,40,39.35839606198165,0.5371232269503546,44.674295774647895,8198.502083736688,117.12145833909555,8
2110,32.40631231285388,3,0,189,0.015873015873015872,0.0,1.0,189,6800,4900,1900,0.7205882352941176,87,49,38,210.48297500920242,0.46664860782768586,0.7547861587643523,0.11844451048244956,1051400.9578574768,-339.59969252728206,1051061.3581649496,2083,0,486.8994708994709,80,109,42,39.90580405223476,0.5347222222222222,45.26748971193411,8254.941284632207,103.18676605790259,8
2111,32.591125749415134,2,1,190,0.010471204188481676,0.005235602094240838,0.9947643979057592,191,5800,4300,1500,0.7413793103448276,73,43,30,210.79680709914072,0.4664921465968586,0.7608924118230955,0.1196815259945844,1060230.1476388208,698.6259825022153,1060928.773621323,2084,0,482.79057591623035,84,107,41,39.54960203068444,0.537521815008726,44.926470588235254,8313.133472405858,98.96587467149831,0
2112,32.299737615698014,2,0,192,0.010416666666666666,0.0,1.0,192,6300,4600,1700,0.7301587301587301,80,46,34,205.55338825927288,0.46629808391506694,0.7574905496150934,0.11768239580902522,1053370.8461086918,-1395.2106977640324,1051975.6354109277,2085,0,481.2552083333333,73,119,42,39.35901587389073,0.5399305555555556,44.60867117117119,8249.07291049567,113.00099877391328,0
2113,32.6788860120486,0,1,191,0.0,0.005208333333333333,0.9947916666666666,192,5200,3700,1500,0.7115384615384616,67,37,30,209.50433429686782,0.4661736701934264,0.7606762033113403,0.12036330675798221,1066839.76812328,1101.5110844187357,1067941.2792076988,2086,1,482.2552083333333,75,117,44,39.12309580003219,0.5411783854166667,44.47642543859651,8350.225766483347,111.33634355311129,0
2114,32.239225787663,2,0,193,0.010362694300518135,0.0,1.0,193,6350,4800,1550,0.7559055118110236,79,48,31,203.29266926883412,0.4666619440846287,0.754345050283338,0.11743141248352722,1054180.8800070034,-2088.551002241279,1052092.3290047622,2087,0,480.5284974093264,77,116,42,39.07204684317725,0.5431778929188256,44.27083333333336,8244.510344657625,107.0715629176315,0
2115,31.944561072925964,0,3,190,0.0,0.015544041450777202,0.9844559585492227,193,5450,3200,2250,0.5871559633027523,77,32,45,190.41336582577088,0.4665787366868164,0.7520257215434096,0.11169839572052462,1049272.1051212929,-4090.913359352918,1045181.1917619399,2088,1,481.5284974093264,72,121,45,38.81249304086402,0.549708549222798,43.69292237442919,8187.617094633137,113.7169040921269,8
2116,31.992683335465223,1,1,190,0.005235602094240838,0.005235602094240838,0.9947643979057592,191,5100,3800,1300,0.7450980392156863,64,38,26,196.07126777490257,0.46612358776522456,0.7553740619453402,0.11450756972206255,1049491.2781709908,-2144.982914062012,1047346.2952569288,2089,0,487.30366492146595,85,106,43,38.83682279598369,0.544011780104712,43.859011627906995,8194.637530221496,96.40750035554701,8
2117,31.949987117529552,4,4,190,0.020618556701030927,0.020618556701030927,0.979381443298969,194,5650,4200,1450,0.7433628318584071,71,42,29,190.7690686422163,0.46682980788063316,0.7520595355448865,0.1123280831455679,1050597.0612615666,-4365.715420976614,1046231.34584059,2090,0,480.3144329896907,73,121,46,38.6607110184067,0.5469286941580755,43.552927927927904,8193.480649030813,112.23946094562757,0
2118,32.1805086804507,3,4,189,0.015544041450777202,0.02072538860103627,0.9792746113989638,193,5450,3700,1750,0.6788990825688074,72,37,35,201.98147027465254,0.4669958981001727,0.7632359263707964,0.1186514265080751,1057455.8547549613,-1332.702341210574,1056123.1524137508,2091,0,483.3056994818653,75,118,38,38.4623609923011,0.5480354058721935,43.64035087719299,8249.783913913812,109.99711885218416,8
2119,32.37188983246868,0,2,187,0.0,0.010582010582010581,0.9894179894179894,189,5550,3600,1950,0.6486486486486487,75,36,39,200.95916763983558,0.4662440429284401,0.7572590555981014,0.1186917039641694,1065417.5238522247,-528.9162435524863,1064888.6076086722,2092,1,494.46560846560845,76,113,43,38.28302135512788,0.5494929453262787,43.43885281385281,8305.369192001734,109.28117357897018,0
2120,31.969203719481197,1,5,183,0.005319148936170213,0.026595744680851064,0.973404255319149,188,6550,4900,1650,0.7480916030534351,82,49,33,217.5576080620263,0.4659956100428566,0.7766295577714175,0.12956890443589508,1054693.9685896682,1741.3394087624029,1056435.3079984304,2093,0,497.8351063829787,73,115,44,37.542242072190575,0.5530806737588653,43.130630630630606,8211.909198663965,112.49190683101322,7
2121,32.318332840682814,0,1,182,0.0,0.00546448087431694,0.994535519125683,183,5700,4100,1600,0.7192982456140351,73,41,32,206.039305620207,0.46485117796593206,0.7468310124229438,0.11940104945447552,1057768.8738010277,1288.3928529264135,1059057.266653954,2094,1,512.1092896174863,85,98,31,38.87818767851791,0.5470742258652095,44.14970930232558,8268.654852152898,97.2782923782694,8
2122,32.72146111286941,2,1,183,0.010869565217391304,0.005434782608695652,0.9945652173913043,184,6000,4400,1600,0.7333333333333333,76,44,32,194.8541830090579,0.46528025263324624,0.7432926005941134,0.10969064148411957,1061745.1549064214,-1422.9030553769126,1060322.2518510446,2095,0,510.2880434782609,78,106,46,40.28931590752241,0.5396286231884058,45.25316455696201,8335.68866957588,106.86780345610103,8
2123,32.23070304884071,5,4,184,0.026595744680851064,0.02127659574468085,0.9787234042553191,188,5150,3400,1750,0.6601941747572816,69,34,35,195.5560632028954,0.4672951748397618,0.7522817785870335,0.11155599730057719,1049991.7345933213,-1683.549997469896,1048308.1845958515,2096,0,500.3510638297872,67,121,46,39.754058392846446,0.5432734929078014,44.745710784313744,8227.025197653727,122.7914208605034,0
2124,32.59117177221172,2,2,184,0.010752688172043012,0.010752688172043012,0.989247311827957,186,5600,3800,1800,0.6785714285714286,74,38,36,196.64755333087132,0.46665516322774386,0.75045782713114,0.11317466225890724,1064527.7266769204,-932.6454192216197,1063595.0812576988,2097,0,506.5537634408602,70,116,44,39.38410060654765,0.5462029569892473,44.410211267605646,8329.970707800803,118.99958154001148,0
2125,32.30287744842416,4,1,187,0.02127659574468085,0.005319148936170213,0.9946808510638298,188,5750,3900,1850,0.6782608695652174,76,39,37,233.52677342090865,0.46733369363219174,0.7907195220775309,0.1346535889643542,1055701.086488259,5956.893684910064,1061657.9801731692,2098,0,502.0851063829787,68,120,38,38.36839385887215,0.544104609929078,44.338768115942024,8258.593441863864,121.44990355682154,7
2126,32.019537593600994,4,7,184,0.020942408376963352,0.03664921465968586,0.9633507853403142,191,7150,5400,1750,0.7552447552447552,89,54,35,227.17082311865556,0.46840842288968493,0.7889407757252545,0.13262489035169686,1050267.7100281,2368.036036406056,1052635.746064506,2099,0,487.27748691099475,76,115,38,38.053266782865876,0.5479384816753927,43.871753246753265,8201.108025698744,107.90931612761506,0
2127,32.41426826914422,2,2,184,0.010752688172043012,0.010752688172043012,0.989247311827957,186,5850,4900,950,0.8376068376068376,68,49,19,211.7013251045298,0.4668119732635862,0.7673035887038924,0.11907558794620379,1051513.7823330401,1471.372217116063,1052985.1545501563,2100,0,500.23655913978496,75,111,44,39.8927392739274,0.5338261648745519,45.28508771929824,8256.397498818189,110.08529998424252,8
2128,32.13726913703118,6,6,184,0.031578947368421054,0.031578947368421054,0.968421052631579,190,5700,3800,1900,0.6666666666666666,76,38,38,203.6501740353947,0.4683085027383273,0.7644380173634768,0.11572818248860643,1045747.6508991807,-1106.6617794555077,1044640.9891197252,2101,0,490.64736842105265,82,108,40,39.696790803692934,0.5367324561403508,44.892068273092356,8198.472260898972,99.98136903535332,0
2129,32.42403984485648,1,2,183,0.005405405405405406,0.010810810810810811,0.9891891891891892,185,6950,5600,1350,0.8057553956834532,83,56,27,201.58537736620949,0.4664108401880141,0.7556217520819275,0.11516706293259345,1056759.824032577,-1344.534417388495,1055415.2896151885,2102,0,504.46486486486486,70,115,39,39.542270045588644,0.539358108108108,44.688967136150254,8278.21510240897,118.26021574869958,0
2130,32.352372208797654,2,4,181,0.010810810810810811,0.021621621621621623,0.9783783783783784,185,5500,4000,1500,0.7272727272727273,70,40,30,225.21915206762074,0.4671611829220525,0.7784990893500519,0.12811150983588915,1053057.8773748802,4933.760444099253,1057991.6378189796,2103,0,501.84324324324325,82,103,37,39.108050500081944,0.5394144144144144,44.85441767068269,8254.564846948397,100.66542496278532,8
2131,32.567965249599524,5,3,183,0.026881720430107527,0.016129032258064516,0.9838709677419355,186,5700,4100,1600,0.7192982456140351,73,41,32,213.47975421820044,0.4677782621331008,0.7663861978051651,0.12285742939270593,1063758.17807056,2518.166880420857,1066276.344950981,2104,0,499.4193548387097,73,113,38,38.95530419856439,0.5433467741935484,44.41159909909911,8323.994158741267,114.02731724303105,0
2132,32.228327452336934,2,0,185,0.010810810810810811,0.0,1.0,185,5300,3600,1700,0.6792452830188679,70,36,34,208.16975897805855,0.46777320799059935,0.7595855455582521,0.12035649734676412,1054103.2749419273,1586.4849365287882,1055689.7598784561,2105,0,499.20540540540543,76,109,42,38.9128010508128,0.5454954954954955,44.237012987012996,8242.813295642365,108.4580696795048,0
2133,32.56182671843583,1,4,182,0.005376344086021506,0.021505376344086023,0.978494623655914,186,5750,3900,1850,0.6782608695652174,76,39,37,201.20773584178667,0.46760631599341274,0.751571779927084,0.11694590403229581,1066663.7439992337,-25.800633077894872,1066637.9433661557,2106,0,497.51612903225805,82,104,35,38.888514341750415,0.5474910394265233,44.03865461847391,8334.568974931008,101.64108506013424,0
2134,32.97417606462865,0,1,181,0.0,0.005494505494505495,0.9945054945054945,182,4950,3200,1750,0.6464646464646465,67,32,35,204.55945665191965,0.4671449061987736,0.7449024046124342,0.11730777285167167,1075896.09674457,2666.944192798491,1078563.0409373685,2107,3,508.9230769230769,71,111,44,39.32015867172607,0.544356684981685,44.545717592592624,8423.394484565291,118.63935893753931,8
2135,32.955142913619326,1,0,182,0.005494505494505495,0.0,1.0,182,6200,4600,1600,0.7419354838709677,78,46,32,202.35013431339652,0.467435189120272,0.7413035715720897,0.11659802140358419,1076802.7500054466,978.2362185277716,1077780.9862239743,2108,0,505.74175824175825,77,105,43,39.191524744889065,0.5469322344322345,44.36431623931627,8424.5104921542,109.40922717083377,0
2136,33.140494609122904,3,0,185,0.016216216216216217,0.0,1.0,185,6150,4700,1450,0.7642276422764228,76,47,29,194.61714494015584,0.4682652761457109,0.7350764604495938,0.1129392408038549,1085123.053888334,-913.289868701575,1084209.7640196325,2109,0,498.5243243243243,83,102,36,39.11691542288561,0.5493806306306306,44.09722222222224,8480.744627404076,102.17764611330212,0
2137,33.30808029459087,2,2,185,0.0106951871657754,0.0106951871657754,0.9893048128342246,187,5150,3400,1750,0.6601941747572816,69,34,35,199.01971308407053,0.46857450213712076,0.744158112565819,0.11543143358876119,1090436.2445923828,853.6617070495504,1091289.9062994323,2110,0,494.1818181818182,84,103,45,39.025083812260505,0.5494652406417112,44.117647058823536,8522.949957733566,101.46368997301865,8
2138,33.71590246191472,0,3,182,0.0,0.016216216216216217,0.9837837837837837,185,5200,3600,1600,0.6923076923076923,68,36,32,197.52941403982226,0.4678723560517039,0.7394416647278239,0.11517283153971125,1105496.9825976724,1473.634239062068,1106970.6168367343,2111,1,500.43243243243245,85,100,41,38.86123198688234,0.5512387387387387,43.91957364341086,8633.982677444312,101.5762667934625,0
2139,33.992754478332536,1,3,180,0.00546448087431694,0.01639344262295082,0.9836065573770492,183,6100,4600,1500,0.7540983606557377,76,46,30,199.6942351990883,0.4674683240257011,0.7401179667850255,0.11700612116846104,1116169.019206418,1878.5037286686097,1118047.5229350866,2112,0,506.327868852459,76,107,44,38.61903693536754,0.5534494535519126,43.73647186147188,8711.103193764286,114.61977886531955,0
2140,33.62024574720786,2,3,179,0.01098901098901099,0.016483516483516484,0.9835164835164835,182,5750,4000,1750,0.6956521739130435,75,40,35,184.86301559193674,0.46750602068281627,0.7323940038367402,0.10623039955810189,1097644.732729295,-1567.2169318112528,1096077.5157974837,2113,0,509.8626373626374,73,109,46,39.74406204667735,0.5476190476190477,44.46790540540542,8591.051816569065,117.6856413228639,8
2141,34.01128283553492,1,1,179,0.005555555555555556,0.005555555555555556,0.9944444444444445,180,6100,4200,1900,0.6885245901639344,80,42,38,186.09392511966882,0.4668102110490379,0.7300988698137738,0.10759057721449235,1112411.5775989497,-697.3926352096405,1111714.18496374,2114,0,516.0555555555555,78,102,43,39.478291316526615,0.5497685185185186,44.23786919831224,8698.79816931529,111.52305345276014,0
2142,33.53369161766313,4,1,182,0.02185792349726776,0.00546448087431694,0.994535519125683,183,5850,4300,1550,0.7350427350427351,74,43,31,206.69911509321693,0.46740327068195925,0.7465939255743888,0.11980744377890565,1097611.9823960857,2925.0850953964596,1100537.0674914822,2115,0,508.1366120218579,84,99,43,38.85359788613213,0.5490095628415301,44.1421568627451,8579.858009725127,102.14116678244199,8
2143,33.06153053997436,0,2,180,0.0,0.01098901098901099,0.989010989010989,182,6250,4500,1750,0.72,80,45,35,207.05194259184873,0.46698490275838345,0.7471272601647088,0.12058517819767563,1083672.8370244526,2225.313207986431,1085898.1502324392,2116,1,509.11538461538464,87,95,33,38.661773770997065,0.5505952380952381,43.96306818181817,8464.972840668124,97.29853839848418,0
2144,32.57516066436719,2,0,182,0.01098901098901099,0.0,1.0,182,4450,3000,1450,0.6741573033707865,59,30,29,207.4021985188534,0.4667306680428227,0.751071450908835,0.12140322239054391,1069315.4751309743,3505.6760904791936,1072821.1512214534,2117,0,510.0274725274725,89,93,37,38.458946908784256,0.5521978021978022,43.773148148148145,8346.630865599076,93.7823692763941,0
2145,32.89775880419663,1,2,181,0.00546448087431694,0.01092896174863388,0.9890710382513661,183,6100,4400,1700,0.7213114754098361,78,44,34,216.4313331657944,0.4667577413479053,0.7644237189451353,0.1250899739144683,1075889.3319874157,3871.2324921787526,1079760.5644795944,2118,0,508.23497267759564,74,109,46,38.71476865428479,0.5462773224043715,44.25000000000002,8413.60181417334,113.69732181315325,7
2146,32.49827607938625,2,2,181,0.01092896174863388,0.01092896174863388,0.9890710382513661,183,6700,5100,1600,0.7611940298507462,83,51,32,233.34756953816398,0.46706424267899677,0.7812046099613121,0.13632941157683356,1066195.955156024,6458.8469574164355,1072654.8021134406,2119,0,508.0327868852459,76,107,37,37.86737523105364,0.5489526411657559,43.844696969697004,8324.60575707772,109.53428627733841,0
2147,32.52409173754697,0,0,181,0.0,0.0,1.0,181,6400,4600,1800,0.71875,82,46,36,232.24065501952595,0.46643006957233474,0.7789009765694022,0.1361510840051973,1068116.6566159902,7012.02239395281,1075128.679009943,2120,1,514.5193370165746,60,121,38,37.76388703802417,0.5504719152854511,43.715846994535525,8335.409303229262,138.92348838715438,0
2148,32.82771843226844,5,2,184,0.026881720430107527,0.010752688172043012,0.989247311827957,186,6450,4900,1550,0.7596899224806202,80,49,31,223.9979784699721,0.46741923374987887,0.7778675047652297,0.13242760487144795,1080723.5253875474,4765.976994350618,1085489.502381898,2121,0,501.66129032258067,68,118,40,37.655051871898955,0.5486671146953406,43.40277777777779,8423.50136161336,123.87502002372588,8
2149,32.36988898548984,4,4,184,0.02127659574468085,0.02127659574468085,0.9787234042553191,188,4800,3100,1700,0.6458333333333334,65,31,34,215.51173517508153,0.46794880911745745,0.7703587576537843,0.12878504036241006,1068949.8811517218,3674.248740440785,1072624.1298921625,2122,0,497.13829787234044,76,112,37,37.46742906774754,0.5525265957446808,43.00595238095237,8318.868791360243,109.45879988631899,0
2150,32.401486134676,2,3,183,0.010752688172043012,0.016129032258064516,0.9838709677419355,186,5700,4500,1200,0.7894736842105263,69,45,24,220.5628096342051,0.467641431754335,0.7744099423973101,0.13234455903728956,1071248.7025090363,4355.524728478029,1075604.2272375142,2123,0,503.36559139784947,77,109,39,37.18357785856488,0.553763440860215,42.855235042735046,8331.872536367347,108.20613683593957,0
2151,32.6767809877799,1,1,183,0.005434782608695652,0.005434782608695652,0.9945652173913043,184,5350,3600,1750,0.6728971962616822,71,36,35,191.81260507329188,0.4671728983527362,0.7439013002031416,0.11326141107072625,1075374.7920694875,-895.911940600673,1074478.8801288868,2124,0,509.7391304347826,68,116,47,38.527078184457245,0.5506680253623188,43.44806763285022,8383.291305953024,123.28369567577977,8
2152,32.21703062801421,2,1,184,0.010810810810810811,0.005405405405405406,0.9945945945945946,185,5700,3800,1900,0.6666666666666666,76,38,38,191.68904510473772,0.46689433999216606,0.7441692706651883,0.11405656604430248,1062585.9811747011,-1962.7815853884517,1060623.1995893128,2125,0,507.9675675675676,72,113,46,38.241707872659596,0.5530405405405405,43.164954337899516,8274.462532443253,114.92309072837851,0
2153,32.26755964996843,1,1,184,0.005405405405405406,0.005405405405405406,0.9945945945945946,185,6100,4300,1800,0.7049180327868853,79,43,36,227.3028710024549,0.46724197023110065,0.7801242582723844,0.13132636209624832,1055167.8936819327,4868.538324703572,1060036.4320066362,2126,0,505.52972972972975,70,115,42,38.450533532212745,0.540990990990991,44.26349765258218,8251.992844169645,117.88561205956636,8
2154,32.22985322178663,3,1,186,0.016042780748663103,0.0053475935828877,0.9946524064171123,187,5000,3200,1800,0.64,68,32,36,221.31249915949317,0.46770839323021485,0.7767489886367867,0.12878590818248076,1056161.4079498693,4348.344141839236,1060509.7520917086,2127,0,501.1016042780749,76,111,38,38.32776280560842,0.5432820855614973,43.993506493506516,8251.051709538611,108.56646986235015,0
2155,32.46384232735421,2,4,184,0.010638297872340425,0.02127659574468085,0.9787234042553191,188,5350,3900,1450,0.7289719626168224,68,39,29,217.70799363386004,0.4681941441953958,0.7759609836569203,0.12756775183316454,1065983.2252139794,3464.6138417373536,1069447.8390557168,2128,0,498.3670212765957,66,122,42,38.15534692309251,0.5455452127659575,43.73445273631841,8319.3643203013,126.05097455001969,0
2156,32.115805784858374,1,2,183,0.005405405405405406,0.010810810810810811,0.9891891891891892,185,6000,4200,1800,0.7,78,42,36,244.8731183052758,0.46753941441441443,0.7936438194340842,0.14228341830391183,1051962.4968732002,8519.4673899092,1060481.9642631093,2129,0,506.9027027027027,72,113,35,37.78212168515731,0.5423986486486487,44.0496575342466,8220.05148919818,114.16738179441917,8
2157,31.739941427441117,1,1,183,0.005434782608695652,0.005434782608695652,0.9945652173913043,184,6350,4400,1950,0.6929133858267716,83,44,39,240.4925640995956,0.46708256612813814,0.7889160415161105,0.1408102439935969,1041979.5079073373,6967.664719174496,1048947.1726265117,2130,0,510.3804347826087,78,106,36,37.60088080413044,0.5452332427536232,43.76318565400847,8132.941478895947,104.26848049866598,0
2158,31.33376578914868,1,2,182,0.005434782608695652,0.010869565217391304,0.9891304347826086,184,5550,4200,1350,0.7567567567567568,69,42,27,281.8087689794691,0.4671091708244239,0.818567773444435,0.16031496857737115,1019928.4116568391,15134.954027239666,1035063.3656840788,2131,0,511.3641304347826,69,115,35,37.66087328434232,0.5322690217391304,44.85119047619047,7994.773038999136,115.8662759275237,8
2159,31.439100438508092,3,1,184,0.016216216216216217,0.005405405405405406,0.9945945945945946,185,5950,4300,1650,0.7226890756302521,76,43,33,224.8312785245103,0.467429249902076,0.778210002338557,0.12863402003276445,1025101.3675110891,3144.9702149484397,1028246.3377260375,2132,0,507.8378378378378,65,120,41,38.89240832303257,0.538400900900901,44.63383838383839,8028.482403646799,123.51511390225845,8
2160,31.215716130145143,2,3,183,0.010752688172043012,0.016129032258064516,0.9838709677419355,186,5950,4300,1650,0.7226890756302521,76,43,33,220.00777108917129,0.4674555603991088,0.7728898506946791,0.1264382009753433,1019169.739770126,1695.0525616714044,1020864.7923317973,2133,0,506.0806451612903,69,117,43,38.842301420917764,0.5403785842293907,44.46428571428572,7976.730318256751,115.60478722111233,0
2161,31.336246685315135,6,4,185,0.031746031746031744,0.021164021164021163,0.9788359788359788,189,6050,4300,1750,0.7107438016528925,78,43,35,224.73375646095917,0.46947469886299675,0.7812328441310727,0.1259259866288122,1015374.2522084011,1787.77398250643,1017162.0261909076,2134,0,498.53968253968253,69,120,41,39.71053516104519,0.5268959435626102,45.43154761904763,7977.219822108442,115.61188147983249,8
2162,30.964292447169452,1,1,185,0.005376344086021506,0.005376344086021506,0.9946236559139785,186,5250,3400,1850,0.6476190476190476,71,34,37,224.3060553161279,0.46896614356291777,0.7776614583627781,0.12617307751712709,1004495.3256521665,2612.87681610556,1007108.2024682721,2135,0,507.5430107526882,69,117,43,39.56927567135985,0.5283378136200717,45.28273809523811,7887.139788961335,114.30637375306283,0
2163,31.273099416993464,5,3,187,0.02631578947368421,0.015789473684210527,0.9842105263157894,190,5800,3600,2200,0.6206896551724138,80,36,44,220.4322677843623,0.4699834075930567,0.7758608721521192,0.12546319155662258,1018108.9741342018,1084.8140040026383,1019193.7881382044,2136,0,497.2526315789474,77,113,41,39.206998743915875,0.5314144736842106,44.83173076923078,7979.902651716024,103.63509937293537,0
2164,31.631235529931192,3,0,190,0.015789473684210527,0.0,1.0,190,5300,3800,1500,0.7169811320754716,68,38,30,222.65033599657409,0.4700501253132832,0.7775470787059378,0.12773098222961424,1032194.9414001564,2663.7101033420786,1034858.6515034984,2137,0,497.84736842105264,67,123,43,38.84322969758749,0.5336622807017544,44.53125000000002,8080.792201787158,120.60883883264415,0
2165,31.299079001232997,2,1,191,0.010416666666666666,0.005208333333333333,0.9947916666666666,192,5350,3900,1450,0.7289719626168224,68,39,29,220.48455089161948,0.4704173711096568,0.7775887496175611,0.12743656137741155,1023615.4530082094,1388.2786884476245,1025003.731696657,2138,0,493.6510416666667,70,122,44,38.609908023558255,0.5357530381944444,44.24882629107984,8004.776190573607,114.35394557962296,0
2166,31.517772527304047,0,0,191,0.0,0.0,1.0,191,6650,5000,1650,0.7518796992481203,83,50,33,208.92329039114287,0.4701214751538532,0.7721906535123741,0.11879404967858556,1025768.3350143882,-1988.620853949899,1023779.7141604383,2139,1,497.05759162303667,79,112,43,39.539527406348874,0.5299956369982548,44.86979166666667,8041.135871093704,101.78653001384436,8
2167,31.48533968406301,4,3,192,0.020512820512820513,0.015384615384615385,0.9846153846153847,195,6450,4500,1950,0.6976744186046512,84,45,39,196.63128293670428,0.4705447616530091,0.7620944211749565,0.11314599338965757,1028355.907636818,-5008.611713166521,1023347.2959236515,2140,0,487.8410256410256,74,121,41,39.39109879360943,0.5328525641025641,44.416666666666686,8047.128067585143,108.74497388628572,0
2168,31.64192313076878,2,2,192,0.010309278350515464,0.010309278350515464,0.9896907216494846,194,6100,4500,1600,0.7377049180327869,77,45,32,196.40968762889986,0.47025454925840854,0.7593930445329162,0.11385819078009426,1035730.7704812012,-4214.488580429161,1031516.2819007721,2141,0,489.89690721649487,77,117,36,39.11189475790313,0.5348475085910653,44.137286324786345,8095.988318141068,105.14270543040348,0
2169,31.597397716826396,3,1,194,0.015384615384615385,0.005128205128205128,0.9948717948717949,195,5500,3400,2100,0.6181818181818182,76,34,42,192.7914973145591,0.47058220988633365,0.7562727834414591,0.11268798786696095,1036782.0876734572,-4523.4457857038,1032258.6418877534,2142,0,487.55897435897435,80,115,42,38.88836596385544,0.537232905982906,43.82716049382717,8094.395094125306,101.17993867656632,0
2170,31.8135266424092,5,0,199,0.02512562814070352,0.0,1.0,199,6000,4300,1700,0.7166666666666667,77,43,34,187.41080649729452,0.4716448403634333,0.7525295833564194,0.11089537206271144,1047603.3916320283,-6533.560696988552,1041069.8309350397,2143,0,478.72361809045225,73,126,43,38.56040763900314,0.5403580402010051,43.36993243243239,8164.307491803991,111.8398286548492,0
2171,31.52330454421969,2,2,199,0.009950248756218905,0.009950248756218905,0.9900497512437811,201,6300,3900,2400,0.6190476190476191,87,39,48,186.564949333334,0.47177031509121065,0.7531844776119414,0.11147523263224951,1040961.4235482881,-7658.616951551929,1033302.8065967362,2144,0,474.9502487562189,75,126,39,38.2153333333333,0.542962271973466,43.00986842105261,8101.178182622196,108.01570910162928,0
2172,31.75943003703464,2,3,198,0.009950248756218905,0.014925373134328358,0.9850746268656716,201,7500,5300,2200,0.7066666666666667,97,53,44,190.5886257649988,0.4721144278606965,0.7609600098033118,0.11491006900283005,1051461.0679553892,-7620.696002596673,1043840.3719527925,2145,0,475.910447761194,70,131,43,37.77474485432468,0.5456053067993367,42.678990610328654,8172.368594770435,116.74812278243479,0
2173,32.038658905434346,1,2,197,0.005025125628140704,0.010050251256281407,0.9899497487437185,199,5600,3600,2000,0.6428571428571429,76,36,40,193.63733305248678,0.4718404734108252,0.7626059491048947,0.11716342542227184,1061775.888542852,-4280.109728625409,1057495.7788142264,2146,0,481.62311557788945,71,128,41,37.563980987168684,0.5464824120603016,42.54918981481483,8248.378692450906,116.17434778099867,0
2174,32.20062000142822,0,2,195,0.0,0.01015228426395939,0.9898477157360406,197,6300,4400,1900,0.6984126984126984,82,44,38,197.42956137328588,0.4709254894851342,0.7649525491061566,0.11979008355716565,1067983.0809331944,-3529.713755453702,1064453.3671777407,2147,1,487.3248730964467,71,126,44,37.363077182339076,0.5476417089678511,42.44791666666667,8293.336765992855,116.80756008440642,0
2175,32.67080979870462,0,1,194,0.0,0.005128205128205128,0.9948717948717949,195,6900,4800,2100,0.6956521739130435,90,48,42,219.7701224908927,0.4701438452727113,0.7707001828308198,0.13139763959239975,1079046.9975959775,1528.4581670197822,1080575.4557629973,2148,2,493.1897435897436,85,110,34,37.33853896664939,0.5500534188034187,42.98691860465117,8396.825498046459,98.78618232995834,8
2176,32.3899196367789,2,0,196,0.01020408163265306,0.0,1.0,196,4750,3300,1450,0.6947368421052632,62,33,29,214.24286944445072,0.46993120966335256,0.7786529229563814,0.12768717728315188,1068796.1659453474,1846.3914886717325,1070642.5574340192,2149,0,491.39285714285717,78,118,38,37.60008725555612,0.5505420918367347,43.1039029535865,8320.843938335487,106.6774863889165,8
2177,32.79799346049125,2,1,197,0.010101010101010102,0.005050505050505051,0.9949494949494949,198,6350,4800,1550,0.7559055118110236,79,48,31,216.19790000000089,0.4700906057187783,0.7862686868686881,0.1299266225961538,1084837.6937377716,957.9262453898837,1085795.6199831616,2150,0,487.4191919191919,80,118,41,37.23770833333334,0.5528724747474747,42.79835390946501,8435.69790650491,105.44622383131139,0
2178,32.59429006387099,1,1,197,0.005050505050505051,0.005050505050505051,0.9949494949494949,198,7200,4800,2400,0.6666666666666666,96,48,48,212.72132646787912,0.4699266352185134,0.782276855573443,0.12873490069493268,1080247.8240683528,-841.6499900280714,1079406.1740783248,2151,0,487.94444444444446,68,130,38,37.065595559204105,0.5556607744107744,42.54227053140096,8391.651913485128,123.406645786546,0
2179,32.4873114503682,0,1,196,0.0,0.005076142131979695,0.9949238578680203,197,6350,4600,1750,0.7244094488188977,81,46,35,212.94677330024314,0.4694319986878,0.7808307618203101,0.12932225869361386,1077767.8665685377,151.43791049151105,1077919.3044790293,2152,1,491.34010152284264,70,127,43,36.92971464373183,0.5571065989847716,42.41490610328639,8368.247170394889,119.54638814849841,0
2180,32.93365334341735,1,1,196,0.005076142131979695,0.005076142131979695,0.9949238578680203,197,6450,4500,1950,0.6976744186046512,84,45,39,214.52646479149223,0.46886762319140857,0.7800408573538171,0.13142665538479822,1095271.920418012,1142.962614533158,1096414.8830325452,2153,0,492.1827411167513,74,123,44,36.564525104564964,0.5595389170896785,42.097222222222236,8493.680679637768,114.77946864375362,0
2181,33.25655626510659,1,2,195,0.005076142131979695,0.01015228426395939,0.9898477157360406,197,6500,4900,1600,0.7538461538461538,81,49,32,213.38374410622114,0.46874352532891334,0.7776166182120772,0.1312962565799811,1107358.6829904378,1358.4683690065976,1108717.1513594445,2154,0,493.0913705583756,79,118,40,36.43352548900883,0.561442470389171,41.94010416666666,8582.183445548777,108.6352334879592,0
2182,32.86672559455219,1,3,193,0.00510204081632653,0.015306122448979591,0.9846938775510204,196,5800,4200,1600,0.7241379310344828,74,42,32,215.27031867128616,0.46848290598290593,0.7801567846381701,0.132929930933537,1095467.5802659558,2164.3310195829645,1097631.9112855387,2155,0,496.5969387755102,78,118,44,36.2536812896856,0.5625,41.811708860759495,8485.803716599774,108.79235534102274,0
2183,33.17639759699826,1,1,193,0.005154639175257732,0.005154639175257732,0.9948453608247423,194,5550,3900,1650,0.7027027027027027,72,39,33,216.71149608200886,0.4676538601926535,0.7783168557468285,0.13412928169093566,1106500.5326113254,3608.2771675478725,1110108.8097788733,2156,0,502.47938144329896,83,111,47,36.131634016741096,0.5641645189003437,41.728670634920626,8568.512310921138,103.23508808338721,0
2184,33.25378290193335,1,4,190,0.005154639175257732,0.020618556701030927,0.979381443298969,194,6350,4900,1450,0.7716535433070866,78,49,29,217.59395493232324,0.4677384354468244,0.7779959571929576,0.13570699461656838,1111430.45583081,3218.109703292156,1114648.565534102,2157,0,503.3917525773196,68,126,48,35.82953793452451,0.5660975085910653,41.45531400966183,8597.588858371231,126.43513027016516,0
2185,32.74756207043934,1,0,191,0.005235602094240838,0.0,1.0,191,5150,3400,1750,0.6601941747572816,69,34,35,218.37244907957893,0.46783319555433084,0.7770314154455455,0.1368861387097961,1096045.5616310723,4519.230719235986,1100564.7923503083,2158,0,508.717277486911,68,123,44,35.62429493912165,0.5680628272251309,41.27415458937198,8472.64068181144,124.59765708546234,0
2186,32.63519482812751,0,1,190,0.0,0.005235602094240838,0.9947643979057592,191,5000,3500,1500,0.7,65,35,30,205.91621159751264,0.46762882336731887,0.7693002482316995,0.1247819580733309,1082010.1865672336,1360.6877055686564,1083370.8742728024,2159,1,509.717277486911,67,124,45,37.191403926234386,0.5571007853403142,42.49387254901962,8403.762638799406,125.42929311640904,8
2187,32.897386361404415,1,1,190,0.005235602094240838,0.005235602094240838,0.9947643979057592,191,4500,3100,1400,0.6888888888888889,59,31,28,201.64588480154654,0.4669674841554147,0.7641318508063535,0.12310689114362765,1092997.4411824872,1379.6872226138448,1094377.1284051011,2160,0,510.70157068062827,72,119,46,37.025209890211315,0.5587914485165795,42.22317351598174,8480.183855861467,117.78033133140927,0
2188,32.97244932173836,2,2,190,0.010416666666666666,0.010416666666666666,0.9895833333333334,192,6000,4700,1300,0.7833333333333333,73,47,26,199.34855432269063,0.4671826143470041,0.7631746706332336,0.12247184029276562,1097426.3695727345,-645.9279500152034,1096780.4416227192,2161,0,509.0104166666667,75,117,40,36.85233389998584,0.5609266493055556,41.995614035087726,8507.036541014313,113.42715388019084,0
2189,33.33686754957132,0,1,189,0.0,0.005263157894736842,0.9947368421052631,190,5300,4200,1100,0.7924528301886793,64,42,22,204.753986273684,0.46673570500324885,0.767482802577029,0.12595805625399986,1109963.213243177,2153.8785057378554,1112117.0917489147,2162,1,515.2842105263157,73,117,40,36.664484689795664,0.5616776315789473,41.94819819819822,8602.638737594949,117.84436626842395,0
2190,33.50413910020465,0,1,188,0.0,0.005291005291005291,0.9947089947089947,189,6000,3800,2200,0.6333333333333333,82,38,44,225.14396680214017,0.4666919959473151,0.7840432006550913,0.13224936063298778,1100929.7541945332,5773.538405972589,1106703.2926005058,2163,2,518.7724867724868,67,122,39,37.87104123095308,0.5471230158730158,43.64276960784314,8589.028306402048,128.1944523343589,8
2191,33.39419344593508,2,1,189,0.010526315789473684,0.005263157894736842,0.9947368421052631,190,6350,4400,1950,0.6929133858267716,83,44,39,246.03137848914272,0.46693817878028404,0.797419543575796,0.14233161981936404,1092427.7262653867,9404.299878566775,1101832.0261439534,2164,0,515.8894736842105,73,117,38,37.92140177572323,0.5421052631578948,44.21452702702704,8541.749565119484,117.0102680153354,7
2192,33.11427618228645,3,2,190,0.015625,0.010416666666666666,0.9895833333333334,192,7550,5400,2150,0.7152317880794702,97,54,43,247.3450454530498,0.4668014197934846,0.8017250257466528,0.1441608878360819,1085643.0923718798,7755.688005702651,1093398.7803775824,2165,0,511.34375,78,114,37,37.6009483350498,0.5448133680555556,43.93459915611816,8479.420404272232,108.71051800349015,0
2193,33.25135810756213,2,1,191,0.010416666666666666,0.005208333333333333,0.9947916666666666,192,6100,4600,1500,0.7540983606557377,76,46,30,245.6311104106843,0.4673797447643979,0.8027371490221789,0.1440639211578229,1092139.139505668,9152.669911949053,1101291.809417617,2166,0,511.8697916666667,61,131,40,37.404061509887455,0.5469835069444444,43.69959677419353,8522.336490773827,139.71043427498077,0
2194,33.50029818396107,0,0,191,0.0,0.0,1.0,191,5650,3700,1950,0.6548672566371682,76,37,39,226.2992093412138,0.46710411499954074,0.7898875125499669,0.12849242500347338,1089830.2645476474,5475.545436651856,1095305.8099842994,2167,1,515.4188481675393,70,121,41,39.151352620882754,0.5329952006980803,44.923708920187806,8545.131810832585,122.07331158332265,8
2195,33.91024331935233,3,0,194,0.015463917525773196,0.0,1.0,194,6950,5100,1850,0.7338129496402878,88,51,37,216.63019153920894,0.4686453937645781,0.7833667689936561,0.12091826264269885,1097494.0834085646,1800.0707003893517,1099294.154108954,2168,0,508.4329896907216,69,125,38,40.068859546509124,0.5290485395189004,45.58035714285715,8627.431994508457,125.03524629722402,8
2196,34.05252511197995,2,1,195,0.01020408163265306,0.00510204081632653,0.9948979591836735,196,6750,5300,1450,0.7851851851851852,82,53,29,212.71906147292552,0.46910812401883834,0.7816546930760957,0.11941185771722636,1103999.2729281767,1018.3378408146723,1105017.6107689913,2169,0,504.234693877551,74,122,42,39.94445656521581,0.530984268707483,45.36111111111111,8671.097158375556,117.17698862669671,0
2197,34.342634517257345,6,4,197,0.029850746268656716,0.01990049751243781,0.9800995024875622,201,5700,4200,1500,0.7368421052631579,72,42,30,209.27794680088377,0.47067578772802654,0.7847980686996634,0.11912060406317246,1118056.1134548609,896.897566401929,1118953.0110212627,2170,0,487.51741293532336,81,120,42,39.48962637526762,0.5346703980099503,44.82977642276423,8763.217727999865,108.18787318518352,0
2198,34.04049055876268,1,2,196,0.005050505050505051,0.010101010101010102,0.98989898989899,198,6350,4700,1650,0.7401574803149606,80,47,33,214.31006034567338,0.46990260045463095,0.7877142270115554,0.12226353861044757,1108974.8199344922,1582.8921163987766,1110557.712050891,2171,0,495.80808080808083,63,135,43,39.2724207740866,0.5358270202020202,44.74283854166668,8689.07899467898,137.92188880442825,0
2199,33.97421858363727,1,3,194,0.005076142131979695,0.015228426395939087,0.9847715736040609,197,5400,3100,2300,0.5740740740740741,77,31,46,209.85605388086105,0.4695949445768155,0.7819467538416156,0.12006615812561301,1107761.273205816,1694.0818874022125,1109455.3550932182,2172,0,499.15736040609136,65,132,44,39.27482488669132,0.5375951776649746,44.63383838383839,8675.865793611929,133.47485836326044,0
2200,34.07867967122027,0,3,191,0.0,0.015463917525773196,0.9845360824742269,194,5550,3600,1950,0.6486486486486487,75,36,39,208.37483922016006,0.4693403575307587,0.7769887144759327,0.11992874068259317,1113127.4562713115,2039.5509464161132,1115167.0072177276,2164,1,496.2113402061856,67,127,44,39.0828213964639,0.5390893470790379,44.40870098039216,8710.214006040302,130.0031941200045,0
2201,34.131182013302116,4,2,193,0.020512820512820513,0.010256410256410256,0.9897435897435898,195,7300,5600,1700,0.7671232876712328,90,56,34,201.87270487669048,0.47069235174905283,0.769414624379982,0.11744264270273509,1118381.0535465435,-1145.8783275432584,1117235.1752190003,2165,0,491.98974358974357,73,122,39,38.83550533377326,0.5422008547008548,44.003378378378386,8737.467287358017,119.69133270353447,0
2202,34.22217602898309,1,0,194,0.005154639175257732,0.0,1.0,194,6000,4200,1800,0.7,78,42,36,204.22200000733787,0.4701193401349643,0.7709253091749186,0.11944274972634274,1123109.0665342212,1072.7159587987944,1124181.78249302,2166,0,494.680412371134,76,118,42,38.5720289013271,0.544458762886598,43.804112554112564,8767.580758074731,115.36290471150963,0
2203,34.25730960298973,2,1,195,0.01020408163265306,0.00510204081632653,0.9948979591836735,196,5350,4000,1350,0.7476635514018691,67,40,27,200.70522307300178,0.4701541514041514,0.769910842670108,0.11827197484520324,1126725.808148477,677.9509333093392,1127403.7590817863,2167,0,490.6224489795918,68,128,42,38.37593442815938,0.5467687074829932,43.52355072463766,8786.193128701525,129.20872248090478,0
2204,33.87435573292894,2,2,195,0.01015228426395939,0.01015228426395939,0.9898477157360406,197,6600,5200,1400,0.7878787878787878,80,52,28,197.07191183537321,0.4697438620118098,0.7666805509147581,0.11687312846279561,1116186.1953224174,-2006.2105047121659,1114179.9848177053,2168,0,489.1015228426396,71,126,41,38.22794559663358,0.5485406091370558,43.28703703703702,8695.986228661573,122.47867927692357,0
2205,33.31007108445915,0,0,195,0.0,0.0,1.0,195,6700,4800,1900,0.7164179104477612,86,48,38,199.79229123663052,0.46910300467001503,0.767454864769934,0.11907933752673047,1099171.3396945442,-1778.8079161583164,1097392.5317783859,2169,1,494.5076923076923,73,122,45,37.96986301369863,0.5501602564102563,43.10247747747746,8557.274736646621,117.22294159789892,0
2206,33.56625073062802,2,0,197,0.01015228426395939,0.0,1.0,197,5700,4000,1700,0.7017543859649122,74,40,34,191.7416157131862,0.4695636503332297,0.761446097833494,0.11179906185091179,1100592.7158352816,-2894.1148847156455,1097698.600950566,2170,0,490.47715736040607,79,118,40,39.00913755699055,0.541825296108291,43.91927083333335,8595.66996249043,108.80594889228392,8
2207,33.16437038829041,3,1,199,0.015,0.005,0.995,200,6350,4400,1950,0.6929133858267716,83,44,39,204.07036542894372,0.46996806951423786,0.77265786127984,0.12273696829834303,1097207.3966761478,-1568.497121791519,1095638.8995543562,2171,0,484.105,85,115,37,37.51957079625183,0.5568229166666667,42.76889534883722,8530.907630040285,100.36361917694452,8
2208,33.04399377298615,2,4,197,0.009950248756218905,0.01990049751243781,0.9800995024875622,201,5500,3600,1900,0.6545454545454545,74,36,38,179.4740133116697,0.4697439883913765,0.746085656663084,0.10523047375673608,1085232.224023046,-6745.803475886631,1078486.4205471594,2172,0,482.6865671641791,79,122,42,39.11121483852399,0.5522388059701493,43.710937500000036,8468.814185334548,107.2001795611968,8
2209,33.41205654669352,1,1,197,0.005050505050505051,0.005050505050505051,0.9949494949494949,198,5700,4000,1700,0.7017543859649122,74,40,34,177.08137323649626,0.46969429916764943,0.7389735184326294,0.10432144278586633,1098835.43826497,-6383.3423262222095,1092452.0959387477,2173,0,482.1161616161616,81,117,40,38.99251036042731,0.5540298821548821,43.53404471544717,8569.0550002693,105.7908024724605,0
2210,33.7142289184819,1,3,195,0.005050505050505051,0.015151515151515152,0.9848484848484849,198,6250,5000,1250,0.8,75,50,25,205.61161243455706,0.4698748269497,0.7740097011941676,0.1169557982369886,1097379.2322081123,-723.217322698843,1096656.0148854135,2174,0,483.1010101010101,81,117,38,39.60910920255581,0.5356165824915825,44.85518292682926,8602.010770169041,106.19766382924742,8
2211,33.80270235976485,2,3,194,0.01015228426395939,0.015228426395939087,0.9847715736040609,197,5550,3700,1850,0.6666666666666666,74,37,37,203.56179699839876,0.47012263027038226,0.7709083612170899,0.11673564954857832,1102929.6215622893,-47.13285440326854,1102882.488707886,2175,0,486.24873096446703,71,126,41,39.345644314813775,0.5379124365482233,44.545717592592595,8635.04507474491,121.62035316542128,0
2212,33.37053681898088,2,0,196,0.01020408163265306,0.0,1.0,196,5800,4400,1400,0.7586206896551724,72,44,28,200.58923130664223,0.46995628379556953,0.7669288860918808,0.11556790737717768,1090332.5570578652,-1258.2061022312669,1089074.350955634,2176,0,488.7244897959184,73,123,41,39.24169419970633,0.540125425170068,44.36936936936939,8530.531371518806,116.8565941303946,0
2213,33.317502212952334,4,3,197,0.02,0.015,0.985,200,6650,4600,2050,0.6917293233082706,87,46,41,209.01671114513812,0.47037531407035177,0.7796128664252753,0.12196775436750093,1092688.5895884663,-971.9649396794402,1091716.6246487868,2177,0,479.93,81,119,41,38.53660326042029,0.5434895833333333,43.889735772357746,8532.954295164336,105.34511475511526,0
2214,33.10243699021412,1,1,197,0.005050505050505051,0.005050505050505051,0.9949494949494949,198,6400,4300,2100,0.671875,85,43,42,204.86836803792758,0.47018247192739576,0.7721746338767617,0.11523447683078376,1073844.114598966,-2000.661742995202,1071843.4528559707,2178,0,485.7121212121212,73,125,43,40.06602882932669,0.5273042929292929,45.28434684684686,8431.708858923519,115.50286108114409,7
2215,32.61258715342208,6,2,201,0.029556650246305417,0.009852216748768473,0.9901477832512315,203,5950,3900,2050,0.6554621848739496,80,39,41,218.57415181688998,0.4723038498431124,0.7873765439588436,0.11992041302386126,1049946.956254196,-651.7469168026528,1049295.2093373933,2179,0,473.88669950738915,74,129,42,40.70368089764638,0.5173440065681445,46.25,8275.443990180855,111.83032419163317,8
2216,32.15850058584902,4,2,203,0.01951219512195122,0.00975609756097561,0.9902439024390244,205,6550,4800,1750,0.732824427480916,83,48,35,218.26524872787948,0.47322353738243267,0.7883629823164107,0.12132507027412408,1039482.1226398406,-2173.435190766202,1037308.6874490744,2180,0,467.3707317073171,67,138,38,40.19184038237537,0.5214430894308943,45.74142156862745,8176.574643442438,122.03842751406624,0
2217,32.30649949096993,1,1,203,0.004901960784313725,0.004901960784313725,0.9950980392156863,204,6400,4400,2000,0.6875,84,44,40,210.26205682766582,0.4734844368781996,0.7804839944308646,0.11322562402879432,1034073.5656340234,-3714.7130357345486,1030358.8525982888,2181,0,468.1127450980392,84,120,40,41.66535487100003,0.5134293300653594,46.98529411764705,8174.019466796116,97.30975555709662,8
2218,32.021097726182255,3,1,205,0.014563106796116505,0.0048543689320388345,0.9951456310679612,206,6550,5000,1550,0.7633587786259542,81,50,31,206.88073712304825,0.4742136316994238,0.7799311933932025,0.11214854703257778,1027070.8291496602,-5253.765957587519,1021817.0631920727,2182,0,464.5242718446602,74,132,42,41.48239288586677,0.5157766990291262,46.72222222222223,8110.232474092513,109.59773613638531,0
2219,32.04397188947389,4,4,205,0.019138755980861243,0.019138755980861243,0.9808612440191388,209,6800,5100,1700,0.75,85,51,34,203.46259416140578,0.4753567430376641,0.7814471361840318,0.11146088850380596,1031159.7005851218,-6639.514464850527,1024520.1861202712,2183,0,458.4736842105263,80,129,42,41.147496662780284,0.5185905103668261,46.309156378600825,8129.262261621034,101.61577827026292,0
2220,32.06336384354778,4,2,207,0.019138755980861243,0.009569377990430622,0.9904306220095693,209,6950,5100,1850,0.7338129496402878,88,51,37,206.9339111484315,0.4756577030425715,0.7870552657652896,0.11452938823439184,1035036.7321810456,-5913.160165496954,1029123.5720155486,2184,0,458.2918660287081,81,128,41,40.65155984401559,0.5215311004784688,45.90955284552845,8146.994456283563,100.58017847263658,0
2221,32.491992313051114,2,3,206,0.009569377990430622,0.014354066985645933,0.9856459330143541,209,6900,5400,1500,0.782608695652174,84,54,30,206.13212437674952,0.47608997362286837,0.7882231809809508,0.11486947843899384,1051067.3037807492,-5368.252761746393,1045699.0510190028,2185,0,452.21531100478467,65,144,40,40.40084388185657,0.5241726475279107,45.643939393939405,8264.535165990106,127.14669486138625,0
2222,32.043103027921994,1,2,205,0.004830917874396135,0.00966183574879227,0.9903381642512077,207,7050,5000,2050,0.7092198581560284,91,50,41,210.84648986864948,0.475926512202367,0.789764401438017,0.11816232498022752,1038325.6986659997,-4664.534219171977,1033661.1644468277,2186,0,447.64251207729467,68,139,39,40.05811540058115,0.5262177938808373,45.42572463768117,8157.349733693391,119.96102549549104,0
2223,32.15775188524655,3,4,204,0.014423076923076924,0.019230769230769232,0.9807692307692307,208,6450,4400,2050,0.6821705426356589,85,44,41,209.32955746322892,0.47635395376563855,0.7889462098215234,0.11838153036025986,1044897.1368507096,-4304.428949688813,1040592.7079010208,2187,0,446.0480769230769,72,136,38,39.74076406381193,0.5286959134615384,45.07705479452057,8197.748821774165,113.85762252464117,0
2224,32.42644155292848,4,3,205,0.019230769230769232,0.014423076923076924,0.9855769230769231,208,6750,4600,2150,0.6814814814814815,89,46,43,221.0307229301322,0.47629443825095996,0.7973986186094209,0.1236910090157755,1050287.7095119448,-1920.829656388646,1048366.8798555562,2188,0,445.9519230769231,73,135,36,39.85577632136866,0.519130608974359,45.481418918918905,8253.13189355993,113.05660128164288,8
2225,32.378098336294926,2,0,207,0.00966183574879227,0.0,1.0,207,6500,4300,2200,0.6615384615384615,87,43,44,215.92114947746578,0.47605451589200004,0.7980907650777709,0.12094686898373425,1049024.893639138,-2598.6678269922068,1046426.2258121457,2189,0,446.9855072463768,66,141,40,39.94826340112784,0.5252616747181964,45.444651741293534,8242.018097950206,124.87906209015463,8
2226,32.48575921916947,2,0,209,0.009569377990430622,0.0,1.0,209,5950,4200,1750,0.7058823529411765,77,42,35,224.36083012291365,0.4764292724819041,0.8060300547100829,0.1270609019950593,1056001.4990991706,-364.9254102136283,1055636.573688957,2190,0,443.69856459330146,71,138,36,39.302466333787244,0.5275618022328549,45.02314814814816,8283.116615721137,116.66361430593152,0
2227,32.62853396437677,3,4,208,0.014150943396226415,0.018867924528301886,0.9811320754716981,212,6150,3900,2250,0.6341463414634146,84,39,45,223.259659326972,0.4770331269188351,0.8077864449993646,0.12757582158009326,1063489.4820247246,-1063.1401090681957,1062426.3419156563,2191,0,438.4056603773585,65,147,40,38.98094774474048,0.5300216194968553,44.681186868686886,8330.678565999451,128.1642856307608,0
2228,32.54081818723166,0,3,205,0.0,0.014423076923076924,0.9855769230769231,208,6050,4100,1950,0.6776859504132231,80,41,39,201.94570892572182,0.47614395593335807,0.7830204070123423,0.11449985919375232,1058160.6644810862,-4911.798890810939,1053248.8655902753,2192,1,447.7307692307692,77,131,43,39.82858539310152,0.5305989583333333,44.97863247863247,8298.603954371987,107.77407732950633,8
2229,32.45142979668371,1,2,204,0.0048543689320388345,0.009708737864077669,0.9902912621359223,206,7500,5400,2100,0.72,96,54,42,197.6363672807135,0.4758588878364512,0.7763107598740273,0.11256781201739072,1056692.5985923402,-6931.822696358435,1049760.7758959818,2193,0,452.88349514563106,78,128,46,39.7612681271744,0.5323118932038835,44.80485232067511,8281.447419369959,106.17240281243537,0
2230,32.52605353088868,6,0,210,0.02857142857142857,0.0,1.0,210,7450,5400,2050,0.7248322147651006,95,54,41,184.6628539764151,0.47635091516670464,0.7620897342849051,0.10638381977860863,1062716.0039353678,-10201.16594937643,1052514.8379859913,2194,0,444.53809523809525,76,134,46,39.651800204628785,0.5365079365079365,44.37229437229439,8314.560437225064,109.40211101611926,0
2231,32.5872668394078,5,2,213,0.023255813953488372,0.009302325581395349,0.9906976744186047,215,6850,4800,2050,0.7007299270072993,89,48,41,184.72545215695905,0.47644986597116573,0.7670572055873004,0.1076470349559946,1068315.5796877842,-10380.984299169755,1057934.5953886143,2195,0,435.1767441860465,81,134,38,39.21047898992907,0.5398740310077519,43.94054878048783,8344.277663642642,103.0157736252178,0
2232,32.34695253378772,2,7,208,0.009302325581395349,0.03255813953488372,0.9674418604651163,215,6600,5100,1500,0.7727272727272727,81,51,30,188.50902845614672,0.4762153155111208,0.773689636610799,0.10945547005346701,1059313.1650093638,-9661.98088665569,1049651.1841227082,2196,0,436.0279069767442,82,133,37,39.25191251471164,0.5412306201550388,44.07630522088355,8278.351607291694,100.95550740599626,8
2233,32.328933217338644,6,10,204,0.028037383177570093,0.04672897196261682,0.9532710280373832,214,6800,4800,2000,0.7058823529411765,88,48,40,191.68484367770367,0.4764211567431589,0.777410531114654,0.11227255129694161,1061424.5456708337,-8908.200377481335,1052516.3452933524,2197,0,438.74766355140184,85,129,42,38.83807588075878,0.543565031152648,43.75000000000002,8284.289136943093,97.46222514050697,0
2234,32.49871668652637,0,2,202,0.0,0.00980392156862745,0.9901960784313726,204,6200,3300,2900,0.532258064516129,91,33,58,194.40923795608225,0.47533223059338675,0.7705662666785045,0.11414088387973587,1067742.5646035736,-5484.196336429592,1062258.368267144,2198,1,460.1519607843137,69,135,41,38.67724176632219,0.5443218954248366,43.660714285714256,8330.69782205505,120.73475104427608,0
2235,32.686414402493185,1,0,203,0.0049261083743842365,0.0,1.0,203,7500,5900,1600,0.7866666666666666,91,59,32,197.1847061756949,0.4748329512754231,0.7726393358156012,0.1165301820735066,1075950.3061280814,-5667.811005297346,1070282.495122784,2199,0,463.0689655172414,71,132,42,38.35782586223098,0.5465927750410509,43.41724537037035,8386.770246357257,118.12352459658108,0
2236,32.99328697129163,2,3,202,0.00975609756097561,0.014634146341463415,0.9853658536585366,205,6300,4400,1900,0.6984126984126984,82,44,38,202.76324517903015,0.47512753068707153,0.7810064263970824,0.11734438507622166,1079431.629392526,-3526.187975096343,1075905.4414174298,2200,0,459.54146341463417,73,132,44,39.01377577225036,0.5388719512195121,44.200450450450475,8439.667945415482,115.61188966322578,8
2237,32.798264408215275,3,3,202,0.014634146341463415,0.014634146341463415,0.9853658536585366,205,6850,4900,1950,0.7153284671532847,88,49,39,198.8054051517269,0.47506874701099955,0.7762701775768464,0.11598105161563561,1075583.3272779107,-5083.644169214167,1070499.6831086965,2201,0,460.4829268292683,76,129,38,38.80737943056364,0.5410569105691057,43.898809523809554,8399.674560496875,110.52203369074834,0
2238,32.850044657724446,2,2,202,0.00980392156862745,0.00980392156862745,0.9901960784313726,204,6900,4800,2100,0.6956521739130435,90,48,42,219.3267680593592,0.4750766685984739,0.7962904754777236,0.12713188768042522,1075247.9865478708,-533.8668496243336,1074714.1196982465,2202,0,462.21078431372547,71,133,44,38.528944020356256,0.5405433006535948,44.14062500000001,8404.991894847479,118.38016753306309,8
2239,32.72064003995719,2,3,201,0.00980392156862745,0.014705882352941176,0.9852941176470589,204,6550,4500,2050,0.6870229007633588,86,45,41,213.79710940073403,0.47507717167326696,0.7871569626831361,0.12265202591936858,1067744.5431007643,-1693.860621329879,1066050.6824794344,2203,0,462.5735294117647,71,133,39,39.06940197077808,0.5363051470588236,44.53125,8359.101010207818,117.73381704518053,8
2240,32.525573400700814,0,4,197,0.0,0.01990049751243781,0.9800995024875622,201,6500,4200,2300,0.6461538461538462,88,42,46,213.5160615555768,0.4746735074626866,0.7836933115700351,0.12308769636872893,1062908.787808876,-1310.3803668470564,1061598.4074420289,2204,1,469.5771144278607,74,127,36,38.88862479853681,0.5380907960199005,44.347222222222236,8315.253188704197,112.3682863338405,0
2241,32.4842295905894,2,2,197,0.010050251256281407,0.010050251256281407,0.9899497487437185,199,6600,4500,2100,0.6818181818181818,87,45,42,212.71271105590876,0.4749367629392755,0.7793646834661487,0.12389759331171266,1064789.761871524,-1101.1366095462154,1063688.6252619778,2205,0,470.7185929648241,79,120,36,38.5120016273393,0.541352596314908,43.95833333333336,8317.316284757226,105.28248461718007,0
2242,32.81374481595511,3,4,196,0.015,0.02,0.98,200,6200,4300,1900,0.6935483870967742,81,43,38,211.52242351673652,0.47509369765494136,0.7803149126371416,0.12423787214192938,1078217.9609726097,-586.5447631604293,1077631.4162094493,2206,0,469.25,69,131,40,38.22336787213867,0.5440104166666666,43.6458333333333,8411.940207506746,121.91217692038762,0
2243,32.72857039865847,2,1,197,0.010101010101010102,0.005050505050505051,0.9949494949494949,198,6900,5000,1900,0.7246376811594203,88,50,38,229.42096359308997,0.4746326419867029,0.7951504574541226,0.13278607286751562,1070804.6466857789,2633.006772521908,1073437.6534583007,2207,0,472.37373737373736,76,122,39,38.32775838665892,0.5429819023569024,44.19642857142857,8372.085195728254,110.1590157332665,8
2244,33.096578312559494,1,1,197,0.005050505050505051,0.005050505050505051,0.9949494949494949,198,7550,6100,1450,0.8079470198675497,90,61,29,229.63137243546336,0.4744222042762652,0.7943931347822366,0.1334537791520665,1084151.3721659866,2641.033503653135,1086792.4056696398,2208,0,473.34343434343435,81,117,36,38.164580128046055,0.5450862794612794,44.042174796747965,8471.328206551834,104.58429884631894,0
2245,32.8561919827258,2,2,197,0.010050251256281407,0.010050251256281407,0.9899497487437185,199,6650,5000,1650,0.7518796992481203,83,50,33,229.18296232064563,0.4745687613149925,0.7971702400762879,0.13393524935400708,1078029.988452989,2963.2212448293044,1080993.2096978182,2209,0,471.8040201005025,86,113,38,37.9629196852847,0.5472675879396984,43.83381226053639,8416.645443850772,97.86797027733455,0
2246,33.15604826566359,2,0,199,0.010050251256281407,0.0,1.0,199,6000,4000,2000,0.6666666666666666,80,40,40,222.39398774017255,0.47451377256653643,0.792498085266274,0.13111848347610752,1090663.819796856,2711.415233710424,1093375.2350305663,2210,0,468.6030150753769,67,132,43,37.800605191909526,0.5497278056951425,43.504901960784316,8504.363850494357,126.93080373872175,0
2247,32.74403715323561,0,3,196,0.0,0.01507537688442211,0.9849246231155779,199,6300,4500,1800,0.7142857142857143,81,45,36,215.50684845449402,0.47425257601137,0.7835983085838696,0.12545269477088053,1073124.446909267,153.13351057798718,1073277.580419845,2211,1,469.6030150753769,76,123,39,38.46257155438133,0.5431323283082077,43.97997835497838,8383.129100716831,110.30433027258988,8
2248,32.46300294900692,3,3,196,0.01507537688442211,0.01507537688442211,0.9849246231155779,199,5500,3900,1600,0.7090909090909091,71,39,32,209.9544034336482,0.47503828062873293,0.7780451422805783,0.1232334465546031,1066482.887060258,-517.444335013919,1065965.4427252442,2212,0,468.7437185929648,65,134,44,38.289347433450295,0.5452261306532663,43.67108585858584,8321.206295688437,128.01855839520672,0
2249,32.44358004076671,3,0,199,0.01507537688442211,0.0,1.0,199,6400,4700,1700,0.734375,81,47,34,202.21792307509267,0.47491349846877484,0.7692488474943604,0.12006562331260125,1069402.5494727916,-2949.527502880849,1066453.0219699107,2213,0,469.39195979899495,71,128,44,38.05156035761914,0.548105108877722,43.24363425925924,8330.095702886048,117.32529158994434,0
2250,32.15657024303965,5,6,198,0.024509803921568627,0.029411764705882353,0.9705882352941176,204,6350,4300,2050,0.6771653543307087,84,43,41,196.12822326127196,0.4755158528928813,0.768321301789247,0.11782009324381432,1063504.7639720517,-5433.340042452897,1058071.4239295989,2214,0,458.8627450980392,79,125,42,37.76832725799917,0.5511131535947713,42.81249999999997,8270.26790938169,104.68693556179353,0
2251,32.25516511300769,0,2,196,0.0,0.010101010101010102,0.98989898989899,198,5850,3800,2050,0.6495726495726496,79,38,41,210.2200911153269,0.4741161616161616,0.7757053820883604,0.12230660064376637,1056928.9599550904,-1012.4595471625989,1055916.500407928,2215,1,473.6666666666667,82,116,38,38.619390789946706,0.5430345117845118,44.001004016064265,8257.289884226062,100.69865712470808,8
2252,32.62237999394951,2,4,194,0.010101010101010102,0.020202020202020204,0.9797979797979798,198,5650,4300,1350,0.7610619469026548,70,43,27,209.49991506184736,0.47403123878377684,0.7770313904975064,0.1227559726873104,1071183.4001190448,-367.4337318800881,1070815.9663871648,2216,0,474.44444444444446,69,129,43,38.36637196833318,0.5452967171717171,43.73511904761902,8359.970325532757,121.15899022511242,0
2253,33.07379683053247,3,3,194,0.015228426395939087,0.015228426395939087,0.9847715736040609,197,5700,3800,1900,0.6666666666666666,76,38,38,206.6103698402764,0.4735757881832936,0.7742203085188346,0.12200538422835813,1088456.3760911408,-122.72511616086013,1088333.6509749799,2217,0,467.8578680203046,71,126,45,38.145512603620354,0.5473244500846024,43.44618055555553,8485.2089004026,119.50998451271268,0
2254,32.5523966814732,1,4,191,0.005128205128205128,0.020512820512820513,0.9794871794871794,195,4550,3000,1550,0.6593406593406593,61,30,31,206.90985553367773,0.4732509472200194,0.7706356336723197,0.12271268407699691,1072639.693462409,837.9448027987482,1073477.6382652079,2218,0,473.2974358974359,73,122,45,37.97379640291717,0.5488247863247864,43.28547297297295,8356.67311768049,114.47497421480122,0
2255,32.82890373488871,2,2,191,0.010362694300518135,0.010362694300518135,0.9896373056994818,193,6300,4200,2100,0.6666666666666666,84,42,42,204.34198003019324,0.4728440288572251,0.765118535008799,0.12219997729284242,1084336.1928712197,-584.9190660591435,1083751.2738051605,2219,0,476.5181347150259,76,117,45,37.72687597592856,0.551543609671848,42.97889610389607,8437.721077639935,111.0226457584202,0
2256,32.30802420688122,0,1,190,0.0,0.005235602094240838,0.9947643979057592,191,6500,4300,2200,0.6615384615384615,87,43,44,207.3158458517789,0.47258771929824567,0.7662452662712491,0.12436431725033084,1068081.028197923,-413.97564018238336,1067667.0525577406,2220,1,481.36649214659684,79,112,45,37.53375869286337,0.5535013089005236,42.8645833333333,8307.537266113073,105.15869957105156,0
2257,31.8797347932227,4,0,194,0.020618556701030927,0.0,1.0,194,6250,4100,2150,0.656,84,41,43,200.31690667501616,0.4726816364866549,0.7630480341124759,0.12146756786677754,1057157.1631055519,-2696.7094434720507,1054460.4536620798,2221,0,474.78350515463916,69,125,48,37.31148156708654,0.5571842783505154,42.470238095238095,8209.980510885598,118.98522479544344,0
2258,32.015378792703224,2,3,193,0.01020408163265306,0.015306122448979591,0.9846938775510204,196,6450,4300,2150,0.6666666666666666,86,43,43,195.44748857387043,0.4726648351648352,0.7589340693173834,0.11932583512931048,1063701.079097815,-4070.4590994031496,1059630.619998412,2222,0,470.92857142857144,74,122,49,37.18402029454024,0.559311224489796,42.22222222222223,8252.853199896841,111.5250432418492,0
2259,31.953207341584726,0,0,193,0.0,0.0,1.0,193,5850,4200,1650,0.717948717948718,75,42,33,196.8230440083038,0.4723672729562464,0.7582337823381622,0.12042099265678445,1062269.3863289468,-2634.1811651805606,1059635.2051637662,2223,1,478.8445595854922,73,120,51,37.070094988535885,0.5601791882556131,42.14527027027029,8239.285643062387,112.86692661729298,0
2260,31.607110127369356,4,4,193,0.02030456852791878,0.02030456852791878,0.9796954314720813,197,6100,4300,1800,0.7049180327868853,79,43,36,189.90471575826402,0.4730265202527712,0.7530406163053016,0.1172300966393175,1053392.3846789482,-5491.16372112466,1047901.2209578236,2224,0,470.1015228426396,79,118,44,36.920012104095235,0.5626586294416244,41.822916666666686,8160.231505279728,103.29406968708516,0
2261,31.721732207814973,0,0,193,0.0,0.0,1.0,193,5800,4200,1600,0.7241379310344828,74,42,32,196.75880793373483,0.4721367659758204,0.7584606129483131,0.12132117111555063,1056872.3399187883,-2810.2116518882995,1054062.1282669,2225,1,480.8238341968912,78,115,44,36.785407195518566,0.5630936960276338,41.864451476793256,8188.50674357061,104.98085568680268,0
2262,32.10107846536746,0,2,191,0.0,0.010362694300518135,0.9896373056994818,193,6300,4100,2200,0.6507936507936508,85,41,44,208.49517792523633,0.4718444156591825,0.7731186439835309,0.12499715700541718,1061058.536354612,-654.8823347309208,1060403.6540198813,2226,2,481.8238341968912,75,118,40,37.52582093928248,0.5544041450777202,42.88651315789473,8253.620215622634,110.04826954163512,8
2263,31.704283835809978,0,0,191,0.0,0.0,1.0,191,5950,4100,1850,0.6890756302521008,78,41,37,207.99973227883982,0.4713373748507394,0.7703259895398087,0.12512226856318076,1048954.60723686,-513.5445044153848,1048441.0627324447,2227,3,487.3979057591623,76,115,40,37.41191164869837,0.5565008726003491,42.76244588744589,8155.532428813958,107.30963722123629,0
2264,32.04538112463156,1,1,191,0.005208333333333333,0.005208333333333333,0.9947916666666666,192,6550,4000,2550,0.6106870229007634,91,40,51,209.0489009722073,0.4711013625290867,0.7743316749190639,0.12292449932867361,1053318.1736407785,-910.9986852687289,1052407.1749555098,2228,0,485.8541666666667,63,129,43,38.24357529782685,0.54736328125,43.60351562499998,8216.323060812472,130.41782636210274,8
2265,32.52091151286261,3,2,192,0.015463917525773196,0.010309278350515464,0.9896907216494846,194,6300,4600,1700,0.7301587301587301,80,46,34,208.10433007993015,0.47133566582981673,0.7707707812795239,0.12021085419911365,1063391.6379709884,-840.7191134891605,1062550.9188574993,2229,0,481.80927835051546,73,121,42,38.94899864222678,0.540270618556701,44.270833333333364,8316.545600424839,113.92528219760054,8
2266,32.977805582529975,4,1,195,0.02040816326530612,0.00510204081632653,0.9948979591836735,196,6200,4300,1900,0.6935483870967742,81,43,38,217.71963209671148,0.4721824306645735,0.7751999796254332,0.12256736597946692,1070075.9613531847,1195.3089242700007,1071271.2702774548,2230,0,476.68367346938777,76,120,39,39.70525109305575,0.529921343537415,45.25162337662337,8401.042436750826,110.54003206251086,8
2267,32.88480711450946,3,5,193,0.015151515151515152,0.025252525252525252,0.9747474747474747,198,5800,3600,2200,0.6206896551724138,80,36,44,213.85146183407863,0.47285086482421507,0.7739819128583529,0.12140015556026135,1069742.6021603826,353.20385163752326,1070095.80601202,2231,0,472.84343434343435,81,117,37,39.47672319338614,0.532354797979798,44.931402439024374,8387.881631761074,103.55409421927253,0
2268,33.098737057328684,2,0,195,0.010256410256410256,0.0,1.0,195,6700,4900,1800,0.7313432835820896,85,49,36,232.47136956252245,0.4724876641113755,0.7896913499629972,0.13397811807468313,1081551.1593915732,4585.935855138757,1086137.095246712,2232,0,479.62051282051283,71,124,36,38.41468590831921,0.5409722222222222,44.3576388888889,8461.439291131357,119.17520128354025,8
2269,33.27451737351053,4,4,195,0.020100502512562814,0.020100502512562814,0.9798994974874372,199,6850,5100,1750,0.7445255474452555,86,51,35,223.38761726941135,0.4729920647006074,0.7848390712167128,0.13009682254827384,1090648.831819712,2077.488763574678,1092726.3205832867,2233,0,470.95979899497485,77,122,35,38.24414076083178,0.5443886097152428,43.96367521367523,8519.485137352392,110.64266412145965,0
2270,33.48241135236456,1,1,195,0.00510204081632653,0.00510204081632653,0.9948979591836735,196,6700,4500,2200,0.6716417910447762,89,45,44,220.40485510455508,0.4726648351648352,0.7801068107400908,0.12914569614683657,1099423.2561591906,2563.6446944686895,1101986.9008536593,2234,0,478.7857142857143,69,127,39,38.08691665214952,0.5464498299319728,43.73511904761903,8580.366159212312,124.35313274220742,0
2271,33.62982094495856,3,1,197,0.015151515151515152,0.005050505050505051,0.9949494949494949,198,6850,4800,2050,0.7007299270072993,89,48,41,218.65997132126736,0.472355748688236,0.7805848798742601,0.12902029788676783,1106505.456786705,1939.6902895611838,1108445.1470762661,2235,0,474.92424242424244,71,127,41,37.86594335720864,0.5484006734006734,43.47511574074072,8626.885925565059,121.50543557133885,0
2272,33.82246173137209,2,3,196,0.010050251256281407,0.01507537688442211,0.9849246231155779,199,6250,4300,1950,0.688,82,43,39,212.9664140356277,0.4725373500499129,0.7770952042904822,0.12722594474361498,1116822.33661203,1519.1296286307197,1118341.4662406608,2236,0,473.22613065326635,80,119,38,37.544099984987234,0.5555904522613065,43.01697530864195,8691.798518235644,108.64748147794555,7
2273,33.58773322076412,0,5,191,0.0,0.025510204081632654,0.9744897959183674,196,6100,4300,1800,0.7049180327868853,79,43,36,213.84138889649597,0.471947496947497,0.7759374157826404,0.12815099061207205,1110070.8074618317,2175.8166482182387,1112246.62411005,2237,1,481.4591836734694,80,116,41,37.403398859543785,0.5570790816326531,42.90123456790121,8635.364744721091,107.94205930901364,0
2274,33.27676409094641,0,2,189,0.0,0.010471204188481676,0.9895287958115183,191,5300,3900,1400,0.7358490566037735,67,39,28,216.12863989889587,0.4707678883071553,0.7742409633256608,0.13006730783807133,1101113.9890061237,4096.453763508043,1105210.4427696317,2238,2,494.3193717277487,80,111,43,37.18693761247751,0.5589005235602094,42.7469135802469,8560.550268457926,107.00687835572407,0
2275,33.21415988953042,2,3,188,0.010471204188481676,0.015706806282722512,0.9842931937172775,191,6150,4200,1950,0.6829268292682927,81,42,39,215.47651834479342,0.4705899237622853,0.773861623384579,0.13060669526993554,1101280.4697855192,3110.0162701005916,1104390.4860556198,2239,0,482.7696335078534,69,122,44,36.936278050659745,0.56206369982548,42.48511904761906,8553.1404298858,123.95855695486667,0
2276,33.278744216772495,1,1,188,0.005291005291005291,0.005291005291005291,0.9947089947089947,189,5250,3600,1650,0.6857142857142857,69,36,33,211.9396044022184,0.4695919640511839,0.7676145882296219,0.12886632456035188,1104401.0062282041,3763.262472283595,1108164.2687004877,2240,0,488.5608465608466,70,119,47,36.910710895975704,0.5642085537918871,42.37089201877935,8573.573187302321,122.47961696146173,0
2277,32.77255067790454,1,1,188,0.005291005291005291,0.005291005291005291,0.9947089947089947,189,6100,4300,1800,0.7049180327868853,79,43,36,239.00657414170973,0.4697690344853465,0.7938795938795951,0.1426329555361814,1081829.23124159,7812.85967308231,1089642.0909146725,2241,0,489.5132275132275,74,115,34,36.91441441441441,0.5543981481481481,43.05555555555555,8420.724826961567,113.79357874272387,8
2278,33.08462145716764,0,1,187,0.0,0.005319148936170213,0.9946808510638298,188,6250,4500,1750,0.72,80,45,35,235.95593053535734,0.46973134031175334,0.7910921328992344,0.1413652743976645,1093357.7844420073,7746.850687217942,1101104.6351292252,2242,1,493.11170212765956,76,112,36,36.84509401529504,0.5558510638297872,42.911255411255404,8505.683795617048,111.91689204759273,0
2279,33.529927938572605,1,2,186,0.005319148936170213,0.010638297872340425,0.9893617021276596,188,6150,3900,2250,0.6341463414634146,84,39,45,236.6493996881482,0.469478301475329,0.7935415607211405,0.14276012623047804,1110251.8453093155,8798.086539021602,1119049.9318483372,2243,0,493.8936170212766,62,126,40,36.56876445643792,0.5576795212765957,42.65873015873015,8628.634233398534,139.17151989352473,0
2280,33.679514983448016,0,2,184,0.0,0.010752688172043012,0.989247311827957,186,6250,4600,1650,0.736,79,46,33,232.04119729216265,0.4686313329458491,0.7867146277284534,0.14069922765574938,1116827.5609103527,8380.000880504751,1125207.5617908575,2244,1,499.8440860215054,65,121,40,36.495870870870874,0.5591957885304659,42.47159090909091,8673.431912640797,133.43741404062766,0
2281,33.36388802777242,1,1,184,0.005405405405405406,0.005405405405405406,0.9945945945945946,185,5450,3700,1750,0.6788990825688074,72,37,35,228.5708246624668,0.46819672933803363,0.7816049777412208,0.13927008269817742,1107881.3656691439,8195.871475835189,1116077.237144979,2245,0,503.22162162162164,67,118,43,36.404339792744096,0.5613738738738738,42.294730392156865,8598.04975936298,128.32910088601463,0
2282,32.89121921692981,1,1,184,0.005405405405405406,0.005405405405405406,0.9945945945945946,185,6250,4500,1750,0.72,80,45,35,227.3544343344358,0.4676765080297689,0.7802331247191931,0.13931575165600854,1093927.2845553833,6491.843796619125,1100419.1283520025,2246,0,503.76216216216216,68,117,41,36.225659486459065,0.5632882882882884,42.08937198067635,8482.995004559656,124.749926537642,0
2283,33.01847299357389,2,0,186,0.010752688172043012,0.0,1.0,186,6700,4900,1800,0.7313432835820896,85,49,36,222.0594957248913,0.46790782718202073,0.7770885479971867,0.13697776966359937,1100201.884171422,4962.055118936651,1105163.9392903587,2247,0,501.8817204301075,73,113,37,36.1171887780141,0.5655241935483871,41.84966216216219,8523.72995818069,116.76342408466698,0
2284,33.115608977648655,0,3,183,0.0,0.016129032258064516,0.9838709677419355,186,5600,4100,1500,0.7321428571428571,71,41,30,225.58705640397466,0.4674337644095709,0.7803922000161392,0.14005160224879842,1105414.8100117024,7073.454619179976,1112488.2646308823,2248,1,502.8817204301075,64,122,38,35.78983956666462,0.5672603046594982,41.61858974358976,8556.457749144729,133.6946523303864,0
2285,33.11440190193855,2,1,184,0.010810810810810811,0.005405405405405406,0.9945945945945946,185,5250,3500,1750,0.6666666666666666,70,35,35,218.52151293236807,0.46728481198589894,0.7711662619202746,0.1365901037703508,1107454.4413908068,6150.524007277968,1113604.9653980848,2249,0,505.92432432432435,67,118,41,35.72411350668325,0.5692567567567568,41.375612745098046,8564.191901201431,127.82375971942434,0
2286,32.649837767503584,1,0,185,0.005405405405405406,0.0,1.0,185,6050,4500,1550,0.743801652892562,76,45,31,219.62986437068096,0.467219937328633,0.7723379023396262,0.1378254677568308,1093104.5470192018,4965.680680960553,1098070.2277001624,2250,0,506.8864864864865,69,116,41,35.55186947687235,0.5707207207207208,41.23511904761906,8448.63138302264,122.44393308728465,0
2287,33.100342029176055,1,0,186,0.005376344086021506,0.0,1.0,186,5400,3400,2000,0.6296296296296297,74,34,40,215.78571766457446,0.4668168168168168,0.7678547192880454,0.1358903254282674,1109257.823812233,5272.399117273557,1114530.2229295066,2251,0,505.1559139784946,72,114,42,35.52368682136363,0.5721326164874552,41.11015981735161,8569.34225792441,119.01864247117237,0
2288,32.811827283227586,0,1,185,0.0,0.005376344086021506,0.9946236559139785,186,5500,3600,1900,0.6545454545454545,74,36,38,219.72179891576184,0.466453550324518,0.7720333818239258,0.13885434862690793,1100643.127592074,5667.057591760375,1106310.1851838343,2252,1,506.1559139784946,74,112,35,35.29501135002771,0.5738127240143369,40.98611111111112,8498.718986179349,114.8475538672885,0
2289,32.81774481889194,2,2,185,0.0106951871657754,0.0106951871657754,0.9893048128342246,187,6250,4900,1350,0.784,76,49,27,224.8783705760403,0.4664481628428498,0.7787483878051624,0.14326137712242384,1103256.6007182335,5969.70933935569,1109226.310057589,2253,0,504.03743315508024,80,107,38,34.871112929623585,0.5764260249554367,40.70216049382717,8509.570329003605,106.36962911254507,0
2290,32.60923505979134,0,4,181,0.0,0.021621621621621623,0.9783783783783784,185,6600,5100,1500,0.7727272727272727,81,51,30,227.5133946686052,0.4658122796709753,0.779770728112128,0.1458944713276117,1098195.5485458414,6370.839451922964,1104566.3879977644,2254,1,510.1945945945946,67,118,37,34.56719985834018,0.5787162162162163,40.471813725490186,8463.015630866783,126.31366613234005,0
2291,32.54397323987207,0,0,181,0.0,0.0,1.0,181,5100,3700,1400,0.7254901960784313,65,37,28,231.1607252715302,0.4645142725598527,0.7784918420517757,0.14831986449825585,1096170.2140969322,9378.300342338847,1105548.514439271,2255,2,521.9779005524862,65,116,38,34.45164437012263,0.5795925414364641,40.45138888888887,8446.743054445924,129.9498931453219,0
2292,32.20634894174887,0,3,178,0.0,0.016574585635359115,0.9834254143646409,181,5800,4100,1700,0.7068965517241379,75,41,34,230.8908454282579,0.4644260282381829,0.7787160153822912,0.14848140763466888,1085457.8549050877,8124.456359155589,1093582.3112642432,2256,3,522.9779005524862,65,116,39,34.377912867274546,0.5808586556169428,40.37247474747473,8361.654673165514,128.6408411256233,0
2293,31.914200406639544,0,1,177,0.0,0.0056179775280898875,0.9943820224719101,178,6000,4300,1700,0.7166666666666667,77,43,34,228.32920350369255,0.46405843331428936,0.7726185479357708,0.14714548670237917,1076224.4726124026,7546.695324554102,1083771.1679369567,2257,4,521.5337078651686,66,112,36,34.36876396871008,0.5827481273408239,40.29850746268655,8288.16547873919,125.57826482938168,0
2294,31.48731566068809,0,3,174,0.0,0.01694915254237288,0.9830508474576272,177,5850,4100,1750,0.7008547008547008,76,41,35,230.2476094253119,0.46375165853449757,0.772965104068216,0.14924483598893712,1063480.4305925693,7722.7653629080705,1071203.1959554774,2258,5,524.6949152542373,68,109,41,34.112405127013616,0.5845103578154426,40.09661835748792,8183.65981905806,120.3479385155597,0
2295,31.702696442916967,0,1,173,0.0,0.005747126436781609,0.9942528735632183,174,5600,3700,1900,0.6607142857142857,75,37,38,225.71054656939617,0.4629821108232011,0.758269967906732,0.13742012980277007,1052488.3993420387,7111.5463746881505,1059599.9457167268,2259,6,531.3275862068965,72,102,39,36.50701904972863,0.5622006704980843,42.323059360730596,8169.053829426301,113.45908096425417,8
2296,31.889731822324897,3,2,174,0.017045454545454544,0.011363636363636364,0.9886363636363636,176,6000,4200,1800,0.7,78,42,36,224.2816742849346,0.4637141504329005,0.7578129043946382,0.13777099095423326,1061349.6594559692,6408.255724905848,1067757.915180875,2260,0,526.2386363636364,77,99,35,36.21407897234155,0.5649266098484849,42.00053418803417,8227.533775046635,106.85108798761864,0
2297,31.602086142951205,0,0,174,0.0,0.0,1.0,174,5750,4400,1350,0.7652173913043478,71,44,27,234.67825018961327,0.4630990742586318,0.7740699764412293,0.14127760997993025,1045798.8648328008,8535.249529849076,1054334.1143626499,2261,1,533.051724137931,78,96,38,36.697247706422,0.5580699233716475,42.734704641350206,8130.120025515824,104.23230801943363,8
2298,31.13935220680559,0,1,173,0.0,0.005747126436781609,0.9942528735632183,174,5150,3800,1350,0.7378640776699029,65,38,27,232.22784093656776,0.46280424335038645,0.7715898307850191,0.1403327156178762,1031595.9816976923,7963.061509698822,1039559.0432073912,2262,2,534.051724137931,64,110,38,36.61851990204626,0.5592672413793103,42.59615384615385,8015.389024771013,125.24045351204708,0
2299,31.163279313249003,1,0,174,0.005747126436781609,0.0,1.0,174,5150,3100,2050,0.6019417475728155,72,31,41,230.18997841795942,0.4617709509888601,0.7712280390492006,0.14012235598999245,1034528.3672748627,7677.612507153368,1042205.9797820161,2263,0,535.0344827586207,65,109,35,36.39822981746908,0.5608836206896552,42.329545454545446,8029.856345771812,123.53625147341249,0
2300,31.510916312032766,1,1,174,0.005714285714285714,0.005714285714285714,0.9942857142857143,175,5750,4100,1650,0.7130434782608696,74,41,33,210.02028731690706,0.4621004378762999,0.7536660484554516,0.12548878030872995,1040549.1226285077,2957.285140359097,1043506.4077688667,2264,0,532.9714285714285,68,107,41,37.61295991697511,0.5547619047619048,43.0102657004831,8097.982010563632,119.08797074358282,8
2301,31.89121831200303,0,0,174,0.0,0.0,1.0,174,6450,4800,1650,0.7441860465116279,81,48,33,209.57463478860316,0.46215229331384405,0.7518087557137234,0.12578908840694458,1054468.845947622,2947.984657086825,1057416.830604709,2265,1,536.6494252873563,68,106,43,37.45486967241987,0.5562739463601533,42.84420289855075,8201.011665559527,120.60311272881657,0
2302,31.62789365459981,2,0,176,0.011363636363636364,0.0,1.0,176,5050,3200,1850,0.6336633663366337,69,32,37,201.89627864273754,0.46277259199134196,0.7420866386192579,0.11722271794941672,1035749.7804194522,1572.8052543437757,1037322.585673796,2266,0,531.5397727272727,72,104,39,38.91123036892483,0.5464607007575757,44.07819634703195,8094.267589829407,112.4203831920751,8
2303,31.95750687044867,3,0,179,0.01675977653631285,0.0,1.0,179,5300,3700,1600,0.6981132075471698,69,37,32,200.19409009532245,0.4638270771870358,0.742805606046792,0.11730533903452493,1049357.1863751407,915.0214222715699,1050272.2077974123,2267,0,523.6145251396648,66,113,43,38.60416793059515,0.5488826815642458,43.73445273631839,8189.607987338355,124.0849695051266,0
2304,31.64213340671748,1,1,179,0.005555555555555556,0.005555555555555556,0.9944444444444445,180,6050,4100,1950,0.6776859504132231,80,41,39,241.2410384222684,0.46404213221601487,0.7714474410535441,0.1376148271809622,1030812.3006560728,7684.845965743806,1038497.1466218166,2268,0,521.7,68,112,36,38.588611899692474,0.5387152777777777,44.74637681159421,8076.769197475546,118.7760176099345,8
2305,32.05828372156396,3,2,180,0.016483516483516484,0.01098901098901099,0.989010989010989,182,5800,4000,1800,0.6896551724137931,76,40,36,252.98450686803704,0.463851238540465,0.7808255838747415,0.14619179888546313,1048382.921190597,10844.92726525541,1059227.8484558524,2269,0,516.945054945055,71,111,37,37.78644802096887,0.5419528388278388,44.25636574074076,8198.70198706727,115.4746758741869,0
2306,32.03216841408146,2,1,181,0.01098901098901099,0.005494505494505495,0.9945054945054945,182,5200,3800,1400,0.7307692307692307,66,38,28,248.95197848217228,0.46418009936656346,0.7930698192935026,0.1414428279071503,1042263.7403697275,10294.724053054462,1052558.464422782,2270,0,516.6373626373627,76,106,36,38.549124109526076,0.5324519230769231,44.89989177489177,8171.409629117066,107.51854775154034,8
2307,31.59260377715929,7,4,184,0.03723404255319149,0.02127659574468085,0.9787234042553191,188,6700,5100,1600,0.7611940298507462,83,51,32,253.30996699371047,0.4660157583342815,0.7953626567492085,0.14742234783086816,1035312.9662656913,8151.018662584775,1043463.9849282762,2271,0,499.25,73,115,36,37.50429565073952,0.5410017730496454,43.989301801801815,8088.044550889616,110.79513083410433,8
2308,31.810481864282714,4,0,188,0.02127659574468085,0.0,1.0,188,6000,4400,1600,0.7333333333333333,76,44,32,254.47815453764122,0.46664687393332577,0.7960128005535363,0.14905149051490504,1044402.7346456952,9555.536101340818,1053958.270747036,2272,0,499.77659574468083,79,109,40,37.22899728997293,0.5432734929078014,43.75000000000002,8151.435977722499,103.1827338952215,0
2309,31.911236380705052,2,1,189,0.010526315789473684,0.005263157894736842,0.9947368421052631,190,5850,3900,1950,0.6666666666666666,78,39,39,257.71593116159266,0.4676535087719298,0.7984073510741276,0.15219416132208533,1050217.4939885847,10281.555877092267,1060499.049865677,2273,0,495.5052631578947,67,123,43,36.8317610062893,0.5454495614035088,43.44362745098038,8187.031049387964,122.19449327444723,0
2310,32.109029320105556,1,1,189,0.005263157894736842,0.005263157894736842,0.9947368421052631,190,6100,4300,1800,0.7049180327868853,79,43,36,256.6092116434238,0.46779912744825025,0.7970984808154451,0.1522687214156751,1058192.0144318668,10208.363718145403,1068400.378150012,2274,0,496.0315789473684,70,120,41,36.67781016058059,0.5472587719298245,43.26584507042252,8243.484508106296,117.76406440151851,0
2311,32.432580051650916,0,4,185,0.0,0.021164021164021163,0.9788359788359788,189,6450,4600,1850,0.7131782945736435,83,46,37,243.43626882428953,0.4674307666328943,0.7813500763438248,0.13982194934625272,1058718.560700473,7296.099230389279,1066014.6599308623,2275,1,499.1746031746032,74,115,38,38.26597633672161,0.5383046737213404,44.48611111111113,8286.974655697566,111.98614399591305,8
2312,32.383243033536374,3,0,188,0.015957446808510637,0.0,1.0,188,5450,3700,1750,0.6788990825688074,72,37,35,226.81316324978144,0.4669562094663784,0.7752202003124691,0.12969296292112287,1055704.4410002385,4839.532744021416,1060543.97374426,2276,0,497.3829787234043,68,120,36,38.86425446375787,0.5386192375886525,44.65579710144929,8268.873379668417,121.60107911277085,8
2313,31.896950923861365,1,1,188,0.005291005291005291,0.005291005291005291,0.9947089947089947,189,6050,4200,1850,0.6942148760330579,79,42,37,229.86378932305598,0.4673158467484709,0.7774354661771858,0.13232334851646974,1041927.0993086891,4050.26224909542,1045977.3615577845,2277,0,495.74603174603175,71,118,38,38.52574715571405,0.5403439153439153,44.40104166666669,8152.82743014848,114.82855535420394,0
2314,31.828132073036752,1,0,189,0.005291005291005291,0.0,1.0,189,6250,4600,1650,0.736,79,46,33,258.78389147675273,0.4673135014447071,0.8121403339143107,0.14924932292719398,1040252.2328267258,9790.104185656452,1050042.3370123822,2278,0,496.5820105820106,60,129,33,37.71428889482589,0.5378637566137566,44.33060109289619,8137.479395449248,135.6246565908208,8
2315,31.342089776116275,3,6,186,0.015625,0.03125,0.96875,192,5250,3900,1350,0.7428571428571429,66,39,27,251.30346981942972,0.46796545502472364,0.8088367849018003,0.14600100823885537,1026580.462338598,7946.646446905161,1034527.1087855032,2279,0,489.8072916666667,64,128,33,37.62248763383634,0.5399848090277778,44.054487179487204,8021.86724061468,125.34167563460437,0
2316,31.481648387361638,3,0,189,0.015873015873015872,0.0,1.0,189,5850,4400,1450,0.7521367521367521,73,44,29,227.91619660125383,0.4682516229502045,0.784666704490733,0.13254416486069226,1031449.9843997674,3366.83148576405,1034816.8158855314,2280,0,487.2857142857143,73,116,36,38.18319814865736,0.5395171957671958,44.017454954955,8058.752476410171,110.39386953986535,8
2317,31.044020989523315,1,4,186,0.005263157894736842,0.021052631578947368,0.9789473684210527,190,5350,3400,1950,0.6355140186915887,73,34,39,230.22941112648218,0.4682046551564096,0.789104784432991,0.1345524607240147,1018584.1756502867,3551.606988544215,1022135.782638831,2281,0,485.7157894736842,75,115,38,37.93450151596221,0.541063596491228,43.832236842105296,7952.477416312995,106.0330322175066,0
2318,31.027769678459432,3,0,189,0.015873015873015872,0.0,1.0,189,6450,4600,1850,0.7131782945736435,83,46,37,222.5867957453551,0.4683794420053285,0.7814069860254484,0.13129994790856644,1020807.2290121777,1193.6420359029971,1022000.8710480806,2282,0,488.22222222222223,66,123,42,37.77602682990888,0.5432649911816578,43.485696517412926,7959.066727688134,120.59192011648688,0
2319,30.73465329430473,2,4,187,0.010471204188481676,0.020942408376963352,0.9790575916230366,191,5550,4100,1450,0.7387387387387387,70,41,29,227.6052490952411,0.468682832736291,0.7845974883438551,0.12978640179414505,1001134.1857472399,1822.6791449525626,1002956.8648921924,2283,0,484.0994764397906,67,124,37,38.951656463809854,0.5327770506108203,44.76102941176472,7844.681268224682,117.08479504812958,8
2320,31.13880438673548,4,5,186,0.020942408376963352,0.02617801047120419,0.9738219895287958,191,5400,3600,1800,0.6666666666666666,72,36,36,218.80905718910597,0.468907871773675,0.7758820940304081,0.12603683120532666,1017346.490010911,920.9252627869196,1018267.4152736979,2284,0,481.26178010471205,72,119,42,38.78460980238922,0.5360493019197208,44.377853881278554,7959.768004908412,110.55233340150572,0
2321,31.10533851430786,2,5,183,0.010638297872340425,0.026595744680851064,0.973404255319149,188,6600,4400,2200,0.6666666666666666,88,44,44,215.95719848486328,0.46844481264459364,0.7686430106036437,0.1250921885563273,1017933.0033454945,-234.00807044443718,1017698.99527505,2285,0,484.1063829787234,74,114,35,38.64176167209556,0.5386192375886525,44.16666666666669,7957.782436577157,107.5376004942859,0
2322,30.693921874530275,2,2,183,0.010810810810810811,0.010810810810810811,0.9891891891891892,185,5500,4000,1500,0.7272727272727273,70,40,30,233.77806765365108,0.4682481394437916,0.7804712897951331,0.13085983468262197,994252.9328195541,3986.905878706325,998239.8386982605,2286,0,491.4216216216216,68,117,38,39.52068505338082,0.5246621621621621,45.47101449275364,7812.492795962902,114.88959994063092,8
2323,30.372875877263763,2,0,185,0.010810810810810811,0.0,1.0,185,6550,4500,2050,0.6870229007633588,86,45,41,235.10428762822863,0.46919188209949075,0.7880855347799642,0.12867103604952326,977094.3562123654,2393.8145125741285,979488.1707249396,2287,0,491.15675675675675,70,115,41,40.38333622534559,0.5179054054054054,46.34683098591549,7704.176218339387,110.05966026199124,8
2324,30.89486108550607,6,4,187,0.031413612565445025,0.020942408376963352,0.9790575916230366,191,5950,4500,1450,0.7563025210084033,74,45,29,225.00635308630493,0.47067833195554326,0.7871306716898958,0.12465083716109646,997608.0279268278,743.6288346873794,998351.6567615152,2288,0,476.69633507853405,79,112,38,40.15436329012313,0.5214332460732984,45.87239583333334,7851.237028721666,99.38274719900843,0
2325,30.899735037251368,1,1,187,0.005319148936170213,0.005319148936170213,0.9946808510638298,188,5650,3800,1850,0.672566371681416,75,38,37,227.18239362844517,0.4701680841582281,0.7861130029694603,0.1261944874991575,998583.5437274958,2122.119940397432,1000705.6636678933,2289,0,477.13829787234044,63,125,38,39.99253094323515,0.5228834219858156,45.76822916666666,7855.694356801196,124.6935612190666,0
2326,31.23026203042478,6,4,189,0.031088082901554404,0.02072538860103627,0.9792746113989638,193,6100,4500,1600,0.7377049180327869,77,45,32,217.95209096332144,0.47163527274035694,0.7828776137074276,0.12280008154465438,1013624.6306323003,-515.6784603532833,1013108.952171947,2290,0,465.61139896373055,72,121,36,39.666760011201376,0.5265004317789292,45.21974885844748,7956.854003328099,110.5118611573347,0
2327,31.192769509308697,2,2,189,0.010471204188481676,0.010471204188481676,0.9895287958115183,191,6650,4800,1850,0.7218045112781954,85,48,37,245.70560057380814,0.47110774317993936,0.8028005324460412,0.138334345223721,1012180.9612124093,4889.706192813829,1017070.6674052231,2291,0,469.91623036649213,72,119,35,38.98889542373831,0.5301592495636998,45.24828767123287,7946.41144477294,110.36682562184639,8
2328,31.151506775416582,3,2,190,0.015625,0.010416666666666666,0.9895833333333334,192,5800,4000,1800,0.6896551724137931,76,40,36,241.57254461226432,0.4714723312972659,0.8028065008726013,0.1371592033916243,1013407.5263601696,4762.286974409273,1018169.8133345789,2292,0,468.4375,77,115,37,38.763307155322885,0.5325520833333333,44.92521367521367,7945.963934434503,103.19433681083771,0
2329,30.862285432136247,2,2,190,0.010416666666666666,0.010416666666666666,0.9895833333333334,192,6100,4200,1900,0.6885245901639344,80,42,38,232.3233796537344,0.4711280631908086,0.7965231265773633,0.1334111180152053,1007395.7912297775,2308.3189734902417,1009704.1102032678,2293,0,469.3020833333333,62,130,38,38.558046981168744,0.5353732638888888,44.49404761904764,7885.497631990805,127.18544567727105,0
2330,31.292001105992348,0,1,189,0.0,0.005263157894736842,0.9947368421052631,190,5250,3100,2150,0.5904761904761905,74,31,43,239.29689688690655,0.47077299730808503,0.7929772693322705,0.13672260541051934,1019888.3563113761,5561.22376728014,1025449.5800786562,2294,1,474.92105263157896,68,122,39,38.576405313781144,0.5368421052631579,44.68599033816426,7989.286272713523,117.489504010493,8
2331,31.61123583814264,3,4,188,0.015625,0.020833333333333332,0.9791666666666666,192,5800,3600,2200,0.6206896551724138,80,36,44,215.07705122865354,0.47137973113001747,0.7727678571428558,0.12254390128144288,1029440.3380992423,81.79846684296263,1029522.1365660853,2295,0,470.8697916666667,77,115,43,39.302721088435376,0.5378146701388888,44.791666666666686,8067.450812859369,104.7720884786931,8
2332,31.214503959857478,1,1,188,0.005291005291005291,0.005291005291005291,0.9947089947089947,189,6450,5100,1350,0.7906976744186046,78,51,27,213.78126191352763,0.47077634245187433,0.7689971734184982,0.12243572745609634,1018084.5242071246,-720.521136073131,1017364.0030710514,2296,0,476.4391534391534,68,121,42,39.135339086574476,0.5394069664902998,44.59541062801935,7972.3275663175245,117.24011126937536,0
2333,31.746091857609397,1,3,186,0.005291005291005291,0.015873015873015872,0.9841269841269842,189,5250,3400,1850,0.6476190476190476,71,34,37,224.1424378480243,0.4708842264250066,0.7721279458723009,0.1254757503156962,1028359.1148351325,3049.783796476303,1031408.8986316088,2297,0,477.41269841269843,76,113,35,39.76293294357338,0.533123897707231,45.46807359307357,8080.393916408502,106.3209725843224,8
2334,31.66123194664289,3,2,187,0.015873015873015872,0.010582010582010581,0.9894179894179894,189,5850,4100,1750,0.7008547008547008,76,41,35,220.40248087312247,0.4709909377462569,0.7692343798000425,0.12453888422188561,1028503.9666697833,1686.965168372999,1030190.9318381563,2298,0,478.30687830687833,81,108,35,39.491392557521365,0.5356040564373898,45.10924796747964,8070.155221155776,99.63154594019477,0
2335,32.08821696455136,4,1,190,0.020942408376963352,0.005235602094240838,0.9947643979057592,191,6250,4600,1650,0.736,79,46,33,216.978575089685,0.4718781574354735,0.7707857493217039,0.12377231454982991,1045339.1573301882,913.2401685915611,1046252.3974987798,2299,0,473.6806282722513,69,122,41,39.20858110340276,0.5384489528795812,44.74702380952383,8190.612880847508,118.70453450503635,0
2336,32.10213533749051,2,1,191,0.010416666666666666,0.005208333333333333,0.9947916666666666,192,5400,3300,2100,0.6111111111111112,75,33,42,218.11981158837344,0.47223472040430486,0.7699891692150858,0.12513189191122576,1047561.4103706513,1898.7794914598708,1049460.1898621111,2300,0,472.03125,71,121,41,38.95897043832824,0.5405815972222222,44.53125000000003,8201.092386999595,115.50834347886753,0
2337,31.84682004554404,6,4,193,0.030456852791878174,0.02030456852791878,0.9796954314720813,197,6000,4200,1800,0.7,78,42,36,202.42311634997537,0.4731236403190718,0.767319625591877,0.11674075300269145,1040853.9910605518,-3261.4182928425953,1037592.5727677093,2301,0,460.9593908629442,76,121,42,39.15639275446673,0.539498730964467,44.33170995670997,8142.222024360653,107.13450032053491,8
2338,32.072196522911405,4,3,194,0.02030456852791878,0.015228426395939087,0.9847715736040609,197,6050,4400,1650,0.7272727272727273,77,44,33,197.97351208360078,0.47309989985842055,0.7624980772188878,0.11502768676447216,1050521.3614454952,-3854.9193111577197,1046666.4421343374,2302,0,461.9035532994924,82,115,38,38.9840966297277,0.541825296108291,44.051204819277125,8208.840058838587,100.10780559559252,0
2339,32.04049547186098,1,2,193,0.005128205128205128,0.010256410256410256,0.9897435897435898,195,5900,4000,1900,0.6779661016949152,78,40,38,201.6460836133179,0.47243699885452467,0.7648649542133608,0.11786651948249821,1051328.8507386958,-2500.7309317699946,1048828.1198069258,2303,0,467.6102564102564,81,114,41,38.660575556216706,0.5435363247863247,43.82621951219514,8207.934853729064,101.33252905838351,0
2340,32.07451619547193,3,0,196,0.015306122448979591,0.0,1.0,196,5950,3600,2350,0.6050420168067226,83,36,47,198.69756894372327,0.47290521978021977,0.763005898561955,0.11714259661607569,1055073.8719426778,-3221.87731778973,1051851.994624888,2304,0,465.5204081632653,76,120,44,38.410029887482416,0.5462903911564626,43.506493506493506,8226.90512805936,108.24875168499157,0
2341,32.106033556673886,1,1,196,0.005076142131979695,0.005076142131979695,0.9949238578680203,197,6550,4600,1950,0.7022900763358778,85,46,39,189.97190912208578,0.4728441503504955,0.757934504333166,0.10810071385162455,1045152.131064019,-6240.090867750454,1038912.0401962686,2305,0,464.1522842639594,84,113,41,39.993376078638555,0.534845600676819,44.8406862745098,8192.15348876845,97.52563677105297,8
2342,31.668276694939998,3,2,197,0.01507537688442211,0.010050251256281407,0.9899497487437185,199,6300,4900,1400,0.7777777777777778,77,49,28,211.6455022267018,0.4731401113310661,0.7703863592731319,0.121740821709083,1034218.4782108036,-2322.462153387489,1031896.0160574161,2306,0,460.2462311557789,74,125,42,39.021543213231176,0.5376360971524288,44.43055555555558,8093.4438814388195,109.37086326268675,0
2343,31.392289962689304,0,3,194,0.0,0.015228426395939087,0.9847715736040609,197,6450,5000,1450,0.7751937984496124,79,50,29,212.0912786930492,0.4726348026520253,0.7692934089624335,0.12220310283917463,1025717.0982142893,-2340.869812481207,1023376.2284018081,2307,1,465.53807106598987,75,122,44,38.9450185870284,0.5388642131979695,44.366776315789494,8024.912281991802,106.99883042655736,0
2344,31.31139715361784,6,2,198,0.03,0.01,0.99,200,5800,4200,1600,0.7241379310344828,74,42,32,208.96466094455647,0.4730553810720268,0.771476252804788,0.12200251165190926,1027056.320710492,-2876.3048343536275,1024180.0158761383,2308,0,455.1,86,114,43,38.517514335577175,0.5432812499999999,43.86973180076629,8019.796550648869,93.25344826335895,0
2345,31.83571261592918,0,3,195,0.0,0.015151515151515152,0.9848484848484849,198,6150,4200,1950,0.6829268292682927,81,42,39,210.1608205189817,0.472297531149054,0.7713242406059331,0.12314322865455464,1045352.5123387268,-1811.5716550632224,1043540.9406836636,2309,1,460.5,69,129,44,38.34943528250394,0.5449810606060606,43.73511904761902,8158.375103555245,118.23732034138037,0
2346,31.55903811440594,2,1,196,0.01015228426395939,0.005076142131979695,0.9949238578680203,197,6200,4200,2000,0.6774193548387096,82,42,40,207.0311313305587,0.47209740495182845,0.7673024535641226,0.1222062590130969,1038488.6361678803,-2600.1045560474186,1035888.5316118328,2310,0,463.74619289340103,71,126,44,38.14948492367848,0.547271573604061,43.46064814814811,8096.135182937499,114.03007299911971,0
2347,31.338139100496885,1,0,197,0.005076142131979695,0.0,1.0,197,6050,4700,1350,0.7768595041322314,74,47,27,220.67451558209885,0.47228193307779964,0.780868179835172,0.12920603999004462,1028787.5214939524,-44.56241148245681,1028742.9590824699,2311,0,464.66497461928935,77,120,37,38.1088649432776,0.5423011844331641,43.76335470085473,8029.97963302936,104.28544977960208,6
2348,31.816940731372952,1,2,196,0.005050505050505051,0.010101010101010102,0.98989898989899,198,6850,5100,1750,0.7445255474452555,86,51,35,221.73426814154737,0.4724299894033397,0.7832047179873274,0.13072952766767834,1046614.0546750947,-35.959711992129996,1046578.0949631025,2312,0,463.3131313131313,67,131,37,37.81752667622236,0.5447706228956228,43.50490196078431,8160.889332201407,121.80431839106578,0
2349,31.833543105403702,1,5,192,0.005076142131979695,0.025380710659898477,0.9746192893401016,197,5450,3300,2150,0.6055045871559633,76,33,43,245.81778553607913,0.47227437929486515,0.8055405649605507,0.14439933971159274,1046047.8413569023,6577.432785429968,1052625.2741423321,2313,0,466.492385786802,66,131,36,37.33941314411628,0.5476945854483926,43.641169154228855,8160.809892179751,123.64863472999623,8
2350,31.831689346056105,0,1,191,0.0,0.005208333333333333,0.9947916666666666,192,6150,4300,1850,0.6991869918699187,80,43,37,245.71075824996083,0.4716546911358348,0.7995367214842308,0.14501224791068415,1047406.549674415,6921.811503295351,1054328.3611777104,2314,1,477.3697916666667,69,123,35,37.163976545429925,0.5497504340277778,43.46726190476191,8165.870426140808,118.34594820493925,0
2351,32.33135785052281,1,4,188,0.005208333333333333,0.020833333333333332,0.9791666666666666,192,5150,3400,1750,0.6601941747572816,69,34,35,241.98785156056633,0.4715444798938336,0.7959965208287012,0.1433754108653317,1065053.7363582915,7996.013091579434,1073049.749449871,2315,0,478.2291666666667,72,120,34,37.11062004299165,0.5513780381944444,43.32191780821918,8298.75092772838,115.26042955178306,0
2352,32.20086869267656,1,0,189,0.005291005291005291,0.0,1.0,189,5200,3900,1300,0.75,65,39,26,240.47865841401742,0.47115510900971896,0.7913253376725284,0.14310351159162527,1062088.6408688503,8081.930294581711,1070170.571163432,2316,0,479.5026455026455,75,114,39,36.98419739580554,0.5531305114638447,43.16063596491229,8270.45063640443,110.27267515205907,0
2353,32.655792630766356,0,4,185,0.0,0.021164021164021163,0.9788359788359788,189,5650,4400,1250,0.7787610619469026,69,44,25,245.90279661822152,0.471054260947878,0.7972074390497734,0.14729237559648192,1079118.576063186,9621.65514732238,1088740.2312105084,2317,1,480.5026455026455,78,111,33,36.59761758219217,0.5550044091710759,42.91930379746837,8395.173904562962,107.63043467388412,0
2354,32.699387773837294,0,2,183,0.0,0.010810810810810811,0.9891891891891892,185,5750,4200,1550,0.7304347826086957,73,42,31,250.13433319417737,0.47040124363493924,0.7974705059450835,0.1498497066858649,1080606.0239705949,11309.33345029892,1091915.3574208939,2318,2,490.5891891891892,70,115,39,36.48312218227472,0.5552927927927929,42.91373239436618,8406.56355576508,120.09376508235829,8
2355,32.17996225800353,1,2,182,0.005434782608695652,0.010869565217391304,0.9891304347826086,184,7100,5400,1700,0.7605633802816901,88,54,34,232.22317544895333,0.4696638403817217,0.7866637416249997,0.1367305064414685,1058144.7096627783,5245.144912480084,1063389.8545752584,2319,0,493.1195652173913,63,121,38,37.59943302022509,0.5487432065217391,43.554687499999986,8252.400477491889,130.9904837697125,7
2356,32.36252448694912,4,0,186,0.021505376344086023,0.0,1.0,186,6050,4600,1450,0.7603305785123967,75,46,29,226.3642348751395,0.4702993315896542,0.7831766397250703,0.13485578048413763,1067765.583145508,5090.787850947851,1072856.370996456,2320,0,482.5698924731183,70,116,42,37.304267329183084,0.551747311827957,43.11913145539905,8313.313398503378,118.76161997861969,0
2357,32.030229747468084,0,3,183,0.0,0.016129032258064516,0.9838709677419355,186,5950,4400,1550,0.7394957983193278,75,44,31,232.94670334535064,0.4703677467790371,0.7876082557568753,0.13150852076087433,1040208.8279650222,5312.64345303685,1045521.4714180591,2321,1,483.5698924731183,70,116,39,39.20698769980622,0.5320900537634409,45.14377934272302,8163.103300224042,116.61576143177203,8
2358,32.35122404049187,4,1,186,0.0213903743315508,0.0053475935828877,0.9946524064171123,187,5900,4000,1900,0.6779661016949152,78,40,38,224.49347827935438,0.4706038084833151,0.7808205149900158,0.12801674287702422,1053803.1741401963,4014.387996911518,1057817.5621371078,2322,0,481.4331550802139,64,123,43,39.02963521064859,0.5353721033868093,44.759615384615394,8257.338866873642,129.02091979490066,0
2359,32.488459251603246,4,0,190,0.021052631578947368,0.0,1.0,190,6200,4500,1700,0.7258064516129032,79,45,34,224.81730035639393,0.4713502506265664,0.7837705114384956,0.13007620517501928,1062839.6358357035,3588.947528071013,1066428.5833637745,2323,0,474.68947368421055,67,123,46,38.45894717930292,0.5387609649122806,44.2095588235294,8310.237325111357,124.0333929121098,0
2360,32.86063308016665,3,4,189,0.015544041450777202,0.02072538860103627,0.9792746113989638,193,4750,3000,1750,0.631578947368421,65,30,35,229.95304112179525,0.47221884894933797,0.7893671821355563,0.12942219296589158,1066194.1552365203,5684.917684584576,1071879.072921105,2324,0,468.2953367875648,70,123,41,39.403352915202824,0.5297927461139896,45.261150234741805,8370.879873399901,119.58399819142716,8
2361,33.003778549526224,3,3,189,0.015625,0.015625,0.984375,192,5550,4300,1250,0.7747747747747747,68,43,25,224.87649496827547,0.4725710351221641,0.7845629301461114,0.1273737595326881,1072893.1932539444,4303.6921548538185,1077196.8854087982,2325,0,465.6770833333333,73,119,41,39.28292112914508,0.5317925347222222,45.016891891891916,8415.40603386996,115.2795347105474,0
2362,32.97249329493752,5,1,193,0.02577319587628866,0.005154639175257732,0.9948453608247423,194,5500,3700,1800,0.6727272727272727,73,37,36,226.1817728452364,0.47259205348717126,0.7906846574061437,0.12974320406354492,1075929.3065587403,4371.119602720365,1080300.4261614606,2326,0,461.83505154639175,64,130,46,38.7571095497982,0.5347938144329897,44.53525641025641,8423.309545105752,131.61421164227738,0
2363,33.085492395436226,2,2,193,0.010256410256410256,0.010256410256410256,0.9897435897435898,195,6200,4700,1500,0.7580645161290323,77,47,30,225.84105283869047,0.4726187329280113,0.7931069194150326,0.1308065654509204,1082707.9072547206,3703.978738236212,1086411.8859929568,2327,0,460.44102564102565,66,129,46,38.392079408487795,0.537232905982906,44.16977611940298,8464.268926724233,128.2464988897611,0
2364,32.94205960042907,2,1,194,0.010256410256410256,0.005128205128205128,0.9948717948717949,195,5900,4200,1700,0.711864406779661,76,42,34,221.895943903271,0.4728478280024672,0.7877637855543593,0.13231342583552438,1087169.2097342801,3347.687595312249,1090516.8973295924,2328,0,460.06666666666666,68,127,39,37.384925764876364,0.5451388888888888,43.08574879227053,8463.28457548463,124.46006728653867,8
2365,33.0269499994502,1,0,195,0.005128205128205128,0.0,1.0,195,5350,3800,1550,0.7102803738317757,69,38,31,251.93737110003826,0.47277513437307256,0.8147316065014529,0.14719574915759698,1083552.5246699154,10247.47490282963,1093799.999572745,2329,0,461.0615384615385,66,129,41,37.38973860969492,0.5400106837606837,43.843283582089555,8460.07506515768,128.18295553269212,8
2366,33.333892740145224,1,3,193,0.00510204081632653,0.015306122448979591,0.9846938775510204,196,6450,4400,2050,0.6821705426356589,85,44,41,252.40345451347522,0.47272152450723876,0.8162722616007552,0.14843779179858504,1095714.0043876218,9662.399973245798,1105376.4043608676,2330,0,459.7040816326531,54,142,41,37.1268220318117,0.5420918367346939,43.59848484848485,8546.86060447133,158.2751963790987,0
2367,33.7391085992773,2,0,195,0.010256410256410256,0.0,1.0,195,6500,4900,1600,0.7538461538461538,81,49,32,248.6375233181529,0.4720856463124505,0.8124342136581701,0.1476494692370723,1112154.5101223416,9804.66858878659,1121959.1787111282,2331,0,462.7128205128205,58,137,43,36.85392743358776,0.544284188034188,43.23799435028249,8662.921192784079,149.36071022041514,0
2368,33.19293162147214,0,0,195,0.0,0.0,1.0,195,6200,4000,2200,0.6451612903225806,84,40,44,249.5720830244308,0.4720272711252093,0.8140088242342227,0.14884315377752166,1095505.338751578,9481.509871323371,1104986.8486229014,2332,1,463.7128205128205,58,137,39,36.66706752794577,0.5459935897435897,43.07909604519776,8527.957997098594,147.0337585706654,0
2369,33.03279392247573,2,0,197,0.01015228426395939,0.0,1.0,197,6850,4200,2650,0.6131386861313869,95,42,53,248.26055440817623,0.4721459649849788,0.8110792728006015,0.14388816044014838,1081196.3894160518,7433.683012109502,1088630.0724281613,2333,0,459.994923857868,65,132,40,37.792689634610234,0.533576565143824,44.14457070707071,8451.619669779908,130.02491799661396,8
2370,32.66624653746157,3,1,199,0.015,0.005,0.995,200,6750,4900,1850,0.725925925925926,86,49,37,247.47083836327488,0.47252250837520937,0.8137485380116967,0.1447813262565196,1072140.9212099153,6314.722523078128,1078455.6437329934,2334,0,454.08,72,128,39,37.45242736470805,0.5363020833333334,43.79280821917807,8369.327291382999,116.24065682476387,0
2371,32.38847228332953,0,3,196,0.0,0.01507537688442211,0.9849246231155779,199,7350,5400,1950,0.7346938775510204,93,54,39,247.6590885094173,0.4724210276974096,0.8135417081412133,0.14592357200168385,1065222.5860877796,5612.410946028443,1070834.9970338081,2335,1,456.34170854271355,60,139,40,37.17624342499501,0.5380548576214406,43.528005464480856,8306.736086463863,138.44560144106438,0
2372,32.64699823612808,2,1,197,0.010101010101010102,0.005050505050505051,0.9949494949494949,198,6450,5200,1250,0.8062015503875969,77,52,25,241.47195967233793,0.4723311798184895,0.8074396135265696,0.14314059465112786,1075605.248706535,5895.701447803725,1081500.9501543387,2336,0,458.74242424242425,62,136,40,37.10507246376807,0.5405092592592593,43.303571428571416,8380.367850791787,135.16722339986754,0
2373,32.67546109267227,2,0,199,0.010050251256281407,0.0,1.0,199,6000,4300,1700,0.7166666666666667,77,43,34,240.21381948462414,0.47211224472531005,0.8085442487705055,0.14370717831830968,1079386.854164621,6056.72778807527,1085443.5819526964,2337,0,457.356783919598,64,135,37,36.79040152129181,0.5429752931323283,42.964743589743584,8398.745520278366,131.23039875434947,0
2374,32.967351280563356,0,3,196,0.0,0.01507537688442211,0.9849246231155779,199,7200,5300,1900,0.7361111111111112,91,53,38,236.59249915192007,0.4722994179652471,0.8059267224510143,0.1347057843795242,1073372.4924735485,3790.3761030484384,1077162.868576597,2338,1,458.356783919598,75,124,38,38.781689762595356,0.5240263819095478,44.81907894736842,8412.6390644398,112.16852085919733,8
2375,32.675188058172495,1,2,195,0.005076142131979695,0.01015228426395939,0.9898477157360406,197,5750,3400,2350,0.591304347826087,81,34,47,235.68074940436657,0.47198733554335437,0.803469322529764,0.13497453721362518,1065717.9605206891,5083.841517841944,1070801.802038531,2339,0,462.84263959390864,63,134,39,38.57698190160595,0.5257508460236886,44.59635416666668,8345.362158347074,132.4660660055091,0
2376,32.79184671163757,1,0,196,0.00510204081632653,0.0,1.0,196,6450,4400,2050,0.6821705426356589,85,44,41,244.9919928799837,0.4721638976103262,0.8053832136720949,0.13704536241377316,1061994.8033831792,6386.044661806258,1068380.8480449854,2340,0,463.4438775510204,64,132,38,39.26167012992466,0.5206738945578231,45.49679487179487,8345.630090184546,130.40047015913353,8
2377,33.16063182651659,1,0,197,0.005076142131979695,0.0,1.0,197,6350,4700,1650,0.7401574803149606,80,47,33,243.03662110597284,0.4726121413032218,0.8051905393849357,0.13643538082546153,1075094.324464737,6507.458397623549,1081601.7828623606,2341,0,462.0862944162437,65,132,37,39.171160282632954,0.5221552453468696,45.359848484848484,8444.028312642338,129.9081278868052,0
2378,33.22676923168626,7,4,200,0.03431372549019608,0.0196078431372549,0.9803921568627451,204,6000,4100,1900,0.6833333333333333,79,41,38,234.5936300514755,0.4751445836955472,0.8074155559806981,0.1337209274022971,1082189.2489669626,3974.940863568084,1086164.1898305307,2342,0,447.19607843137254,63,141,36,38.78798386582488,0.526296977124183,44.77539062500001,8480.28919795041,134.6077650468319,0
2379,32.696103556073595,2,1,201,0.009900990099009901,0.0049504950495049506,0.995049504950495,202,6650,4800,1850,0.7218045112781954,85,48,37,233.24149619343217,0.4753111505180369,0.8029702970297026,0.13369893258939458,1066687.9725764636,2709.179739054735,1069397.1523155184,2343,0,451.9752475247525,67,135,38,38.604010494752615,0.5282590759075907,44.56188725490197,8351.830986481744,124.65419382808572,0
2380,33.02517675988321,4,0,205,0.01951219512195122,0.0,1.0,205,5700,4000,1700,0.7017543859649122,74,40,34,225.9208451915389,0.4761507651841224,0.8003443328550917,0.13070289734903232,1080369.257256211,2115.587143655942,1082484.8443998669,2344,0,445.45365853658535,71,134,41,38.434200603318246,0.53119918699187,44.21296296296298,8447.41211103499,118.97763536669,0
2381,33.46995520235397,5,2,208,0.023809523809523808,0.009523809523809525,0.9904761904761905,210,5550,3600,1950,0.6486486486486487,75,36,39,199.6881390852992,0.4768464722412091,0.7729425028184911,0.11281743908831725,1087211.1236870985,-4129.36678361779,1083081.7569034807,2345,0,435.82380952380953,86,124,37,40.02519024802701,0.5273809523809524,45.11494252873559,8530.991455312518,99.19757506177346,8
2382,33.71532348149491,4,1,211,0.018867924528301886,0.0047169811320754715,0.9952830188679245,212,7050,4900,2150,0.6950354609929078,92,49,43,201.49637671487642,0.4772562147903067,0.7802171156974333,0.11477159485133838,1097862.8211797902,-5206.923880460714,1092655.8972993295,2346,0,430.35849056603774,90,122,43,39.66098875631705,0.5308569182389937,44.803113553113505,8604.045578026955,95.60050642252172,0
2383,33.42793133761954,2,3,210,0.009389671361502348,0.014084507042253521,0.9859154929577465,213,6250,4300,1950,0.688,82,43,39,196.9108764087691,0.4770425487938111,0.7757529201330995,0.11299489215981803,1090911.619870071,-5887.527369374817,1085024.0925006962,2347,0,429.3098591549296,76,137,43,39.49044656252756,0.5327660406885759,44.5211038961039,8540.130997171898,112.37014469963025,0
2384,33.26973879330423,4,0,214,0.018691588785046728,0.0,1.0,214,5950,3800,2150,0.6386554621848739,81,38,43,194.74653720669914,0.47702446506661983,0.776631528025834,0.11290264968209666,1089038.1998832847,-6332.716337382654,1082705.4835459022,2348,0,426.6542056074766,83,131,48,39.15153112328151,0.5360689252336448,44.1344246031746,8512.58085965086,102.56121517651638,0
2385,33.274973430431245,2,2,214,0.009259259259259259,0.009259259259259259,0.9907407407407407,216,6900,4700,2200,0.6811594202898551,91,47,44,192.3185275147419,0.476918245765145,0.7763926117632549,0.11228786557916856,1091475.8834031117,-8117.793057212257,1083358.0903458996,2349,0,423.69444444444446,87,129,42,38.94248544227743,0.5385802469135803,43.86837121212121,8522.773142609749,97.96290968516952,0
2386,33.44024154261328,4,4,214,0.01834862385321101,0.01834862385321101,0.981651376146789,218,5900,3900,2000,0.6610169491525424,79,39,40,190.43112490214648,0.47708844191716343,0.7765419343202002,0.11244447305736156,1100496.4484152733,-7586.244675492666,1092910.2037397807,2350,0,417.348623853211,75,143,46,38.56292517006804,0.5411410550458715,43.448464912280684,8579.145301461516,114.38860401948688,0
2387,33.32547615772919,0,3,211,0.0,0.014018691588785047,0.985981308411215,214,6300,4100,2200,0.6507936507936508,85,41,44,216.488018453459,0.47685078539774467,0.803436559567271,0.12863760366866453,1098715.7874766765,-1528.2392651283944,1097187.548211548,2351,1,424.67289719626166,73,141,37,37.65600445857547,0.5431756230529595,43.215090090090094,8557.47939286735,117.22574510777191,8
2388,33.47852689720836,0,6,205,0.0,0.02843601895734597,0.9715639810426541,211,7300,5100,2200,0.6986301369863014,95,51,44,220.58223933634991,0.47624971789663734,0.804365033318444,0.1316540987213795,1105172.9651914532,-743.6944968153548,1104429.270694638,2352,2,431.6777251184834,75,136,34,37.38314797034193,0.5449249605055293,43.050986842105246,8602.27444821768,114.6969926429024,0
2389,33.812831308118966,2,4,203,0.00966183574879227,0.01932367149758454,0.9806763285024155,207,7050,5300,1750,0.75177304964539,88,53,35,224.98929985859795,0.47533339586948703,0.8050950415942775,0.13514286191506494,1118246.5048163915,1868.6996375928538,1120115.2044539843,2353,0,440.54589371980677,76,131,36,37.0302061964126,0.5468498389694042,42.81655844155844,8696.100324657056,114.422372692856,0
2390,33.87459151909052,0,2,201,0.0,0.009852216748768473,0.9901477832512315,203,7450,5200,2250,0.697986577181208,97,52,45,222.27247381686328,0.4746825667788454,0.7979828949004475,0.12964329176442121,1110809.5645597863,1330.4779708272245,1112140.0425306135,2354,1,448.39408866995075,72,131,37,38.2147201946472,0.5406403940886699,43.90696347031963,8675.047003326441,120.48676393508946,8
2391,33.48415281365968,1,4,198,0.0049504950495049506,0.019801980198019802,0.9801980198019802,202,5150,4000,1150,0.7766990291262136,63,40,23,218.3198700116324,0.4745938213224308,0.7882076603740846,0.12591380962300797,1094380.3565043786,2234.995435063672,1096615.3519394423,2355,0,450.63861386138615,78,124,36,38.748388344507475,0.5422854785478548,44.33016877637129,8560.887698534509,109.75497049403216,8
2392,33.06192311310028,5,2,201,0.024630541871921183,0.009852216748768473,0.9901477832512315,203,6800,5300,1500,0.7794117647058824,83,53,30,215.18979179255612,0.47465005121201775,0.7889578366012906,0.12579783566102445,1084881.5489961312,-708.913070387649,1084172.6359257435,2356,0,448.7487684729064,86,117,37,38.30914656945221,0.5459770114942528,43.821839080459746,8469.7426595772,98.48537976252557,0
2393,33.206054232116436,1,2,200,0.0049504950495049506,0.009900990099009901,0.9900990099009901,202,6500,4800,1700,0.7384615384615385,82,48,34,212.26343905188423,0.47465385531090426,0.786037106785779,0.12485711683758832,1091576.7911158237,-559.6312657071303,1091017.1598501166,2357,0,451.75742574257424,71,131,36,38.14822782072259,0.5483188943894389,43.590856481481474,8514.335925286434,119.92022429980892,0
2394,33.13347655537354,2,0,202,0.009900990099009901,0.0,1.0,202,5750,3900,1850,0.6782608695652174,76,39,37,209.92173736587284,0.47500738879858134,0.7841577286032306,0.12445787334996573,1091682.9812732225,-316.4023836741626,1091366.5788895483,2358,0,451.81188118811883,75,127,41,37.908958032996956,0.550536303630363,43.29769736842104,8505.439725953795,113.40586301271726,0
2395,32.65449450904963,0,1,201,0.0,0.0049504950495049506,0.995049504950495,202,5800,4100,1700,0.7068965517241379,75,41,34,206.66273098761047,0.47487859793442033,0.780306361598702,0.12277512666278001,1076532.7132976637,-1704.161894480706,1074828.551403183,2359,1,452.81188118811883,76,126,40,37.915766643836804,0.5517223597359736,43.222402597402585,8384.94264443004,110.32819268986896,0
2396,32.17589200155666,0,2,199,0.0,0.009950248756218905,0.9900497512437811,201,6100,4300,1800,0.7049180327868853,79,43,36,216.99984943915933,0.47453669154228856,0.786780425037813,0.12776079280440758,1057995.5226366539,-383.02617610859943,1057612.4964605453,2360,2,454.4726368159204,69,132,37,37.99172856341513,0.5481446932006633,43.55654761904759,8251.296828315804,119.58401200457688,8
2397,31.756533982685912,3,3,199,0.01485148514851485,0.01485148514851485,0.9851485148514851,202,6750,5000,1750,0.7407407407407407,85,50,35,210.9534465255418,0.4743865244733429,0.782224088410268,0.1252059847438768,1046644.6103668226,-2991.3424311474255,1043653.2679356751,2361,0,451.28712871287127,73,129,41,37.84124449439844,0.5511551155115512,43.2573198198198,8153.257647947703,111.68846093079046,0
2398,31.953335819709313,2,4,197,0.009950248756218905,0.01990049751243781,0.9800995024875622,201,5200,3500,1700,0.6730769230769231,69,35,34,216.49747579990066,0.47431384742951904,0.7858564732792319,0.12937409713025155,1055194.0583481856,289.37002228689744,1055483.4283704725,2362,0,454.23383084577114,76,125,36,37.442096120440056,0.5530679933665008,43.005952380952365,8211.81710723776,108.0502250952337,0
2399,32.355662844317976,0,4,193,0.0,0.02030456852791878,0.9796954314720813,197,6350,4700,1650,0.7401574803149606,80,47,33,221.76935469451416,0.47384232880969646,0.7867780790220316,0.1328844154220535,1069310.3958826277,1678.055292604984,1070988.4511752327,2363,1,457.56852791878174,78,119,38,37.20456371593664,0.5541983925549916,42.9061181434599,8318.442960687093,106.64670462419349,0
2400,32.206550666673486,2,1,194,0.010256410256410256,0.005128205128205128,0.9948717948717949,195,6300,4100,2200,0.6507936507936508,85,41,44,227.15284076887755,0.4734315798748789,0.793583504560037,0.13525320789374204,1062455.9481922102,2967.9773647304637,1065423.9255569407,2364,0,462.5230769230769,74,121,39,37.30421578169493,0.5530448717948717,43.13888888888889,8272.610389298057,111.79203228781158,8
2401,32.41305728916865,0,2,192,0.0,0.010309278350515464,0.9896907216494846,194,6550,4700,1850,0.7175572519083969,84,47,37,216.49927143445254,0.47314902604917825,0.7755191432996682,0.12391845458368957,1056988.7860733226,417.46041985260763,1057406.2464931752,2365,1,465.82474226804123,71,123,39,39.08905506458194,0.538928264604811,44.618055555555586,8277.709595897131,116.5874590971427,8
2402,32.011515907190685,3,0,195,0.015384615384615385,0.0,1.0,195,6400,4200,2200,0.65625,86,42,44,215.47472307445395,0.47316723940435285,0.7766362227570955,0.12474008162101871,1047408.3840976002,-261.99369814116926,1047146.390399459,2366,0,464.0923076923077,75,120,43,38.67650735819407,0.541826923076923,44.188596491228104,8188.910812661908,109.18547750215876,0
2403,31.572092636470277,1,5,191,0.00510204081632653,0.025510204081632654,0.9744897959183674,196,6000,4600,1400,0.7666666666666667,74,46,28,220.1829471934431,0.47336145996860285,0.7812015726338728,0.12834551652564025,1035119.8480612707,383.1477689122985,1035502.9958301829,2367,0,462.71938775510205,80,116,38,38.2918173295835,0.5437925170068028,43.9300411522634,8084.664462157937,101.05830577697421,0
2404,32.03708023137639,3,4,190,0.015463917525773196,0.020618556701030927,0.979381443298969,194,6150,4000,2150,0.6504065040650406,83,40,43,227.7729246351431,0.4735796921460748,0.7899165727018878,0.13252242887863022,1049791.0450217542,2872.795316078266,1052663.8403378325,2368,0,464.52061855670104,74,120,35,38.16901312934032,0.5407538659793815,44.00000000000004,8201.492539232457,110.83098025989807,8
2405,31.80610169021825,1,1,190,0.005235602094240838,0.005235602094240838,0.9947643979057592,191,5650,4100,1550,0.7256637168141593,72,41,31,226.17840695076723,0.47288968494534767,0.7855764734446575,0.13204550659262795,1043266.8332406674,3342.8860733897304,1046609.719314057,2369,0,470.9267015706806,76,115,37,38.07868536417896,0.5427574171029668,43.871753246753286,8146.441061971177,107.19001397330496,0
2406,31.756445116687722,0,2,188,0.0,0.010526315789473684,0.9894736842105263,190,6350,4300,2050,0.6771653543307087,84,43,41,227.8714996328482,0.47263123085491504,0.7850205972545767,0.13381176608395845,1043411.2057497399,3202.7352375821647,1046613.940987322,2370,1,474.2631578947368,64,126,36,37.81244790364256,0.5447916666666667,43.65384615384614,8140.642565489343,127.19754008577098,0
2407,31.865365570154935,3,2,189,0.015706806282722512,0.010471204188481676,0.9895287958115183,191,6450,4600,1850,0.7131782945736435,83,46,37,218.29035336348778,0.47258771929824567,0.7761851661579993,0.12940613898190242,1049870.0719349969,1185.3017976878182,1051055.3737326846,2371,0,472.39267015706804,71,120,41,37.69802410340227,0.5487020069808028,43.301504629629605,8179.791396285519,115.20832952514816,0
2408,31.758611531243737,2,4,187,0.010471204188481676,0.020942408376963352,0.9790575916230366,191,6600,5000,1600,0.7575757575757576,82,50,32,208.85296437365446,0.4724981629466336,0.7683142739046587,0.12400644759685661,1046827.8636576802,-1073.379497230988,1045754.4841604492,2372,0,473.26178010471205,73,118,42,37.880802266081844,0.5533922338568935,43.24324324324322,8154.238095859824,111.70189172410718,8
2409,31.84252864486344,0,1,186,0.0,0.0053475935828877,0.9946524064171123,187,6350,4500,1850,0.7086614173228346,82,45,37,209.50391845640527,0.47226295210166175,0.760329387899533,0.1193322629306448,1036878.4835942481,-303.97894477407954,1036574.5046494739,2373,1,483.24064171122996,89,98,42,39.45676863652167,0.5399398395721925,44.803240740740726,8126.110116789245,91.30460805381173,8
2410,32.23470488998353,3,1,188,0.015873015873015872,0.005291005291005291,0.9947089947089947,189,6600,4900,1700,0.7424242424242424,83,49,34,199.20386324451886,0.47251421254080833,0.750371913614817,0.11434050728265564,1052052.4083188628,-2485.419185436216,1049566.9891334265,2374,0,477.6031746031746,77,112,43,39.4217827086927,0.5426587301587302,44.51121794871797,8235.605492124452,106.95591548213574,0
2411,32.26553471079226,2,2,188,0.010526315789473684,0.010526315789473684,0.9894736842105263,190,5600,3900,1700,0.6964285714285714,73,39,34,198.89580680352177,0.47267938364429596,0.7492014149426516,0.1148915778123878,1055041.1476796533,-1631.3479442681328,1053409.7997353852,2375,0,475.9842105263158,83,107,45,39.18448744059744,0.5450657894736842,44.27083333333335,8251.238303645354,99.41250968247414,0
2412,32.4786685266101,1,0,189,0.005291005291005291,0.0,1.0,189,4850,3500,1350,0.7216494845360825,62,35,27,200.06486739845198,0.4725189031483357,0.7471700255825326,0.11611281525603115,1063485.6003340965,-96.77887779883713,1063388.8214562975,2376,0,478.9047619047619,87,102,36,38.97348204511468,0.5467372134038802,44.09327651515154,8311.509645795317,95.53459362983122,0
2413,32.42996331814894,0,1,188,0.0,0.005291005291005291,0.9947089947089947,189,6650,5100,1550,0.7669172932330827,82,51,31,206.2114257092415,0.472251538519269,0.7564133651090155,0.12025919887302847,1063395.4382017874,-593.1421191408808,1062802.2960826466,2377,1,479.9047619047619,89,100,37,38.63121064208022,0.5486662257495591,43.91203703703705,8304.923245108419,93.31374432706089,0
2414,32.07167866301588,2,1,189,0.010526315789473684,0.005263157894736842,0.9947368421052631,190,6700,5200,1500,0.7761194029850746,82,52,30,220.8739988670247,0.47264399424487147,0.7745496975326802,0.12924188900959724,1052676.2319090837,1801.7617708064763,1054477.9936798902,2378,0,478.3578947368421,84,106,38,38.12768052167537,0.5498355263157895,43.78676470588237,8217.188551564666,97.8236732329127,8
2415,32.43800729550882,0,0,189,0.0,0.0,1.0,189,5700,4000,1700,0.7017543859649122,74,40,34,218.9891413459438,0.47233479680288193,0.771860928971539,0.12866338145391612,1065967.951224167,3187.0812681748866,1069155.0324923417,2379,1,481.86772486772486,71,118,37,38.02012791572609,0.5511463844797178,43.634259259259245,8315.993768466638,117.12667279530477,0
2416,32.194899644637836,2,1,190,0.010471204188481676,0.005235602094240838,0.9947643979057592,191,5800,4100,1700,0.7068965517241379,75,41,34,213.69567352318,0.47233053182694956,0.7684811730575023,0.12639829220646115,1060039.4709091817,1305.1697394187026,1061344.6406486004,2380,0,477.81151832460733,76,115,39,37.900983183088236,0.5531195462478184,43.38474025974027,8261.702534620352,108.70661229763621,0
2417,31.985926491667534,2,1,191,0.010416666666666666,0.005208333333333333,0.9947916666666666,192,5350,4200,1150,0.7850467289719626,65,42,23,209.2493380177472,0.47260512107329844,0.7634730289071374,0.12452704943058554,1055017.2245027316,402.33116490350403,1055419.555667635,2381,0,476.2395833333333,80,112,44,37.78404349422527,0.5552300347222222,43.15843621399178,8215.31537926421,102.69144224080262,0
2418,32.441218752133565,0,2,189,0.0,0.010471204188481676,0.9895287958115183,191,6300,4600,1700,0.7301587301587301,80,46,34,209.64366442883158,0.47252801506383757,0.7618129996583172,0.12522782570119273,1071181.3400279577,413.27627824926003,1071594.616306207,2382,1,479.70680628272254,79,112,37,37.63342791514659,0.556555410122164,43.02083333333332,8336.717360574296,105.52806785537084,0
2419,32.64820876211879,2,2,189,0.010471204188481676,0.010471204188481676,0.9895287958115183,191,6150,4200,1950,0.6829268292682927,81,42,39,211.3057257674497,0.4720503811885735,0.7648345177994267,0.12687412461315958,1079610.2339260448,1275.5648051417365,1080885.7987311864,2383,0,480.5602094240838,84,107,40,37.39675164800255,0.5584096858638743,42.830882352941174,8396.111040111055,99.95370285846494,0
2420,32.54734849565302,2,3,188,0.010471204188481676,0.015706806282722512,0.9842931937172775,191,5500,4100,1400,0.7454545454545455,69,41,28,211.3768343637275,0.4719286764030495,0.7651388954900993,0.12773419673414085,1078244.232370466,1883.1705018830144,1080127.402872349,2384,0,479.39267015706804,73,118,41,37.15479055014766,0.5602094240837696,42.5957207207207,8377.82678197505,114.76475043801439,0
2421,32.346363002752746,0,2,186,0.0,0.010638297872340425,0.9893617021276596,188,6650,4800,1850,0.7218045112781954,85,48,37,203.75918096823247,0.4713248331247393,0.7533801610928028,0.12129063223652115,1066983.8652207775,-768.4483032593216,1066215.4169175182,2385,1,487.48936170212767,77,111,47,37.915464306140464,0.5560172872340425,43.149038461538446,8308.194439529123,107.89862908479381,8
2422,32.20250644693006,1,1,186,0.0053475935828877,0.0053475935828877,0.9946524064171123,187,5200,3500,1700,0.6730769230769231,69,35,34,203.72942932911084,0.47137048856688324,0.7553163462171142,0.12201457417381474,1064098.357194008,757.6302122357874,1064855.9874062438,2386,0,489.5347593582888,81,106,37,37.68689982046088,0.5582107843137255,42.92428861788617,8278.482253131622,102.20348460656324,0
2423,32.621203070311324,0,2,184,0.0,0.010752688172043012,0.989247311827957,186,6050,4000,2050,0.6611570247933884,81,40,41,208.01087366994278,0.47096774193548385,0.7578483113473298,0.12493302951175611,1078809.0054893256,1630.800750967352,1080439.806240293,2387,1,493.1505376344086,83,103,37,37.470315588986935,0.5594758064516129,42.819940476190474,8389.522947360936,101.0785897272402,0
2424,32.61687990531705,0,0,184,0.0,0.0,1.0,184,6300,4400,1900,0.6984126984126984,82,44,38,208.74635568513025,0.47042547715213434,0.7622227151730254,0.11893687707641215,1062189.7874981933,1245.6494372424845,1063435.4369354357,2388,2,499.3804347826087,76,108,43,39.46428571428576,0.5409873188405797,44.79166666666669,8324.099559169515,109.52762577854625,8
2425,32.23187594080371,0,1,183,0.0,0.005434782608695652,0.9945652173913043,184,5750,4200,1550,0.7304347826086957,73,42,31,207.75334305720267,0.4703004969509781,0.7620117852690558,0.11884165701090964,1050894.0758817329,1115.3514926881235,1052009.427374421,2389,3,500.3804347826087,68,116,43,39.33552566755346,0.5429121376811594,44.640700483091805,8230.70926235956,121.03984209352294,0
2426,31.90589546834425,2,0,185,0.010810810810810811,0.0,1.0,185,5650,4200,1450,0.7433628318584071,71,42,29,203.97439914617325,0.47091412064238153,0.759233112696218,0.11764476441616144,1042809.2843422205,-108.72056044881128,1042700.5637817717,2390,0,498.6378378378378,71,114,43,39.11366379960765,0.5453265765765766,44.32870370370372,8157.421653885727,114.89326273078488,0
2427,32.019640170029135,0,0,185,0.0,0.0,1.0,185,5150,3600,1550,0.6990291262135923,67,36,31,203.87302274923752,0.47065707011359187,0.7577235474062212,0.11790222993731689,1047356.1425885245,555.5325369008847,1047911.6751254253,2391,1,499.6378378378378,71,114,48,39.012917868657716,0.5467342342342343,44.227430555555564,8189.745638974921,115.34853012640734,0
2428,32.16805705526234,1,0,186,0.005376344086021506,0.0,1.0,186,6250,4700,1550,0.752,78,47,31,195.55403025767527,0.47094655139009983,0.7475822391641949,0.11233651227211058,1050129.5185877108,-2378.5880695238834,1047750.9305181869,2392,0,497.9462365591398,76,110,43,39.48373305802628,0.5447468637992832,44.480519480519504,8219.565228081701,108.15217405370659,8
2429,31.949680855695235,1,2,185,0.0053475935828877,0.0106951871657754,0.9893048128342246,187,6100,4400,1700,0.7213114754098361,78,44,34,200.87321008524523,0.47094162689513736,0.7535431061864435,0.11297742976864532,1036421.3935849044,-1862.1415339155324,1034559.2520509888,2393,0,496.27807486631013,83,104,42,40.171210645894206,0.5367090017825311,45.287698412698404,8137.976745733855,98.04791259920307,8
2430,32.214929141172085,3,3,185,0.015957446808510637,0.015957446808510637,0.9840425531914894,188,6100,4600,1500,0.7540983606557377,76,46,30,208.68451734786532,0.4716377242386316,0.7657981373241363,0.11894946094877908,1049225.947078541,91.44207098880406,1049317.3891495296,2394,0,491.47340425531917,67,121,44,39.45022557669608,0.5402814716312057,44.77634803921572,8222.011863067903,122.71659497116272,8
2431,31.841695113553254,3,3,185,0.015957446808510637,0.015957446808510637,0.9840425531914894,188,5000,3500,1500,0.7,65,35,30,209.699375070954,0.4720140232108317,0.7637265390323218,0.11863954581455032,1034755.6456691057,797.5224495901512,1035553.1681186958,2395,0,492.4308510638298,84,104,35,39.71522536813596,0.5370124113475176,45.06127450980389,8117.681169696583,96.63906154400695,8
2432,31.537810849603574,1,2,184,0.005376344086021506,0.010752688172043012,0.989247311827957,186,6100,4300,1800,0.7049180327868853,79,43,36,211.7817960696508,0.47092475540056183,0.7674282142419107,0.11513010386902545,1012458.7855572028,-415.9319896396787,1012042.8535675631,2396,0,498.5967741935484,70,116,39,41.244595950823154,0.5201052867383513,46.610915492957744,7991.3370185373105,114.16195740767587,8
2433,31.863621934551755,4,3,185,0.02127659574468085,0.015957446808510637,0.9840425531914894,188,5400,3800,1600,0.7037037037037037,70,38,32,205.9918902992569,0.47221609872188725,0.7620769677467247,0.11316781075854326,1026255.5296021794,-719.9367054364952,1025535.592896743,2397,0,493.26063829787233,79,109,33,40.96979957589439,0.5229942375886525,46.197916666666664,8087.053629534925,102.3677674624674,0
2434,32.023857787869744,1,1,185,0.005376344086021506,0.005376344086021506,0.9946236559139785,186,5600,4300,1300,0.7678571428571429,69,43,26,201.1249693445085,0.4722724740869902,0.7580198558458886,0.11133639315251745,1033824.0025414512,-1214.435836247154,1032609.5667052041,2398,0,498.0967741935484,75,111,47,40.7913160544438,0.5260416666666667,45.90186403508769,8137.202570303067,108.49603427070755,8
2435,32.08820887735818,4,1,188,0.021164021164021163,0.005291005291005291,0.9947089947089947,189,4600,2900,1700,0.6304347826086957,63,29,34,195.27400284863435,0.4727170813163721,0.7553517222595609,0.10939236664563758,1039663.9919116702,-1796.1301363633656,1037867.8617753069,2399,0,490.8835978835979,68,121,48,40.46994227651915,0.5288800705467371,45.44082125603867,8168.3480991850365,120.12276616448582,0
2436,31.595326646895884,4,4,188,0.020833333333333332,0.020833333333333332,0.9791666666666666,192,5650,4000,1650,0.7079646017699115,73,40,33,189.9733399878857,0.47390663630744617,0.7511968085106377,0.1072352671360196,1026047.7604541575,-5065.65599188647,1020982.104462271,2400,0,484.1822916666667,72,120,40,40.306900895856664,0.5310872395833333,45.14840182648404,8052.119490775741,111.83499292744085,0
2437,31.530575167545777,2,3,187,0.010526315789473684,0.015789473684210527,0.9842105263157894,190,6050,3900,2150,0.6446280991735537,82,39,43,194.28097956373793,0.47274842198087813,0.7552388976858353,0.11008445244908144,1025115.1892894467,-4217.92337183566,1020897.2659176111,2401,0,490.2684210526316,73,117,42,40.04870503266167,0.5325109649122808,45.00281531531534,8040.207899213061,110.13983423579536,0
2438,31.725609185793715,1,3,185,0.005319148936170213,0.015957446808510637,0.9840425531914894,188,6000,4400,1600,0.7333333333333333,76,44,32,210.49849329011704,0.4721651353965184,0.7621418166773706,0.1161152023880786,1023089.6887551119,-528.232403279063,1022561.4563518328,2402,0,496.34574468085106,80,108,35,40.693255857133245,0.5264295212765957,46.03909465020575,8057.064431597883,100.71330539497355,8
2439,31.288445100961052,4,2,187,0.021164021164021163,0.010582010582010581,0.9894179894179894,189,4850,3300,1550,0.6804123711340206,64,33,31,205.37060847598195,0.4724098465233217,0.7564389938731739,0.11440512029501959,1012026.6938894683,-1081.8924163970169,1010944.8014730713,2403,0,494.1904761904762,76,113,36,40.43401946704961,0.529265873015873,45.65746753246751,7957.982363949735,104.71029426249652,0
2440,31.42449527095207,4,0,191,0.020942408376963352,0.0,1.0,191,5500,4200,1300,0.7636363636363637,68,42,26,200.9847670504073,0.4734270230550197,0.7514918137927453,0.1129857302637379,1019236.5203503813,-2729.797077622495,1016506.7232727588,2404,0,489.4659685863874,82,109,41,40.18726799382412,0.5322316753926701,45.30622489959837,8003.62333118344,97.6051625754078,0
2441,31.873694202966508,6,3,194,0.030456852791878174,0.015228426395939087,0.9847715736040609,197,5500,3500,2000,0.6363636363636364,75,35,40,197.75571072399097,0.4748297161504196,0.7582272599378073,0.11253800719207697,1037610.904548676,-3861.3036232031027,1033749.6009254729,2405,0,475.5279187817259,89,108,41,39.791987964558935,0.5357445008460238,44.83796296296293,8132.9567407244485,91.38153641263425,0
2442,31.891142339008493,3,3,194,0.015228426395939087,0.015228426395939087,0.9847715736040609,197,5500,4100,1400,0.7454545454545455,69,41,28,199.45328848076818,0.47464302980075274,0.7598783360837944,0.11412790926497388,1039877.3421488474,-3418.6088983539767,1036458.7332504934,2406,0,476.502538071066,76,121,42,39.53587699316629,0.5373307952622673,44.62932900432903,8144.0624179311135,107.15871602540939,0
2443,31.539985250116196,1,1,194,0.005128205128205128,0.005128205128205128,0.9948717948717949,195,6200,4300,1900,0.6935483870967742,81,43,38,205.01528536762856,0.47451757864129,0.7662907502856675,0.11802433887068879,1030280.3002100056,-2955.3580487595004,1027324.9421612461,2407,0,474.1589743589744,76,119,48,39.15914664267318,0.5394764957264957,44.39935064935068,8061.640710439677,106.07421987420628,0
2444,31.34545407423372,2,1,195,0.01020408163265306,0.00510204081632653,0.9948979591836735,196,6500,4600,1900,0.7076923076923077,84,46,38,203.46873012725553,0.47478741496598637,0.7687926208334364,0.11818502835051321,1026626.3730609014,-3922.727111629241,1022703.6459492722,2408,0,472.60714285714283,79,117,35,38.85497218830555,0.5420918367346939,44.06250000000003,8022.477152124261,101.55034369777546,0
2445,31.779414440325723,3,1,197,0.015151515151515152,0.005050505050505051,0.9949494949494949,198,5550,4200,1350,0.7567567567567568,69,42,27,199.46912133374954,0.47502253926746313,0.7676444680807377,0.11679221034609842,1043279.2819609317,-3529.599664309205,1039749.6822966225,2409,0,468.72727272727275,81,117,40,38.6515604085073,0.5444549663299663,43.762703252032544,8143.071248422444,100.53174380768449,0
2446,32.08891163229072,5,4,198,0.024752475247524754,0.019801980198019802,0.9801980198019802,202,6950,5300,1650,0.762589928057554,86,53,33,192.14749558467773,0.4762793909988014,0.7623772951958734,0.11370953562981943,1056702.1860645672,-6741.464273768167,1049960.721790799,2410,0,460.36633663366337,75,127,41,38.4350744142989,0.5474938118811881,43.36622807017542,8235.09842931754,109.80131239090055,0
2447,31.95561586518149,1,2,197,0.005025125628140704,0.010050251256281407,0.9899497487437185,199,5750,3900,1850,0.6782608695652174,76,39,37,194.32475195247292,0.4746893135712231,0.7620874804498288,0.11536094674088089,1053270.526158997,-4614.693253060697,1048655.8329059363,2411,0,461.45226130653265,76,123,43,38.260160352670475,0.5489949748743719,43.24945887445885,8204.621665385223,107.95554822875293,0
2448,32.2582956619894,0,2,195,0.0,0.01015228426395939,0.9898477157360406,197,6300,4700,1600,0.746031746031746,79,47,32,199.64376526201684,0.47417793259435753,0.7639537548798223,0.11575911024420027,1055976.5535425115,-3536.1729644727216,1052440.3805780387,2412,1,467.02030456852793,76,121,40,39.020478657784395,0.5398688663282571,44.128787878787904,8253.969211997723,108.60485805260161,8
2449,31.914268308733302,1,0,196,0.00510204081632653,0.0,1.0,196,6850,5300,1550,0.7737226277372263,84,53,31,206.1721047901026,0.4734781091923949,0.769523490147231,0.11998540524669996,1045845.3036148216,-2925.174493777344,1042920.1291210443,2413,0,470.3724489795918,77,119,41,38.712180490349525,0.5414540816326531,43.99038461538464,8170.359555000297,106.10856564935452,0
2450,31.442155894046483,2,1,197,0.010101010101010102,0.005050505050505051,0.9949494949494949,198,5750,4000,1750,0.6956521739130435,75,40,35,212.74760329999003,0.47415942419115004,0.7783634860337769,0.12480525955845637,1032782.7307402331,-1405.5898610792306,1031377.1408791539,2414,0,466.6111111111111,70,128,39,38.23840870062964,0.5439288720538721,43.691314553990615,8058.897644791561,115.12710921130801,0
2451,31.28602156369186,2,1,198,0.010050251256281407,0.005025125628140704,0.9949748743718593,199,6100,4100,2000,0.6721311475409836,81,41,40,208.91377290662487,0.4744059100214879,0.7759124751569146,0.1235722933188763,1030119.8985610899,-2858.7530890826056,1027261.1454720072,2415,0,464.9497487437186,73,126,41,38.022947522398965,0.5462206867671692,43.384009009009006,8028.49342773229,109.97936202373,0
2452,31.80018832946027,3,3,198,0.014925373134328358,0.014925373134328358,0.9850746268656716,201,6600,5000,1600,0.7575757575757576,82,50,32,204.42251853257432,0.47463619402985074,0.7776250851427404,0.1214670435999924,1048425.1744943135,-3935.6570673840038,1044489.5174269296,2416,0,460.6666666666667,75,126,42,37.96620629837201,0.5512541459369817,43.215460526315766,8165.796715356831,108.87728953809108,8
2453,31.892349988366927,1,4,195,0.005025125628140704,0.020100502512562814,0.9798994974874372,199,6100,4200,1900,0.6885245901639344,80,42,38,214.93954664884882,0.4739702299375666,0.7797733926942465,0.12668232240755617,1048995.7056539038,-805.8677180321483,1048189.8379358717,2417,0,465.63316582914575,75,124,41,38.00416154544969,0.5462730318257956,43.51699561403509,8179.845741945044,109.06460989260059,8
2454,31.526270234329186,1,0,196,0.00510204081632653,0.0,1.0,196,5300,3600,1700,0.6792452830188679,70,36,34,213.03657161556228,0.47352716727716726,0.7753813687423416,0.12600844175165554,1038024.3823653018,-272.5688655070667,1037751.8134997948,2418,0,469.33673469387753,76,120,40,37.9178967438101,0.547406462585034,43.384740259740255,8090.122024823989,106.44897401084195,0
2455,31.636770483676845,4,2,198,0.02,0.01,0.99,200,6850,5200,1650,0.7591240875912408,85,52,33,217.12451487197652,0.4739332077051926,0.7870633253301336,0.1301185042362268,1045591.7083022735,-1445.2815161418312,1044146.4267861317,2419,0,460.93,80,120,39,37.31899009603838,0.5510416666666667,42.90123456790121,8133.7746336119235,101.67218292014904,0
2456,31.69706707242286,1,1,198,0.005025125628140704,0.005025125628140704,0.9949748743718593,199,6300,4300,2000,0.6825396825396826,83,43,40,216.9267265862547,0.47301744412297175,0.7858366979405706,0.1312179150329438,1050371.0499160073,-529.2892881507328,1049841.7606278565,2420,0,464.18090452261305,69,130,40,36.97495183044316,0.5533396147403685,42.559523809523796,8160.108040965975,118.26243537631848,0
2457,31.611292386486184,2,1,199,0.01,0.005,0.995,200,5950,4100,1850,0.6890756302521008,78,41,37,211.16639297322877,0.4730093174204355,0.7801853624807191,0.12860833671168326,1049553.3140760434,-1623.9224866928553,1047929.3915893505,2421,0,462.13,75,125,40,36.86932654291437,0.5555729166666667,42.31085526315788,8145.886899099847,108.6118253213313,0
2458,31.795755633255002,2,4,197,0.009950248756218905,0.01990049751243781,0.9800995024875622,201,6500,4200,2300,0.6461538461538462,88,42,46,201.93499759453516,0.47288764510779435,0.7745859948569913,0.12149463520914572,1052031.8776983889,-4211.589061520304,1047820.2886368686,2422,0,460.7562189054726,86,115,43,37.56157396633308,0.554570895522388,42.75622605363985,8179.260174574768,95.10767644854381,8
2459,31.957672721666768,0,1,196,0.0,0.005076142131979695,0.9949238578680203,197,5550,3400,2150,0.6126126126126126,77,34,43,202.28152010765427,0.4724114264995338,0.7709801701785783,0.12224839693462647,1058734.901672372,-2117.4989397366835,1056617.4027326351,2423,1,470.74111675126903,71,126,43,37.385716426858586,0.5561019458544839,42.59259259259262,8226.141682058718,115.86115045153124,0
2460,31.94559595450017,0,2,194,0.0,0.01020408163265306,0.9897959183673469,196,6850,5100,1750,0.7445255474452555,86,51,35,230.52555026793507,0.472058695272981,0.796538677146376,0.13744408957241472,1054250.2952488053,2556.325886472843,1056806.6211352781,2424,2,474.0408163265306,70,126,36,37.16735195020274,0.5520833333333333,43.089788732394375,8207.149805740228,117.2449972248604,8
2461,32.08688973741183,1,0,195,0.005128205128205128,0.0,1.0,195,6700,5400,1300,0.8059701492537313,80,54,26,215.30262740020655,0.47192814344876205,0.7786719404501938,0.12491299109887705,1050549.7203194958,-462.77700013193316,1050086.9433193638,2425,0,476.8205128205128,75,120,38,38.59690233886804,0.5422008547008548,44.106359649122815,8210.831022443537,109.47774696591382,8
2462,32.4034828625401,2,1,196,0.01015228426395939,0.005076142131979695,0.9949238578680203,197,7400,5300,2100,0.7162162162162162,95,53,42,216.2848112103489,0.4720315791291136,0.7882260033619857,0.12289594029098484,1054379.1298820174,-1190.7617898670787,1053188.3680921502,2426,0,472.9695431472081,79,118,41,39.37831768068602,0.5326247884940778,44.895833333333336,8266.263492745911,104.63624674361913,8
2463,32.558683523348535,3,1,198,0.01507537688442211,0.005025125628140704,0.9949748743718593,199,6300,4400,1900,0.6984126984126984,82,44,38,233.49148758996535,0.4720826353992183,0.7988118538741997,0.12881658310119945,1049999.7174025776,2933.1991970739045,1052932.9165996516,2427,0,469.16582914572865,77,122,35,40.10375585002891,0.5222989949748744,46.033653846153825,8268.809890004208,107.38714142862608,8
2464,32.26328223523177,4,2,200,0.019801980198019802,0.009900990099009901,0.9900990099009901,202,6650,4200,2450,0.631578947368421,91,42,49,218.3380126953109,0.4726055161486298,0.7855778155940578,0.12046235183189663,1040488.8198815074,-1614.3477670760894,1038874.4721144313,2428,0,463.13366336633663,83,119,37,40.486653645833364,0.5238758250825082,46.03174603174606,8193.849456566872,98.72107778996231,8
2465,31.856493041631495,3,3,200,0.014778325123152709,0.014778325123152709,0.9852216748768473,203,6950,5200,1750,0.7482014388489209,87,52,35,211.50536072885117,0.4733738152140337,0.7816230092992973,0.11780144444047103,1030343.953626709,-3965.346082678435,1026378.6075440305,2429,0,460.99014778325125,73,130,38,40.28508043686812,0.5269396551724138,45.66441441441441,8102.239812446469,110.98958647186944,0
2466,32.18447020555041,3,2,201,0.014778325123152709,0.009852216748768473,0.9901477832512315,203,6650,4600,2050,0.6917293233082706,87,46,41,218.3147048120271,0.4740901737957047,0.7915010074867361,0.12111251021153611,1039693.0601221294,-1853.9432968645833,1037839.1168252648,2430,0,459.0197044334975,68,135,37,40.2690750529588,0.5264265188834154,45.81823671497587,8180.705387241178,120.30449098884085,8
2467,32.30153387738485,2,2,201,0.009852216748768473,0.009852216748768473,0.9901477832512315,203,6500,4500,2000,0.6923076923076923,85,45,40,221.7547950366819,0.4739997398754654,0.7958913731096682,0.12431408500352029,1046798.1809550797,-673.4967875068269,1046124.6841675729,2431,0,459.9950738916256,71,132,38,39.768201492678685,0.5289922003284072,45.41377314814816,8223.525631370701,115.82430466719298,0
2468,32.238297787867246,3,4,200,0.014705882352941176,0.0196078431372549,0.9803921568627451,204,6600,5000,1600,0.7575757575757576,82,50,32,218.48249366763366,0.47432909945587426,0.7941825577705328,0.12340326996905986,1047120.3129477494,-1644.508571428482,1045475.8043763209,2432,0,458.6519607843137,74,130,38,39.556427442646175,0.53125,45.12500000000001,8216.736148682683,111.03697498219842,0
2469,32.134807915950255,4,3,201,0.0196078431372549,0.014705882352941176,0.9852941176470589,204,6250,4500,1750,0.72,80,45,35,217.54026965000264,0.4744925987636434,0.7941956351307522,0.12386053255280882,1046271.7671765443,-1528.7515282458198,1044743.0156482984,2433,0,457.1813725490196,77,127,42,39.26714814039495,0.5340584150326797,44.818376068376075,8200.21246872301,106.49626582757156,0
2470,32.54965175476238,2,4,199,0.009852216748768473,0.019704433497536946,0.9802955665024631,203,6600,4500,2100,0.6818181818181818,87,45,42,217.1367937842519,0.47456876229494865,0.7936434481152204,0.12481843236062298,1062797.9081622206,-1045.493956209133,1061752.4142060115,2434,0,458.85221674876846,64,139,43,38.90630879217358,0.5367405582922824,44.455128205128204,8317.896584638476,129.9671341349762,0
2471,32.72663671089563,2,2,199,0.009950248756218905,0.009950248756218905,0.9900497512437811,201,5550,3700,1850,0.6666666666666666,74,37,37,212.5098909578854,0.47418843283582085,0.7868226821824313,0.12315545450307383,1071144.4627456611,-224.2414043555973,1070920.2213413056,2435,0,463.5970149253731,67,134,46,38.71118229353771,0.5392827529021559,44.148284313725476,8373.166151124027,124.97262912125414,0
2472,32.39714017449743,2,0,201,0.009950248756218905,0.0,1.0,201,6850,5200,1650,0.7591240875912408,85,52,33,210.36755307989677,0.4737095771144279,0.7854017940154969,0.12298041942179685,1063071.6946293025,-2322.8417704669973,1060748.8528588356,2436,0,464.1243781094527,72,129,40,38.43217939434455,0.5419776119402986,43.82134703196347,8299.455729919402,115.27021847110281,0
2473,32.74955640217422,2,2,201,0.009852216748768473,0.009852216748768473,0.9901477832512315,203,6550,4800,1750,0.732824427480916,83,48,35,214.94266720905648,0.47398246598058824,0.7886295728014221,0.12483045905870682,1072565.0297802198,-1042.002348775698,1071523.027431444,2437,0,460.5418719211823,71,132,42,38.567222536272844,0.5413587848932677,44.06828703703704,8381.650068785619,118.05140941951575,7
2474,32.924176336226196,1,2,200,0.0049504950495049506,0.009900990099009901,0.9900990099009901,202,5750,4300,1450,0.7478260869565218,72,43,29,203.6811835526538,0.4737312817102606,0.7741179488139409,0.11491047688985222,1069026.6136082872,-2601.8788181958007,1066424.7347900914,2438,0,463.74257425742576,79,123,36,39.978848381108065,0.5316109735973598,45.16927083333332,8390.091862972404,106.20369446800511,8
2475,33.27645841950605,1,2,199,0.004975124378109453,0.009950248756218905,0.9900497512437811,201,5000,3400,1600,0.68,66,34,32,203.19871322384142,0.4732120646766169,0.7730719006750271,0.11489401460306607,1081189.5348431626,-1260.7355537573476,1079928.7992894053,2439,0,467.00995024875624,81,120,37,39.903977923954706,0.5328047263681592,45.08384146341462,8482.706950002867,104.72477716052921,0
2476,32.91810529686853,1,2,198,0.005,0.01,0.99,200,5500,4100,1400,0.7454545454545455,69,41,28,202.77287303447466,0.47333333333333333,0.7729769016328161,0.11545639097269075,1071785.9584009661,-2034.1763874056123,1069751.7820135604,2440,0,470.23,81,119,43,39.642655648480044,0.5351041666666667,44.81707317073171,8400.138455328957,103.70541302875256,0
2477,32.7811411875166,3,2,199,0.014925373134328358,0.009950248756218905,0.9900497512437811,201,5650,3600,2050,0.6371681415929203,77,36,41,196.46335546636325,0.4732483416252073,0.768012152591808,0.11289350914409989,1070241.0699719898,-3797.369647078147,1066443.7003249116,2441,0,468.44776119402985,70,131,43,39.4486469158485,0.5380907960199005,44.468896713615045,8376.601174632926,119.66573106618466,0
2478,33.14269087563669,3,0,202,0.01485148514851485,0.0,1.0,202,6500,4200,2300,0.6461538461538462,88,42,46,195.31065580779142,0.47330796512487067,0.7687649266908174,0.11369591390841252,1086189.575480863,-4471.120336248683,1081718.4551446142,2442,0,466.8811881188119,76,126,41,38.9796345222369,0.5411509900990099,43.97997835497839,8485.192435354866,111.64726888624823,0
2479,32.97082988441737,5,3,204,0.024154589371980676,0.014492753623188406,0.9855072463768116,207,5850,3900,1950,0.6666666666666666,78,39,39,186.66992023799136,0.47412762065569153,0.7631704946560871,0.11008088306073338,1084641.1124259813,-6756.026011319356,1077885.086414662,2443,0,456.57971014492756,73,134,43,38.70847510335491,0.5443840579710144,43.49662162162161,8457.129253291814,115.8510856615317,0
2480,33.184829756804056,1,4,201,0.004878048780487805,0.01951219512195122,0.9804878048780488,205,5900,4400,1500,0.7457627118644068,74,44,30,185.08871092988915,0.47369081779053085,0.761018093827456,0.10739822015423743,1086540.4384954434,-6678.726173136204,1079861.7123223073,2444,0,454.8341463414634,85,120,38,39.364862892664995,0.5411077235772358,44.10125968992249,8491.95613217057,99.90536626083023,8
2481,32.687083723868426,0,1,200,0.0,0.004975124378109453,0.9950248756218906,201,5350,3700,1650,0.6915887850467289,70,37,33,223.42210326636155,0.4732815091210614,0.7938862541309397,0.1274569903395726,1064871.0387161628,2033.1454354803227,1066904.1841516432,2445,1,463.23383084577114,65,136,43,39.04134205156745,0.5334266169154229,44.7443181818182,8343.56384258407,128.36252065513955,8
2482,32.3959326977152,4,2,202,0.0196078431372549,0.00980392156862745,0.9901960784313726,204,6400,4900,1500,0.765625,79,49,30,218.30549491889516,0.4738662706461895,0.7923961539910209,0.12580577313692445,1058565.4268217653,-981.8701187284078,1057583.556703037,2446,0,457.3872549019608,69,135,42,38.77935997438731,0.5361519607843137,44.360119047619065,8281.6923781853,120.02452722007682,0
2483,32.79280067542722,5,6,201,0.024154589371980676,0.028985507246376812,0.9710144927536232,207,6650,4800,1850,0.7218045112781954,85,48,37,207.1503876773942,0.47444714131607335,0.7840579206241931,0.12072649037466218,1075083.7269767404,-3509.1978342216644,1071574.5291425188,2447,0,445.4782608695652,77,130,37,38.63261013177571,0.5394021739130435,43.93696581196584,8397.024040473383,109.0522602658881,0
2484,33.0252131623456,0,2,199,0.0,0.009950248756218905,0.9900497512437811,201,5700,4500,1200,0.7894736842105263,69,45,24,213.6014177628636,0.4734452736318408,0.785036772369091,0.1247888995489271,1083473.044862709,386.2756981045013,1083859.3205608134,2448,1,454.2985074626866,75,126,40,38.37445600799045,0.5400082918739635,43.84594298245616,8459.542335404061,112.79389780538749,0
2485,32.6583033526575,1,0,200,0.005,0.0,1.0,200,5900,4000,1900,0.6779661016949152,78,40,38,218.8624014358354,0.4729517378559464,0.7879946223111549,0.12830086230798687,1072506.6802722127,1046.2775200705364,1073552.9577922833,2449,0,457.545,64,136,44,38.10889819909956,0.5413020833333333,43.71794871794872,8369.736974610565,130.77714022829008,0
2486,32.86389368889537,1,2,199,0.004975124378109453,0.009950248756218905,0.9900497512437811,201,5950,4100,1850,0.6890756302521008,78,41,37,216.17344711521704,0.4729425787728026,0.7865330619413089,0.12766124443884497,1081570.0043990712,611.3432294734394,1082181.3476285446,2450,0,456.2636815920398,67,134,43,37.89755990765065,0.5434286898839138,43.44362745098038,8431.441352659585,125.84240824865053,0
2487,33.302325537355536,1,2,198,0.005,0.01,0.99,200,6050,4100,1950,0.6776859504132231,80,41,39,211.00323265306173,0.4728617043551089,0.7802342857142859,0.12525632874588077,1097643.9803652463,271.2856318479626,1097915.2659970943,2451,0,458.98,70,130,44,37.83369047619043,0.5453645833333334,43.25117370892017,8550.33299447945,122.14761420684928,0
2488,33.56208997898667,5,3,200,0.024630541871921183,0.014778325123152709,0.9852216748768473,203,6150,4700,1450,0.7642276422764228,76,47,29,204.6650764112561,0.4738117592547432,0.7759623491944503,0.12281164062068567,1109636.3043838935,-1329.2401949137184,1108307.0641889798,2452,0,452.30049261083747,78,125,40,37.59048217276857,0.548747947454844,42.85337552742613,8630.378148341142,110.6458736966813,0
2489,33.12527953036996,2,2,200,0.009900990099009901,0.009900990099009901,0.9900990099009901,202,5900,3600,2300,0.6101694915254238,82,36,46,240.09982244997485,0.4736414872830567,0.8051996803664916,0.14043412920706652,1087128.1559226483,5903.855443479419,1093032.0113661278,2453,0,455.13366336633663,79,123,35,37.65077590296131,0.5423886138613861,43.80208333333334,8486.627604681786,107.42566588204792,8
2490,33.35919854730954,1,1,200,0.004975124378109453,0.004975124378109453,0.9950248756218906,201,7200,5400,1800,0.75,90,54,36,237.0407154831283,0.4731550580431177,0.8018990719114065,0.1394760085787807,1096712.6655185686,4593.110982785931,1101305.7765013545,2454,0,457.8358208955224,66,135,34,37.50075789728974,0.5446724709784412,43.57898009950247,8553.99971456428,129.60605628127695,0
2491,33.57118652280677,4,0,204,0.0196078431372549,0.0,1.0,204,5850,4200,1650,0.717948717948718,75,42,33,230.39709806219588,0.47321428571428575,0.7958636660011971,0.1368774613131207,1106758.5630674465,4348.792237244832,1111107.3553046912,2455,0,452.0686274509804,70,134,38,37.305736487258564,0.5469771241830066,43.221830985915474,8620.347806956592,123.14782581366559,0
2492,33.64513644333046,1,4,201,0.004878048780487805,0.01951219512195122,0.9804878048780488,205,7250,5300,1950,0.7310344827586207,92,53,39,249.89418279624354,0.4732325043838674,0.8126739944917252,0.14535265188680954,1102394.1124365726,6846.37516934574,1109240.4876059182,2456,0,450.85853658536587,75,130,33,37.61338589352325,0.5391260162601625,44.01041666666668,8612.80445932134,114.8373927909512,8
2493,33.88100933856885,2,3,200,0.009852216748768473,0.014778325123152709,0.9852216748768473,203,6650,4400,2250,0.6616541353383458,89,44,45,247.75095953450187,0.47262798939992523,0.8108155601843057,0.14506072992203223,1112269.3132700343,7863.157924687041,1120132.4711947213,2457,0,448.0394088669951,79,124,37,37.41472508765691,0.5416666666666667,43.763020833333364,8681.567484032588,109.89325929155174,0
2494,34.023277877781894,1,2,199,0.004975124378109453,0.009950248756218905,0.9900497512437811,201,5900,3900,2000,0.6610169491525424,79,39,40,240.56486081234954,0.47227611940298503,0.8074931812799946,0.14405938110574076,1124227.8637764785,7989.94391415058,1132217.807690629,2458,0,453.14925373134326,70,131,38,36.74416447894074,0.5472636815920398,42.92840375586853,8746.418353499004,124.94883362141435,8
2495,33.834268791816626,1,2,198,0.005,0.01,0.99,200,6300,4800,1500,0.7619047619047619,78,48,30,232.88744676271313,0.47232045644891124,0.8015055784622838,0.1369750275324776,1112196.131850012,5503.303489183072,1117699.4353391952,2459,0,451.925,66,134,36,37.62316577734658,0.5443229166666667,43.594527363184085,8675.291680886827,131.4438133467701,8
2496,33.306565158673536,0,4,194,0.0,0.020202020202020204,0.9797979797979798,198,6250,4300,1950,0.688,82,43,39,258.23594577662703,0.4721266172725564,0.8124253253018905,0.14935107677978277,1089472.9560324205,10418.21583981778,1099891.1718722384,2460,1,448.2828282828283,67,131,42,37.61984438322254,0.539614898989899,44.22487745098038,8518.990785146601,127.14911619621793,8
2497,33.45538559338704,4,1,197,0.020202020202020204,0.005050505050505051,0.9949494949494949,198,5900,4300,1600,0.7288135593220338,75,43,32,250.253283862302,0.47179386931925005,0.8012071998031416,0.14293081661580376,1090281.160017809,9069.288125531719,1099350.4481433406,2461,0,448.9848484848485,67,131,39,38.310782431297234,0.5352483164983165,44.69975490196081,8541.168141841183,127.48012152001765,8
2498,33.0061994604678,2,1,198,0.010050251256281407,0.005025125628140704,0.9949748743718593,199,5100,3400,1700,0.6666666666666666,68,34,34,245.26137952719756,0.47180874913286974,0.7972148576204909,0.14097142032505416,1077673.002266983,7962.313443043746,1085635.3157100268,2462,0,446.0502512562814,71,128,41,38.19147606106928,0.5372173366834171,44.45891203703706,8434.440119650555,118.79493126268387,0
2499,32.80978700318739,5,1,202,0.024630541871921183,0.0049261083743842365,0.9950738916256158,203,6150,4400,1750,0.7154471544715447,79,44,35,246.3633147046006,0.4728342600269879,0.804337052644073,0.14400109239776002,1076563.3224020668,6295.141719274325,1082858.464121341,2463,0,438.14778325123154,80,123,41,37.51600150602411,0.5412048440065682,43.82716049382717,8404.976300199269,105.06220375249086,0
2500,32.535202148502336,3,1,204,0.014634146341463415,0.004878048780487805,0.9951219512195122,205,7250,6000,1250,0.8275862068965517,85,60,25,221.51842636763345,0.47336601307189546,0.7872672636845603,0.12734389677478516,1062342.7606536048,-1184.300679393341,1061158.4599742114,2464,0,434.54634146341465,79,126,39,38.79229083868337,0.5386178861788617,44.45312499999999,8314.26923654304,105.24391438662074,8
2501,33.0031708392983,4,3,205,0.019230769230769232,0.014423076923076924,0.9855769230769231,208,6250,4400,1850,0.704,81,44,37,205.9870022986346,0.47405607425987856,0.7822210400513019,0.11750232957860007,1075145.6471541831,-3556.794221656468,1071588.8529325267,2465,0,429.2451923076923,69,139,43,39.48914427019569,0.5333533653846154,44.74702380952384,8424.157580453695,122.08924029643036,8
2502,33.03501864912196,4,2,207,0.019138755980861243,0.009569377990430622,0.9904306220095693,209,7000,5400,1600,0.7714285714285715,86,54,32,198.90643299989233,0.47479507882468414,0.7757918183299812,0.11466554062728011,1079557.036397258,-5853.832134056828,1073703.2042632012,2466,0,427.89473684210526,74,135,40,39.26212401079298,0.5367822966507176,44.34722222222226,8445.494281588808,114.12830110255146,0
2503,33.09494100845987,3,1,209,0.014285714285714285,0.004761904761904762,0.9952380952380953,210,6950,4500,2450,0.6474820143884892,94,45,49,216.57843165062644,0.47554160021265285,0.7982423858760637,0.12438377861170188,1080309.817400716,-2155.6388101157336,1078154.1785906004,2467,0,424.9238095238095,68,142,42,38.955933037912345,0.5359623015873016,44.48973429951691,8456.097170413403,124.35437015313828,8
2504,33.25974959614596,0,3,206,0.0,0.014354066985645933,0.9856459330143541,209,7700,5700,2000,0.7402597402597403,97,57,40,223.90700155395885,0.47539604036314564,0.8058307323186746,0.1261265145454766,1079420.5601254671,-1162.035793322459,1078258.5243321448,2468,1,427.94736842105266,61,148,43,39.523982238635355,0.5239234449760766,45.22849462365591,8473.636473050356,138.91207332869436,8
2505,33.3494022439206,1,1,206,0.004830917874396135,0.004830917874396135,0.9951690821256038,207,6500,5100,1400,0.7846153846153846,79,51,28,222.15629300120264,0.47503928052155153,0.8025015718390114,0.12574493645256407,1083900.9895170578,259.085162288869,1084160.0746793468,2469,0,431.79227053140096,61,146,41,39.379667764964296,0.5264694041867954,45.04368279569891,8502.64077707483,139.3875537225382,0
2506,33.4947339564475,1,3,204,0.004830917874396135,0.014492753623188406,0.9855072463768116,207,6850,5200,1650,0.7591240875912408,85,52,33,221.7369783207517,0.4751145193314885,0.8015391458480867,0.12617927694149442,1090366.7430525606,104.92537318291215,1090471.6684257435,2470,0,431.06280193236717,64,143,43,39.18189716534772,0.5286835748792271,44.8397435897436,8546.524904720485,133.53945163625758,0
2507,33.460435003680885,1,1,204,0.004878048780487805,0.004878048780487805,0.9951219512195122,205,6450,4700,1750,0.7286821705426356,82,47,35,238.18815339475339,0.4750936553483182,0.8100833871209603,0.13687586510749195,1092433.0987687865,4590.924500609086,1097024.0232693956,2471,0,434.0048780487805,60,145,45,38.380724850752905,0.5315548780487804,44.467213114754095,8550.238206883205,142.5039701147201,0
2508,32.990398355803606,2,1,205,0.009708737864077669,0.0048543689320388345,0.9951456310679612,206,7450,5600,1850,0.7516778523489933,93,56,37,233.06018370890058,0.47561370273896914,0.8100547561257507,0.1305137028769839,1068779.847559915,1168.0055233366957,1069947.8530832515,2472,0,430.7718446601942,65,141,37,39.52210441468252,0.5240695792880259,45.45454545454544,8397.555945113616,129.1931683863633,8
2509,32.53758106107055,2,2,205,0.00966183574879227,0.00966183574879227,0.9903381642512077,207,6250,4200,2050,0.672,83,42,41,227.2199947453635,0.47594019198599186,0.80565076901035,0.12798168046556074,1055955.6522425546,336.84755077799946,1056292.4997933325,2473,0,429.5990338164251,70,137,40,39.44296477589019,0.5259158615136876,45.23180751173709,8289.54071486928,118.42201021241827,0
2510,32.76823350442368,3,6,202,0.014423076923076924,0.028846153846153848,0.9711538461538461,208,4950,3200,1750,0.6464646464646465,67,32,35,220.79041597262756,0.47629879304471695,0.8003714447578014,0.12498914540239812,1065056.539973917,480.85529904150326,1065537.3952729586,2474,0,428.2980769230769,75,133,34,39.40906891732072,0.5279947916666667,45.038377192982445,8354.641990807115,111.39522654409487,0
2511,32.83196290938937,2,1,203,0.00980392156862745,0.004901960784313725,0.9950980392156863,204,7000,5500,1500,0.7857142857142857,85,55,30,228.8924602414456,0.4754866745548794,0.805829843367784,0.130272995029611,1068845.0085146572,1130.1127231417981,1069975.121237799,2475,0,437.4166666666667,74,130,37,38.99276072283909,0.5297691993464052,44.833333333333336,8377.622535712531,113.21111534746665,0
2512,32.32015366316075,1,3,201,0.004901960784313725,0.014705882352941176,0.9852941176470589,204,6200,4400,1800,0.7096774193548387,80,44,36,232.4044265800253,0.47557873724202326,0.8094766943278457,0.1332972201489738,1054606.4548107143,2019.0416795757315,1056625.4964902902,2476,0,438.3627450980392,61,143,39,38.602638934561,0.5317606209150327,44.53965053763442,8256.517749468429,135.35274999128572,0
2513,31.868725124893345,3,1,203,0.014705882352941176,0.004901960784313725,0.9950980392156863,204,5150,3700,1450,0.7184466019417476,66,37,29,228.0705680240698,0.4761074688496088,0.8053804855275446,0.13188428498783206,1042392.5272452672,1597.8111585749175,1043990.3384038421,2477,0,438.9019607843137,64,140,43,38.397425856307464,0.5343647875816994,44.23076923076925,8151.03931079006,127.35998923109469,0
2514,31.9000230696158,2,1,204,0.00975609756097561,0.004878048780487805,0.9951219512195122,205,7550,5500,2050,0.7284768211920529,96,55,41,221.99082999180445,0.47560078909612624,0.8012100301589915,0.12771680219009046,1041847.7930196273,-2293.868740488527,1039553.9242791388,2478,0,437.69268292682926,64,141,39,38.74950359501715,0.5344004065040651,44.423076923076934,8152.909742215294,127.38921472211396,8
2515,31.44811077432244,1,1,204,0.004878048780487805,0.004878048780487805,0.9951219512195122,205,6900,4500,2400,0.6521739130434783,93,45,48,221.3473414533702,0.475519089749721,0.7961772628316304,0.12791107633549503,1028432.1239411006,-2371.8567000788735,1026060.2672410217,2479,0,438.6146341463415,69,136,40,38.59512587765238,0.5375508130081301,44.25595238095239,8042.667139397411,116.56039332460016,8
2516,31.133615171477405,3,1,206,0.014492753623188406,0.004830917874396135,0.9951690821256038,207,6950,5300,1650,0.762589928057554,86,53,33,219.2314937755584,0.47576137767146637,0.7970027028951041,0.12798982027914496,1021208.7109458576,-3573.777768545221,1017634.9331773124,2480,0,435.1256038647343,76,131,37,38.256615433370285,0.5402576489533011,43.871753246753265,7974.19826896084,104.92366143369527,0
2517,31.392260637086085,0,3,203,0.0,0.014563106796116505,0.9854368932038835,206,5950,3800,2150,0.6386554621848739,81,38,43,215.14971247273283,0.47560580945615283,0.7921303970321234,0.1260162601626017,1030671.6822449646,-2800.2567822412448,1027871.4254627234,2481,1,438.15533980582524,79,127,38,38.23678861788619,0.5415655339805825,43.75000000000003,8044.266788253382,101.8261618766251,0
2518,31.619859268087904,2,2,203,0.00975609756097561,0.00975609756097561,0.9902439024390244,205,6500,4700,1800,0.7230769230769231,83,47,36,218.5397249138283,0.47590865614538497,0.7960244765084628,0.12939082168173005,1041402.2643190296,-1982.447126216327,1039419.8171928133,2482,0,439.1658536585366,69,136,38,37.73935322084999,0.5439532520325203,43.348214285714285,8115.293345189168,117.61294703172707,0
2519,31.851667340953444,1,1,203,0.004901960784313725,0.004901960784313725,0.9950980392156863,204,6350,4400,1950,0.6929133858267716,83,44,39,217.70538571016905,0.4754922083776039,0.7925570044144423,0.1294818361906314,1050407.9014469343,-1414.1085324972341,1048993.7929144371,2483,0,441.87254901960785,74,130,41,37.589457934490646,0.545343137254902,43.18055555555555,8180.127511132905,110.54226366395818,0
2520,32.197680877044895,0,1,202,0.0,0.0049261083743842365,0.9950738916256158,203,6150,4300,1850,0.6991869918699187,80,43,37,219.21764025681236,0.47505649579736303,0.7926625055506911,0.13075946682655062,1062703.4310556625,-157.3323102319846,1062546.0987454304,2484,1,444.70935960591135,76,127,35,37.44131300898625,0.5467980295566502,43.07359307359307,8272.434459102209,108.84782183029222,0
2521,32.016051761152326,1,1,202,0.0049261083743842365,0.0049261083743842365,0.9950738916256158,203,7150,5100,2050,0.7132867132867133,92,51,41,221.89886177999836,0.47489493407468825,0.7962392875038062,0.13325401091568134,1058750.2251642125,-762.9060253487314,1057987.3191388638,2485,0,439.29064039408865,79,124,37,37.118848412738615,0.5492610837438423,42.82552083333334,8233.711436647414,104.22419540060018,0
2522,31.589160020922773,0,1,201,0.0,0.0049504950495049506,0.995049504950495,202,5550,3800,1750,0.6846846846846847,73,38,35,222.8256424325562,0.4743172544866427,0.7967079819093028,0.13405285975220624,1045172.4811058196,628.2459110465816,1045800.7270168662,2486,1,442.4059405940594,81,121,39,37.02716049382716,0.5506910066006601,42.75914634146341,8126.022490138283,100.32126531034916,0
2523,31.49923070200793,0,2,199,0.0,0.009950248756218905,0.9900497512437811,201,6200,4400,1800,0.7096774193548387,80,44,36,220.19161986885646,0.4739604063018242,0.7939294146792251,0.13293834673089405,1043248.470879711,-457.08585425766796,1042791.3850254533,2487,2,443.30348258706465,65,136,41,36.96233468244719,0.5522388059701493,42.6294191919192,8106.975300783526,124.72269693513117,0
2524,31.60739472958036,0,1,198,0.0,0.005025125628140704,0.9949748743718593,199,5300,3600,1700,0.6792452830188679,70,36,34,226.54809542345365,0.47369422871935435,0.792656068913443,0.13059316852016115,1032886.5584328766,1699.696520290976,1034586.2549531675,2488,3,448.321608040201,72,127,41,38.55759749199968,0.5399392797319933,44.34931506849316,8080.452111517749,112.22850154885762,8
2525,31.307170077177766,3,3,198,0.014925373134328358,0.014925373134328358,0.9850746268656716,201,6050,5000,1050,0.8264462809917356,71,50,21,227.60378138838738,0.47399771973466004,0.7964284474898802,0.13244692370829875,1025925.3928369331,450.89976641084604,1026376.292603344,2489,0,444.7164179104478,76,125,32,38.16670189530054,0.5428067993366501,43.99350649350652,8014.8388330697635,105.45840569828636,0
2526,30.978299968005157,3,3,198,0.014925373134328358,0.014925373134328358,0.9850746268656716,201,5400,3700,1700,0.6851851851851852,71,37,34,213.0380748091869,0.47418843283582085,0.7797358901701399,0.12522801060687322,1018143.9408097861,-2219.314994249221,1015924.6258155368,2490,0,445.07960199004975,69,132,39,38.154117573084164,0.5472118573797679,43.6160714285714,7942.338246261259,115.10635139509071,8
2527,30.646554687355557,2,4,196,0.01,0.02,0.98,200,6100,4500,1600,0.7377049180327869,77,45,32,206.82407106295906,0.47422476968174204,0.7728385639970279,0.12243565059574689,1009301.9002841365,-4350.41441033115,1004951.4858738054,2491,0,446.92,70,130,43,38.04581356352064,0.54953125,43.353873239436595,7865.31955906554,112.36170798665057,0
2528,31.05664766665727,4,3,197,0.02,0.015,0.985,200,6100,4600,1500,0.7540983606557377,76,46,30,197.76840392834487,0.47485395728643215,0.7621279675738286,0.11818201854126287,1025582.7521412078,-5534.427202519071,1020048.3249386888,2492,0,444.065,76,124,38,37.92342211928198,0.5525520833333333,43.00595238095236,7981.373589332849,105.01807354385328,0
2529,30.793123960899162,1,0,198,0.005050505050505051,0.0,1.0,198,5350,3500,1850,0.6542056074766355,72,35,37,200.0770853165883,0.47460059563485957,0.7629252953341463,0.12000885360391167,1017967.7469296823,-4215.596049603314,1013752.150880079,2493,0,449.24747474747477,77,121,39,37.7239794328451,0.5547664141414141,42.868589743589716,7917.879390266397,102.82960247099217,0
2530,30.73324903793587,1,0,199,0.005025125628140704,0.0,1.0,199,5400,3800,1600,0.7037037037037037,70,38,32,199.43776036658295,0.4744207146845338,0.7650264550416146,0.12024540663697166,1017487.2413479919,-4614.9246767966515,1012872.3166711952,2494,0,447.9849246231156,70,129,40,37.5470380295342,0.5565850083752093,42.67899061032865,7908.310664265822,112.97586663236889,0
2531,31.130203241008697,0,1,198,0.0,0.005025125628140704,0.9949748743718593,199,6000,3900,2100,0.65,81,39,42,195.74240380003968,0.47385285010913153,0.7604419035820897,0.11847635665092647,1031766.1424746572,-5407.923022503255,1026358.2194521539,2495,1,448.9849246231156,72,127,42,37.49745977202605,0.5582077051926297,42.537100456621005,8014.872389804797,111.31767208062219,0
2532,31.271118509102223,0,1,197,0.0,0.005050505050505051,0.9949494949494949,198,5600,3900,1700,0.6964285714285714,73,39,34,202.42684126750856,0.4734656206737425,0.771697577404634,0.12199801328168935,1035174.8208402355,-3290.56617153025,1031884.2546687052,2496,2,448.9191919191919,71,127,40,37.48529894105521,0.5605008417508417,42.693865740740755,8046.250617540296,113.32747348648304,8
2533,31.24152360105076,1,1,197,0.005050505050505051,0.005050505050505051,0.9949494949494949,198,6150,4600,1550,0.7479674796747967,77,46,31,202.6795664247958,0.4733561289716112,0.7728840315725567,0.12314196764853182,1036569.6380326367,-3731.7030388873727,1032837.9349937494,2497,0,444.42929292929296,73,125,39,37.17759562841533,0.5624473905723906,42.39864864864867,8047.858697905848,110.24463969734039,0
2534,31.695283321790676,1,1,197,0.005050505050505051,0.005050505050505051,0.9949494949494949,198,5850,3900,1950,0.6666666666666666,78,39,39,200.7962832952903,0.47291655984549386,0.7696325853170529,0.12250829419027333,1052864.9170971254,-3167.7275669783976,1049697.189530147,2498,0,445.25252525252523,78,120,43,37.07124769797424,0.5643939393939394,42.246835443037995,8169.5595777210965,104.73794330411663,0
2535,31.8008637798035,0,0,197,0.0,0.0,1.0,197,7550,5600,1950,0.7417218543046358,95,56,39,228.93428759981958,0.47258516350702723,0.7890978964259485,0.1373416053446813,1051334.0126054203,1187.2806410567655,1052521.2932464771,2499,1,448.48223350253807,87,110,37,36.97545036750601,0.5575296108291032,42.86221590909093,8177.2036445155745,93.99084648868477,8
2536,31.378680584750345,2,0,199,0.010050251256281407,0.0,1.0,199,5200,3800,1400,0.7307692307692307,66,38,28,247.17339943060045,0.47288208720369523,0.8046202697903855,0.1475896656715667,1035984.4090028923,6213.557626069307,1042197.9666289616,2500,0,444.964824120603,66,133,33,36.68333030816395,0.5471105527638191,43.03482587064677,8063.2281204097335,122.17012303651111,8
2537,30.9098214710466,1,0,200,0.005,0.0,1.0,200,6400,4900,1500,0.765625,79,49,30,248.50290373557738,0.4730208333333333,0.8061855823652064,0.1490218377706919,1021760.0090002351,4382.065831489622,1026142.0748317247,2501,0,443.735,67,133,35,36.48725300367391,0.5491145833333333,42.876838235294116,7947.631026218094,118.62135860027006,0
2538,30.978602790300595,1,1,200,0.004975124378109453,0.004975124378109453,0.9950248756218906,201,5800,4200,1600,0.7241379310344828,74,42,32,241.42096569916907,0.4732773631840796,0.809145296348132,0.14190574276464368,1018140.7612171393,3160.1051581455795,1021300.8663752849,2502,0,442.5223880597015,62,139,39,37.428119222666496,0.5447242951907131,43.61772486772485,7942.364663796283,128.102655867682,8
2539,31.15535497509241,0,1,199,0.0,0.005,0.995,200,6950,5000,1950,0.7194244604316546,89,50,39,221.30690610721064,0.4729506909547739,0.7829404289925783,0.1293521114305788,1022269.9676231507,-1702.919251800282,1020567.0483713504,2503,1,445.73,79,121,40,38.15886449120667,0.5431770833333334,43.828125000000014,7981.125700260036,101.0269075982283,8
2540,30.959171742965452,1,2,198,0.005,0.01,0.99,200,6650,4400,2250,0.6616541353383458,89,44,45,224.88559367347386,0.47309306951423785,0.7865728344204144,0.13234176451935908,1017849.6795332287,-870.0541095630288,1016979.6254236657,2504,0,445.13,70,130,37,37.807291070679334,0.5452604166666667,43.57394366197182,7938.738317540322,113.41054739343318,0
2541,31.49459287306395,6,1,203,0.029411764705882353,0.004901960784313725,0.9950980392156863,204,6750,5200,1550,0.7703703703703704,83,52,31,221.8179241898535,0.47417415241958855,0.7852805070904516,0.12741895442703255,1028132.4419345063,-1938.3591875685088,1026194.0827469378,2505,0,436.79411764705884,73,131,36,38.81413434699573,0.5357434640522876,44.48198198198199,8047.43594920971,110.2388486193111,8
2542,31.789720806525178,3,5,201,0.014563106796116505,0.024271844660194174,0.9757281553398058,206,6000,3800,2200,0.6333333333333333,82,38,44,209.9967504410743,0.4741608453705896,0.7827396022667434,0.12383557945100178,1045782.8975531339,-3277.7979693984507,1042505.0995837355,2506,0,433.5339805825243,69,137,40,38.110544661677395,0.5433353559870551,43.49702380952379,8154.15799913797,118.17620288605754,8
2543,31.92229390978564,0,3,198,0.0,0.014925373134328358,0.9850746268656716,201,6250,4400,1850,0.704,81,44,37,227.05784191603004,0.47319237147595355,0.7973279530417379,0.12923598108114678,1039247.9062796993,743.8773631240542,1039991.7836428233,2507,1,445.09452736318406,78,123,38,39.037416459969656,0.5324937810945274,44.831223628691966,8145.572675925216,104.43041892211815,7
2544,31.510632565312417,3,2,199,0.014925373134328358,0.009950248756218905,0.9900497512437811,201,6200,4800,1400,0.7741935483870968,76,48,28,220.89972923380424,0.47338515754560534,0.7929404675294145,0.12686555538792418,1028593.6362331574,-956.7888528964195,1027636.8473802609,2508,0,445.9800995024876,68,133,40,38.845519448547506,0.5350331674958541,44.4897342995169,8051.290099153245,118.40132498754772,0
2545,32.02372886405747,1,1,199,0.005,0.005,0.995,200,6350,5000,1350,0.7874015748031497,77,50,27,218.85255965259302,0.4731469849246231,0.7902891566265062,0.12639496735403227,1047074.3360576178,-519.0202814501472,1046555.3157761677,2509,0,449.05,70,130,41,38.68163128705298,0.536875,44.278169014084504,8189.166580113279,116.98809400161828,0
2546,31.77721022068302,2,2,199,0.009950248756218905,0.009950248756218905,0.9900497512437811,201,6600,4300,2300,0.6515151515151515,89,43,46,214.93929679951822,0.4733571724709784,0.785635272238401,0.12522124392394895,1041679.8046552216,-2020.4150594294315,1039659.3895957922,2510,0,447.72636815920396,77,124,41,38.44680670734886,0.5394900497512438,43.95032051282051,8136.544492002607,105.66940898704684,0
2547,32.228271570397425,0,0,199,0.0,0.0,1.0,199,6700,5000,1700,0.746268656716418,84,50,34,225.4578273181845,0.47306608801583677,0.7885576434726764,0.12814352704183607,1048764.5231119469,790.4341498417043,1049554.9572617887,2511,1,453.2211055276382,88,111,37,39.133539019131014,0.5340766331658291,44.88529962546813,8221.905845270883,93.43074824171458,8
2548,32.00523926490358,3,0,202,0.01485148514851485,0.0,1.0,202,6250,4600,1650,0.736,79,46,33,219.2725754919588,0.4731006682757828,0.785915500640973,0.12586329048637154,1044572.133473087,-840.7956012449904,1043731.337871842,2512,0,447.4752475247525,73,129,39,38.90794306703401,0.536509900990099,44.51013513513515,8177.014254757918,112.01389390079339,0
2549,32.33442948677762,2,1,203,0.00980392156862745,0.004901960784313725,0.9950980392156863,204,6050,4500,1550,0.743801652892562,76,45,31,217.8935710404379,0.4734467062687144,0.7850425302503885,0.12586558044806528,1057293.917521413,-774.490534384784,1056519.4269870282,2513,0,444.078431372549,77,127,40,38.69865919891379,0.5383986928104575,44.27083333333335,8268.856707295776,107.38774944539969,0
2550,31.883982588258476,3,5,201,0.014563106796116505,0.024271844660194174,0.9757281553398058,206,6150,4500,1650,0.7317073170731707,78,45,33,216.24961476747012,0.4738105809456153,0.7860015121707182,0.12599102837806758,1045195.4548858212,-2145.3771048461485,1043050.077780975,2514,0,440.7281553398058,83,123,32,38.41130698695598,0.5411104368932038,43.948412698412696,8163.944351219743,98.36077531590053,0
2551,31.724853921065748,1,3,199,0.0049504950495049506,0.01485148514851485,0.9851485148514851,202,6250,4600,1650,0.736,79,46,33,219.5341197831399,0.4729056860909972,0.7857844214525807,0.1281966194750822,1040673.3566942037,-957.3381312741949,1039716.0185629295,2515,0,448.58910891089107,82,120,34,38.239869665343704,0.5423886138613861,43.86295180722893,8125.910437688682,99.09646875230099,0
2552,31.78999768100791,2,2,199,0.009950248756218905,0.009950248756218905,0.9900497512437811,201,5600,4400,1200,0.7857142857142857,68,44,24,215.6957636705832,0.4724813432835821,0.7819355756975854,0.12661835287227408,1044409.1565910318,-745.0738769094187,1043664.0827141224,2516,0,451.30348258706465,74,127,37,38.13766525791071,0.5450870646766169,43.66666666666668,8148.836072231718,110.1194063815097,0
2553,32.20632280046394,1,2,198,0.005,0.01,0.99,200,6600,5000,1600,0.7575757575757576,82,50,32,190.24102701633674,0.47223408710217757,0.7559445934791564,0.10949026329230087,1051965.02136747,-6574.618789957654,1045390.4025775124,2517,0,453.71,78,122,40,39.54689864493051,0.5397916666666667,44.40928270042196,8231.637146152387,105.53380956605623,8
2554,32.2501362359149,2,1,199,0.01,0.005,0.995,200,7100,5500,1600,0.7746478873239436,87,55,32,185.7199599736818,0.47213463149078727,0.749767745827467,0.10751866832935124,1055227.1464476248,-7904.651319720604,1047322.4951279042,2518,0,454.56,80,120,45,39.43628929552917,0.541875,44.187242798353935,8249.996270638178,103.12495338297722,0
2555,32.195408009407096,5,3,201,0.024509803921568627,0.014705882352941176,0.9852941176470589,204,5150,3500,1650,0.6796116504854369,68,35,33,182.49322443069124,0.472566325380727,0.749430886574149,0.10685685936270699,1056948.237155901,-7372.821629016516,1049575.4155268846,2519,0,446.3872549019608,92,112,41,39.08501624630273,0.5451388888888888,43.761200716845906,8249.7126907618,89.6707901169761,0
2556,31.959060621789632,2,4,199,0.009852216748768473,0.019704433497536946,0.9802955665024631,203,5950,4400,1550,0.7394957983193278,75,44,31,192.0951642542783,0.4726950527565072,0.7617670539919603,0.11169978069600624,1047056.6468865828,-6323.096286557626,1040733.5506000252,2520,0,449.1625615763547,91,112,38,39.10452052370844,0.5430521346469622,44.02173913043478,8180.824756990711,89.89917315374407,8
2557,32.38711591447993,0,1,198,0.0,0.005025125628140704,0.9949748743718593,199,5900,4100,1800,0.6949152542372882,77,41,36,194.0884742652371,0.4723343146709981,0.7587576583101576,0.11324359325281216,1062139.5529888663,-4470.190940726028,1057669.3620481403,2521,1,458.00502512562815,93,106,38,38.92333917470759,0.5447026800670016,43.89406028368794,8294.532755978998,89.1885242578387,0
2558,32.08410868724876,1,3,196,0.005025125628140704,0.01507537688442211,0.9849246231155779,199,6500,5000,1500,0.7692307692307693,80,50,30,195.77398012701914,0.4722920156337242,0.7615164280058966,0.11475178308511051,1053611.8426172442,-5046.043212371658,1048565.7994048726,2522,0,458.47738693467335,75,124,40,38.705342817413644,0.5467441373534339,43.72258771929827,8222.432349700946,109.63243132934595,0
2559,32.149254175049826,0,0,196,0.0,0.0,1.0,196,5400,3800,1600,0.7037037037037037,70,38,32,197.12890624999932,0.47187009419152276,0.7576626275510208,0.11595818014705897,1056845.962361932,-2933.0222729726966,1053912.9400889594,2523,1,465.86224489795916,77,119,40,38.53515625000002,0.5492134353741497,43.589743589743605,8243.39850642307,107.05712346003986,0
2560,32.280248278112374,2,2,196,0.010101010101010102,0.010101010101010102,0.98989898989899,198,6250,4800,1450,0.768,77,48,29,198.87936945354815,0.47206572920405404,0.7628462410683734,0.11776549766821574,1063191.3131708268,-3560.6364056188754,1059630.676765208,2524,0,462.14646464646466,81,117,43,38.2391275654986,0.5510837542087542,43.34349593495938,8284.935673411946,102.28315646187588,0
2561,32.39055177469669,0,1,195,0.0,0.00510204081632653,0.9948979591836735,196,6100,4100,2000,0.6721311475409836,81,41,40,201.06010256276747,0.4718303026338741,0.7644136103494594,0.11923831750914984,1067293.7083980604,-2381.9635049776757,1064911.7448930827,2525,1,466.69897959183675,80,116,43,38.1255635707845,0.5528805272108843,43.28703703703705,8315.074518087686,103.93843147609607,0
2562,32.19364613939878,1,1,195,0.00510204081632653,0.00510204081632653,0.9948979591836735,196,6300,4200,2100,0.6666666666666666,84,42,42,203.6491001161021,0.4717670722135008,0.7686295785872401,0.12141002610374897,1062411.7478687665,-2228.1607187502022,1060183.5871500163,2526,0,467.07142857142856,83,113,40,37.86086507055396,0.5543686224489797,43.09275793650793,8270.780841640908,99.64796194748082,0
2563,32.536447030638804,1,2,194,0.00510204081632653,0.01020408163265306,0.9897959183673469,196,6150,4400,1750,0.7154471544715447,79,44,35,194.75431058558436,0.47145364556078845,0.7622149988715119,0.11756297716078203,1077554.3402778588,-3378.329468136257,1074176.0108097226,2527,0,467.765306122449,70,126,45,37.62268175426595,0.5592049319727892,42.6349765258216,8373.743453806732,119.6249064829533,8
2564,32.97335157907582,0,4,190,0.0,0.020618556701030927,0.979381443298969,194,6750,5500,1250,0.8148148148148148,80,55,25,189.92528890083318,0.4707197131563485,0.7540273787392269,0.11539285481026718,1094030.3535611113,-3993.193806725032,1090037.1597543862,2528,1,472.41752577319585,73,121,46,37.50614754098363,0.5612650343642611,42.39864864864865,8493.979925353153,116.35588938839935,0
2565,32.50737886101591,1,0,191,0.005235602094240838,0.0,1.0,191,6650,5100,1550,0.7669172932330827,82,51,31,189.69326698839075,0.47007440066133926,0.7508500131070934,0.11609919079764457,1080798.1332293379,-3845.9742305544514,1076952.1589987834,2529,0,480.18324607329845,75,116,46,37.24110591403566,0.5631544502617801,42.1326754385965,8382.59081539412,111.76787753858827,0
2566,32.10496627560308,2,4,189,0.010362694300518135,0.02072538860103627,0.9792746113989638,193,5900,3800,2100,0.6440677966101694,80,38,42,183.88597308293328,0.4700734473949338,0.7443630356100477,0.11323742233204616,1069254.740774935,-5175.810303812355,1064078.9304711227,2530,0,476.1968911917098,80,113,41,37.165113691099066,0.5655224525043178,41.91100823045267,8285.93837686571,103.57422971082137,0
2567,32.26588726270398,1,0,190,0.005263157894736842,0.0,1.0,190,6100,4700,1400,0.7704918032786885,75,47,28,191.6665726700026,0.46901455026455025,0.7499308051416516,0.11846019022785509,1075708.6312352181,-2864.522691921309,1072844.1085432968,2531,0,484.29473684210524,82,108,43,36.83039692183069,0.5674890350877193,41.779618473895574,8331.709719253675,101.60621608845945,0
2568,32.434810275823544,1,4,187,0.005235602094240838,0.020942408376963352,0.9790575916230366,191,6350,4500,1850,0.7086614173228346,82,45,37,189.73428936830567,0.468936575732525,0.7490592094311181,0.11801578500262597,1083256.5592811357,-3443.8173042475496,1079812.7419768882,2532,0,482.75392670157066,71,120,45,36.64726078519182,0.5693717277486912,41.55092592592593,8382.74668355487,118.0668546979559,0
2569,32.72964728863032,0,2,185,0.0,0.0106951871657754,0.9893048128342246,187,6500,4700,1800,0.7230769230769231,83,47,36,193.37346342255213,0.4683852279914899,0.7471770108217206,0.12091421495645228,1094695.041290829,-1563.005694819713,1093132.0355960093,2533,1,492.9144385026738,71,116,46,36.36149102198356,0.5711898395721925,41.36284722222223,8465.102786152274,119.22679980496162,0
2570,32.927089184907274,0,2,183,0.0,0.010810810810810811,0.9891891891891892,185,6650,5100,1550,0.7669172932330827,82,51,31,191.19312743798108,0.4679837446141794,0.7415959851943743,0.12013933154732516,1102787.7934486365,-1480.9105740247778,1101306.8828746118,2534,2,497.6702702702703,73,112,44,36.23975669893759,0.5733671171171171,41.188063063063076,8521.923729641156,116.73868122796104,0
2571,33.35814070313694,2,3,182,0.010810810810810811,0.016216216216216217,0.9837837837837837,185,5550,3800,1750,0.6846846846846847,73,38,35,195.55790740403327,0.46812573443008226,0.7487811979852501,0.12397294863870362,1119928.9486693025,1252.1923285935445,1121181.140997896,2535,0,490.68108108108106,74,111,38,35.80760572439302,0.5754504504504505,40.875,8643.928209700358,116.80984067162646,0
2572,32.83687661568884,0,1,181,0.0,0.005494505494505495,0.9945054945054945,182,5900,4200,1700,0.711864406779661,76,42,34,193.11691534628233,0.4676685538218687,0.736433821898155,0.11858336206800668,1092759.265215955,-93.9402970848414,1092665.32491887,2536,1,497.4945054945055,77,105,44,37.031740690892775,0.5661057692307692,42.01388888888889,8471.45809911696,110.01893635216832,8
2573,32.95574360495897,1,2,180,0.005494505494505495,0.01098901098901099,0.989010989010989,182,5500,4400,1100,0.8,66,44,22,196.0157701495992,0.46749084249084244,0.7407947462842013,0.12112896266455053,1098659.0029879664,1170.898120495443,1099829.901108462,2537,0,498.467032967033,78,104,47,36.72392296039083,0.5677655677655677,41.78533755274262,8509.656210652849,109.0981565468314,0
2574,33.24475361539792,0,3,177,0.0,0.016666666666666666,0.9833333333333333,180,5500,4100,1400,0.7454545454545455,69,41,28,194.07800731426738,0.4669434098903373,0.7358580546303339,0.12037901193073769,1109442.4425584679,1563.6756963241728,1111006.118254792,2538,1,504.44444444444446,68,112,48,36.63759520052981,0.5697916666666667,41.651570048309175,8588.729900668837,126.30485148042408,0
2575,33.60767763947499,1,0,178,0.0056179775280898875,0.0,1.0,178,5850,4200,1650,0.717948717948718,75,42,33,206.24220838924646,0.4667741858693582,0.7515251258013376,0.12320542396446568,1109721.1309186853,4324.267347376152,1114045.3982660614,2539,0,508.0730337078652,73,105,40,37.71796486999707,0.5574087078651686,43.018018018018005,8636.56760960379,118.30914533703822,8
2576,33.51536994234763,1,3,176,0.00558659217877095,0.01675977653631285,0.9832402234636871,179,4800,3800,1000,0.7916666666666666,58,38,20,205.84880019680173,0.4666177578306447,0.7535957258602517,0.12360030611943106,1108292.3592245055,5028.13048272931,1113320.4897072348,2540,0,506.2290502793296,76,103,43,37.53627476766617,0.559066573556797,42.83008658008657,8619.144786309884,113.40979981986689,0
2577,33.120856676339244,1,1,176,0.005649717514124294,0.005649717514124294,0.9943502824858758,177,5550,4200,1350,0.7567567567567568,69,42,27,204.69627440063618,0.4663879258688581,0.7487705004538066,0.1235872995065498,1096966.760797465,3959.0018153151273,1100925.76261278,2541,0,511.89830508474574,64,113,46,37.35990037359902,0.5619703389830508,42.62820512820514,8524.374330480923,133.19334891376442,0
2578,32.72711165943683,2,1,177,0.011235955056179775,0.0056179775280898875,0.9943820224719101,178,6100,4800,1300,0.7868852459016393,74,48,26,239.2880489274786,0.4662716360904801,0.7799023510616427,0.13970488555190574,1073489.8176780888,9674.656803140819,1083164.4744812297,2542,0,509.85393258426967,77,101,36,37.74131211220604,0.5519077715355805,43.8701923076923,8382.388815656217,108.86219241111971,8
2579,32.596593051714216,0,1,176,0.0,0.005649717514124294,0.9943502824858758,177,5100,3600,1500,0.7058823529411765,66,36,30,237.76577766922424,0.46571247431946583,0.7772487118373157,0.1391633377169531,1069989.272998079,10381.366318423075,1080370.639316502,2543,1,513.728813559322,77,100,38,37.684596407102404,0.5530838041431262,43.77670940170939,8352.006334003561,108.46761472731897,0
2580,32.241905443366235,2,2,176,0.011235955056179775,0.011235955056179775,0.9887640449438202,178,6200,4400,1800,0.7096774193548387,80,44,36,231.06942476325327,0.46556674390063263,0.7717465936918306,0.13599948887833005,1060064.5131508352,7189.699453140132,1067254.2126039753,2544,0,499.0056179775281,68,110,40,37.643500529848076,0.5550678838951311,43.56884057971013,8267.829194761724,121.58572345237829,0
2581,31.89962369863569,1,3,174,0.005649717514124294,0.01694915254237288,0.9830508474576272,177,5600,4100,1500,0.7321428571428571,71,41,30,210.6926420405032,0.46531522855675395,0.7494774950293868,0.12144125955931662,1042405.5793689588,2925.4371190017787,1045331.0164879606,2545,0,502.6214689265537,75,102,42,38.966777468010605,0.5470809792843692,44.35307017543862,8155.0408611150815,108.73387814820109,8
2582,31.53580596689988,0,0,174,0.0,0.0,1.0,174,5550,4100,1450,0.7387387387387387,70,41,29,213.6210796460368,0.46456077115584793,0.7495300045582765,0.12348727838274703,1031401.045586176,3715.800981234393,1035116.8465674104,2546,1,510.12068965517244,75,99,42,38.77992140050019,0.5488505747126438,44.243421052631604,8065.48984844238,107.5398646458984,0
2583,31.117554377011306,0,0,174,0.0,0.0,1.0,174,5150,3400,1750,0.6601941747572816,69,34,35,216.3461854985585,0.4644182003410626,0.7526262116126397,0.12539857206050484,1018526.6341907034,4120.870427169281,1022647.5046178726,2547,2,511.12068965517244,76,98,34,38.60693262130107,0.5502873563218391,44.14231601731605,7961.665394107418,104.75875518562393,0
2584,31.410427376203852,4,0,178,0.02247191011235955,0.0,1.0,178,5250,3200,2050,0.6095238095238096,73,32,41,206.26331012409884,0.4656917200956432,0.7500382769207634,0.1210097372018376,1031761.385908559,1712.9037431452443,1033474.2896517043,2548,0,500.6123595505618,67,111,42,38.40196429994422,0.5482209737827715,43.68872549019606,8050.846673692413,120.16189065212556,8
2585,31.777342121067363,6,1,183,0.03260869565217391,0.005434782608695652,0.9945652173913043,184,5650,4000,1650,0.7079646017699115,73,40,33,193.78340495944968,0.46714567494258336,0.7398312479114852,0.11518800365863682,1047783.798559036,-1841.3775707769655,1045942.420988259,2549,0,485.2554347826087,75,109,47,38.22543054369484,0.5518002717391304,43.2017543859649,8160.365706967043,108.8048760928939,0
2586,31.880316749048067,1,6,178,0.005434782608695652,0.03260869565217391,0.967391304347826,184,5250,3800,1450,0.7238095238095238,67,38,29,196.26346624658592,0.46739563534489587,0.7420274237881064,0.117180834258991,1052520.4077163292,-735.7392972646949,1051784.6684190645,2550,0,485.8478260869565,78,106,33,37.99474890530925,0.5531589673913043,43.037974683544306,8192.030759565518,105.0260353790451,0
2587,32.105144494049675,2,1,179,0.011111111111111112,0.005555555555555556,0.9944444444444445,180,5850,4000,1850,0.6837606837606838,77,40,37,205.46439028386516,0.4664151406993586,0.750024297592168,0.12272226356904042,1060061.839037155,1710.9918841922645,1061772.8309213473,2551,0,497.60555555555555,75,105,34,37.74362410439665,0.5538773148148148,43.0235745614035,8250.265270270504,110.00353693694005,0
2588,32.04176001085927,0,1,178,0.0,0.00558659217877095,0.994413407821229,179,5900,4300,1600,0.7288135593220338,75,43,32,205.7903576444817,0.465701044085954,0.7500939330702627,0.1232019022041721,1058671.151179437,1872.8629658220925,1060544.014145259,2552,1,501.3854748603352,76,103,36,37.64823001087607,0.555633147113594,42.93831168831167,8236.708924869381,108.37774901143922,0
2589,32.28523874878236,0,0,178,0.0,0.0,1.0,178,5400,3800,1600,0.7037037037037037,70,38,32,207.04621447065918,0.46569701009331554,0.750468583479972,0.1242734919757732,1067501.8384384103,3204.442917828124,1070706.2813562385,2553,2,503.4269662921348,76,102,38,37.5192891086678,0.5568820224719101,42.843614718614695,8302.355294583333,109.24151703399122,0
2590,32.18930047228995,2,1,179,0.011111111111111112,0.005555555555555556,0.9944444444444445,180,5200,3900,1300,0.75,65,39,26,212.39039977715026,0.46649143906476304,0.7591071139199488,0.1273723184669382,1064069.8862037214,3999.645704326982,1068069.5319080483,2554,0,498.8222222222222,74,106,39,37.41391184573004,0.5558449074074074,42.875,8276.67388393755,111.84694437753447,8
2591,31.93880524229806,0,1,178,0.0,0.00558659217877095,0.994413407821229,179,5700,4100,1600,0.7192982456140351,73,41,32,212.2085453709118,0.4658435858807775,0.7583228970230573,0.12765649596922168,1056719.5836708474,3348.985143148966,1060068.5688139964,2555,1,502.5754189944134,77,102,42,37.302936697469946,0.5575535381750465,42.761752136752115,8215.882299374214,106.69977012174304,0
2592,31.769117495514543,2,0,180,0.011111111111111112,0.0,1.0,180,6000,4300,1700,0.7166666666666667,77,43,34,208.53440896098402,0.4658125129319263,0.7562806530504322,0.126368544146869,1053295.6499702407,1929.6771655439634,1055225.3271357846,2556,0,500.7,67,113,40,37.1239837398374,0.5595486111111111,42.49387254901961,8180.742418805153,122.10063311649482,0
2593,32.10039746129287,1,0,181,0.0055248618784530384,0.0,1.0,181,5800,4400,1400,0.7586206896551724,72,44,28,204.068488696033,0.465749693063229,0.7523813427029256,0.12453693175017352,1066399.8540600636,1523.7213127414475,1067923.5753728051,2557,0,498.9281767955801,72,109,42,36.977321375848845,0.5619244935543278,42.23744292237443,8274.280532830964,114.92056295598562,0
2594,32.21672621193745,1,1,181,0.005494505494505495,0.005494505494505495,0.9945054945054945,182,6250,4600,1650,0.736,79,46,33,206.34364802132367,0.46565238398801934,0.7569152331223707,0.12680271085981262,1072352.5281619527,1604.6265251653645,1073957.154687118,2558,0,497.18131868131866,74,108,36,36.66215840376092,0.5640453296703296,41.986111111111114,8312.362817210593,112.3292272596026,0
2595,32.43213027560494,1,1,181,0.005494505494505495,0.005494505494505495,0.9945054945054945,182,4250,2500,1750,0.5882352941176471,60,25,35,209.28748548844487,0.46568527007062915,0.761201475054871,0.12913298378477928,1080743.0475588841,4587.198976543617,1085330.2465354279,2559,0,498.1758241758242,77,105,38,36.43731786594934,0.5653044871794872,41.840277777777786,8372.669743025115,108.73597068863786,0
2596,32.52563081302199,0,3,178,0.0,0.016574585635359115,0.9834254143646409,181,5400,3800,1600,0.7037037037037037,70,38,32,223.86094680387322,0.4654005524861879,0.7697272420430161,0.13008721453211874,1065417.482217277,6101.07326211159,1071518.5554793885,2560,1,501.9171270718232,87,94,34,38.31611594135875,0.5512776243093922,44.045928030303024,8325.067649976003,95.69043275834485,8
2597,32.43258172843479,2,0,180,0.011111111111111112,0.0,1.0,180,5550,4100,1450,0.7387387387387387,70,41,29,223.87439546038655,0.4658855783157459,0.7719496552829905,0.1307735261758251,1063989.914410704,6090.019772928674,1070079.9341836327,2561,0,501.93888888888887,92,88,37,38.11628186628186,0.5546296296296296,43.85080645161289,8307.579654430683,90.29977885250743,0
2598,32.140022564589096,1,2,179,0.0055248618784530384,0.011049723756906077,0.988950276243094,181,5550,4100,1450,0.7387387387387387,70,41,29,216.600232705342,0.46576376099856764,0.7657554583029129,0.12735863716005522,1056414.0952576606,4013.907773202486,1060428.0030308631,2562,0,500.16022099447514,71,110,39,38.05180942707747,0.556226979742173,43.60532407407407,8240.530669699752,116.06381224929228,0
2599,31.836111788677872,2,2,179,0.011049723756906077,0.011049723756906077,0.988950276243094,181,4900,3700,1200,0.7551020408163265,61,37,24,204.46020508671222,0.46581747493349707,0.7501635243929017,0.11866467391160562,1042447.9939718834,1527.8261279447534,1043975.8200998282,2563,0,500.68508287292815,81,100,36,38.860707785223816,0.5502992633517496,44.09298780487806,8147.084247750476,100.58128700926513,8
2600,31.92093632119565,2,0,181,0.011049723756906077,0.0,1.0,181,5700,4100,1600,0.7192982456140351,73,41,32,201.83135619339927,0.4654082259054635,0.7481524431920161,0.11787931758890634,1047157.9388127311,369.86138785177036,1047527.8002005828,2564,0,501.56906077348066,87,94,39,38.686755780458135,0.552543738489871,43.8565340909091,8176.3392643744655,93.98091108476397,0
2601,32.05762519979028,0,1,180,0.0,0.0055248618784530384,0.994475138121547,181,6100,4100,2000,0.6721311475409836,81,41,40,203.79549726599822,0.46514349294045426,0.7513641390262815,0.11960064268506003,1053119.6476566556,624.2084549559513,1053743.8561116117,2565,1,502.56906077348066,70,111,38,38.45288859634057,0.5544429097605893,43.67664319248824,8217.118102487282,117.38740146410403,0
2602,32.34791431963265,0,0,180,0.0,0.0,1.0,180,5900,4400,1500,0.7457627118644068,74,44,30,215.7280578195392,0.4644637130146907,0.7599434438353785,0.12487975060541809,1058397.8028816532,3765.2204832254442,1062163.0233648787,2566,2,506.34444444444443,77,103,41,38.672180892717336,0.5478587962962963,44.19070512820514,8274.897152678486,107.46619678803229,8
2603,31.848389486151795,4,0,184,0.021739130434782608,0.0,1.0,184,5500,3800,1700,0.6909090909090909,72,38,34,212.89429218366365,0.4656483873841768,0.7636345187966094,0.12082808503403986,1035954.2326439713,1809.748618681795,1037763.9812626531,2567,0,496.3152173913044,76,108,41,39.51040451186308,0.5371942934782609,44.9404761904762,8123.235056438142,106.88467179523872,8
2604,31.994330188557576,3,4,183,0.016042780748663103,0.0213903743315508,0.9786096256684492,187,5200,3200,2000,0.6153846153846154,72,32,40,209.67566670367938,0.4665368102275123,0.764224987111429,0.11989995500115419,1043042.0770595646,1140.1085814911276,1044182.1856410558,2568,0,489.3368983957219,67,120,45,39.29981052652629,0.539605614973262,44.65379901960786,8169.630666560487,121.93478606806697,0
2605,32.378666269009706,4,3,184,0.0213903743315508,0.016042780748663103,0.983957219251337,187,5800,4000,1800,0.6896551724137931,76,40,36,211.23863348627847,0.4663643072087095,0.7666327578511392,0.12239659222055595,1059698.9727446109,1569.8725818771863,1061268.8453264881,2569,0,488.8983957219251,71,116,46,38.75065973007614,0.5432263814616756,44.15509259259261,8283.916873570177,116.67488554324193,0
2606,32.133366260602294,1,1,184,0.005405405405405406,0.005405405405405406,0.9945945945945946,185,5150,3500,1650,0.6796116504854369,68,35,33,209.96969154643656,0.4662321288679984,0.7615318498710724,0.12217488781010485,1052973.205478126,2068.491832181303,1055041.6973103073,2570,0,492.79459459459457,75,110,37,38.621417353749536,0.5454954954954955,43.996710526315816,8226.247464576945,109.6832995276926,0
2607,32.27872795658083,1,0,185,0.005405405405405406,0.0,1.0,185,6400,4800,1600,0.75,80,48,32,214.7749889949689,0.46650386799843324,0.7679049074993567,0.12566540167868087,1059453.1271059162,2108.8067429721013,1061561.9338488881,2571,0,493.7837837837838,79,106,40,38.28629237180468,0.5477477477477477,43.78906250000003,8270.163151063105,104.68560950712791,0
2608,32.18405518424379,2,2,185,0.0106951871657754,0.0106951871657754,0.9893048128342246,187,5850,4200,1650,0.717948717948718,75,42,33,214.26017043217678,0.466706917371054,0.7701801732639617,0.12532269863035425,1056243.7113035347,2012.191520362543,1058255.9028238973,2572,0,489.4919786096257,80,107,40,38.31212562326407,0.5484625668449198,43.80144032921814,8245.508582568304,103.06885728210379,8
2609,31.678678046566688,3,1,187,0.015957446808510637,0.005319148936170213,0.9946808510638298,188,6000,4400,1600,0.7333333333333333,76,44,32,214.80698754780042,0.4671553219934008,0.7719638785621434,0.12725115695083106,1043506.238698213,1230.4863244196408,1044736.7250226326,2573,0,487.8244680851064,73,115,42,37.81420240576211,0.5515846631205674,43.32770270270269,8131.039069553697,111.38409684320133,0
2610,32.042854515177666,1,0,188,0.005319148936170213,0.0,1.0,188,6150,4600,1550,0.7479674796747967,77,46,31,216.06661296465003,0.4672122112868358,0.7736489400914452,0.12883268592815222,1057481.9261732313,1947.307611916638,1059429.233785148,2574,0,488.75531914893617,76,112,39,37.53609165745179,0.5539117907801419,43.0871212121212,8232.22199807543,108.31871050099251,0
2611,32.3848648710973,3,1,190,0.015706806282722512,0.005235602094240838,0.9947643979057592,191,5550,3900,1650,0.7027027027027027,72,39,33,213.0055232903467,0.46778726922017083,0.7750207205585864,0.12800420144673538,1071163.537914133,1882.74998458749,1073046.2878987205,2575,0,482.0628272251309,79,112,42,37.32096601360127,0.556064572425829,42.79947916666664,8329.404111963286,105.43549508814286,0
2612,32.56896537083577,1,1,190,0.005235602094240838,0.005235602094240838,0.9947643979057592,191,5750,4200,1550,0.7304347826086957,73,42,31,213.05921526253113,0.46742559933866074,0.7762918575085955,0.1290361778679582,1079638.184431201,2055.372868474944,1081693.5572996761,2576,0,483.020942408377,69,122,42,37.02892321177445,0.5582460732984293,42.51488095238094,8386.023925767406,121.53657863431023,0
2613,32.47788616357087,0,2,188,0.0,0.010526315789473684,0.9894736842105263,190,5150,3500,1650,0.6796116504854369,68,35,33,214.75496829211266,0.4672851109254618,0.77680955706275,0.1306308277858599,1077946.1900660219,3148.859973646223,1081095.050039668,2577,1,480.2421052631579,70,120,40,36.82319249093637,0.5594298245614036,42.35622065727698,8367.725336245094,119.53893337492991,0
2614,32.76599501527104,4,1,191,0.020833333333333332,0.005208333333333333,0.9947916666666666,192,5600,3700,1900,0.6607142857142857,75,37,38,208.16712318197617,0.4674808664194299,0.7725187629399588,0.12791949172632872,1090626.2286207157,1406.5048957565132,1092032.7335164722,2578,0,475.3958333333333,77,115,40,36.61620082815732,0.5622829861111112,41.98717948717948,8454.046790799088,109.79281546492322,0
2615,32.99086230856326,0,0,191,0.0,0.0,1.0,191,7450,5300,2150,0.7114093959731543,96,53,43,205.87786488335232,0.46726485716910077,0.7693262234479148,0.12694396726996446,1099155.9229984202,-391.6250798391816,1098764.297918581,2579,1,478.67015706806285,78,113,40,36.55001191874821,0.5644088132635253,41.864451476793235,8516.114338274525,109.1809530548016,0
2616,33.3676857954488,1,1,191,0.005208333333333333,0.005208333333333333,0.9947916666666666,192,5700,3800,1900,0.6666666666666666,76,38,38,210.48784288423107,0.46717466095840604,0.7762244945422974,0.13073597760652333,1113967.4251119792,2795.320071024388,1116762.7451830036,2580,0,477.171875,64,128,42,36.16361221367733,0.5665690104166667,41.60256410256411,8622.124451375279,134.72069455273873,0
2617,33.321186470072945,0,1,190,0.0,0.005235602094240838,0.9947643979057592,191,6550,4900,1650,0.7480916030534351,82,49,33,205.23575441702917,0.4666884816753927,0.756542894302598,0.1244926942631488,1105063.5238401943,609.7091988163743,1105673.2330390108,2581,1,480.5811518324607,78,113,36,37.172119257287186,0.56260907504363,42.457805907172975,8581.611473278757,110.02065991383022,8
2618,32.897384696302574,2,3,189,0.010416666666666666,0.015625,0.984375,192,7000,5300,1700,0.7571428571428571,87,53,34,228.93724536212932,0.4665315726803374,0.7894277384696018,0.14108923260689382,1095883.0305848732,4777.688452240744,1100660.719037114,2582,0,479.0364583333333,76,116,36,35.9738600628931,0.5681966145833333,41.88311688311689,8491.37040050669,111.72855790140382,8
2619,33.31050524270016,0,2,187,0.0,0.010582010582010581,0.9894179894179894,189,5900,3900,2000,0.6610169491525424,79,39,40,204.4895198349289,0.4654536755600585,0.7502299579186582,0.12311874785442581,1102373.1553065567,1384.7514415110081,1103757.9067480678,2583,1,486.8835978835979,94,95,41,37.46936666240467,0.5610119047619048,42.73026315789476,8569.784917867108,91.16792465816071,7
2620,33.13574564437713,1,0,188,0.005319148936170213,0.0,1.0,188,7500,6000,1500,0.8,90,60,30,212.19874088846896,0.46564242234611447,0.7647250375824937,0.12239812345496306,1083031.395553862,863.5796958422097,1083894.9752497042,2584,0,487.56382978723406,75,113,38,38.90028054751442,0.5431072695035462,44.32565789473685,8471.959967793478,112.95946623724637,8
2621,33.237201184490814,2,2,188,0.010526315789473684,0.010526315789473684,0.9894736842105263,190,7550,5600,1950,0.7417218543046358,95,56,39,201.98169815960384,0.4659530771372877,0.7534594676193844,0.11617893741029771,1085447.4718722866,-1701.8952736376064,1083745.5765986491,2585,0,483.42105263157896,80,110,39,39.26957010349047,0.5464912280701755,44.4315843621399,8494.378846957079,106.17973558696349,8
2622,33.18729270602265,1,0,189,0.005291005291005291,0.0,1.0,189,6600,4700,1900,0.7121212121212122,85,47,38,219.91461035673197,0.4656788247213779,0.7780281007551357,0.12802863635435544,1087676.3687733691,3439.184966604252,1091115.5537399733,2586,0,486.8835978835979,77,112,38,38.346710743657965,0.5456900352733687,43.97702991452993,8496.709247691813,110.34687334664693,8
2623,33.10486587943898,5,2,192,0.02577319587628866,0.010309278350515464,0.9896907216494846,194,6000,4600,1400,0.7666666666666667,74,46,28,217.5299928099476,0.4668965778181365,0.7828012302983383,0.12868969900540425,1090058.2052849492,2624.0707116117383,1092682.275996561,2587,0,475.30927835051546,69,125,43,37.7956774910602,0.5493986254295533,43.377976190476176,8495.437679924451,123.12228521629639,0
2624,33.330088983644345,0,1,191,0.0,0.005208333333333333,0.9947916666666666,192,5850,3600,2250,0.6153846153846154,81,36,45,214.70665364286634,0.46683152905031994,0.7778837348548913,0.12738112901680526,1098375.9774486213,2915.726111940936,1101291.7035605623,2588,1,479.890625,71,121,41,37.76046069315301,0.5506184895833333,43.27256944444443,8556.748104958997,120.51757894308446,0
2625,33.58744843695997,4,0,195,0.020512820512820513,0.0,1.0,195,5450,4000,1450,0.7339449541284404,69,40,29,214.7987043870487,0.4679079654595118,0.773998598538475,0.12447772364769838,1099308.0541281311,2775.9891497941308,1102084.0432779253,2589,0,472.14358974358976,72,123,44,38.65390871909279,0.5439636752136752,44.14954337899544,8593.364019330667,119.35227804625927,8
2626,33.92315478907241,3,5,193,0.015151515151515152,0.025252525252525252,0.9747474747474747,198,6100,3900,2200,0.639344262295082,83,39,44,241.05012878143836,0.46856573347690095,0.800746800304617,0.13543723384825382,1100103.3595920717,7336.011300512292,1107439.370892584,2590,0,465.97474747474746,73,125,39,39.187670425234,0.5323021885521886,45.32657657657657,8639.325963455756,118.34693100624324,8
2627,33.97073692750974,5,6,192,0.025252525252525252,0.030303030303030304,0.9696969696969697,198,5450,3400,2050,0.6238532110091743,75,34,41,233.66687277723784,0.4687724324462903,0.7966480372954112,0.13264306681922455,1105052.9452558665,6592.8531942426,1111645.798450109,2591,0,466.2070707070707,80,118,37,38.9730597290847,0.5357218013468014,44.93312757201644,8664.80962217366,108.31012027717074,0
2628,34.349171375274715,2,2,192,0.010309278350515464,0.010309278350515464,0.9896907216494846,194,5250,3500,1750,0.6666666666666666,70,35,35,237.4677442358236,0.4676555294410911,0.7984590632397923,0.13564890881584607,1119459.2169910658,9117.091004574022,1128576.3079956397,2592,0,466.0927835051546,63,131,40,38.63131667304179,0.5376932989690721,44.69401041666667,8769.549189332027,139.19919348146075,0
2629,34.30812392990344,3,0,195,0.015384615384615385,0.0,1.0,195,4750,3600,1150,0.7578947368421053,59,36,23,232.43673800096317,0.4683518371662701,0.7947187416443076,0.13383158765645511,1120756.2296283648,8350.984421815085,1129107.2140501798,2593,0,463.74871794871797,67,128,45,38.452145511207014,0.5401175213675213,44.393382352941174,8769.383515538733,130.88632112744378,0
2630,34.34747848643749,6,0,201,0.029850746268656716,0.0,1.0,201,5600,3700,1900,0.6607142857142857,75,37,38,229.6707731620758,0.46930244610281924,0.7969732761958688,0.12958177570657325,1115263.1035029367,5428.667852131133,1120691.7713550678,2594,0,450.8756218905473,74,127,41,39.31388979725313,0.5343594527363185,45.166666666666664,8752.882434293813,118.2821950580245,8
2631,34.72666951882017,4,0,205,0.01951219512195122,0.0,1.0,205,6200,4600,1600,0.7419354838709677,78,46,32,223.27934011844349,0.47036007492427867,0.7891186284501648,0.12305015999587501,1119546.3332319164,2794.313303209504,1122340.646535126,2595,0,443.05853658536586,85,120,35,40.405973732748244,0.5253556910569106,46.07558139534886,8817.949367642343,103.74058079579227,8
2632,34.101391228217075,4,1,208,0.019138755980861243,0.004784688995215311,0.9952153110047847,209,6350,4900,1450,0.7716535433070866,78,49,29,216.99443722154427,0.47150081278370753,0.7888711105416149,0.12042426711404455,1101741.1183140315,-335.6612135224377,1101405.457100509,2596,0,435.5598086124402,70,139,39,40.28807861018123,0.5279106858054227,45.80399061032863,8668.437564848711,123.83482235498158,0
2633,34.055635614066254,3,2,209,0.014218009478672985,0.009478672985781991,0.990521327014218,211,7300,5300,2000,0.726027397260274,93,53,40,209.37059777568606,0.47160441585797036,0.7808207905291824,0.11735465173178139,1103595.2409142803,-3287.9209414752013,1100307.319972805,2597,0,432.4028436018957,77,134,40,40.089167060098916,0.5305094786729858,45.41933760683759,8669.906272849112,112.59618536167677,0
2634,34.36960414411036,8,3,214,0.03686635944700461,0.013824884792626729,0.9861751152073732,217,6350,4400,1950,0.6929133858267716,83,44,39,211.4515908209857,0.4730622759856631,0.7879104580050333,0.1202167274324634,1118541.706157185,-2446.5153666889646,1116095.1907904958,2598,0,421.2442396313364,87,130,38,39.47985779241865,0.5339861751152073,44.8745265151515,8768.561530752932,100.78806357187277,0
2635,34.06669926552143,5,6,213,0.0228310502283105,0.0273972602739726,0.9726027397260274,219,7400,5600,1800,0.7567567567567568,92,56,36,204.92838011035022,0.4735889433482747,0.783734543913196,0.1174431794514977,1111329.4036449376,-5651.4131084079445,1105677.9905365296,2599,0,418.3333333333333,79,140,41,39.33583329085317,0.5364821156773212,44.57031250000002,8701.646347548678,110.14742212086934,0
2636,34.02254016057029,3,5,211,0.013888888888888888,0.023148148148148147,0.9768518518518519,216,6950,4700,2250,0.6762589928057554,92,47,45,212.61419084443378,0.473065604364054,0.8019386008965284,0.12279274618508218,1112430.8726346,-2846.282028885446,1109584.5906057144,2600,0,424.8333333333333,72,144,39,38.84095474582894,0.5364583333333333,44.277968036529685,8700.313102419816,120.837681978053,8
2637,33.55635574073341,2,5,208,0.009389671361502348,0.023474178403755867,0.9765258215962441,213,5850,4100,1750,0.7008547008547008,76,41,35,205.65935935849853,0.472432604009803,0.7865266427187645,0.11668981971017056,1091420.5107840018,-3557.8313922876305,1087862.679391714,2601,0,431.5868544600939,84,129,40,39.70565859440067,0.5301741001564946,44.95098039215685,8558.51563328604,101.88709087245286,8
2638,33.97086563899821,1,4,205,0.004784688995215311,0.019138755980861243,0.9808612440191388,209,5700,3900,1800,0.6842105263157895,75,39,36,203.98911203544796,0.4714739755858177,0.7817463328984986,0.1160439929918676,1105764.2531308702,-2387.2263766590395,1103377.0267542112,2602,0,440.73205741626793,86,123,41,39.646781636164526,0.5317982456140351,44.85153256704978,8667.614305160983,100.7862128507091,0
2639,34.30914909901113,5,5,205,0.023809523809523808,0.023809523809523808,0.9761904761904762,210,6950,5000,1950,0.7194244604316546,89,50,39,218.8140539485562,0.47179976456292244,0.7982793117246902,0.12117976949091974,1107743.2960577135,-472.0397310553617,1107271.2563266582,2603,0,438.93809523809523,79,131,41,40.32503245200518,0.5178571428571428,45.88541666666666,8718.455127816396,110.36019149134678,8
2640,34.26343371116011,3,4,204,0.014423076923076924,0.019230769230769232,0.9807692307692307,208,6450,4600,1850,0.7131782945736435,83,46,37,222.2396307380687,0.47171755001238697,0.7963793388169804,0.12508331805982612,1111715.7442081117,1363.4592957013401,1113079.203503813,2604,0,441.7019230769231,79,129,41,39.59909357322972,0.525390625,45.26041666666665,8728.25282715017,110.4842130019009,7
2641,34.609066500621125,7,6,205,0.03317535545023697,0.02843601895734597,0.9715639810426541,211,5600,3900,1700,0.6964285714285714,73,39,34,219.5358589205121,0.47294158579703605,0.7989808609579725,0.12518807864818524,1127345.453927918,1698.5505056401712,1129044.0044335583,2605,0,433.5876777251185,65,146,39,39.15666996454781,0.5291271721958926,44.760101010101025,8833.614637753264,135.90176365774252,0
2642,34.52128572979278,0,0,205,0.0,0.0,1.0,205,6650,4900,1750,0.7368421052631579,84,49,35,222.20075567809263,0.4715955284552846,0.7967604350789979,0.1267077087738406,1124486.1091682464,2322.33264134062,1126808.441809587,2606,1,442.3414634146341,65,140,39,39.08865116662545,0.5305386178861788,44.76010101010102,8811.209482673768,135.55706896421182,0
2643,33.97672815786672,3,3,205,0.014423076923076924,0.014423076923076924,0.9855769230769231,208,6900,5000,1900,0.7246376811594203,88,50,38,217.02512227049453,0.4721815774804905,0.7934238084456018,0.12488487980555617,1109738.2441249955,-331.7843761055037,1109406.45974889,2607,0,436.94711538461536,71,137,41,38.86868372391416,0.5329527243589743,44.41550925925928,8683.924763264995,122.30879948260556,0
2644,34.18761648705023,2,3,204,0.00966183574879227,0.014492753623188406,0.9855072463768116,207,6050,3900,2150,0.6446280991735537,82,39,43,220.76653713989208,0.4718215999874928,0.7922761451867901,0.12883945996092727,1121264.062745359,2057.5168703405343,1123321.5796156996,2608,0,439.8502415458937,76,131,38,38.23112543136843,0.5405092592592593,43.885281385281424,8755.951776688882,115.20989179853792,8
2645,33.969299562649375,4,0,208,0.019230769230769232,0.0,1.0,208,5800,3900,1900,0.6724137931034483,77,39,38,219.0728954623936,0.4718549679487179,0.7899697383834445,0.12921365391045303,1117549.0881405747,1564.942912062338,1119114.0310526371,2609,0,438.4375,71,137,42,37.87013536379018,0.5436197916666667,43.489583333333314,8713.479184689962,122.72505893929525,0
2646,33.401087623986236,1,3,206,0.004784688995215311,0.014354066985645933,0.9856459330143541,209,7300,4900,2400,0.6712328767123288,97,49,48,216.05850781166887,0.47206918629615996,0.7896029201400878,0.1250457950938662,1092791.791895914,-1878.607218825564,1090913.1846770884,2610,0,437.3349282296651,78,131,40,38.67149914089347,0.5396730462519936,44.19831223628694,8544.054587359393,109.53916137640248,8
2647,33.03517866050675,4,2,208,0.01904761904761905,0.009523809523809525,0.9904761904761905,210,6800,4600,2200,0.6764705882352942,90,46,44,211.4274417324767,0.47239262930052406,0.7824755861386972,0.11957894624575714,1073436.925903408,-3409.1953790139632,1070027.7305243942,2611,0,436.0857142857143,84,126,39,39.68368426112873,0.529811507936508,45.07352941176468,8421.541501174705,100.25644644255601,7
2648,33.390432103146914,3,2,209,0.014218009478672985,0.009478672985781991,0.990521327014218,211,6550,4900,1650,0.7480916030534351,82,49,33,209.09357548975635,0.4727290679304897,0.7809356581109641,0.11958227975037453,1088597.324843009,-3226.2586159979383,1085371.0662270111,2612,0,434.8530805687204,72,139,41,39.309746670392094,0.5330766192733017,44.648972602739754,8526.281142777098,118.42057142745969,0
2649,33.69253768020659,2,2,209,0.009478672985781991,0.009478672985781991,0.990521327014218,211,7700,5700,2000,0.7402597402597403,97,57,40,247.52521924425463,0.4726228089972166,0.8124687722838544,0.13818979382950725,1090511.8916609033,4085.8390143665456,1094597.7306752698,2613,0,434.97630331753555,67,144,38,39.275204708290644,0.5205371248025277,45.57291666666668,8572.294092073427,127.94468794139443,8
2650,33.41737549983503,5,3,211,0.02336448598130841,0.014018691588785047,0.985981308411215,214,7300,5400,1900,0.7397260273972602,92,54,38,232.8473573020495,0.4729649313325435,0.8023105517181313,0.13151683145121354,1085417.5031675799,447.31943639228666,1085864.8226039722,2614,0,429.73364485981307,74,140,39,39.19030298076399,0.5237052180685358,45.125000000000014,8517.25358052049,115.098021358385,0
2651,33.50653331126541,4,2,213,0.018604651162790697,0.009302325581395349,0.9906976744186047,215,7400,5100,2300,0.6891891891891891,97,51,46,229.19659140710326,0.4723728537274505,0.80176410903422,0.13074641570067042,1091554.9368684946,-363.86582722869025,1091191.071041266,2615,0,428.65581395348835,67,148,45,38.895369481285925,0.5272286821705426,44.74571078431375,8552.686344448819,127.65203499177342,0
2652,33.31198033333546,2,2,213,0.009302325581395349,0.009302325581395349,0.9906976744186047,215,8250,5400,2850,0.6545454545454545,111,54,57,226.7513361762341,0.47220260088386584,0.7998927654596464,0.1305187985979567,1088117.9446738062,-1903.5604255749695,1086214.3842482313,2616,0,428.45116279069765,69,146,38,38.60910572892415,0.5299418604651163,44.40476190476194,8514.383544722843,123.39686296699773,0
2653,33.469853811163354,2,3,212,0.009302325581395349,0.013953488372093023,0.986046511627907,215,7050,4700,2350,0.6666666666666666,94,47,47,220.9055898474626,0.4726309497935231,0.7939917700962362,0.127829039462016,1094985.982820734,-1672.2951180558866,1093313.6877026781,2617,0,429.4,70,145,47,38.55415352260779,0.5319767441860466,44.204812206572804,8561.427541045166,122.30610772921666,0
2654,33.262797880610734,1,0,213,0.004694835680751174,0.0,1.0,213,7000,5100,1900,0.7285714285714285,89,51,38,218.48493369109005,0.47267435852009326,0.790975383650623,0.12699879262964325,1089654.042094775,-1985.4017733386645,1087668.6403214363,2618,0,433.23474178403757,72,141,39,38.44294700263876,0.5335974178403755,44.0353881278539,8514.099149292211,118.25137707350294,0
2655,33.34913764187062,1,2,212,0.004672897196261682,0.009345794392523364,0.9906542056074766,214,6400,4600,1800,0.71875,82,46,36,255.37512084775472,0.47306274040922586,0.8266387420341124,0.14736928183299589,1090151.7092087548,6479.524896314604,1096631.2341050694,2619,0,432.2056074766355,68,146,38,37.77885202023183,0.5292542834890965,44.30857487922706,8527.088530198727,125.39836073821658,8
2656,33.021330886900536,2,6,208,0.009345794392523364,0.028037383177570093,0.9719626168224299,214,6750,4800,1950,0.7111111111111111,87,48,39,238.6209239130422,0.47319665657496385,0.8192680820804537,0.13720703125000014,1078289.1382204015,1910.4700815104852,1080199.608301912,2620,0,431.9485981308411,65,149,40,38.34635416666664,0.5325155763239875,44.44444444444447,8438.784559985752,129.82745476901158,8
2657,33.00057218958422,3,3,208,0.014218009478672985,0.014218009478672985,0.985781990521327,211,6850,5000,1850,0.7299270072992701,87,50,37,232.34029171951488,0.47311931091551945,0.812282836333639,0.13175517098683612,1073164.870098575,817.8877963679133,1073982.757894943,2621,0,438.1184834123223,74,137,37,39.04689939367536,0.5277448657187993,44.97222222222224,8416.062590904847,113.7305755527682,8
2658,32.80765201149987,2,3,207,0.009523809523809525,0.014285714285714285,0.9857142857142858,210,6450,4100,2350,0.6356589147286822,88,41,47,217.1346014769409,0.47317156527682847,0.7966994469884663,0.12032823139505364,1059475.843893966,-2440.2269723281906,1057035.6169216377,2622,0,441.1380952380952,77,133,44,40.34178490103342,0.5158730158730158,45.8600427350427,8337.73528016607,108.28227636579312,8
2659,32.86675262822457,1,0,208,0.004807692307692308,0.0,1.0,208,6200,4100,2100,0.6612903225806451,83,41,42,212.29251037139753,0.47293350520252697,0.7902718066082304,0.11828539738948657,1063143.6715542977,-2660.5122160544834,1060483.1593382433,2623,0,446.07211538461536,67,141,43,40.249839396129424,0.5176282051282051,45.64950980392158,8359.674642142201,124.77126331555525,0
2660,33.121294959826464,3,1,210,0.014218009478672985,0.004739336492890996,0.995260663507109,211,7050,5100,1950,0.723404255319149,90,51,39,216.81839395565385,0.47357255698487927,0.8000802560948939,0.11769265037511056,1062800.9332836543,-3163.041710173678,1059637.8915734806,2624,0,440.7156398104265,70,141,38,41.17693191251132,0.5120458135860979,46.66960093896713,8390.630869590997,119.86615527987139,8
2661,32.833879308684146,5,0,215,0.023255813953488372,0.0,1.0,215,7200,5200,2000,0.7222222222222222,92,52,40,211.8171506296281,0.4747310367311454,0.8011456017773717,0.11653928267202848,1057983.9314040928,-5380.171647610678,1052603.7597564822,2625,0,432.3581395348837,77,138,41,40.763311676924964,0.5157461240310077,46.14049145299144,8335.192464994316,108.24925279213397,0
2662,32.7268096711078,3,6,212,0.013761467889908258,0.027522935779816515,0.9724770642201834,218,6750,4200,2550,0.6222222222222222,93,42,51,212.68987152978218,0.47545061232542735,0.7926350969998099,0.1173900822224971,1055558.8128843715,-5448.666339098382,1050110.146545273,2626,0,427.39449541284404,84,134,39,40.615199034981906,0.5161506116207951,46.01715686274512,8312.048167079827,98.95295436999794,8
2663,33.15288441225216,7,0,219,0.0319634703196347,0.0,1.0,219,7200,5200,2000,0.7222222222222222,92,52,40,204.79270965167234,0.47664181084439977,0.7871365832172255,0.11443168004993969,1073326.8016440128,-7038.099189912206,1066288.7024541006,2627,0,425.39269406392697,77,142,46,40.32836499772574,0.52021499238965,45.53952991452989,8436.09855223089,109.55972145754401,0
2664,33.1122825002782,6,7,218,0.02666666666666667,0.03111111111111111,0.9688888888888889,225,7100,5400,1700,0.7605633802816901,88,54,34,220.43773528222397,0.47746693121693123,0.8094375624963239,0.12672151002681695,1081182.7857555281,-4433.30305638511,1076749.482699143,2628,0,415.02222222222224,76,149,39,38.820253220398776,0.5322685185185185,44.4534632034632,8461.729118374657,111.33854103124548,8
2665,33.21144972853976,2,1,219,0.00909090909090909,0.004545454545454545,0.9954545454545455,220,7150,5300,1850,0.7412587412587412,90,53,37,222.13319335464834,0.4763426214196762,0.8081476382625206,0.12836000762647895,1086084.7684887715,-2898.9044243490735,1083185.8640644224,2629,0,425.27272727272725,77,143,40,38.57658833768493,0.5336647727272728,44.25747863247863,8493.579891847437,110.30623236165503,0
2666,33.27443303691953,3,4,218,0.013513513513513514,0.018018018018018018,0.9819819819819819,222,6050,4300,1750,0.7107438016528925,78,43,35,216.85861970891978,0.4766006107917873,0.8066424566871144,0.1262440387525587,1090518.4213557334,-3152.3360755290287,1087366.0852802044,2630,0,421.7567567567568,81,141,40,38.42661506400719,0.536082957957958,43.97865853658538,8518.964982546724,105.17240719193487,0
2667,32.81028047139341,3,5,216,0.013574660633484163,0.02262443438914027,0.9773755656108597,221,6900,4500,2400,0.6521739130434783,93,45,48,214.76525460579913,0.47604809406279996,0.804588326695048,0.1260493512914355,1077872.217092298,-4802.0997727312415,1073070.1173195667,2631,0,424.08597285067873,67,154,43,38.16840225900914,0.5390742835595776,43.67340686274508,8410.147413110048,125.52458825537384,0
2668,32.85757790496473,1,3,214,0.004608294930875576,0.013824884792626729,0.9861751152073732,217,7100,4800,2300,0.676056338028169,94,48,46,216.6915894333828,0.4747388277294191,0.8029590270721532,0.1280237336490194,1081500.3798460383,-3629.592743671332,1077870.787102367,2632,0,432.80645161290323,70,147,43,37.86751391430313,0.5404185867895546,43.42723004694833,8430.359777024927,120.4337111003561,0
2669,32.342159413715805,3,5,212,0.013824884792626729,0.02304147465437788,0.9769585253456221,217,6500,4500,2000,0.6923076923076923,85,45,40,211.46358287200096,0.4749850657108721,0.7987790481399522,0.12608806600697492,1067359.620448855,-4758.462089397503,1062601.1583594575,2633,0,432.12442396313367,76,141,37,37.654349428676724,0.5430587557603687,43.0871212121212,8309.117281194181,109.3304905420287,0
2670,32.48182193766244,1,0,213,0.004694835680751174,0.0,1.0,213,7150,5000,2150,0.6993006993006993,93,50,43,237.68665819415205,0.4748215445714117,0.8212829087395257,0.1356775124685844,1058377.0444024254,562.4205586832518,1058939.4649611088,2634,0,439.09389671361504,58,155,42,38.653405030315625,0.5257726917057903,44.72104519774011,8291.925554319576,142.9642336951651,8
2671,32.42041055186069,1,1,213,0.004672897196261682,0.004672897196261682,0.9953271028037384,214,5950,3900,2050,0.6554621848739496,80,39,41,231.07427689168748,0.4751359271934828,0.8168553138263048,0.1325343032869902,1057877.8365950966,139.67122619094516,1058017.5078212875,2635,0,438.0373831775701,61,153,42,38.63661898498299,0.5274045950155763,44.53965053763441,8282.1294092917,135.77261326707705,0
2672,32.51653776795089,1,2,212,0.004672897196261682,0.009345794392523364,0.9906542056074766,214,7350,4800,2550,0.6530612244897959,99,48,51,252.39124245569323,0.47542158454360645,0.827186484007802,0.1427129685934484,1056508.1497123463,3180.68091409288,1059688.830626439,2636,0,436.98130841121497,67,147,31,38.64883170081926,0.5260903426791277,45.08272058823529,8289.027343695927,123.71682602531234,8
2673,32.03619507138688,1,4,209,0.004694835680751174,0.018779342723004695,0.9812206572769953,213,5400,3500,1900,0.6481481481481481,73,35,38,249.2335702531423,0.47533734904184016,0.8250498652665501,0.14172433840101306,1042662.3591094891,3973.2924658844286,1046635.6515753736,2637,0,439.73708920187795,68,145,36,38.50838264299805,0.528462441314554,44.86714975845411,8173.485759457108,120.1983199920163,0
2674,31.62702126409228,2,1,210,0.009478672985781991,0.004739336492890996,0.995260663507109,211,6950,5200,1750,0.7482014388489209,87,52,35,247.22152515543624,0.4754334988339728,0.8233489710966864,0.1416701412340032,1031718.0790068276,1862.5834045011397,1033580.6624113286,2638,0,444.18483412322274,61,150,37,38.258553684579795,0.5316943127962086,44.573252688172055,8078.387168649132,132.43257653523168,0
2675,31.994751179106835,2,1,211,0.009433962264150943,0.0047169811320754715,0.9952830188679245,212,6200,4200,2000,0.6774193548387096,82,42,40,222.72238645525385,0.4757537482488301,0.8022347664707707,0.12350968703427734,1033441.5723737566,-2565.88534776927,1030875.6870259873,2639,0,442.5330188679245,66,146,46,40.17247267759564,0.5154284591194969,45.83333333333334,8131.999258023003,123.2121099700455,8
2676,32.45689424208188,5,1,215,0.023148148148148147,0.004629629629629629,0.9953703703703703,216,5600,4000,1600,0.7142857142857143,72,40,32,211.35052781059488,0.47718337281079526,0.7925886428121569,0.11870172571128072,1052423.9416943865,-4313.9288884767,1048110.0128059098,2640,0,434.89351851851853,69,147,48,39.960057169013815,0.5187596450617284,45.34226190476192,8265.399273284962,119.78839526499945,0
2677,32.758319440847956,6,3,218,0.027149321266968326,0.013574660633484163,0.9864253393665159,221,6650,4800,1850,0.7218045112781954,85,48,37,200.16199037084778,0.47840566296448644,0.7859679800491319,0.11380328539052885,1066117.3780076432,-8170.76472980784,1057946.6132778353,2641,0,425.1131221719457,76,145,42,39.766159393393096,0.5227187028657616,44.87283549783552,8357.537152799723,109.96759411578583,0
2678,33.13038928054083,2,1,219,0.00909090909090909,0.004545454545454545,0.9954545454545455,220,6750,5000,1750,0.7407407407407407,85,50,35,211.77812650547457,0.4781029472810295,0.7966084107649818,0.12125755608593371,1080490.5826045687,-4985.145741839091,1075505.4368627295,2642,0,428.0318181818182,66,154,42,39.19639414784603,0.5246212121212122,44.60509950248757,8461.332473747594,128.20200717799386,0
2679,33.357113124626956,2,4,217,0.00904977375565611,0.01809954751131222,0.9819004524886877,221,7150,5400,1750,0.7552447552447552,89,54,35,213.54957679186677,0.47847593582887704,0.799834250184599,0.12323649087181025,1090421.487876823,-4778.190547829055,1085643.297328994,2643,0,426.6606334841629,70,151,45,38.8472094713488,0.5274792609351433,44.30751173708922,8529.163256103311,121.84518937290444,0
2680,33.09306249232348,3,4,216,0.013636363636363636,0.01818181818181818,0.9818181818181818,220,6150,4400,1750,0.7154471544715447,79,44,35,206.70749129305688,0.4784285491905355,0.7919893483404248,0.12010129721240076,1083956.9195009372,-5337.596900041989,1078619.3226008953,2644,0,429.20454545454544,75,145,42,38.76088857948667,0.529971590909091,44.051535087719316,8470.118544156408,112.93491392208544,0
2681,33.18112260828409,1,6,211,0.004608294930875576,0.027649769585253458,0.9723502304147466,217,6350,4700,1650,0.7401574803149606,80,47,33,209.62618509235568,0.47826260880696364,0.7940797175564398,0.12259875111647431,1088931.3354424604,-4096.295664734462,1084835.039777726,2645,0,435.82027649769583,74,143,45,38.43504915248115,0.532018049155146,43.805555555555564,8500.819272672356,114.87593611719399,0
2682,32.90553105494367,2,1,212,0.009389671361502348,0.004694835680751174,0.9953051643192489,213,7150,5100,2050,0.7132867132867133,92,51,41,209.3884208233826,0.4777438214190805,0.7903778777817339,0.1234112460994399,1082322.7464835567,-4424.829858516589,1077897.9166250401,2546,0,432.1267605633803,66,147,47,38.146329635691316,0.534330985915493,43.5167910447761,8439.716197347681,127.87448783860123,0
2683,33.12692809769481,2,0,214,0.009345794392523364,0.0,1.0,214,7550,5600,1950,0.7417218543046358,95,56,39,223.9404884042713,0.4778366460444912,0.8120650079249803,0.12909561231807243,1082556.7044698414,-1864.3445751410954,1080692.3598947003,2547,0,430.19158878504675,60,154,42,38.62258700153634,0.5237538940809969,44.34767759562841,8468.976102298298,141.14960170497164,8
2684,33.56027318710745,1,3,212,0.004651162790697674,0.013953488372093023,0.986046511627907,215,6900,4900,2000,0.7101449275362319,89,49,40,222.17563199155416,0.4779613127580961,0.8107521900208192,0.12863944916507714,1098134.0036956512,-1104.2767435007227,1097029.7269521505,2548,0,429.1860465116279,64,151,47,38.49905510660069,0.5256298449612403,44.18269230769231,8585.298732144163,134.14529268975255,0
2685,33.30994128107674,4,3,213,0.018518518518518517,0.013888888888888888,0.9861111111111112,216,5800,4000,1800,0.6896551724137931,76,40,36,224.0598440625223,0.47771542133218486,0.8114241208152919,0.13104525407214512,1093171.1948070251,-12.84651157918961,1093158.348295446,2549,0,428.0462962962963,76,140,39,38.063791495054005,0.5339023919753086,43.804112554112564,8533.86996727588,112.2877627273142,8
2686,33.68177372386358,4,1,216,0.018433179723502304,0.004608294930875576,0.9953917050691244,217,7900,6000,1900,0.759493670886076,98,60,38,218.56332675420725,0.4778679168800137,0.8077789580015642,0.12926720348531737,1108970.4156773714,-2823.947335511405,1106146.46834186,2550,0,426.815668202765,68,149,42,37.779076950229445,0.5369623655913979,43.387681159420296,8643.158057944356,127.10526555800524,0
2687,34.06825191862952,2,2,216,0.009174311926605505,0.009174311926605505,0.9908256880733946,218,7000,5500,1500,0.7857142857142857,85,55,30,216.2046493821651,0.47786221620936037,0.8046460920166796,0.1285670672532014,1123450.8467836995,-2020.9407146066842,1121429.9060690927,2551,0,425.43119266055044,73,145,44,37.634519111306034,0.5392775229357798,43.18693693693694,8749.17212842732,119.85167299215507,0
2688,33.593555210711166,2,5,213,0.009174311926605505,0.022935779816513763,0.9770642201834863,218,6800,4900,1900,0.7205882352941176,87,49,38,221.24287361623513,0.47782390183063456,0.8073993008350151,0.13225374698645928,1109464.5707574068,-1307.7740380456007,1108156.796719361,2552,0,426.0183486238532,72,146,35,37.30764070105306,0.5429568042813455,42.99372146118722,8633.754607593033,119.91325843879213,8
2689,33.83648413306925,2,1,214,0.009302325581395349,0.004651162790697674,0.9953488372093023,215,6750,4700,2050,0.6962962962962963,88,47,41,235.48875720130576,0.47724317177425196,0.8162593722899973,0.13679414004582013,1108236.9752487266,2445.4695971717842,1110682.4448458983,2553,0,432.5674418604651,73,142,36,38.0325780075533,0.5350290697674418,44.05968468468471,8660.12041817947,118.63178655040369,8
2690,33.25280160653894,0,2,212,0.0,0.009345794392523364,0.9906542056074766,214,7500,5400,2100,0.72,96,54,42,237.44802896322796,0.4769179720064938,0.8168207293980896,0.1385682032856619,1090589.4294490875,1491.6620861636516,1092081.0915352511,2554,1,435.56542056074767,75,139,37,37.80571015733706,0.5368964174454829,43.88706140350879,8516.472736016849,113.552969813558,0
2691,33.27362686051485,1,0,213,0.004694835680751174,0.0,1.0,213,7300,5200,2100,0.7123287671232876,94,52,42,206.68595085161002,0.4770065624354091,0.7933559216705666,0.11981531414117966,1089141.1069586093,-4877.966939336991,1084263.1400192722,2555,0,437.14084507042253,77,136,39,38.848963498442814,0.5394659624413145,44.13728632478632,8513.48046234779,110.56468132919208,8
2692,33.26251204902765,0,2,211,0.0,0.009389671361502348,0.9906103286384976,213,6950,4800,2150,0.6906474820143885,91,48,43,213.01184671097369,0.4767657306522574,0.7979281947727821,0.1258653276556067,1094868.0552304795,-2906.0267301007398,1091962.0285003788,2556,1,438.14084507042253,69,144,43,37.957216873525894,0.5459213615023475,43.422619047619044,8534.408225436517,123.68707573096401,8
2693,32.775653162990125,2,3,210,0.009389671361502348,0.014084507042253521,0.9859154929577465,213,7000,5100,1900,0.7285714285714285,89,51,38,212.62411922749385,0.47656549886320015,0.7978966889161949,0.12663070912739244,1081299.4909387687,-3617.9296236013784,1077681.5613151672,2557,0,438.61032863849766,73,140,44,37.66896828876224,0.54856220657277,43.13063063063063,8419.06135864644,115.32960765269097,0
2694,32.51162166320224,1,2,209,0.004739336492890996,0.009478672985781991,0.990521327014218,211,6800,5100,1700,0.75,85,51,34,226.77480838160156,0.4760315579628376,0.8064498556408997,0.1331432463933699,1068166.556511477,-553.3467654947999,1067613.2097459822,2558,0,434.1516587677725,69,142,36,37.84758504586092,0.5437894944707741,43.66071428571429,8334.005874558372,120.7826938341793,6
2695,32.01371110083402,1,1,209,0.004761904761904762,0.004761904761904762,0.9952380952380953,210,6050,4400,1650,0.7272727272727273,77,44,33,230.53022964401794,0.47539065466697045,0.8093702709569102,0.1363259012339315,1054007.0312209514,546.0965907549794,1054553.1278117064,2559,0,437.1857142857143,69,141,36,37.4772867857419,0.5458829365079365,43.39285714285714,8214.946937839008,119.05720199766678,0
2696,31.65430586119642,0,0,209,0.0,0.0,1.0,209,6400,4400,2000,0.6875,84,44,40,231.39593685330152,0.4753481167954852,0.8088557835536592,0.13725830200882763,1043098.2566653453,73.73966622454373,1043171.9963315699,2560,1,440.0382775119617,72,137,37,37.33869249439535,0.5474980063795853,43.27910958904109,8126.321586027168,112.86557758371067,0
2697,31.71663817915065,2,1,210,0.009478672985781991,0.004739336492890996,0.995260663507109,211,7200,5200,2000,0.7222222222222222,92,52,40,226.50038017585206,0.47543255848943056,0.8072377995159501,0.1352340505167585,1047116.6020866983,-1965.5383077834458,1045151.0637789149,2561,0,436.85781990521326,78,133,34,37.2177750410509,0.5498617693522907,43.0379746835443,8149.971582743759,104.48681516338154,0
2698,31.259628296192826,1,0,211,0.004739336492890996,0.0,1.0,211,7450,5800,1650,0.7785234899328859,91,58,33,227.3516000000002,0.47520875648837735,0.8085734597156398,0.1366295673076922,1033954.1993260093,-2635.771691302616,1031318.4276347066,2562,0,437.8530805687204,80,131,35,36.95083333333331,0.5516390205371249,42.798353909465014,8040.027853959047,100.5003481744881,0
2699,30.917194760091053,0,1,210,0.0,0.004739336492890996,0.995260663507109,211,7050,5300,1750,0.75177304964539,88,53,35,223.38997085693015,0.4751269465132024,0.8063130809992181,0.12848289884450476,1009658.3867957629,-4140.48847964802,1005517.8983161149,2563,1,438.8530805687204,69,142,40,38.725447381700995,0.5322867298578199,44.4345238095238,7901.367601336353,114.51257393241092,8
2700,31.155909740132707,0,1,209,0.0,0.004761904761904762,0.9952380952380953,210,8150,6100,2050,0.7484662576687117,102,61,41,222.74264365953695,0.4748761107313739,0.804205073352837,0.12852278841905473,1018421.4134152185,-4780.824403282095,1013640.5890119363,2564,2,441.65714285714284,73,137,39,38.6178246348088,0.5344742063492063,44.313063063063076,7966.159128938243,109.12546751970196,0
2701,30.908243318593687,4,4,209,0.018779342723004695,0.018779342723004695,0.9812206572769953,213,6250,4100,2150,0.656,84,41,43,217.7449599499434,0.475292135412053,0.8028737253795444,0.12663032136894836,1012666.0649933158,-4749.413647072504,1007916.6513462433,2565,0,436.3474178403756,77,136,36,38.443195255982204,0.5371674491392802,44.01709401709404,7911.981943520399,102.75301225351167,0
2702,31.175614364563984,1,2,208,0.004761904761904762,0.009523809523809525,0.9904761904761905,210,6650,4700,1950,0.706766917293233,86,47,39,220.69862395755,0.47494873547505123,0.8047976488343447,0.1290817805488314,1023132.0400073025,-3489.2333287011643,1019642.8066786014,2566,0,442.5047619047619,77,133,39,38.149195510147365,0.5391865079365079,43.80341880341883,7987.08581690438,103.72838723252443,0
2703,31.60737169746679,1,2,207,0.004784688995215311,0.009569377990430622,0.9904306220095693,209,7400,5300,2100,0.7162162162162162,95,53,42,218.98856796622005,0.4742909228928966,0.8018368394017055,0.12865680470107926,1038657.2023919823,-3709.1893280758904,1034948.0130639065,2567,0,443.6555023923445,63,146,40,38.0219906672592,0.5419158692185009,43.636067708333336,8102.990097766921,128.6188904407448,0
2704,31.331551466811323,2,0,209,0.009569377990430622,0.0,1.0,209,6400,4400,2000,0.6875,84,44,40,188.3299185761324,0.47445577996564836,0.7651199079274098,0.11005480257190238,1027989.8547700965,-9479.750870811044,1018510.1038992854,2568,0,444.5598086124402,84,125,41,39.011445725493964,0.5396232057416268,43.83578431372553,8026.02230772998,95.5478846158331,8
2705,31.496375544400504,2,3,208,0.009478672985781991,0.014218009478672985,0.985781990521327,211,7000,4500,2500,0.6428571428571429,95,45,50,185.47104739561533,0.47459471150229443,0.7638683364482941,0.10895259015350499,1034975.1476495567,-10808.415067400929,1024166.7325821558,2569,0,441.33649289099526,75,136,40,38.885621613915006,0.5416666666666667,43.64035087719299,8074.399783202701,107.65866377603601,0
2706,31.076661584065,1,0,209,0.004784688995215311,0.0,1.0,209,7100,5200,1900,0.7323943661971831,90,52,38,182.82769493139597,0.47435130658814867,0.7595618439296261,0.1079711911259468,1022757.4115449829,-11502.323994645898,1011255.0875503371,2570,0,445.70334928229664,77,132,43,38.752266496625154,0.5441088516746411,43.44284188034188,7972.939979854074,103.54467506303993,0
2707,31.240428197981696,2,2,209,0.009478672985781991,0.009478672985781991,0.990521327014218,211,7200,5200,2000,0.7222222222222222,92,52,40,186.56804754591386,0.4748824569322199,0.7639427935224414,0.1110513369309204,1030487.1955473339,-10948.803181133859,1019538.3923662001,2571,0,442.4691943127962,79,132,33,38.35906079962147,0.5462578988941549,43.15104166666667,8024.071440538908,101.57052456378365,0
2708,31.757451606401492,1,1,209,0.004761904761904762,0.004761904761904762,0.9952380952380953,210,7500,5500,2000,0.7333333333333333,95,55,40,189.16356717161747,0.4747977899293689,0.7668443965710705,0.11313559457107433,1048979.5939988752,-9814.255621787594,1039165.3383770876,2572,0,435.7952380952381,85,125,37,38.11282595036132,0.5484126984126985,42.974806201550386,8162.46515368022,96.02900180800259,0
2709,31.379545323646376,0,2,207,0.0,0.009569377990430622,0.9904306220095693,209,6750,5000,1750,0.7407407407407407,85,50,35,191.55419340313378,0.4746925223898908,0.7695406355963923,0.11486758241699757,1037278.6528777281,-8810.98486274363,1028467.6680149845,2573,1,438.67464114832535,85,124,38,37.95262546322467,0.5501893939393939,42.87790697674418,8068.374371734051,94.9220514321653,0
2710,31.178656741290542,0,3,204,0.0,0.014492753623188406,0.9855072463768116,207,7300,5100,2200,0.6986301369863014,95,51,44,221.06288948581522,0.4741969967012179,0.8010733531652319,0.1307095989556094,1026473.7803469131,-3316.9480270164004,1023156.8323198968,2574,2,443.70531400966183,70,137,40,37.72536687631032,0.5467491948470209,43.397887323943685,8000.509190216764,114.29298843166806,8
2711,31.232594005606195,0,3,201,0.0,0.014705882352941176,0.9852941176470589,204,6350,4800,1550,0.7559055118110236,79,48,31,221.7281817983117,0.4735090875430632,0.7980594826075396,0.131501035819702,1029150.6455890745,-1511.6597113948878,1027638.9858776795,2575,3,450.6029411764706,73,131,42,37.59338844108133,0.5489174836601307,43.285472972973,8017.860597976407,109.83370682159462,0
2712,31.260570244394984,0,0,201,0.0,0.0,1.0,201,7150,5200,1950,0.7272727272727273,91,52,39,216.72418869216955,0.47270004145936984,0.7910722832575046,0.12922477448832045,1031664.8917673185,-2632.6526659064366,1029032.239101412,2576,5,457.7363184079602,76,125,39,37.519197690133936,0.5509950248756219,43.087121212121225,8031.243094038249,105.67425123734539,0
2713,30.980928766907446,0,1,200,0.0,0.004975124378109453,0.9950248756218906,201,6400,4500,1900,0.703125,83,45,38,219.33834442071625,0.4723217247097844,0.7948693496829402,0.13141868871594142,1023857.1184091812,-1685.7749449530693,1022171.3434642282,2577,6,458.7363184079602,77,124,41,37.26965482312609,0.552808872305141,42.90865384615384,7964.928681780633,103.44063223091732,0
2714,31.08304477941473,1,1,200,0.004975124378109453,0.004975124378109453,0.9950248756218906,201,6150,4400,1750,0.7154471544715447,79,44,35,217.37348990878493,0.4722636815920398,0.7934969362613746,0.1311949219236711,1029370.7980917536,-1598.4154417207246,1027772.3826500329,2578,0,459.4228855721393,61,140,42,37.04682943813379,0.5550373134328358,42.64112903225807,7999.497310669954,131.13930017491728,0
2715,30.945592604072093,0,0,200,0.0,0.0,1.0,200,7100,5300,1800,0.7464788732394366,89,53,36,219.4414104642851,0.4717436139028475,0.7942777155655105,0.13330692486027626,1026709.4438273007,-2039.4863019071531,1024669.9575253936,2579,1,462.655,64,136,37,36.751119820828684,0.5568229166666667,42.403846153846146,7971.465633298937,124.55415052029589,0
2716,30.72455904464595,1,0,201,0.004975124378109453,0.0,1.0,201,6850,4800,2050,0.7007299270072993,89,48,41,220.9752732453624,0.4718677446102819,0.7957822965239356,0.13551986786325385,1022105.7217947458,-1877.9817681517288,1020227.740026594,2580,0,461.3482587064677,68,133,36,36.35932439814271,0.5587686567164178,42.05917874396134,7925.117992705602,116.54585283390591,0
2717,30.64758454845988,0,0,201,0.0,0.0,1.0,201,5500,3800,1700,0.6909090909090909,72,38,34,218.46763460895482,0.47179000829187395,0.7932066973536194,0.1344190134018604,1020475.1226108085,-1111.8427571865923,1019363.2798536218,2581,1,462.3482587064677,71,130,39,36.3038090299191,0.5600124378109452,41.94155092592593,7908.868136442124,111.39250896397357,0
2718,31.03297943590399,1,1,201,0.0049504950495049506,0.0049504950495049506,0.995049504950495,202,5700,3700,2000,0.6491228070175439,77,37,40,216.3940919106092,0.4714530688143441,0.7929953381037396,0.13379172809382622,1034709.566546275,-1318.9925911997939,1033390.5739550752,2582,0,461.05445544554453,72,130,40,36.17853327439171,0.5615202145214522,41.766552511415526,8013.753265575836,111.30212868855328,0
2719,31.02040286533228,2,2,201,0.009852216748768473,0.009852216748768473,0.9901477832512315,203,6800,4800,2000,0.7058823529411765,88,48,40,196.4401362051362,0.4709961143897641,0.7696097006441842,0.1199829058613087,1030766.715475571,-6903.209203251607,1023863.5062723194,2583,0,459.69458128078816,80,123,42,37.142696797366064,0.558754105090312,42.206790123456784,7996.84922631751,99.96061532896888,7
2720,30.91604862460319,1,2,200,0.0049504950495049506,0.009900990099009901,0.9900990099009901,202,5850,4300,1550,0.7350427350427351,74,43,31,220.1480135214598,0.4709866509038964,0.7975163429408134,0.1301702360600305,1017831.6925646797,-1435.2749565400204,1016396.4176081397,2584,0,461.61386138613864,64,138,41,37.74838142226663,0.5413572607260726,43.39743589743591,7933.137348992757,123.95527107801183,8
2721,31.169537517657922,4,2,202,0.0196078431372549,0.00980392156862745,0.9901960784313726,204,6050,3900,2150,0.6446280991735537,82,39,43,214.37386125804454,0.4717729764319521,0.7941870434667755,0.12817069288458857,1029461.8172165623,-2712.059045112214,1026749.7581714501,2585,0,457.7843137254902,70,134,41,37.47740419378165,0.5448835784313726,42.98708920187796,8010.973565644582,114.44247950920831,0
2722,31.090912486264568,0,3,199,0.0,0.01485148514851485,0.9851485148514851,202,6100,4400,1700,0.7213114754098361,78,44,34,215.3255895897786,0.4713576301660017,0.7926613241947569,0.12920989295640595,1027936.6848800594,-2231.785453447486,1025704.899426612,2586,1,461.94059405940595,71,131,41,37.31597652001052,0.546565594059406,42.85300925925928,7994.934585226704,112.60471246798176,0
2723,30.70680304880108,1,0,200,0.005,0.0,1.0,200,5600,4200,1400,0.75,70,42,28,215.96336466947042,0.4711725293132328,0.7913185378590071,0.13046367297856046,1017176.4420980734,-1665.4306203957121,1015511.0114776777,2587,0,466.0,61,139,41,37.04879242819843,0.5486458333333333,42.60752688172044,7903.699978286858,129.56885210306325,0
2724,31.18822029939491,0,0,200,0.0,0.0,1.0,200,5900,4100,1800,0.6949152542372882,77,41,36,253.52244252875659,0.47144943467336686,0.8142760985521975,0.14875079824675294,1024493.0008904997,6046.393587874844,1030539.3944783745,2588,1,467.0,63,137,34,37.186732706798736,0.5397395833333334,43.68489583333332,7994.011934812331,126.88907833035445,8
2725,30.797675489043765,2,2,200,0.009900990099009901,0.009900990099009901,0.9900990099009901,202,6550,4300,2250,0.6564885496183206,88,43,45,248.84388479643465,0.4715674925701525,0.8102032495102693,0.1473799678248232,1014416.9931708572,3536.2930768307006,1017953.2862476879,2589,0,463.36633663366337,67,135,37,36.949480254650354,0.5419760726072607,43.336397058823515,7904.642353231102,117.97973661538958,0
2726,30.91354063396616,1,1,200,0.004975124378109453,0.004975124378109453,0.9950248756218906,201,6800,5000,1800,0.7352941176470589,86,50,36,242.8530830456313,0.4713764510779436,0.8035769507126167,0.14439199611517362,1019375.5184760886,2511.6974886311036,1021887.2159647198,2590,0,466.4228855721393,70,131,38,36.95583866544788,0.5440505804311775,43.19248826291078,7938.829449192207,113.41184927417439,0
2727,31.30558672984721,2,2,200,0.009900990099009901,0.009900990099009901,0.9900990099009901,202,7100,4400,2700,0.6197183098591549,98,44,54,238.3361302488,0.47139252171485807,0.7989385310891941,0.14272772857428062,1034433.6736580743,1808.5837557427785,1036242.2574138171,2591,0,464.76732673267327,75,127,33,36.80066823061065,0.547184405940594,42.92763157894735,8047.801325452452,107.30401767269936,0
2728,31.48025756571275,4,2,202,0.0196078431372549,0.00980392156862745,0.9901960784313726,204,5800,4200,1600,0.7241379310344828,74,42,32,242.31599137381434,0.47151741443703915,0.8073057211222683,0.14665483856750786,1043346.0831878003,3963.8880987274288,1047309.9712865277,2592,0,461.1764705882353,67,137,36,36.30115676008011,0.5499897875816994,42.53982843137254,8104.912513892973,120.96884349093989,0
2729,31.66496322927628,1,0,203,0.0049261083743842365,0.0,1.0,203,6850,4900,1950,0.7153284671532847,88,49,39,239.1237714214815,0.47151229901315256,0.8016516160143456,0.14562208115907008,1051308.081504109,2828.5506750290624,1054136.6321791383,2593,0,463.66995073891627,73,130,38,36.152308896900834,0.5525451559934318,42.31418918918919,8159.61172403058,111.77550306891206,0
2730,31.700635947757938,1,3,201,0.004901960784313725,0.014705882352941176,0.9852941176470589,204,6250,4600,1650,0.736,79,46,33,242.50837910982918,0.47168845986670527,0.8054833837655717,0.14834161641429922,1053811.4021760607,4061.6190058345974,1057873.0211818954,2594,0,462.3921568627451,74,130,39,35.899766585869465,0.5543811274509804,42.15277777777778,8173.920921807311,110.45839083523393,0
2731,31.843713111268055,1,4,198,0.0049504950495049506,0.019801980198019802,0.9801980198019802,202,6100,4100,2000,0.6721311475409836,81,41,40,242.06181899447486,0.4712668095167725,0.8041784892547263,0.14860037694435796,1059633.291415518,4799.352397428708,1064432.6438129465,2595,0,458.2178217821782,75,127,31,35.77838876492048,0.5557962046204621,42.02302631578948,8214.944739313165,109.53259652417553,0
2732,31.40213099861553,0,3,195,0.0,0.015151515151515152,0.9848484848484849,198,5500,3900,1600,0.7090909090909091,71,39,32,245.15775993332957,0.47054673212668136,0.8068795553458132,0.14232583378047284,1028324.9312037232,5320.3673235000815,1033645.2985272233,2596,3,467.59090909090907,68,130,34,37.808100322479156,0.5365635521885521,44.08212560386474,8036.366616674684,118.18186200992183,8
2733,31.038084543104084,0,2,193,0.0,0.010256410256410256,0.9897435897435898,195,5800,4200,1600,0.7241379310344828,74,42,32,271.9724777482198,0.4701989162040709,0.8243200760292115,0.15849986446051179,1017548.0249302174,10549.011513615711,1028097.0364438331,2597,4,472.9076923076923,71,124,33,36.97389918451135,0.5392628205128205,43.9380787037037,7947.671561464108,111.93903607695927,8
2734,31.22082893864297,4,1,196,0.02030456852791878,0.005076142131979695,0.9949238578680203,197,6500,4400,2100,0.676923076923077,86,44,42,250.25200987654182,0.4710959891570841,0.8078547095318656,0.1409076632187743,1013121.0747118067,4807.117038982627,1017928.1917507893,2598,0,468.9187817258883,68,129,37,38.86925925925926,0.5318845177664975,45.244565217391326,7953.675850537491,116.96582133143369,8
2735,31.392095237588418,5,1,200,0.024875621890547265,0.004975124378109453,0.9950248756218906,201,6500,4400,2100,0.676923076923077,86,44,42,252.38262126374013,0.47131737147595354,0.8139199109348356,0.14436285936285928,1023496.4214181204,4962.541938312505,1028458.9633564329,2599,0,460.5273631840796,62,139,39,38.19808663558663,0.5353959369817578,44.64285714285714,8016.195748169894,129.29347980919184,0
2736,31.380385848148983,4,2,202,0.0196078431372549,0.00980392156862745,0.9901960784313726,204,6300,4600,1700,0.7301587301587301,80,46,34,243.3259856287638,0.47172015357867286,0.8092621584598045,0.14074801703556328,1026510.0446786846,2855.3136758536175,1029365.3583545382,2600,0,454.44117647058823,70,134,44,37.99567894153188,0.5379901960784313,44.21948356807513,8026.491298072633,114.66416140103762,0
2737,31.84980768773403,4,2,204,0.019417475728155338,0.009708737864077669,0.9902912621359223,206,6750,5300,1450,0.7851851851851852,82,53,29,239.6559516221352,0.4722092311942537,0.8088616904797024,0.14016423803882821,1045246.4777935006,2149.907863057175,1047396.3856565579,2601,0,450.88349514563106,75,131,42,37.66495470432983,0.5407059061488673,43.80482456140351,8159.767068244576,108.79689424326101,0
2738,32.07668596314578,1,1,204,0.004878048780487805,0.004878048780487805,0.9951219512195122,205,7550,5100,2450,0.6754966887417219,100,51,49,213.2541118555107,0.4719781205164993,0.7912843254306674,0.12198135198135196,1045816.5676982895,-3945.063338344626,1041871.5043599448,2602,0,452.1658536585366,69,136,38,39.197261072261064,0.5396849593495935,44.64285714285714,8191.010879874715,118.71030260687994,8
2739,32.083979305373404,4,1,207,0.019230769230769232,0.004807692307692308,0.9951923076923077,208,7250,5100,2150,0.7034482758620689,94,51,43,211.01852391404276,0.47256528319707664,0.7912629673125857,0.12231604704752039,1050173.1278600942,-4528.8033409539985,1045644.3245191402,2603,0,446.6105769230769,79,129,36,38.74151823579302,0.5427183493589743,44.140625,8208.986892585774,103.91122648842752,0
2740,31.64962814887647,1,1,207,0.004807692307692308,0.004807692307692308,0.9951923076923077,208,6450,4700,1750,0.7286821705426356,82,47,35,207.72346357821235,0.47243125232255667,0.7890033813978417,0.12134434003596084,1038317.1511400427,-4913.433014505428,1033403.7181255373,2604,0,447.59615384615387,83,125,38,38.52835334366124,0.5449719551282051,43.84920634920636,8107.077369087244,97.67563095285836,0
2741,31.254641915653963,0,3,204,0.0,0.014492753623188406,0.9855072463768116,207,6350,4700,1650,0.7401574803149606,80,47,33,210.8910491562106,0.4724156934477745,0.7912729933794325,0.12377183282486345,1026758.0133544563,-4443.1850668265015,1022314.8282876298,2605,1,450.7391304347826,68,139,37,38.26884190274261,0.5464472624798712,43.67451690821256,8011.361187890829,117.8141351160416,0
2742,30.850731080020253,3,3,204,0.014492753623188406,0.014492753623188406,0.9855072463768116,207,6050,4100,1950,0.6776859504132231,80,41,39,209.763177009414,0.47212548660944603,0.7901813283103449,0.12431041705448999,1016344.8578257245,-4811.654737059069,1011533.2030886655,2606,0,451.6521739130435,73,134,42,37.929291198245124,0.5487117552334944,43.31362612612612,7918.962292288397,108.47893551079996,0
2743,30.66226285544263,2,2,204,0.009708737864077669,0.009708737864077669,0.9902912621359223,206,6750,4700,2050,0.6962962962962963,88,47,41,210.67005599484526,0.47193937958797066,0.7900531445023362,0.12566098314868357,1012026.0544491753,-5309.282888190139,1006716.7715609851,2607,0,453.49514563106794,76,130,38,37.66092302021904,0.5510720064724919,43.07359307359306,7877.94502368187,103.65717136423514,0
2744,30.321297573718084,1,1,204,0.004878048780487805,0.004878048780487805,0.9951219512195122,205,7750,6000,1750,0.7741935483870968,95,60,35,210.88627259870873,0.47181870715765983,0.7892335805047379,0.12678849467369294,1003039.4367038312,-6444.550384804179,996594.886319027,2608,0,452.9219512195122,83,122,40,37.35837913412399,0.5542174796747967,42.78273809523809,7799.161139311247,93.96579685917165,0
2745,30.86961706432271,0,0,204,0.0,0.0,1.0,204,6900,4800,2100,0.6956521739130435,90,48,42,207.36168845367968,0.4714570454618629,0.7843585815367926,0.12518066801552172,1022368.5288559591,-5299.987126904745,1017068.5417290543,2609,1,456.13235294117646,68,136,40,37.29604156890349,0.5556066176470589,42.632850241545896,7944.825357979673,116.83566702911284,0
2746,31.078404775453187,1,3,202,0.004878048780487805,0.014634146341463415,0.9853658536585366,205,6400,4700,1700,0.734375,81,47,34,230.4490808828564,0.47149489877251716,0.7881533921947785,0.1351957323852494,1020848.1217383869,-349.2977248799343,1020498.824013507,2610,0,454.9024390243902,68,137,38,37.78296422821687,0.5479674796747968,43.68961352657003,7965.717938974054,117.1429108672655,8
2747,30.704850427919542,1,2,201,0.0049261083743842365,0.009852216748768473,0.9901477832512315,203,5850,4100,1750,0.7008547008547008,76,41,35,225.82665364441453,0.4711139833195142,0.7819810889888765,0.13330087291686865,1010380.548641423,-815.8283585803038,1009564.7202828426,2611,0,459.7536945812808,71,132,41,37.66730581246707,0.5500821018062397,43.460648148148124,7877.002427486483,110.94369616178145,0
2748,30.364551726084553,0,2,199,0.0,0.009950248756218905,0.9900497512437811,201,5950,4700,1250,0.7899159663865546,72,47,25,222.34995772229945,0.47070999170812605,0.7772020753283688,0.13179832965437857,1000391.0951888104,-1662.616455800804,998728.4787330095,2612,1,454.1641791044776,74,127,42,37.59795566857842,0.5519796849087895,43.30555555555554,7794.411736131841,105.32988832610596,0
2749,30.464895439831576,2,0,201,0.009950248756218905,0.0,1.0,201,5800,4000,1800,0.6896551724137931,76,40,36,219.94428457271724,0.47083022388059703,0.7732681915983806,0.13133435570476742,1005822.8964532339,-1755.00052654719,1004067.8959266867,2613,0,453.5074626865672,79,122,33,37.382030656194566,0.5544154228855722,43.03385416666666,7828.446764388989,99.09426284036695,0
2750,30.462458618427853,1,0,202,0.0049504950495049506,0.0,1.0,202,6350,4600,1750,0.7244094488188977,81,46,35,215.47841496449436,0.4708496502635338,0.7715082326861566,0.12954937052734844,1007709.0948682253,-3322.0882984980517,1004387.0065697272,2614,0,452.25742574257424,83,119,39,37.24026130556358,0.5561571782178218,42.78273809523808,7835.4701967190895,94.40325538215771,0
2751,30.672282010821007,1,0,203,0.0049261083743842365,0.0,1.0,203,6350,4600,1750,0.7244094488188977,81,46,35,213.81206828399962,0.47091685769562175,0.7722210684587851,0.12911461964604012,1015922.3859643965,-3506.7066881874407,1012415.6792762091,2615,0,451.02463054187194,71,132,39,37.11846543001687,0.5577278325123153,42.621527777777764,7894.385083514231,111.18852230301734,0
2752,31.13379468964099,0,0,203,0.0,0.0,1.0,203,6600,5300,1300,0.803030303030303,79,53,26,207.26704495430192,0.4706801037246582,0.7637299275833724,0.12582812389152015,1032760.813614134,-4388.543603519944,1028372.2700106141,2616,1,452.02463054187194,77,126,39,37.08926349354486,0.5596264367816092,42.42788461538459,8019.197358161076,104.14542023585814,0
2753,30.79667978071767,0,2,201,0.0,0.009852216748768473,0.9901477832512315,203,7200,5200,2000,0.7222222222222222,92,52,40,242.97076150102308,0.4705388642312507,0.8006704304000001,0.14423533195934923,1015062.7139886662,1526.1121178239418,1016588.8261064901,2617,2,453.02463054187194,72,131,37,37.012310342911086,0.548132183908046,43.25057077625568,7907.029955685625,109.81986049563369,8
2754,30.710460061527204,4,0,205,0.01951219512195122,0.0,1.0,205,6250,4200,2050,0.672,83,42,41,237.8192831395974,0.4708851426749561,0.8066881423531218,0.13743139259313167,1004312.5324172167,518.9773015152387,1004831.509718732,2618,0,447.4829268292683,67,138,40,38.17341768992713,0.5370934959349594,44.25551470588235,7854.030801580821,117.22434032210181,8
2755,30.9240393376452,5,1,209,0.023809523809523808,0.004761904761904762,0.9952380952380953,210,5550,3800,1750,0.6846846846846847,73,38,35,211.81049211866033,0.4720679539758487,0.7893470368037527,0.11973408913139327,1004683.0087237213,-4989.519499794497,999693.4892239268,2619,0,437.8047619047619,75,135,40,39.69400831630638,0.5293154761904761,45.09320175438596,7882.747856380547,105.10330475174062,8
2756,30.482076874948834,3,2,210,0.014150943396226415,0.009433962264150943,0.9905660377358491,212,6400,4900,1500,0.765625,79,49,30,201.74964136981194,0.4725904646934335,0.7810381877152635,0.11522418727473488,993373.3162128438,-8717.457941543471,984655.8582713003,2620,0,434.5188679245283,68,144,43,39.55044054165925,0.5317413522012578,44.70108695652175,7782.041093482204,114.441780786503,0
2757,30.34355916765208,1,3,208,0.004739336492890996,0.014218009478672985,0.985781990521327,211,6950,5100,1850,0.7338129496402878,88,51,37,202.84985950668937,0.47257579177010456,0.7822671279459876,0.11668325523235706,990960.5125861593,-8946.75984904389,982013.7527371154,2621,0,437.3649289099526,71,140,45,39.24574252287951,0.5339158767772512,44.42997685185187,7754.904118874083,109.22400167428286,0
2758,30.357899190960378,3,2,209,0.014218009478672985,0.009478672985781991,0.990521327014218,211,6550,4100,2450,0.6259541984732825,90,41,49,210.66212291238674,0.4727243662077785,0.7947353998858604,0.1203882230282913,989507.5172338217,-7059.649156351819,982447.8680774699,2622,0,438.2132701421801,63,148,44,39.29906132466374,0.5302626382306477,44.67773437499998,7751.047601051316,123.03250160398913,8
2759,29.968086033337144,1,1,209,0.004761904761904762,0.004761904761904762,0.9952380952380953,210,6250,4100,2150,0.656,84,41,43,205.6739893408432,0.4731155540366067,0.7889212303846447,0.11847020573457481,979095.9442019244,-7975.086241710357,971120.857960214,2623,0,440.4761904761905,67,143,39,39.12058538582928,0.5326388888888889,44.37806372549017,7660.500178282689,114.33582355645805,0
2760,30.55729292339855,2,0,211,0.009478672985781991,0.0,1.0,211,5150,3400,1750,0.6601941747572816,69,34,35,200.9022607347781,0.47381234484315055,0.7847141534001818,0.11664558259236717,1000689.7639552386,-7141.832825448518,993547.9311297901,2624,0,438.8436018957346,72,139,41,38.93666945451167,0.5350513428120063,44.07819634703194,7820.277519708181,108.61496555150251,0
2761,30.434474956544758,0,2,209,0.0,0.009478672985781991,0.990521327014218,211,5850,4300,1550,0.7350427350427351,74,43,31,202.43749894710956,0.473817986910404,0.7859570930344362,0.1179212634184893,997622.8973112025,-7658.743155190282,989964.1541560122,2625,1,439.8436018957346,75,136,43,38.77229314990273,0.5364336492890995,43.95559210526316,7792.577119835698,103.90102826447597,0
2762,30.56808530404859,2,3,208,0.009478672985781991,0.014218009478672985,0.985781990521327,211,6600,4600,2000,0.696969696969697,86,46,40,199.48790292634777,0.4733045587903408,0.7812876429857962,0.11736411607911282,1004913.5353016654,-8706.381244074008,996207.1540575915,2626,0,440.69668246445497,68,143,45,38.46874693356878,0.5390995260663507,43.583937198067595,7838.148081057675,115.26688354496581,0
2763,31.041760532344984,2,2,208,0.009523809523809525,0.009523809523809525,0.9904761904761905,210,5900,4300,1600,0.7288135593220338,75,43,32,198.6202091957273,0.47237506645401384,0.7797794226220693,0.11747004503183016,1022043.1262455806,-7300.316091609906,1014742.8101539707,2627,0,443.7190476190476,71,139,46,38.29148343387647,0.5406746031746033,43.388310185185155,7965.678625031801,112.19265669058875,0
2764,31.292941601693627,0,1,207,0.0,0.004807692307692308,0.9951923076923077,208,7100,4700,2400,0.6619718309859155,95,47,48,203.43080837095553,0.47205432072959247,0.7846039962127977,0.11934237886176155,1027888.2025011643,-6879.1744100442265,1021009.0280911201,2628,1,448.3269230769231,69,139,38,38.476350828301555,0.5433193108974359,43.69047619047617,8020.678960529288,116.24172406564185,8
2765,31.6766543509493,2,1,208,0.009569377990430622,0.004784688995215311,0.9952153110047847,209,6200,4000,2200,0.6451612903225806,84,40,44,198.62085446019898,0.47213819623359093,0.7795238207475705,0.11733684184340376,1042603.497897064,-6583.440476898828,1036020.0574201652,2629,0,447.1004784688995,74,135,41,38.33455132716218,0.5451056618819776,43.430555555555536,8127.261608681709,109.82785957677984,0
2766,31.450460722362816,0,0,208,0.0,0.0,1.0,208,6950,4900,2050,0.7050359712230215,90,49,41,199.38325727883608,0.47205238526570054,0.7789126385654501,0.11820984569722406,1036230.9148702114,-7228.58098002995,1029002.3338901814,2630,1,448.4567307692308,75,133,38,38.17948324345489,0.5465244391025641,43.29769736842104,8073.405686254538,107.6454091500605,0
2767,31.685524571343098,0,0,208,0.0,0.0,1.0,208,6200,3600,2600,0.5806451612903226,88,36,52,200.74814849068278,0.47204028861637554,0.7797686907476313,0.11936879701533139,1044859.2765570732,-5849.286959570776,1039009.9895975024,2631,2,449.4567307692308,77,131,39,38.03367134685388,0.547676282051282,43.189102564102555,8137.188000893774,105.67776624537369,0
2768,31.7162178054455,2,2,208,0.009523809523809525,0.009523809523809525,0.9904761904761905,210,6150,4200,1950,0.6829268292682927,81,42,39,195.88419188538577,0.4721562428799271,0.7764520878900956,0.11714367022804652,1047588.3456385455,-7108.800697209132,1040479.5449413364,2632,0,446.1666666666667,80,130,33,37.9437481236866,0.5496527777777778,42.97839506172839,8151.753202927379,101.89691503659223,0
2769,31.99737223881213,2,6,204,0.009523809523809525,0.02857142857142857,0.9714285714285714,210,6900,4800,2100,0.6956521739130435,90,48,42,214.0060852527826,0.4720200121515911,0.7873759605877972,0.12618095999385193,1052568.1837032621,-3848.8007088062495,1048719.382994456,2633,0,445.5904761904762,79,131,38,38.013403810684146,0.5462301587301588,43.50260416666669,8207.24265276517,103.88914750335658,7
2770,31.644588582628558,1,2,203,0.004878048780487805,0.00975609756097561,0.9902439024390244,205,6300,4300,2000,0.6825396825396826,83,43,40,210.95679291786084,0.4715407301131835,0.7851845701435731,0.12332051327287903,1038366.8933350393,-3489.8900619913675,1034877.0032730479,2634,0,454.3414634146341,85,120,32,38.41843971631202,0.5456808943089431,43.822674418604656,8106.6260722213565,95.37207143789831,7
2771,31.28135252118227,1,3,201,0.004901960784313725,0.014705882352941176,0.9852941176470589,204,6350,4600,1750,0.7244094488188977,81,46,35,206.85761775758078,0.4711521821372227,0.7809313507237272,0.12162361504804363,1028174.475711674,-4612.855463026661,1023561.6202486473,2635,0,457.12745098039215,72,132,33,38.30362774562185,0.5478451797385622,43.60730593607306,8020.310246869337,111.39319787318523,0
2772,31.37724548910977,2,0,203,0.009852216748768473,0.0,1.0,203,6550,4700,1850,0.7175572519083969,84,47,37,212.6342409511331,0.47127249670779886,0.7865004749893534,0.12347508985191648,1027585.1331713498,-3450.0430390881006,1024135.0901322616,2636,0,460.23152709359607,70,133,39,38.63088072307573,0.5348932676518883,44.07276995305165,8030.29152453098,114.71845035044257,8
2773,31.443782614313875,0,3,200,0.0,0.014778325123152709,0.9852216748768473,203,5750,3800,1950,0.6608695652173913,77,38,39,212.3301481859331,0.47128367393389586,0.7853204308521684,0.1236938434033787,1030731.8878387777,-2578.9091030451164,1028152.9787357326,2637,1,461.23152709359607,71,132,39,38.515886917542474,0.5359708538587848,43.9525462962963,8051.100473207856,113.39578131278671,0
2774,31.027354645123175,0,2,198,0.0,0.01,0.99,200,5400,4000,1400,0.7407407407407407,68,40,28,221.09855244893805,0.47063965661641544,0.7884146341463405,0.12950058072009302,1018691.0773135228,-353.7754826658993,1018337.301830857,2638,2,468.05,74,126,41,38.08434959349595,0.5372916666666667,43.75000000000002,7950.759627812861,107.44269767314677,0
2775,31.290559432465166,1,2,197,0.005025125628140704,0.010050251256281407,0.9899497487437185,199,7400,5400,2000,0.7297297297297297,94,54,40,220.62064741182232,0.47072166387493025,0.7870066280527879,0.13023383793464097,1029667.6807235506,-1766.809931948465,1027900.8707916022,2639,0,462.8040201005025,67,132,41,37.79912073804263,0.540462730318258,43.458946078431346,8027.313094600033,119.81064320298556,0
2776,30.987306399857722,0,3,194,0.0,0.015228426395939087,0.9847715736040609,197,7050,5500,1550,0.7801418439716312,86,55,31,216.39487502625573,0.4705542750094962,0.7810431839917611,0.12827531251556337,1020924.1647852468,-2265.4485900026507,1018658.7161952442,2640,1,467.9137055837563,69,128,41,37.748792270531375,0.5423011844331641,43.30357142857141,7954.330883892008,115.28015773756533,0
2777,30.68829217804145,0,1,193,0.0,0.005154639175257732,0.9948453608247423,194,6300,4600,1700,0.7301587301587301,80,46,34,219.42547836808492,0.4706757562808255,0.7796631729209793,0.1305663638447199,1012179.202335662,-680.4188666546438,1011498.7834690074,2641,2,474.6340206185567,70,124,40,37.527490574660106,0.5441365979381443,43.16314553990607,7881.884431760392,112.59834902514845,0
2778,31.144841714225134,0,0,193,0.0,0.0,1.0,193,6100,4000,2100,0.6557377049180327,82,40,42,237.95843613884554,0.4704366364421417,0.7957388631780411,0.13608800064653157,1015381.2634181534,3623.7075055338128,1019004.9709236872,2642,3,478.0518134715026,65,128,35,38.573343531738686,0.5344343696027634,44.64962121212121,7952.84712901591,122.35149429255246,8
2779,31.166323722232043,1,1,193,0.005154639175257732,0.005154639175257732,0.9948453608247423,194,6650,5500,1150,0.8270676691729323,78,55,23,233.08086393553373,0.4708187552303118,0.7932136885707328,0.13426770894314544,1018268.3200349021,2017.7719503838898,1020286.091985286,2643,0,476.58247422680415,69,125,36,38.4168704156479,0.5363509450171822,44.375,7966.891501495566,115.46219567384878,0
2780,31.513920613273456,4,4,193,0.02030456852791878,0.02030456852791878,0.9796954314720813,197,7150,5100,2050,0.7132867132867133,92,51,41,231.16197518504808,0.4712492230394696,0.797751349988671,0.13489983348868917,1033559.4909565562,1233.9306801543034,1034793.4216367105,2644,0,470.26395939086296,75,122,38,37.96670412786758,0.5395516074450084,43.88706140350879,8071.122814962039,107.61497086616052,0
2781,31.04700431282516,1,1,193,0.005154639175257732,0.005154639175257732,0.9948453608247423,194,5950,3900,2050,0.6554621848739496,80,39,41,230.42669721554165,0.4710413216886562,0.7940922780978124,0.13508004918881722,1019591.2251894587,2238.2077060708434,1021829.4328955295,2645,0,477.3453608247423,64,130,40,37.812526054694025,0.5423646907216495,43.71794871794871,7956.789951453505,124.32484299146101,0
2782,31.019338009238172,2,3,192,0.010256410256410256,0.015384615384615385,0.9846153846153847,195,6200,4800,1400,0.7741935483870968,76,48,28,228.1866803939234,0.47095779363820606,0.7927248124490076,0.13492252323609633,1021230.355064047,1406.2329279145374,1022636.5879919616,2646,0,475.7794871794872,67,128,40,37.542348218016826,0.544818376068376,43.39767156862745,7959.634359570294,118.80051282940737,0
2783,31.358331546663884,5,3,194,0.025380710659898477,0.015228426395939087,0.9847715736040609,197,6100,4200,1900,0.6885245901639344,80,42,38,214.29330298889883,0.4715610863634794,0.7792369003549819,0.12769968947628396,1034715.1720610827,-1153.4936252609687,1033561.6784358217,2647,0,468.9543147208122,77,120,32,37.60397171969223,0.5486463620981388,43.10897435897435,8055.673953413794,104.61914225212719,0
2784,30.971055014496436,2,0,196,0.01020408163265306,0.0,1.0,196,6200,4300,1900,0.6935483870967742,81,43,38,214.33149769000966,0.4713081065759637,0.7801751439815652,0.12819772581992475,1023026.1167074486,-1546.6560460197543,1021479.4606614289,2648,0,472.33673469387753,78,118,38,37.46312778946288,0.5497980442176871,42.9720464135021,7960.426890790837,102.05675501013894,0
2785,30.64314002217371,1,3,194,0.005076142131979695,0.015228426395939087,0.9847715736040609,197,6000,3800,2200,0.6333333333333333,82,38,44,217.04796967901413,0.4712492230394696,0.7837144268677767,0.1265105326528606,1004645.630247466,-1788.7411415784181,1002856.8891058876,2649,0,470.93401015228426,79,118,36,38.374394047255855,0.5391814720812182,43.932291666666686,7846.718641615519,99.3255524255129,8
2786,30.934706754183757,0,2,192,0.0,0.010309278350515464,0.9896907216494846,194,6250,3900,2350,0.624,86,39,47,220.35680616873947,0.47040366878549933,0.7848130249915788,0.12893299997943633,1015343.4555500083,-302.43179413359985,1015041.0237558747,2650,1,476.5515463917526,80,114,37,38.14278723083875,0.5415055841924399,43.78858024691359,7925.825137134833,99.07281421418541,0
2787,31.32696358822484,0,3,189,0.0,0.015625,0.984375,192,4850,3800,1050,0.7835051546391752,59,38,21,220.89285417810504,0.4702208087914485,0.782328961056806,0.12979939272154237,1029497.584953254,2231.7319819580375,1031729.316935212,2651,2,481.8020833333333,68,124,38,37.96617987673224,0.5429144965277778,43.62922705314009,8031.317869191325,118.10761572340185,0
2788,31.839804062916247,2,1,190,0.010471204188481676,0.005235602094240838,0.9947643979057592,191,5900,4200,1700,0.711864406779661,76,42,34,218.9992102282766,0.47064044272986133,0.7791975829050171,0.12938710096189512,1048000.5643710125,1802.259183207958,1049802.8235542204,2652,0,482.29842931937173,70,121,38,37.8083066483684,0.5450479930191972,43.42723004694835,8169.226723184836,116.70323890264052,0
2789,31.95383167723187,1,2,189,0.005235602094240838,0.010471204188481676,0.9895287958115183,191,6950,5300,1650,0.762589928057554,86,53,33,225.04126619115473,0.47106296500413336,0.7824672399467449,0.1322433508067113,1050112.8922579638,2113.7469834772196,1052226.639241441,2653,0,482.2565445026178,67,124,40,37.85801067558954,0.5464114310645725,43.627450980392126,8192.085278035358,122.26992952291579,7
2790,32.17223476129504,0,0,189,0.0,0.0,1.0,189,6600,4800,1800,0.7272727272727273,84,48,36,245.69053256166796,0.4704468272730684,0.7926996154785539,0.1452910680210353,1059226.2028507085,7648.369976332564,1066874.5728270411,2654,1,485.58730158730157,69,120,35,37.08826258408722,0.5471781305114638,43.39285714285713,8255.625241425145,119.64674262934993,8
2791,32.621774629406616,3,0,192,0.015625,0.0,1.0,192,6550,4500,2050,0.6870229007633588,86,45,41,240.00250264529382,0.4708604884744037,0.7885229689302204,0.14301180054533938,1076386.4647200617,6717.089069266719,1083103.5537893286,2655,0,478.984375,74,118,42,36.945713487600884,0.5497504340277778,43.11111111111109,8380.171438131967,113.24555997475632,0
2792,32.41631090525922,0,2,190,0.0,0.010416666666666666,0.9895833333333334,192,7200,5300,1900,0.7361111111111112,91,53,38,237.74510668533057,0.47063495309773123,0.7871290832905777,0.14204942149899072,1070435.7940454055,5298.174411024137,1075733.9684564297,2656,1,479.984375,78,114,33,36.90182999828973,0.5514322916666667,43.011603375527415,8330.615764022941,106.80276620542233,0
2793,32.707150532434625,1,0,191,0.005235602094240838,0.0,1.0,191,5400,3700,1700,0.6851851851851852,71,37,34,208.62040138680624,0.47023514283089923,0.7666519650094707,0.1201227017049782,1068467.1629218895,980.8096794774992,1069447.972601367,2657,0,482.37696335078533,72,119,38,39.059621503935695,0.537303664921466,44.39212328767125,8360.205300906158,116.11396251258553,8
2794,32.41475749184917,3,1,193,0.015463917525773196,0.005154639175257732,0.9948453608247423,194,6150,4100,2050,0.6666666666666666,82,41,41,216.50586594007416,0.4710335318626142,0.7802643063443857,0.12129781336539318,1050274.0550048084,528.0987506418396,1050802.1537554502,2658,0,475.9020618556701,70,124,41,39.925772770061286,0.527759879725086,45.43720657276995,8251.59121539136,117.87987450559085,8
2795,32.83233171232296,6,2,197,0.03015075376884422,0.010050251256281407,0.9899497487437185,199,6250,4100,2150,0.656,84,41,43,238.4156403244885,0.47213656667174253,0.8034787125761376,0.13543553867432118,1068249.8123390789,4887.492607067328,1073137.3049461462,2659,0,464.86934673366835,72,127,38,38.82397773675673,0.5318781407035176,44.905821917808225,8375.33667267692,116.3241204538461,8
2796,32.72716848585448,4,0,201,0.01990049751243781,0.0,1.0,201,6500,4500,2000,0.6923076923076923,85,45,40,246.3063179332216,0.4729332504145937,0.8086980370694208,0.14204044301175717,1069607.6743972492,5990.22558278054,1075597.8999800298,2660,0,461.2238805970149,65,136,39,38.03674866761321,0.5348776948590381,44.33396464646465,8367.22541512559,128.72654484808598,0
2797,32.271227767035434,3,0,204,0.014705882352941176,0.0,1.0,204,6250,4900,1350,0.784,76,49,27,244.96090697134474,0.4732892438584629,0.8099227032585181,0.1425930332159512,1057616.5865279213,4764.943652763423,1062381.5301806848,2661,0,455.4264705882353,71,133,36,37.71002863170584,0.5374285130718954,43.98148148148148,8262.03192369009,116.36664681253649,0
2798,32.73530447489343,1,1,204,0.004878048780487805,0.004878048780487805,0.9951219512195122,205,6000,4300,1700,0.7166666666666667,77,43,34,245.28672833195137,0.4735931771082417,0.8107232368070476,0.14334386262636029,1074058.174686428,5690.443141404433,1079748.6178278325,2662,0,454.2,73,132,38,37.55105872440197,0.5391768292682927,43.83445945945947,8385.656965570266,114.87201322698995,0
2799,33.02061597474818,1,0,205,0.004878048780487805,0.0,1.0,205,6900,4600,2300,0.6666666666666666,92,46,46,240.76066534385893,0.4733939104096923,0.8087468894810181,0.1415176223207685,1085253.4348293894,4357.267807246362,1089610.7026366359,2663,0,455.1170731707317,62,143,39,37.44504815340295,0.5409044715447154,43.61772486772486,8465.900649875077,136.54678467540447,0
2800,33.091917229121904,2,3,204,0.00966183574879227,0.014492753623188406,0.9855072463768116,207,5950,4300,1650,0.7226890756302521,76,43,33,235.01252031065383,0.47403186217031723,0.8118089103596347,0.13509223106292717,1080499.3668893208,3436.175881345096,1083935.5427706658,2664,0,451.71014492753625,61,146,40,38.4500328731098,0.5293377616747181,44.455645161290334,8456.452638691962,138.63037112609774,7
2801,33.21447523402779,3,0,207,0.014492753623188406,0.0,1.0,207,7000,5000,2000,0.7142857142857143,90,50,40,226.03721944434457,0.47402013664149584,0.804259746661008,0.13094164418799883,1086981.2686021498,739.6447085832788,1087720.9133107332,2665,0,452.07246376811594,67,140,41,38.38074815879291,0.5325080515297906,44.16360294117648,8497.47167407321,126.8279354339285,0
2802,32.709988132477655,3,0,210,0.014285714285714285,0.0,1.0,210,6500,4800,1700,0.7384615384615385,82,48,34,216.9344413480147,0.47429606212500947,0.7963972953958736,0.12396144322454405,1066144.3868125675,-2243.312610098639,1063901.0742024689,2666,0,446.6,65,145,44,39.142442459458884,0.5271329365079365,44.68118686868688,8351.475347523556,128.48423611574702,8
2803,32.23920739883346,0,2,208,0.0,0.009523809523809525,0.9904761904761905,210,6100,4200,1900,0.6885245901639344,80,42,38,215.581209131431,0.4744740639477481,0.7961457410142774,0.12381106089411217,1052376.3208786128,-2725.4880567400996,1049650.8328218728,2667,1,447.6,68,142,45,38.98141309699654,0.5286706349206349,44.489734299516925,8237.448448448959,121.13894777130821,0
2804,32.42773868391191,1,1,208,0.004784688995215311,0.004784688995215311,0.9952153110047847,209,7000,5000,2000,0.7142857142857143,90,50,40,235.2300480257002,0.4738941157526684,0.8099848904558042,0.13027314318912148,1047003.2882472553,457.32675549370833,1047460.615002749,2668,0,450.6363636363636,80,129,33,39.90721997300945,0.5214314194577352,45.88477366255145,8240.382155273945,103.0047769409243,8
2805,31.99388485511038,2,3,207,0.009523809523809525,0.014285714285714285,0.9857142857142858,210,5950,4100,1850,0.6890756302521008,78,41,37,241.5094628928733,0.4739671147565884,0.8168012945929635,0.13538840454048687,1036828.1764929953,2130.76320340395,1038958.9396963993,2669,0,449.3666666666667,71,139,33,39.26527485745675,0.5241071428571429,45.41377314814814,8145.20242759514,114.72116095204423,0
2806,32.21925316303165,6,6,207,0.028169014084507043,0.028169014084507043,0.971830985915493,213,6000,3400,2600,0.5666666666666667,86,34,52,230.14794926228961,0.474768026397378,0.8109971785536005,0.1306015530105566,1047972.2760072475,-362.26595864006686,1047610.0100486075,2670,0,442.2488262910798,80,133,34,39.07597186507335,0.5279733959311423,44.94598765432096,8217.649794012359,102.72062242515449,0
2807,31.779415722989278,4,0,211,0.018957345971563982,0.0,1.0,211,6150,4300,1850,0.6991869918699187,80,43,37,216.1182367375161,0.47432765365229823,0.7981503405614563,0.12232176867939264,1032860.3276737448,-3706.009437403522,1029154.3182363412,2671,0,443.8056872037915,77,134,39,39.5353722521956,0.5289296998420221,45.045405982905976,8102.308033755173,105.22477965915809,7
2808,31.3379631163417,2,2,211,0.009389671361502348,0.009389671361502348,0.9906103286384976,213,7750,5300,2450,0.6838709677419355,102,53,49,214.93557660067057,0.47434080373224674,0.8009667026150791,0.12437443670868549,1025239.9229512599,-6277.893201288749,1018962.0297499711,2672,0,440.62910798122067,70,143,41,38.70686358856709,0.5358470266040689,44.204812206572775,8016.10016040813,114.515716577259,8
2809,31.375008031765045,0,3,208,0.0,0.014218009478672985,0.985781990521327,211,7150,5000,2150,0.6993006993006993,93,50,43,211.10572761348806,0.47383209207853755,0.79533119446762,0.12267610882697554,1027729.9713983494,-5958.063319552275,1021771.9080787972,2673,1,445.7962085308057,73,138,40,38.64226429448753,0.5377172195892574,44.04560810810812,8030.571101373673,110.00782330648866,0
2810,31.472263808813043,1,1,208,0.004784688995215311,0.004784688995215311,0.9952153110047847,209,6050,4200,1850,0.6942148760330579,79,42,37,212.50578359442156,0.4738759047969574,0.795230870968997,0.12446767324816099,1033298.3488791921,-3933.6249369211637,1029364.723942271,2674,0,450.95215311004785,64,145,42,38.304539295392935,0.5398225677830941,43.74999999999999,8064.767601008329,126.01199376575514,0
2811,31.14562167910115,4,2,210,0.018867924528301886,0.009433962264150943,0.9905660377358491,212,7250,5500,1750,0.7586206896551724,90,55,35,212.48737718275243,0.4743882082923485,0.7945515727224397,0.12598751740313818,1026207.1316053616,-6038.787631788348,1020168.3439735733,2675,0,445.5,70,142,44,37.84053456783067,0.542944182389937,43.29518779342722,7995.230964190597,114.21758520272282,0
2812,30.93802054400559,1,1,210,0.004739336492890996,0.004739336492890996,0.995260663507109,211,5950,3900,2050,0.6554621848739496,80,39,41,210.53172858819684,0.4739505754908599,0.791245442034471,0.12551037223516157,1020968.5166382368,-5160.746671605071,1015807.7699666318,2676,0,448.39336492890993,72,139,38,37.68491261201211,0.5450236966824644,43.093607305936054,7948.175255055281,110.3913229868789,0
2813,30.60837073081652,1,2,209,0.004739336492890996,0.009478672985781991,0.990521327014218,211,6050,4000,2050,0.6611570247933884,81,40,41,209.97008526685832,0.4739139020537125,0.7912458665288997,0.1258074834138005,1011549.1466099794,-5770.987886937076,1005778.1587230423,2677,0,449.34123222748815,72,139,40,37.50994431185362,0.5467022116903634,42.908105022831045,7869.164033349321,109.29394490762945,0
2814,31.10634941712675,1,3,207,0.004761904761904762,0.014285714285714285,0.9857142857142858,210,6200,4500,1700,0.7258064516129032,79,45,34,214.46454973149463,0.4736011430090377,0.796425731772711,0.12900074868233732,1029147.8748797068,-4056.852881359805,1025091.021998347,2678,0,452.45714285714286,72,138,42,37.24864092749763,0.5480654761904762,42.765410958904106,8001.629008883325,111.13373623449063,0
2815,31.120022278608673,2,5,204,0.009569377990430622,0.023923444976076555,0.9760765550239234,209,7150,5500,1650,0.7692307692307693,88,55,33,209.230108607995,0.47297973408170774,0.7904801721868655,0.12676883050955018,1031725.9886055003,-5776.371870076,1025949.6167354243,2679,0,455.41148325358853,64,145,44,37.1123247033441,0.5502890749601276,42.50000000000001,8013.40573674175,125.20946463658984,0
2816,31.282401510773557,2,1,205,0.009708737864077669,0.0048543689320388345,0.9951456310679612,206,6950,5500,1450,0.7913669064748201,84,55,29,204.53432311701602,0.4727958007735417,0.7816312895190982,0.12483493126913452,1039257.5499059242,-5637.23209714851,1033620.3178087757,2680,0,461.8349514563107,67,139,44,36.961245320021405,0.5531957928802589,42.233455882352956,8063.55652913279,120.35158998705657,0
2817,31.568394728687245,0,2,203,0.0,0.00975609756097561,0.9902439024390244,205,5350,3600,1750,0.6728971962616822,71,36,35,215.59718572852796,0.4725729316116691,0.7930857759125689,0.1263850939299579,1036709.8852303189,-1647.653265479652,1035062.2319648393,2681,1,463.25365853658536,65,140,41,38.19307591246869,0.5438008130081301,43.71843434343434,8090.397626332431,124.4676557897297,8
2818,31.322654985987104,1,2,202,0.004901960784313725,0.00980392156862745,0.9901960784313726,204,6750,4800,1950,0.7111111111111111,87,48,39,209.43682733583074,0.4719958385653112,0.785970081518309,0.12360429532496958,1030657.0169383535,-4378.492860204224,1026278.5240781493,2682,0,464.0049019607843,69,135,41,38.0945216273179,0.5462622549019608,43.46726190476188,8035.286447967672,116.45342678214017,0
2819,31.835133869758234,3,3,202,0.014634146341463415,0.014634146341463415,0.9853658536585366,205,6250,4200,2050,0.672,83,42,41,199.81500329519037,0.47136238641798184,0.7770498293094246,0.11849029695404703,1048967.6908384894,-5330.103479712138,1043637.5873587773,2683,0,462.5219512195122,76,129,41,38.1605932054525,0.5500508130081301,43.290043290043265,8172.39583756125,107.53152417843751,8
2820,32.08899844035734,0,0,202,0.0,0.0,1.0,202,5800,4000,1800,0.6896551724137931,76,40,36,205.22848183447175,0.47063055186115627,0.7791422564052013,0.12222733276115297,1058649.046052523,-2747.0126966261887,1055902.0333558968,2684,1,469.4257425742574,78,124,42,37.85857587735053,0.5515676567656767,43.13027426160335,8242.692228594356,105.67554139223535,0
2821,32.29750556585705,1,0,203,0.0049261083743842365,0.0,1.0,203,5950,4100,1850,0.6890756302521008,78,41,37,206.5833734970415,0.47070449039977885,0.781112808430729,0.12366188476587506,1067084.5726914771,-2461.6138333494364,1064622.9588581277,2685,0,468.10837438423647,79,124,40,37.63233208388209,0.5535201149425287,42.94270833333331,8302.309308348236,105.092522890484,0
2822,32.07370776077621,2,1,204,0.00975609756097561,0.004878048780487805,0.9951219512195122,205,6900,5400,1500,0.782608695652174,84,54,30,212.40798854764398,0.4709259923481588,0.7901908513375511,0.1280715707997108,1061880.3346725693,-2789.6268067799756,1059090.7078657893,2686,0,464.5317073170732,66,139,43,37.21149779469521,0.5559451219512195,42.677238805970156,8253.295042733329,125.04992488989892,0
2823,31.81479513512158,0,1,203,0.0,0.004901960784313725,0.9950980392156863,204,7000,5200,1800,0.7428571428571429,88,52,36,210.86818740073556,0.47069136562671043,0.778945260347129,0.1248342336098251,1047787.3176439868,-3610.9975093868798,1044176.3201345999,2687,1,467.04411764705884,75,129,42,37.94064307966176,0.5501940359477124,43.352521929824555,8165.186936748227,108.86915915664302,8
2824,31.46957739075856,3,1,205,0.014563106796116505,0.0048543689320388345,0.9951456310679612,206,5300,3300,2000,0.6226415094339622,73,33,40,213.95222828300592,0.4709665324808588,0.783915731303177,0.127948810127592,1039441.799742857,-2021.8221549039135,1037419.9775879531,2688,0,463.38349514563106,80,126,37,37.47936055238668,0.5527912621359223,42.97839506172837,8088.361287701846,101.10451609627307,0
2825,31.361329918448092,1,2,204,0.0048543689320388345,0.009708737864077669,0.9902912621359223,206,5950,4100,1850,0.6890756302521008,78,41,37,238.53573316175857,0.470629587970637,0.8064995786962821,0.1387824770553061,1027643.8243309037,1875.954613185243,1029519.778944089,2689,0,464.378640776699,78,128,35,37.89402523821786,0.5431330906148868,44.00052742616035,8028.4839183369295,102.9292810043196,8
2826,31.39932739765896,1,2,203,0.004878048780487805,0.00975609756097561,0.9902439024390244,205,5800,4000,1800,0.6896551724137931,76,40,36,237.62310793839518,0.4705155029491472,0.8070989490382703,0.13917924893534656,1030903.6983489266,2193.3081573718546,1033097.0065062984,2690,0,457.81951219512194,79,126,37,37.66090785907861,0.5453252032520326,43.75000000000002,8046.077645650159,101.84908412215391,0
2827,31.893812474996324,1,6,198,0.004901960784313725,0.029411764705882353,0.9705882352941176,204,6300,4700,1600,0.746031746031746,79,47,32,230.83129557678765,0.4707864467626131,0.7984900998042423,0.1360494420553864,1049045.4828439425,1330.50558476884,1050375.9884287114,2691,0,457.8578431372549,66,138,34,37.59635590309349,0.5474877450980392,43.51679104477612,8180.22736940321,123.94283893035167,0
2828,31.99850296674824,4,0,202,0.019801980198019802,0.0,1.0,202,6100,4500,1600,0.7377049180327869,77,45,32,209.2008724965305,0.47086196492783605,0.7833856556387349,0.12253193960511004,1050575.8493574886,-2543.7231381262955,1048032.1262193623,2692,0,462.0247524752475,67,135,38,38.38922764227641,0.5412025577557755,43.74999999999997,8199.61638522918,122.3823341078982,8
2829,31.844818805318543,0,3,199,0.0,0.01485148514851485,0.9851485148514851,202,6300,4500,1800,0.7142857142857143,81,45,36,211.8342570623233,0.47078859005303514,0.7857443727164313,0.12448237802651063,1046530.3540705404,-2361.803990459651,1044168.5500800807,2693,1,463.0247524752475,67,135,38,38.1966021351179,0.5429042904290429,43.62745098039213,8164.137370187007,121.85279656995533,0
2830,32.328022800755484,2,3,198,0.009950248756218905,0.014925373134328358,0.9850746268656716,201,6450,4500,1950,0.6976744186046512,84,45,39,197.54154618454046,0.47083540630182424,0.7684800086130426,0.11338635823751746,1055098.0491305874,-4964.8599996901485,1050133.1891308972,2694,0,466.1442786069652,77,124,43,39.46425304479643,0.5396455223880596,44.51121794871796,8259.447171491129,107.26554768170297,8
2831,32.026007394313275,0,4,194,0.0,0.020202020202020204,0.9797979797979798,198,5500,4100,1400,0.7454545454545455,69,41,28,202.08751328004726,0.4705456639149532,0.7686486297812294,0.11651129333888934,1046615.0525954252,-2798.433331904738,1043816.6192635205,2695,1,473.4141414141414,78,120,40,39.17685285471143,0.5406670875420876,44.34335443037976,8187.661621418025,104.97002078741058,0
2832,32.29236307046911,2,1,195,0.01020408163265306,0.00510204081632653,0.9948979591836735,196,5200,3400,1800,0.6538461538461539,70,34,36,196.464489642069,0.47045395081109365,0.7598612092732708,0.11384664826160404,1056903.2173910704,-2871.209758840364,1054032.0076322302,2696,0,475.5,82,114,37,39.12509401877107,0.542623299319728,44.15160642570282,8261.949216297508,100.75547824753058,0
2833,31.839954859110087,2,1,196,0.01015228426395939,0.005076142131979695,0.9949238578680203,197,5000,2900,2100,0.58,71,29,42,203.56414993454314,0.4705661452398218,0.7649424546356811,0.11871535006462014,1044048.7526169925,-1893.8206366604618,1042154.931980332,2697,0,473.61928934010155,89,108,39,38.699004188134616,0.546584179357022,43.91203703703703,8153.829180702173,91.61605821013679,8
2834,32.0564296705366,0,1,195,0.0,0.00510204081632653,0.9948979591836735,196,5750,3700,2050,0.6434782608695652,78,37,41,240.04996497533418,0.47051118524332813,0.793664308445728,0.13811548097247736,1046975.7829327745,5315.300004607246,1052291.0829373817,2698,1,475.1938775510204,72,124,35,38.28548098933618,0.5382121598639455,44.42066210045663,8192.961070619043,113.79112598082004,8
2835,31.572761203137834,4,2,197,0.020100502512562814,0.010050251256281407,0.9899497487437185,199,6300,4400,1900,0.6984126984126984,82,44,38,238.58136233842572,0.4717230935823901,0.7936834784505986,0.13845233389245615,1033790.5773743206,3228.632864518496,1037019.210238839,2699,0,469.0,80,119,29,37.991858887381284,0.5405150753768844,44.097222222222214,8079.557293997404,100.99446617496754,0
2836,31.731231011819812,1,2,196,0.005050505050505051,0.010101010101010102,0.98989898989899,198,5950,4500,1450,0.7563025210084033,74,45,29,243.63018818233053,0.4707998983062435,0.798799648925214,0.14191565379491508,1040128.3683010283,5131.3340205918785,1045259.7023216202,2700,0,472.3636363636364,80,118,32,37.71775071153525,0.5422453703703703,43.955761316872426,8124.598886899846,101.55748608624808,0
2837,31.91154692209804,0,1,195,0.0,0.00510204081632653,0.9948979591836735,196,6450,4900,1550,0.7596899224806202,80,49,31,249.35407876992662,0.4705095499738357,0.8025661070216212,0.14600179454868228,1047619.5028055466,6595.639204697205,1054215.1420102438,2701,1,478.0816326530612,83,113,36,37.373011744019124,0.5438988095238095,43.7624007936508,8176.938170279173,98.51732735276113,0
2838,32.09592029460458,1,0,196,0.00510204081632653,0.0,1.0,196,6850,4800,2050,0.7007299270072993,89,48,41,246.67199457897823,0.4702293738008024,0.8053957516154095,0.1396770442489801,1043286.1084713121,5419.893058631872,1048706.001529944,2702,0,478.65816326530614,65,131,37,38.73897400185701,0.5300807823129252,45.0284090909091,8183.547859206727,125.9007362954881,8
2839,32.134733857463765,5,0,201,0.024875621890547265,0.0,1.0,201,6350,4000,2350,0.6299212598425197,87,40,47,235.3752011133774,0.47134535655058046,0.810172961905274,0.12903164400965048,1034299.1049374478,2139.671967207771,1036438.7769046556,2703,0,467.72636815920396,57,144,43,40.31044276916543,0.5158582089552239,46.28232758620691,8153.149877952445,143.03771715706046,8
2840,31.635443442723833,1,0,202,0.0049504950495049506,0.0,1.0,202,6700,4500,2200,0.6716417910447762,89,45,44,215.9010846454705,0.47184713807201617,0.7913130165113638,0.11783517029445548,1016841.5052931678,-3192.563218934485,1013648.9420742333,2704,0,466.4059405940594,66,136,38,40.9811646635598,0.517378300330033,46.45522388059701,8021.0014251234425,121.53032462308246,8
2841,31.730898588899674,4,4,202,0.019417475728155338,0.019417475728155338,0.9805825242718447,206,5450,3500,1950,0.6422018348623854,74,35,39,199.22425235780406,0.4727030547004499,0.7794944136875543,0.10943445508482424,1021936.6576709715,-5931.086683693891,1016005.5709872775,2705,0,458.33009708737865,75,131,37,41.147155316735955,0.5193163430420712,46.203399122806985,8053.19420464158,107.3759227285544,8
2842,31.927862003019985,4,2,204,0.019417475728155338,0.009708737864077669,0.9902912621359223,206,6750,5100,1650,0.7555555555555555,84,51,33,193.78958441506418,0.47329061094009,0.7730123084922322,0.10762775380590471,1031757.316032424,-7961.235701774972,1023796.080330649,2706,0,458.63592233009706,70,136,45,40.848025353955066,0.5226031553398058,45.77464788732394,8116.871959922671,115.95531371318101,0
2843,31.89633317637871,1,3,202,0.004878048780487805,0.014634146341463415,0.9853658536585366,205,5850,4000,1850,0.6837606837606838,77,40,37,191.3864283589573,0.47349952175992344,0.7692640242534361,0.10675961341625419,1032114.3777666554,-7343.463116262594,1024770.9146503928,2707,0,461.1756097560976,72,133,45,40.73624822376786,0.524390243902439,45.60502283105022,8114.266950178058,112.69815208580637,0
2844,32.30105041488605,4,0,206,0.019417475728155338,0.0,1.0,206,6450,4700,1750,0.7286821705426356,82,47,35,192.97534878877633,0.47397781987528614,0.7715219245277454,0.10808437196367354,1046500.5830081053,-7260.236997270392,1039240.3460108349,2708,0,458.81553398058253,72,134,41,40.53583440775829,0.5265978964401294,45.44805936073062,8222.29506779618,114.19854260828028,8
2845,31.990658690086885,3,3,206,0.014354066985645933,0.014354066985645933,0.9856459330143541,209,5950,4100,1850,0.6890756302521008,78,41,37,190.1467505241083,0.47423629002576373,0.7706508982576492,0.10721040189125297,1038528.1095189344,-8255.450929405726,1030272.6585895286,2709,0,453.21531100478467,77,132,40,40.34722222222219,0.528658293460925,45.1923076923077,8151.46591622409,105.86319371719597,0
2846,31.77654420367174,3,1,208,0.014354066985645933,0.004784688995215311,0.9952153110047847,209,6150,4400,1750,0.7154471544715447,79,44,35,191.2445757667907,0.4746235124524598,0.7717240770493834,0.10860704114166042,1033806.1862155859,-8408.03489842331,1025398.1513171626,2710,0,453.4066985645933,82,127,44,40.03884788847888,0.5314493620414673,44.9171686746988,8105.650865206188,98.84940079519743,0
2847,31.857481833384707,2,4,206,0.009523809523809525,0.01904761904761905,0.9809523809523809,210,6650,5000,1650,0.7518796992481203,83,50,33,194.91541333454083,0.4744171033644718,0.7788765820651176,0.11177724758843814,1039460.1002151109,-8128.640984361422,1031331.4592307495,2711,0,452.22857142857146,71,139,43,39.56651988824073,0.5346230158730159,44.54571759259262,8138.130161054366,114.621551564146,8
2848,32.01079737570914,3,1,208,0.014354066985645933,0.004784688995215311,0.9952153110047847,209,6400,4600,1800,0.71875,82,46,36,190.06558382702082,0.4741816571586308,0.7725718857213193,0.10987062559517441,1046935.9786779288,-8402.700396612967,1038533.2782813158,2712,0,455.24401913875596,75,134,48,39.382368703108305,0.536981658692185,44.243421052631604,8186.972026188821,109.15962701585094,0
2849,31.60761549164635,1,0,209,0.004784688995215311,0.0,1.0,209,5950,3700,2250,0.6218487394957983,82,37,45,210.44138720957952,0.47406376518218624,0.7892066964039977,0.11913057470701746,1027333.3040004836,-4511.310875907589,1022821.993124576,2713,0,456.20574162679424,75,134,41,39.67292943411105,0.532994417862839,45.03837719298245,8058.728938810374,107.44971918413832,8
2850,31.43730348533284,3,1,211,0.014150943396226415,0.0047169811320754715,0.9952830188679245,212,7650,6200,1450,0.8104575163398693,91,62,29,203.65545655507927,0.47487490312676983,0.7860990816282756,0.116172332766521,1024134.3222777171,-8335.891404560894,1015798.4308731562,2714,0,450.7358490566038,69,143,43,39.548657669212425,0.5355247641509434,44.747023809523824,8024.465278034465,116.29659823238354,0
2851,30.98418651466071,1,2,210,0.0047169811320754715,0.009433962264150943,0.9905660377358491,212,6850,5000,1850,0.7299270072992701,87,50,37,218.7041863147963,0.4753001207189484,0.7989775293252028,0.12290404021871792,1004849.523407026,-5297.040522891274,999552.4828841346,2715,0,451.67452830188677,72,140,40,39.749668496937105,0.5240762578616351,45.31963470319634,7891.063939978079,109.59811027747332,8
2852,30.56493254880562,4,4,210,0.018691588785046728,0.018691588785046728,0.9813084112149533,214,6500,4700,1800,0.7230769230769231,83,47,36,212.29848735110158,0.4755810956079154,0.795647994330068,0.12028567707661511,993700.7350049918,-7107.767415752565,986592.9675892392,2716,0,448.3878504672897,77,137,40,39.59184386020039,0.5266257788161994,45.005341880341874,7793.894525733086,101.21940942510501,0
2853,30.408543713715332,5,0,215,0.023255813953488372,0.0,1.0,215,6500,4900,1600,0.7538461538461538,81,49,32,205.82285033052014,0.476252445120626,0.7908083145815188,0.11767874136505868,991298.8720988482,-8693.608123036911,982605.2639758113,2717,0,443.54418604651164,70,145,44,39.40413602237037,0.5296027131782945,44.65962441314556,7764.528972909389,110.92184247013414,0
2854,30.263432003452344,2,3,214,0.009216589861751152,0.013824884792626729,0.9861751152073732,217,7950,6500,1450,0.8176100628930818,94,65,29,209.39451522118446,0.47668739688228934,0.7967274127641757,0.11689117740744262,979496.0336468777,-10329.780574687822,969166.2530721899,2718,0,440.44700460829495,72,145,36,40.248995139278364,0.525825652841782,45.576484018264836,7699.728775992506,106.94067744434035,8
2855,29.851815342455893,6,4,216,0.02727272727272727,0.01818181818181818,0.9818181818181818,220,6350,4800,1550,0.7559055118110236,79,48,31,200.04194564791862,0.4768308080808081,0.7922033157984687,0.11551276161840611,976013.7072481757,-11301.26380460733,964712.4434435684,2719,0,433.8681818181818,77,143,46,39.16879917833022,0.5354166666666667,44.284188034188034,7633.581198949593,99.13741816817654,8
2856,30.102462193829076,1,4,213,0.004608294930875576,0.018433179723502304,0.9815668202764977,217,7200,4900,2300,0.6805555555555556,95,49,46,200.81296618222893,0.4760357996245093,0.790002957231299,0.11670552222687448,986072.4992417129,-10996.771311309541,975075.7279304033,2720,0,440.44239631336404,81,136,37,38.90220978708622,0.5377304147465438,44.04217479674797,7704.960756395617,95.12297230118045,0
2857,30.04335001681685,3,3,213,0.013888888888888888,0.013888888888888888,0.9861111111111112,216,6950,4900,2050,0.7050359712230215,90,49,41,187.10652899160678,0.4762632787826586,0.7730113377252981,0.10818569184520206,982657.7867916616,-13377.662465367406,969280.1243262943,2721,0,443.44444444444446,85,131,38,39.44895655742881,0.5390625,44.23449612403102,7684.052555173289,90.40061829615634,8
2858,30.47910500385164,1,3,211,0.004672897196261682,0.014018691588785047,0.985981308411215,214,7350,5600,1750,0.7619047619047619,91,56,35,201.05291502794455,0.4756683924941132,0.7880190171179107,0.11772227350851838,1000598.4789733492,-9915.351805976032,990683.1271673732,2722,0,447.803738317757,87,127,40,38.610094162393594,0.544392523364486,43.76183712121213,7809.909872376638,89.76907899283492,8
2859,30.16676128504658,0,3,208,0.0,0.014218009478672985,0.985781990521327,211,7100,4700,2400,0.6619718309859155,95,47,48,187.51382931178804,0.47493323553750094,0.7702003280653091,0.109583675993601,989788.2669081362,-12180.202372835087,977608.0645353011,2723,1,455.0,86,125,42,39.03034198021345,0.5450730647709321,43.83381226053642,7727.704234836882,89.85702598647538,8
2860,30.060332864116496,0,0,208,0.0,0.0,1.0,208,6850,5100,1750,0.7445255474452555,86,51,35,203.4983142105128,0.4745830043044717,0.7824019816748342,0.11748533906960729,982773.761045431,-8451.43927538552,974322.3217700454,2724,2,461.8942307692308,74,134,41,39.08804519037535,0.5387119391025641,44.29166666666669,7686.677616128514,103.87402183957451,8
2861,29.882192573906238,2,3,207,0.009523809523809525,0.014285714285714285,0.9857142857142858,210,6550,4700,1850,0.7175572519083969,84,47,37,201.06419184234764,0.4748594972279183,0.7828806420832366,0.11689904630834125,978973.9260246764,-9182.679745823472,969791.2462788529,2725,0,458.48571428571427,78,132,33,38.88019626023802,0.5411706349206349,44.02689873417723,7649.037505765359,98.0645834072482,0
2862,30.437883190478363,3,2,208,0.014285714285714285,0.009523809523809525,0.9904761904761905,210,7600,5800,1800,0.7631578947368421,94,58,36,197.9641747636981,0.474691463507253,0.7798683701122717,0.11595044521873801,999337.5320936401,-10033.39402973826,989304.1380639018,2726,0,459.34761904761905,84,126,36,38.677168021680245,0.5440476190476191,43.750000000000014,7799.707567560117,92.85366151857282,0
2863,30.61447442029939,1,2,207,0.004784688995215311,0.009569377990430622,0.9904306220095693,209,8100,5900,2200,0.7283950617283951,103,59,44,198.6079311657233,0.47426696110906635,0.7788865361893287,0.11440935753067721,1000238.2608402543,-10168.9496683433,990069.311171911,2727,0,462.4354066985646,79,130,38,39.298084759576206,0.538127990430622,44.375,7825.825023689031,99.06107624922824,8
2864,31.066715489545647,2,5,204,0.009569377990430622,0.023923444976076555,0.9760765550239234,209,6250,4500,1750,0.72,80,45,35,199.75712116328222,0.47475673997055573,0.7814477312934229,0.11577865258560258,1016850.7951207843,-7425.362502815333,1009425.432617969,2728,0,462.73205741626793,81,128,35,39.032891034870865,0.5401714513556619,44.14380081300815,7948.611746378843,98.13100921455361,0
2865,31.284796353754285,1,3,202,0.004878048780487805,0.014634146341463415,0.9853658536585366,205,7400,5600,1800,0.7567567567567568,92,56,36,197.5546038109318,0.47407540251873104,0.7740350583608753,0.11520725037902463,1025835.8776435511,-7868.279923417684,1017967.5977201334,2729,0,472.20975609756096,82,123,36,38.85403904271829,0.5420223577235772,43.91315261044178,8011.624869457305,97.70274231045494,0
2866,31.400655454695055,4,4,202,0.019417475728155338,0.019417475728155338,0.9805825242718447,206,6600,4600,2000,0.696969696969697,86,46,40,222.99426678299793,0.4741761386060463,0.801323491384377,0.12905260560447854,1027325.9742488621,-1982.439525049395,1025343.5347238127,2730,0,470.6456310679612,73,133,41,38.496267150928155,0.540453074433657,44.20045045045044,8032.2735208715785,110.03114412152847,7
2867,31.269441734362434,1,0,203,0.0049261083743842365,0.0,1.0,203,5900,4000,1900,0.6779661016949152,78,40,38,221.49835191376783,0.4737081158854802,0.7964379853977464,0.1286758385700922,1024179.5683929806,-1129.1827074403946,1023050.3856855403,2731,0,477.8029556650246,77,126,37,38.38806635359598,0.5425389983579638,44.057158119658105,8003.1897815044495,103.93752962992791,0
2868,30.886205838201963,2,0,205,0.00975609756097561,0.0,1.0,205,6550,4600,1950,0.7022900763358778,85,46,39,223.13803779524136,0.4740096445082098,0.7922022466116858,0.1266883556647607,1004766.9671682863,-2709.6541009189577,1002057.3130673674,2732,0,474.13170731707316,84,121,35,39.23480990359054,0.532469512195122,44.926470588235276,7878.253533288379,93.78873253914738,8
2869,30.8534305069943,0,1,204,0.0,0.004878048780487805,0.9951219512195122,205,6050,4100,1950,0.6776859504132231,80,41,39,226.026377625671,0.4739757691694564,0.7963886396228212,0.12883351113080233,1004880.7924991875,-1624.0869051589298,1003256.7055940286,2733,1,475.13170731707316,68,137,35,39.007847312591196,0.534349593495935,44.77657004830918,7874.518359771227,115.80174058487098,0
2870,31.19569932471409,3,1,206,0.014492753623188406,0.004830917874396135,0.9951690821256038,207,6950,4900,2050,0.7050359712230215,90,49,41,216.70071591599654,0.4741188265090756,0.7897946660322654,0.12457203282897447,1018599.5660464093,-4203.7489612037125,1014395.8170852056,2734,0,471.45410628019323,73,134,39,38.91612500459035,0.5370873590982287,44.45382882882884,7971.941519437802,109.20467834846303,0
2871,31.66863595399891,2,2,206,0.009615384615384616,0.009615384615384616,0.9903846153846154,208,6400,4000,2400,0.625,88,40,48,208.79255908983282,0.47411800910442214,0.7873885917069485,0.11784480672837074,1028393.1387682771,-5055.832961229222,1023337.3058070479,2735,0,469.8894230769231,74,134,40,39.83175740730651,0.5262419871794872,45.15277777777777,8070.663904443398,109.0630257357216,8
2872,31.244009670655323,0,2,204,0.0,0.009708737864077669,0.9902912621359223,206,7150,5100,2050,0.7132867132867133,92,51,41,228.65065153446562,0.4739590733285974,0.8031612861374777,0.12251090995104481,998489.5569577948,-2688.942450247844,995800.614507547,2736,1,471.2669902912621,73,133,35,41.40404602821085,0.5074838187702265,47.184684684684704,7898.964156601531,108.20498844659632,8
2873,30.988749102606647,4,2,206,0.019230769230769232,0.009615384615384616,0.9903846153846154,208,7000,5300,1700,0.7571428571428571,87,53,34,229.55115291115715,0.4747010676018828,0.809577862314395,0.12479068346050798,994833.9680089239,-2926.943137674212,991907.0248712497,2737,0,467.7067307692308,66,142,37,40.79411584243467,0.5107672275641026,46.610696517412926,7852.217550906122,118.9729931955473,0
2874,30.75592698803169,3,0,209,0.014354066985645933,0.0,1.0,209,7000,5100,1900,0.7285714285714285,89,51,38,225.3484015482865,0.4750404474911054,0.808227170643657,0.12337990196206754,989536.5332860594,-4201.904790070852,985334.6284959886,2738,0,465.6794258373206,68,141,42,40.61514312920311,0.5129585326953747,46.33152173913043,7801.809196556397,114.7324881846529,0
2875,30.389504753646104,4,3,210,0.018779342723004695,0.014084507042253521,0.9859154929577465,213,7000,4500,2500,0.6428571428571429,95,45,50,219.86360059698063,0.47507068089881005,0.8071272342263285,0.12153808043736977,980638.9907207213,-6478.636122870974,974160.3545978504,2739,0,457.9154929577465,75,138,41,40.371200881215685,0.5162852112676056,45.956688596491205,7720.250419528872,102.93667226038497,0
2876,30.217468277242517,3,1,212,0.014084507042253521,0.004694835680751174,0.9953051643192489,213,6700,5000,1700,0.746268656716418,84,50,34,215.133849298781,0.4751315808899519,0.803485760565517,0.11965799162263835,976923.8404345673,-7266.122747112648,969657.7176874547,2740,0,449.38497652582157,62,151,44,40.24711728114094,0.519170579029734,45.71759259259259,7683.770579294184,123.93178353700297,0
2877,30.47149354156517,5,2,215,0.02304147465437788,0.009216589861751152,0.9907834101382489,217,7500,5500,2000,0.7333333333333333,95,55,40,202.8509175124637,0.47605180064857483,0.7954452110282564,0.11432565535379886,989086.2969494758,-10772.587432958604,978313.7095165171,2741,0,441.10138248847926,69,148,38,40.03986099754698,0.522513440860215,45.20833333333334,7763.882625277978,112.52003804750693,0
2878,30.273608659855036,2,1,216,0.009216589861751152,0.004608294930875576,0.9953917050691244,217,7400,5400,2000,0.7297297297297297,94,54,40,198.26965937894053,0.4762909270637765,0.7909474686945333,0.11222062720848071,983922.9948701966,-11783.58459039562,972139.410279801,2742,0,441.9400921658986,73,144,41,39.99006183745583,0.5244335637480799,45.04504504504506,7718.406532197302,105.73159633146989,0
2879,30.79295861502338,5,4,217,0.02262443438914027,0.01809954751131222,0.9819004524886877,221,5950,4200,1750,0.7058823529411765,77,42,35,193.9364217091693,0.47704819690113803,0.7897740765700711,0.11115868073574361,1004572.9793919369,-11185.342206201603,993387.6371857353,2743,0,434.88235294117646,68,153,43,39.61140661938534,0.5275735294117647,44.56521739130436,7865.592689707081,115.67048073098648,0
2880,30.89914533454157,6,1,222,0.026905829596412557,0.004484304932735426,0.9955156950672646,223,8400,6200,2200,0.7380952380952381,106,62,44,190.03469325429438,0.47732093079626714,0.7877328141445283,0.11025209168972049,1011659.0758747142,-14549.935567645121,997109.140307069,2744,0,431.7578475336323,72,151,36,39.243875350842984,0.530923019431988,44.106735159817354,7906.883180427142,109.81782195037698,0
2881,30.653873970396365,2,4,220,0.008928571428571428,0.017857142857142856,0.9821428571428571,224,6400,4800,1600,0.75,80,48,32,209.55028283520983,0.4776769031603673,0.8022433758512426,0.11825968328489175,995407.8023154471,-9482.402697684636,985925.3996177625,2745,0,430.82142857142856,76,148,35,39.81668259192413,0.5244605654761905,45.15692640692641,7811.927460150531,102.78851921250698,8
2882,30.563419253794184,1,2,219,0.004524886877828055,0.00904977375565611,0.9909502262443439,221,6800,4200,2600,0.6176470588235294,94,42,52,216.90879691049793,0.4772333059097765,0.8076284550035009,0.12320368717059589,994392.0910406109,-7861.521575013352,986530.5694655975,2746,0,437.552036199095,78,143,38,39.37721837416863,0.5265365761689291,44.91033755274262,7796.412300684372,99.95400385492785,0
2883,30.538730969413237,1,2,218,0.004545454545454545,0.00909090909090909,0.990909090909091,220,6650,4800,1850,0.7218045112781954,85,48,37,216.05527348902348,0.4769713401134634,0.807376431960755,0.12330245170025347,994998.2677509821,-7655.0754279911325,987343.192322991,2747,0,439.8863636363636,66,154,38,39.21422335911647,0.5282670454545455,44.72947761194032,7795.637807630571,118.11572435803896,0
2884,30.60782744107814,4,2,220,0.018018018018018018,0.009009009009009009,0.990990990990991,222,7250,5300,1950,0.7310344827586207,92,53,39,192.9327033899691,0.4771280047015341,0.7862733807529443,0.10989013548061011,996664.4673776508,-13192.165987220935,983472.3013904298,2748,0,436.31531531531533,81,141,45,39.88081163820994,0.528200075075075,44.80436991869921,7810.983809245724,96.43189887957683,8
2885,30.683375682535804,4,2,222,0.017857142857142856,0.008928571428571428,0.9910714285714286,224,6750,4800,1950,0.7111111111111111,87,48,39,193.75913715378303,0.47747754510997226,0.7886722843171481,0.11161617900830732,1002489.4077246746,-12701.703470691555,989787.704253983,2749,0,433.32142857142856,74,150,44,39.42203205650636,0.5306919642857143,44.37500000000004,7843.437908848311,105.99240417362583,0
2886,31.03878399249587,4,3,223,0.017699115044247787,0.01327433628318584,0.9867256637168141,226,6650,4900,1750,0.7368421052631579,84,49,35,185.87836275750143,0.4780317928548017,0.7818677535984078,0.10795628429452861,1016550.8901814605,-14059.036974677481,1002491.8532067831,2750,0,430.12389380530976,78,148,41,39.309204877211066,0.5333702064896755,44.066455696202574,7943.865998079545,101.84443587281467,0
2887,31.430431650173745,0,2,221,0.0,0.008968609865470852,0.9910313901345291,223,6700,4900,1800,0.7313432835820896,85,49,36,229.67398687569332,0.47747579417983005,0.8226872871393383,0.13197353686095195,1026134.3431164126,-4164.726869276743,1021969.6162471359,2751,1,436.86995515695065,67,156,36,38.60111554063505,0.5257380418535127,44.46997549019607,8031.418969922596,119.87192492421785,8
2888,31.297353496065007,2,2,221,0.008968609865470852,0.008968609865470852,0.9910313901345291,223,6400,4300,2100,0.671875,85,43,42,228.42312103565047,0.4775616423598486,0.8223260260673049,0.13208001763092153,1023684.9696260024,-4233.336856148613,1019451.6327698538,2752,0,437.7982062780269,68,155,40,38.39078424428444,0.5280269058295964,44.233091787439626,8004.827338924141,117.71804910182561,0
2889,31.264981498574688,1,2,220,0.0045045045045045045,0.009009009009009009,0.990990990990991,222,6300,4400,1900,0.6984126984126984,82,44,38,228.81362055948898,0.47763076991018166,0.8222314598135962,0.1328014793372098,1023752.5977262814,-3850.2923114135306,1019902.3054148678,2753,0,440.48198198198196,69,153,37,38.23674429648581,0.5292323573573574,44.0922619047619,8000.950696889702,115.95580720130003,0
2890,31.15962098874642,0,2,218,0.0,0.00909090909090909,0.990909090909091,220,7650,5700,1950,0.7450980392156863,96,57,39,235.94282477155323,0.4772727272727273,0.8260744985673345,0.13733163082934,1021160.1768843763,-3462.916664336181,1017697.2602200401,2754,2,445.4818181818182,70,150,38,37.94424546322828,0.5303030303030303,43.98474178403757,7977.338413345455,113.9619773335065,0
2891,31.563371872705268,1,0,219,0.0045662100456621,0.0,1.0,219,7500,5800,1700,0.7733333333333333,92,58,34,236.96212571881793,0.4772317875246115,0.8257786687455924,0.13879210220673638,1036289.611680032,-2187.722151194161,1034101.8895288379,2755,0,448.3744292237443,72,147,41,37.67784552845531,0.5321061643835616,43.75000000000001,8088.114042380737,112.33491725528802,0
2892,31.731272039408214,1,0,220,0.004545454545454545,0.0,1.0,220,7450,5300,2150,0.7114093959731543,96,53,43,233.19151916397357,0.4770621454268715,0.8241151192349598,0.13746219065317386,1043746.9417137326,-2771.413007804811,1040975.5287059278,2756,0,447.33181818181816,60,160,41,37.529821349312016,0.5344223484848485,43.51092896174862,8138.7244882498235,135.64540813749707,0
2893,31.769884845129557,5,4,221,0.022222222222222223,0.017777777777777778,0.9822222222222222,225,7050,4700,2350,0.6666666666666666,94,47,47,222.92571302191269,0.47759093915343914,0.8191708046981552,0.1335167493195481,1049815.0320059957,-5243.847089788314,1044571.1849162075,2757,0,438.3688888888889,67,158,37,37.1918821753466,0.5381018518518519,42.92279411764706,8167.313227190014,121.90019742074648,0
2894,31.562572002333592,3,1,223,0.013392857142857142,0.004464285714285714,0.9955357142857143,224,6700,4600,2100,0.6865671641791045,88,46,42,204.75330921631118,0.47727443345611786,0.8006989398917834,0.12049422015093113,1037687.7671192602,-9005.999149809704,1028681.7679694504,2758,0,438.36607142857144,70,154,43,38.32353530152189,0.5345517113095238,43.573943661971796,8093.465866443387,115.62094094919125,7
2895,31.10466238101369,1,1,223,0.004464285714285714,0.004464285714285714,0.9955357142857143,224,7750,5400,2350,0.6967741935483871,101,54,47,201.00531996051353,0.47703420283472137,0.7970483299900935,0.11869554907957847,1023652.2969604074,-11398.088504232337,1012254.208456175,2759,0,439.3482142857143,71,153,39,38.28931229910336,0.5361328125,43.44618055555551,7980.01993637888,112.39464699125183,0
2896,31.622337585466813,4,8,219,0.01762114537444934,0.03524229074889868,0.9647577092511013,227,6550,4700,1850,0.7175572519083969,84,47,37,194.44919267065245,0.4775739737242213,0.7918647045581921,0.11591630366920685,1043534.936857657,-11367.094800882003,1032167.842056775,2760,0,433.49339207048456,77,150,35,38.1001347230164,0.5386839207048458,43.095619658119624,8123.917042356017,105.50541613449373,0
2897,31.552314248952342,2,3,218,0.00904977375565611,0.013574660633484163,0.9864253393665159,221,6150,4600,1550,0.7479674796747967,77,46,31,202.6425561796393,0.47721016728369664,0.7959125131475571,0.12106862179502191,1041886.7807249501,-8123.879900824568,1033762.9008241256,2761,0,434.9457013574661,74,147,37,37.80625664306684,0.5400169683257918,43.01388888888885,8108.506535393872,109.57441264045772,0
2898,31.152920469426466,1,3,216,0.0045662100456621,0.0136986301369863,0.9863013698630136,219,5850,3600,2250,0.6153846153846154,81,36,45,247.0725027515332,0.47698916397860724,0.8269542974590931,0.14443805411586746,1022244.1788906754,863.6855403412865,1023107.8644310167,2762,0,439.6575342465753,72,147,34,37.49187693793053,0.5348649162861492,43.821347031963484,7980.713201878074,110.84323891497326,8
2899,31.42359760303377,2,2,216,0.009174311926605505,0.009174311926605505,0.9908256880733946,218,6750,4700,2050,0.6962962962962963,88,47,41,245.05374271345448,0.47699155498245466,0.8258148767363342,0.14443978518392242,1033595.4292080253,307.28567578903585,1033902.7148838143,2763,0,439.54587155963304,61,157,35,37.22951875627757,0.5370317278287462,43.51478494623655,8059.688188977029,132.12603588486934,0
2900,31.224576180689446,5,0,221,0.02262443438914027,0.0,1.0,221,6900,5400,1500,0.782608695652174,84,54,30,220.6794813696437,0.47737470862470865,0.8085629117055375,0.12698774325329484,1019848.2379852901,-6088.083953131849,1013760.1540321583,2764,0,433.15384615384613,71,150,40,38.77528397298014,0.5305901206636501,44.41550925925929,7980.517401737039,112.4016535455921,8
2901,31.57201959699299,2,1,222,0.008968609865470852,0.004484304932735426,0.9955156950672646,223,7900,6100,1800,0.7721518987341772,97,61,36,215.6491268697843,0.47764580724221983,0.808253107778349,0.12194764702496533,1025845.3784512841,-8255.467966715481,1017589.9104845687,2765,0,430.26008968609864,75,148,39,39.582157194831254,0.5217208520179373,45.07949561403508,8048.355160149006,107.31140213532008,8
2902,31.284732771751386,1,3,220,0.004484304932735426,0.013452914798206279,0.9865470852017937,223,7900,5400,2500,0.6835443037974683,104,54,50,217.93602969861456,0.4776727400045786,0.8118911149793404,0.12422591354794527,1018937.5086792179,-8087.360969490697,1010850.1477097272,2766,0,431.23318385650225,63,160,42,39.21312682014329,0.523776158445441,44.775390625,7984.633701071507,126.7402174773255,0
2903,31.12776833153108,3,2,221,0.013452914798206279,0.008968609865470852,0.9910313901345291,223,7350,4800,2550,0.6530612244897959,99,48,51,229.67208220659785,0.4783123931105994,0.822647617061216,0.12845863078672898,1008061.6646233523,-5645.275698660958,1002416.3889246914,2767,0,431.7354260089686,65,158,39,39.65678294573645,0.5166292974588939,45.501893939393945,7921.958086267982,121.87627825027666,8
2904,31.3896386220102,4,3,222,0.017777777777777778,0.013333333333333334,0.9866666666666667,225,6500,4500,2000,0.6923076923076923,85,45,40,221.25048060352313,0.47862764550264547,0.8189514386443775,0.12352098259979526,1015974.9472462527,-6543.010928125546,1009431.9363181271,2768,0,427.12,63,162,43,39.94370522006143,0.517962962962963,45.57291666666666,7986.374201485384,126.76784446802198,8
2905,30.959477296318934,4,6,220,0.017699115044247787,0.02654867256637168,0.9734513274336283,226,7100,4600,2500,0.647887323943662,96,46,50,211.86717700145425,0.4793563585709604,0.8114010568839856,0.1197589923512553,1005816.3157118852,-9680.107321623864,996136.2083902614,2769,0,424.76106194690266,71,155,34,39.694896134854424,0.5212481563421829,45.095486111111114,7891.710510472275,111.15085226017288,0
2906,31.093045951733586,5,5,220,0.022222222222222223,0.022222222222222223,0.9777777777777777,225,6300,4400,1900,0.6984126984126984,82,44,38,202.97130085817344,0.4789765211640212,0.8029281427807877,0.11602497995105442,1013552.3555634056,-10155.591980685802,1003396.7635827197,2770,0,425.12888888888887,66,159,42,39.484767297895225,0.5240740740740741,44.66728855721394,7939.071729871308,120.28896560411073,0
2907,30.75406899521568,4,1,223,0.017857142857142856,0.004464285714285714,0.9955357142857143,224,7350,5500,1850,0.7482993197278912,92,55,37,201.50595712051592,0.4791116138159299,0.8007685299228933,0.11614369904284637,1004965.2665552102,-11648.702417983497,993316.5641372268,2771,0,423.125,68,156,47,39.20244281721192,0.5266927083333333,44.35386473429953,7862.158882321616,115.61998356355318,0
2908,31.21797507567762,0,0,223,0.0,0.0,1.0,223,6700,4800,1900,0.7164179104477612,86,48,38,200.94681452648558,0.4791700332619615,0.7990880087233931,0.11630558052896618,1021381.3913646144,-10251.332597730066,1011130.0587668843,2772,1,425.5470852017937,69,154,40,39.05613728912155,0.5282604633781764,44.19642857142858,7985.669517126479,115.73434082792,0
2909,31.256527996546808,1,3,221,0.004464285714285714,0.013392857142857142,0.9866071428571429,224,8000,6000,2000,0.75,100,60,40,197.5021636452459,0.4792104587070254,0.7956326806521219,0.11475854581486204,1023816.6046681182,-12358.80108042334,1011457.8035876949,2773,0,424.64285714285717,72,152,42,38.99458289197376,0.5302734375,44.04965753424659,8000.119045006604,111.11276451398061,0
2910,31.50801058527133,2,1,222,0.008968609865470852,0.004484304932735426,0.9955156950672646,223,6800,5000,1800,0.7352941176470589,86,50,36,201.6219984703694,0.47889228915013665,0.799017494406473,0.11769899568825896,1033462.9933532381,-9726.225186989846,1023736.7681662482,2774,0,427.2152466367713,74,149,44,38.71095656417769,0.532044095665172,43.87500000000002,8069.989211152664,109.05390825881979,0
2911,31.60799576957801,0,4,218,0.0,0.018018018018018018,0.9819819819819819,222,6350,4400,1950,0.6929133858267716,83,44,39,198.6251569832769,0.4785925631513867,0.7952830879660149,0.11633759194734812,1037754.704856655,-9525.161767542453,1028229.5430891125,2775,1,430.0900900900901,75,147,46,38.660230352303536,0.5333145645645645,43.75000000000001,8099.54891595438,107.99398554605841,0
2912,31.336566230715263,0,2,216,0.0,0.009174311926605505,0.9908256880733946,218,7450,5200,2250,0.697986577181208,97,52,45,202.26018192423155,0.4779749573697487,0.7953962103983183,0.11872115999552618,1029486.6514474906,-9405.168517932441,1020081.4829295581,2776,2,432.8165137614679,64,154,47,38.4853339585287,0.5344992354740061,43.6698717948718,8032.506039427749,125.50790686605858,0
2913,31.10239055214686,0,3,213,0.0,0.013888888888888888,0.9861111111111112,216,7850,5900,1950,0.7515923566878981,98,59,39,192.84170085141415,0.4777719458799885,0.7803692424900182,0.11025679900190613,1013917.8306001812,-11944.87220469703,1001972.9583954843,2777,3,434.27314814814815,70,146,44,39.735597180724696,0.5295621141975309,44.65962441314555,7941.69608523424,113.452801217632,8
2914,31.610577376605796,4,3,214,0.018433179723502304,0.013824884792626729,0.9861751152073732,217,6450,5200,1250,0.8062015503875969,77,52,25,197.89525283598581,0.4782154946805484,0.7794736222646741,0.11368925924776149,1031951.601247913,-9006.335391308916,1022945.2658566041,2778,0,429.44239631336404,82,135,41,39.42125081859856,0.5331701228878648,44.47791164658634,8077.2007453274755,98.50244811374971,7
2915,31.53982423577589,4,2,216,0.01834862385321101,0.009174311926605505,0.9908256880733946,218,7300,5500,1800,0.7534246575342466,91,55,36,194.72710551410842,0.47861485153398436,0.7779770245311926,0.11280184753354136,1032170.8021323116,-10701.673460919868,1021469.1286713918,2779,0,428.1559633027523,87,131,33,39.18248469285458,0.5355026758409787,44.16429924242424,8069.013035130494,92.74727626586775,0
2916,31.421525766454835,4,4,216,0.01818181818181818,0.01818181818181818,0.9818181818181818,220,7200,5100,2100,0.7083333333333334,93,51,42,200.76313046539923,0.4788064722568148,0.7885415327246987,0.11730539937110587,1030903.3181603643,-9806.524527791289,1021096.793632573,2780,0,425.08181818181816,91,129,38,38.697842998585536,0.5383996212121211,43.840579710144944,8048.919824957866,88.4496684061304,0
2917,31.202718949730393,2,1,217,0.009174311926605505,0.0045871559633027525,0.9954128440366973,218,6350,4100,2250,0.6456692913385826,86,41,45,201.55435488168595,0.4789499922490452,0.7879521305674555,0.11849342009923344,1025559.458029511,-8608.805008810039,1016950.653020701,2781,0,426.51376146788994,74,144,40,38.4434814012279,0.5407110091743119,43.61111111111112,8000.030441833674,108.10851948423883,0
2918,31.579138365956098,3,1,219,0.013636363636363636,0.004545454545454545,0.9954545454545455,220,5450,3700,1750,0.6788990825688074,72,37,35,198.02032383201174,0.47892365435173656,0.7859061393152307,0.11728896103896126,1040181.7298430804,-8254.575402465949,1031927.1544406144,2782,0,420.5272727272727,79,141,42,38.25081168831174,0.5427083333333333,43.33333333333335,8105.312180595432,102.5988883619675,0
2919,31.474418052651735,2,1,220,0.00904977375565611,0.004524886877828055,0.995475113122172,221,6450,4700,1750,0.7286821705426356,82,47,35,198.29336184986948,0.47886157959687375,0.787793149544062,0.11828268367688058,1038842.2596200451,-9450.895181645168,1029391.3644383999,2783,0,419.27149321266967,82,139,38,37.9775832030741,0.5448246606334841,43.07228915662652,8086.650180395193,98.61768512677065,0
2920,31.313413510336837,0,3,217,0.0,0.013636363636363636,0.9863636363636363,220,7150,5000,2150,0.6993006993006993,93,50,43,199.81779379703067,0.47866464300539646,0.7887159584265222,0.1196482630101804,1034660.7716068018,-9801.273457839035,1024859.4981489627,2784,1,421.98636363636365,83,137,40,37.79486251808972,0.5464488636363636,42.93154761904762,8049.6907498671,96.98422590201325,0
2921,31.205660517428488,1,0,218,0.0045871559633027525,0.0,1.0,218,7500,5600,1900,0.7466666666666667,94,56,38,203.85247479585752,0.47826341619808627,0.7920247468673074,0.12268552611567173,1032596.6262536,-9000.524454470195,1023596.1017991299,2785,0,426.091743119266,84,134,42,37.50089319740849,0.5483084862385321,42.74509803921568,8027.809137032561,95.56915639324477,0
2922,31.634263620240905,0,1,217,0.0,0.0045871559633027525,0.9954128440366973,218,7050,4800,2250,0.6808510638297872,93,48,45,215.93583242141318,0.4780872581349793,0.7979582036316322,0.1278912407798813,1041975.8079872346,-5650.017307860246,1036325.7906793744,2786,1,427.091743119266,77,141,36,37.793708916523585,0.5446769877675841,43.33600427350428,8119.376502636363,105.44644808618652,8
2923,31.246528950186676,2,0,219,0.0091324200913242,0.0,1.0,219,5850,3800,2050,0.6495726495726496,79,38,41,213.9504487025603,0.4783393029198609,0.7939269341064681,0.12777917854867593,1031684.501923357,-5504.12757880388,1026180.3743445531,2787,0,426.1004566210046,84,135,34,37.52901107984805,0.5469939117199392,43.026960784313744,8029.515509270442,95.58947034845764,0
2924,31.00567072623953,0,1,218,0.0,0.0045662100456621,0.995433789954338,219,7550,4900,2650,0.6490066225165563,102,49,53,219.0799944713113,0.47801464119643083,0.799566591377086,0.13156175781684012,1025338.7412429588,-6423.758847453637,1018914.9823955052,2788,1,427.1004566210046,88,131,37,37.19119297926249,0.5492294520547945,42.825374531835244,7973.871756409994,90.61217905011357,0
2925,31.17897576597735,0,2,216,0.0,0.009174311926605505,0.9908256880733946,218,6450,4600,1850,0.7131782945736435,83,46,37,219.4758150436793,0.47771556462182385,0.7985179957657,0.13222079589216942,1032008.5354310635,-4749.81711084607,1027258.7183202174,2789,2,430.0321100917431,90,128,39,37.06140350877197,0.5507931957186545,42.70833333333337,8022.090639788025,89.13434044208917,0
2926,31.620036407454,0,2,214,0.0,0.009259259259259259,0.9907407407407407,216,6450,4500,1950,0.6976744186046512,84,45,39,220.58170733797883,0.47762345679012347,0.799548979935931,0.13336086709699768,1047667.0098163965,-3430.7644506049774,1044236.2453657915,2790,3,434.412037037037,71,145,37,36.899869330635674,0.5520833333333333,42.578124999999986,8139.689059575038,114.64350788133856,0
2927,31.358746238224732,2,3,213,0.009259259259259259,0.013888888888888888,0.9861111111111112,216,6950,5000,1950,0.7194244604316546,89,50,39,219.74711272964188,0.4774538831467126,0.800645771385804,0.1340296347128493,1041596.4189931136,-4372.438859345956,1037223.9801337676,2791,0,434.93981481481484,73,143,40,36.59407427635171,0.5542052469135803,42.257882882882875,8082.469645578459,110.71876226819806,0
2928,31.60464419543341,1,2,212,0.004672897196261682,0.009345794392523364,0.9906542056074766,214,6900,5300,1600,0.7681159420289855,85,53,32,254.8612808656007,0.47688597838327995,0.8228941924759674,0.15337478909721758,1045780.3310164384,3605.7829333799564,1049386.1139498183,2792,0,439.78504672897196,79,135,40,36.19102301294055,0.5505257009345794,42.74739583333332,8130.377023036136,102.91616484855868,8
2929,31.16615889328484,0,5,207,0.0,0.02358490566037736,0.9764150943396226,212,7000,4800,2200,0.6857142857142857,92,48,44,238.78932577839532,0.47669639929655133,0.8046500921859574,0.14440736509272012,1032706.6410428177,-80.13549170272381,1032626.505551115,2793,1,444.5141509433962,66,146,41,36.42121633047469,0.5543435534591195,42.56840796019901,8023.1539016637325,121.56293790399594,8
2930,31.209106561049655,1,0,208,0.004807692307692308,0.0,1.0,208,6450,4700,1750,0.7286821705426356,82,47,35,236.2045302735739,0.47581541093769353,0.7980869205886529,0.14358050660449856,1035636.3398406564,874.3990372612752,1036510.7388779176,2794,0,453.19711538461536,69,139,39,36.29587376771409,0.5568910256410257,42.38095238095239,8040.060309298997,116.52261317824633,0
2931,30.919498443884837,0,2,206,0.0,0.009615384615384616,0.9903846153846154,208,6500,4600,1900,0.7076923076923077,84,46,38,236.42485460667223,0.4756436385172798,0.7993492618492608,0.14448185559296675,1027567.5599789632,488.50219331203516,1028056.0621722753,2795,1,454.19711538461536,73,135,43,36.092171717171695,0.5584435096153846,42.18750000000001,7971.433192564078,109.19771496663121,0
2932,31.024368818076876,1,1,206,0.004830917874396135,0.004830917874396135,0.9951690821256038,207,5950,4500,1450,0.7563025210084033,74,45,29,248.8438847964351,0.4759812313368666,0.8093763920785069,0.14737996782482318,1021883.8412870861,3507.9089753160615,1025391.7502624022,2796,0,456.28985507246375,67,140,41,36.949480254650354,0.5453401771336555,43.33639705882351,7962.826279823454,118.8481534302008,8
2933,31.052030783626847,1,1,206,0.004830917874396135,0.004830917874396135,0.9951690821256038,207,6000,4300,1700,0.7166666666666667,77,43,34,250.36103830914968,0.4759880712286791,0.8086348982371572,0.14870842395952968,1023649.7707695377,3856.4038949563737,1027506.174664494,2797,0,457.20772946859904,69,138,41,36.8006254225828,0.5466988727858293,43.22916666666663,7973.255821004105,115.5544321884653,0
2934,31.36814055727372,2,4,204,0.009615384615384616,0.019230769230769232,0.9807692307692307,208,6700,4700,2000,0.7014925373134329,87,47,40,242.71585266266766,0.4757239602687972,0.803517397881998,0.1452841203454272,1036365.0735814787,2008.4465008267862,1038373.5200823054,2798,0,455.9855769230769,74,134,37,36.7052986096102,0.5490284455128205,42.94444444444441,8063.3547976946675,108.96425402290092,0
2935,31.771369351976592,1,1,204,0.004878048780487805,0.004878048780487805,0.9951219512195122,205,6150,4600,1550,0.7479674796747967,77,46,31,243.8226231516912,0.4755300494181412,0.8043184827645138,0.14655022928380498,1050926.1661885928,4097.914915770202,1055024.081104363,2799,0,462.8243902439024,73,132,42,36.52149919731466,0.5504065040650407,42.79279279279277,8171.825180170493,111.94281068726703,0
2936,31.736950504893933,0,3,201,0.0,0.014705882352941176,0.9852941176470589,204,6500,4600,1900,0.7076923076923077,84,46,38,238.30532602641082,0.47513955294761584,0.797931072876173,0.1438696705704302,1051112.0844714295,2797.121596052755,1053909.2060674822,2800,1,466.05392156862746,66,138,40,36.49734706616728,0.5519301470588236,42.630597014925364,8168.120004011397,123.75939400017269,0
2937,31.314862768359532,1,1,201,0.0049504950495049506,0.0049504950495049506,0.995049504950495,202,6750,4600,2150,0.6814814814814815,89,46,43,236.2363362119276,0.4746964435249495,0.7956679267855427,0.1435773930638235,1039099.830630427,1944.6273893134185,1041044.4580197404,2801,0,470.0693069306931,67,135,42,36.30087857525124,0.554352310231023,42.386642156862756,8067.126948154163,120.40487982319647,0
2938,31.183819583371896,1,1,201,0.0049504950495049506,0.0049504950495049506,0.995049504950495,202,6550,4400,2150,0.6717557251908397,87,44,43,251.81515898839768,0.47466873553026945,0.8114472926226417,0.14628423072103214,1021367.6483223728,4489.171349580746,1025856.8196719536,2802,0,470.53465346534654,70,132,36,37.61309353205312,0.5411509900990099,44.058098591549296,7981.246077346281,114.01780110494687,8
2939,31.00698661206497,2,0,203,0.009852216748768473,0.0,1.0,203,6700,4800,1900,0.7164179104477612,86,48,38,248.0238697528925,0.47471813068006313,0.8109007709666938,0.1449389488868464,1017342.198196002,3165.029771897335,1020507.2279678994,2803,0,469.1527093596059,72,131,38,37.482128267973856,0.5430521346469622,43.83561643835616,7942.88561158376,110.3178557164411,0
2940,31.119597972373068,0,1,202,0.0,0.0049261083743842365,0.9950738916256158,203,5900,4200,1700,0.711864406779661,76,42,34,246.24609954590176,0.4745392950625112,0.8099090299890066,0.14435558761912756,1021979.2128391842,3831.678995728003,1025810.8918349122,2804,1,470.1527093596059,63,140,34,37.40659003344765,0.5444376026272578,43.717447916666664,7975.409988167088,126.59380933598553,0
2941,31.15546396626014,1,4,199,0.0049261083743842365,0.019704433497536946,0.9802955665024631,203,6000,3800,2200,0.6333333333333333,82,38,44,239.62776448276895,0.4746825667788454,0.809077155043322,0.1411141279731862,1024507.3940309869,2500.0833055425715,1027007.4773365295,2805,0,471.064039408867,61,142,42,37.403094426974135,0.5461309523809523,43.54838709677419,7989.868984895747,130.98145876878274,8
2942,31.548832820890254,2,0,201,0.009950248756218905,0.0,1.0,201,5950,4100,1850,0.6890756302521008,78,41,37,232.21180232704916,0.47427031509121065,0.8007183012461265,0.13771939509355768,1039572.8398298352,2130.2165574268424,1041703.0563872621,2806,0,476.03980099502485,64,137,42,37.32403708096636,0.5481965174129353,43.2852564102564,8099.050528170512,126.54766450266425,0
2943,31.31307636094384,0,1,200,0.0,0.004975124378109453,0.9950248756218906,201,6450,4500,1950,0.6976744186046512,84,45,39,226.56411809507492,0.47386712271973463,0.7945762381121448,0.13488525387562963,1032942.941621058,155.561322181371,1033098.5029432394,2807,1,477.03980099502485,66,135,34,37.32421362710087,0.5498548922056385,43.1436567164179,8042.962291031591,121.86306501563017,0
2944,31.62349654051209,0,1,199,0.0,0.005,0.995,200,5750,4200,1550,0.7304347826086957,73,42,31,227.77049059508468,0.473348513400335,0.7921478681584524,0.13640655784098935,1044951.7041901455,1851.8324623116564,1046803.5366524571,2808,2,480.11,66,134,35,37.07060780163292,0.55140625,42.92599502487561,8129.57890698641,123.17543798464258,0
2945,31.522844667181445,0,2,197,0.0,0.010050251256281407,0.9899497487437185,199,5350,3700,1650,0.6915887850467289,70,37,33,227.29565215341495,0.47307666277515525,0.7914156906405945,0.13642544534112977,1042288.7364161334,2231.5396151726677,1044520.276031306,2809,3,483.38693467336685,68,131,36,36.99916343783026,0.5528685092127303,42.84420289855072,8106.282247294197,119.21003304844407,0
2946,32.03362045424968,0,0,197,0.0,0.0,1.0,197,6450,4200,2250,0.6511627906976745,87,42,45,226.39564886361518,0.47245243274974963,0.7882240682207564,0.13622585131004233,1059934.1156982991,2142.8943752397668,1062077.0100735389,2810,4,489.1370558375635,70,127,36,36.92837249534239,0.5546742808798646,42.75234741784038,8240.5736655636,117.72248093662284,0
2947,32.399756060956676,2,1,198,0.010050251256281407,0.005025125628140704,0.9949748743718593,199,6750,4800,1950,0.7111111111111111,87,48,39,221.10625829265385,0.47270971862680405,0.7854631291497949,0.13371356555185376,1073582.5151532036,925.1625787881067,1074507.6777319917,2811,0,485.2110552763819,66,133,38,36.876434351974865,0.5567943886097153,42.568407960198996,8340.720784473253,126.37455734050383,0
2948,31.932872598769734,1,0,199,0.005025125628140704,0.0,1.0,199,5800,4100,1700,0.7068965517241379,75,41,34,221.57956840566501,0.47256061452041354,0.7861423856271514,0.13465219926190383,1059568.47885178,1355.7452480448073,1060924.224099825,2812,0,485.89447236180905,68,131,39,36.683221987810605,0.5584170854271358,42.39130434782608,8226.185658596098,120.97331850876614,0
2949,32.21451548037259,1,3,197,0.005,0.015,0.985,200,6350,4300,2050,0.6771653543307087,84,43,41,216.3138861573804,0.4724795854271357,0.7821653767357166,0.13216507675790945,1070544.7691045902,-35.26013790633897,1070509.5089666839,2813,0,484.46,70,130,38,36.6181519842173,0.5600520833333333,42.19483568075116,8305.06845688241,118.64383509832015,0
2950,32.20905889310155,0,3,194,0.0,0.015228426395939087,0.9847715736040609,197,4750,3400,1350,0.7157894736842105,61,34,27,242.33946990804833,0.4718923737007494,0.8024125059010765,0.1396464459193888,1052437.539281813,6859.431076176895,1059296.97035799,2814,1,489.8629441624365,67,130,41,38.16764541387024,0.5393401015228426,44.362745098039206,8233.835398408048,122.89306564788131,8
2951,31.91309299963107,0,2,192,0.0,0.010309278350515464,0.9896907216494846,194,6700,4300,2400,0.6417910447761194,91,43,48,222.04127908474945,0.4717869193241102,0.7742686692134606,0.13096446700507605,1049902.3659792372,1124.3328512266507,1051026.698830464,2815,2,496.55670103092785,71,123,41,37.7939932318105,0.5488079896907216,43.489583333333314,8186.040782457402,115.2963490486958,8
2952,31.79025971110982,2,0,194,0.010309278350515464,0.0,1.0,194,6400,4400,2000,0.6875,84,44,40,218.9506981478802,0.47181084521838224,0.7718451149276273,0.13012470131970869,1048156.0182336306,698.8983920308792,1048854.9166256615,2816,0,496.66494845360825,74,120,43,37.58586186381092,0.551331615120275,43.208333333333314,8163.473774982032,110.31721317543287,0
2953,32.095145256092934,1,0,195,0.005128205128205128,0.0,1.0,195,5750,4200,1550,0.7304347826086957,73,42,31,261.8969642726376,0.4718796810291656,0.8177637141398149,0.15784935095771174,1062472.0329390056,10901.64001026081,1073373.6729492664,2817,0,495.1128205128205,61,134,32,35.95270159973881,0.5572649572649573,42.69153225806453,8258.352647800146,135.38283029180567,8
2954,31.984669705923825,0,3,192,0.0,0.015384615384615385,0.9846153846153847,195,6000,4300,1700,0.7166666666666667,77,43,34,263.674121481096,0.4715195171380739,0.8197956488954314,0.15978446567885515,1060446.2247900937,10922.44533989443,1071368.670129988,2818,1,496.1128205128205,62,133,34,35.703603227601555,0.5589209401709402,42.49338624338623,8236.263988096169,132.8429675499382,0
2955,32.17433101918989,2,1,193,0.010309278350515464,0.005154639175257732,0.9948453608247423,194,5450,4000,1450,0.7339449541284404,69,40,29,259.68778696051436,0.4705978580204049,0.8165469124232005,0.15869809203142524,1069270.2172820359,11285.283277751925,1080555.5005597877,2819,0,499.5773195876289,67,127,38,35.49242424242423,0.5615335051546392,42.18749999999999,8294.944715884883,123.80514501320721,0
2956,32.3549836123789,0,1,192,0.0,0.0051813471502590676,0.9948186528497409,193,6700,4800,1900,0.7164179104477612,86,48,38,261.3998947927927,0.47038603734887735,0.817735241679133,0.1604023779197541,1076515.6167355771,10980.213791495567,1087495.8305270728,2820,1,502.9119170984456,69,124,34,35.29558455917699,0.5633635578583764,42.03869047619047,8346.333942270641,120.96136148218321,0
2957,31.957967676763168,0,2,190,0.0,0.010416666666666666,0.9895833333333334,192,5100,3700,1400,0.7254901960784313,65,37,28,257.8862627946425,0.4703264752399651,0.815041252315492,0.15875281463717714,1064257.5019571327,11391.477966177248,1075648.97992331,2821,2,505.3072916666667,68,124,34,35.26786584771376,0.5643988715277778,41.923309178743956,8247.60654339169,121.28833152046603,0
2958,31.998518862073677,0,2,188,0.0,0.010526315789473684,0.9894736842105263,190,6100,4100,2000,0.6721311475409836,81,41,40,256.89944118776384,0.4701678965933352,0.812994777114207,0.15893826344897316,1067095.3083169477,10727.237680141763,1077822.5459970895,2822,3,509.4894736842105,67,123,37,35.10865857998696,0.565734649122807,41.743259803921575,8263.833172421892,123.34079361823719,0
2959,31.60860383991836,2,0,190,0.010526315789473684,0.0,1.0,190,6400,4800,1600,0.75,80,48,32,258.1927547942367,0.4697426436461524,0.8127669594038369,0.16079115793034546,1056015.5410087684,10131.112327716082,1066146.6533364845,2823,0,507.63157894736844,58,132,38,34.8336862236186,0.5679824561403508,41.507768361581924,8170.578545555174,140.8720438888823,0
2960,31.193128076660894,0,0,190,0.0,0.0,1.0,190,5800,4000,1800,0.6896551724137931,76,40,36,256.04503610886377,0.46963415483152327,0.810550592032605,0.16002035082516256,1043156.8792373702,9619.028162308696,1052775.9073996788,2824,1,508.63157894736844,61,129,39,34.75923850668054,0.5694627192982455,41.38104838709679,8067.134080713087,132.2480996838211,0
2961,31.06726908411754,2,4,188,0.010416666666666666,0.020833333333333332,0.9791666666666666,192,5150,3300,1850,0.6407766990291263,70,33,37,212.81784523405352,0.46930048811082026,0.7690325269955536,0.1341974209666812,1041500.0772916505,779.9604520621938,1042280.0377437127,2825,0,504.3229166666667,75,117,35,35.55296774648883,0.5770941840277778,41.0635964912281,8044.446923480715,107.2592923130762,8
2962,30.678121072535784,0,0,188,0.0,0.0,1.0,188,4850,3200,1650,0.6597938144329897,65,32,33,223.39286807111466,0.46839207152880497,0.7749768732654951,0.13421254897042947,1014638.1572359084,2882.5855998640036,1017520.7428357725,2826,1,514.1595744680851,82,106,41,37.06326550529449,0.5589539007092199,42.808734939759034,7890.144768316711,96.2212776623989,8
2963,30.89656298233932,1,1,188,0.005291005291005291,0.005291005291005291,0.9947089947089947,189,6250,4700,1550,0.752,78,47,31,216.43286345190793,0.4679420428533904,0.7680255538602918,0.13069723831668173,1023350.9841896945,247.3567649007582,1023598.3409545952,2827,0,512.4338624338625,71,118,40,37.05101180438448,0.5610119047619048,42.62152777777778,7952.110177312162,112.00155179312904,0
2964,30.979495328617972,0,1,187,0.0,0.005319148936170213,0.9946808510638298,188,5750,4000,1750,0.6956521739130435,75,40,35,216.277722614126,0.4675849546781962,0.7664228907636337,0.13100810690070158,1026998.784085171,1073.3916298833528,1028072.1757150543,2828,1,515.3191489361702,72,116,40,36.9395954558049,0.5623891843971631,42.50856164383561,7976.954811713913,110.79103905158212,0
2965,30.914356425225225,2,0,189,0.010582010582010581,0.0,1.0,189,6200,4300,1900,0.6935483870967742,81,43,38,216.08949967186538,0.46798191301737396,0.768504542898576,0.13220076234678033,1027716.011984479,415.72776689824695,1028131.7397513773,2829,0,509.8201058201058,77,112,41,36.575512740832814,0.5648148148148149,42.147435897435905,7971.346071824922,103.52397495876522,0
2966,30.781577893638236,1,4,186,0.005263157894736842,0.021052631578947368,0.9789473684210527,190,5800,4100,1700,0.7068965517241379,75,41,34,221.8214254582603,0.467949967511371,0.7729590899789605,0.13625785173128024,1024464.3050535333,1649.6264956161885,1026113.9315491494,2830,0,508.13157894736844,80,110,36,36.278058850895555,0.5663377192982456,42.00102880658436,7941.615428268642,99.27019285335803,0
2967,30.378812300413223,2,1,187,0.010638297872340425,0.005319148936170213,0.9946808510638298,188,5800,4300,1500,0.7413793103448276,73,43,30,216.06081957082307,0.46812836594986157,0.7646771427024466,0.13372655837151615,1013195.3564948855,382.3638219272116,1013577.7203168127,2831,0,513.2446808510638,83,105,40,36.14843912549416,0.56853945035461,41.728670634920626,7845.976237359923,94.52983418505931,0
2968,30.324586470307576,1,3,185,0.005319148936170213,0.015957446808510637,0.9840425531914894,188,6200,4600,1600,0.7419354838709677,78,46,32,205.31561739452786,0.4679405127621648,0.7556333053328468,0.12471563391443949,1006082.7109816583,-2487.101408968064,1003595.6095726902,2832,0,514.1755319148937,75,113,37,37.11800752013053,0.5630540780141844,42.406798245614034,7811.407320764264,104.15209761019018,8
2969,30.50017273095368,1,1,185,0.005376344086021506,0.005376344086021506,0.9946236559139785,186,5350,3500,1850,0.6542056074766355,72,35,37,205.90083299069505,0.467763126029255,0.7549168931320847,0.12537178058668738,1012594.582453655,-851.1863981855167,1011743.3960554694,2833,0,519.0967741935484,74,112,41,37.013780341005045,0.5643481182795699,42.31944444444444,7859.301453852548,106.2067764034128,0
2970,31.011919820000823,0,1,184,0.0,0.005405405405405406,0.9945945945945946,185,6300,4700,1600,0.746031746031746,79,47,32,202.38087420781463,0.46734601449275365,0.7496548132968273,0.1238140025096474,1030959.4067883388,-1570.706796281358,1029388.6999920574,2834,1,522.8864864864864,77,108,40,36.92899316345554,0.5661599099099099,42.147435897435884,7996.50304333031,103.8506888744196,0
2971,31.446057505360383,2,2,184,0.010752688172043012,0.010752688172043012,0.989247311827957,186,5500,3200,2300,0.5818181818181818,78,32,46,197.6928036066654,0.4673259953501889,0.745275204091038,0.12169629395026228,1047205.439709682,-1295.0041343285475,1045910.4355753534,2835,0,520.3010752688172,80,106,39,36.82188891103584,0.5684923835125448,41.92386831275719,8115.476877797973,101.44346097247467,0
2972,31.024390001940812,1,3,182,0.005405405405405406,0.016216216216216217,0.9837837837837837,185,4950,2800,2150,0.5656565656565656,71,28,43,195.59113115159576,0.46661158441049744,0.7406793977507158,0.12086298952479313,1034264.1849688716,-1491.4196304714105,1032772.7653384003,2836,0,523.2108108108108,86,99,40,36.7359694271848,0.5703265765765766,41.786398467432925,8010.9194777520315,93.15022648548874,0
2973,31.39850881658769,1,0,183,0.00546448087431694,0.0,1.0,183,6200,4500,1700,0.7258064516129032,79,45,34,196.09926491891565,0.46611721611721607,0.7400698618155741,0.12167831701925627,1047938.685682566,-1699.9988115106662,1046238.6868710554,2837,0,525.8907103825137,72,111,44,36.571670532788396,0.5718351548269581,41.638127853881294,8112.177520450043,112.66913222847282,0
2974,30.967891926838803,0,3,180,0.0,0.01639344262295082,0.9836065573770492,183,5000,3400,1600,0.68,66,34,32,196.24573688958793,0.46578694529514203,0.7459716212373679,0.11912854961104491,1027236.2328317867,-1281.8537056482073,1025954.3791261385,2838,1,526.8907103825137,74,109,43,37.37586501303137,0.5661429872495447,42.43055555555557,7976.3827192115,107.78895566502028,8
2975,30.72590458057729,2,1,181,0.01098901098901099,0.005494505494505495,0.9945054945054945,182,5950,4400,1550,0.7394957983193278,75,44,31,194.9129007433304,0.46529379920263897,0.7439485324369579,0.11937719715364638,1021768.5667205218,-2518.8249544294126,1019249.7417660924,2839,0,528.6703296703297,77,105,36,37.08071177049352,0.5685668498168498,42.10737179487181,7923.9842862651,102.90888683461169,0
2976,30.8916729040387,1,1,181,0.005494505494505495,0.005494505494505495,0.9945054945054945,182,5300,3700,1600,0.6981132075471698,69,37,32,199.29150287116352,0.4651059690769635,0.7480383101914725,0.12275811590777577,1028925.5118732946,-688.777679257787,1028236.7341940368,2840,0,529.6428571428571,79,103,39,36.75734873709347,0.5703411172161172,41.901041666666686,7973.108597706491,100.92542528742393,0
2977,30.84413904524543,0,1,180,0.0,0.0055248618784530384,0.994475138121547,181,6000,4200,1800,0.7,78,42,36,209.42604169751695,0.46512303048905257,0.7589448327070822,0.12357181848048812,1014849.5354557743,307.18422581330515,1015156.7196815875,2841,1,533.1160220994475,71,110,44,38.10281663000769,0.5532343462246777,43.47511574074073,7912.289198658071,111.44069293884607,8
2978,31.139379293000705,2,1,181,0.01098901098901099,0.005494505494505495,0.9945054945054945,182,5050,3500,1550,0.693069306930693,66,35,31,207.35561345668165,0.4657194210025702,0.7566214481653308,0.12307304661820498,1026310.1012029807,1112.2321263464878,1027422.3333293272,2842,0,530.8076923076923,75,107,44,37.932859990034856,0.5548878205128205,43.25657894736841,7994.8307691404525,106.59774358853937,0
2979,31.67451261819835,3,4,180,0.016304347826086956,0.021739130434782608,0.9782608695652174,184,5400,3500,1900,0.6481481481481481,73,35,38,203.43926549272217,0.4665275797893403,0.754227424920755,0.12159566770066345,1046047.8222995644,361.4401277768484,1046409.2624273412,2843,0,525.5054347826087,78,106,35,37.769996408598814,0.5569519927536232,42.998417721518976,8140.3998607766625,104.36410077918798,0
2980,31.342167854785636,0,1,179,0.0,0.005555555555555556,0.9944444444444445,180,5450,4000,1450,0.7339449541284404,69,40,29,211.65890432133176,0.4648781812538796,0.7602428728454826,0.12680850623337264,1035774.3778233223,2396.1739868386107,1038170.551810161,2844,2,538.1777777777778,76,104,36,37.46974321195537,0.5582175925925925,42.911255411255404,8057.71858647653,106.02261297995433,0
2981,31.785605780506128,1,1,179,0.005555555555555556,0.005555555555555556,0.9944444444444445,180,5600,4000,1600,0.7142857142857143,72,40,32,208.85666720257933,0.46531980653838195,0.7573200262143593,0.1257792439510771,1051982.5167934806,2342.712482573356,1054325.229276054,2845,0,538.7611111111111,80,100,38,37.34775400713117,0.5603587962962964,42.72119341563784,8177.762721769574,102.22203402211967,0
2982,31.712026789394045,1,2,178,0.005555555555555556,0.011111111111111112,0.9888888888888889,180,4900,3600,1300,0.7346938775510204,62,36,26,218.616120242195,0.4657155234843782,0.765329991645781,0.1327117775578138,1051927.9264281096,5093.680410026065,1057021.6068381357,2846,0,538.7944444444445,70,110,38,36.798672818409656,0.5624421296296296,42.42957746478873,8168.080139592157,116.68685913703082,0
2983,31.730742217796866,1,1,178,0.00558659217877095,0.00558659217877095,0.994413407821229,179,5750,4200,1550,0.7304347826086957,73,42,31,216.9166411590649,0.46540288326742413,0.7614017267648541,0.1325601695972067,1054528.1456048847,4198.9406704619505,1058727.0862753466,2847,0,539.731843575419,75,104,37,36.595117845117834,0.564653165735568,42.18750000000001,8180.5819780257725,109.07442637367697,0
2984,31.990748198723324,2,3,177,0.011111111111111112,0.016666666666666666,0.9833333333333333,180,4550,3100,1450,0.6813186813186813,60,31,29,211.26469553182721,0.465265492447755,0.7562943336978154,0.12980495944071807,1064780.5638780282,4440.108327179848,1069220.672205208,2848,0,534.3888888888889,79,101,35,36.541393304735436,0.5666087962962962,41.9921875,8253.862962990923,104.47927801254333,0
2985,31.739716490870805,0,0,177,0.0,0.0,1.0,177,5800,3900,1900,0.6724137931034483,77,39,38,216.85472355113336,0.464584938366718,0.7596332454813663,0.13363497563385934,1057300.811539102,4656.1350393402745,1061956.9465784424,2849,1,543.5762711864406,80,97,36,36.28794861574744,0.5682674199623352,41.885288065843625,8192.487778912917,102.40609723641145,0
2986,31.266191583789517,0,2,175,0.0,0.011299435028248588,0.9887005649717514,177,4650,2900,1750,0.6236559139784946,64,29,35,211.86737602599524,0.46453411230953606,0.7542077482322473,0.1310758054637723,1042668.8778684207,4131.50384359033,1046800.3817120111,2850,2,544.5762711864406,80,97,38,36.27222139229159,0.5693267419962336,41.74382716049384,8074.686977696284,100.93358722120355,0
2987,31.000769340448155,2,1,176,0.011299435028248588,0.005649717514124294,0.9943502824858758,177,5300,3600,1700,0.6792452830188679,70,36,34,229.82287016061264,0.46384394795411743,0.764760952434409,0.13869325391705983,1026613.6039528381,6487.857001274452,1033101.4609541126,2851,0,544.1129943502825,65,112,40,36.73060018806982,0.5629708097928436,42.64520202020203,7978.196730829366,122.74148816660563,8
2988,30.804985060381398,0,1,175,0.0,0.005681818181818182,0.9943181818181818,176,4650,3500,1150,0.7526881720430108,58,35,23,226.93035308783055,0.4632487824675325,0.7599665756087302,0.13754920350910396,1021399.5636760436,6507.3127257522565,1027906.8764017959,2852,1,548.1193181818181,69,107,41,36.64132476162959,0.5642163825757576,42.48511904761906,7932.742060564014,114.96727624005817,0
2989,31.070794544008884,0,2,173,0.0,0.011428571428571429,0.9885714285714285,175,5550,4000,1550,0.7207207207207207,71,40,31,224.7745362571516,0.46291187739463596,0.7559260228830118,0.1369161768127121,1031650.2201603892,5827.739963228214,1037477.9601236174,2853,2,551.1485714285715,74,101,40,36.513240630951096,0.5662499999999999,42.30555555555557,8006.771138465885,108.19960997926871,0
2990,30.714670340020916,0,0,173,0.0,0.0,1.0,173,4900,3600,1300,0.7346938775510204,62,36,26,224.48502256797457,0.4625131626114621,0.7528195833625231,0.13726211245181383,1020921.068712087,6336.297829990852,1027257.3665420779,2854,3,558.393063583815,76,97,41,36.37924777445472,0.567557803468208,42.1672077922078,7919.249215509469,104.20064757249301,0
2991,30.90346039453655,0,0,173,0.0,0.0,1.0,173,5750,4400,1350,0.7652173913043478,71,44,27,219.20128518528998,0.46231152260608505,0.7460235683183076,0.13463280423624768,1028487.4427452185,4739.153849336959,1033226.5965945555,2855,4,559.393063583815,79,94,36,36.349929342888856,0.5691835260115607,42.00520833333334,7972.931826267568,100.92318767427301,0
2992,30.966966337896274,0,1,172,0.0,0.005780346820809248,0.9942196531791907,173,5550,4600,950,0.8288288288288288,65,46,19,218.8048313596633,0.4618368284267598,0.7464396249601752,0.13489424069260758,1031682.1172580962,4997.406336687522,1036679.5235947837,2856,5,560.393063583815,81,92,37,36.22190780839895,0.5709898843930636,41.86991869918698,7993.505538440682,98.68525356099607,0
2993,31.160906962019915,1,0,173,0.005780346820809248,0.0,1.0,173,4500,2800,1700,0.6222222222222222,62,28,34,218.76631310927255,0.4620132634314648,0.7465907501126985,0.1352609769651863,1038980.4267252067,6358.783469474268,1045339.210194681,2857,0,560.9364161849711,83,90,39,36.11658022794212,0.5726156069364161,41.765873015873005,8046.8096053707895,96.94951331772036,0
2994,31.27362687420002,0,0,173,0.0,0.0,1.0,173,4500,3200,1300,0.7111111111111111,58,32,26,220.43177675611366,0.4619418492628937,0.7504109436705013,0.13672440429663768,1043660.3459406899,6911.180877121302,1050571.5268178112,2858,1,561.9364161849711,69,104,40,35.95697012460879,0.5736392100192678,41.651785714285715,8079.485657187301,117.0939950317,0
2995,30.93326829214574,1,2,172,0.005747126436781609,0.011494252873563218,0.9885057471264368,174,5150,3300,1850,0.6407766990291263,70,33,37,220.75100810570768,0.4619446659136713,0.7502117228818674,0.1376863172415602,1033894.1460524928,5696.635003135596,1039590.7810556283,2859,0,559.7011494252873,72,102,40,35.74516621594276,0.5754310344827587,41.45262557077626,7997.715299449053,111.07937915901464,0
2996,31.347394987584018,2,0,174,0.011494252873563218,0.0,1.0,174,5350,4200,1150,0.7850467289719626,65,42,23,222.27407495538446,0.4616491429140921,0.7609587888982343,0.13386070906537503,1037481.9073870259,5971.066249479547,1043452.9736365054,2860,0,545.8045977011494,82,92,41,37.00223577235771,0.5619612068965517,42.72088353413653,8065.030085912022,98.35402543795148,8
2997,30.892015917456494,2,1,175,0.011363636363636364,0.005681818181818182,0.9943181818181818,176,5400,4500,900,0.8333333333333334,63,45,18,219.78929772403725,0.4622734036796537,0.7615177929307719,0.1336196781496514,1025151.8315600507,4463.480223819043,1029615.3117838698,2861,0,540.5909090909091,68,108,43,36.71391249145426,0.5640980113636364,42.37620772946862,7958.518291536801,117.0370336990706,0
2998,30.495122639567015,1,1,175,0.005681818181818182,0.005681818181818182,0.9943181818181818,176,6700,5100,1600,0.7611940298507462,83,51,32,219.2007990632371,0.46212729978354977,0.761661667435779,0.13426873419049065,1014128.1372272896,2559.5396065469317,1016687.6768338366,2862,0,541.2670454545455,73,103,38,36.449918581591255,0.5664654356060606,42.10304054054055,7864.599407087675,107.73423845325583,0
2999,30.82302032602765,0,0,175,0.0,0.0,1.0,175,5750,4000,1750,0.6956521739130435,75,40,35,226.4353684747489,0.46231800766283526,0.7686141126254067,0.13414125905253202,1015323.8155007502,5231.044456819893,1020554.8599575701,2863,1,544.9085714285715,68,107,38,37.515316825471515,0.5531547619047619,43.327294685990324,7911.428013030194,116.34452960338521,8
3000,30.528434660974295,6,1,180,0.03314917127071823,0.0055248618784530384,0.994475138121547,181,4800,3100,1700,0.6458333333333334,65,31,34,221.75208947656523,0.46381215469613263,0.7711590846398715,0.1333425653062061,1009937.7323349285,3791.1604772988007,1013728.8928122272,2864,0,527.8121546961326,75,106,38,37.07288724889436,0.556975138121547,42.77686403508771,7852.619699595714,104.70159599460952,0
3001,30.737775621524097,2,1,181,0.01098901098901099,0.005494505494505495,0.9945054945054945,182,6700,5100,1600,0.7611940298507462,83,51,32,218.61448555254537,0.46374941816930765,0.7676269432455669,0.13230132848165768,1018718.7745702147,1441.336165077449,1020160.1107352921,2865,0,525.9010989010989,68,114,39,36.91387162347057,0.5589514652014652,42.54227053140097,7913.677920432862,116.37761647695386,0
3002,30.456173823866713,1,0,182,0.005494505494505495,0.0,1.0,182,5250,3900,1350,0.7428571428571429,66,39,27,217.30056726591658,0.4640238904741667,0.7670311901081128,0.13230578842393204,1011118.2635295432,2293.3144475798726,1013411.5779771231,2866,0,524.532967032967,69,113,43,36.72205859705861,0.560782967032967,42.32142857142859,7847.903362114265,113.73772988571399,0
3003,30.141034462877165,3,2,183,0.016216216216216217,0.010810810810810811,0.9891891891891892,185,6100,4500,1600,0.7377049180327869,77,45,32,201.635135443428,0.4644119663141402,0.7522022772397596,0.12043937493202875,995220.1665319831,-2965.7293850588685,992254.4371469242,2867,0,517.0108108108108,72,113,40,37.84068613841225,0.5530405405405405,43.02226027397257,7745.574909274403,107.57742929547781,8
3004,30.289127966413044,2,2,183,0.010810810810810811,0.010810810810810811,0.9891891891891892,185,6600,5000,1600,0.7575757575757576,82,50,32,211.38722467427004,0.4641781727379553,0.7611198047900702,0.12745774079472294,1002801.0280944773,-1204.1347541206346,1001596.8933403566,2868,0,515.1351351351351,65,120,40,37.23728328426561,0.5556306306306307,42.67676767676769,7794.09631256944,119.90917403952984,0
3005,30.110299569788282,0,4,179,0.0,0.02185792349726776,0.9781420765027322,183,5000,2700,2300,0.54,73,27,46,218.65902869087043,0.46347254748894096,0.7746243954710639,0.1274021224880057,987068.6109630734,1566.2927448863707,988634.9037079598,2869,1,520.311475409836,68,115,43,38.34740974392235,0.5429189435336976,43.946256038647334,7709.854936642177,113.3802196565026,8
3006,30.19267870489076,3,0,182,0.016483516483516484,0.0,1.0,182,5500,4000,1500,0.7272727272727273,70,40,30,211.7459032474403,0.4643344109849635,0.7661388974092991,0.12430652145668068,991947.6745581276,108.1712647017066,992055.8458228294,2870,0,522.9285714285714,60,122,43,38.23682077587548,0.5453869047619048,43.6646174863388,7739.451844930245,128.99086408217076,0
3007,30.072240936179302,0,2,180,0.0,0.01098901098901099,0.989010989010989,182,5300,3300,2000,0.6226415094339622,73,33,40,210.6112711597461,0.46412760811932086,0.7648312854134476,0.12375369917500072,988254.111135106,-72.50908499803427,988181.6020501079,2871,1,523.9285714285714,60,122,46,38.23103310464265,0.5465888278388278,43.630464480874316,7709.606440827523,128.49344068045872,0
3008,29.743698045462892,1,1,180,0.0055248618784530384,0.0055248618784530384,0.994475138121547,181,6500,4700,1800,0.7230769230769231,83,47,36,199.69639274624808,0.46461019030079803,0.7494050380474393,0.11234453506031275,964936.2849441089,-4161.140933339071,960775.1440107699,2872,0,526.292817679558,74,107,35,40.191066884769185,0.5324010128913443,45.277777777777786,7576.380863247093,102.38352517901477,7
3009,29.76264415619031,4,3,181,0.021739130434782608,0.016304347826086956,0.9836956521739131,184,5750,4500,1250,0.782608695652174,70,45,25,196.7820667789774,0.46611675378157913,0.751125461336505,0.11177609365807378,968349.8407116361,-4439.223395933906,963910.6173157023,2873,0,518.0163043478261,79,105,40,39.88911787725659,0.5348731884057971,44.908854166666686,7592.187000832389,96.10363292192896,0
3010,29.43720754372299,4,3,182,0.021621621621621623,0.016216216216216217,0.9837837837837837,185,5550,3900,1650,0.7027027027027027,72,39,33,205.07102978385026,0.46659444770857816,0.7604934928666933,0.11909033984174885,964067.1106382915,-3009.5529681328585,961057.5576701586,2874,0,516.0864864864865,77,108,40,38.822140471717844,0.5461711711711712,44.070512820512825,7533.849430661163,97.84220039819692,8
3011,29.42113526533826,1,2,181,0.00546448087431694,0.01092896174863388,0.9890710382513661,183,5650,3700,1950,0.6548672566371682,76,37,39,231.84312801356464,0.4661722612542285,0.7860548227565602,0.13454203570550977,963339.6400546477,2418.735097946256,965758.375152594,2875,0,522.3060109289618,68,115,36,38.16429217548622,0.544341985428051,44.09722222222223,7528.950239775809,110.71985646729131,8
3012,29.667092065260878,3,1,183,0.016304347826086956,0.005434782608695652,0.9945652173913043,184,6500,4400,2100,0.676923076923077,86,44,42,227.9895581878773,0.46618295616535993,0.7851119592295119,0.13365690701759703,974286.3605433772,1125.423377751817,975411.7839211291,2876,0,520.4402173913044,61,123,38,37.8733993269525,0.5470448369565217,43.71639784946236,7603.189219816679,124.64244622650293,0
3013,29.73359355731162,5,6,182,0.026595744680851064,0.031914893617021274,0.9680851063829787,188,6400,4600,1800,0.71875,82,46,36,214.43418632030574,0.4676708812151553,0.7742964756923831,0.12381844952043411,972136.80731614,-2308.1269462288988,969828.6803699111,2877,0,509.6436170212766,69,119,44,38.80232580695225,0.5424977836879432,44.28571428571427,7603.304638226793,110.19282084386657,8
3014,30.03754141447812,3,3,182,0.016216216216216217,0.016216216216216217,0.9837837837837837,185,6150,4100,2050,0.6666666666666666,82,41,41,215.5706145594435,0.46629700352526443,0.7716455278542,0.1253398252842659,984078.8161058062,-722.3049674285921,983356.5111383776,2878,0,506.97837837837835,71,114,39,38.50681295804367,0.5447072072072072,44.02488425925924,7688.863140138283,108.29384704420116,0
3015,30.23380038172261,3,2,183,0.016216216216216217,0.010810810810810811,0.9891891891891892,185,5350,3700,1650,0.6915887850467289,70,37,33,243.49235698636053,0.4667511261261261,0.7913551986149849,0.13629751456806222,979348.4463369352,5342.7723019020605,984691.2186388372,2879,0,507.85945945945946,68,117,36,39.27342823250297,0.5305743243243244,45.47101449275362,7695.378539188444,113.16733145865359,8
3016,30.460964867130087,3,2,184,0.016129032258064516,0.010752688172043012,0.989247311827957,186,6450,5200,1250,0.8062015503875969,77,52,25,255.12983984674554,0.4676226629855662,0.8017357267232805,0.14474760369036024,990719.4259563484,6902.41769546031,997621.8436518087,2880,0,505.23118279569894,76,110,33,38.44701992609486,0.5337701612903225,44.95400432900431,7768.947113636373,102.2229883373207,0
3017,30.076692756636294,3,2,185,0.016042780748663103,0.0106951871657754,0.9893048128342246,187,6500,4900,1600,0.7538461538461538,81,49,32,221.13820899100708,0.46832772698522224,0.7763260541786252,0.12234028564592847,970782.1639957142,-964.5941867150059,969817.5698089992,2881,0,502.97860962566847,78,109,38,40.30707786254256,0.5260138146167558,45.925632911392384,7641.7166762608285,97.97072661872858,8
3018,30.156262197021707,2,0,187,0.0106951871657754,0.0,1.0,187,5850,4200,1650,0.717948717948718,75,42,33,171.32491265788835,0.46864278458206354,0.71920750416411,0.09500745156482811,974057.7398881661,-9873.928557984302,964183.8113301818,2882,0,502.1711229946524,77,110,41,41.47882513661199,0.5281305704099821,45.8333333333333,7664.716641742945,99.5417745680902,8
3019,30.69249425593466,2,5,184,0.010582010582010581,0.026455026455026454,0.9735449735449735,189,5200,3500,1700,0.6730769230769231,69,35,34,195.83744463521865,0.46884733010619534,0.7555753020598077,0.10666210006357353,985895.2487325418,-4384.958762043174,981510.2899704986,2883,0,497.84656084656086,73,116,38,41.57341071494685,0.5197310405643739,46.537162162162154,7779.40669443072,106.56721499220164,8
3020,31.05951488342551,3,2,185,0.016042780748663103,0.0106951871657754,0.9893048128342246,187,6000,4300,1700,0.7166666666666667,77,43,34,188.25564228942537,0.4687589845322293,0.7367271971609519,0.1032031127724843,999698.3364369585,-5760.2295156776845,993938.1069212809,2884,0,500.5882352941176,85,102,35,41.50509818430647,0.5251782531194296,46.281492248062044,7880.373767721899,92.71027962025764,8
3021,31.280195035652888,7,1,191,0.036458333333333336,0.005208333333333333,0.9947916666666666,192,6200,4700,1500,0.7580645161290323,77,47,30,192.82450954044447,0.46974815026905176,0.7528176229508172,0.10692995529061104,1010361.160830429,-5635.520940831302,1004725.6398895978,2885,0,488.515625,93,99,42,40.932377049180324,0.5284830729166667,45.83333333333336,7950.38290489518,85.48798822467936,0
3022,30.90933591103543,4,2,193,0.020512820512820513,0.010256410256410256,0.9897435897435898,195,5750,4200,1550,0.7304347826086957,73,42,31,183.91262407962634,0.470859767380386,0.7454656129471771,0.10314736916511141,1001820.270128831,-7900.521052889437,993919.7490759416,2886,0,481.9384615384615,80,115,43,40.713603225915094,0.531517094017094,45.396090534979415,7869.637761917153,98.37047202396441,0
3023,31.356071300375213,2,2,193,0.010256410256410256,0.010256410256410256,0.9897435897435898,195,5600,3700,1900,0.6607142857142857,75,37,38,181.3419850942318,0.47098753194114024,0.7421726681513172,0.10230128155315872,1018092.9015294773,-7675.402445259952,1010417.4990842174,2887,0,475.6102564102564,84,111,39,40.55045926709625,0.5334935897435897,45.17156862745096,7990.418463480364,95.1240293271472,0
3024,31.716730320201464,2,5,190,0.010256410256410256,0.02564102564102564,0.9743589743589743,195,6500,4600,1900,0.7076923076923077,84,46,38,183.24416117737331,0.4711307163626752,0.7445678435040148,0.10394367073681997,1031503.6976710872,-7696.594033780724,1023807.1036373065,2888,0,469.7692307692308,85,110,43,40.28780395136776,0.5356303418803419,44.96124031007751,8088.995562283905,95.1646536739283,0
3025,32.113223977986124,2,1,191,0.010416666666666666,0.005208333333333333,0.9947916666666666,192,5700,4100,1600,0.7192982456140351,73,41,32,199.5080722486686,0.4705838241710297,0.7574463405338789,0.1127182220175679,1043147.1572531511,-2476.7443169491917,1040670.4129362019,2889,0,476.765625,83,109,37,40.02890759300701,0.533203125,45.11408730158729,8185.208403317514,98.61696871466884,7
3026,32.35174942160718,2,0,193,0.010362694300518135,0.0,1.0,193,6350,4500,1850,0.7086614173228346,82,45,37,199.10033487714557,0.47068400978698904,0.7598015061245411,0.11325871508585164,1053049.7934975938,-3017.486694464059,1050032.3068031298,2890,0,475.27979274611397,84,109,42,39.772954691002255,0.5350820379965457,44.85294117647059,8254.45371271889,98.26730610379632,0
3027,32.61709601195155,3,2,194,0.015306122448979591,0.01020408163265306,0.9897959183673469,196,5450,3900,1550,0.7155963302752294,70,39,31,215.49508623413783,0.47135498430141287,0.7801832200450178,0.1221301061847561,1060505.597515153,1056.7490376624628,1061562.3465528155,2891,0,468.98979591836735,81,115,34,39.4996845006808,0.5319409013605443,44.994918699186975,8317.525220324085,102.68549654721093,8
3028,32.48064563141055,0,1,193,0.0,0.005154639175257732,0.9948453608247423,194,6250,4000,2250,0.64,85,40,45,220.5521342511623,0.4710908427256379,0.7832191520326974,0.125456768028151,1057233.1303445508,1585.0046597054088,1058818.1350042562,2892,1,474.6958762886598,82,112,36,39.227127397934055,0.5335051546391752,44.85441767068272,8287.293244058417,101.06455175680996,0
3029,32.024447542749236,2,2,193,0.010256410256410256,0.010256410256410256,0.9897435897435898,195,6750,5200,1550,0.7703703703703704,83,52,31,219.15233226059576,0.4712078156665786,0.7819622497446761,0.12615140352179396,1046077.618374031,100.06995845575966,1046177.6883324868,2893,0,468.6974358974359,74,121,38,38.80130504084479,0.5368055555555555,44.402777777777786,8185.359835127993,110.61297074497288,8
3030,32.476514663974044,4,4,193,0.02030456852791878,0.02030456852791878,0.9796954314720813,197,5300,3700,1600,0.6981132075471698,69,37,32,214.31245238657556,0.4717153993577126,0.7818147920659146,0.12460160641451334,1063966.8085116171,904.267198008627,1064871.0757096258,2894,0,464.8527918781726,78,119,37,38.541076426449635,0.5396573604060914,44.02689873417722,8313.11417684243,106.57838688259525,0
3031,32.03783429243406,3,2,194,0.015306122448979591,0.01020408163265306,0.9897959183673469,196,6600,5100,1500,0.7727272727272727,81,51,30,213.11803228092066,0.47122143729286586,0.779933543619747,0.1246118086606462,1051339.3561330338,-988.1250322875871,1050351.2311007462,2895,0,467.9795918367347,80,116,41,38.35452119204185,0.5419855442176871,43.81430041152263,8207.634991506924,102.59543739383655,0
3032,32.0382454115914,1,1,194,0.005128205128205128,0.005128205128205128,0.9948717948717949,195,7500,5800,1700,0.7733333333333333,92,58,34,206.53122372553426,0.470779363820601,0.7717408783327773,0.12144480706014184,1053085.5088516602,-3000.9922338481974,1050084.516617812,2896,0,471.3128205128205,70,125,42,38.30789368276492,0.5441239316239317,43.603286384976506,8214.500833523593,117.3500119074799,0
3033,32.5239254896538,0,3,191,0.0,0.015463917525773196,0.9845360824742269,194,5950,3800,2150,0.6386554621848739,81,38,43,205.1603556830858,0.47062345316311455,0.7664201062017324,0.12264056450914237,1074140.2780266718,-675.7997013037157,1073464.4783253681,2897,1,474.7061855670103,83,111,34,37.720798150381974,0.5542310996563573,42.993551587301596,8358.85857853518,100.70913950042386,8
3034,32.875736438555464,2,4,189,0.010362694300518135,0.02072538860103627,0.9792746113989638,193,6850,5100,1750,0.7445255474452555,86,51,35,203.08479076857554,0.4703590511658031,0.7647836210694137,0.1223462032191171,1088170.4667859287,-1251.8256864474297,1086918.6410994814,2898,0,477.40932642487047,69,124,40,37.48313090418355,0.5571027633851469,42.70833333333332,8458.653021169972,122.58917421985467,0
3035,32.83318939311707,0,3,186,0.0,0.015873015873015872,0.9841269841269842,189,5750,4300,1450,0.7478260869565218,72,43,29,205.34528835004136,0.46984291155390445,0.7628694486423395,0.12440507959377205,1088498.0242991014,1153.5881336299494,1089651.6124327313,2899,1,486.5767195767196,70,119,38,37.215353351186074,0.5601300705467371,42.50293427230047,8454.449927209476,120.77785610299252,0
3036,32.415384404334226,0,2,184,0.0,0.010752688172043012,0.989247311827957,186,6850,5200,1650,0.7591240875912408,85,52,33,208.36773674584583,0.4686119587329265,0.7632163993040184,0.126541416604871,1075381.6839177802,764.9695231768974,1076146.653440957,2900,2,495.36021505376345,70,116,39,37.047663799813954,0.5615479390681004,42.41490610328639,8349.719835488511,119.28171193555016,0
3037,32.00881665291142,1,4,181,0.005405405405405406,0.021621621621621623,0.9783783783783784,185,5850,4400,1450,0.7521367521367521,73,44,29,235.9608536081742,0.46842685076380725,0.7872887545612894,0.14156896624697585,1058234.55692903,7090.3858741281965,1065324.9428031582,2901,0,498.87567567567567,75,110,39,36.791582271733915,0.5561936936936938,42.859100877192965,8230.775893986678,109.74367858648904,8
3038,31.51621252737878,0,0,181,0.0,0.0,1.0,181,5750,4000,1750,0.6956521739130435,75,40,35,234.52581374737133,0.4677703601391447,0.7818116359751717,0.14123322233478408,1043056.7620577384,6974.747181257739,1050031.509238996,2902,1,501.8508287292818,73,108,41,36.68858629242579,0.5575506445672191,42.7224099099099,8108.4152078111,111.07418092891918,0
3039,31.890673650510998,0,2,179,0.0,0.011049723756906077,0.988950276243094,181,5200,3600,1600,0.6923076923076923,68,36,32,231.53526931086867,0.4675657356251279,0.7776629964930575,0.14015997124146237,1057012.3059786821,7547.125785935204,1064559.4317646173,2903,2,502.8508287292818,64,117,41,36.570760197518545,0.5591620626151013,42.53205128205128,8210.826328030595,128.29416137547804,0
3040,31.862147027179983,2,1,180,0.011049723756906077,0.0055248618784530384,0.994475138121547,181,5950,4800,1150,0.8067226890756303,71,48,23,227.43239472241305,0.4678995293636177,0.7729179042148844,0.1385881144195196,1058039.7060423815,5976.500811323329,1064016.2068537048,2904,0,501.3646408839779,69,112,42,36.43054432767449,0.5614065377532229,42.291666666666664,8211.140806796171,119.00204067820538,0
3041,32.32218313382693,0,1,179,0.0,0.005555555555555556,0.9944444444444445,180,5550,4100,1450,0.7387387387387387,70,41,29,233.43399889969302,0.4672718808193668,0.7766058410313796,0.1426829795709327,1074245.0111726397,8603.061751215131,1082848.0729238547,2905,1,505.05,70,110,42,36.16177279538688,0.5628472222222223,42.18016431924884,8333.299944406433,119.04714206294905,0
3042,32.51458894740998,0,2,177,0.0,0.0111731843575419,0.9888268156424581,179,5200,3300,1900,0.6346153846153846,71,33,38,230.9436266783632,0.4665432176260122,0.7733502853764518,0.14175407254051262,1081912.6865904706,8972.167918106894,1090884.8545085776,2906,2,508.8100558659218,71,108,34,36.070665788047066,0.5640712290502794,42.02835648148148,8387.841949092404,118.13861900130146,0
3043,32.39293323807734,1,0,178,0.0056179775280898875,0.0,1.0,178,5250,4000,1250,0.7619047619047619,65,40,25,229.9540129553356,0.46642240102414356,0.7710046193621112,0.14190298107674548,1079476.1150627676,8795.972909624099,1088272.0879723916,2907,0,512.3258426966293,73,105,38,35.898991275899704,0.5660697565543071,41.835585585585605,8362.702640573501,114.55757041881509,0
3044,32.147012306165806,0,2,176,0.0,0.011235955056179775,0.9887640449438202,178,5800,4100,1700,0.7068965517241379,75,41,34,231.72099099930213,0.46597936371907994,0.7738907796307279,0.14373120799922137,1072816.383962433,8318.815130412793,1081135.199092846,2908,1,513.3258426966293,64,114,39,35.66414407708373,0.5674742509363295,41.65064102564104,8305.160022238799,129.76812534748123,0
3045,32.089440742091625,0,1,175,0.0,0.005681818181818182,0.9943181818181818,176,5450,3800,1650,0.6972477064220184,71,38,33,235.25973861961316,0.46470441017316017,0.7763506530315423,0.1461925193762669,1071436.9710768086,9763.196352584338,1081200.167429393,2909,2,519.9715909090909,63,113,35,35.50582866200583,0.5693063446969697,41.58528645833336,8292.383637079944,131.62513709650705,0
3046,32.317985105437856,1,1,175,0.005681818181818182,0.005681818181818182,0.9943181818181818,176,5900,4400,1500,0.7457627118644068,74,44,30,229.89823209339352,0.46480045995670993,0.7698643153835136,0.14404994527914053,1081541.595189641,8628.900133913536,1090170.4953235546,2910,0,519.2045454545455,68,108,39,35.34153683063938,0.5713186553030303,41.28925120772948,8361.010126085292,122.95603126596018,0
3047,31.94035521035637,0,2,173,0.0,0.011428571428571429,0.9885714285714285,175,5300,3600,1700,0.6792452830188679,70,36,34,230.7064793238308,0.4643062397372742,0.7702943857315292,0.1452624184146467,1070335.4921638872,9086.666618494091,1079422.1587823813,2911,1,522.92,69,106,41,35.14345145714777,0.5733333333333333,41.11607142857143,8268.844636823962,119.83832806991249,0
3048,32.11759702677103,1,1,173,0.005747126436781609,0.005747126436781609,0.9942528735632183,174,5550,3600,1950,0.6486486486486487,75,36,39,229.9769991597308,0.46419673111421167,0.7681325111054647,0.14610879138105487,1078916.1593202513,9275.180133082824,1088191.3394533342,2912,0,520.7241379310345,71,103,39,34.837575351640986,0.57602969348659,40.79861111111112,8324.925757112724,117.25247545229188,0
3049,32.33493963449235,0,0,173,0.0,0.0,1.0,173,5300,4300,1000,0.8113207547169812,63,43,20,229.48787825309518,0.4636753931980105,0.7661154983410965,0.14599234037261707,1086610.5804739746,9972.791320067477,1096583.371794042,2913,1,524.5722543352601,73,100,40,34.802254710322,0.5777938342967245,40.7516891891892,8382.778480411702,114.83258192344798,0
3050,32.181518449069394,0,0,173,0.0,0.0,1.0,173,5450,4300,1150,0.7889908256880734,66,43,23,226.70462926129335,0.46329311735448314,0.7630473304085337,0.14451656285794068,1082054.5355740257,9011.354465562166,1091065.8900395879,2914,2,525.5722543352601,75,98,42,34.80091613812541,0.5792389210019269,40.679824561403514,8345.31701009312,111.27089346790827,0
3051,31.68515681674785,0,1,172,0.0,0.005780346820809248,0.9942196531791907,173,5200,3500,1700,0.6730769230769231,69,35,34,233.2476622094462,0.462985056235157,0.7693264554851089,0.14391671108109846,1055851.4858418282,9454.978142595446,1065306.4639844235,2915,3,526.5722543352601,71,102,36,35.81876260928043,0.5637042389210019,41.840277777777786,8179.831282379194,115.2088913011154,8
3052,31.926426467405527,1,0,173,0.005780346820809248,0.0,1.0,173,5550,4200,1350,0.7567567567567568,69,42,27,231.86737551413734,0.462972453734821,0.7688159865880222,0.14388830019200288,1065591.2674911653,9265.170112792173,1074856.4376039575,2916,0,526.2080924855492,63,110,39,35.64345260593845,0.5658718689788054,41.63411458333336,8248.699442441377,130.93173718160915,0
3053,32.257837821952364,0,2,171,0.0,0.011560693641618497,0.9884393063583815,173,5600,3800,1800,0.6785714285714286,74,38,36,233.67736080590907,0.4621700945467581,0.7701123353124331,0.14559480522055362,1077850.8325274705,10173.867577494466,1088024.700104965,2917,1,527.2080924855492,64,109,37,35.449600148781876,0.5676180154142583,41.490384615384635,8338.96124849224,130.29626950769125,0
3054,31.844365707330414,0,1,170,0.0,0.005847953216374269,0.9941520467836258,171,5300,3800,1500,0.7169811320754716,68,38,30,229.70396861129782,0.46166723999541337,0.7638692190846876,0.14374258654335895,1065312.8864332668,9441.319565295824,1074754.2059985627,2918,2,533.140350877193,65,106,34,35.393594789187894,0.5694444444444444,41.33522727272729,8237.015618330806,126.72331720508933,0
3055,31.796820264018585,0,0,170,0.0,0.0,1.0,170,6200,4300,1900,0.6935483870967742,81,43,38,215.79040731801777,0.4611845921800673,0.7498523720699513,0.13122512546177875,1055260.806431971,5343.031849338961,1060603.83828131,2919,3,536.2294117647059,69,101,38,36.80657839003447,0.5612745098039216,42.36607142857143,8191.939720698719,118.72376406809737,8
3056,31.48558184240418,0,1,169,0.0,0.0058823529411764705,0.9941176470588236,170,4350,2600,1750,0.5977011494252874,61,26,35,215.5294052273559,0.46090396217658663,0.7493844438566606,0.13152608962971216,1045963.7894440105,6737.190685643726,1052700.9801296543,2920,4,537.2294117647059,70,100,39,36.68333902517695,0.5628063725490196,42.238849765258216,8115.759791508197,115.93942559297425,0
3057,31.899601387212634,0,1,168,0.0,0.005917159763313609,0.9940828402366864,169,5500,4200,1300,0.7636363636363637,68,42,26,219.93797895788583,0.46033800601108293,0.7505005015112658,0.13481553940305566,1061045.0863430887,7372.822374698936,1068417.9087177876,2921,5,541.1715976331361,70,99,33,36.40476867652637,0.5644723865877712,42.0774647887324,8227.626062018762,117.5375151716966,0
3058,32.07916398145209,0,1,167,0.0,0.005952380952380952,0.9940476190476191,168,5050,3300,1750,0.6534653465346535,68,33,35,218.03638801028038,0.46002489069480085,0.7479335987173099,0.1342738900218573,1068409.981585439,7940.450659803916,1076350.4322452429,2922,6,543.6964285714286,72,96,38,36.28192900978604,0.566344246031746,41.90924657534247,8279.335601206123,114.99077223897393,0
3059,32.38164164634808,1,0,168,0.005952380952380952,0.0,1.0,168,5750,4100,1650,0.7130434782608696,74,41,33,209.53295896595773,0.4597204400722365,0.7362212729319833,0.12352754796369521,1065168.9017245362,5287.598355372064,1070456.5000799082,2923,0,544.4047619047619,72,96,41,38.13305516921648,0.5541914682539683,43.50742009132418,8305.650807549986,115.35626121597203,8
3060,32.203045572842925,1,0,169,0.005917159763313609,0.0,1.0,169,5150,3400,1750,0.6601941747572816,69,34,35,203.32676750476554,0.46007384709307786,0.7299885295024251,0.12086073337465894,1061820.3777688863,4229.301016486863,1066049.6787853732,2924,0,542.1775147928994,75,94,44,37.9803586678053,0.5564595660749507,43.201754385964875,8269.685606534793,110.26247475379724,0
3061,31.716887861188546,1,1,169,0.0058823529411764705,0.0058823529411764705,0.9941176470588236,170,4450,3000,1450,0.6741573033707865,59,30,29,218.25186436441447,0.46033400046409095,0.750464444737674,0.1269702576024723,1039268.6201918643,6914.46278646143,1046183.0829783258,2925,0,539.9823529411765,77,93,35,38.416573199784395,0.5479779411764706,44.00373931623932,8119.4046929904325,105.44681419468094,7
3062,31.932051308804425,5,1,173,0.028735632183908046,0.005747126436781609,0.9942528735632183,174,4500,2300,2200,0.5111111111111111,67,23,44,207.91838073300212,0.4622775618452816,0.7448670534866271,0.12202717547409714,1049011.8444690704,4321.768814349647,1053333.61328342,2926,0,527.3045977011494,68,106,39,38.34503896970767,0.5507064176245211,43.674516908212546,8184.998477841005,120.36762467413243,0
3063,31.677862646774834,0,3,170,0.0,0.017341040462427744,0.9826589595375722,173,5100,3700,1400,0.7254901960784313,65,37,28,207.04829370765137,0.46194885065196933,0.7440709307052418,0.11951401508075345,1035602.9794888501,3183.9659723453447,1038786.9454611954,2927,1,531.2716763005781,75,98,43,39.0039844196684,0.5476878612716762,44.298245614035096,8100.08505397797,108.0011340530396,8
3064,31.92807762277685,2,2,170,0.011627906976744186,0.011627906976744186,0.9883720930232558,172,4650,3400,1250,0.7311827956989247,59,34,25,211.2285220777256,0.46122118523051814,0.7482495950102834,0.12270974918519609,1045752.112784886,5128.534648642219,1050880.6474335282,2928,0,535.3313953488372,77,95,38,38.65091529698235,0.5493580426356589,44.057158119658126,8171.762922549677,106.12679120194386,0
3065,32.33958212085839,2,1,171,0.011627906976744186,0.005813953488372093,0.9941860465116279,172,5300,3700,1600,0.6981132075471698,69,37,32,211.4201162588197,0.4610263951221723,0.7493758097922192,0.12348742657492623,1060911.115224256,5159.59026419741,1066070.7054884534,2929,0,536.3081395348837,79,93,41,38.43872848041207,0.5515988372093024,43.85416666666668,8283.64921199907,104.85631913922875,0
3066,31.82658539382811,1,2,170,0.005813953488372093,0.011627906976744186,0.9883720930232558,172,6150,4500,1650,0.7317073170731707,78,45,33,211.3596960704824,0.46120701867718394,0.7494611583766246,0.12428328824928372,1046126.4501698115,3671.7937118368086,1049798.2438816484,2930,0,536.796511627907,63,109,42,38.18432732389595,0.553718507751938,43.603515625,8160.224604638255,129.5273746767977,0
3067,31.41968963973351,4,0,174,0.022988505747126436,0.0,1.0,174,5100,3900,1200,0.7647058823529411,63,39,24,201.23035658608543,0.4622256549952384,0.7388462612104119,0.11947926190475851,1035653.1604143135,1780.9709539353776,1037434.131368249,2931,0,531.2011494252873,71,103,47,38.07691675588363,0.5562739463601533,43.24363425925923,8067.205324599915,113.62261020563261,0
3068,31.615950807189787,1,3,172,0.005714285714285714,0.017142857142857144,0.9828571428571429,175,5250,3400,1850,0.6476190476190476,71,34,37,196.2814726962514,0.4625424192665572,0.7340613061396406,0.11725040425591068,1043942.6883785899,731.3216570863283,1044674.0100356763,2932,0,529.16,76,99,40,37.97542903769214,0.5582142857142858,43.01948051948049,8124.683462302102,106.90372976713293,0
3069,31.500546833152693,1,0,173,0.005780346820809248,0.0,1.0,173,5250,3200,2050,0.6095238095238096,73,32,41,205.49812771081304,0.46142374647129986,0.744810446784197,0.12306267188199206,1040875.7601016029,2929.60397608951,1043805.3640776924,2933,0,536.2601156069364,75,98,41,37.64484253927631,0.5592485549132948,42.92763157894735,8097.920180956808,107.9722690794241,0
3070,31.076884508315782,2,2,173,0.011428571428571429,0.011428571428571429,0.9885714285714285,175,4850,3400,1450,0.7010309278350515,63,34,29,205.48176722610884,0.4614408866995074,0.747645863274174,0.12394571661154068,1028996.8536957117,2438.018393500203,1031434.872089212,2934,0,531.12,67,108,44,37.37455850546661,0.5613690476190476,42.6623774509804,7997.25157560046,119.36196381493224,0
3071,31.034985357805255,2,0,175,0.011428571428571429,0.0,1.0,175,4900,3000,1900,0.6122448979591837,68,30,38,200.18911595607935,0.46162835249042145,0.7398629046109642,0.12153485214878408,1029491.7961227419,1318.6105099697397,1030810.4066327116,2935,0,525.6228571428571,73,102,46,37.2704667176741,0.5632142857142857,42.426801801801815,7993.780434644179,109.50384157046821,0
3072,30.94329437202741,3,5,173,0.016853932584269662,0.028089887640449437,0.9719101123595506,178,5600,3700,1900,0.6607142857142857,75,37,38,207.94766435986193,0.46225322160858245,0.7442043952412432,0.12625393907563018,1026470.6236818065,1490.4337457284623,1027961.057427535,2936,0,517.7471910112359,76,102,40,37.06801470588234,0.5635533707865168,42.424242424242415,7970.242489764615,104.87161170742915,8
3073,30.767549246176785,0,2,171,0.0,0.011560693641618497,0.9884393063583815,173,5600,4000,1600,0.7142857142857143,72,40,32,204.45137796606593,0.46138873952592196,0.732387963612934,0.1236651776922441,1019553.7632756113,1489.8343624370136,1021043.5976380483,2937,1,532.4913294797688,77,96,38,37.29806461932185,0.5652095375722543,42.5614316239316,7920.753830375864,102.8669328620242,8
3074,31.21678386426821,0,0,171,0.0,0.0,1.0,171,4550,2900,1650,0.6373626373626373,62,29,33,203.492358055395,0.4607126476321523,0.7280036475048492,0.1233804983942236,1035143.279433225,3378.7493714119573,1038522.028804637,2938,2,539.2690058479532,79,92,43,37.233500185391165,0.5665204678362573,42.47395833333331,8039.134782128797,101.76119977378224,0
3075,31.339013477295786,0,1,170,0.0,0.005847953216374269,0.9941520467836258,171,4900,3400,1500,0.6938775510204082,64,34,30,205.36750977778078,0.46036435041852997,0.7316856320153207,0.12494801270567253,1040211.1752591988,3625.115741199582,1043836.2910003983,2939,3,540.2690058479532,80,91,40,37.0569212211962,0.5677387914230019,42.34825102880655,8074.551633456978,100.93189541821224,0
3076,31.213938636593568,2,1,171,0.011627906976744186,0.005813953488372093,0.9941860465116279,172,5100,3400,1700,0.6666666666666666,68,34,34,199.8763934037168,0.4605794403644771,0.7279223318560049,0.12274789480557226,1038783.3542995818,2025.6540770428246,1040809.0083766247,2940,0,536.9593023255813,84,88,35,36.8531889290012,0.5710392441860466,42.009803921568604,8052.890149234835,95.86773987184327,0
3077,31.02163972646742,1,1,171,0.005813953488372093,0.005813953488372093,0.9941860465116279,172,6550,4900,1650,0.7480916030534351,82,49,33,200.14790352735963,0.46021465161612035,0.726239515688996,0.12367878760661946,1034172.4986723607,447.49149898464157,1034619.9901713453,2941,0,536.3255813953489,86,86,38,36.61830736653378,0.5737645348837209,41.78639846743294,8010.209319216875,93.1419688281032,0
3078,31.549573023975917,1,0,172,0.005813953488372093,0.0,1.0,172,5500,3600,1900,0.6545454545454545,74,36,38,193.08145504570325,0.4599681535881046,0.7204114541791449,0.11795387507919816,1048406.3693003915,585.5654527404458,1048991.934753132,2942,0,537.2616279069767,83,89,39,37.22225896708192,0.5718265503875969,42.199900793650784,8133.483055498924,97.99377175299908,8
3079,31.65847552214306,0,1,171,0.0,0.005813953488372093,0.9941860465116279,172,4850,3200,1650,0.6597938144329897,65,32,33,182.48191292697948,0.45991644566843465,0.7095889715095736,0.10842899325586881,1043750.1667205341,-1156.8945917972092,1042593.2721287368,2943,1,538.2616279069767,77,95,49,38.52996498162399,0.5588057170542635,43.215811965811916,8129.395931353606,105.57657053705982,8
3080,31.240774099555964,3,3,171,0.017241379310344827,0.017241379310344827,0.9827586206896551,174,5550,3400,2150,0.6126126126126126,77,34,43,177.6648684668696,0.4602137454875645,0.7046615581098377,0.10622091072168015,1031808.8597316989,-3686.7629305639757,1028122.0968011349,2944,0,533.0402298850574,81,93,44,38.42160109397652,0.5610033524904214,42.987804878048735,8029.259928635757,99.12666578562663,0
3081,30.888792814591156,1,0,172,0.005813953488372093,0.0,1.0,172,6050,4600,1450,0.7603305785123967,75,46,29,178.6598390363962,0.4596515311210843,0.7033675317248564,0.10744753699794352,1021904.9762468226,-3935.3242866507217,1017969.6519601719,2945,0,540.1337209302326,82,90,49,38.175436670569866,0.5625605620155039,42.77108433734934,7945.490681825411,96.89622782713916,0
3082,31.302095117098098,0,0,172,0.0,0.0,1.0,172,5550,3600,1950,0.6486486486486487,75,36,39,181.74882251340512,0.45949924067274134,0.7088748097750774,0.10966580918821066,1036549.8514653202,-2271.6570039465987,1034278.1944613736,2946,1,541.1337209302326,71,101,47,37.973165429877824,0.5640746124031008,42.65046296296296,8055.579686674491,113.45886882640129,0
3083,31.16616521287869,2,2,172,0.011494252873563218,0.011494252873563218,0.9885057471264368,174,5150,3600,1550,0.6990291262135923,67,36,31,211.0629900431225,0.45994036941067035,0.7451018776396887,0.12349664769886236,1022944.1757618956,3231.1312767011514,1026175.3070385967,2947,0,535.9022988505748,81,93,40,38.38042499214968,0.5501676245210728,43.7881097560976,7985.142100845498,98.58200124500615,8
3084,31.58722369707042,1,1,172,0.005780346820809248,0.005780346820809248,0.9942196531791907,173,6750,4600,2150,0.6814814814814815,89,46,43,212.83192562263486,0.46024751310660034,0.7509895386646395,0.12192138838974842,1030314.8216258729,2506.7774968353156,1032821.5991227082,2948,0,538.8901734104046,70,103,40,39.15024795603807,0.5410043352601156,44.58626760563381,8067.810700444539,115.25443857777913,8
3085,31.962394067909333,3,0,175,0.017142857142857144,0.0,1.0,175,5300,3800,1500,0.7169811320754716,68,38,30,216.29593267254515,0.4609428024083197,0.7518602510131014,0.12438557673962836,1043748.6023904366,4851.71548594109,1048600.3178763776,2949,0,533.6685714285715,73,102,37,38.91208803818969,0.5432142857142856,44.43975225225226,8168.3173466060725,111.89475817268593,6
3086,31.97714338949507,3,3,175,0.016853932584269662,0.016853932584269662,0.9831460674157303,178,5500,4400,1100,0.8,66,44,22,216.2678650659364,0.4616825631096722,0.7577714085344474,0.12550347760125657,1047031.3101447206,4187.845220438043,1051219.1553651586,2950,0,525.6573033707865,77,101,36,38.562867480777946,0.5457045880149813,44.09722222222224,8183.039818770137,106.27324439961217,0
3087,32.262600562959044,3,1,177,0.016853932584269662,0.0056179775280898875,0.9943820224719101,178,5950,4100,1850,0.6890756302521008,78,41,37,199.56452445394666,0.46190275926278596,0.7452377335368181,0.11532206926356378,1055064.5729249946,560.6919527966515,1055625.2648777913,2951,0,526.1573033707865,71,107,45,39.1526300654334,0.5476357677902621,44.25636574074074,8250.95471862597,116.2106298398024,8
3088,32.41511171388608,2,2,177,0.0111731843575419,0.0111731843575419,0.9888268156424581,179,5900,4400,1500,0.7457627118644068,74,44,30,199.05672787938965,0.4624827380578746,0.7443068251656868,0.1158857130329726,1062369.0011310976,594.3394331304826,1062963.3405642281,2952,0,520.5474860335196,77,102,42,38.88072044581226,0.5502211359404097,43.97702991452992,8299.013176641447,107.77939190443438,0
3089,32.64239307892987,1,3,175,0.0056179775280898875,0.016853932584269662,0.9831460674157303,178,6550,4900,1650,0.7480916030534351,82,49,33,199.51721390394442,0.46206741044033944,0.7446065248323332,0.1165683728264258,1070934.2639221898,583.9641224054012,1071518.2280445953,2953,0,523.7752808988764,77,101,43,38.73271944458927,0.551439606741573,43.84348290598291,8361.561720712536,108.59171065860437,0
3090,32.31515721855805,1,1,175,0.005681818181818182,0.005681818181818182,0.9943181818181818,176,5050,3500,1550,0.693069306930693,66,35,31,202.92154141053595,0.4614353354978355,0.7449186991869927,0.11885404568331404,1060972.251648363,2808.824939658654,1063781.0765880216,2954,0,530.3238636363636,79,97,45,38.55013550135505,0.5526751893939394,43.75000000000001,8280.759037255515,104.81973464880399,0
3091,32.385054969826555,0,1,174,0.0,0.005714285714285714,0.9942857142857143,175,5500,3900,1600,0.7090909090909091,71,39,32,199.05706625727922,0.4617200328407225,0.7385396376848181,0.1171581194541278,1064771.0505278348,1890.0403107501993,1066661.090838585,2955,1,531.8,68,107,45,38.4643971505946,0.5542261904761905,43.56884057971013,8304.537193802398,122.12554696768233,0
3092,32.0231608782804,2,0,176,0.011363636363636364,0.0,1.0,176,5000,3600,1400,0.72,64,36,28,195.86236598259467,0.46192370129870125,0.7360815262003986,0.11617626033774298,1055241.4995005871,1136.4193550409032,1056377.918855628,2956,0,529.3238636363636,70,106,42,38.2523478873776,0.5564630681818181,43.28051643192486,8220.969322889474,117.44241889842105,0
3093,32.28366350955734,3,2,177,0.01675977653631285,0.0111731843575419,0.9888268156424581,179,5100,3800,1300,0.7450980392156863,64,38,26,190.1610120696019,0.46316536940556147,0.7288229610597801,0.11106682009989995,1059067.0074503454,-621.3492027433713,1058445.6582476022,2957,0,521.4357541899441,88,91,41,38.984464244916644,0.5524324953445066,43.855337078651694,8269.288107521821,93.9691830400207,8
3094,32.60768431488545,1,1,177,0.0056179775280898875,0.0056179775280898875,0.9943820224719101,178,5250,3700,1550,0.7047619047619048,68,37,31,190.82933725487283,0.4632550149177934,0.7280528058833944,0.11189621100616981,1070924.6936844715,22.769909136980004,1070947.4635936085,2958,0,524.8089887640449,74,104,44,38.81753644393863,0.554248595505618,43.70833333333333,8357.077759202508,112.93348323246633,0
3095,32.76807748433656,4,2,179,0.022099447513812154,0.011049723756906077,0.988950276243094,181,6150,4300,1850,0.6991869918699187,80,43,37,193.09483145382154,0.4640999079189687,0.7370471392598923,0.11479100642673135,1080484.3381413233,-622.811767621447,1079861.5263737019,2959,0,517.0773480662983,82,99,46,38.23907324145569,0.5572628913443831,43.19779116465863,8414.914677265237,102.62091069835654,0
3096,32.90094719003658,2,3,178,0.011049723756906077,0.016574585635359115,0.9834254143646409,181,6050,4600,1450,0.7603305785123967,75,46,29,209.54020881469756,0.46443242275424595,0.7494724306563778,0.1229531847758471,1080775.2712951074,3043.175205788006,1083818.4465008955,2960,0,515.414364640884,76,105,35,38.31147411199664,0.5537523020257826,43.682359307359334,8433.09316030341,110.96175210925539,8
3097,32.59852764598088,0,3,175,0.0,0.016853932584269662,0.9831460674157303,178,6150,4200,1950,0.6829268292682927,81,42,39,216.9283343616964,0.4636881334772213,0.7571385399967023,0.1252843274281658,1065870.108012946,4493.485435434281,1070363.5934483805,2961,1,524.9044943820224,72,106,41,38.73063259118727,0.5455290262172285,44.27796803652971,8336.16172864765,115.78002400899514,8
3098,32.070226068265804,2,1,176,0.011299435028248588,0.005649717514124294,0.9943502824858758,177,5300,3900,1400,0.7358490566037735,67,39,28,196.10877223570574,0.4633731381612738,0.7369380583056253,0.11004491127358537,1039610.4659711705,75.34641699903659,1039685.8123881695,2962,0,528.7457627118644,81,96,40,40.38261657686421,0.5379001883239172,45.37601626016259,8165.848720938988,100.81294717208627,8
3099,31.69294226265961,8,2,182,0.043478260869565216,0.010869565217391304,0.9891304347826086,184,5950,4700,1250,0.7899159663865546,72,47,25,184.22872972879517,0.4652103379662628,0.7285022132986285,0.10417744872637179,1029767.7549959979,-4807.438916282927,1024960.3160797149,2963,0,509.57608695652175,82,102,41,40.38396842588944,0.5383265398550725,45.08032128514055,8079.154659125748,98.5262763308018,8
3100,31.936189837821733,3,0,185,0.016216216216216217,0.0,1.0,185,6150,4600,1550,0.7479674796747967,77,46,31,175.0937109537687,0.46599588719153934,0.7150579150579128,0.09976269577598482,1040022.6752469931,-6729.714062987427,1033292.9611840056,2964,0,507.2432432432432,79,106,46,40.32312925170065,0.5412162162162162,44.79166666666668,8150.381781527457,103.16938963958806,0
3101,31.621587127384785,1,2,184,0.005376344086021506,0.010752688172043012,0.989247311827957,186,5200,3500,1700,0.6730769230769231,69,35,34,175.52861663978493,0.4659970454325293,0.7173325168452864,0.10056642328037964,1031479.4215874268,-6189.168807270771,1025290.252780156,2965,0,505.51075268817203,83,103,46,40.09751622404557,0.5432347670250897,44.58085317460317,8076.758805341564,97.310347052308,0
3102,31.610910166445365,1,1,184,0.005405405405405406,0.005405405405405406,0.9945945945945946,185,6000,4100,1900,0.6833333333333333,79,41,38,173.00303658943034,0.4656078632980807,0.7138410353213078,0.09972413225454903,1032991.941519345,-7257.851468948151,1025734.0900503969,2966,0,506.97297297297297,84,101,44,39.92767604621061,0.5454954954954955,44.35049019607845,8081.313688507604,96.20611533937624,0
3103,31.462774190943453,3,2,185,0.016042780748663103,0.0106951871657754,0.9893048128342246,187,5750,4400,1350,0.7652173913043478,71,44,27,171.609917917468,0.4656599198819313,0.7150589487337231,0.09970153254567511,1030534.816036909,-7780.000961762382,1022754.8150751466,2967,0,502.45454545454544,88,99,41,39.66202518139141,0.5479055258467023,44.05430711610489,8052.761540350605,91.50865386762051,0
3104,31.528154293110898,1,1,185,0.005376344086021506,0.005376344086021506,0.9946236559139785,186,5750,4300,1450,0.7478260869565218,72,43,29,171.17460207185982,0.4651288385159353,0.7117754814105732,0.09995310271294272,1034208.7493595441,-7543.9457738285255,1026664.8035857156,2968,0,505.9569892473118,90,96,43,39.48007910260998,0.5501792114695341,43.86446886446889,8075.4805455890055,89.72756161765561,0
3105,31.658967415795157,3,1,187,0.015957446808510637,0.005319148936170213,0.9946808510638298,188,4900,3400,1500,0.6938775510204082,64,34,30,170.70876621841438,0.4654516061743847,0.7149592394203887,0.10047027149926764,1040889.3243722628,-6962.213533298402,1033927.1108389645,2969,0,500.50531914893617,80,108,46,39.192473253092594,0.5520833333333333,43.56995884773663,8118.310317270528,101.47887896588159,0
3106,32.132642362584704,1,2,186,0.005319148936170213,0.010638297872340425,0.9893617021276596,188,6100,4500,1600,0.7377049180327869,77,45,32,171.72519988162247,0.4651801968369553,0.7178708321848164,0.10184514246386162,1058806.8967888092,-7335.234802580272,1051471.661986229,2970,0,501.468085106383,82,106,42,38.87721013607104,0.5542996453900709,43.28564257028113,8248.910636629902,100.59647117841344,0
3107,32.23686443042075,1,3,184,0.0053475935828877,0.016042780748663103,0.983957219251337,187,6050,4400,1650,0.7272727272727273,77,44,33,172.7610980417543,0.46495313667989185,0.7189989186447934,0.102973866882266,1063773.9435221793,-6694.249089780242,1057079.694432399,2971,0,504.6417112299465,84,103,39,38.66226605606705,0.5559269162210339,43.10049019607843,8281.634669790568,98.5908889260782,0
3108,32.388269420724676,3,1,186,0.016042780748663103,0.0053475935828877,0.9946524064171123,187,5850,4200,1650,0.717948717948718,75,42,33,189.38712468760608,0.4650561593161214,0.7344756660717564,0.11388291949849262,1071469.5102521104,-2665.494052582907,1068804.0161995275,2972,0,503.83957219251334,91,96,43,37.90478181764827,0.55899064171123,42.77626811594204,8331.031529665146,91.54979702928732,0
3109,32.60818885640357,2,1,187,0.010638297872340425,0.005319148936170213,0.9946808510638298,188,6650,5000,1650,0.7518796992481203,83,50,33,186.5193705784011,0.4653959020745629,0.7306530752786908,0.11290131696643574,1080771.8319259172,-3933.0236340626307,1076838.8082918546,2973,0,499.71276595744683,77,111,42,37.7324960665318,0.5609485815602837,42.53472222222221,8395.476401744145,109.03216106161227,0
3110,32.9332787243116,1,1,187,0.005319148936170213,0.005319148936170213,0.9946808510638298,188,6300,4400,1900,0.6984126984126984,82,44,38,191.21971512810572,0.46540419842985553,0.737670824923067,0.11621387223759119,1092792.6312940326,-2107.300869972657,1090685.3304240599,2974,0,500.68617021276594,77,111,46,37.461767755313645,0.5625,42.3878205128205,8484.013709828632,110.18199623154068,0
3111,32.445352922082925,0,1,186,0.0,0.0053475935828877,0.9946524064171123,187,5600,3600,2000,0.6428571428571429,76,36,40,211.84480137484135,0.4650561593161214,0.7694448067475308,0.12408052651955095,1065246.841055115,2133.4010917000096,1067380.242146815,2975,1,503.88770053475935,84,103,41,38.32147696476968,0.5503565062388591,43.75000000000003,8314.121686283825,98.97763912242648,8
3112,32.05009252812398,1,2,185,0.0053475935828877,0.0106951871657754,0.9893048128342246,187,5850,4400,1450,0.7521367521367521,73,44,29,212.5580575698723,0.4648561037318153,0.7670919789666482,0.12526290251674999,1054145.5515256256,1563.4261656415783,1055708.9776912672,2976,0,504.8663101604278,72,115,41,38.0700363488001,0.5520276292335116,43.521689497716885,8220.153583055062,114.16879976465364,0
3113,32.13865622538288,1,1,185,0.005376344086021506,0.005376344086021506,0.9946236559139785,186,5200,3800,1400,0.7307692307692307,66,38,28,179.90755900064806,0.4651833284897801,0.7300874237021497,0.10513854752305074,1054487.2399625569,-4457.954932200953,1050029.285030356,2977,0,507.13440860215053,86,100,41,39.22518890706553,0.5482750896057348,43.83381226053642,8232.837044325568,95.73066330611125,8
3114,32.023075129025344,3,2,186,0.015957446808510637,0.010638297872340425,0.9893617021276596,188,5550,3700,1850,0.6666666666666666,74,37,37,183.8167956371824,0.465152937383851,0.737066917557208,0.10855531696851778,1053904.6267912558,-4404.9257192064415,1049499.7010720493,2978,0,502.65425531914894,77,111,42,38.72689041000816,0.5510859929078014,43.44284188034185,8215.749149354977,106.69804090071399,0
3115,31.634388970756984,3,2,187,0.015873015873015872,0.010582010582010581,0.9894179894179894,189,5700,4200,1500,0.7368421052631579,72,42,30,190.02875360402885,0.4654302225224211,0.745122315754962,0.11198227103299689,1040462.4378815528,-3956.4439515119197,1036505.993930041,2979,0,500.3492063492063,77,112,42,38.64916905319792,0.5498787477954145,43.52297008547008,8113.4941263807,105.37005358935974,8
3116,31.633775667517842,0,2,185,0.0,0.0106951871657754,0.9893048128342246,187,5750,3900,1850,0.6782608695652174,76,39,37,189.09405508409063,0.46474229965691066,0.7400321003998962,0.11181888198090142,1041489.0097779065,-3762.12396311653,1037726.8858147899,2980,1,506.63101604278074,78,109,41,38.5417201925218,0.5516377005347594,43.39398734177213,8117.417039366571,104.06944922264834,0
3117,31.294486636484528,2,0,187,0.0106951871657754,0.0,1.0,187,5500,3800,1700,0.6909090909090909,72,38,34,188.39044192796112,0.4648716769210128,0.7389610500278514,0.11201199144088833,1031941.4426220789,-4018.4191161298636,1027923.0235059491,2981,0,507.32085561497325,83,104,44,38.35394635182776,0.5543114973262032,43.191964285714285,8036.675641802544,96.82741737111499,0
3118,31.3036784786666,3,1,189,0.015789473684210527,0.005263157894736842,0.9947368421052631,190,7600,5600,2000,0.7368421052631579,96,56,40,186.51835079825148,0.46551099972152604,0.7415964121693011,0.11186518287433214,1034816.8147068482,-6997.534868515808,1027819.2798383324,2982,0,500.29473684210524,88,102,43,38.07628552354074,0.5572368421052631,42.872191011235955,8049.046260508271,91.46643477850309,0
3119,31.5202926528077,0,1,188,0.0,0.005291005291005291,0.9947089947089947,189,5250,3600,1650,0.6857142857142857,69,36,33,208.09630766714665,0.4652531520882585,0.7662116564779327,0.12167811646052083,1034362.271370969,-0.6061074994881892,1034361.6652634696,2983,1,503.5132275132275,81,108,41,38.48237012611363,0.5483906525573192,43.813516260162615,8075.072941173469,99.6922585330058,8
3120,31.721647119722775,0,0,188,0.0,0.0,1.0,188,6100,4800,1300,0.7868852459016393,74,48,26,209.99692067977068,0.46490404672507296,0.7676695224229904,0.12339680647002986,1042468.0645643292,83.01669310184116,1042551.0812574311,2984,2,507.0851063829787,68,120,40,38.245519766026774,0.5504210992907801,43.62922705314009,8132.503191230852,119.59563516515959,0
3121,32.11471599487461,1,1,188,0.005291005291005291,0.005291005291005291,0.9947089947089947,189,6500,4800,1700,0.7384615384615385,82,48,34,212.28003889436746,0.4648708675747683,0.7712835880053366,0.12568464918678876,1057700.405035591,605.7366239087273,1058306.1416594996,2985,0,505.3968253968254,69,120,41,37.900009180340554,0.5526895943562611,43.348214285714285,8242.299207791699,119.45361170712607,0
3122,32.39949784726679,1,2,187,0.005291005291005291,0.010582010582010581,0.9894179894179894,189,5900,4100,1800,0.6949152542372882,77,41,36,210.57529033861795,0.4643642819617997,0.7698641683521705,0.12569788586792444,1069592.7990417455,1345.9628404620762,1070938.7618822076,2986,0,506.37566137566137,73,116,42,37.635358460246174,0.5550044091710759,43.04617117117117,8325.175023986589,114.04349347926834,0
3123,32.36025196610041,0,0,187,0.0,0.0,1.0,187,5250,3700,1550,0.7047619047619048,68,37,31,209.21965948986562,0.46360785272075594,0.7660417254691849,0.12530101447481562,1069306.7765769905,2093.9999371284894,1071400.776514119,2987,1,512.4171122994652,76,111,42,37.546264624883776,0.5564839572192513,42.924783549783534,8319.018778568765,109.4607734022206,0
3124,32.53693437777718,2,1,188,0.010582010582010581,0.005291005291005291,0.9947089947089947,189,5550,4000,1550,0.7207207207207207,71,40,31,206.47112372286628,0.46394916319561713,0.7656185906921906,0.12449353554651009,1077220.555218961,1132.9877066860822,1078353.5429256472,2988,0,507.984126984127,65,124,47,37.36378598298986,0.5584766313932981,42.6767676767677,8372.50912397858,128.80783267659353,0
3125,32.39079227599334,2,2,188,0.010526315789473684,0.010526315789473684,0.9894736842105263,190,6000,4400,1600,0.7333333333333333,76,44,32,204.67925128491638,0.4640252250997865,0.7641796155590295,0.12422741750878603,1074384.8945160932,-19.140839724214402,1074365.753676369,2989,0,506.13684210526316,68,122,47,37.16480569720417,0.5604714912280702,42.43659420289857,8342.682775071335,122.68651139810787,0
3126,31.873864567299183,1,5,184,0.005291005291005291,0.026455026455026454,0.9735449735449735,189,6250,4300,1950,0.688,82,43,39,200.4811095926035,0.46402890352358434,0.759855111981274,0.11940765182209558,1051571.0506823284,-1885.9737887493925,1049685.076893579,2990,0,508.8624338624339,71,118,38,37.97809302543881,0.554783950617284,43.12789351851851,8187.506733107581,115.31699624095184,8
3127,32.07891990153016,1,1,184,0.005405405405405406,0.005405405405405406,0.9945945945945946,185,5600,4100,1500,0.7321428571428571,71,41,30,203.89216775824914,0.46246572659616136,0.7603033508112602,0.12207103363791504,1059912.6807824236,621.5788238371547,1060534.2596062608,2991,0,520.7513513513513,72,113,40,37.695323341659716,0.5565315315315316,42.936643835616444,8246.314812015793,114.53215016688601,0
3128,31.617506699274042,0,1,183,0.0,0.005434782608695652,0.9945652173913043,184,5300,3900,1400,0.7358490566037735,67,39,28,235.60523616061352,0.462212050566247,0.7891411625875451,0.1407183273658238,1043946.2735846523,7091.841665381072,1051038.1152500333,2992,1,524.429347826087,68,116,35,36.9709052990248,0.5539515398550725,43.02536231884059,8124.897328427609,119.48378424158248,8
3129,31.6222256309236,1,0,184,0.005434782608695652,0.0,1.0,184,5300,3900,1400,0.7358490566037735,67,39,28,255.8001189767993,0.4623110447849845,0.8020943796394489,0.14982578397212545,1038221.9001090361,11015.457114442052,1049237.3572234781,2993,0,525.2065217391304,67,117,39,37.19512195121953,0.5476109601449275,43.75000000000001,8103.195317924185,120.94321370036096,7
3130,31.766820034460945,3,1,186,0.016042780748663103,0.0053475935828877,0.9946524064171123,187,5350,3400,1950,0.6355140186915887,73,34,39,247.43546431749763,0.4634724857685009,0.7996351924830807,0.13893107872809302,1029964.7514000741,8219.961298666622,1038184.7126987408,2994,0,517.7647058823529,64,123,36,39.05168344870986,0.5260695187165776,45.352564102564095,8089.339268390764,126.39592606860569,8
3131,31.90992041846509,4,1,189,0.021052631578947368,0.005263157894736842,0.9947368421052631,190,5800,4200,1600,0.7241379310344828,74,42,32,245.80572162431457,0.4643541724682076,0.8033214818635668,0.1396156951651426,1038197.9353068414,7238.998535394433,1045436.9338422358,2995,0,506.91052631578947,69,121,36,38.64047369035118,0.5294956140350877,44.91071428571429,8139.878806745974,117.96925806878222,0
3132,32.11901014923001,1,2,188,0.005263157894736842,0.010526315789473684,0.9894736842105263,190,6600,5000,1600,0.7575757575757576,82,50,32,242.25141941327593,0.4649035783904205,0.8005177626739204,0.13852334510465497,1047096.4507118625,6132.120289510625,1053228.5710013732,2996,0,507.37894736842105,60,130,38,38.469287099578665,0.5319627192982457,44.65505464480876,8201.426891418,136.69044819029997,0
3133,32.1988540289639,2,2,188,0.010526315789473684,0.010526315789473684,0.9894736842105263,190,5800,4300,1500,0.7413793103448276,73,43,30,238.77156343637967,0.46545240415854455,0.7975920593100898,0.13765421006164505,1052248.2023165587,6449.389678049235,1058697.5919946078,2997,0,507.0684210526316,62,128,39,38.24092937524253,0.534375,44.345238095238116,8231.790360380995,132.7708122642096,0
3134,31.843497828289372,1,1,188,0.005291005291005291,0.005291005291005291,0.9947089947089947,189,5650,4100,1550,0.7256637168141593,72,41,31,233.6482038451977,0.46552755262861645,0.7918033482499873,0.13536230823197526,1042140.954568974,5248.872437712298,1047389.8270066862,2998,0,510.0899470899471,65,124,33,38.18270614846805,0.5368716931216931,44.16035353535355,8146.829226587316,125.33583425518948,0
3135,31.829916495437004,2,3,187,0.010526315789473684,0.015789473684210527,0.9842105263157894,190,6350,4300,2050,0.6771653543307087,84,43,41,263.34933575727655,0.4661416272161886,0.8157380512278849,0.14731225029731274,1030837.6006715217,9944.079482094076,1040781.6801536158,2999,0,508.12631578947367,61,129,35,38.79500044010212,0.5235197368421053,45.49731182795699,8100.799312380377,132.79998872754717,8
3136,31.877287596145354,5,3,189,0.026041666666666668,0.015625,0.984375,192,5050,3800,1250,0.7524752475247525,63,38,25,253.54591436668494,0.4667480184700407,0.8088595115925503,0.14216307022538213,1033109.2698193899,8938.12689141114,1042047.396710801,3000,0,503.7760416666667,60,132,36,38.95130458112552,0.5221354166666667,45.40642076502733,8115.752745405255,135.26254575675426,8
3137,32.091307572487274,3,1,191,0.015625,0.005208333333333333,0.9947916666666666,192,5100,3200,1900,0.6274509803921569,70,32,38,242.02236470467028,0.4676069844386271,0.800057361076187,0.13691649280661097,1042844.1339336074,6978.320662601179,1049822.4545962086,3001,0,504.203125,64,128,36,38.894083689548225,0.5252821180555556,45.06410256410257,8181.226295883467,127.83166087317917,0
3138,31.811401409894653,5,3,193,0.025510204081632654,0.015306122448979591,0.9846938775510204,196,6400,4200,2200,0.65625,86,42,44,233.9779036219386,0.46815639717425434,0.79786543027371,0.13444243867574063,1038562.5878252467,3000.139415905214,1041562.727241152,3002,0,494.88775510204084,64,132,42,38.49234347235288,0.5289647108843538,44.47115384615384,8128.730696807199,127.01141713761248,0
3139,31.34369619058656,2,2,193,0.010256410256410256,0.010256410256410256,0.9897435897435898,195,6500,4700,1800,0.7230769230769231,83,47,36,231.42076207823538,0.4679993832055687,0.7947608798845995,0.13351690078976228,1024529.8972250072,1919.497917549409,1026449.3951425566,3003,0,496.9076923076923,67,128,40,38.39974886665468,0.5316239316239316,44.31678921568627,8014.056879857225,119.61278925160038,0
3140,31.344222386531364,1,2,192,0.005154639175257732,0.010309278350515464,0.9896907216494846,194,5450,4200,1250,0.7706422018348624,67,42,25,228.6457928617749,0.46819580951872225,0.7912198763126415,0.13259913687211508,1026108.5787125429,2673.0819083995952,1028781.6606209425,3004,0,497.5618556701031,69,125,36,38.271481535330004,0.533666237113402,44.1220238095238,8020.2961895298495,116.23617665985289,0
3141,30.883121747843614,1,1,192,0.0051813471502590676,0.0051813471502590676,0.9948186528497409,193,5450,3200,2250,0.5871559633027523,77,32,45,226.35794311979367,0.4683305897380541,0.7885553701589536,0.13196757553426672,1012582.1601419642,1791.2030019063477,1014373.3631438706,3005,0,495.8238341968912,71,122,38,38.12711864406778,0.5364313471502591,43.9236111111111,7908.438294803679,111.38645485638985,0
3142,31.342805244399308,2,1,193,0.010309278350515464,0.005154639175257732,0.9948453608247423,194,6600,4800,1800,0.7272727272727273,84,48,36,231.3538877486785,0.46860922671509714,0.7950945846182857,0.13598083730661045,1030094.0073914478,2263.250671325148,1032357.2580627729,3006,0,494.2474226804124,63,131,39,37.6883358726934,0.5388745704467354,43.619791666666636,8035.674938310125,127.55039584619246,0
3143,31.564144488930143,2,0,195,0.010256410256410256,0.0,1.0,195,6500,4400,2100,0.676923076923077,86,44,42,236.9194848880165,0.46874724645343196,0.8001532501809197,0.1403650849811953,1039764.5680157078,3768.097171818513,1043532.6651875263,3007,0,492.6820512820513,65,130,38,37.24270583533174,0.5411324786324787,43.32386363636363,8101.76265504215,124.64250238526385,0
3144,31.25801199104267,1,1,195,0.00510204081632653,0.00510204081632653,0.9948979591836735,196,6300,4900,1400,0.7777777777777778,77,49,28,235.3761022959783,0.4689407814407815,0.800927469354177,0.14035145441040503,1031591.4853643174,3062.39659735432,1034653.8819616718,3008,0,491.16326530612247,68,128,37,37.038601284914,0.5432610544217686,43.08574879227053,8030.628744920952,118.09748154295518,0
3145,31.058560599921247,1,1,195,0.00510204081632653,0.00510204081632653,0.9948979591836735,196,7100,5400,1700,0.7605633802816901,88,54,34,210.96944106738465,0.4687783446712018,0.7775058717297227,0.1246744304722274,1022360.6518849939,-3162.62894050729,1019198.0229444866,3009,0,491.7908163265306,68,128,40,38.00477563348235,0.5423044217687074,43.417874396135254,7969.071496924216,117.19222789594436,8
3146,31.60335340051358,0,0,195,0.0,0.0,1.0,195,5800,4100,1700,0.7068965517241379,75,41,34,220.35244087813126,0.46834743149176133,0.7878240068497693,0.12721174866064758,1033210.8264113071,734.105508288585,1033944.9319195957,3010,1,495.3025641025641,70,125,39,38.658270698261525,0.5364850427350427,44.292840375586856,8081.203732651867,115.44576760931238,8
3147,31.136615553025063,5,3,197,0.025,0.015,0.985,200,5600,4100,1500,0.7321428571428571,71,41,30,214.08398721249225,0.4698513400335009,0.7872877478393474,0.12495644001393925,1021239.6980577179,-1873.7867080241017,1019365.9113496938,3011,0,483.895,79,121,38,38.39709371293001,0.5393749999999999,43.88020833333336,7974.703488645932,100.94561378032826,0
3148,31.221686584703598,0,1,196,0.0,0.005076142131979695,0.9949238578680203,197,6750,4700,2050,0.6962962962962963,88,47,41,220.2571892328644,0.4692981888186747,0.790852518264505,0.12877761844114774,1024537.2339912417,-1017.6617153348316,1023519.5722759068,3012,1,491.98984771573606,77,120,38,38.174153764617984,0.5407677664974619,43.81677350427352,7998.472405907749,103.87626501178895,0
3149,31.087819667324723,5,0,201,0.024875621890547265,0.0,1.0,201,6400,4600,1800,0.71875,82,46,36,216.62484796402026,0.47014614427860696,0.7902305240530734,0.12834808185694283,1024089.32668386,-2231.3610611066656,1021857.9656227534,3013,0,482.9800995024876,72,129,41,37.76163275517011,0.5440505804311775,43.32191780821917,7979.561931732811,110.8272490518446,0
3150,31.55626930794182,1,1,201,0.0049504950495049506,0.0049504950495049506,0.995049504950495,202,6400,4800,1600,0.75,80,48,32,216.4428285957855,0.4701651601727337,0.7910081577562378,0.12882771899651957,1040891.3621864908,-1741.3058614870333,1039150.0563250037,3014,0,481.58415841584156,74,128,41,37.59350384830292,0.5460499174917492,43.15277777777778,8105.140115441231,109.52892047893555,0
3151,31.399145793498164,0,2,199,0.0,0.009950248756218905,0.9900497512437811,201,5600,3800,1800,0.6785714285714286,74,38,36,213.15777229760394,0.47018345771144276,0.7871000077169139,0.12735092866718015,1036829.0157793356,-1598.3673485918898,1035230.6484307437,3015,1,484.53731343283584,74,127,35,37.53603019330199,0.5475746268656716,43.01388888888889,8069.144369681908,109.04249148218794,0
3152,31.445331425245907,3,4,198,0.01485148514851485,0.019801980198019802,0.9801980198019802,202,6700,4500,2200,0.6716417910447762,89,45,44,209.07254949400294,0.47000404331477924,0.7856109706469185,0.12581403801196062,1040496.4475482627,-3592.1509943264464,1036904.2965539362,3016,0,483.0495049504951,76,126,40,37.370503786285234,0.5498659240924093,42.74891774891775,8089.34554088847,106.43875711695355,0
3153,31.300361887180905,1,1,198,0.005025125628140704,0.005025125628140704,0.9949748743718593,199,6100,4300,1800,0.7049180327868853,79,43,36,210.44072908931508,0.4699708559633183,0.7837174791209016,0.12711126550972152,1036800.8580611913,-2262.974301835035,1034537.8837593562,3017,0,488.8743718592965,64,135,41,37.195691426436746,0.5514551926298157,42.612179487179496,8056.331927404064,125.8801863656885,0
3154,31.472465506976853,0,2,196,0.0,0.010101010101010102,0.98989898989899,198,6950,5200,1750,0.7482014388489209,87,52,35,206.82985333980403,0.46943899656463106,0.7789908225378865,0.1255847315901688,1044046.8761124697,-3361.9875467553857,1040684.8885657144,3018,1,492.2676767676768,68,130,43,37.094005196733484,0.5529776936026936,42.42149758454107,8106.630532609306,119.21515489131332,0
3155,31.738290721067678,2,2,196,0.010101010101010102,0.010101010101010102,0.98989898989899,198,6250,4800,1450,0.768,77,48,29,245.99843301472794,0.469816075304654,0.8130831907266947,0.14362703626355156,1041064.5708931438,5370.050621372773,1046434.6215145165,3019,0,492.33838383838383,69,129,35,37.56826632581919,0.5378261784511784,43.86904761904762,8129.158629330613,117.81389317870453,8
3156,31.402476081531372,1,1,196,0.005076142131979695,0.005076142131979695,0.9949238578680203,197,6550,4800,1750,0.732824427480916,83,48,35,250.03670669597912,0.46933595773334713,0.8146021785941,0.14658625354432236,1031286.5006778028,5621.896057899609,1036908.3967357024,3020,0,495.51269035532994,59,138,36,37.30721898568398,0.5394458544839256,43.71527777777777,8047.97485964523,136.40635355330897,0
3157,31.122169769013386,1,1,196,0.005076142131979695,0.005076142131979695,0.9949238578680203,197,5550,3900,1650,0.7027027027027027,72,39,33,249.19869620671741,0.46912013536379016,0.8137674087810463,0.1466960729492855,1023302.6462101574,6051.137052090939,1029353.7832622484,3021,0,496.48730964467006,60,137,37,37.171760893209914,0.5408206429780034,43.56215846994535,7980.902039297705,133.0150339882951,0
3158,31.348535570105266,2,3,195,0.010101010101010102,0.015151515151515152,0.9848484848484849,198,6700,4800,1900,0.7164179104477612,86,48,38,246.73440806091418,0.4698251551043429,0.8097575554947671,0.1412136652334861,1022251.9808624509,4144.9474774390665,1026396.92833989,3022,0,494.77272727272725,60,138,38,38.319820572829606,0.5339856902356903,44.62090163934429,8005.7607488204785,133.42934581367464,7
3159,31.554741993958476,0,2,193,0.0,0.010256410256410256,0.9897435897435898,195,5850,4400,1450,0.7521367521367521,73,44,29,249.08243749582005,0.4696735395189004,0.8076237878373111,0.14315987621784665,1030265.3449049316,6474.2006752784455,1036739.54558021,3023,1,502.24615384615385,62,133,40,38.0959506092958,0.535309829059829,44.460978835978835,8063.467882219381,130.05593358418358,0
3160,31.35891488935246,2,0,195,0.010256410256410256,0.0,1.0,195,5450,4200,1250,0.7706422018348624,67,42,25,244.74625389675757,0.4700755573178254,0.8052868756363667,0.1418888413113888,1026488.5307749144,5795.844515029553,1032284.375289944,3024,0,502.87179487179486,64,131,35,37.87240594596852,0.5379273504273504,44.1346153846154,8023.660819285315,125.36970030133304,0
3161,30.901936131894594,5,1,199,0.025,0.005,0.995,200,7550,5800,1750,0.7682119205298014,93,58,35,241.1876418735325,0.4713997068676717,0.8067560910664362,0.14230639262467415,1016738.0438907556,1494.9302418238412,1018232.9741325795,3025,0,491.275,60,140,40,37.289752806994166,0.5420833333333333,43.47677595628415,7927.064285746591,132.1177380957765,0
3162,30.972023747264167,2,3,198,0.009950248756218905,0.014925373134328358,0.9850746268656716,201,6300,4500,1800,0.7142857142857143,81,45,36,221.10870358992304,0.4717661691542288,0.7926796004843659,0.12757185174889404,1012391.4557670373,-1730.2875379669913,1010661.1682290704,3026,0,489.70646766169153,69,132,44,38.66206883172312,0.5365878938640133,44.3154761904762,7919.067143236516,114.76908903241328,8
3163,30.655765744622038,2,4,196,0.01,0.02,0.98,200,5800,3800,2000,0.6551724137931034,78,38,40,220.43461450288865,0.4718404522613065,0.7905192414947004,0.12774378274197834,1003354.8768010729,-1565.170904552222,1001789.7058965206,3027,0,492.345,72,128,38,38.50971370143146,0.5383333333333333,44.149543378995446,7843.29166382813,108.93460644205737,0
3164,31.132788715037503,1,1,196,0.005076142131979695,0.005076142131979695,0.9949238578680203,197,5700,4200,1500,0.7368421052631579,72,42,30,222.73545075052135,0.47106145757795503,0.7907433840966134,0.1301161154833789,1021366.7445987161,398.91644795774573,1021765.6610466739,3028,0,499.507614213198,73,124,42,38.14313485739408,0.5407677664974619,43.84853603603605,7974.709406637667,109.24259461147489,0
3165,31.234146636155636,1,1,196,0.005076142131979695,0.005076142131979695,0.9949238578680203,197,6250,4700,1550,0.752,78,47,31,225.72824921519316,0.4713182861977278,0.7925462523817806,0.13251003841001147,1026152.9466707754,676.3416158010268,1026829.2882865764,3029,0,500.28426395939084,61,136,41,37.8798119988639,0.5429357021996616,43.665994623655905,8006.373911757823,131.25203134029218,0
3166,30.77697209116134,1,2,195,0.005076142131979695,0.01015228426395939,0.9898477157360406,197,6250,4400,1850,0.704,81,44,37,222.02639020772145,0.471347422217618,0.790264801928874,0.13088925640628724,1012376.3829372872,-695.1452329767849,1011681.2377043104,3030,0,501.24365482233503,68,129,37,37.81366490092212,0.5449978849407784,43.508454106280205,7894.033149589866,116.08872278808627,8
3167,31.093400454905815,3,1,197,0.015151515151515152,0.005050505050505051,0.9949494949494949,198,5450,3800,1650,0.6972477064220184,71,38,33,219.1840446542597,0.47134415218171566,0.7878242372183932,0.13009104427103926,1024788.7890362309,-126.5296605396561,1024662.2593756912,3031,0,499.57575757575756,73,125,41,37.62992991209313,0.5470328282828283,43.25731981981981,7983.002968708136,109.35620505079639,0
3168,30.963212561503248,1,2,196,0.005050505050505051,0.010101010101010102,0.98989898989899,198,6200,4300,1900,0.6935483870967742,81,43,38,216.14969259134324,0.47119406843391615,0.7851302972957477,0.1287500342826694,1021550.1619339216,-1638.4493062692964,1019911.7126276523,3032,0,490.04040404040404,74,124,34,37.572654771559876,0.549084595959596,43.12499999999999,7953.67522673613,107.48209765859635,0
3169,30.76490533032462,1,3,194,0.005076142131979695,0.015228426395939087,0.9847715736040609,197,5550,4000,1550,0.7207207207207207,71,40,31,217.31980862448918,0.4712136123484927,0.7863072987540787,0.13014209229121596,1016567.8834011032,-765.9324250945156,1015801.9509760087,3033,0,493.1928934010152,75,122,36,37.34093978815665,0.5504970389170897,42.927631578947334,7908.807077515939,105.45076103354586,0
3170,31.2991693618401,3,1,196,0.015228426395939087,0.005076142131979695,0.9949238578680203,197,6350,4100,2250,0.6456692913385826,86,41,45,221.3612861495041,0.47108196070306296,0.7915985493933524,0.13375392166026193,1036863.485300189,154.28693350121011,1037017.7722336903,3034,0,494.1218274111675,66,131,40,36.901651969074635,0.5520833333333333,42.59950248756217,8056.421765463657,122.06699644641904,0
3171,31.5247494524097,1,0,197,0.005076142131979695,0.0,1.0,197,6850,4900,1950,0.7153284671532847,88,49,39,220.6851897421654,0.4710312424462171,0.7913419348761044,0.1338441345579104,1045442.4225160012,-107.26812450957004,1045335.1543914916,3035,0,495.0913705583756,67,130,41,36.77978031564754,0.553669627749577,42.46323529411764,8118.78198213711,121.17585047965837,0
3172,31.89871235727937,0,0,197,0.0,0.0,1.0,197,5900,4100,1800,0.6949152542372882,77,41,36,219.401621037823,0.47084023964915916,0.7905717059411634,0.13328965532413375,1058347.4375409416,1140.6286835416668,1059488.0662244833,3036,1,496.0913705583756,67,130,44,36.7502180463051,0.5550444162436547,42.401960784313715,8217.045756740326,122.6424739811989,0
3173,31.53488506145918,2,4,195,0.010050251256281407,0.020100502512562814,0.9798994974874372,199,6550,4900,1650,0.7480916030534351,82,49,33,219.61176018357784,0.4706021690946314,0.7934713384899463,0.13461557684892966,1048913.8856847342,-279.23505675585784,1048634.6506279784,3037,0,492.09547738693465,70,129,38,36.413182593856654,0.5575272194304858,42.0774647887324,8133.557502647495,116.19367860924993,0
3174,31.249343179608218,1,2,194,0.00510204081632653,0.01020408163265306,0.9897959183673469,196,6250,4500,1750,0.72,80,45,35,226.42514824564387,0.469943746729461,0.7967790021577643,0.13957251675440388,1041048.6751567528,1693.9201206596226,1042742.5952774124,3038,0,500.40816326530614,69,127,39,36.030400860909346,0.5590986394557823,41.874999999999986,8066.236708236342,116.90198127878756,0
3175,31.25270734419101,3,3,194,0.015228426395939087,0.015228426395939087,0.9847715736040609,197,5750,4500,1250,0.782608695652174,70,45,25,222.01756648847572,0.4698938585586519,0.793537818333254,0.13785095711505924,1043262.6181483393,1174.5255379377577,1044437.1436862771,3039,0,496.84263959390864,59,138,40,35.87797319088892,0.561336717428088,41.614583333333314,8075.243809090149,136.86853913712116,0
3176,30.81043952681363,2,2,194,0.01020408163265306,0.01020408163265306,0.9897959183673469,196,4850,3100,1750,0.6391752577319587,66,31,35,219.97150686317136,0.46966030001744286,0.7902759717290695,0.13749353988620375,1030396.3636738883,1281.5681567353022,1031677.9318306235,3040,0,494.2755102040816,60,136,43,35.68738307472213,0.5633503401360545,41.37636612021856,7968.307831857761,132.80513053096269,0
3177,30.49369169880094,1,1,194,0.005128205128205128,0.005128205128205128,0.9948717948717949,195,5200,3200,2000,0.6153846153846154,72,32,40,220.02528654780937,0.4690534408317914,0.7889452529452534,0.13845128575287313,1021683.5799927552,759.2444898194817,1022442.8244825747,3041,0,497.6871794871795,66,129,45,35.44244244244247,0.5648504273504273,41.13805970149254,7893.6562000160975,119.60085151539542,0
3178,30.749592319467986,0,2,192,0.0,0.010309278350515464,0.9896907216494846,194,6150,4400,1750,0.7154471544715447,79,44,35,221.8660079568871,0.4686125652119723,0.7889748702826627,0.14028411189631487,1031617.4485877719,826.1690113677878,1032443.6175991397,3042,1,499.1546391752577,69,125,38,35.22020595162866,0.5667955326460481,40.96726190476192,7965.151093824125,115.43697237426268,0
3179,30.523117993645897,0,3,189,0.0,0.015625,0.984375,192,5850,4100,1750,0.7008547008547008,76,41,35,223.07426422586363,0.46828188627108785,0.7878143875047185,0.1413017039536862,1024521.6372166594,1458.8820811169398,1025980.5192977763,3043,3,505.1302083333333,70,122,39,35.123985466213675,0.5675998263888888,40.90375586854462,7908.425231334939,112.97750330478485,0
3180,30.51027956334372,0,4,185,0.0,0.021164021164021163,0.9788359788359788,189,5950,4300,1650,0.7226890756302521,76,43,33,224.09827284926402,0.46767467822432357,0.7848697403126899,0.14234344234365573,1024862.3646354699,2183.9771646043478,1027046.3418000742,3044,4,503.04761904761904,68,121,41,34.99767021958184,0.5685626102292769,40.80615942028986,7908.076537183706,116.29524319387804,0
3181,30.413811180644792,0,1,184,0.0,0.005405405405405406,0.9945945945945946,185,5750,4200,1550,0.7304347826086957,73,42,31,246.41019619541316,0.46703143360752053,0.7963693723067709,0.14988894718987197,1009444.7769615385,6997.497107905734,1016442.2740694442,2983,5,497.62702702702705,61,124,38,36.00688783827848,0.5545045045045045,42.35551075268819,7835.950847701438,128.45821061805637,8
3182,30.694282962383163,1,1,184,0.005405405405405406,0.005405405405405406,0.9945945945945946,185,6350,4400,1950,0.6929133858267716,83,44,39,242.8832804640128,0.46703755385820606,0.7936360828981242,0.1484953317572537,1020211.6315662975,6208.46956847326,1026420.1011347708,2984,0,498.5891891891892,63,122,43,35.908994066031184,0.5567004504504505,42.17122395833335,7913.869407667866,125.61697472488676,0
3183,31.224358030372432,0,0,184,0.0,0.0,1.0,184,5900,3900,2000,0.6610169491525424,79,39,40,248.0374899880279,0.4667305179377524,0.7947185425335295,0.15247968910066959,1039426.2882761032,8863.337514315474,1048289.6257904187,2985,1,501.8858695652174,67,117,34,35.57300324546821,0.5592164855072463,41.97303921568628,8056.726205018288,120.24964485101923,0
3184,31.47259507880198,3,1,186,0.016042780748663103,0.0053475935828877,0.9946524064171123,187,6550,5300,1250,0.8091603053435115,78,53,25,246.7142609897162,0.46706510072259594,0.798145851493566,0.15363147770288088,1051450.0634406942,7931.545073872133,1059381.6085145664,2986,0,494.8181818181818,59,128,34,35.133110014104375,0.5623328877005347,41.510416666666664,8135.337988338235,137.8870845481057,0
3185,31.857106269675317,0,2,184,0.0,0.010752688172043012,0.989247311827957,186,5400,4000,1400,0.7407407407407407,68,40,28,246.3482724414294,0.46679320449481737,0.796074018504626,0.15403270942174496,1065499.98505819,9896.816121090736,1075396.8011792807,2987,1,498.1666666666667,61,125,38,34.992800225195964,0.5635640681003584,41.36424731182795,8239.386658524552,135.07191243482873,0
3186,31.63135641485316,0,0,184,0.0,0.0,1.0,184,5800,4000,1800,0.6896551724137931,76,40,36,242.7797891071834,0.4663982685911143,0.7906651239678322,0.1524951697507549,1059277.8955729424,8834.252818620078,1068112.1483915625,2988,2,499.8858695652174,64,120,40,34.91882882325015,0.5657269021739131,41.20192307692308,8186.134210632436,127.90834704113182,0
3187,31.545753166303555,1,1,184,0.005405405405405406,0.005405405405405406,0.9945945945945946,185,6250,4700,1550,0.752,78,47,31,240.57405060721018,0.46614766940853897,0.7900915604342977,0.15196201812287558,1058040.5990213342,7657.42252268835,1065698.0215440225,2989,0,498.1783783783784,68,117,34,34.771605657884514,0.5675675675675675,41.0024154589372,8170.273872601209,120.15108636178249,0
3188,31.31559158086354,0,2,182,0.0,0.010869565217391304,0.9891304347826086,184,5400,4000,1400,0.7407407407407407,68,40,28,239.26647422096772,0.4658104904173596,0.7880156156992872,0.15171810232740723,1051423.289603622,8114.068683454054,1059537.358287076,2990,1,501.79347826086956,68,116,36,34.666351102048736,0.5687839673913043,40.86654589371981,8114.917413730723,119.33702079015768,0
3189,30.957521455885797,2,2,182,0.010869565217391304,0.010869565217391304,0.9891304347826086,184,6050,4500,1550,0.743801652892562,76,45,31,241.5480715848105,0.4653445988754257,0.7904148896585279,0.15429416347238306,1041476.7964850351,7463.342358257278,1048940.1388432924,2991,0,502.1358695652174,60,124,38,34.342357910906294,0.5708786231884058,40.607923497267755,8030.135773820099,133.83559623033497,0
3190,31.50028763239432,2,1,183,0.010869565217391304,0.005434782608695652,0.9945652173913043,184,5900,4400,1500,0.7457627118644068,74,44,30,237.49095372274158,0.46508350162350515,0.7866754146431867,0.15290277141616684,1061992.097577344,7742.703219931562,1069734.8007972755,2992,0,502.64130434782606,63,121,39,34.16515189503153,0.5735960144927537,40.33203124999999,8179.615704544567,129.83516991340582,0
3191,31.50319842865271,1,1,183,0.005434782608695652,0.005434782608695652,0.9945652173913043,184,5300,3800,1500,0.7169811320754716,68,38,30,247.65829890367232,0.4651670279955651,0.7971747667673752,0.15247035769308007,1049139.410696476,9865.616353178033,1059005.027049654,2993,0,503.3097826086956,73,111,32,35.528480782517,0.5591598731884058,41.92004504504504,8130.344031403694,111.37457577265334,8
3192,31.81506522406313,0,2,181,0.0,0.01092896174863388,0.9890710382513661,183,5350,3900,1450,0.7289719626168224,68,39,29,245.40864574116605,0.46471606717508357,0.7948138584032705,0.15144939930401052,1060237.4904678108,10088.289339943603,1070325.7798077543,2994,1,507.04918032786884,74,109,33,35.49770012911555,0.5606215846994536,41.833333333333336,8213.589338678972,110.99445052268881,0
3193,31.34083365655573,0,3,178,0.0,0.016574585635359115,0.9834254143646409,181,5800,4100,1700,0.7068965517241379,75,41,34,244.5525837620142,0.46386970534069977,0.7920258794464174,0.1513334757250453,1045227.9014627691,9122.63678457354,1054350.5382473427,2995,2,513.3038674033149,75,106,34,35.41926489058714,0.5622697974217311,41.73519736842105,8094.234218619501,107.92312291492668,0
3194,31.111400192372578,1,0,179,0.00558659217877095,0.0,1.0,179,4950,3600,1350,0.7272727272727273,63,36,27,236.98887679046277,0.46415531563199636,0.7864645480440149,0.14225094754484147,1028700.038121832,8008.0933177598035,1036708.1314395918,2996,0,514.9664804469273,69,110,39,36.747909553845275,0.5517923649906891,42.842261904761905,8000.537302446283,115.94981597748237,8
3195,31.5589512873152,0,1,178,0.0,0.00558659217877095,0.994413407821229,179,5300,3900,1400,0.7358490566037735,67,39,28,227.92034625883528,0.4641657774151026,0.7748576069963444,0.1302390477368135,1028627.6666439677,5789.034790582356,1034416.7014345501,2997,1,515.9664804469273,65,114,33,38.861951639158434,0.5353817504655494,44.68118686868688,8057.59398634627,123.96298440532723,8
3196,32.012545407972425,3,1,180,0.016574585635359115,0.0055248618784530384,0.994475138121547,181,5250,3900,1350,0.7428571428571429,66,39,27,242.14949442208936,0.4652087170042971,0.7818828146842507,0.13572622083644897,1037384.3597087273,8790.419644970363,1046174.7793536977,2998,0,510.9337016574586,67,114,36,39.25508203461904,0.5292357274401474,45.41973039215687,8149.762440794961,121.63824538499941,8
3197,32.07225181844334,3,2,181,0.01639344262295082,0.01092896174863388,0.9890710382513661,183,6550,5300,1250,0.8091603053435115,78,53,25,242.6154368492537,0.46659010388518585,0.7871944065700613,0.1320338745800671,1029959.6448841639,6826.821836134526,1036786.4667202984,2999,0,501.10382513661204,67,116,38,40.41999113475176,0.5212317850637522,46.56862745098038,8128.114799085858,121.3151462550128,8
3198,32.373474814003025,2,2,181,0.01092896174863388,0.01092896174863388,0.9890710382513661,183,4900,3500,1400,0.7142857142857143,63,35,28,269.37218296517517,0.46626108408895295,0.8093905196956335,0.14427202571776168,1034455.1618255385,14230.689024107607,1048685.8508496461,3000,0,500.46994535519127,63,120,35,40.3908060777749,0.5110997267759563,47.20052083333332,8183.997571795143,129.90472336182768,7
3199,32.50786585846655,3,3,181,0.016304347826086956,0.016304347826086956,0.9836956521739131,184,5450,3700,1750,0.6788990825688074,72,37,35,268.7657946861556,0.46728364813494894,0.8093783686669076,0.14139417894358622,1032872.5347955922,13270.161524768251,1046142.6963203604,3001,0,494.76630434782606,58,126,35,41.141528925619866,0.5066802536231885,47.91666666666667,8194.691185155112,141.2877790543985,8
3200,32.06427142373963,8,4,185,0.042328042328042326,0.021164021164021163,0.9788359788359788,189,5450,4000,1450,0.7339449541284404,69,40,29,249.1992774679152,0.46946062704041425,0.7984555711312749,0.13354688959216582,1024766.1551847729,7824.197089123884,1032590.3522738968,3002,0,482.1904761904762,68,121,36,40.87659978901696,0.5108575837742504,47.17693236714977,8106.587462762209,119.21452151120896,0
3201,31.98381383628993,3,2,186,0.015957446808510637,0.010638297872340425,0.9893617021276596,188,6200,4000,2200,0.6451612903225806,84,40,44,249.4950122031771,0.4697188957788145,0.8005795307229617,0.13478958303581914,1024785.6646919501,7335.782383591713,1032121.4470755418,3003,0,485.70212765957444,56,132,42,40.5409267013187,0.513242464539007,46.85672514619882,8096.4873768327325,144.58013172915594,0
3202,32.21077137625959,4,2,188,0.021052631578947368,0.010526315789473684,0.9894736842105263,190,6200,3900,2300,0.6290322580645161,85,39,46,217.55418345429777,0.4704776988768217,0.7729262748199748,0.11875287222546668,1035375.7377189833,850.064637569129,1036225.8023565524,3004,0,476.84736842105264,75,115,37,40.9340257131016,0.5195723684210527,46.450109649122815,8167.037550567818,108.8938340075709,8
3203,32.038547710905135,8,6,190,0.04081632653061224,0.030612244897959183,0.9693877551020408,196,6150,4000,2150,0.6504065040650406,83,40,43,207.3775837282729,0.4716771323914181,0.7693663093645104,0.11454608929794174,1033603.508937921,-2480.760356677568,1031122.7485812434,3005,0,463.1938775510204,87,109,37,40.719560169004474,0.5233843537414966,45.98721590909093,8138.200702276488,93.54253680777573,0
3204,31.695454294593503,6,2,194,0.030612244897959183,0.01020408163265306,0.9897959183673469,196,4850,3000,1850,0.6185567010309279,67,30,37,210.07190727377366,0.4716787676609105,0.7765071816530216,0.11689169723198467,1024838.1782719578,-992.0578486859895,1023846.1204232718,3006,0,464.13775510204084,70,126,42,40.359189599800004,0.5254570578231292,45.70129107981221,8060.113105753954,115.14447293934221,0
3205,31.349439292948116,5,1,198,0.02512562814070352,0.005025125628140704,0.9949748743718593,199,5700,3900,1800,0.6842105263157895,75,39,36,205.54047918427287,0.4729476507114698,0.7766190545038603,0.11599675095486348,1017994.5445248261,-3652.1827022782386,1014342.3618225479,3007,0,457.52763819095475,76,123,39,39.918869660615066,0.5289468174204355,45.15692640692642,7989.187464834393,105.12088769518938,0
3206,31.06116808995664,1,2,197,0.005025125628140704,0.010050251256281407,0.9899497487437185,199,5650,4500,1150,0.7964601769911505,68,45,23,210.61587791518676,0.4730481109249953,0.782926473937676,0.11967477610540406,1010701.4583197252,-2876.045009166412,1007825.4133105588,3008,0,452.22613065326635,79,120,41,39.522934531101136,0.5310406197654942,44.89583333333333,7923.833401281635,100.30168862381817,0
3207,30.801928891489165,2,3,196,0.010050251256281407,0.01507537688442211,0.9849246231155779,199,5200,3600,1600,0.6923076923076923,68,36,32,207.452924067757,0.47279008679762446,0.780596841882756,0.11878107994635921,1004551.8575556645,-3320.5559544761054,1001231.3016011884,3009,0,453.15577889447235,66,133,42,39.30685761246726,0.5331867671691792,44.60509950248756,7866.65556437333,119.19175097535349,0
3208,30.47917339656815,3,1,198,0.01507537688442211,0.005025125628140704,0.9949748743718593,199,6200,4500,1700,0.7258064516129032,79,45,34,203.85294976117183,0.4730343637378813,0.7772399989201566,0.1177315075350999,996570.615228666,-5369.22808806622,991201.3871405998,3010,0,453.70854271356785,68,131,44,39.065421020524596,0.5355946398659966,44.278381642512066,7794.183547168881,114.62034628189531,0
3209,30.292785263913164,3,1,200,0.014925373134328358,0.004975124378109453,0.9950248756218906,201,7050,4700,2350,0.6666666666666666,94,47,47,200.29559050597126,0.4731063432835821,0.775734142657188,0.11695855073461826,993687.7366827759,-7443.745600516418,986243.9910822595,3011,0,450.1542288557214,72,129,44,38.7338672237697,0.5386090381426203,43.86415525114153,7759.068143368126,107.7648353245573,0
3210,29.880967567091893,0,6,194,0.0,0.03,0.97,200,5250,3500,1750,0.6666666666666666,70,35,35,196.85498559641195,0.4730396775544388,0.7616387331991072,0.1122433779182525,973304.8741895966,-6930.016602097681,966374.857587499,3012,1,453.4,74,126,36,39.73943879124271,0.5355729166666667,44.76388888888891,7626.701958061813,103.06353997380828,8
3211,30.22029404148044,2,3,193,0.01020408163265306,0.015306122448979591,0.9846938775510204,196,5200,3400,1800,0.6538461538461539,70,34,36,189.35464237909497,0.4731690432583289,0.744976755180836,0.10898411639152403,987105.4742343879,-7017.399187179919,980088.075047208,3013,0,458.0561224489796,75,121,39,39.568139568139586,0.5378932823129252,44.407894736842124,7724.068575733692,102.98758100978256,0
3212,30.4502712563015,1,1,193,0.005154639175257732,0.005154639175257732,0.9948453608247423,194,6200,4400,1800,0.7096774193548387,80,44,36,206.97920217138946,0.4730872638569877,0.7623815984431443,0.11623942601808943,987340.1061946566,-4128.226509603241,983211.8796850534,3014,0,458.0773195876289,80,114,38,40.07381409285255,0.532860824742268,45.3446502057613,7754.324478102867,96.92905597628584,7
3213,30.930903636239695,4,5,192,0.02030456852791878,0.025380710659898477,0.9746192893401016,197,5500,3900,1600,0.7090909090909091,71,39,32,206.8494346359867,0.47358118374253255,0.7688796739829857,0.11730279440219586,1005867.666106474,-3287.368389451766,1002580.2977170222,3015,0,452.0406091370558,86,111,35,39.69600938967135,0.535427241962775,44.97126436781606,7888.269246311051,91.72406100361687,0
3214,31.008598355458304,2,3,191,0.010309278350515464,0.015463917525773196,0.9845360824742269,194,5500,3500,2000,0.6363636363636364,75,35,40,205.51615712826762,0.4734177750476292,0.7668889675518888,0.11718183119907463,1010034.8943985761,-2784.301987549799,1007250.5924110264,3016,0,455.2680412371134,74,120,35,39.51837441729701,0.5374785223367697,44.76388888888889,7914.514055253576,106.95289263856183,0
3215,31.0057650410987,4,1,194,0.020512820512820513,0.005128205128205128,0.9948717948717949,195,5900,4100,1800,0.6949152542372882,77,41,36,198.9999643061026,0.4737223543924575,0.7617010795203212,0.1148538836080768,1013593.4074915542,-4558.989617655928,1009034.4178738982,3017,0,453.2717948717949,80,115,41,39.21461382420492,0.5405448717948718,44.302983539094654,7928.081614096792,99.1010201762099,0
3216,31.2363453762582,1,2,193,0.005128205128205128,0.010256410256410256,0.9897435897435898,195,5850,4200,1650,0.717948717948718,75,42,33,198.70390357419095,0.47351969336505423,0.7623763032581905,0.11551150665054648,1023297.7905634465,-4183.346899239588,1019114.4436642069,3018,0,453.87179487179486,84,111,36,38.945675938781704,0.5430555555555556,44.031862745098046,7995.509140611599,95.18463262632856,0
3217,30.90743844502567,2,1,194,0.010256410256410256,0.005128205128205128,0.9948717948717949,195,6450,4800,1650,0.7441860465116279,81,48,33,195.6826033272327,0.47316944224160723,0.760232505472936,0.11450402047031634,1014469.5209473602,-5747.192628977816,1008722.3283183824,3019,0,454.8,86,109,41,38.77225571288377,0.5450854700854701,43.7859195402299,7918.920920559234,92.08047582045621,0
3218,31.39517347669626,1,2,193,0.005128205128205128,0.010256410256410256,0.9897435897435898,195,6650,5100,1550,0.7669172932330827,82,51,31,199.9714141204646,0.4729282315622522,0.763621514038995,0.11581627990344145,1027375.5910535483,-4560.850044834309,1022814.741008714,3020,0,455.7230769230769,78,117,37,39.05611105384325,0.5447115384615384,44.171940928270075,8031.766294763542,102.97136275337874,8
3219,31.912350251789306,0,1,192,0.0,0.0051813471502590676,0.9948186528497409,193,5150,3500,1650,0.6796116504854369,68,35,33,203.65380404049282,0.47232679368163505,0.7668945248350258,0.11839346260370469,1045455.1551651114,-1167.816139376086,1044287.3390257353,3021,1,461.4145077720207,77,116,39,38.81753143423595,0.5457145941278065,44.03044871794874,8168.589974306208,106.0855840818988,0
3220,32.332243000487985,0,2,190,0.0,0.010416666666666666,0.9895833333333334,192,6500,4800,1700,0.7384615384615385,82,48,34,201.97206736888847,0.47189840568644564,0.7639341150123549,0.11788177393549629,1060441.0441067927,-2064.1059997853445,1058376.9381070074,3022,2,464.71875,78,114,41,38.7089854475563,0.5472005208333333,43.881856540084414,8280.874051179897,106.1650519382038,0
3221,31.877449624595616,2,2,190,0.010416666666666666,0.010416666666666666,0.9895833333333334,192,6100,3900,2200,0.639344262295082,83,39,44,198.2498995026979,0.47183818717277487,0.75998011957279,0.11648871993971505,1047574.1000942431,-2963.707986937918,1044610.3921073051,3023,0,462.6145833333333,69,123,44,38.54843858834453,0.5501302083333333,43.63095238095234,8172.391400781649,118.44045508379202,0
3222,32.22566389204829,4,1,193,0.020618556701030927,0.005154639175257732,0.9948453608247423,194,5100,3500,1600,0.6862745098039216,67,35,32,193.2810284633466,0.4724301363887257,0.7568738280158773,0.11486894680999,1062511.7207903839,-2827.3283702552603,1059684.3924201287,3024,0,458.75773195876286,74,120,47,38.245037589918276,0.5524591924398625,43.2083333333333,8275.281940278828,111.82813432809228,0
3223,32.16189381482289,1,2,192,0.005154639175257732,0.010309278350515464,0.9896907216494846,194,6050,5100,950,0.8429752066115702,70,51,19,189.47255727166944,0.47251248597831313,0.7527302261785744,0.11344190528529763,1062664.7914445489,-4580.836888487794,1058083.9545560612,3025,0,459.1958762886598,77,117,47,38.06469383690924,0.5547143470790379,42.9353632478632,8267.685550768125,107.37253962036526,0
3224,31.945785056560194,0,0,192,0.0,0.0,1.0,192,6150,3700,2450,0.6016260162601627,86,37,49,211.95851172680344,0.47188761180191974,0.7780644503024143,0.12355759359101025,1047386.9212068892,-149.48539577369547,1047237.4358111155,3026,1,464.875,75,117,41,38.50051963460545,0.5435655381944444,43.92817982456141,8180.415326366712,109.07220435155617,8
3225,32.1566663568182,2,3,191,0.010309278350515464,0.015463917525773196,0.9845360824742269,194,5600,3900,1700,0.6964285714285714,73,39,34,221.4204001840149,0.472047878496519,0.7832745457817951,0.13044824719412473,1057563.0005231816,2433.204559129839,1059996.2050823115,3027,0,461.07216494845363,66,128,43,37.853621079857746,0.5460695876288659,43.53233830845769,8247.145028328205,124.95674285345764,0
3226,31.840022302616024,3,1,193,0.015463917525773196,0.005154639175257732,0.9948453608247423,194,5400,3700,1700,0.6851851851851852,71,37,34,219.20210434020274,0.4721836440361092,0.7816148189661802,0.1305483028720625,1050432.1526740436,1851.38766655155,1052283.5403405952,3028,0,461.4742268041237,73,121,38,37.499999999999986,0.5489690721649485,43.130630630630606,8178.726449579576,112.03734862437776,0
3227,31.967203683012137,2,2,193,0.010256410256410256,0.010256410256410256,0.9897435897435898,195,6250,4500,1750,0.72,80,45,35,222.13849093377064,0.4722200193849679,0.7880548722381051,0.13316799689656555,1056613.9566187733,1692.9259645707198,1058306.882583344,3029,0,460.0974358974359,74,121,40,37.177461466436164,0.5509081196581196,42.88888888888887,8219.123258054415,111.06923321695155,0
3228,32.38736535622132,2,3,192,0.010256410256410256,0.015384615384615385,0.9846153846153847,195,6950,4800,2150,0.6906474820143885,91,48,43,224.70464093045987,0.4714875759978853,0.7894391200694615,0.1354931548547363,1072281.2075740255,2239.312744880215,1074520.5203189058,3030,0,460.9948717948718,62,133,43,36.893058322088706,0.552991452991453,42.675264550264544,8334.070222203567,134.42048745489623,0
3229,32.0302042034423,1,3,190,0.0051813471502590676,0.015544041450777202,0.9844559585492227,193,6200,4600,1600,0.7419354838709677,78,46,32,223.6759925347555,0.4709786089522165,0.7860597058336047,0.1356856820142055,1062265.8801289832,2720.6750147310495,1064986.5551437142,3031,0,463.07253886010363,65,128,44,36.69516280589944,0.5547819516407599,42.45580808080807,8249.193058582225,126.91066243972654,0
3230,32.417100445165495,1,4,187,0.005235602094240838,0.020942408376963352,0.9790575916230366,191,5200,3300,1900,0.6346153846153846,71,33,38,208.10057288227364,0.47046018186828326,0.7689857367489086,0.1275686449288023,1078279.6988700796,1478.124612437813,1079757.8234825174,3032,0,468.59685863874347,73,118,42,36.7074510178464,0.5601003490401396,42.074887387387385,8361.18428289368,114.53677099854357,8
3231,31.913067593208538,1,2,186,0.005319148936170213,0.010638297872340425,0.9893617021276596,188,5950,4100,1850,0.6890756302521008,78,41,37,204.87447534286912,0.46997193461523873,0.7625542844269773,0.1261651142863543,1062870.44009108,1.0047542208740197,1062871.4448453009,3033,0,475.1489361702128,76,112,37,36.62257137365901,0.5620567375886525,41.91017316017316,8236.438089058878,108.37418538235366,0
3232,31.609497230110858,1,0,187,0.0053475935828877,0.0,1.0,187,5700,3900,1800,0.6842105263157895,75,39,36,230.7736320788299,0.4697856170816323,0.780209464427307,0.13635722342273307,1040450.2534949615,4921.696799274403,1045371.950294236,3034,0,478.5401069518717,66,121,39,37.502398553798294,0.5487410873440286,43.42350746268657,8110.253930169779,122.8826353056027,8
3233,31.268116563895713,3,5,185,0.015789473684210527,0.02631578947368421,0.9736842105263158,190,4750,3300,1450,0.6947368421052632,62,33,29,226.0475617678779,0.4706111343172747,0.7801039154284546,0.13459147856762127,1031490.1511925049,3883.166732929115,1035373.317925434,3035,0,471.9684210526316,69,121,35,37.33362058976887,0.5507127192982456,43.139880952380956,8031.532142997084,116.39901656517513,0
3234,31.380029818438008,4,0,189,0.021164021164021163,0.0,1.0,189,5350,3600,1750,0.6728971962616822,71,36,35,222.33258770600776,0.4707751697999925,0.7765494780726496,0.13338514351228206,1037430.1901323487,2980.9077472920835,1040411.0978796408,3036,0,472.23809523809524,74,115,39,37.14407565445967,0.5530202821869489,42.86111111111111,8069.026000813341,109.04089190288299,0
3235,31.315886515403193,0,2,187,0.0,0.010582010582010581,0.9894179894179894,189,5850,3900,1950,0.6666666666666666,78,39,39,228.14779118298284,0.47042806484295846,0.7810499501251733,0.13337814493219094,1027599.4410276329,3238.908538264418,1030838.3495658974,3037,1,473.23809523809524,73,116,44,37.975701503745626,0.5433201058201058,43.82038288288288,8022.491817199081,109.89714818080932,8
3236,31.784735445753505,2,1,188,0.010582010582010581,0.005291005291005291,0.9947089947089947,189,5550,3500,2050,0.6306306306306306,76,35,41,222.3920787696725,0.47096279410109193,0.7738382391168992,0.13082766276838723,1044883.5057330312,3124.762982422234,1048008.2687154535,3038,0,473.2962962962963,63,126,47,37.88482290212011,0.5457451499118166,43.58723958333332,8150.0117547591,129.36526594855715,0
3237,32.068368142749826,1,1,188,0.005291005291005291,0.005291005291005291,0.9947089947089947,189,5650,3700,1950,0.6548672566371682,76,37,39,219.9835522800946,0.4711879432624113,0.7701702998909983,0.13034103260273164,1056397.2861516974,3028.0055253401297,1059425.2916770375,3039,0,474.21693121693124,67,122,45,37.674564335163524,0.5477843915343915,43.321078431372534,8231.274151346717,122.85483807980175,0
3238,32.21190124925903,1,1,188,0.005291005291005291,0.005291005291005291,0.9947089947089947,189,5800,3900,1900,0.6724137931034483,77,39,38,216.37340715632197,0.47084670156478664,0.7670959721021415,0.12907322174530111,1063197.1221044785,2409.5167577083776,1065606.6388621868,3040,0,475.037037037037,68,121,38,37.511384335154816,0.5495480599647267,43.07065217391304,8276.18278021043,121.70857029721222,0
3239,31.935396401851527,4,2,190,0.020833333333333332,0.010416666666666666,0.9895833333333334,192,6300,5000,1300,0.7936507936507936,76,50,26,218.88114192568997,0.47118089641506694,0.7712424751129372,0.1321471596217042,1057694.1950853816,1601.8626456924585,1059296.057731074,3041,0,468.5416666666667,65,127,42,36.99606252938411,0.5527886284722222,42.6294191919192,8219.231520280833,126.4497156966282,0
3240,32.19714101085525,0,1,189,0.0,0.005263157894736842,0.9947368421052631,190,6650,4700,1950,0.706766917293233,86,47,39,225.292343855533,0.4700982781026641,0.7768118931796533,0.1363303096827408,1067058.0397222603,3430.001359784036,1070488.0410820444,3042,1,474.4421052631579,63,127,42,36.745321785307866,0.5540021929824561,42.54557291666669,8289.296492671094,131.57613480430308,0
3241,32.679089131583446,0,1,188,0.0,0.005291005291005291,0.9947089947089947,189,5550,3900,1650,0.7027027027027027,72,39,33,233.95307835733522,0.47008682314533373,0.7945655145974797,0.1376582846635479,1074351.3412339345,6919.560703802123,1081270.9019377367,3043,2,477.29100529100526,60,129,40,37.58019223938909,0.5408399470899471,43.57923497267759,8379.597035516676,139.65995059194458,8
3242,32.98857850534243,1,1,188,0.005291005291005291,0.005291005291005291,0.9947089947089947,189,5550,3600,1950,0.6486486486486487,75,36,39,229.7781953758846,0.47003522646253143,0.7901873421692964,0.13560322180512935,1085459.4430271662,6532.98239449905,1091992.4254216652,3044,0,478.22222222222223,62,127,41,37.57439037490602,0.5423831569664903,43.46891534391535,8462.5958252379,136.4934810522242,0
3243,32.747856064586685,4,4,188,0.020833333333333332,0.020833333333333332,0.9791666666666666,192,5050,3100,1950,0.6138613861386139,70,31,39,220.41532852734053,0.47091900269051773,0.7834257703892482,0.13139676214419943,1080680.1783585758,4189.695309178214,1084869.873667754,3045,0,467.8020833333333,69,123,32,37.432663345690436,0.5452473958333333,43.0952380952381,8413.080165164074,121.92869804585615,0
3244,33.205202071732664,2,0,190,0.010526315789473684,0.0,1.0,190,5600,3900,1700,0.6964285714285714,73,39,34,218.7693169087962,0.4703744314489928,0.7799018623291625,0.13125388428698606,1097786.2254023927,4432.388528633559,1102218.6139310263,3046,0,473.6421052631579,68,122,36,37.23384997749466,0.547094298245614,42.85929951690822,8538.408920407972,125.56483706482311,0
3245,33.16490956132724,1,1,190,0.005235602094240838,0.005235602094240838,0.9947643979057592,191,5550,3900,1650,0.7027027027027027,72,39,33,208.85692428079048,0.47047510792688524,0.7726924167904647,0.12034137065702738,1083640.8867254877,1515.1805252789518,1085156.0672507666,3047,0,472.15706806282725,70,121,40,39.02710820324457,0.5409576788830716,44.366197183098606,8478.07195124073,121.11531358915329,8
3246,32.98606024368408,3,1,192,0.015544041450777202,0.0051813471502590676,0.9948186528497409,193,5300,3600,1700,0.6792452830188679,70,36,34,202.89865679200634,0.471263088298791,0.7690634510421333,0.11765822959015249,1079831.9258408418,-80.71053715335893,1079751.2153036885,3048,0,468.23316062176167,74,119,40,38.93333061933455,0.5431778929188256,44.125000000000014,8440.308164852697,114.05821844395537,0
3247,33.14264818411616,3,2,193,0.015384615384615385,0.010256410256410256,0.9897435897435898,195,6500,4700,1800,0.7230769230769231,83,47,36,201.04347439238518,0.47178275618997273,0.7691560235286474,0.1174987417004388,1087451.219125498,-1775.0057349548551,1085676.2133905431,3049,0,464.4153846153846,76,119,43,38.68106164624703,0.5455662393162393,43.831168831168846,8490.113447164853,111.7120190416428,0
3248,33.06163237731738,1,1,193,0.005154639175257732,0.005154639175257732,0.9948453608247423,194,5000,3300,1700,0.66,67,33,34,203.7768118943846,0.47160552766055946,0.7650902048045134,0.11788229583301445,1081536.0907967507,278.3953062560513,1081814.4861030069,3050,0,466.4072164948454,75,119,49,39.003724145322046,0.544727233676976,44.216008771929864,8456.636285985527,112.75515047980703,7
3249,32.851948810195154,2,3,192,0.010256410256410256,0.015384615384615385,0.9846153846153847,195,6350,4400,1950,0.6929133858267716,83,44,39,208.77392410542492,0.47141928804299943,0.7713575688354459,0.12168784799814295,1077062.1676954066,-377.5009489463009,1076684.6667464604,3051,0,464.9794871794872,79,116,40,38.58626563612329,0.547275641025641,43.932291666666714,8412.323246110775,106.48510438114904,0
3250,33.17969720046975,2,2,192,0.010309278350515464,0.010309278350515464,0.9896907216494846,194,6500,5100,1400,0.7846153846153846,79,51,28,210.3803252286373,0.4708994355714617,0.7728182267351258,0.12352646885529796,1090138.4566574069,568.7366111656556,1090707.1932685724,3052,0,467.2216494845361,67,127,42,38.265158758615186,0.5498281786941581,43.65808823529409,8505.347012142407,126.94547779317026,0
3251,32.74299427567789,3,1,194,0.015384615384615385,0.005128205128205128,0.9948717948717949,195,6300,4500,1800,0.7142857142857143,81,45,36,209.55578412156106,0.47132346462243374,0.774092398057153,0.12073391623247412,1069828.5397082611,-462.248297161756,1069366.2914110995,3053,0,465.14358974358976,73,122,39,39.012481644640225,0.5381410256410256,44.3693693693694,8370.112275426749,114.65907226611985,8
3252,33.17405968685412,1,1,194,0.005128205128205128,0.005128205128205128,0.9948717948717949,195,6250,4200,2050,0.672,83,42,41,211.34349602836403,0.4711020794783682,0.7771816863337859,0.12251006557062785,1085868.3856624982,648.2441705179995,1086516.629833016,3054,0,465.5230769230769,74,121,43,38.731430716896476,0.539957264957265,44.138888888888914,8487.951771544878,114.70205096682268,0
3253,32.94427755952486,1,3,192,0.005128205128205128,0.015384615384615385,0.9846153846153847,195,5550,3900,1650,0.7027027027027027,72,39,33,216.4627552782681,0.47113622345581113,0.7830728320639144,0.12637866616383367,1080613.1283117223,2232.4990288452195,1082845.6273405675,3055,0,465.73333333333335,77,118,38,38.325935919495286,0.5423611111111111,43.870192307692335,8438.011475883182,109.58456462185951,0
3254,33.38121998690685,1,1,192,0.0051813471502590676,0.0051813471502590676,0.9948186528497409,193,5450,3900,1550,0.7155963302752294,70,39,31,214.3452719443669,0.4708954015544042,0.779175229573662,0.1255997881192426,1096112.4864398928,2939.3057975148367,1099051.7922374075,3056,0,470.51295336787564,63,130,41,38.24077749550122,0.5444192573402418,43.73372395833332,8554.480935772246,135.78541167892453,0
3255,33.671200348259795,2,0,194,0.010309278350515464,0.0,1.0,194,5000,3500,1500,0.7,65,35,30,211.82411319810973,0.47041479710841655,0.7763992060766962,0.1247633891611829,1107292.1838311455,3110.2369782459946,1110402.4208093914,3057,0,469.0412371134021,64,130,39,38.109260763606855,0.545801116838488,43.54166666666666,8635.259922647438,134.9259362913662,0
3256,34.05468317964778,2,0,196,0.01020408163265306,0.0,1.0,196,6650,5600,1050,0.8421052631578947,77,56,21,205.78949886670688,0.4703934458398744,0.7728991561850198,0.12218485937529784,1122503.9809645216,349.90634371442366,1122853.887308236,3058,0,465.2448979591837,69,127,44,37.960279741895626,0.5480973639455782,43.24404761904761,8743.742612822052,126.72090743220366,0
3257,34.286186798635995,1,1,196,0.005076142131979695,0.005076142131979695,0.9949238578680203,197,6150,4500,1650,0.7317073170731707,78,45,33,205.2104541800031,0.4705089523118892,0.7726076643374946,0.12243271828910271,1131710.89423255,897.7813211835819,1132608.6755537335,3059,0,463.8781725888325,72,125,44,37.79249509422785,0.5498096446700508,43.06506849315067,8809.31905673854,122.35165356581307,0
3258,34.287353788930545,2,3,195,0.010101010101010102,0.015151515151515152,0.9848484848484849,198,5600,3600,2000,0.6428571428571429,76,36,40,222.30681673146842,0.4709772214531098,0.7911681424108785,0.1268733399370064,1117142.3435480157,4469.6716460182315,1121612.015194034,3060,0,462.40909090909093,65,133,39,39.053676682741845,0.5362478956228955,44.72853535353534,8752.583020551783,134.65512339310436,8
3259,33.774422071940805,4,0,199,0.020100502512562814,0.0,1.0,199,6300,4700,1600,0.746031746031746,79,47,32,214.93863993742903,0.4715274605349982,0.7866462457605226,0.11944348966426838,1091624.2667422295,826.44704325371,1092450.7137854833,3061,0,460.41206030150755,63,136,42,40.287180184793975,0.5276381909547738,45.75195312500001,8587.080846122857,136.3028705733787,8
3260,33.864507761591476,1,1,199,0.005,0.005,0.995,200,6400,4700,1700,0.734375,81,47,34,208.81909089475758,0.47170697236180903,0.7816257331378302,0.11673329507395483,1096513.3735313057,-605.414837049706,1095907.958694256,3062,0,459.105,66,134,42,40.20840970185729,0.5292187500000001,45.5223880597015,8617.759064703516,130.57210704096235,0
3261,34.14773006905913,3,2,200,0.01485148514851485,0.009900990099009901,0.9900990099009901,202,6150,4600,1550,0.7479674796747967,77,46,31,200.6006165084899,0.47217245045400064,0.7751378357585015,0.1133315245903037,1109223.192915792,-2047.828731115187,1107175.364184677,3063,0,454.91584158415844,73,129,41,40.00242769831187,0.5323329207920793,45.11542792792793,8703.729565884782,119.22917213540796,0
3262,34.271934742420676,3,2,201,0.014778325123152709,0.009852216748768473,0.9901477832512315,203,6600,4700,1900,0.7121212121212122,85,47,38,201.55114987338428,0.4719959680697134,0.7784001955428863,0.11516122780046982,1117025.8044693558,-2172.4329341917755,1114853.371535164,3064,0,453.61083743842363,67,136,45,39.53852172956538,0.5347393267651888,44.684436274509814,8750.158338724372,130.599378189916,0
3263,33.67209283458124,3,1,203,0.014705882352941176,0.004901960784313725,0.9950980392156863,204,6000,4200,1800,0.7,78,42,36,241.93577669365962,0.4727680583727744,0.807662186680675,0.1352625680793547,1090323.4588177647,5957.650571278987,1096281.1093890436,3065,0,452.171568627451,65,139,41,39.360838915074886,0.5226205065359477,45.51767676767679,8568.952412638746,131.83003711751917,8
3264,33.25079779246653,2,1,204,0.00975609756097561,0.004878048780487805,0.9951219512195122,205,6500,4600,1900,0.7076923076923077,84,46,38,239.51923277939545,0.4730053403475211,0.806386661056721,0.13454711747438056,1078226.752392413,4151.208899050347,1082377.9612914633,3066,0,450.9317073170732,68,137,44,39.23543185725297,0.5244410569105691,45.335144927536255,8467.809600862345,124.52661177738743,0
3265,33.49124119359492,2,3,203,0.009708737864077669,0.014563106796116505,0.9854368932038835,206,5950,4200,1750,0.7058823529411765,77,42,35,238.7694714124267,0.47337151708895725,0.8102278732131982,0.13341551907787114,1084277.9186223191,4628.493098723453,1088906.4117210426,3067,0,445.3543689320388,70,136,38,39.46417589175893,0.5232099514563107,45.53990610328638,8522.184378839629,121.74549112628041,8
3266,33.025645980661636,3,5,201,0.014563106796116505,0.024271844660194174,0.9757281553398058,206,7050,4800,2250,0.6808510638297872,93,48,45,233.12034306012654,0.47324226458284,0.8086846117625952,0.12908070146423858,1066247.2825725328,1462.7864600471867,1067710.06903258,3068,0,445.7718446601942,70,136,38,39.96824480369515,0.5200748381877023,45.89201877934271,8392.080228654022,119.88686040934317,8
3267,32.80013539217768,5,1,205,0.024271844660194174,0.0048543689320388345,0.9951456310679612,206,5650,3800,1850,0.672566371681416,75,38,37,252.38756394275498,0.47357772910253376,0.8216120952417729,0.13640902362539836,1051077.7959042129,6205.7928845168335,1057283.5887887296,3069,0,445.77669902912623,59,147,36,40.45084121976866,0.5102649676375405,46.84027777777777,8303.67316473497,140.74022313110117,8
3268,32.83735277647218,5,3,207,0.023809523809523808,0.014285714285714285,0.9857142857142858,210,7550,5900,1650,0.7814569536423841,92,59,33,244.99053240950838,0.47432881446039343,0.8188759592962245,0.13421396649797765,1056698.1956688152,2226.2107106138956,1058924.4063794292,3070,0,438.1047619047619,67,143,39,40.09300213352656,0.5140873015873015,46.30821078431372,8330.5667789699,124.33681759656567,0
3269,32.772121155899235,7,12,202,0.03271028037383177,0.056074766355140186,0.9439252336448598,214,6400,4200,2200,0.65625,86,42,44,247.20133052063494,0.47500978090766827,0.8254429758343147,0.13750062982101416,1059530.7405856894,3183.4817600589904,1062714.2223457485,3071,0,430.68224299065423,61,153,35,39.429784715339714,0.5176693925233644,45.715725806451594,8333.435041910832,136.613689211653,0
3270,32.23365794336283,3,2,203,0.014634146341463415,0.00975609756097561,0.9902439024390244,205,6150,3900,2250,0.6341463414634146,84,39,45,264.7543183120666,0.4746313566076837,0.8283903086331672,0.1460686137536018,1039527.466758727,7893.877165675069,1047421.343924402,3072,0,449.38048780487804,67,138,34,39.308575607696476,0.5205284552845528,46.03247549019606,8186.302313771602,122.18361662345674,8
3271,32.11601407716479,3,1,205,0.014563106796116505,0.0048543689320388345,0.9951456310679612,206,6350,4400,1950,0.6929133858267716,83,44,39,253.26279565450898,0.47507893282816327,0.8218540428760504,0.13795248397088733,1031653.3602786706,4705.88283410894,1036359.2431127795,3073,0,447.79126213592235,63,143,36,40.113832166784405,0.5136529126213591,46.533203125,8140.343216531371,129.21179708779954,8
3272,32.593881700342756,4,2,207,0.019138755980861243,0.009569377990430622,0.9904306220095693,209,6950,4500,2450,0.6474820143884892,94,45,49,251.6991823365496,0.47588965311004783,0.8247840021195025,0.13885378525253886,1051116.4149429726,4163.028436334171,1055279.4433793067,3074,0,442.33971291866027,71,138,35,39.643623485625305,0.5170952950558214,46.035879629629626,8277.676495483453,116.58699289413313,0
3273,32.904504259562074,5,0,212,0.02358490566037736,0.0,1.0,212,6350,4100,2250,0.6456692913385826,86,41,45,253.330826547929,0.4768649959760351,0.8300702397627093,0.1414945348279905,1065151.301157843,5217.131904184131,1070368.4330620272,3075,0,437.04716981132077,59,153,39,39.109693413391604,0.5199488993710693,45.555555555555586,8372.368306044184,141.9045475600709,0
3274,32.91910367204075,4,3,213,0.018518518518518517,0.013888888888888888,0.9861111111111112,216,6700,4400,2300,0.6567164179104478,90,44,46,243.6950104122675,0.4773022538041918,0.8260876920147997,0.13753734124875575,1068984.380060046,2201.2319258571856,1071185.6119859032,3076,0,429.93518518518516,65,151,41,38.94421822423157,0.5227623456790124,45.15467171717174,8389.279782077725,129.06584280119577,0
3275,32.54938269602993,4,1,216,0.018433179723502304,0.004608294930875576,0.9953917050691244,217,6200,4500,1700,0.7258064516129032,79,45,34,245.0979324193459,0.47742966660977415,0.8293960132540612,0.1401361460931981,1061093.2733516193,2414.353480511397,1063507.6268321306,3077,0,428.6405529953917,54,163,40,38.400738021065116,0.525921658986175,44.65909090909089,8311.188967952157,153.91090681392885,0
3276,32.978355695564105,3,2,217,0.0136986301369863,0.0091324200913242,0.9908675799086758,219,7150,4900,2250,0.6853146853146853,94,49,45,243.46095160366832,0.4777938363146356,0.8291896666363119,0.1403286053557353,1077656.0344484546,1523.4327296508945,1079179.4671781056,3078,0,425.70319634703196,56,163,46,38.12906569447422,0.5283485540334856,44.35307017543857,8430.815384233245,150.5502747184508,0
3277,32.62528599940759,2,5,214,0.0091324200913242,0.0228310502283105,0.9771689497716896,219,6000,4100,1900,0.6833333333333333,79,41,38,241.2810689345988,0.47784794660187396,0.8273779824004364,0.1401286208043244,1068499.204355775,1761.7260365458187,1070260.9303923207,3079,0,424.28767123287673,58,161,37,37.892637049300966,0.5302987062404871,44.06779661016948,8349.86133205175,143.96312641468535,0
3278,32.879498280703835,1,3,212,0.004651162790697674,0.013953488372093023,0.986046511627907,215,6450,4300,2150,0.6666666666666666,86,43,43,249.82889223376364,0.47771046149387814,0.8272303289962526,0.14299544765597935,1072199.412242245,4123.2782828345935,1076322.6905250796,3080,0,432.45116279069765,59,156,40,38.23787672784953,0.5281007751937985,44.618055555555564,8396.830203283931,142.31915598786324,8
3279,33.21299353430454,4,1,215,0.018518518518518517,0.004629629629629629,0.9953703703703703,216,6750,4700,2050,0.6962962962962963,88,47,41,241.81812625227494,0.47801553976457073,0.8222271903424534,0.13983867644846534,1086372.9394775925,2590.9337271295162,1088963.873204722,3081,0,431.34722222222223,62,154,41,38.044502984463556,0.5306712962962963,44.22949735449736,8494.904050630914,137.01458146178894,0
3280,33.276118229713994,5,2,218,0.022727272727272728,0.00909090909090909,0.990909090909091,220,7700,5400,2300,0.7012987012987013,100,54,46,226.9606219183716,0.4785509201605092,0.8126502236464024,0.1329894038777286,1092655.129218126,-2102.0624660712947,1090553.0667520547,3082,0,424.45454545454544,66,154,37,37.918233937996725,0.5340909090909092,43.734452736318396,8527.522648948598,129.2048886204333,0
3281,32.93315333257036,0,1,217,0.0,0.0045871559633027525,0.9954128440366973,218,5600,3800,1800,0.6785714285714286,74,38,36,231.28205409099877,0.47823126735156923,0.8156914406933764,0.13563967330683338,1081668.0843857913,834.0832802843543,1082502.1676660758,3083,1,429.3440366972477,64,154,38,37.77420850788886,0.535072629969419,43.70192307692308,8440.703866150614,131.88599790860334,0
3282,32.84870304659749,1,3,215,0.0045871559633027525,0.013761467889908258,0.9862385321100917,218,6650,5000,1650,0.7518796992481203,83,50,33,227.0888142011837,0.4784884581237052,0.8125024700070576,0.13379960952752817,1080350.3698505198,-1182.9031177671968,1079167.4667327525,3084,0,430.0366972477064,65,153,39,37.70487179487177,0.5369839449541285,43.529040404040394,8424.73839184356,129.61135987451632,0
3283,32.446006468883006,3,0,218,0.013761467889908258,0.0,1.0,218,7700,5400,2300,0.7012987012987013,100,54,46,218.10699287024937,0.4787808805084626,0.8041706124333177,0.12973553016463896,1070043.3080104203,-4623.214369782806,1065420.0936406376,3085,0,420.41284403669727,68,150,45,37.57482463359198,0.5399464831804281,43.17632850241545,8332.902506772894,122.5426839231308,0
3284,32.79401096760816,1,4,215,0.0045662100456621,0.0182648401826484,0.9817351598173516,219,7250,5100,2150,0.7034482758620689,94,51,43,218.43830208916816,0.47846759666540994,0.8072046409654121,0.13074508767457715,1083457.365515653,-3716.2825381513935,1079741.0829775017,3086,0,419.48858447488584,69,150,36,37.33139400254717,0.5419044901065448,42.94642857142858,8429.81764069143,122.17127015494826,0
3285,32.370219541444825,0,0,215,0.0,0.0,1.0,215,5650,4200,1450,0.7433628318584071,71,42,29,221.98831452520608,0.47778290951242486,0.8082517369813462,0.13285747034870593,1069427.3179538634,-1169.926436041982,1068257.3915178215,3087,2,428.15813953488373,68,147,38,37.24366692116442,0.5425872093023256,42.94987922705314,8320.768842575195,122.36424768492934,0
3286,31.880692603028386,0,1,214,0.0,0.004651162790697674,0.9953488372093023,215,6750,4600,2150,0.6814814814814815,89,46,43,220.8887541123867,0.4775374918495979,0.8082777028863257,0.13285605440454828,1054746.8167914734,-3153.657946985108,1051593.1588444882,3088,3,429.15813953488373,69,146,40,37.08588838751979,0.5442829457364341,42.767857142857146,8200.738874046861,118.85128802966466,0
3287,32.09457196939442,2,2,214,0.009259259259259259,0.009259259259259259,0.9907407407407407,216,6400,5100,1300,0.796875,77,51,26,216.91882454063008,0.47753328667815104,0.8067467485961151,0.12715985100688637,1053989.6091919777,-3873.9625792076154,1050115.64661277,3089,0,428.037037037037,65,151,40,38.15920474606889,0.5357349537037037,43.718434343434346,8225.247153393731,126.54226389836509,8
3288,32.045212392558575,3,4,213,0.013824884792626729,0.018433179723502304,0.9815668202764977,217,6700,4700,2000,0.7014925373134329,87,47,40,211.80702846768438,0.47727676793537005,0.8035631263752834,0.12532223031403317,1055210.8763606679,-5399.78397425306,1049811.0923864148,3090,0,426.9447004608295,68,149,41,37.93703551189283,0.5380184331797235,43.37258454106281,8223.680034135024,120.93647109022095,0
3289,31.78920835766881,2,1,214,0.009302325581395349,0.004651162790697674,0.9953488372093023,215,7200,5500,1700,0.7638888888888888,89,55,34,215.66611794593703,0.47693617329566035,0.8049201084686468,0.12875448473404344,1049487.05671082,-4932.240128933863,1044554.816581886,3091,0,430.6418604651163,71,144,35,37.499354859899036,0.5419573643410853,43.04108796296297,8168.520394105273,115.04958301556722,0
3290,31.373809816863318,1,2,213,0.004651162790697674,0.009302325581395349,0.9906976744186047,215,6550,4800,1750,0.732824427480916,83,48,35,224.71060469619724,0.4768917988843005,0.8092841589479485,0.1308375011677111,1028280.1148306655,-3336.9107198648258,1024943.2041108008,3092,0,431.5953488372093,74,141,38,38.219006545875374,0.5379360465116279,43.97222222222225,8032.5668078342105,108.5482001058677,8
3291,31.795364027279817,1,1,213,0.004672897196261682,0.004672897196261682,0.9953271028037384,214,6950,5000,1950,0.7194244604316546,89,50,39,226.9390062605858,0.4768078225322861,0.8090434144894592,0.1326811967137,1043355.3513456881,-2394.394677788725,1040960.9566678994,3093,0,432.35981308411215,76,138,40,38.003863688370224,0.5393788940809969,43.817640692640715,8145.411371544941,107.17646541506501,0
3292,32.11659924848448,1,2,212,0.004672897196261682,0.009345794392523364,0.9906542056074766,214,7300,5600,1700,0.7671232876712328,90,56,34,221.85028957886104,0.47666430827958406,0.8032508713174906,0.13047540924001966,1055714.2714304603,-3257.8966341235346,1052456.3747963367,3094,0,433.28504672897196,67,147,38,37.90850161309596,0.5416179906542056,43.59681372549018,8234.79837961291,122.90743850168522,0
3293,32.40091201648961,2,0,214,0.009345794392523364,0.0,1.0,214,6650,4300,2350,0.6466165413533834,90,43,47,215.5982898318273,0.47635351308264956,0.7975619598090278,0.12771049281824456,1067274.1041227735,-3429.5056738672083,1063844.5984489063,3095,0,426.2710280373832,71,143,43,37.79668799203352,0.5440517912772586,43.33043981481479,8316.327836871213,117.13137798410159,0
3294,32.7596971036472,0,2,212,0.0,0.009345794392523364,0.9906542056074766,214,6800,5100,1700,0.75,85,51,34,219.61285609934362,0.47601209541778183,0.8007198787572625,0.13105928509154305,1081404.9318791658,-2101.914862020327,1079303.0170171454,3096,1,427.2710280373832,74,140,35,37.41272522522523,0.5459501557632398,43.055555555555536,8417.422172464858,113.74894827655213,0
3295,32.82159909686706,0,3,209,0.0,0.014150943396226415,0.9858490566037735,212,7900,6200,1700,0.7848101265822784,96,62,34,221.8053434750473,0.47533551670690627,0.8000724558871521,0.1331869503990943,1085363.794013768,-2152.1021746795723,1083211.6918390885,3097,2,432.12264150943395,77,135,36,37.124324920808,0.5484473270440251,42.828525641025614,8440.779030560414,109.62050689039499,0
3296,32.84884513500245,3,2,210,0.014150943396226415,0.009433962264150943,0.9905660377358491,212,6850,5200,1650,0.7591240875912408,85,52,33,225.78474734249176,0.4752190825359921,0.8029172748126316,0.1364713125465026,1088301.3584638732,-105.63054934862157,1088195.7279145245,3098,0,432.00471698113205,68,144,37,36.77558012237796,0.5511006289308176,42.58756038647344,8455.701364687931,124.34854948070488,0
3297,32.52373274451424,1,2,209,0.004739336492890996,0.009478672985781991,0.990521327014218,211,7150,4700,2450,0.6573426573426573,96,47,49,226.63597310529786,0.4748344993605657,0.8028157708275414,0.13766783941244953,1079047.3985270518,-439.8085616161061,1078607.5899654357,3099,0,434.8530805687204,68,143,39,36.568403367911095,0.5526757503949447,42.40640096618359,8377.905371673436,123.20449075990348,0
3298,32.04806768694552,1,1,209,0.004761904761904762,0.004761904761904762,0.9952380952380953,210,7750,5900,1850,0.7612903225806451,96,59,37,225.04584296346064,0.4745296005164426,0.8009336701281691,0.13725408053385998,1064476.42603869,-1838.801077478267,1062637.6249612116,3100,0,437.77142857142854,71,139,40,36.45950275984658,0.5544146825396825,42.25983796296296,8260.074158607267,116.33907265644038,0
3299,32.35579470917513,1,2,208,0.004761904761904762,0.009523809523809525,0.9904761904761905,210,7050,4700,2350,0.6666666666666666,94,47,47,224.63585659968572,0.4742129946077314,0.7994936871114531,0.13793755492030305,1076749.621033796,-674.6853071372061,1076074.935726659,3101,0,438.45238095238096,74,136,33,36.21859578286227,0.5563492063492064,42.01388888888889,8347.345648929564,112.8019682287779,0
3300,32.80169767795871,0,3,205,0.0,0.014423076923076924,0.9855769230769231,208,5250,3400,1850,0.6476190476190476,71,34,37,228.12956472083968,0.4738988178186548,0.8018024382367186,0.14029854958452476,1092058.7488415584,2976.1774045619695,1095034.9262461204,3102,2,443.3557692307692,74,134,33,36.071640023682676,0.5575420673076923,41.95833333333334,8464.204738316617,114.38114511238672,0
3301,32.4648808166937,3,3,205,0.014423076923076924,0.014423076923076924,0.9855769230769231,208,5950,4100,1850,0.6890756302521008,78,41,37,229.55014142743713,0.47416687956769477,0.8069662253715111,0.1397068786930071,1077681.0911558263,1926.3693776986697,1079607.460533525,3103,0,443.7355769230769,69,139,38,36.42163586485705,0.5544370993589743,42.336309523809504,8365.021002098934,121.23218843621643,8
3302,32.61026163522356,0,2,203,0.0,0.00975609756097561,0.9902439024390244,205,6800,5000,1800,0.7352941176470589,86,50,36,228.33901413543163,0.47396879483500715,0.8030406695715371,0.13937362846354853,1083392.9086705036,1676.1737374280365,1085069.0824079318,3104,1,450.9268292682927,71,134,40,36.3450286243475,0.555589430894309,42.23090277777777,8405.917701892036,118.39320706890192,0
3303,32.70423539468869,0,3,200,0.0,0.014778325123152709,0.9852216748768473,203,5100,3300,1800,0.6470588235294118,69,33,36,230.40767254688998,0.4738524037132777,0.8039859911029357,0.1410297512182611,1087368.8622006557,4407.625747922537,1091776.4879485783,3105,2,437.89162561576353,71,132,42,36.18809844404548,0.5575738916256158,42.129629629629626,8433.453293908138,118.78103230856533,0
3304,32.2748420703727,0,1,199,0.0,0.005,0.995,200,5400,3600,1800,0.6666666666666666,72,36,36,233.1411804638684,0.47339405360134007,0.8024862225132317,0.1431416554224899,1074016.5763816908,4679.498491078061,1078696.074872769,3106,3,444.53,73,127,34,36.003971826631,0.5594791666666667,42.01858108108109,8326.309552698785,114.05903496847651,0
3305,32.543152683914094,0,1,198,0.0,0.005025125628140704,0.9949748743718593,199,6100,4500,1600,0.7377049180327869,77,45,32,233.06957562302821,0.4730586856843138,0.8008160252432452,0.1436682607944941,1084150.97854347,4636.521696083626,1088787.5002395536,3107,4,447.53768844221105,74,125,37,35.85889157923058,0.5609296482412061,41.875000000000014,8400.20128653536,113.5162336018292,0
3306,32.41924657158573,1,0,199,0.005025125628140704,0.0,1.0,199,6250,4400,1850,0.704,81,44,37,238.49587551766953,0.4731358814273387,0.8043331657219326,0.14239874758615442,1070318.8175808124,5003.3246963943075,1075322.1422772068,3108,0,448.286432160804,75,124,34,36.90882583031079,0.5481574539363484,43.03728070175437,8330.537756634954,111.07383675513273,8
3307,32.068179388843184,0,1,198,0.0,0.005025125628140704,0.9949748743718593,199,6750,5000,1750,0.7407407407407407,85,50,35,238.1057634602201,0.47287151244437675,0.805776568025312,0.1428634580761317,1060213.2777535878,3938.5783860359775,1064151.8561396238,3109,1,449.286432160804,76,123,35,36.734423225308625,0.5496231155778895,42.85714285714285,8246.103271416794,108.5013588344315,0
3308,32.12713435624269,3,4,197,0.014925373134328358,0.01990049751243781,0.9800995024875622,201,6400,4200,2200,0.65625,86,42,44,232.97500678090654,0.47294568822553895,0.8038805129249329,0.14137230631254522,1065577.9778560018,3050.607323317135,1068628.585179319,3110,0,445.5223880597015,66,135,38,36.44361946154774,0.5526015754560532,42.444029850746254,8274.535257237478,125.37174632177997,0
3309,32.550523690201096,0,1,196,0.0,0.005076142131979695,0.9949238578680203,197,5900,4500,1400,0.7627118644067796,73,45,28,229.71972376907402,0.47245890742083635,0.797147183500281,0.13998192034598245,1080898.4870770678,4360.740374750772,1085259.2274518185,3111,1,450.25888324873097,69,128,37,36.37159795203452,0.5546214043993232,42.291666666666664,8388.541209328901,121.57306100476669,0
3310,32.67412202445063,2,4,194,0.010101010101010102,0.020202020202020204,0.9797979797979798,198,6050,4100,1950,0.6776859504132231,80,41,39,227.5902872331408,0.47220940368148495,0.7951498509566679,0.13964434769676695,1087108.9107689597,3833.0858511230053,1090941.9966200828,3112,0,448.45959595959596,74,124,34,36.17078554891513,0.5569234006734007,42.04166666666668,8428.562060557271,113.89948730482799,0
3311,32.340862277806245,0,1,193,0.0,0.005154639175257732,0.9948453608247423,194,6200,4900,1300,0.7903225806451613,75,49,26,235.61314303621612,0.4716556051136869,0.7986499424178934,0.14467815312058552,1076252.6933594139,5715.855956720836,1081968.5493161348,3113,1,456.340206185567,71,123,34,35.93539703903097,0.5576138316151202,42.013888888888886,8343.493289031258,117.51398998635574,0
3312,32.481431647849085,2,1,194,0.010256410256410256,0.005128205128205128,0.9948717948717949,195,6200,4400,1800,0.7096774193548387,80,44,36,211.01705660208648,0.47195237465856027,0.7800221249850263,0.12317790647657899,1065377.1589740699,-237.4495484396275,1065139.7094256303,3114,0,454.33846153846156,73,122,40,38.47205047174133,0.5419337606837606,43.87668918918919,8319.251813522167,113.9623536098927,8
3313,32.05712070135583,0,0,194,0.0,0.0,1.0,194,6100,4200,1900,0.6885245901639344,80,42,38,200.53841599883668,0.47174296244858716,0.7638588232961832,0.118543722321257,1055317.044840997,-2573.67829020279,1052743.3665507943,3115,1,457.3041237113402,75,119,41,38.26167806206931,0.549291237113402,43.407346491228054,8225.621664611841,109.67495552815788,8
3314,32.147201340654384,1,0,195,0.005128205128205128,0.0,1.0,195,7250,5800,1450,0.8,87,58,29,201.96298405841938,0.471749713631157,0.7667739207724471,0.12002696817147472,1059920.2665160794,-3437.0680220836543,1056483.1984939957,3116,0,455.95384615384614,76,119,41,38.0226442594739,0.5514957264957265,43.20887445887445,8255.116015263786,108.61994756926033,0
3315,32.13180977773452,0,1,194,0.0,0.005128205128205128,0.9948717948717949,195,6250,4600,1650,0.736,79,46,33,203.1558783652118,0.4716505859547097,0.7681101053542132,0.12119591800115112,1060572.0594112459,-2157.7103401415316,1058414.3490711043,3117,1,456.95384615384614,80,115,36,37.848699467774495,0.5526709401709402,43.06841563786007,8255.676794616194,103.19595993270244,0
3316,32.62486906349389,2,2,194,0.01020408163265306,0.01020408163265306,0.9897959183673469,196,6550,4700,1850,0.7175572519083969,84,47,37,203.66667731803136,0.4717016614338043,0.7693949885495031,0.12224127026176568,1078722.1559503807,-1810.048549648645,1076912.107400732,3118,0,455.15816326530614,83,113,40,37.607346369613104,0.5545812074829932,42.844742063492056,8389.656619167545,101.08020023093427,0
3317,32.27105790815014,0,1,193,0.0,0.005154639175257732,0.9948453608247423,194,7300,5500,1800,0.7534246575342466,91,55,36,236.94781577119858,0.47134011715898366,0.8019569462508727,0.13845008924454397,1058780.0910420215,4075.125990887496,1062855.217032909,3119,1,460.6701030927835,80,114,39,37.77036581488361,0.5453178694158076,43.840020576131685,8266.5535297382,103.3319191217275,8
3318,32.147804333678934,1,0,194,0.005154639175257732,0.0,1.0,194,5750,4000,1750,0.6956521739130435,75,40,35,232.55316333672195,0.4714853417730534,0.799042354671629,0.13692479975834757,1057087.2896066275,4615.798624212384,1061703.08823084,3120,0,457.58247422680415,63,131,41,37.59097063552507,0.547948883161512,43.554687499999986,8244.15372853912,130.85958299268447,0
3319,31.972555140879948,2,1,195,0.01020408163265306,0.00510204081632653,0.9948979591836735,196,6700,5000,1700,0.746268656716418,84,50,34,222.00202395007645,0.47164824263038546,0.7907500662602702,0.1314935064935063,1053140.441279313,859.8618935366603,1054000.3031728498,3121,0,453.9030612244898,69,127,43,37.63528138528135,0.5499043367346939,43.333333333333314,8206.289152825815,118.93172685254804,0
3320,32.17075398568044,2,1,196,0.01015228426395939,0.005076142131979695,0.9949238578680203,197,6550,4600,1950,0.7022900763358778,85,46,39,217.96045318572223,0.47150713077109013,0.7881083695458928,0.12997117957260013,1061724.6202040904,332.79587562418556,1062057.4160797147,3122,0,451.7258883248731,71,126,38,37.4847486578819,0.5521362098138748,43.08449074074072,8265.165643485383,116.41078371106174,0
3321,32.624637665445604,0,2,194,0.0,0.01020408163265306,0.9897959183673469,196,5850,4100,1750,0.7008547008547008,76,41,35,229.58218814180435,0.4714040423861852,0.7923194360252326,0.1332632241512786,1068310.6394048058,4003.0188419456267,1072313.6582467514,3123,1,455.03061224489795,73,123,35,38.212550421708855,0.5426764455782314,44.087837837837874,8349.041564721389,114.37043239344368,8
3322,32.78827267500094,0,2,192,0.0,0.010309278350515464,0.9896907216494846,194,5000,3400,1600,0.68,66,34,32,226.94154115376645,0.47103965244021867,0.7881182897624126,0.1320615536529495,1074460.6248862615,4967.950024145967,1079428.5749104074,3124,3,460.4381443298969,76,118,37,38.18365567533294,0.5438144329896908,43.99350649350653,8394.010715661854,110.44750941660334,0
3323,32.31670874733468,2,0,194,0.010309278350515464,0.0,1.0,194,6400,5000,1400,0.78125,78,50,28,220.4559801992003,0.4709428360308388,0.7818349729496039,0.12889959614916244,1060484.1221771338,1558.0133280502605,1062042.135505184,3125,0,460.91237113402065,79,115,40,38.167354934349866,0.546606529209622,43.81510416666671,8279.052664112212,104.79813498876219,0
3324,31.906610216641774,2,5,191,0.01020408163265306,0.025510204081632654,0.9744897959183674,196,6150,3600,2550,0.5853658536585366,87,36,51,204.02004169707726,0.4711178702250131,0.7610931910758232,0.12204107948788803,1053956.114642188,-2344.365908762222,1051611.7487334257,3126,0,457.19897959183675,83,113,38,37.72479736575482,0.5536777210884354,42.96875,8200.995907246204,98.80717960537595,7
3325,32.123051996504245,1,0,192,0.005208333333333333,0.0,1.0,192,5350,3700,1650,0.6915887850467289,70,37,33,201.6219828320227,0.47038101276178007,0.7614557981940981,0.11636204877887238,1050104.3386196874,-1405.176213397659,1048699.1624062897,3127,0,467.4270833333333,76,116,44,39.14927340705078,0.5426974826388888,44.30465367965369,8213.71490511267,108.07519611990357,8
3326,32.45337690127132,1,0,193,0.0051813471502590676,0.0,1.0,193,6900,5200,1700,0.7536231884057971,86,52,34,206.22033455370928,0.4699767469055844,0.7691451277993575,0.11986633165750549,1063129.3776851299,-1652.2208119789652,1061477.156873151,3128,0,466.0,79,114,36,38.75796961372807,0.5451748704663213,44.03645833333335,8306.881290692641,105.15039608471697,0
3327,32.796763138962966,3,0,196,0.015306122448979591,0.0,1.0,196,5900,4300,1600,0.7288135593220338,75,43,32,201.2207041774387,0.4708142551892552,0.7666288006005868,0.1177015783778569,1076367.5190856904,-1782.513971170688,1074585.0051145197,3129,0,459.8520408163265,83,113,42,38.644320748628566,0.547140731292517,43.79960317460319,8402.543730790909,101.23546663603504,0
3328,32.78886194529937,1,2,195,0.005076142131979695,0.01015228426395939,0.9898477157360406,197,6950,4800,2150,0.6906474820143885,91,48,43,202.83200687779564,0.4707560689250319,0.7687945680654891,0.11961180677434254,1078654.9146686723,-2592.851785831234,1076062.062882841,3130,0,458.51269035532994,73,124,42,38.29391212087952,0.549492385786802,43.496621621621614,8410.453862151517,115.2116967418016,0
3329,33.128664241085474,0,1,194,0.0,0.005128205128205128,0.9948717948717949,195,6100,4200,1900,0.6885245901639344,80,42,38,201.004595091248,0.4704136928363733,0.7649875522173943,0.11889402233982585,1090790.5365345597,-1249.2179749013258,1089541.3185596582,3131,1,462.9025641025641,73,122,43,38.22590967270063,0.5508547008547009,43.38400900900899,8501.345004433913,116.45678088265635,0
3330,33.40054781765204,4,1,197,0.020202020202020204,0.005050505050505051,0.9949494949494949,198,5950,4400,1550,0.7394957983193278,75,44,31,202.8921417693556,0.47165072894768323,0.7719971062942605,0.1200267196572389,1099785.5158272767,-922.4322413780574,1098863.0835858986,3132,0,455.0808080808081,72,126,46,38.172356909845796,0.5471380471380471,43.378995433789925,8571.282134027528,119.04558519482677,8
3331,33.68834655701739,3,4,196,0.015,0.02,0.98,200,6600,4900,1700,0.7424242424242424,83,49,34,192.3450240640662,0.4717341917922948,0.764074837645601,0.11139934796689696,1102417.382127956,-4191.100421190276,1098226.2817067658,3133,0,451.5,78,122,42,39.25121551042847,0.5421354166666666,44.171940928270075,8618.424313017647,110.49261939766214,8
3332,33.75971556911863,1,5,192,0.005076142131979695,0.025380710659898477,0.9746192893401016,197,5500,3900,1600,0.7090909090909091,71,39,32,191.04026873098604,0.471011818432957,0.7580079858652355,0.11116745482688625,1106287.26327182,-2630.9167861764217,1103656.3464856436,3134,0,456.4517766497462,80,117,33,39.10360258535521,0.5437817258883249,43.994341563786044,8642.67821289162,108.03347766114526,0
3333,33.53360410598503,0,2,190,0.0,0.010416666666666666,0.9895833333333334,192,6600,4500,2100,0.6818181818181818,87,45,42,197.37168188030245,0.4702651205279232,0.7600121780423652,0.11525489715293644,1100005.9585414727,-1577.994776862587,1098427.96376461,3135,2,468.25,82,110,35,38.80753180786255,0.5456271701388888,43.862951807228946,8589.198370972077,104.74632159722046,0
3334,33.0691386967097,2,3,189,0.010416666666666666,0.015625,0.984375,192,6450,4500,1950,0.6976744186046512,84,45,39,178.89987611160714,0.4708036785558464,0.7360985657647203,0.10543247594653274,1087676.6985577955,-5932.954675705676,1081743.7438820899,3136,0,467.28125,76,116,43,38.93159800974033,0.5486653645833333,43.52002164502164,8481.571977149875,111.59963127828783,8
3335,32.5859486754653,6,5,190,0.03076923076923077,0.02564102564102564,0.9743589743589743,195,6000,4000,2000,0.6666666666666666,80,40,40,170.96420745069452,0.47126729227244696,0.7290783090783111,0.10202702702702693,1075669.4573859908,-8219.804747817285,1067449.6526381734,3137,0,458.56410256410254,83,112,38,38.66272522522525,0.5528311965811965,43.05555555555554,8372.778479112576,100.87684914593466,0
3336,32.73111486223475,1,0,191,0.005235602094240838,0.0,1.0,191,5400,3700,1700,0.6851851851851852,71,37,34,171.99269742959638,0.4704027739505832,0.72520299986942,0.1029522559924367,1081400.2543369941,-6401.410651106,1074998.8436858882,3138,0,467.8743455497382,83,108,39,38.52277204238827,0.5545920593368238,42.9439484126984,8413.731150536465,101.37025482574055,0
3337,32.4778518249846,2,1,192,0.010362694300518135,0.0051813471502590676,0.9948186528497409,193,6550,4600,1950,0.7022900763358778,85,46,39,172.16715394764148,0.4704793645653425,0.7282579621433152,0.10365321118831144,1074802.8651617842,-8140.849930064991,1066662.0152317192,3139,0,464.01554404145077,87,106,42,38.302697770007036,0.5566709844559585,42.73200757575758,8355.511737265808,96.04036479615871,0
3338,32.52294660924337,5,0,197,0.025380710659898477,0.0,1.0,197,4650,3400,1250,0.7311827956989247,59,34,25,165.83545718062686,0.4710571411305639,0.7227459040715971,0.10083738936622878,1079330.6692848185,-8251.741002016272,1071078.9282828022,3140,0,455.5532994923858,82,115,48,38.09705037022599,0.5590630287648054,42.36947791164656,8378.903714790953,102.18175261940186,0
3339,32.43340102973537,0,1,196,0.0,0.005076142131979695,0.9949238578680203,197,4950,3200,1750,0.6464646464646465,67,32,35,164.94628182078142,0.4709093028074174,0.7219131328845356,0.10062836711608228,1077361.6589341096,-8808.640036510205,1068553.0188975993,3141,1,456.5532994923858,83,114,51,37.998005372464064,0.5601205583756346,42.24950396825395,8359.725203410786,100.71958076398538,0
3340,32.00357111768608,0,0,196,0.0,0.0,1.0,196,6000,4200,1800,0.7,78,42,36,162.03582134380096,0.470606030873888,0.7148014064246861,0.0991979786515125,1064126.4437623448,-10714.679534262345,1053411.7642280825,3142,2,459.3673469387755,88,108,48,37.94459825413389,0.5617028061224489,42.12312734082394,8252.980833754344,93.78387311084481,0
3341,32.15996148690788,0,0,196,0.0,0.0,1.0,196,6550,4600,1950,0.7022900763358778,85,46,39,159.9296005570562,0.4703629208093494,0.7109912827406424,0.09825775124525406,1070394.4525915317,-11512.448551709822,1058882.004039822,3143,3,460.3673469387755,88,108,41,37.86810848000961,0.5631909013605443,41.99438202247188,8297.450737563096,94.28921292685337,0
3342,32.303751218107706,0,1,195,0.0,0.00510204081632653,0.9948979591836735,196,6500,5100,1400,0.7846153846153846,79,51,28,161.3706207075146,0.4703116823652538,0.7139116155236431,0.0994329784426595,1076058.3871362412,-10971.158030059907,1065087.2291061813,3144,4,461.3673469387755,88,108,41,37.723892440937746,0.5645727040816326,41.889044943820195,8337.952078802924,94.74945544094231,0
3343,32.0598417130311,2,3,194,0.01015228426395939,0.015228426395939087,0.9847715736040609,197,6200,4100,2100,0.6612903225806451,83,41,42,162.71533633616022,0.47054024655547494,0.7187386687615747,0.10091967865566939,1069881.090852932,-10782.787692433354,1059098.3031604986,3145,0,458.6903553299492,80,117,44,37.450117809082954,0.5672060067681894,41.65380658436215,8282.53806806949,103.53172585086864,0
3344,32.24869953328643,0,0,194,0.0,0.0,1.0,194,5000,3500,1500,0.7,65,35,30,166.65877748322762,0.4694349482755551,0.7215125319600402,0.10340541081432125,1076298.922853974,-7925.067462128278,1068373.8553918456,3146,1,466.7061855670103,77,117,44,37.334160377683595,0.5676546391752577,41.63995726495728,8331.775389569479,108.20487518921401,0
3345,32.366413900017875,1,2,193,0.005128205128205128,0.010256410256410256,0.9897435897435898,195,7000,5600,1400,0.8,84,56,28,165.10337147212343,0.4691779011366641,0.7208980038621595,0.10326238573432883,1082618.791163351,-10251.197511970955,1072367.59365138,3147,0,465.3076923076923,79,116,46,37.08383675661163,0.5697649572649572,41.35416666666669,8371.438095181771,105.96757082508572,0
3346,32.39545615976582,0,2,191,0.0,0.010362694300518135,0.9896373056994818,193,5150,3300,1850,0.6407766990291263,70,33,37,165.068488834051,0.4684823870178469,0.7181983835698658,0.10358086765390333,1084572.3514919037,-7944.256181607379,1076628.0953102962,3148,1,470.96891191709847,79,114,45,36.96561708515744,0.5712435233160622,41.23697916666669,8382.74609717488,106.11071009082127,0
3347,32.22623473339716,1,0,192,0.005208333333333333,0.0,1.0,192,6200,4000,2200,0.6451612903225806,84,40,44,162.88719225311647,0.4678444498981966,0.7129654366775617,0.10266281514907255,1080210.3174455145,-9409.514869690292,1070800.802575824,3149,0,471.6979166666667,79,113,51,36.86326586204004,0.5726996527777778,41.080729166666686,8343.993198875083,105.62016707436814,0
3348,31.81916201708702,0,3,189,0.0,0.015625,0.984375,192,6350,4900,1450,0.7716535433070866,78,49,29,163.50831009802886,0.46732520724258286,0.7141575142715313,0.10348334611765009,1067777.5409855058,-9831.899742566104,1057945.6412429397,3150,1,472.6979166666667,80,112,45,36.69769173492185,0.5745442708333333,40.93364197530865,8243.274419164352,103.0409302395544,0
3349,32.28617710900001,1,0,190,0.005263157894736842,0.0,1.0,190,5850,4500,1350,0.7692307692307693,72,45,27,164.55268713337077,0.4669683467929082,0.7127909435775048,0.10467711012690493,1084955.922866424,-8143.517494212791,1076812.4053722112,3151,0,474.80526315789473,80,110,50,36.48763166162338,0.5764254385964912,40.75360082304526,8370.075158697666,104.62593948372083,0
3350,31.947023683348355,0,0,190,0.0,0.0,1.0,190,5450,3600,1850,0.6605504587155964,73,36,37,165.79928721240196,0.4668349113524552,0.7151137418931066,0.10574444932823926,1074316.0023353554,-7825.834514384143,1066490.1678209712,3152,1,475.80526315789473,83,107,52,36.3624001817052,0.5776315789473685,40.66220238095239,8285.070762523126,99.82012966895333,0
3351,31.94959426211841,0,1,189,0.0,0.005263157894736842,0.9947368421052631,190,6700,4900,1800,0.7313432835820896,85,49,36,165.97748765726695,0.46641023855936137,0.7154785524737846,0.10621562348277264,1075383.462493503,-9002.110925431456,1066381.3515680716,3153,2,476.80526315789473,76,114,50,36.23744286285339,0.5790570175438596,40.54383116883113,8289.51932295946,109.07262267051922,0
3352,31.879249240094737,0,0,189,0.0,0.0,1.0,189,6150,4800,1350,0.7804878048780488,75,48,27,231.9504432112226,0.46614671282224474,0.7871754408073874,0.1446733030494834,1065515.4787696654,5479.357509808495,1070994.8362794737,3154,3,479.3333333333333,67,122,38,35.455178338665725,0.5715939153439153,41.45220588235295,8242.309569153187,123.01954580825652,8
3353,31.795609653651177,1,1,189,0.005263157894736842,0.005263157894736842,0.9947368421052631,190,5500,3700,1800,0.6727272727272727,73,37,36,219.71477349664227,0.466201383087348,0.7749218917119354,0.12884180524380098,1044273.0908134576,2388.4451233432965,1046661.5359368009,3155,0,477.80526315789473,70,120,40,38.0748277901807,0.5538377192982455,43.705985915492946,8149.024428398336,116.4146346914048,8
3354,31.757830319648725,1,2,188,0.005263157894736842,0.010526315789473684,0.9894736842105263,190,5950,4400,1550,0.7394957983193278,75,44,31,215.83976926774625,0.4659466954423095,0.7743770819453708,0.1295694663537378,1050104.6658882939,1380.869758462482,1051485.5356467564,3156,0,478.7473684210526,79,111,37,37.287974683544306,0.5554276315789474,42.83854166666666,8166.889958503389,103.37835390510618,8
3355,31.32724885636238,1,3,186,0.005291005291005291,0.015873015873015872,0.9841269841269842,189,6750,4600,2150,0.6814814814814815,89,46,43,213.72753593884286,0.4658042984727382,0.770471683530465,0.12891718250578602,1037281.3799483653,-210.88131767866525,1037070.4986306865,3157,0,481.18518518518516,68,121,36,37.16304411592162,0.5575947971781305,42.66304347826087,8061.658876895426,118.55380701316803,0
3356,30.9278358481222,0,2,184,0.0,0.010752688172043012,0.989247311827957,186,5800,4200,1600,0.7241379310344828,74,42,32,214.79477649322953,0.46518938293131845,0.7677551045408739,0.13033951957617188,1025798.4536779441,1067.2299169710009,1026865.6835949151,3158,1,485.05913978494624,70,116,38,36.91208582550082,0.5599238351254481,42.44424882629109,7965.641994040293,113.79488562914705,0
3357,31.27680200031324,2,1,185,0.010752688172043012,0.005376344086021506,0.9946236559139785,186,5600,3600,2000,0.6428571428571429,76,36,40,212.3456790123451,0.4653074445413155,0.7654284783317027,0.1297668038408779,1039442.058665198,1344.2059482503732,1040786.2646134484,3159,0,485.0483870967742,75,111,42,36.71296296296293,0.562219982078853,42.18750000000001,8063.550515705779,107.51400687607705,0
3358,31.257613495743243,1,2,184,0.005376344086021506,0.010752688172043012,0.989247311827957,186,5900,3900,2000,0.6610169491525424,79,39,40,208.49311369160162,0.4652638525622397,0.7622286782875853,0.12811981413873225,1040419.2855018805,284.05127581566694,1040703.3367776962,3160,0,480.66129032258067,77,109,36,36.60778985507248,0.563788082437276,41.98717948717949,8064.8650205363165,104.7385067602119,0
3359,31.126684727279212,1,0,185,0.005405405405405406,0.0,1.0,185,6650,5000,1650,0.7518796992481203,83,50,33,212.099295235753,0.4646555522914218,0.7672757461153357,0.1312084507763597,1037992.7294421605,381.5052749037095,1038374.2347170642,3161,0,484.24864864864867,77,108,40,36.269262591788184,0.5656531531531532,41.74679487179488,8038.566095835037,104.39696228357191,0
3360,30.928003674157413,0,0,185,0.0,0.0,1.0,185,5950,4500,1450,0.7563025210084033,74,45,29,213.709119593119,0.46466044849197025,0.7684512041838509,0.13272297862684443,1032489.8730885622,1180.5003533136455,1033670.3734418758,3162,1,485.24864864864867,68,117,40,36.08417075640726,0.5670608108108108,41.60628019323672,7991.60191556279,117.52355758180573,0
3361,31.154332613571153,0,1,184,0.0,0.005405405405405406,0.9945945945945946,185,5350,4000,1350,0.7476635514018691,67,40,27,216.0984335247568,0.4643213866039953,0.7712353633858133,0.1345468137749414,1040774.8628917307,2631.9635045693535,1043406.8263963001,3163,2,486.24864864864867,68,117,41,35.929895261456984,0.5685247747747748,41.51570048309179,8052.905842535713,118.42508591964284,0
3362,31.408284257799277,0,1,183,0.0,0.005434782608695652,0.9945652173913043,184,5300,3800,1500,0.7169811320754716,68,38,30,219.66071751712212,0.46394321196642113,0.7730792659712185,0.13722786619505126,1050239.372441897,4039.2668230638637,1054278.6392649608,3164,3,489.7608695652174,68,116,37,35.71438995913602,0.5696897644927537,41.39492753623189,8122.341626450818,119.44620038898262,0
3363,31.87665751371896,1,0,184,0.005434782608695652,0.0,1.0,184,5850,4200,1650,0.717948717948718,75,42,33,218.6861060346642,0.46335110279559677,0.7710459943357924,0.1371869872476313,1067119.8800309384,4022.858247228783,1071142.7382781673,3165,0,490.6195652173913,71,113,41,35.5885402106048,0.5713315217391304,41.24710648148148,8248.177367373604,116.17151221652963,0
3364,32.177252694690274,2,4,182,0.010752688172043012,0.021505376344086023,0.978494623655914,186,6250,3700,2550,0.592,88,37,51,212.92770414227687,0.46270948367722564,0.7671443914193623,0.13446131443930934,1079138.7533289716,2505.7074394594792,1081644.460768431,3166,0,486.3333333333333,77,109,38,35.49772039739425,0.5740367383512545,41.01228632478634,8333.513107747474,108.22744295775941,0
3365,31.6763570919757,0,2,180,0.0,0.01098901098901099,0.989010989010989,182,6000,4800,1200,0.8,72,48,24,218.05616207486685,0.4623492299597272,0.768488268488269,0.13830217565748065,1063606.1314626108,3985.1741972065724,1067591.3056598173,3167,2,490.5659340659341,75,107,42,35.20725348636308,0.5748626373626373,40.858004385964904,8208.674390597354,109.44899187463139,0
3366,31.97427641347353,0,0,180,0.0,0.0,1.0,180,6100,4900,1200,0.8032786885245902,73,49,24,236.05742254218185,0.4616949875853507,0.7778602172449773,0.1401313495150603,1053876.4576305295,7655.072053229544,1061531.529683759,3168,7,496.81666666666666,72,108,34,37.189809926082354,0.5548032407407407,43.25057077625571,8209.377219001557,114.01912804168829,8
3367,31.573614723810635,0,1,179,0.0,0.005555555555555556,0.9944444444444445,180,6400,4900,1500,0.765625,79,49,30,243.75886246407512,0.4611822367059797,0.7820090805902373,0.14552380491926004,1042364.7660631387,8417.129929636685,1050781.8959927754,3169,8,497.81666666666666,74,106,34,36.778079563266864,0.556712962962963,43.04166666666668,8113.103416739203,109.63653265863788,0
3368,31.262992001378347,1,1,179,0.005555555555555556,0.005555555555555556,0.9944444444444445,180,5250,3800,1450,0.7238095238095238,67,38,29,247.17192583973574,0.4611576660459342,0.7853429848713629,0.14851684881148347,1034017.8375064286,9866.036049820428,1043883.8735562491,3170,0,498.59444444444443,75,105,36,36.447120081712406,0.5584490740740741,42.804276315789465,8040.707852328168,107.20943803104224,0
3369,31.322826052247144,1,1,179,0.005555555555555556,0.005555555555555556,0.9944444444444445,180,5700,4100,1600,0.7192982456140351,73,41,32,244.0846209622594,0.46121585971446305,0.783503808852646,0.14742141189457134,1037521.8263033584,8948.624342665182,1046470.4506460236,3171,0,499.4611111111111,66,114,36,36.332678948958005,0.5605324074074074,42.615049751243774,8062.024025108065,122.15187916830402,0
3370,31.62504645933276,1,0,180,0.005555555555555556,0.0,1.0,180,4700,3100,1600,0.6595744680851063,63,31,32,237.6884663812079,0.46118094351334576,0.7769943425598955,0.144406023969594,1049281.709119276,9180.4320484829,1058462.1411677587,3172,0,499.23333333333335,70,110,40,36.277385427345564,0.5628472222222223,42.400234741784054,8146.604544204334,116.38006491720478,0
3371,31.62057337485826,2,1,181,0.01098901098901099,0.005494505494505495,0.9945054945054945,182,5700,3900,1800,0.6842105263157895,75,39,36,237.28338737286964,0.46147964604456315,0.7790323625294151,0.14551475201541084,1051899.8803698113,7819.673358253196,1059719.5537280645,3173,0,494.7362637362637,73,109,38,35.94034235610858,0.5651900183150182,42.06081081081082,8156.185058008229,111.7285624384689,0
3372,31.779903250068152,1,0,182,0.005494505494505495,0.0,1.0,182,4700,3300,1400,0.7021276595744681,61,33,28,235.89010453214743,0.46140438750935986,0.7778159340659334,0.1453853297320584,1058680.0701363203,8846.43048211157,1067526.500618432,3174,0,495.1923076923077,77,105,42,35.79155456677702,0.56753663003663,41.88034188034188,8203.017761983408,106.53269820757673,0
3373,31.687099014440538,1,1,182,0.00546448087431694,0.00546448087431694,0.994535519125683,183,5100,3500,1600,0.6862745098039216,67,35,32,233.0168448589939,0.46141711203186614,0.7769015887320994,0.144160328972838,1056705.3516496036,7546.029397400922,1064251.3810470046,3175,0,493.4808743169399,80,103,45,35.726023304451736,0.5690459927140255,41.74382716049383,8183.388919855908,102.29236149819886,0
3374,31.417497756816996,0,1,181,0.0,0.005494505494505495,0.9945054945054945,182,4800,3400,1400,0.7083333333333334,62,34,28,231.20447450572243,0.46134177746746813,0.7745037220843665,0.14334677419354838,1048340.8105660153,7276.217241963883,1055617.0278079791,3176,1,496.7197802197802,80,102,45,35.69388440860217,0.5702266483516483,41.66666666666668,8116.186920511087,101.45233650638859,0
3375,31.42953403009487,1,1,181,0.005494505494505495,0.005494505494505495,0.9945054945054945,182,5900,4600,1300,0.7796610169491526,72,46,26,229.27935927866764,0.46106224576528443,0.7749613105043653,0.14340731776074317,1051294.6933825936,5908.03474236475,1057202.7281249582,3177,0,496.9945054945055,62,120,43,35.422260222889896,0.5724015567765568,41.352513227513214,8129.169987314359,131.1156449566832,0
3376,31.851532332974507,0,2,179,0.0,0.011049723756906077,0.988950276243094,181,6050,4300,1750,0.7107438016528925,78,43,35,227.75934418346105,0.4607594127276448,0.7768218707445234,0.1386737272813222,1057442.942423528,5918.502215562285,1063361.4446390904,3178,1,500.35911602209944,69,112,36,36.45255832755832,0.5603706261510129,42.32142857142856,8207.457349371804,118.94865723727251,8
3377,31.688860964044537,0,0,179,0.0,0.0,1.0,179,5000,3600,1400,0.72,64,36,28,227.41542597542477,0.46038384282217065,0.7750287086998497,0.13894797862448374,1053076.348908916,7097.161294353086,1060173.5102032693,3179,2,505.731843575419,70,109,37,36.33194855451853,0.5626745810055866,42.19483568075116,8169.552007925305,116.70788582750436,0
3378,31.843161738510883,2,3,178,0.011049723756906077,0.016574585635359115,0.9834254143646409,181,4650,3400,1250,0.7311827956989247,59,34,25,224.25483755246958,0.4607542971147944,0.7747303699891954,0.13827791563675823,1060923.8638595098,6733.461749070571,1067657.3256085804,3180,0,501.1325966850829,73,108,36,36.07490820518413,0.5645718232044199,41.86373873873874,8219.874717916848,112.60102353310751,0
3379,31.647559767736634,0,1,177,0.0,0.0056179775280898875,0.9943820224719101,178,5300,3600,1700,0.6792452830188679,70,36,34,220.6282636325969,0.4601768975221651,0.7669617635422459,0.13205154776122058,1045570.7865286396,5236.493427356319,1050807.279955996,3181,1,510.0730337078652,73,105,37,37.27633344285634,0.5562968164794008,42.94763513513512,8135.080080498828,111.43945315751819,8
3380,31.629587321111426,1,2,176,0.0056179775280898875,0.011235955056179775,0.9887640449438202,178,5800,4500,1300,0.7758620689655172,71,45,26,227.26401588725534,0.45982048392898706,0.7704752901468241,0.14030590472694138,1054169.852397764,6514.974816638374,1060684.8272144024,3182,0,511.0280898876405,74,104,37,35.95192945648862,0.5674742509363295,41.81944444444446,8166.144426557536,110.35330306158832,8
3381,31.42022119518755,1,0,177,0.005649717514124294,0.0,1.0,177,5900,4200,1700,0.711864406779661,76,42,34,228.4497068091842,0.4593231039205616,0.7697205324323946,0.14170309480977725,1048563.8014182082,6608.81860094291,1055172.6200191511,3183,0,514.8361581920904,63,114,38,35.74840137340138,0.5689736346516008,41.65039062500002,8117.401872252845,128.8476487659182,0
3382,31.537446369167366,0,0,177,0.0,0.0,1.0,177,5300,3300,2000,0.6226415094339622,73,33,40,241.52541553430117,0.4592736153912001,0.7891372239271626,0.14456907176799502,1041953.6129675385,9631.65586788995,1051585.2688354284,3184,1,515.8361581920904,65,112,38,36.73654601829678,0.558674670433145,42.94507575757574,8106.855887225793,124.72085980347373,8
3383,31.133142506761647,1,1,177,0.0056179775280898875,0.0056179775280898875,0.9943820224719101,178,5700,3900,1800,0.6842105263157895,75,39,36,211.0466561147562,0.45975502020779113,0.7611078749938591,0.12468106879694664,1024722.9157225172,1952.8689614801528,1026675.7846839973,3185,0,513.9325842696629,64,114,39,38.014652300645416,0.5520833333333333,43.42948717948719,7987.846338673963,124.81009904178067,8
3384,31.592132416049,0,3,174,0.0,0.01694915254237288,0.9830508474576272,177,6400,5300,1100,0.828125,75,53,22,207.6022523399999,0.4593231039205616,0.7558166875574592,0.12320561250692372,1041198.5186608873,1431.0315214143757,1042629.5501823017,3186,1,517.7514124293785,65,112,43,37.930767299850416,0.553966572504708,43.260732323232325,8110.940940843895,124.78370678221377,0
3385,31.240521458638074,4,4,174,0.02247191011235955,0.02247191011235955,0.9775280898876404,178,4000,2800,1200,0.7,52,28,24,196.99458380588595,0.4596617839988151,0.7438863185723721,0.11779228479675419,1031837.3481380239,1053.2737903638708,1032890.6219283878,3187,0,514.6910112359551,71,107,41,37.92012618444506,0.5567064606741573,42.983217592592595,8029.338306028732,113.08927191589764,0
3386,31.346588346927614,2,1,175,0.011363636363636364,0.005681818181818182,0.9943181818181818,176,6350,5100,1250,0.8031496062992126,76,51,25,201.2635706322873,0.45924986471861473,0.7467827475489355,0.12088217766454978,1036660.4865904939,178.39821292147826,1036838.8848034154,3188,0,520.8636363636364,74,102,44,37.6433367536138,0.5586529356060606,42.81944444444445,8061.7330058341595,108.94233791667783,0
3387,31.538065777805876,2,2,175,0.011299435028248588,0.011299435028248588,0.9887005649717514,177,5600,3500,2100,0.625,77,35,42,209.79217710588495,0.4602941491183017,0.7502503783069028,0.12268169482193522,1034975.0036785897,2425.9318543804893,1037400.9355329702,3189,0,504.64406779661016,86,91,41,38.43519730180244,0.5484345574387948,43.80986590038314,8079.741300858608,93.95048024254196,8
3388,31.711917903508013,2,2,175,0.011299435028248588,0.011299435028248588,0.9887005649717514,177,4800,3200,1600,0.6666666666666666,64,32,32,202.18944528729537,0.4604559899845917,0.7401910164443051,0.11908861586060261,1042860.3217486454,1971.069993297533,1044831.391741943,3190,0,505.44632768361583,74,103,43,38.35634985106959,0.5504354990583804,43.54166666666665,8132.785612337119,109.90250827482593,0
3389,32.0603702524554,1,1,175,0.005681818181818182,0.005681818181818182,0.9943181818181818,176,5500,3700,1800,0.6727272727272727,73,37,36,234.2572745273489,0.46001826298701304,0.7595371677013587,0.1346810121833164,1046870.6508419809,8347.41308978303,1055218.0639317639,3191,0,508.8238636363636,72,104,37,38.462737543507025,0.5417258522727273,44.449200913242024,8193.053237032333,113.7924060698935,8
3390,31.904058230747875,2,0,177,0.011299435028248588,0.0,1.0,177,5250,3600,1650,0.6857142857142857,69,36,33,251.1529358919761,0.46008683230611197,0.7796906224557771,0.14450759376699118,1042007.5818610041,11690.65268121794,1053698.234542222,3192,0,506.93220338983053,69,108,32,38.00066715186802,0.5436087570621468,44.419642857142854,8154.050596921045,118.17464633218906,8
3391,31.66468877095706,3,1,179,0.016666666666666666,0.005555555555555556,0.9944444444444445,180,6100,4500,1600,0.7377049180327869,77,45,32,260.4897518608715,0.4608291951169046,0.792875844619386,0.1517479080785073,1037970.1779205786,11976.11881710312,1049946.2967376818,3193,0,499.46666666666664,76,104,36,37.28315809865975,0.5467592592592593,43.95292207792207,8107.651033115566,106.67961885678376,0
3392,31.599606188795565,2,0,181,0.011049723756906077,0.0,1.0,181,6450,4400,2050,0.6821705426356589,85,44,41,234.28272970671128,0.46143851033353794,0.7825229803094402,0.13671435239847335,1036354.923896455,5910.012103090563,1042264.9359995455,3194,0,497.5966850828729,74,107,36,37.88864786695589,0.5441988950276243,43.88888888888889,8093.010251685983,109.36500340116194,8
3393,31.502754417236687,1,3,179,0.005494505494505495,0.016483516483516484,0.9835164835164835,182,6000,3900,2100,0.65,81,39,42,239.25169416615304,0.4615131645518386,0.7880973785292276,0.1407968502520265,1035722.958073516,7159.69448117345,1042882.6525546894,3195,0,495.85714285714283,64,118,37,37.43867570776828,0.546474358974359,43.573717948717935,8078.134189586576,126.22084671229025,0
3394,31.05092715461836,2,2,179,0.011049723756906077,0.011049723756906077,0.988950276243094,181,4550,3300,1250,0.7252747252747253,58,33,25,231.8442741195848,0.46194495600572943,0.7796498572349049,0.13754392768607487,1023257.4836158339,6697.277705268931,1029954.7613211029,3196,0,499.0828729281768,69,112,38,37.321759795965676,0.5487453959484346,43.273809523809504,7971.586239158826,115.53023535012791,0
3395,30.900147695347805,1,1,179,0.005555555555555556,0.005555555555555556,0.9944444444444445,180,5500,4100,1400,0.7454545454545455,69,41,28,235.89581924747284,0.4623868456445272,0.7858678434034858,0.13626452617706963,1010394.7627145923,6169.580062782959,1016564.3427773752,3197,0,493.56666666666666,63,117,42,38.23828920570266,0.5397569444444444,44.270833333333336,7902.069020008217,125.42966698425741,8
3396,31.028014978609544,0,1,178,0.0,0.00558659217877095,0.994413407821229,179,5000,3700,1300,0.74,63,37,26,236.87285437077895,0.46217803862490325,0.7853315377844341,0.13730949504684373,1015624.7214776671,7314.78534918826,1022939.5068268554,3198,1,497.24581005586595,66,113,37,38.07802151060335,0.5414338919925512,44.13868159203978,7938.868820008937,120.28589121225663,0
3397,30.951245397311013,0,0,178,0.0,0.0,1.0,178,5050,3300,1750,0.6534653465346535,68,33,35,235.40941452702782,0.46136516324932814,0.7831232696390928,0.13686064829233766,1013982.5743102313,7090.2088317960115,1021072.7831420272,3199,2,501.0280898876405,70,108,38,38.00295179687052,0.5428955992509363,44.0287558685446,7922.628791767681,113.18041131096687,0
3398,30.795283155658158,0,0,178,0.0,0.0,1.0,178,5550,3600,1950,0.6486486486486487,75,36,39,234.50809867967132,0.4611555470915593,0.7828238066638642,0.13661370409587928,1009473.9787798835,6195.9646860545145,1015669.943465938,3200,3,502.0280898876405,71,107,39,37.948026142313594,0.5443586142322097,43.95254629629628,7885.0538380908065,111.05709631113812,0
3399,31.0794154699411,1,1,178,0.00558659217877095,0.00558659217877095,0.994413407821229,179,5950,4500,1450,0.7563025210084033,74,45,29,234.60545769266932,0.46136986587994055,0.7764825795711416,0.13803376999358796,1021742.7710995687,6191.286091597961,1027934.0571911667,3201,0,500.21787709497204,67,112,37,37.56577702769975,0.5474278398510242,43.5814950980392,7969.3372480291355,118.94533206013635,8
3400,30.83729611675084,3,1,180,0.016574585635359115,0.0055248618784530384,0.994475138121547,181,5300,3500,1800,0.660377358490566,71,35,36,228.20780612376518,0.4618937998772253,0.7715658219046313,0.13524112267360575,1015902.2571042528,4867.365065988445,1020769.6221702413,3202,0,495.585635359116,73,108,40,37.455842701764,0.5500115101289134,43.31362612612612,7915.513720283643,108.43169479840607,0
3401,31.171628893733953,1,1,180,0.0055248618784530384,0.0055248618784530384,0.994475138121547,181,5750,4200,1550,0.7304347826086957,73,42,31,229.45833914719384,0.4615664006547984,0.7733173665732258,0.13700012602023562,1029123.2615621495,5278.182875158551,1034401.444437308,3203,0,496.3259668508287,78,103,36,37.14176672824301,0.552255985267035,43.037974683544284,8009.924892946779,102.69134478136897,0
3402,30.72424697328727,0,3,177,0.0,0.016666666666666666,0.9833333333333333,180,5100,3300,1800,0.6470588235294118,69,33,36,226.6807675024132,0.46102188081936685,0.7708201111786304,0.13598091727331818,1015722.4436784443,4948.948620491003,1020671.3922989352,3204,1,498.97777777777776,79,101,38,37.03581797312806,0.5539351851851853,42.864583333333314,7900.292047245748,100.00369680057909,0
3403,30.95901228126464,1,0,178,0.0056179775280898875,0.0,1.0,178,4850,3200,1650,0.6597938144329897,65,32,33,214.65530140109664,0.4598522239150215,0.7597076445090851,0.12493656996294339,1014574.9939066076,3106.7802222077203,1017681.7741288154,3205,0,505.5449438202247,74,104,43,38.49063726287997,0.544066011235955,43.986111111111114,7925.937130285438,107.10725851737078,8
3404,30.911200126945722,5,0,183,0.0273224043715847,0.0,1.0,183,6200,4700,1500,0.7580645161290323,77,47,30,204.95877375259514,0.4612419684140996,0.7553012025436636,0.12049822238695296,1015986.1393352974,-1152.9453464410576,1014833.1939888564,3206,0,492.7049180327869,66,117,46,38.35513815616601,0.5470742258652095,43.610074626865654,7925.3202937415945,120.08061051123627,0
3405,31.394584713369408,1,2,182,0.005434782608695652,0.010869565217391304,0.9891304347826086,184,6050,4300,1750,0.7107438016528925,78,43,35,199.43766570058122,0.461701611625881,0.7509808382086431,0.11817589473271405,1034222.650934699,-1597.4097365835978,1032625.2411981154,3207,0,491.0217391304348,69,115,47,38.19925551239685,0.549026268115942,43.31845238095236,8058.410591084905,116.78855929108558,0
3406,31.626859131537167,0,1,181,0.0,0.005494505494505495,0.9945054945054945,182,5650,3800,1850,0.672566371681416,75,38,37,204.49423612906654,0.4611944225203894,0.7549896208380737,0.12173513294341462,1043267.290057715,618.4295117585561,1043885.7195694735,3208,1,496.92857142857144,75,107,41,37.89443258626822,0.5518543956043955,43.14692982456139,8123.455867941396,108.31274490588528,8
3407,31.219695431021517,1,0,182,0.005494505494505495,0.0,1.0,182,5550,3800,1750,0.6846846846846847,73,38,35,207.84416881468817,0.461131180053832,0.7593971889373303,0.1242609825672152,1031104.840508326,911.8257072507322,1032016.6662155767,3209,0,497.8296703296703,77,105,39,37.646953754221855,0.5540293040293041,42.98878205128204,8023.811946714829,104.20534995733544,0
3408,31.07389666648603,1,0,183,0.00546448087431694,0.0,1.0,183,5750,4200,1550,0.7304347826086957,73,42,31,205.30091471304107,0.46110935967493344,0.7568531353095727,0.12325874724245231,1027527.3189903164,-159.54030373012301,1027367.7786865862,3210,0,496.10382513661204,82,101,41,37.55419045759927,0.5556124772313297,42.83383534136544,7991.154826718891,97.45310764291331,0
3409,31.244756140148603,1,4,180,0.005434782608695652,0.021739130434782608,0.9782608695652174,184,5400,3800,1600,0.7037037037037037,70,38,32,219.45722863665225,0.4610897036113091,0.7762329005837765,0.128488786394205,1025711.3475571399,2819.9539432112515,1028531.3015003512,3211,0,494.4021739130435,70,114,40,38.141401851321675,0.5455729166666667,43.76467136150235,8006.010357800705,114.37157654001007,8
3410,31.397087616098595,2,2,180,0.01098901098901099,0.01098901098901099,0.989010989010989,182,4050,2300,1750,0.5679012345679012,58,23,35,209.78975935062448,0.4607175743225467,0.763070263070263,0.12367164266691534,1032765.0842202682,2882.707696859538,1035647.7919171277,3212,0,499.989010989011,64,118,43,38.12870977819433,0.5477335164835164,43.509615384615394,8053.051078456076,125.82892310087618,0
3411,31.166493659960643,0,1,179,0.0,0.005555555555555556,0.9944444444444445,180,6250,4300,1950,0.688,82,43,39,207.47714676846414,0.4594551779433064,0.757689105366137,0.12278414738914264,1026333.2967032356,338.14080669204213,1026671.4375099277,3213,1,506.3833333333333,64,116,43,38.0408028391824,0.5491319444444445,43.365384615384635,7998.401113311092,124.9750173954858,0
3412,31.48012782434518,1,1,179,0.005555555555555556,0.005555555555555556,0.9944444444444445,180,4800,3100,1700,0.6458333333333334,65,31,34,208.0674051440385,0.4596724343058142,0.7587758459448579,0.12401000196007066,1038783.1138976217,2427.3814032246646,1041210.4953008464,3214,0,506.97222222222223,65,115,40,37.75771282586885,0.5507523148148148,43.10290404040406,8087.15341851119,124.41774490017215,0
3413,31.80290749944869,0,1,178,0.0,0.00558659217877095,0.994413407821229,179,5700,4000,1700,0.7017543859649122,74,40,34,204.85423790453729,0.459386050258406,0.7533842496720631,0.12259108816113218,1050655.7747620866,1546.257607777824,1052202.0323698644,3215,1,510.659217877095,67,112,41,37.68772348033374,0.5527816573556796,42.95343137254903,8174.828245109538,122.01236186730654,0
3414,32.072433217608044,1,0,179,0.00558659217877095,0.0,1.0,179,4650,3200,1450,0.6881720430107527,61,32,29,202.12341160694362,0.4595639005712133,0.7504757461854259,0.12152358204022484,1060976.2792613436,2439.629039669091,1063415.9083010128,3216,0,510.4804469273743,70,109,44,37.582705909194644,0.5547020484171322,42.78169014084509,8249.61706530381,117.851672361483,0
3415,31.66344263461856,2,0,181,0.011049723756906077,0.0,1.0,181,6400,4700,1700,0.734375,81,47,34,203.0447061211628,0.4604051565377532,0.7543529341135613,0.12315765495778387,1050071.6788525276,42.299087753698586,1050113.9779402814,3217,0,505.82872928176795,66,115,45,37.230355166515736,0.5568600368324126,42.45957711442788,8154.61640613276,123.55479403231455,0
3416,31.93905162843008,2,2,181,0.01092896174863388,0.01092896174863388,0.9890710382513661,183,5400,4300,1100,0.7962962962962963,65,43,22,197.73492500765212,0.4606327188294401,0.7506540818016232,0.12083800972689883,1061451.0261035298,-22.812190824467507,1061428.2139127054,3218,0,501.2896174863388,69,114,47,37.08964646464647,0.5590846994535519,42.187500000000014,8234.286747954657,119.33748910079213,0
3417,31.96598208915303,1,3,179,0.005494505494505495,0.016483516483516484,0.9835164835164835,182,6700,5400,1300,0.8059701492537313,80,54,26,198.134658323083,0.4604709287029729,0.7457410830187388,0.11822773549106147,1055168.5731545535,-1286.9070569534665,1053881.6660976,3219,0,504.032967032967,79,103,39,37.969021858477326,0.5555173992673993,43.059895833333336,8213.34276777679,103.9663641490733,7
3418,32.12401805224936,3,2,180,0.016483516483516484,0.01098901098901099,0.989010989010989,182,5450,3800,1650,0.6972477064220184,71,38,33,193.14859519214386,0.46095283629814016,0.7381288884474533,0.11607834986213511,1062554.1222337906,-803.8327949844188,1061750.2894388062,3220,0,504.22527472527474,81,101,45,37.82942123112882,0.55746336996337,42.79725609756097,8262.385588210007,102.00476034827169,0
3419,32.26856058875745,2,1,181,0.01098901098901099,0.005494505494505495,0.9945054945054945,182,6100,4100,2000,0.6721311475409836,81,41,40,209.3133674214757,0.46136517718009434,0.7615384615384617,0.12491281604184826,1065192.4056232853,2091.801874558393,1067284.2074978438,3221,0,503.96153846153845,71,111,39,37.67736486486484,0.5536858974358974,43.05555555555555,8291.227373500167,116.77785033098827,8
3420,32.659200295937445,2,1,182,0.01092896174863388,0.00546448087431694,0.994535519125683,183,5450,4200,1250,0.7706422018348624,67,42,25,211.9085491722878,0.4613583138173302,0.7658434345156793,0.12707556005190365,1079584.2789342701,3704.6276516340035,1083288.906585904,3222,0,502.1912568306011,73,110,41,37.42860140881049,0.5542463570127505,42.87725225225223,8397.423319335436,115.03319615527994,8
3421,32.35402760658717,2,1,183,0.010869565217391304,0.005434782608695652,0.9945652173913043,184,5750,3500,2250,0.6086956521739131,80,35,45,194.76922751522136,0.46168861863467175,0.74697867160254,0.11661672280602914,1069022.4734546533,-907.4637297654008,1068115.0097248878,3223,0,500.3967391304348,82,102,40,37.92738693876222,0.5561028079710144,42.93423694779115,8317.112794499513,101.42820481096967,7
3422,32.211324074968815,1,3,181,0.005434782608695652,0.016304347826086956,0.9836956521739131,184,6000,4100,1900,0.6833333333333333,79,41,38,204.39609894330084,0.4611441504316148,0.7588209631307319,0.12453060970999258,1069586.0408489355,923.8428467465965,1070509.883695682,3224,0,501.3858695652174,70,114,43,37.03019736217858,0.562896286231884,42.297535211267615,8300.937608228118,118.5848229746874,8
3423,32.03179814414519,0,1,180,0.0,0.0055248618784530384,0.994475138121547,181,5050,3200,1850,0.6336633663366337,69,32,37,205.0483601853383,0.4601660016369961,0.7553731606222696,0.12513491818878222,1064120.9320659344,2389.2504318027777,1066510.1824977372,3225,1,509.34806629834253,72,109,42,36.952063957779764,0.5650322283609577,42.237442922374434,8256.598197429217,114.67497496429468,0
3424,32.16815108791094,0,2,178,0.0,0.011111111111111112,0.9888888888888889,180,5700,4100,1600,0.7192982456140351,73,41,32,202.3931656528282,0.4596976515621767,0.7502268316351275,0.12392522709758787,1069648.62531523,1597.9142827492342,1071246.5395979793,3226,2,509.3777777777778,73,107,47,36.89774381368264,0.5668981481481481,42.11711711711713,8295.615539562657,113.6385690351049,0
3425,32.482156068102576,0,1,177,0.0,0.0056179775280898875,0.9943820224719101,178,5150,3500,1650,0.6796116504854369,68,35,33,201.00594597910566,0.45921345669607905,0.7458311303828107,0.12338018640502038,1080838.3420051339,2700.986677046064,1083539.32868218,3227,3,513.7471910112359,74,104,38,36.84238272136679,0.5682935393258427,42.027777777777786,8379.493983457482,113.23640518185786,0
3426,32.8963168795355,0,2,175,0.0,0.011299435028248588,0.9887005649717514,177,5800,3900,1900,0.6724137931034483,77,39,38,202.15633419570338,0.4589071327683616,0.7445638173036742,0.12427179551368708,1095077.385229871,3075.36597173734,1098152.7512016082,3228,4,516.8305084745763,77,100,38,36.75766221555129,0.5697975517890772,41.97382478632478,8488.110823043604,110.23520549407277,0
3427,32.385284338845274,0,1,174,0.0,0.005714285714285714,0.9942857142857143,175,5600,3900,1700,0.6964285714285714,73,39,34,240.30715713813646,0.4581650246305418,0.7820485305825753,0.14228803981478994,1066631.899119318,10663.855878042812,1077295.7549973608,3229,5,522.3142857142857,66,109,38,37.17818633389873,0.5557142857142857,43.345771144278594,8311.820178259575,125.93666936756932,8
3428,32.85796568993135,2,2,174,0.011363636363636364,0.011363636363636364,0.9886363636363636,176,4850,3300,1550,0.6804123711340206,64,33,31,222.7012943967602,0.4582832792207792,0.7634271967993453,0.13440657802580752,1088141.4680648223,8416.102684965472,1096557.5707497876,3230,0,520.2897727272727,62,114,49,36.910804154620386,0.5601325757575757,42.64219576719577,8456.253901517564,136.3911919599607,8
3429,32.806559821465825,1,0,175,0.005714285714285714,0.0,1.0,175,5200,3700,1500,0.7115384615384616,67,37,30,216.5779091985665,0.45801313628899837,0.7561494031574891,0.13172197428306331,1088813.585162617,6962.593956303294,1095776.1791189204,3231,0,523.4971428571429,65,110,49,36.781221922731355,0.5626785714285714,42.361111111111136,8452.245620669373,130.03454801029804,0
3430,32.45324522661045,2,0,177,0.011299435028248588,0.0,1.0,177,4750,3000,1750,0.631578947368421,65,30,35,212.8471117841801,0.4585299499229584,0.7547635926188474,0.1301832334866038,1078795.9049785805,5773.718515858595,1084569.623494439,3232,0,518.5706214689266,67,110,49,36.66874603929024,0.5641478342749529,42.15686274509806,8367.846563331956,124.89323228853665,0
3431,32.44903837575527,1,6,172,0.0056179775280898875,0.033707865168539325,0.9662921348314607,178,5000,3600,1400,0.72,64,36,28,211.9191614705016,0.45847550202077914,0.7563003818142198,0.13037587027298606,1080425.8580022028,5192.58837177506,1085618.446373978,3233,0,516.6516853932584,70,108,40,36.476751568215,0.5658356741573034,41.945422535211286,8373.622887194286,119.62318410277551,0
3432,32.726350228319575,0,1,171,0.0,0.005813953488372093,0.9941860465116279,172,5200,3800,1400,0.7307692307692307,66,38,28,231.07290594993174,0.45665388843555915,0.7673274655469426,0.13864374356995884,1081973.2116301563,10402.938834272058,1092376.1504644284,3234,3,534.2558139534884,69,103,39,36.91526813271605,0.5549297480620154,42.857142857142854,8415.347201567882,121.96155364591132,8
3433,32.35688330276882,0,1,170,0.0,0.005847953216374269,0.9941520467836258,171,5100,3600,1500,0.7058823529411765,66,36,30,226.68786572472854,0.4563381492948056,0.7607074366077127,0.1365656166683124,1070996.686967572,9256.390633386985,1080253.077600959,3235,4,537.7017543859649,68,103,40,36.87584345479081,0.556712962962963,42.70833333333334,8325.156433108254,122.42877107512138,0
3434,32.69658772207663,0,1,169,0.0,0.0058823529411764705,0.9941176470588236,170,4750,2800,1950,0.5894736842105263,67,28,39,228.7873695543304,0.4558040375913679,0.7604223809924888,0.138314321307912,1083319.5356745177,10819.96539075852,1094139.5010652763,3236,5,541.7941176470588,64,106,39,36.690686671232015,0.5584558823529412,42.58012820512822,8416.751419546774,131.51174093041834,0
3435,32.55904345109891,3,1,171,0.01744186046511628,0.005813953488372093,0.9941860465116279,172,4750,3700,1050,0.7789473684210526,58,37,21,219.54461721576462,0.45637622399020805,0.7528226564487046,0.13382676232021903,1081284.231111697,8328.026524172255,1089612.257635869,3237,0,536.4418604651163,67,105,44,36.62129497543193,0.5606225775193798,42.279411764705905,8391.135830595766,125.24083329247411,0
3436,32.31973165327785,2,0,173,0.011560693641618497,0.0,1.0,173,5050,3500,1550,0.693069306930693,66,35,31,200.12618219858967,0.45672861495720746,0.7311512633402926,0.1153402622017322,1056105.0614283264,2620.854788851741,1058725.916217178,3238,0,534.2312138728323,78,95,40,39.240445120693195,0.5453395953757225,44.3565400843882,8262.328023388103,105.92728235112953,8
3437,32.41193841285215,0,1,172,0.0,0.005780346820809248,0.9942196531791907,173,4550,3300,1250,0.7252747252747253,58,33,25,199.0909277041823,0.4567496191244343,0.7303167420814471,0.11518087702257725,1060308.082040708,3069.543941145651,1063377.6259818538,3239,1,535.2312138728323,80,93,43,39.120475113122204,0.5466040462427746,44.21296296296298,8290.553691250425,103.63192114063031,0
3438,32.754517793731296,1,1,172,0.005780346820809248,0.005780346820809248,0.9942196531791907,173,4800,3200,1600,0.6666666666666666,64,32,32,198.40092605705217,0.45695545996325676,0.7291028270629221,0.1153427195628861,1073052.9297734604,3178.938995057875,1076231.8687685183,3240,0,534.1040462427745,81,92,36,38.95099255583126,0.5490125240847784,44.02947154471547,8384.191228959486,103.50853369085785,0
3439,32.866211860211806,2,0,174,0.011494252873563218,0.0,1.0,174,4550,2900,1650,0.6373626373626373,62,29,33,201.22070417743885,0.4574772163532877,0.7347386809983183,0.11770157837785702,1078646.7790076998,4059.21288613138,1082705.9918938312,3241,0,532.0057471264367,83,91,40,38.64432074862861,0.5509458812260537,43.79960317460319,8420.336520733874,101.4498375992033,0
3440,32.806423032502806,2,1,175,0.011363636363636364,0.005681818181818182,0.9943181818181818,176,5050,3400,1650,0.6732673267326733,67,34,33,198.87394484355798,0.45772321428571433,0.7360389788567274,0.11727770300774434,1079232.6216061816,2676.249772535066,1081908.8713787168,3242,0,526.9488636363636,73,103,40,38.39543774924083,0.5532670454545454,43.49662162162161,8414.958340347179,115.27340192256409,0
3441,32.62757586386198,0,1,174,0.0,0.005714285714285714,0.9942857142857143,175,4850,3000,1850,0.6185567010309279,67,30,37,201.93040240336174,0.45729611384783797,0.7384890317992798,0.11969460221997782,1074948.7312129561,3562.965971362759,1078511.697184319,3243,1,530.8228571428572,74,101,39,38.122114309418116,0.5544047619047618,43.30555555555553,8375.317459942955,113.17996567490479,0
3442,32.89841285374894,1,1,174,0.005714285714285714,0.005714285714285714,0.9942857142857143,175,5300,4000,1300,0.7547169811320755,66,40,26,199.24970024262672,0.4576915708812261,0.7347061744744265,0.1185879250409555,1085145.534061151,2942.984476261504,1088088.5185374126,3244,0,530.7428571428571,76,99,46,38.03712823483971,0.5560714285714285,43.15476190476188,8449.800682376517,111.1815879260068,0
3443,33.01011843738624,1,1,174,0.005714285714285714,0.005714285714285714,0.9942857142857143,175,5700,4200,1500,0.7368421052631579,72,42,30,201.8307818329176,0.45752736726874654,0.736626910681238,0.12091097271866438,1090871.5648014962,3334.29216063654,1094205.8569621327,3245,0,531.4685714285714,80,95,38,37.72530972270856,0.5582738095238096,42.91409465020574,8486.436184179314,106.08045230224143,0
3444,32.6022066178837,2,0,176,0.011363636363636364,0.0,1.0,176,5050,3700,1350,0.7326732673267327,64,37,27,201.2568679865997,0.45737554112554113,0.7391758969574298,0.12120490878659902,1079015.1664595308,3181.842582336763,1082197.0090418677,3246,0,529.4318181818181,85,91,42,37.54251800762678,0.5601325757575757,42.7204457364341,8387.88118665777,98.68095513715025,0
3445,32.59762962982723,0,3,173,0.0,0.017045454545454544,0.9829545454545454,176,5950,4400,1550,0.7394957983193278,75,44,31,199.50655827365512,0.45719358766233764,0.7374469436036613,0.12079359342546872,1080500.617271033,1963.3918728605258,1082464.0091438936,3247,1,530.4318181818181,73,103,40,37.38854946877338,0.5618489583333333,42.525337837837824,8393.063676227017,114.97347501680845,0
3446,32.406470524172256,0,0,173,0.0,0.0,1.0,173,5500,3900,1600,0.7090909090909091,71,39,32,201.15244367445942,0.45577362548729666,0.7361035568847532,0.1221071053336444,1074955.3369428504,3145.97857339105,1078101.3155162414,3248,2,540.1618497109827,74,99,44,37.24948323896827,0.5632827552986512,42.43055555555554,8346.916609316282,112.79617039616598,0
3447,32.73572436917748,2,0,175,0.011428571428571429,0.0,1.0,175,5600,3700,1900,0.6607142857142857,75,37,38,199.88986352995317,0.45616310892172957,0.7393399492268651,0.12250675794558442,1088806.6740467309,2928.2834971403245,1091734.9575438711,3249,0,534.9771428571429,79,96,43,36.92784060312334,0.5661309523809523,42.083333333333314,8443.088910216975,106.87454316730349,0
3448,32.6134697510886,0,0,175,0.0,0.0,1.0,175,5050,3100,1950,0.6138613861386139,70,31,39,200.9009044964089,0.45588533114395186,0.7397857966716122,0.12353268382864187,1085742.0308835488,3575.311210854171,1089317.342094403,3250,1,535.9771428571429,83,92,35,36.78032487504805,0.5675595238095238,41.96428571428569,8415.439962557608,101.39084292238081,0
3449,32.75082954443923,0,2,173,0.0,0.011428571428571429,0.9885714285714285,175,5200,3500,1700,0.6730769230769231,69,35,34,197.89845787849748,0.4558908045977012,0.73673586316874,0.11889175602991207,1083179.9268554107,2671.9274259256954,1085851.8542813363,3251,2,536.9771428571429,81,94,42,37.72020810695114,0.5589285714285714,42.80995934959348,8423.187181868807,103.98996520825688,8
3450,33.16187391641265,2,2,173,0.011428571428571429,0.011428571428571429,0.9885714285714285,175,5300,3600,1700,0.6792452830188679,70,36,34,191.07469772660508,0.45643678160919543,0.7282200847088629,0.11574162203681058,1099346.6429609815,1711.465500105488,1101058.1084610869,3252,0,532.0171428571429,72,103,40,37.588551768726326,0.5613690476190476,42.50856164383562,8538.898613322868,118.59581407392872,0
3451,33.201018789256906,1,2,172,0.005747126436781609,0.011494252873563218,0.9885057471264368,174,4500,3600,900,0.8,54,36,18,188.57875048237804,0.45625152260093454,0.7233780700335977,0.11482446858219786,1102261.684040386,2272.6262161876525,1104534.3102565736,3253,0,530.3678160919541,74,100,44,37.46013672541729,0.5638170498084292,42.31944444444446,8555.256966626184,115.61158063008357,0
3452,33.537552030886054,0,0,172,0.0,0.0,1.0,172,5800,4100,1700,0.7068965517241379,75,41,34,189.69326698839075,0.45578335373317014,0.7215896870465084,0.11609919079764458,1115049.102637205,2103.461426345142,1117152.5640635502,3254,1,535.5755813953489,75,97,47,37.24110591403564,0.5657703488372092,42.1326754385965,8648.238814543476,115.30985086057969,0
3453,33.28489077517297,2,3,171,0.011494252873563218,0.017241379310344827,0.9827586206896551,174,4050,2400,1650,0.5925925925925926,57,24,33,185.51983629033566,0.45654496932651206,0.722575376701228,0.11149687756405054,1100961.0466993279,2000.0226291389654,1102961.069328467,3255,0,530.4080459770115,82,92,45,38.02454376890795,0.5628591954022988,42.79618473895581,8561.00089792158,104.40244997465341,8
3454,32.83122735416944,1,1,171,0.005813953488372093,0.005813953488372093,0.9941860465116279,172,4100,2600,1500,0.6341463414634146,56,26,30,184.66336596331658,0.4563825989392085,0.7178489035029558,0.11138223655421546,1087069.0659373137,1648.3665501167497,1088717.4324874305,3256,0,537.1220930232558,70,102,48,37.91227194982899,0.5646802325581395,42.66431924882631,8448.646241081791,120.69494630116844,0
3455,33.1174475258773,0,1,170,0.0,0.005847953216374269,0.9941520467836258,171,4900,3100,1800,0.6326530612244898,67,31,36,187.2617056005061,0.4559970186905171,0.7204183925325307,0.11349507792472706,1098046.9706646781,2024.429711227443,1100071.4003759057,3257,1,532.53216374269,70,101,47,37.66605420085081,0.5663986354775828,42.488262910798134,8528.131440349187,121.83044914784553,0
3456,32.75776836714094,2,2,170,0.011627906976744186,0.011627906976744186,0.9883720930232558,172,4800,3600,1200,0.75,60,36,24,202.6870397295109,0.45641730699487737,0.7417474151565326,0.11841256909987005,1074698.8629923696,4365.506228119117,1079064.3692204887,3258,0,530.1279069767442,75,97,40,38.654032229297094,0.5511749031007752,43.84594298245615,8391.035266084145,111.88047021445527,8
3457,33.00858368164395,0,0,170,0.0,0.0,1.0,170,5250,3600,1650,0.6857142857142857,69,36,33,216.8126902435604,0.45607161503654714,0.7510989074313112,0.12690504254623117,1083526.5508710442,7734.461288935561,1091261.0121599797,3259,1,535.0529411764705,82,88,37,38.219819422675066,0.5523897058823529,43.77510040160644,8457.62103971442,103.14171999651732,8
3458,32.773761193701226,0,1,169,0.0,0.0058823529411764705,0.9941176470588236,170,4700,3000,1700,0.6382978723404256,64,30,34,208.7823724244123,0.4559577677224736,0.7448049291721117,0.12296139070403336,1077752.97272494,6303.1645065952225,1084056.137231535,3260,2,536.0529411764705,65,105,44,38.19049120971547,0.5528186274509803,43.54482323232324,8405.000720272286,129.3077033888044,8
3459,32.92343790042173,0,1,168,0.0,0.005917159763313609,0.9940828402366864,169,5250,3700,1550,0.7047619047619048,68,37,31,210.23880653716327,0.45577832957640646,0.742990066463822,0.12415654202695349,1083529.63930211,6509.99564290359,1090039.6349450136,3261,3,540.2011834319527,67,102,46,38.04981689355943,0.5541173570019724,43.44362745098038,8446.717799575083,126.07041491903108,0
3460,33.030197431836896,2,2,168,0.011764705882352941,0.011764705882352941,0.9882352941176471,170,5150,3700,1450,0.7184466019417476,66,37,29,227.96605733928055,0.4561782109293422,0.7661488420414087,0.1282584623369685,1071581.3326376425,9706.83430395521,1081288.1669415978,3262,0,537.9941176470588,68,102,43,39.46788755210492,0.5370098039215686,45.27475845410628,8413.625019133224,123.72977969313564,8
3461,33.02841852806648,1,0,169,0.005917159763313609,0.0,1.0,169,5100,3700,1400,0.7254901960784313,65,37,28,224.44844790276167,0.4557665891800507,0.7615251165533772,0.12712105596115558,1073668.2113386202,9296.632719497651,1082964.8440581178,3263,0,541.6627218934912,72,97,40,39.29699013188575,0.5400024654832347,45.01997716894978,8421.586910359896,116.96648486610967,0
3462,33.312606690076834,4,1,172,0.023121387283236993,0.005780346820809248,0.9942196531791907,173,5350,4100,1250,0.7663551401869159,66,41,25,215.44112453203408,0.45793985526728503,0.7572523815298389,0.12323232323232296,1086112.0762203098,6848.641413744978,1092960.7176340548,3264,0,530.1156069364162,62,111,43,39.14141414141412,0.5428709055876686,44.642857142857125,8506.612065501726,137.20342041131815,0
3463,33.62011617164618,0,2,170,0.0,0.011627906976744186,0.9883720930232558,172,4350,2800,1550,0.6436781609195402,59,28,31,191.98410148047068,0.45780562922163287,0.7242804561087026,0.11121377175873584,1100252.9486358997,3496.2147490205953,1103749.1633849202,3265,1,534.1627906976744,77,95,46,39.252351185815485,0.5489946705426356,44.16399572649575,8601.236184565034,111.70436603331213,8
3464,33.04464650056658,4,0,174,0.022988505747126436,0.0,1.0,174,5000,3600,1400,0.72,64,36,28,215.81941902883472,0.4585132770801497,0.7492260815898977,0.12399141537610381,1078780.4393755118,6764.353537138759,1085544.7929126506,3266,0,528.9885057471264,75,99,40,38.96173049759516,0.5448994252873562,44.47642543859649,8443.68619394275,112.58248258590335,8
3465,32.66705138846801,2,2,174,0.011363636363636364,0.011363636363636364,0.9886363636363636,176,5150,3600,1550,0.6990291262135923,67,36,31,212.78741231468422,0.4592748917748917,0.746477064474925,0.12308586358980193,1068605.366604296,5127.154149062699,1073732.5207533587,3267,0,523.9659090909091,79,97,42,38.776046969388446,0.5473484848484849,44.218750000000014,8355.619237956622,105.76733212603318,0
3466,32.86037348691927,0,3,171,0.0,0.017241379310344827,0.9827586206896551,174,4250,2700,1550,0.6352941176470588,58,27,31,203.19982330523806,0.4580516521604323,0.7331008397832388,0.11183071401919989,1058932.5371061245,3984.9808864263223,1062917.5179925507,3268,1,530.8850574712644,80,94,40,40.97046333350219,0.52915469348659,46.12911522633745,8342.292091117191,104.27865113896489,7
3467,33.19409087866404,6,1,176,0.03389830508474576,0.005649717514124294,0.9943502824858758,177,5300,3700,1600,0.6981132075471698,69,37,32,192.9045417988916,0.4598380521314844,0.7242743513929963,0.10755088837280587,1073939.054679644,733.5442525819508,1074672.598932226,3269,0,522.5706214689266,74,103,45,40.71799071799068,0.5336040489642184,45.62499999999997,8443.746867260099,114.10468739540674,0
3468,33.13848194123091,7,2,181,0.03825136612021858,0.01092896174863388,0.9890710382513661,183,5500,4100,1400,0.7454545454545455,69,41,28,181.26591518480635,0.4630109189535419,0.7142694285367819,0.1023994269324523,1076412.062333929,-3076.6364810154973,1073335.4258529134,3270,0,506.08743169398906,85,98,34,40.498572367691565,0.5378529143897997,45.11870155038757,8446.379305829887,99.36916830388103,0
3469,33.392859462621516,3,3,181,0.016304347826086956,0.016304347826086956,0.9836956521739131,184,5250,3800,1450,0.7238095238095238,67,38,29,209.79973948189587,0.46343339173992243,0.759053081421504,0.11630544161303025,1078493.1411111315,3203.5160076250354,1081696.6571187566,3271,0,504.32065217391306,81,103,42,40.5138930540977,0.5322124094202898,45.84603658536583,8486.927582173066,104.77688373053168,8
3470,32.86976290098859,4,1,184,0.021621621621621623,0.005405405405405406,0.9945945945945946,185,5150,3900,1250,0.7572815533980582,64,39,25,206.16909979392057,0.46289047199373284,0.7570257547392722,0.11568809486549375,1065522.975171463,1785.582520167879,1067308.557691631,3272,0,502.54594594594596,72,113,44,40.127166928192445,0.5348536036036036,45.376712328767105,8369.407094823597,116.24176520588328,0
3471,32.529663020842136,7,2,189,0.03664921465968586,0.010471204188481676,0.9895287958115183,191,4750,3200,1550,0.6736842105263158,63,32,31,188.4514379151475,0.4646045742628823,0.7479955275011416,0.10425341014938913,1049945.4000058072,-3377.255927302116,1046568.1440785051,3273,0,487.69633507853405,88,103,45,41.1389234383638,0.5281958987783595,45.92696629213484,8264.910169199942,93.91943374090843,8
3472,32.83990287393766,1,2,188,0.005263157894736842,0.010526315789473684,0.9894736842105263,190,6000,3900,2100,0.65,81,39,42,188.55782196986982,0.4647962498839692,0.7466213521680971,0.10475630539560803,1061335.8691796751,-3975.3640257965935,1057360.5051538786,3274,0,487.9421052631579,72,118,47,40.96812968887393,0.5300438596491228,45.76198630136984,8349.151676725782,115.96043995452474,0
3473,33.15347750809818,5,3,190,0.025906735751295335,0.015544041450777202,0.9844559585492227,193,6000,4200,1800,0.7,78,42,36,221.86914306581238,0.4664381836499712,0.7825627927125924,0.12291732634581806,1070551.5954993232,2904.4730202348273,1073456.068519558,3275,0,480.979274611399,82,111,42,40.23264523350946,0.5246653713298791,45.870983935742984,8425.2606182415,102.7470807102622,8
3474,32.784391057396725,2,1,191,0.010416666666666666,0.005208333333333333,0.9947916666666666,192,5450,4200,1250,0.7706422018348624,67,42,25,217.8268661758753,0.46638159449534616,0.7772007466281312,0.12156144467234348,1060990.527634978,2372.448335403211,1063362.9759703812,3276,0,484.4270833333333,67,125,42,40.046463551702004,0.5271809895833333,45.58823529411765,8340.73478372006,124.48857886149342,0
3475,33.001043068711994,2,3,190,0.010362694300518135,0.015544041450777202,0.9844559585492227,193,5300,3700,1600,0.6981132075471698,69,37,32,217.90232089206023,0.46668668141911346,0.7816044099071506,0.12276413312174325,1071077.1685048435,2778.0401743404254,1073855.2086791839,3277,0,482.5181347150259,74,119,44,39.67055531327227,0.5320056131260795,45.22222222222223,8407.932417395195,113.62070834317832,8
3476,32.82911097232904,3,4,189,0.015544041450777202,0.02072538860103627,0.9792746113989638,193,6150,4800,1350,0.7804878048780488,75,48,27,215.47443792601317,0.46755248812607947,0.7772605106788155,0.12237187156648432,1068062.5107996033,1278.033836877767,1069340.544636481,3278,0,479.25906735751295,83,110,39,39.419259439312874,0.5351899827288429,44.91567460317458,8374.19162575401,100.89387500908447,0
3477,32.38908934014788,4,2,191,0.02072538860103627,0.010362694300518135,0.9896373056994818,193,6450,4800,1650,0.7441860465116279,81,48,33,211.00700590260925,0.4672387737478411,0.7735416523551979,0.12066126179727663,1055911.55746395,-489.05275231394626,1055422.504711636,3279,0,480.1761658031088,67,126,44,39.26581528586,0.5377266839378239,44.65379901960787,8270.430916221329,123.43926740628848,0
3478,32.32715150515741,3,2,192,0.015463917525773196,0.010309278350515464,0.9896907216494846,194,5800,4100,1700,0.7068965517241379,75,41,34,206.8091252660365,0.4671597626551289,0.7686530738267814,0.1193291280601115,1056706.8527985201,-892.6760220220431,1055814.176776498,3280,0,478.6082474226804,73,121,47,39.025223886075025,0.540002147766323,44.31306306306308,8265.63034825004,113.22781298972659,0
3479,32.59674934064177,4,3,193,0.02040816326530612,0.015306122448979591,0.9846938775510204,196,6250,4400,1850,0.704,81,44,37,239.35071584056823,0.4677143293214722,0.798518716879016,0.1365464972030299,1061934.2104125698,5384.942687567831,1067319.1531001376,3281,0,471.9744897959184,64,132,40,38.6340092918132,0.533375850340136,44.74358974358977,8320.529222720286,130.00826910500447,8
3480,32.094345619147965,2,2,193,0.010256410256410256,0.010256410256410256,0.9897435897435898,195,5300,3600,1700,0.6792452830188679,70,36,34,235.1401269539718,0.4677438540840602,0.7939046581039977,0.13176538120275003,1039958.5507291018,4607.197129062219,1044565.747858164,3282,0,472.12820512820514,66,129,44,39.44312120841985,0.5274038461538462,45.429104477611965,8170.286305471581,123.7922167495694,8
3481,31.899440861027934,2,3,192,0.010256410256410256,0.015384615384615385,0.9846153846153847,195,5650,4400,1250,0.7787610619469026,69,44,25,232.12867192179067,0.4674365582870737,0.7919345192324139,0.12816682714911826,1028991.0632522134,3121.665786425178,1032112.7290386386,3283,0,473.07179487179485,79,116,39,40.1065963500282,0.5258547008547009,46.00260416666665,8102.374907240476,102.5617076865883,8
3482,31.543684456204183,8,3,197,0.04,0.015,0.985,200,6550,4400,2150,0.6717557251908397,87,44,43,232.61540290378957,0.46913421273031825,0.7948116738799864,0.12989086083765472,1021020.5974964327,951.0235319400108,1021971.6210283728,3284,0,445.925,69,131,42,39.646937263617595,0.5283333333333333,45.56547619047618,8025.802333812174,116.31597585235035,8
3483,31.61788397665448,2,3,196,0.010050251256281407,0.01507537688442211,0.9849246231155779,199,6600,4500,2100,0.6818181818181818,87,45,42,232.6124713737518,0.46905296685447434,0.7943939058572429,0.13105169456019866,1026185.5533874528,1340.711532298852,1027526.2649197517,3285,0,449.0854271356784,74,125,35,39.2957733682221,0.5306742043551089,45.22222222222219,8055.5342176075665,108.85857050821036,0
3484,31.37134941044296,4,10,190,0.02,0.05,0.95,200,6900,5300,1600,0.7681159420289855,85,53,32,237.45706827370938,0.4689264028475712,0.8027755379730899,0.13520403459842692,1021422.3702745081,1608.7923029131452,1023031.1625774213,3286,0,447.77,80,120,39,38.75789531152881,0.5340104166666666,44.81738683127569,8005.422921185884,100.06778651482355,0
3485,31.48772700929047,3,2,191,0.015544041450777202,0.010362694300518135,0.9896373056994818,193,4300,2900,1400,0.6744186046511628,57,29,28,236.3116343490314,0.46749739133563617,0.7959080992637044,0.1352385859226378,1026768.7603293917,5627.480770393204,1032396.2410997848,3287,0,464.7253886010363,61,132,42,38.58881578947368,0.5361614853195165,44.623655913978475,8041.220607211235,131.82328864280714,0
3486,31.242137453960783,1,0,192,0.005208333333333333,0.0,1.0,192,5800,4200,1600,0.7241379310344828,74,42,32,208.5404143519398,0.4669411721931356,0.7723702577635003,0.12053304054983496,1021753.2177742635,-1584.6321199853337,1020168.5856542782,3288,0,463.1666666666667,70,122,44,38.91538071745451,0.5411241319444444,44.24882629107982,7990.213323025906,114.1459046146558,8
3487,31.63096018303351,4,5,191,0.02040816326530612,0.025510204081632654,0.9744897959183674,196,5700,3900,1800,0.6842105263157895,75,39,36,205.34720037255522,0.46799777603349035,0.7711341748112299,0.11954786451085014,1036669.3124821726,-2324.571793928394,1034344.7406882442,3289,0,454.6938775510204,77,119,39,38.71966990071813,0.543686224489796,43.97702991452995,8098.25237271557,105.17210873656585,0
3488,31.483253473046968,2,3,190,0.010362694300518135,0.015544041450777202,0.9844559585492227,193,6100,4400,1700,0.7213114754098361,78,44,34,208.20939916716196,0.46753787061024754,0.7717258519735457,0.12195121951219526,1033659.1618787528,-1656.489392318399,1032002.6724864343,3290,0,461.2642487046632,78,115,42,38.41463414634149,0.5453907599309153,43.750000000000014,8067.583702468314,103.4305602880553,0
3489,31.733737786598955,0,2,188,0.0,0.010526315789473684,0.9894736842105263,190,6950,5300,1650,0.762589928057554,86,53,33,211.47518856926416,0.4669045298431263,0.7704463755531012,0.12407046116558279,1042388.8391623889,-862.1247351277043,1041526.7144272613,3291,1,468.5736842105263,66,124,42,38.26744409397873,0.5466008771929824,43.68781094527362,8133.743798971836,123.23854240866419,0
3490,31.524016138612563,4,2,190,0.020833333333333332,0.010416666666666666,0.9895833333333334,192,5050,3600,1450,0.7128712871287128,65,36,29,208.11433758613384,0.46791091750290864,0.7699630105584898,0.12363874231965863,1039266.8178337879,-192.73492625472045,1039074.0829075332,3292,0,462.7708333333333,72,120,46,37.87811429100678,0.5495334201388888,43.2220319634703,8094.672808423656,112.42601122810633,0
3491,31.657507503185116,2,2,190,0.010416666666666666,0.010416666666666666,0.9895833333333334,192,5500,3700,1800,0.6727272727272727,73,37,36,200.83010053086338,0.46830745073443864,0.7576748400750775,0.11482414814846172,1032014.2844332907,-2448.093501594639,1029566.1909316961,3293,0,462.8020833333333,70,122,43,39.53162108327589,0.5348849826388888,44.65962441314557,8083.439856007021,115.47771222867173,8
3492,32.00720315230922,4,1,193,0.020618556701030927,0.005154639175257732,0.9948453608247423,194,6750,4900,1850,0.725925925925926,86,49,37,197.39086767933748,0.46890802218542454,0.754128339644331,0.11430530414949841,1047359.3545226579,-4202.165647740133,1043157.1888749178,3294,0,458.9072164948454,77,117,46,39.127644950233204,0.5388208762886597,44.17735042735045,8188.167515833852,106.33983786797211,0
3493,32.366275311935624,3,5,191,0.015306122448979591,0.025510204081632654,0.9744897959183674,196,5750,3800,1950,0.6608695652173913,77,38,39,181.1772332126035,0.46963141025641025,0.7418059446473015,0.10174463717166005,1049452.1466317882,-6922.63273684504,1042529.5138949432,3295,0,454.9234693877551,76,120,44,40.7325754356141,0.526626275510204,45.34632034632034,8242.191104868443,108.4498829587953,8
3494,32.152835735628464,3,0,194,0.015463917525773196,0.0,1.0,194,6650,4900,1750,0.7368421052631579,84,49,35,198.98413380364383,0.4701833279917383,0.7586713170496537,0.10830240449382604,1032586.4017420429,-4356.337854387293,1028230.0638876556,3296,0,459.35051546391753,76,118,43,41.520875591615955,0.5148732817869416,46.56385281385284,8148.690809946815,107.21961592035282,8
3495,31.893187607678918,7,4,197,0.03482587064676617,0.01990049751243781,0.9800995024875622,201,6600,4800,1800,0.7272727272727273,84,48,36,184.08529506467448,0.47217039800995025,0.7464747326417054,0.10125180037094228,1027579.7995825371,-8967.533878269753,1018612.2657042674,3297,0,444.318407960199,84,117,36,41.478991664252845,0.5182421227197347,46.151960784313744,8096.0231385473635,96.38122783984957,0
3496,31.52455299412368,3,0,200,0.015,0.0,1.0,200,6150,4000,2150,0.6504065040650406,83,40,43,222.58414581246643,0.47187133584589613,0.7958748940977121,0.11873613442632462,1006057.0699617494,-1363.5292887943415,1004693.540672955,3298,0,447.525,72,128,39,41.736797514826335,0.5078645833333333,47.360159817351594,7964.358030264828,110.61608375367817,8
3497,31.74330289612327,3,2,201,0.014778325123152709,0.009852216748768473,0.9901477832512315,203,6750,4800,1950,0.7111111111111111,87,48,39,195.41159701259858,0.4728616950364987,0.7685226122239703,0.10543267540822956,1016662.6913376166,-7616.463972518192,1009046.2273650984,3299,0,441.8965517241379,92,111,40,41.96290272614622,0.5126231527093597,46.90860215053762,8033.956902338679,87.3256185036813,8
3498,31.303950813475776,5,5,201,0.024271844660194174,0.024271844660194174,0.9757281553398058,206,6200,4300,1900,0.6935483870967742,81,43,38,194.89966442441823,0.4737617412581893,0.7719812156917081,0.10628498505512039,1005928.6577078406,-8188.968435567196,997739.6892722733,3300,0,436.4271844660194,77,129,43,41.54676772199687,0.5151699029126213,46.48771367521368,7935.936141722921,103.06410573666132,0
3499,31.091908041161034,6,6,201,0.028985507246376812,0.028985507246376812,0.9710144927536232,207,5800,3700,2100,0.6379310344827587,79,37,42,183.88017541092646,0.4736664165220518,0.7601588547734197,0.10143777374879524,1002671.5572384206,-10325.71563509028,992345.8416033303,3301,0,434.8357487922705,86,121,42,41.3669990413779,0.518719806763285,46.03687739463603,7896.198053892122,91.81625644060607,0
3500,30.801908850797876,4,3,202,0.01951219512195122,0.014634146341463415,0.9853658536585366,205,6600,4600,2000,0.696969696969697,86,46,40,226.6316424153245,0.4731169296987088,0.8018630740722192,0.1240107975913065,990839.0191290773,-2688.90514511769,988150.1139839597,3302,0,439.4439024390244,71,134,42,40.605749486652954,0.5166666666666666,46.35416666666666,7812.775838717981,110.03909631997156,8
3501,31.011232733188688,2,3,201,0.00980392156862745,0.014705882352941176,0.9852941176470589,204,5800,3900,1900,0.6724137931034483,77,39,38,222.582197333667,0.47306286020155186,0.7975186751061047,0.12259847802794865,999596.0711947739,-2101.5420054734914,997494.5291893004,3303,0,442.5735294117647,78,126,41,40.44561868162305,0.5184334150326797,46.097046413502106,7873.8435853148785,100.94671263224203,0
3502,30.828433763970416,4,1,204,0.01951219512195122,0.004878048780487805,0.9951219512195122,205,7100,5500,1600,0.7746478873239436,87,55,32,187.97632099358663,0.47390004782400763,0.7632166750282356,0.10335032378193312,993150.9234806751,-10762.228642544089,982388.694838131,3304,0,441.0048780487805,80,125,40,41.39624919782482,0.516869918699187,46.167695473251015,7825.252387258819,97.81565484073523,8
3503,30.58719848978172,3,1,206,0.014492753623188406,0.004830917874396135,0.9951690821256038,207,5800,3900,1900,0.6724137931034483,77,39,38,185.0098225835849,0.47433281741006517,0.7598903737671217,0.10240899565702025,987425.0607458862,-10663.332939363505,976761.7278065226,3305,0,437.6328502415459,87,120,44,41.20333706015714,0.5194243156199678,45.90435606060607,7772.073896563166,89.33418271911685,0
3504,30.78739651000797,6,2,210,0.02830188679245283,0.009433962264150943,0.9905660377358491,212,6550,4300,2250,0.6564885496183206,88,43,45,188.99114446011953,0.47606951772034933,0.7724171373696895,0.1053542985260488,996032.1228422056,-11301.749837001882,984730.3730052037,3306,0,427.0377358490566,76,136,43,40.823051286142295,0.5258451257861636,45.63041125541125,7831.377388767307,103.04443932588562,8
3505,30.977200950724534,5,3,212,0.023255813953488372,0.013953488372093023,0.986046511627907,215,6150,4400,1750,0.7154471544715447,79,44,35,183.54797097976603,0.4763094979352314,0.7692346823034466,0.1033182671921043,1005124.8791425454,-12252.2735704207,992872.6055721247,3307,0,422.01395348837207,82,133,47,40.580250106742824,0.5286337209302325,45.25602409638553,7891.255332552766,96.23482112869227,0
3506,31.306292102888968,3,3,212,0.013953488372093023,0.013953488372093023,0.986046511627907,215,6100,3900,2200,0.639344262295082,83,39,44,183.30545838075864,0.4765739332029269,0.769579907584359,0.10430726835052674,1019118.0374022138,-11738.020201977737,1007380.0172002361,3308,0,422.5302325581395,84,131,40,40.163476778252694,0.5319767441860466,44.8406862745098,7988.092008262874,95.09633343170087,0
3507,31.394726147281,3,3,212,0.013953488372093023,0.013953488372093023,0.986046511627907,215,6950,5000,1950,0.7194244604316546,89,50,39,180.77755459327457,0.47657755560385423,0.7680086189781887,0.10360486153084897,1024170.8231188655,-12920.580622157617,1011250.2424967078,3309,0,423.47906976744184,74,141,45,39.951833324270936,0.534156976744186,44.56944444444448,8019.172341314592,108.36719380154854,0
3508,31.303289454861908,2,1,213,0.009345794392523364,0.004672897196261682,0.9953271028037384,214,6750,4800,1950,0.7111111111111111,87,48,39,181.2351856193602,0.4765043401635148,0.7662572215029413,0.10448390902485374,1022981.4398314911,-12469.953773395508,1010511.4860580956,3310,0,425.85981308411215,76,138,46,39.71187427240977,0.5363609813084111,44.34523809523813,8002.835012418651,105.30046068971909,0
3509,31.40512264391295,0,0,213,0.0,0.0,1.0,213,6300,4500,1800,0.7142857142857143,81,45,36,183.1698777666296,0.47638372161691317,0.7676927325643128,0.10597000781786753,1027371.6101970823,-11263.293547858722,1016108.3166492236,3311,1,427.7230046948357,80,133,48,39.52771493212667,0.5383411580594679,44.21296296296298,8033.023268871305,100.4127908608913,0
3510,31.019278517534048,2,4,211,0.009302325581395349,0.018604651162790697,0.9813953488372094,215,6950,5200,1750,0.7482014388489209,87,52,35,188.78846478551603,0.4761917699050931,0.7771634978077326,0.11021020213906346,1017440.4594871404,-11533.795528550301,1005906.6639585901,3312,0,424.7348837209302,83,132,43,39.03864465317452,0.5409883720930233,43.87400793650795,7944.8434833972115,95.72100582406279,0
3511,30.702285371711774,0,5,206,0.0,0.023696682464454975,0.976303317535545,211,6900,4300,2600,0.6231884057971014,95,43,52,190.3445475616629,0.47557831189347777,0.7744931855121522,0.11141357058694336,1007823.2767016698,-10733.26687482138,997090.0098268484,3313,1,432.73933649289097,83,128,45,38.897694640725305,0.5423578199052133,43.7748015873016,7866.699161090181,94.77950796494194,0
3512,30.604874672047707,3,1,208,0.014354066985645933,0.004784688995215311,0.9952153110047847,209,6700,4600,2100,0.6865671641791045,88,46,42,192.19031391515176,0.47512479297018767,0.7751031164618549,0.1134339285478193,1007059.6041089277,-9790.579711007662,997269.02439792,3314,0,436.511961722488,72,137,43,38.53425019468239,0.5449561403508771,43.464611872146094,7851.2334025980235,109.04490836941699,0
3513,30.812276290138914,4,2,210,0.018867924528301886,0.009433962264150943,0.9905660377358491,212,7200,4900,2300,0.6805555555555556,95,49,46,191.14757609545674,0.4756158901904677,0.7760697180071956,0.11428983292185914,1017676.9653429728,-10694.702965302562,1006982.2623776703,3315,0,430.97641509433964,78,134,43,38.072457076407375,0.5486438679245282,42.985232067510516,7919.210040181721,101.5283338484836,0
3514,30.84216102883584,0,1,209,0.0,0.004761904761904762,0.9952380952380953,210,6650,4400,2250,0.6616541353383458,89,44,45,235.27527867834183,0.4752534745955799,0.8152282822022523,0.1372935486971087,1011513.4111125371,-1053.180062723376,1010460.2310498138,3316,1,435.9142857142857,74,136,36,37.863227584960235,0.5360119047619047,43.8888888888889,7899.02013016298,106.7435152724727,8
3515,30.925361410571707,5,3,211,0.02336448598130841,0.014018691588785047,0.985981308411215,214,7950,5600,2350,0.7044025157232704,103,56,47,224.73437150882575,0.47557606803855323,0.8099094461164793,0.13259327919020722,1017497.0044442355,-5016.690038822349,1012480.3144054131,3317,0,428.55607476635515,68,146,39,37.713335687382276,0.5397196261682242,43.47826086956522,7933.027492277091,116.66216900407487,0
3516,30.966666902750177,3,3,211,0.014018691588785047,0.014018691588785047,0.985981308411215,214,5800,4000,1800,0.6896551724137931,76,40,36,217.8454444463536,0.4750545719801676,0.8044881414653562,0.1295698053253622,1021232.8482407805,-4105.815258354364,1017127.0329824261,3318,0,428.93457943925233,72,142,44,37.58450012964404,0.5421047507788161,43.17922374429223,7952.883432016213,110.45671433355852,0
3517,31.436179838746433,2,4,209,0.009389671361502348,0.018779342723004695,0.9812206572769953,213,5700,3400,2300,0.5964912280701754,80,34,46,217.2142748958093,0.47456318097262823,0.8036832345267237,0.1302160186810629,1039061.9927150145,-3160.180536122644,1035901.8121788919,3319,0,431.22535211267603,74,139,40,37.304068532123345,0.5443075117370892,42.88888888888889,8082.591127428808,109.22420442471362,0
3518,31.00886292828129,0,3,206,0.0,0.014354066985645933,0.9856459330143541,209,6700,4700,2000,0.7014925373134329,87,47,40,225.3326538701089,0.47398996288798917,0.8072668609873686,0.1353329252533496,1025479.6223456541,-2285.191041427232,1023194.4313042269,3320,1,439.46411483253587,73,136,40,37.02586206896549,0.5453050239234449,42.82094594594595,7974.83003518722,109.24424705735919,0
3519,31.27362465215189,2,4,204,0.009615384615384616,0.019230769230769232,0.9807692307692307,208,5600,4100,1500,0.7321428571428571,71,41,30,223.77347157953508,0.47393172070481854,0.8062043962395589,0.13542078219840395,1036472.224201638,-813.0024389275723,1035659.2217627105,3321,0,442.32211538461536,62,146,41,36.78178451394689,0.5473257211538461,42.54298941798941,8051.6139130068805,129.86474053236904,0
3520,31.22736681093528,2,2,204,0.009708737864077669,0.009708737864077669,0.9902912621359223,206,7350,5400,1950,0.7346938775510204,93,54,39,219.7275536641559,0.4735954889888705,0.8008482267694288,0.13379717806195832,1036751.1300013752,-2989.4420892497624,1033761.6879121255,3322,0,447.1601941747573,63,143,40,36.655718376284334,0.5490999190938511,42.317708333333336,8046.739442557414,127.72602289773673,0
3521,31.28176652926621,3,4,203,0.014492753623188406,0.01932367149758454,0.9806763285024155,207,7150,5300,1850,0.7412587412587412,90,53,37,215.68805657090985,0.47307720869877895,0.797555506661292,0.13258671271976954,1041323.4255106702,-3629.7948179680193,1037693.6306927021,3323,0,445.6328502415459,70,137,39,36.40946911544512,0.5519323671497585,41.974765258215974,8071.485151851628,115.30693074073754,0
3522,31.59986556905187,0,1,202,0.0,0.0049261083743842365,0.9950738916256158,203,6250,4400,1850,0.704,81,44,37,216.10315027435135,0.4725131688045652,0.7940192912546375,0.1329108892514944,1052065.3271289186,-1379.0737026048091,1050686.2534263139,3324,1,454.4581280788177,71,132,41,36.379606787770065,0.5532122331691297,41.956018518518526,8154.155125717746,114.84725529179924,0
3523,31.54806377939524,1,1,202,0.0049261083743842365,0.0049261083743842365,0.9950738916256158,203,5800,4400,1400,0.7586206896551724,72,44,28,213.2011520061875,0.4722408509323839,0.7914920891469859,0.1315564543688934,1051302.4737234896,-1572.2202990393575,1049730.2534244503,3325,0,455.4433497536946,72,131,42,36.333853821210106,0.5547003284072249,41.837899543379,8144.51441062814,113.1182557031686,0
3524,31.954589193572282,0,2,200,0.0,0.009900990099009901,0.9900990099009901,202,6400,4800,1600,0.75,80,48,32,216.80856078647244,0.4719312882780815,0.7937332769732501,0.13431730891095378,1066033.2160291937,-574.9745364269484,1065458.2414927667,3326,1,458.38613861386136,74,128,44,36.09415887012943,0.5566728547854786,41.694444444444464,8254.047914195284,111.541188029666,0
3525,32.33729131954069,0,0,200,0.0,0.0,1.0,200,5250,3500,1750,0.6666666666666666,70,35,35,218.51254828074434,0.4714797948073702,0.7936052136522458,0.1357404327466853,1079612.736258289,1931.7860312289008,1081544.522289518,3327,2,463.485,59,141,44,35.950797276717736,0.5584895833333333,41.59722222222219,8356.045902778478,141.62789665726234,0
3526,32.79021704729991,1,1,200,0.004975124378109453,0.004975124378109453,0.9950248756218906,201,6550,4500,2050,0.6870229007633588,86,45,41,217.71793148736836,0.4715029021558872,0.7935832523635626,0.1361501152067575,1096751.0645076844,1006.4746242361912,1097757.5391319206,3328,0,462.1741293532338,60,141,44,35.72821757119591,0.5604788557213931,41.35928961748632,8480.885030710417,141.34808384517362,0
3527,32.68189256521446,0,2,198,0.0,0.01,0.99,200,6250,4100,2150,0.656,84,41,43,233.15764141982703,0.47114688023450585,0.8051771619014214,0.14401210332984107,1089384.3858516717,4549.65880095245,1093934.044652624,3329,1,465.31,68,132,38,35.782465064608544,0.5566145833333334,41.802536231884055,8438.381771480412,124.0938495805943,7
3528,33.04405251823186,1,3,196,0.005025125628140704,0.01507537688442211,0.9849246231155779,199,5850,3800,2050,0.6495726495726496,79,38,41,216.85321230390582,0.4711023552103954,0.7847252724527993,0.128025584523443,1087407.881692352,1511.5784459144356,1088919.4601382664,3330,0,468.37688442211055,73,126,38,37.89111796982168,0.5477910385259632,43.454391891891895,8477.306547646056,116.12748695405556,8
3529,32.526047212459645,2,0,198,0.010101010101010102,0.0,1.0,198,5050,3700,1350,0.7326732673267327,64,37,27,222.10847915198548,0.4718301885180058,0.7880812776222399,0.12957582800697257,1066656.2610920588,2732.6799858203017,1069388.9410778792,3331,0,466.9848484848485,83,115,38,38.21058493124152,0.5425084175084175,43.89880952380954,8329.959412595741,100.36095677826194,8
3530,32.732220628850214,0,1,197,0.0,0.005050505050505051,0.9949494949494949,198,6000,4700,1300,0.7833333333333333,73,47,26,219.079658755554,0.4717345835683399,0.7861743511255643,0.12823397271167808,1074459.721195614,1478.4538132247753,1075938.1750088388,3332,1,467.9848484848485,84,114,42,38.161130508258424,0.5438236531986532,43.77450980392158,8386.829275833376,99.84320566468304,0
3531,32.44346538284785,1,0,198,0.005050505050505051,0.0,1.0,198,6100,4700,1400,0.7704918032786885,75,47,28,213.43499500946353,0.47163897861867404,0.7805574190506404,0.12575184185239033,1067015.2407709619,-152.32148220572708,1066862.919288756,3333,0,468.94444444444446,70,128,42,38.05596075739371,0.5458754208754208,43.52992957746478,8320.777851490047,118.86825502128639,0
3532,32.85822149308103,2,2,198,0.01,0.01,0.99,200,6850,5300,1550,0.7737226277372263,84,53,31,210.61234371497613,0.47218331239530986,0.7791641641641653,0.1251215303929248,1083249.0556017987,-1220.875514534252,1082028.1800872644,3334,0,465.245,76,124,45,37.81434943715644,0.5481770833333333,43.222402597402585,8437.255169915701,111.01651539362764,0
3533,33.26822228852787,3,2,199,0.014925373134328358,0.009950248756218905,0.9900497512437811,201,6350,4700,1650,0.7401574803149606,80,47,33,214.47166316556607,0.4725393864013267,0.7844021852509571,0.12889307699950137,1100400.5375221132,650.9466861299716,1101051.4842082432,3335,0,463.43283582089555,81,120,37,37.28098607201067,0.5511504975124378,42.79725609756096,8556.67805736561,105.63800070821742,0
3534,32.76379639453169,1,0,200,0.005,0.0,1.0,200,6650,4800,1850,0.7218045112781954,85,48,37,215.9060374255169,0.4721628978224455,0.7836598057354298,0.130387947741332,1085218.1031346498,211.0280780476769,1085429.1312126976,3336,0,465.44,69,131,39,37.062037465309885,0.5530208333333333,42.61904761904763,8432.777119640203,122.21416115420584,0
3535,32.77467111363288,1,1,200,0.004975124378109453,0.004975124378109453,0.9950248756218906,201,6450,4900,1550,0.7596899224806202,80,49,31,218.50703197344015,0.4722398424543947,0.786681163867964,0.13269899551565872,1087301.0349776181,866.5844029219088,1088167.61938054,3337,0,464.1194029850746,70,131,39,36.7864906684893,0.5550373134328358,42.41490610328639,8442.266736239046,120.60381051770065,0
3536,32.7627284602518,4,3,201,0.0196078431372549,0.014705882352941176,0.9852941176470589,204,6650,4600,2050,0.6917293233082706,87,46,41,210.60924436115815,0.47260657136417783,0.7822996955697279,0.12926240239415315,1090144.9951133153,-1531.077267017336,1088613.9178462978,3338,0,458.1764705882353,79,125,36,36.59818964937075,0.5579044117647058,42.03125,8451.760107480579,106.984305157982,0
3537,32.78429298857848,1,2,200,0.0049504950495049506,0.009900990099009901,0.9900990099009901,202,6250,3700,2550,0.592,88,37,51,211.43912623092245,0.47204365958983957,0.7827310340660523,0.13030729772175054,1092119.8894265555,-466.6249680474457,1091653.264458508,3339,0,463.6287128712871,81,121,38,36.42501066325442,0.5595090759075907,41.88262195121951,8462.195747394895,104.47155243697401,0
3538,32.75165350383349,1,1,200,0.004975124378109453,0.004975124378109453,0.9950248756218906,201,5950,4200,1750,0.7058823529411765,77,42,35,211.39798113629035,0.47196102819237146,0.7820033542269822,0.12850434853315107,1086830.7686554496,-199.23393388702152,1086631.5347215626,3340,0,466.76616915422886,72,129,42,36.93410509213103,0.5570066334991708,42.38013698630137,8437.47648912971,117.18717346013487,8
3539,32.842330119321446,0,2,198,0.0,0.01,0.99,200,6550,4700,1850,0.7175572519083969,84,47,37,245.9984965321407,0.47166876046901174,0.809211973503313,0.1448295784219026,1079899.4482252684,6580.728133860795,1086480.1763591291,3341,1,469.3,64,136,36,37.24925009373829,0.5452083333333333,43.55769230769231,8422.16292579137,131.59629571549016,7
3540,32.436165377080044,1,2,197,0.005025125628140704,0.010050251256281407,0.9899497487437185,199,5900,4100,1800,0.6949152542372882,77,41,36,227.92061844882895,0.4718637378813258,0.7996909683663505,0.13196979965489478,1061361.2922162914,2681.2244239171846,1064042.5166402087,3342,0,468.8994974874372,69,130,37,38.35091763131874,0.541143216080402,44.18154761904763,8297.769627937267,120.25753083967054,8
3541,32.31875065832035,2,2,197,0.010050251256281407,0.010050251256281407,0.9899497487437185,199,5800,4200,1600,0.7241379310344828,74,42,32,225.3766032116887,0.47190286449080415,0.7961025786208042,0.13116179367237638,1059100.3769136416,2139.2890818032624,1061239.6659954449,3343,0,469.31658291457285,77,122,37,38.220526864893074,0.5436557788944724,43.99038461538462,8273.910925747887,107.45338864607645,0
3542,32.28228843705743,1,0,198,0.005050505050505051,0.0,1.0,198,5650,3800,1850,0.672566371681416,75,38,37,230.90733550200585,0.4712362627971765,0.8003918670053596,0.13519801900604034,1059784.029427536,3692.381288538289,1063476.4107160743,3344,0,472.0959595959596,78,120,38,37.84648964819293,0.5456649831649831,43.76318565400844,8271.910748910033,106.05013780653888,0
3543,31.93554972555697,0,1,197,0.0,0.005050505050505051,0.9949494949494949,198,7300,5700,1600,0.7808219178082192,89,57,32,224.8932687219983,0.4712870028542617,0.7949682311384441,0.132549633944509,1050418.2969031367,346.4008631881961,1050764.6977663247,3345,1,473.0959595959596,66,132,35,37.74865632135135,0.5475063131313131,43.51679104477612,8190.932273359975,124.1050344448481,0
3544,31.451129655090266,0,0,197,0.0,0.0,1.0,197,5800,4200,1600,0.7241379310344828,74,42,32,220.78203608821573,0.47098268241306673,0.7901386468671869,0.1304904412306849,1035322.3383528413,516.1147738305881,1035838.453126672,3346,2,476.3553299492386,67,130,37,37.74800995024873,0.5490164974619289,43.412990196078425,8069.951313155043,120.44703452470213,0
3545,31.35037584815695,1,0,198,0.005050505050505051,0.0,1.0,198,5500,3800,1700,0.6909090909090909,72,38,34,219.9941198772309,0.47082767181117435,0.7898028575607889,0.13062012865377057,1033368.4450613125,366.99631603299895,1033735.4413773455,3347,0,474.94444444444446,71,127,40,37.59514518885821,0.5507680976430976,43.243634259259245,8049.4085673790405,113.37195165322592,0
3546,31.15392540456859,1,2,197,0.005025125628140704,0.010050251256281407,0.9899497487437185,199,5850,3800,2050,0.6495726495726496,79,38,41,224.1811671317823,0.47108649307141764,0.7944733667283901,0.1342120522318249,1029336.7798970853,501.58413779972943,1029838.364034885,3348,0,473.5527638190955,76,123,36,37.17547275725363,0.5527638190954773,42.938311688311686,8008.48066203479,105.37474555308934,0
3547,30.825951689773266,0,0,197,0.0,0.0,1.0,197,5650,3800,1850,0.672566371681416,75,38,37,248.77275367361213,0.4706308919506889,0.8148617222658883,0.14678178734033753,1014237.9975273536,5412.955905057835,1019650.9534324114,3349,1,479.07106598984774,60,137,37,37.095177073625365,0.5484877326565144,43.47677595628414,7907.572511676451,131.79287519460752,8
3548,31.046959028283617,0,1,196,0.0,0.005076142131979695,0.9949238578680203,197,6650,4900,1750,0.7368421052631579,84,49,35,205.73233099026783,0.47036435132428606,0.772693817295472,0.1241345797728162,1028094.8410215798,-3747.5303755122623,1024347.3106460675,3350,2,480.07106598984774,72,125,38,37.35676000369648,0.5605964467005076,42.65125570776255,7989.895920021327,110.97077666696288,8
3549,31.04973905322565,2,1,197,0.010101010101010102,0.005050505050505051,0.9949494949494949,198,6600,4600,2000,0.696969696969697,86,46,40,210.32003477310872,0.47018727888017225,0.7733598160995865,0.12522253058127944,1024275.4022395827,-3114.8723567464012,1021160.5298828364,3351,0,478.40909090909093,76,122,31,37.738979301627424,0.553766835016835,43.14123376623375,7975.3976650919,104.93944296173554,8
3550,30.758664531057708,2,2,197,0.010050251256281407,0.010050251256281407,0.9899497487437185,199,6450,4300,2150,0.6666666666666666,86,43,43,205.19706070553804,0.4706476405597009,0.7705142365993518,0.12309976684089996,1016875.5213231416,-4518.026384216306,1012357.4949389254,3352,0,476.92964824120605,80,119,36,37.58627156789197,0.5562709380234505,42.86265432098762,7909.201354147286,98.86501692684108,0
3551,31.055425187134194,1,1,197,0.005050505050505051,0.005050505050505051,0.9949494949494949,198,5650,3700,1950,0.6548672566371682,76,37,39,206.34089665244133,0.4702700652891008,0.7704971795880908,0.12445525699413201,1028265.9034971585,-2815.3382950529653,1025450.5652021056,3353,0,479.72727272727275,71,127,34,37.35505565862709,0.5585542929292929,42.664930555555536,7991.649997157879,112.55845066419548,0
3552,31.2820343193551,0,0,197,0.0,0.0,1.0,197,5950,4000,1950,0.6722689075630253,79,40,39,207.62613015668626,0.47004601332918955,0.7693484304478502,0.12552196340571742,1036453.6196387304,-2311.0291735042792,1034142.5904652261,3354,1,483.11167512690355,72,125,37,37.23519493717667,0.5599619289340101,42.579908675799075,8052.624131295146,111.8420018235437,0
3553,31.048247973515753,0,2,195,0.0,0.01015228426395939,0.9898477157360406,197,5700,3900,1800,0.6842105263157895,75,39,36,206.8828147811356,0.4697719189198522,0.7695480970724651,0.12551354366335146,1029734.3642172867,-2493.1312507730613,1027241.2329665136,3355,2,484.11167512690355,72,125,38,37.123247825364274,0.561336717428088,42.45148401826483,7996.430189411873,111.06153040849823,0
3554,30.829075612503612,1,0,196,0.00510204081632653,0.0,1.0,196,6450,4700,1750,0.7286821705426356,82,47,35,210.4909515899362,0.4692836429443572,0.7713701604740653,0.12828456530321367,1023779.4532422532,-2550.737733762896,1021228.7155084902,3356,0,482.9183673469388,73,123,38,36.861390284757114,0.5635097789115646,42.28603603603602,7945.083281443048,108.83675728004175,0
3555,30.7992211618213,1,5,192,0.005076142131979695,0.025380710659898477,0.9746192893401016,197,5900,4200,1700,0.711864406779661,76,42,34,238.7562431835911,0.4692388376670465,0.805780899160391,0.14409619717536187,1019963.0143428764,3404.5074981431353,1023367.5218410195,3357,0,481.46192893401013,62,135,37,36.49761751793554,0.5557318104906938,42.64219576719575,7926.419930286817,127.84548274656157,8
3556,31.250620728833887,0,0,192,0.0,0.0,1.0,192,6400,4800,1600,0.75,80,48,32,211.2216346717618,0.468092709242292,0.7720916022271886,0.12746451763476807,1034880.0409770736,-1082.1892111283596,1033797.8517659452,3358,1,491.5572916666667,66,126,41,37.210274069151644,0.5621202256944444,42.64614427860698,8042.467738252326,121.8555717917019,8
3557,31.664276653531513,1,0,193,0.0051813471502590676,0.0,1.0,193,6250,4600,1650,0.736,79,46,33,209.2333014571176,0.4678279720782959,0.7705870097721943,0.12689863867594076,1050069.506241698,-908.098089920637,1049161.4081517775,3359,0,490.00518134715026,67,126,42,37.07470854151795,0.5636334196891192,42.463235294117666,8154.715366102552,121.71216964332167,0
3558,31.52590707913971,0,3,190,0.0,0.015544041450777202,0.9844559585492227,193,6350,4900,1450,0.7716535433070866,78,49,29,210.42657627675166,0.4673354742371905,0.7735931683818702,0.1262835970901343,1042350.3002340015,-1082.3590081431585,1041267.9412258583,3360,1,491.00518134715026,73,120,43,37.437960732793194,0.5568329015544041,42.849099099099085,8106.915407118837,111.05363571395667,7
3559,31.92232825332212,1,2,189,0.005235602094240838,0.010471204188481676,0.9895287958115183,191,6100,4100,2000,0.6721311475409836,81,41,40,211.24860229928512,0.4670512997152567,0.7720589673540974,0.1275433290573884,1057271.3551269968,369.4192043300136,1057640.7743313268,3361,0,493.9947643979058,64,127,41,37.19126193441263,0.5591732111692844,42.628205128205146,8215.906919044159,128.37354561006498,0
3560,32.211347670794716,1,1,189,0.005263157894736842,0.005263157894736842,0.9947368421052631,190,5950,4300,1650,0.7226890756302521,76,43,33,216.4224697231826,0.4666892926761348,0.7753869969040232,0.13139935661764726,1068535.2934871123,2301.009440573561,1070836.302927686,3362,0,497.07894736842104,65,125,45,36.849724264705884,0.5609100877192983,42.42424242424244,8296.862278841107,127.64403505909395,0
3561,32.6387324704922,2,0,191,0.010471204188481676,0.0,1.0,191,6200,4200,2000,0.6774193548387096,82,42,40,214.53654270805526,0.4670111141728667,0.7740231866830254,0.12711926405218216,1075199.9365047838,1733.9354195312671,1076933.871924315,3363,0,495.1675392670157,74,117,37,37.81270854751724,0.5517561082024434,43.319444444444436,8377.727983155071,113.21254031290637,8
3562,32.58457167208969,2,2,191,0.010362694300518135,0.010362694300518135,0.9896373056994818,193,5850,4100,1750,0.7008547008547008,76,41,35,208.63590243583283,0.46688795336787564,0.7709713593464798,0.12435642772305237,1075246.4909236745,417.0043949644364,1075663.495318639,3364,0,491.0259067357513,76,117,35,37.74080656485868,0.5538644214162349,43.100649350649334,8370.955303747027,110.14414873351352,0
3563,32.35049802647836,1,0,192,0.005208333333333333,0.0,1.0,192,5250,3800,1450,0.7238095238095238,67,38,29,208.6723544617309,0.4666230366492146,0.7684367732281081,0.12318854794455782,1064566.4123279352,779.1159482693233,1065345.5282762046,3365,0,490.015625,70,122,41,38.10322067177553,0.5489366319444444,43.45657276995303,8299.30763631157,118.56153766159386,8
3564,32.11671079616482,2,2,192,0.010309278350515464,0.010309278350515464,0.9896907216494846,194,5450,3900,1550,0.7155963302752294,70,39,31,207.41644685556224,0.46700786104730874,0.7674986435160092,0.12312913653157709,1058571.1140704148,-336.988155116499,1058234.1259152982,3366,0,485.95360824742266,72,122,43,37.9251653420775,0.5507946735395188,43.25057077625568,8245.947165459309,114.52704396471262,0
3565,31.649294779616497,2,1,193,0.010309278350515464,0.005154639175257732,0.9948453608247423,194,4900,3800,1100,0.7755102040816326,60,38,22,204.9971685103492,0.46721373502127733,0.7654683946298648,0.12250176817210065,1045153.720124652,-849.2893432779501,1044304.4307813741,3367,0,486.14948453608247,76,118,35,37.73764717236053,0.5531572164948453,43.00595238095236,8133.680369701981,107.02211012765765,0
3566,31.431632792897666,0,3,190,0.0,0.015544041450777202,0.9844559585492227,193,6050,4600,1450,0.7603305785123967,75,46,29,209.43150139561956,0.46679012845423146,0.7709967918823419,0.12555214415000254,1038915.8560421409,-1133.658489076196,1037782.1975530647,3368,1,489.6683937823834,80,113,38,37.503647109821756,0.5548359240069085,42.88837448559668,8081.43819995367,101.01797749942088,0
3567,31.280121590517453,2,4,188,0.010416666666666666,0.020833333333333332,0.9791666666666666,192,5450,4000,1450,0.7339449541284404,69,40,29,209.17209866170293,0.46652816408522396,0.7712013343702189,0.12596974469805,1035254.1770337078,-540.7422283135566,1034713.4348053943,3369,0,492.296875,81,111,41,37.33947851347122,0.5570203993055556,42.721036585365816,8047.717258291954,99.35453405298709,0
3568,30.94072085208154,2,0,190,0.010526315789473684,0.0,1.0,190,6600,4700,1900,0.7121212121212122,85,47,38,209.04564575602683,0.4661903601596584,0.7697921434019825,0.1265276276944374,1025484.3226272578,-1725.3935127405875,1023758.9291145172,3370,0,497.19473684210527,66,124,42,37.155168075684394,0.5589364035087719,42.53731343283582,7966.081114901597,120.69819871063027,0
3569,30.741440884370657,0,3,187,0.0,0.015789473684210527,0.9842105263157894,190,5600,3600,2000,0.6428571428571429,76,36,40,207.1884133335865,0.46621066555277085,0.7675543012158847,0.12563429156100378,1019410.4388223186,-1357.9937289417376,1018052.4450933768,3371,1,498.19473684210527,69,121,43,37.1345198197157,0.5603070175438596,42.470238095238095,7916.835951561286,114.73675292117805,0
3570,31.16587021870503,1,2,186,0.005319148936170213,0.010638297872340425,0.9893617021276596,188,4950,3300,1650,0.6666666666666666,66,33,33,204.25921223142544,0.4662480562824743,0.7613473584357897,0.12427920432625404,1034477.0757885075,-289.7054855941633,1034187.3703029134,3372,0,494.4308510638298,71,117,45,37.08383635614948,0.5623891843971631,42.34664351851852,8029.991069515598,113.09846576782532,0
3571,30.79964894904508,1,2,185,0.0053475935828877,0.0106951871657754,0.9893048128342246,187,4950,3500,1450,0.7070707070707071,64,35,29,198.92282503256345,0.46623972169512967,0.7534927698065772,0.12167744047242214,1023853.0939454332,-1616.4500268085785,1022236.6439186246,3373,0,496.88235294117646,76,111,46,37.024527806925484,0.5648952762923352,42.15367965367967,7941.576149469719,104.49442301933841,0
3572,30.59276368932006,1,2,184,0.005376344086021506,0.010752688172043012,0.989247311827957,186,5750,4200,1550,0.7304347826086957,73,42,31,196.08286525060714,0.46625980819529206,0.749012751568157,0.12057623938870442,1018484.7736813074,-3008.5174724906738,1015476.2562088168,3374,0,498.1774193548387,80,106,41,36.90277431680371,0.5673163082437276,41.962448559670776,7894.081834184745,98.67602292730932,0
3573,30.660533748961825,1,0,185,0.005405405405405406,0.0,1.0,185,4850,3700,1150,0.7628865979381443,60,37,23,206.17370184850895,0.4655699177438308,0.7586336002520973,0.12364924145527866,1013546.0236776018,-56.69286091065533,1013489.3308166912,3375,0,501.74054054054056,81,104,38,37.57220287205834,0.5573761261261261,42.873475609756085,7883.636478820297,97.32884541753454,8
3574,30.310943570504133,5,0,190,0.02631578947368421,0.0,1.0,190,5650,4400,1250,0.7787610619469026,69,44,25,193.3090186477137,0.46670031560382436,0.7535299062100131,0.11395288349336691,997029.414406205,-5103.044467646601,991926.3699385583,3376,0,489.5105263157895,73,117,45,38.55252867570385,0.5478070175438596,43.51069819819818,7774.432753352372,106.4990788130462,8
3575,30.671913623191248,4,1,193,0.020618556701030927,0.005154639175257732,0.9948453608247423,194,6000,4000,2000,0.6666666666666666,80,40,40,188.4664409103706,0.4669221729608461,0.7519174080885489,0.11219792024747549,1011777.4061310224,-6662.782654592327,1005114.6234764301,3377,0,480.39690721649487,80,114,40,38.30473222183281,0.5507946735395188,43.145576131687214,7878.216702623371,98.47770878279213,0
3576,30.417252736443068,3,3,193,0.015306122448979591,0.015306122448979591,0.9846938775510204,196,6600,4500,2100,0.6818181818181818,87,45,42,188.52327003606342,0.46756551979766264,0.7553201498537416,0.11301922671006145,1005390.8233290345,-7892.0868643523645,997498.7364646822,3378,0,476.4795918367347,86,110,44,38.04077023377108,0.5528805272108843,42.88793103448274,7820.642783313863,90.93770678271935,0
3577,30.584917811325923,0,1,192,0.0,0.0051813471502590676,0.9948186528497409,193,6050,4600,1450,0.7603305785123967,75,46,29,185.0627145340714,0.46701051561600465,0.7474419288830152,0.1113810017991952,1012066.0853278224,-7190.860592272779,1004875.2247355495,3379,1,484.0362694300518,87,106,45,37.98299245387199,0.5544581174438687,42.743844696969674,7868.158366400813,90.43860191265303,0
3578,30.765666232180184,0,1,191,0.0,0.005208333333333333,0.9947916666666666,192,6200,4500,1700,0.7258064516129032,79,45,34,185.3086014234504,0.4669377635980221,0.7454659936882997,0.11214709580759097,1019647.9150494429,-6810.09418356998,1012837.8208658729,3380,2,485.671875,74,118,42,37.77074229918546,0.5560980902777778,42.54166666666668,7920.8771520267455,107.03888043279386,0
3579,31.088010300302557,1,2,190,0.005208333333333333,0.010416666666666666,0.9895833333333334,192,5000,3500,1500,0.7,65,35,30,182.6629347754103,0.4666542821044212,0.740586773700306,0.11113579314481188,1031883.7864665583,-5702.615843371246,1026181.1706231871,3381,0,486.28125,77,115,44,37.641404913699276,0.5578884548611112,42.3477564102564,8009.895602613993,104.02461821576614,0
3580,31.2836542089119,0,0,190,0.0,0.0,1.0,190,5750,4000,1750,0.6956521739130435,75,40,35,182.98302748582998,0.4659432145177759,0.7387307304574295,0.11184279679987535,1039721.6434842132,-5699.717186543223,1034021.9262976699,3382,1,491.87894736842105,80,110,49,37.46342112263901,0.559594298245614,42.18106995884773,8065.518255919035,100.81897819898794,0
3581,31.339946453815667,2,2,190,0.010416666666666666,0.010416666666666666,0.9895833333333334,192,4950,3000,1950,0.6060606060606061,69,30,39,177.2404641260574,0.4662060518470041,0.7330692869044189,0.10890918773203623,1043144.3366150331,-6372.522725576637,1036771.8138894564,3383,0,487.7447916666667,83,109,43,37.41608990996187,0.5610894097222222,41.9890873015873,8086.048188468352,97.42226733094401,0
3582,31.020343578635554,0,1,189,0.0,0.005263157894736842,0.9947368421052631,190,4900,3400,1500,0.6938775510204082,64,34,30,178.3302712344996,0.4657958553791887,0.7319413679668065,0.10964894936874996,1032691.2340356046,-6067.978426588266,1026623.2556090164,3384,1,493.53684210526313,86,104,44,37.36446877948434,0.5623355263157894,41.965996168582365,8004.3034538215115,93.07329597466874,0
3583,30.618672612087433,1,0,190,0.005263157894736842,0.0,1.0,190,5250,3600,1650,0.6857142857142857,69,36,33,173.029428193378,0.4654396407685881,0.7225739720058055,0.1042063805629261,1013370.5785708729,-8181.413648378179,1005189.1649224947,3385,0,494.4315789473684,88,102,46,38.26833697267462,0.5556469298245614,42.720037453183494,7877.57094287102,89.51785162353431,8
3584,31.138643569779763,0,0,190,0.0,0.0,1.0,190,6450,4900,1550,0.7596899224806202,80,49,31,172.9856679423491,0.4651437621832359,0.7207209389616387,0.10462219764111837,1031821.3903147444,-8751.937519840345,1023069.4527949041,3386,1,495.4315789473684,79,111,46,38.11184942592686,0.5571820175438597,42.56510416666664,8016.173463777488,101.47055017439858,0
3585,31.391196882150602,0,0,190,0.0,0.0,1.0,190,5700,4300,1400,0.7543859649122807,71,43,28,174.0061898359664,0.46484092174881647,0.7231530589181439,0.10553143421123679,1041007.3574081045,-7471.655229241808,1033535.7021788626,3387,2,496.4315789473684,80,110,47,37.98270581577281,0.5584978070175439,42.4639917695473,8084.363538605233,101.0545442325654,0
3586,31.596613934323575,1,2,189,0.005235602094240838,0.010471204188481676,0.9895287958115183,191,6050,5000,1050,0.8264462809917356,71,50,21,180.6470008601801,0.4646505005970423,0.7294319686503765,0.11027945070561837,1049760.1549665022,-6322.795276556921,1043437.3596899454,3388,0,494.82722513089004,81,110,46,37.568992706485325,0.5602639616055847,42.22560975609754,8144.797890692199,100.55306037891603,0
3587,31.447800343134876,0,0,189,0.0,0.0,1.0,189,5500,4000,1500,0.7272727272727273,70,40,30,180.4388950663982,0.4644475402454126,0.7286590057610687,0.11068444282737061,1046231.2013868513,-5543.839607553382,1040687.3617792979,3389,1,500.6137566137566,83,106,42,37.39668966235597,0.5618386243386244,42.05109126984126,8111.925780475523,97.73404554789788,0
3588,31.622424497666074,1,0,190,0.005263157894736842,0.0,1.0,190,4800,3500,1300,0.7291666666666666,61,35,26,179.42743734324486,0.4645015316067948,0.7293139985614794,0.110587752931226,1053438.9543438116,-4996.829604908751,1048442.1247389029,3390,0,498.9736842105263,87,103,43,37.24834907823535,0.5631578947368421,41.87973484848483,8162.388596071282,93.82055857553198,0
3589,31.333674070407888,1,2,189,0.005235602094240838,0.010471204188481676,0.9895287958115183,191,5200,3200,2000,0.6153846153846154,72,32,40,177.81341998575232,0.46473201984017637,0.7288557934003796,0.1100289098543353,1044975.4181333854,-6237.86942013234,1038737.548713253,3391,0,497.35602094240835,88,103,45,37.144626725882915,0.5645178883071553,41.73689138576778,8092.332069728672,91.95831897418945,0
3590,30.929287522934807,0,0,189,0.0,0.0,1.0,189,4300,2700,1600,0.627906976744186,59,27,32,178.24129739130407,0.46421652782468387,0.7273574925851676,0.11055239655804153,1032161.1604802985,-5305.25112781531,1026855.9093524831,3392,1,499.6084656084656,74,115,42,37.04796337114493,0.5655313051146384,41.6527777777778,7990.495516862696,107.97966914679319,0
3591,30.86466369892584,0,1,188,0.0,0.005291005291005291,0.9947089947089947,189,6350,4500,1850,0.7086614173228346,82,45,37,181.65766866607146,0.46384714248189424,0.7336037978772285,0.11297746987093159,1030779.9336936458,-6700.184067488721,1024079.749626157,3393,2,500.6084656084656,74,115,43,36.860714029808,0.5671296296296297,41.55555555555558,7976.800862633546,107.79460625180468,0
3592,31.146693997446253,0,2,186,0.0,0.010638297872340425,0.9893617021276596,188,4950,3600,1350,0.7272727272727273,63,36,27,186.64867812315154,0.46348240698600524,0.7394369785659016,0.1166363780434885,1041571.1172752209,-3668.425557864912,1037902.691717356,3394,3,504.2074468085106,73,115,45,36.55812286813265,0.5683178191489362,41.38513513513516,8054.998059136915,110.34243916625911,0
3593,31.209157057635263,0,3,183,0.0,0.016129032258064516,0.9838709677419355,186,5150,3700,1450,0.7184466019417476,66,37,29,201.22367116620086,0.46284510316768385,0.7529785895523715,0.1230354798173566,1037349.1870953635,-602.1576582797761,1036747.0294370838,3395,4,509.51075268817203,80,106,43,36.980023941343646,0.5622759856630825,42.16820987654317,8046.712832414131,100.58391040517664,7
3594,30.860398860285898,1,1,183,0.005434782608695652,0.005434782608695652,0.9945652173913043,184,5000,3400,1600,0.68,66,34,32,200.56405122425727,0.46259441573612103,0.750973909189594,0.12308413986736036,1026816.6589474669,-611.4982033883134,1026205.1607440786,3396,0,510.23369565217394,81,103,38,36.86121165115476,0.5638020833333333,42.035060975609724,7960.9009102619375,98.28272728718441,0
3595,31.15457235694421,1,0,184,0.005434782608695652,0.0,1.0,184,5250,3900,1350,0.7428571428571429,66,39,27,198.2414934175284,0.46257709174784195,0.7481368846706562,0.12223326205507229,1037971.2365743835,-896.2063874114556,1037075.030186972,3397,0,511.2282608695652,83,101,40,36.74777414809121,0.5653872282608696,41.86507936507934,8042.083062774623,96.892567021381,0
3596,31.60796061590811,0,1,183,0.0,0.005434782608695652,0.9945652173913043,184,5050,3300,1750,0.6534653465346535,68,33,35,196.6887842820249,0.46236239803595475,0.7459872415381956,0.12186475925620052,1054498.3901177607,-368.3987240774777,1054129.9913936832,3398,1,512.2282608695652,85,99,40,36.61024102035078,0.5669157608695652,41.69089147286819,8164.624129055831,96.05440151830389,0
3597,31.482214355606622,0,0,183,0.0,0.0,1.0,183,6600,4700,1900,0.7121212121212122,85,47,38,202.1199342827666,0.46200009007386056,0.74851748036153,0.12583595908572218,1051710.8799812554,-685.6532107437579,1051025.2267705116,3399,2,515.9071038251366,76,107,40,36.293417770101684,0.5693306010928962,41.51785714285713,8137.590228525083,107.07355563848793,0
3598,31.182431823240318,0,2,181,0.0,0.01092896174863388,0.9890710382513661,183,4850,3600,1250,0.7422680412371134,61,36,25,200.7827755605704,0.4616172761664565,0.7474693274180781,0.12549883237237117,1042835.1930562272,426.6689028142964,1043261.8619590414,3400,3,516.9071038251366,78,105,40,36.183869514972294,0.5708105646630237,41.376582278480996,8064.5070909946235,103.39111655121312,0
3599,31.470391817150304,1,1,181,0.005494505494505495,0.005494505494505495,0.9945054945054945,182,6050,4100,1950,0.6776859504132231,80,41,39,197.0109341441587,0.46084975107765164,0.7406282242347824,0.12400969682057253,1054501.4963349912,-900.335030126078,1053601.161304865,3401,0,519.9175824175824,80,102,39,36.02645305514157,0.5733173076923077,41.12654320987654,8146.849116245297,101.83561395306621,0
3600,31.461211218094082,0,0,181,0.0,0.0,1.0,181,5000,3100,1900,0.62,69,31,38,201.39930366867046,0.4605867607939431,0.7444293730758178,0.12712252461650897,1054991.3485219956,1294.9045937604355,1056286.253115756,3402,1,523.7292817679559,79,102,34,35.81298079340338,0.5744129834254144,41.02864583333334,8147.552472873375,103.13357560599209,0
3601,31.394294166064608,1,2,180,0.005494505494505495,0.01098901098901099,0.989010989010989,182,5400,3700,1700,0.6851851851851852,71,37,34,198.69649375024954,0.4606062675814057,0.7433992128079785,0.1259481379589064,1053963.8899832158,83.78589580798734,1054047.6758790237,3403,0,521.8461538461538,81,101,38,35.73042291727951,0.5757783882783882,40.879065040650424,8134.918856699554,100.43109699629079,0
3602,31.400250877604638,0,0,180,0.0,0.0,1.0,180,5850,4200,1650,0.717948717948718,75,42,33,199.52218327337084,0.45964721704945166,0.7431462435887219,0.1268941661493712,1055121.3911665364,254.02471679695373,1055375.4158833334,3404,1,523.8722222222223,83,97,40,35.589023758271594,0.577199074074074,40.76140873015874,8140.156803029849,98.07417834975722,0
3603,31.487666893235893,2,0,182,0.01098901098901099,0.0,1.0,182,5850,4300,1550,0.7350427350427351,74,43,31,218.48478910038764,0.46003582053305814,0.7648190184923116,0.13518016095676372,1050077.0736747468,3635.1735961957565,1053712.2472709424,3405,0,519.1043956043956,83,99,42,36.098506674349366,0.5689102564102564,41.74107142857142,8131.971115061134,97.97555560314619,8
3604,31.48184935356328,0,2,180,0.0,0.01098901098901099,0.989010989010989,182,5550,4000,1550,0.7207207207207207,71,40,31,220.39707908735122,0.45975059700888427,0.7670072293552868,0.13670455089401187,1050612.6854182123,4360.3934236585155,1054973.0788418709,3406,1,520.1043956043956,67,115,42,35.957419211384504,0.5702266483516483,41.65134803921569,8133.293341725574,121.3924379362026,0
3605,31.216849495667812,0,1,179,0.0,0.005555555555555556,0.9944444444444445,180,5500,3700,1800,0.6727272727272727,73,37,36,218.58457154270147,0.45958126422511897,0.7621984627768674,0.1357508536474923,1042132.6029826564,4058.821702728951,1046191.4246853854,3407,2,525.3111111111111,68,112,42,35.95819213990805,0.571412037037037,41.60628019323672,8066.237861833509,118.62114502696336,0
3606,31.56685641660999,0,0,179,0.0,0.0,1.0,179,6150,4300,1850,0.6991869918699187,80,43,37,190.60037229507037,0.45933112589709785,0.7172539572715699,0.11545756830168048,1046478.7292071208,-2058.1529228505806,1044420.5762842703,3408,3,528.4972067039106,82,97,43,37.5997140582606,0.5659916201117319,42.50753012048189,8128.227825044925,99.1247295737186,8
3607,31.301275611857257,1,1,179,0.005555555555555556,0.005555555555555556,0.9944444444444445,180,4800,3600,1200,0.75,60,36,24,204.43748305155304,0.4595903165735568,0.7532370326094173,0.11984019241249046,1027930.2136908623,1229.493127920904,1029159.7068187832,3409,0,526.5555555555555,67,113,41,38.48002590157402,0.5534722222222221,43.71936274509803,8021.910860698085,119.73001284624009,8
3608,31.709482382274064,0,0,179,0.0,0.0,1.0,179,5700,3600,2100,0.631578947368421,78,36,42,201.59241413074338,0.4593834348126295,0.7476845418710838,0.11890331013100691,1043203.8216261715,560.3953664073351,1043764.2169925788,3410,1,529.2960893854748,71,108,43,38.31852791878176,0.5554585661080074,43.48958333333332,8133.812538161417,114.56073997410446,0
3609,31.56825808046441,0,1,178,0.0,0.00558659217877095,0.994413407821229,179,5000,3600,1400,0.72,64,36,28,201.47321050061151,0.45923696984914114,0.747855366747274,0.11923315863288861,1039569.0009653276,1089.0608322794228,1040658.061797607,3411,2,530.2960893854748,72,107,44,38.19421276990081,0.5566224394785848,43.364726027397246,8101.528561317782,112.52123001830253,0
3610,31.531421854059225,2,2,178,0.011111111111111112,0.011111111111111112,0.9888888888888889,180,6050,4400,1650,0.7272727272727273,77,44,33,209.409950563658,0.45927219118559903,0.7541313172778685,0.12503005871888978,1041001.7330427215,1549.2242906316505,1042550.9573333531,3412,0,528.3055555555555,78,102,34,37.65693418171863,0.5576388888888889,43.0379746835443,8102.378020726601,103.87664129136668,7
3611,31.193801624279132,1,1,178,0.00558659217877095,0.00558659217877095,0.994413407821229,179,6000,4700,1300,0.7833333333333333,73,47,26,230.18926442238669,0.45923173895758795,0.7763496533938381,0.13299475236409386,1020057.0804175927,5161.23780203461,1025218.3182196273,3413,0,532.1675977653631,68,111,37,38.37650039354586,0.5423067970204842,44.26328502415459,7977.4003550013385,117.31471110296086,7
3612,31.05771035621499,1,0,179,0.00558659217877095,0.0,1.0,179,6350,4500,1850,0.7086614173228346,82,45,37,228.52695878561076,0.45960313225786203,0.77279911065346,0.13291127922971108,1017587.073302664,4359.215832281611,1021946.2891349456,3414,0,531.2737430167598,70,109,36,38.16411623108664,0.5442853817504656,44.01408450704225,7950.3364186508,113.57623455215428,0
3613,30.72887651694939,2,4,177,0.011049723756906077,0.022099447513812154,0.9779005524861879,181,5450,3100,2350,0.5688073394495413,78,31,47,226.86886568467213,0.4596940863515449,0.7744968836346913,0.13299098086579397,1009136.295784527,4138.32134917331,1013274.6171337003,3415,0,526.3922651933701,66,115,37,37.904685351451896,0.5467311233885819,43.718905472636806,7875.230107359958,119.3216682933327,0
3614,30.313510088842342,4,0,181,0.022099447513812154,0.0,1.0,181,5700,4000,1700,0.7017543859649122,74,40,34,215.39791222074138,0.46066861059954983,0.7627249341314386,0.1275420214551381,998403.2909707612,1110.7968858837266,999514.087856645,3416,0,524.7348066298342,71,110,38,37.816610296880846,0.5503568139963168,43.34490740740739,7780.116738658287,109.57910899518714,0
3615,30.769687210695047,2,0,183,0.01092896174863388,0.0,1.0,183,5400,3800,1600,0.7037037037037037,70,38,32,214.5895139801097,0.46125572969835266,0.7647027472116197,0.12789871424353322,1015343.3244740537,1576.4061043670663,1016919.7305784208,3417,0,519.9890710382514,73,110,37,37.589726027397276,0.5525956284153005,43.102477477477464,7904.656413220468,108.28296456466394,0
3616,31.28262954413473,0,4,179,0.0,0.02185792349726776,0.9781420765027322,183,5900,4300,1600,0.7288135593220338,75,43,32,188.07393223288952,0.4614346263936428,0.7354339013324065,0.10687325147427539,1017927.8829475138,-4210.860064912054,1013717.0228826018,3418,1,520.9890710382514,81,102,43,40.095400524516165,0.5338114754098361,44.893292682926834,7980.408619224011,98.52356320029644,8
3617,31.584418963564445,2,1,180,0.011049723756906077,0.0055248618784530384,0.994475138121547,181,5250,3400,1850,0.6476190476190476,71,34,37,182.59590244021206,0.46049212195621037,0.724860173154769,0.10453889106887933,1030042.6128332287,-3833.6879115682764,1026208.9249216603,3419,0,526.1491712707183,73,108,42,39.94533015488071,0.5367173112338859,44.608671171171196,8066.386729391233,110.4984483478251,0
3618,31.172939143295206,4,2,182,0.021739130434782608,0.010869565217391304,0.9891304347826086,184,5200,3400,1800,0.6538461538461539,70,34,36,199.01545693943757,0.46185257780945593,0.7467376161621786,0.1151697821042091,1019861.0776334653,-1406.376324005424,1018454.7013094599,3420,0,518.5380434782609,75,109,44,39.11153306899567,0.5424592391304348,44.202302631578966,7973.9660530608835,106.31954737414512,8
3619,31.21465643953226,3,1,184,0.016216216216216217,0.005405405405405406,0.9945945945945946,185,5350,3900,1450,0.7289719626168224,68,39,29,195.69220278344747,0.46183534077555816,0.7436086347496538,0.114069764104919,1023400.9763942496,-2295.681719735411,1021105.2946745142,3421,0,507.75135135135133,80,105,41,38.91895172090534,0.5447635135135135,43.9300411522634,7993.135789917323,99.91419737396653,0
3620,31.742468529635463,1,2,183,0.005405405405405406,0.010810810810810811,0.9891891891891892,185,5700,4200,1500,0.7368421052631579,72,42,30,198.51066572486926,0.46217929886408143,0.7485244273522,0.11649915488341134,1042766.488950675,-1299.9460165638584,1041466.5429341112,3422,0,500.3243243243243,70,115,42,38.588351172419,0.5470157657657657,43.67664319248822,8136.336086872874,116.23337266961249,0
3621,32.06252666664166,0,1,182,0.0,0.00546448087431694,0.994535519125683,183,4700,3000,1700,0.6382978723404256,64,30,34,198.31750557585727,0.4616635641225805,0.744482698343937,0.11691561701298762,1054671.8628106285,531.9786067287737,1055203.8414173573,3423,1,505.94535519125685,72,111,43,38.42072322670373,0.5484972677595629,43.50742009132416,8223.800183117533,114.21944698774352,0
3622,32.32791003477285,0,2,180,0.0,0.01098901098901099,0.989010989010989,182,5700,3600,2100,0.631578947368421,78,36,42,217.84316370849996,0.4612114979863599,0.769200550339342,0.12520513555652077,1055509.35540552,3887.099461091224,1059396.4548666112,3424,2,509.6868131868132,62,120,45,38.8942359538445,0.5404647435897436,44.46097883597881,8261.042486564327,133.24262075103755,8
3623,32.120058896196,4,1,183,0.021739130434782608,0.005434782608695652,0.9945652173913043,184,5300,3700,1600,0.6981132075471698,69,37,32,213.25798915614027,0.46153765245109685,0.7676126442587525,0.12405542786005677,1052455.4710021014,2788.9074844570932,1055244.3784865586,3425,0,504.17934782608694,68,116,41,38.547379646556976,0.5437613224637681,44.00664251207728,8222.521719546996,120.9194370521617,0
3624,32.073922857316745,2,2,183,0.010810810810810811,0.010810810810810811,0.9891891891891892,185,6800,4800,2000,0.7058823529411765,88,48,40,212.32877251081547,0.4620801508029769,0.7664272749622087,0.12452925852024792,1053459.762671453,935.9636595129259,1054395.7263309658,3426,0,502.1459459459459,62,123,46,38.258418811689566,0.5466216216216216,43.70039682539683,8220.53370058312,132.58925323521163,0
3625,31.687847409063313,5,2,186,0.026595744680851064,0.010638297872340425,0.9893617021276596,188,5500,3800,1700,0.6909090909090909,72,38,34,211.86630388381815,0.4636270006068191,0.7656185297655445,0.1263004098843313,1045699.8626807046,1209.7129755953633,1046909.5756563,3427,0,494.9255319148936,69,119,40,37.652291859746725,0.5500332446808511,43.095238095238095,8140.758893899831,117.98201295507,0
3626,31.652550095274282,2,1,187,0.010638297872340425,0.005319148936170213,0.9946808510638298,188,5500,3900,1600,0.7090909090909091,71,39,32,224.63665264717613,0.4633058131376342,0.7801609359448656,0.13269725101629287,1041790.5158380249,3704.866847485626,1045495.3826855106,3428,0,495.9148936170213,68,120,39,37.669535157399245,0.5461546985815603,43.43297101449274,8121.000737759431,119.4264814376387,8
3627,31.32290535935725,1,0,188,0.005319148936170213,0.0,1.0,188,5650,4000,1650,0.7079646017699115,73,40,33,219.16604082706374,0.46277425380210113,0.7735588966585341,0.13032807199637977,1032918.9954842567,2026.153347070188,1034945.1488313269,3429,0,496.8670212765957,73,115,40,37.55846671051665,0.5478723404255319,43.18693693693692,8044.131269370927,110.19357903247845,0
3628,31.80231330568486,0,3,185,0.0,0.015957446808510637,0.9840425531914894,188,6400,5000,1400,0.78125,78,50,28,219.06832781977786,0.4625490670155877,0.7738295149226655,0.1309939184718256,1050398.890035288,2021.8256767559233,1052420.715712044,3430,1,497.8670212765957,75,113,36,37.352015784982946,0.5499778368794326,42.982456140350855,8173.752454882104,108.98336606509471,0
3629,31.857153994491203,1,0,186,0.005376344086021506,0.0,1.0,186,5100,3500,1600,0.6862745098039216,67,35,32,220.5357735944306,0.4620362297781653,0.7783622935373016,0.13043884169914519,1048906.6723151938,3964.288881478308,1052870.9611966722,3431,0,504.10752688172045,62,124,40,37.72699205326458,0.5450268817204301,43.38624338624339,8174.983961549346,131.85458002498945,8
3630,32.194190381353735,1,0,187,0.0053475935828877,0.0,1.0,187,5700,4000,1700,0.7017543859649122,74,40,34,215.73076384443053,0.4623835604623081,0.7755551538542096,0.12877986103803446,1062825.807605703,2756.8446616705296,1065582.6522673734,3432,0,502.4064171122995,64,123,40,37.50155918672821,0.5468471479500892,43.0448717948718,8272.462316901068,129.2572237015792,0
3631,32.510508175394634,2,2,187,0.010582010582010581,0.010582010582010581,0.9894179894179894,189,6300,4200,2100,0.6666666666666666,84,42,42,210.4059719941236,0.46284335247101205,0.7722265842022855,0.12649972959716263,1075459.311328033,1156.6123480211318,1076615.9236760542,3433,0,498.07936507936506,69,120,43,37.37073329476426,0.5490520282186948,42.782738095238095,8362.263896007384,121.1922303769186,0
3632,32.01578992811644,2,1,188,0.010582010582010581,0.005291005291005291,0.9947089947089947,189,6900,5000,1900,0.7246376811594203,88,50,38,205.43069573849448,0.4626967709857781,0.7673445676019055,0.12477984313911311,1062178.2847250877,-1059.1951941208745,1061119.0895309667,3434,0,498.6825396825397,65,124,43,37.11673865980435,0.5520282186948854,42.4084595959596,8246.996644835679,126.87687145901045,0
3633,32.12119574667719,2,0,190,0.010526315789473684,0.0,1.0,190,5650,4200,1450,0.7433628318584071,71,42,29,196.14148269785062,0.46272858071103684,0.7570552072702517,0.12001199195580392,1067874.0691078396,-1759.1193501201033,1066114.9497577194,3435,0,496.9736842105263,69,121,48,37.08520891043395,0.5546052631578947,42.14285714285715,8282.679760393217,120.03883710714808,0
3634,31.666208971216815,1,2,189,0.005235602094240838,0.010471204188481676,0.9895287958115183,191,6100,4300,1800,0.7049180327868853,79,43,36,209.9114497679153,0.462770965371544,0.7719714080469056,0.12217148407355705,1037740.9526563778,-733.2584288722292,1037007.6942275056,3436,0,495.36649214659684,78,113,36,38.613342947397335,0.5426483420593369,43.987341772151915,8106.950334719788,103.93526070153574,8
3635,32.08950635899117,2,3,188,0.010471204188481676,0.015706806282722512,0.9842931937172775,191,6200,4600,1600,0.7419354838709677,78,46,32,204.95258142339654,0.462485073941398,0.7675810951163924,0.12060357082165574,1054991.7522337881,-1155.3433998586406,1053836.4088339296,3437,0,496.29319371727746,71,120,39,38.32092078537574,0.5455388307155322,43.57638888888888,8228.507099345456,115.89446618796417,0
3636,31.816943168543066,1,2,187,0.005291005291005291,0.010582010582010581,0.9894179894179894,189,5300,3800,1500,0.7169811320754716,68,38,30,202.6523404694517,0.46241767983789256,0.7627243888351967,0.11986866212712818,1047600.9614255303,-640.2426578138584,1046960.7187677164,3438,0,501.3333333333333,73,116,42,38.183625891387834,0.5475088183421517,43.384009009009,8164.736401499689,111.84570413013273,0
3637,32.25725710489496,2,1,188,0.010582010582010581,0.005291005291005291,0.9947089947089947,189,6200,4100,2100,0.6612903225806451,83,41,42,199.42177432077358,0.46273429584599796,0.7588847549861197,0.11847338649084788,1063436.8419039287,-1585.5076218878285,1061851.3342820408,3439,0,502.2275132275132,76,113,44,38.10169818941746,0.5495480599647267,43.222402597402585,8282.940978192762,108.98606550253635,0
3638,32.44378816082216,4,4,188,0.020833333333333332,0.020833333333333332,0.9791666666666666,192,4550,3300,1250,0.7252747252747253,58,33,25,200.5125284602404,0.4636853957606166,0.7643149097120561,0.12034275653633032,1072721.1104881973,68.80443933297283,1072789.9149275303,3440,0,495.2239583333333,82,110,38,37.69013339840575,0.5523546006944444,42.84638554216867,8343.037392259595,101.74435844219019,0
3639,32.06919695233601,0,0,188,0.0,0.0,1.0,188,5800,4300,1500,0.7413793103448276,73,43,30,224.85920041439053,0.46276180926916216,0.7793972246675576,0.12697471320270054,1041553.1670550094,3440.56246661294,1044993.7295216223,3441,1,506.2659574468085,72,116,38,39.403238900397504,0.528867464539007,45.13413242009131,8173.343703848055,113.51866255344521,8
3640,31.58454718738743,3,2,189,0.015706806282722512,0.010471204188481676,0.9895287958115183,191,6600,4900,1700,0.7424242424242424,83,49,34,206.40999831518195,0.4637158996968862,0.765824053998627,0.11469674587303479,1020825.4414914862,-2658.284468329324,1018167.1570231569,3442,0,499.29842931937173,65,126,40,40.5065362012954,0.5226876090750436,45.75441919191921,8030.2315442175895,123.54202375719369,7
3641,31.401685822492894,0,0,189,0.0,0.0,1.0,189,6800,5500,1300,0.8088235294117647,81,55,26,204.74538591861818,0.46314824196029875,0.7614197045806874,0.11418009558283743,1016023.3142293078,-2994.7828851611557,1013028.5313441467,3443,1,501.62433862433863,66,123,43,40.40726989365608,0.5244708994708995,45.61567164179107,7988.096757270393,121.03176904955141,0
3642,31.908925277286695,4,0,193,0.02072538860103627,0.0,1.0,193,6750,5100,1650,0.7555555555555555,84,51,33,201.13525228167552,0.4644479526482441,0.760216414278762,0.113342094218504,1035698.6866470786,-3686.8966746877622,1032011.7899723909,3444,0,492.20725388601034,73,120,47,40.08931860036832,0.5278497409326425,45.213963963963984,8129.948585569997,111.36915870643831,0
3643,32.04193725327276,3,3,193,0.015306122448979591,0.015306122448979591,0.9846938775510204,196,6550,4100,2450,0.6259541984732825,90,41,49,210.14969024682756,0.465552503052503,0.770552680117164,0.11846215872432175,1040122.6974578955,-2033.7074621061447,1038088.9899957894,3445,0,485.65816326530614,83,113,37,39.84629751301888,0.5334821428571428,45.200892857142826,8164.257003261273,98.36454220796715,7
3644,31.5516405370688,4,0,197,0.02030456852791878,0.0,1.0,197,6200,4500,1700,0.7258064516129032,79,45,34,213.99665293499615,0.4657953917607652,0.7791290656138379,0.12197809217294794,1027624.7727160058,-1618.3476331376942,1026006.4250828681,3446,0,484.15736040609136,66,131,44,39.314413783300864,0.5361146362098139,44.77611940298508,8052.732137072794,122.01109298595142,0
3645,31.478052821489463,4,5,196,0.01990049751243781,0.024875621890547265,0.9751243781094527,201,6300,4500,1800,0.7142857142857143,81,45,36,204.8674452688516,0.46669050580431176,0.7722903185295944,0.1180658771956539,1028583.7854861799,-4355.333524496373,1024228.4519616835,3447,0,475.50248756218906,76,125,47,39.121509587059684,0.5387126865671642,44.35876623376624,8047.088259844252,105.88274026110858,0
3646,31.55550318223281,4,2,198,0.02,0.01,0.99,200,5850,3600,2250,0.6153846153846154,81,36,45,199.72577874378757,0.46760050251256285,0.7630694789081873,0.1161129383060401,1033772.664687223,-4555.789900260496,1029216.8747869625,3448,0,477.275,81,119,37,38.91708023159635,0.5414583333333334,44.02947154471547,8077.278825228606,99.71949166948897,0
3647,31.432691731516964,0,3,195,0.0,0.015151515151515152,0.9848484848484849,198,6600,5000,1600,0.7575757575757576,82,50,32,218.71953089899284,0.46739390521116414,0.7867157475233488,0.1248229397925117,1024124.8680220046,-1400.7778568468393,1022724.0901651578,3449,1,483.0959595959596,66,132,39,39.14621272103456,0.5352483164983165,44.7294776119403,8023.839638367176,121.57332785404812,8
3648,31.7626963610627,2,2,195,0.01015228426395939,0.01015228426395939,0.9898477157360406,197,5550,4100,1450,0.7387387387387387,70,41,29,221.97817732532613,0.4673018319002728,0.7873609335702116,0.12472140323508682,1030041.2562974195,779.3361285580349,1030820.5924259776,3450,0,486.4162436548223,73,124,39,39.67338234210331,0.5290291878172588,45.32657657657657,8089.114619430542,110.80978930726769,8
3649,31.948360787331872,3,2,196,0.015151515151515152,0.010101010101010102,0.98989898989899,198,7050,4900,2150,0.6950354609929078,92,49,43,214.3408225221222,0.46737254097660186,0.7821444337348142,0.12128416164662616,1038269.9595958844,-2141.2725720416875,1036128.6870238427,3451,0,484.90909090909093,78,120,35,39.59087578657011,0.5313552188552189,45.05537974683543,8145.06270863738,104.4238808799664,0
3650,31.872097385621686,3,1,198,0.01507537688442211,0.005025125628140704,0.9949748743718593,199,6300,4000,2300,0.6349206349206349,86,40,46,210.3502898806249,0.46804096238769605,0.7816152969396524,0.11989894559360595,1038060.0689283878,-2428.752717482259,1035631.3162109056,3452,0,482.8542713567839,67,132,40,39.40771112178142,0.5343383584589615,44.7763480392157,8134.513090408158,121.41064314042026,0
3651,31.439610875990056,4,1,201,0.019801980198019802,0.0049504950495049506,0.995049504950495,202,5950,3900,2050,0.6554621848739496,80,39,41,200.83405586847468,0.4690953237114756,0.7751531153996252,0.11588150542550762,1027695.0091528228,-5070.76862320974,1022624.240529613,3453,0,476.61386138613864,73,129,41,39.17799860529987,0.5373349834983498,44.31306306306307,8038.697803371122,110.11914799138523,0
3652,31.202833199685497,2,2,201,0.009852216748768473,0.009852216748768473,0.9901477832512315,203,6150,4400,1750,0.7154471544715447,79,44,35,206.8882924047733,0.46917219431302737,0.7797755009969454,0.12032742087316564,1022344.9021611094,-4447.76178863257,1017897.1403724768,3454,0,474.64039408866995,78,125,35,38.7176565021806,0.5398706896551724,44.01371308016878,7987.497412166326,102.40381297649137,0
3653,30.840531825098015,1,2,200,0.0049504950495049506,0.009900990099009901,0.9900990099009901,202,6900,5300,1600,0.7681159420289855,85,53,32,211.62968464065187,0.4688844350852996,0.7837361525516471,0.12360101557270768,1011713.1552021016,-4478.292803555856,1007234.8623985457,3455,0,477.94554455445547,77,125,37,38.43608793882519,0.5414088283828382,43.85683760683762,7899.591351567609,102.59209547490401,0
3654,30.81709613612275,2,0,202,0.009900990099009901,0.0,1.0,202,5850,4000,1850,0.6837606837606838,77,40,37,209.47590483563826,0.46888700064036254,0.7831334274666526,0.12341922118071376,1013526.4795397288,-3788.1247247074216,1009738.3548150214,3456,0,472.8019801980198,70,132,39,38.15749957096272,0.5436262376237624,43.52992957746477,7903.6628162494035,112.9094688035629,0
3655,31.18221567458008,1,0,203,0.0049261083743842365,0.0,1.0,203,6600,4300,2300,0.6515151515151515,89,43,46,207.88949294552907,0.46896084312864783,0.7831761268803865,0.1231532493297193,1027152.6022969265,-4493.153266162493,1022659.449030764,3457,0,471.4679802955665,73,130,41,37.9917553288728,0.5455665024630543,43.32770270270269,8003.610932014222,109.63850591800305,0
3656,31.503664508196277,2,2,203,0.00975609756097561,0.00975609756097561,0.9902439024390244,205,6900,4800,2100,0.6956521739130435,90,48,42,218.94615217251464,0.46920731707317076,0.7957310543334617,0.12730505410877552,1032117.538824983,-2704.367256900904,1029413.1715680822,3458,0,467.85853658536587,75,130,37,38.419629470978826,0.5391260162601625,44.024122807017534,8064.178157278942,107.52237543038589,8
3657,31.468217047153185,1,1,203,0.004901960784313725,0.004901960784313725,0.9950980392156863,204,5750,4300,1450,0.7478260869565218,72,43,29,216.62221980267947,0.4689995250973953,0.7925665916750184,0.12656601095057615,1032421.3405824715,-1820.919486273333,1030600.4210961981,3459,0,470.80392156862746,78,126,39,38.293354609564005,0.5407475490196079,43.84229957805908,8060.826115177292,103.34392455355503,0
3658,31.397674450482988,2,2,203,0.00975609756097561,0.00975609756097561,0.9902439024390244,205,6500,4800,1700,0.7384615384615385,82,48,34,238.84186478064433,0.46952913279132796,0.8147315629961027,0.13918715568251383,1029326.1937330667,1669.23751575385,1030995.4312488205,3460,0,469.4829268292683,65,140,36,37.82359467455622,0.5366869918699186,43.93939393939395,8039.707548684308,123.68780844129704,8
3659,30.994218529169412,0,1,202,0.0,0.0049261083743842365,0.9950738916256158,203,6850,5400,1450,0.7883211678832117,83,54,29,229.85447771900976,0.4692331610008291,0.8054616230164817,0.13381239580014895,1015794.1942620449,-753.0312015790441,1015041.1630604658,3461,1,474.57635467980293,63,140,38,38.093081161262994,0.5323275862068966,43.977864583333336,7935.206013408777,125.95565100648852,8
3660,30.70851086259461,3,2,203,0.014634146341463415,0.00975609756097561,0.9902439024390244,205,6550,4800,1750,0.732824427480916,83,48,35,225.8826001553114,0.46995456719273077,0.8039540331462984,0.13278783706859246,1009298.0824735336,-1953.4249598215774,1007344.657513712,3462,0,469.25853658536585,60,145,42,37.822060521291235,0.5353658536585366,43.613387978142086,7873.251060297073,131.22085100495121,0
3661,30.723303009745198,3,2,204,0.014563106796116505,0.009708737864077669,0.9902912621359223,206,5900,4400,1500,0.7457627118644068,74,44,30,253.16275898915018,0.4699872720814587,0.8239987154493171,0.1455467033527714,1003203.9066638828,3694.7737679446054,1006898.6804318274,3463,0,467.86893203883494,60,146,40,37.98056576456176,0.5286711165048543,44.450136612021865,7851.335886967856,130.85559811613092,8
3662,30.717173710135796,2,2,204,0.009708737864077669,0.009708737864077669,0.9902912621359223,206,6650,4700,1950,0.706766917293233,86,47,39,254.97282984807495,0.4700454850422291,0.8248597187688083,0.14806967609722785,1005985.940131055,3449.8163885182967,1009435.7565195733,3464,0,468.1650485436893,64,142,35,37.54500626174077,0.5308960355987056,44.07051282051283,7861.4305152383,122.83485180059844,0
3663,31.24923662031093,2,4,202,0.009708737864077669,0.019417475728155338,0.9805825242718447,206,7000,4300,2700,0.6142857142857143,97,43,54,259.3765604757045,0.4701022180124714,0.8292053674931761,0.1476721682914939,1017420.8525469049,4579.024257975008,1021999.87680488,3465,0,468.9466019417476,71,135,36,38.20184639225912,0.5278114886731391,44.820601851851855,7974.161393360026,112.31213230084543,8
3664,31.62960397385181,2,1,203,0.00980392156862745,0.004901960784313725,0.9950980392156863,204,6300,4900,1400,0.7777777777777778,77,49,28,251.2961428452243,0.46987286293827873,0.8227488365497408,0.14445254469674496,1032752.7061088835,4805.354311626135,1037558.0604205097,3466,0,471.9901960784314,61,143,35,38.03391409160639,0.5313521241830066,44.455645161290334,8082.7667413018735,132.50437280822743,0
3665,31.697663730762166,2,3,202,0.00975609756097561,0.014634146341463415,0.9853658536585366,205,7100,4600,2500,0.647887323943662,96,46,50,256.24872892495574,0.4702056432329029,0.8263747804515904,0.14564010036367736,1031489.0085526503,4763.549468335927,1036252.5580209863,3467,0,470.66341463414636,65,140,38,38.34910913140312,0.5275406504065041,44.88636363636363,8086.506258586479,124.40778859363813,8
3666,31.32450056462564,2,1,203,0.00980392156862745,0.004901960784313725,0.9950980392156863,204,6350,4200,2150,0.6614173228346457,85,42,43,251.44561789461255,0.47132825831482017,0.8232707330953495,0.14139152697634724,1016077.2256915959,3947.633168533343,1020024.8588601293,3468,0,470.078431372549,61,143,37,38.89127088830255,0.5199652777777778,45.29569892473118,7978.485022844827,130.79483644007914,8
3667,31.1828662908312,8,1,210,0.037914691943127965,0.004739336492890996,0.995260663507109,211,6450,4300,2150,0.6666666666666666,86,43,43,228.2266120699213,0.4734484315053036,0.8080108393865792,0.12768522349913214,1009930.1187397403,-2551.4141145312306,1007378.7046252091,3469,0,455.4407582938389,66,145,41,39.68272755039706,0.519994075829384,45.491293532338304,7936.310963633488,120.24713581262861,8
3668,31.666779758914682,5,2,213,0.023255813953488372,0.009302325581395349,0.9906976744186047,215,6600,4500,2100,0.6818181818181818,87,45,42,244.69726275390738,0.47400836774614213,0.8242654885148035,0.13730430339031974,1026519.269978748,637.2911055876239,1027156.5610843357,3470,0,447.89302325581394,63,152,40,39.14706383704081,0.5185077519379845,45.37760416666665,8063.071330541329,127.98525921494173,8
3669,31.31878906480151,5,3,215,0.022935779816513763,0.013761467889908258,0.9862385321100917,218,7150,5100,2050,0.7132867132867133,92,51,41,247.49453527270748,0.4752652059640074,0.8290306686573952,0.1331035800739869,1002053.9034039374,-1149.4269717680909,1000904.4764321692,3471,0,442.57339449541286,70,148,37,40.77567374241191,0.5023413608562691,47.03638497652582,7922.514099989835,113.17877285699764,8
3670,31.04464219986677,6,4,217,0.027149321266968326,0.01809954751131222,0.9819004524886877,221,6850,4300,2550,0.6277372262773723,94,43,51,231.98757747116963,0.47608837241190183,0.8198550675330869,0.12679868960410504,998299.7599861057,-4731.371418154644,993568.388567951,3472,0,437.3755656108597,58,163,42,40.51506080014854,0.5060331825037707,46.398305084745765,7872.973879923841,135.74092896420416,0
3671,30.642991981229773,4,4,217,0.01809954751131222,0.01809954751131222,0.9819004524886877,221,7250,5300,1950,0.7310344827586207,92,53,39,232.87389888099605,0.4767825311942959,0.8189189929822318,0.1290874745679094,989658.1958947344,-5356.887472491979,984301.3084222424,3473,0,437.4977375565611,66,155,40,39.930364388980635,0.5104638009049773,45.84888059701493,7787.950713886256,117.99925324070085,0
3672,30.21754764032737,3,2,218,0.013636363636363636,0.00909090909090909,0.990909090909091,220,6850,5100,1750,0.7445255474452555,86,51,35,222.13231242124064,0.4764628303583783,0.8141148862934169,0.12268623311853806,974832.1277308571,-7541.657048925632,967290.4706819315,3474,0,437.8909090909091,72,148,38,40.347920528809226,0.5116003787878788,45.990296803652946,7675.550307440982,106.60486538112474,8
3673,30.577662859133024,3,3,218,0.013574660633484163,0.013574660633484163,0.9864253393665159,221,6850,5500,1350,0.8029197080291971,82,55,27,263.3164694793116,0.47719988344988346,0.8403053400472345,0.1435344673038707,982461.8627348649,689.6778186825022,983151.5405535474,3475,0,436.26244343891403,58,163,38,39.829276361610276,0.5005656108597285,46.50423728813559,7751.307968422168,133.64324083486497,8
3674,30.451600273564527,6,0,224,0.026785714285714284,0.0,1.0,224,6700,4300,2400,0.6417910447761194,91,43,48,256.6514377855417,0.47826037996476617,0.8381147540983607,0.1423248882265275,983597.2623084505,-1011.669685322755,982585.5926231277,3476,0,428.82589285714283,55,169,39,39.31010928961747,0.5045107886904762,45.83333333333333,7739.781736197643,140.7233042945026,0
3675,30.060864436484447,2,2,224,0.008849557522123894,0.008849557522123894,0.9911504424778761,226,7100,5100,2000,0.7183098591549296,91,51,40,249.85226459427992,0.4786090626024255,0.8334492980510697,0.13930119409571465,972568.7759842189,-3700.2977693313214,968868.4782148876,3477,0,426.0221238938053,59,167,43,39.26938301938305,0.5066832595870207,45.62499999999999,7646.732391030714,129.6056337462833,0
3676,30.47270650062403,5,2,227,0.021834061135371178,0.008733624454148471,0.9912663755458515,229,7550,5200,2350,0.6887417218543046,99,52,47,267.75924215702486,0.47908766184019,0.8452071229947085,0.14791748425955945,983126.7866458539,-701.7433326873552,982425.0433131666,3478,0,421.3056768558952,69,160,33,39.180579964850594,0.5110080058224162,45.98214285714283,7740.611606631678,112.18277690770547,8
3677,30.43358025079727,1,3,225,0.0043859649122807015,0.013157894736842105,0.9868421052631579,228,7100,5400,1700,0.7605633802816901,88,54,34,268.523157337156,0.479058788675065,0.8448765709182642,0.14936788703427709,983940.0580893065,142.13820572921395,984082.1962950357,3479,0,424.1359649122807,60,168,33,38.885624426387324,0.5128837719298245,45.71379781420766,7738.839540891785,128.98065901486308,0
3678,30.074176280737344,4,4,225,0.017467248908296942,0.017467248908296942,0.982532751091703,229,7450,5600,1850,0.7516778523489933,93,56,37,266.74827985130884,0.4795217893715366,0.8447781985181304,0.1499924648167396,975512.481454379,-1206.744719712431,974305.7367346666,3480,0,423.1965065502183,65,164,36,38.50255091502461,0.5156022561863174,45.29671717171718,7659.991427060288,117.84602195477366,0
3679,29.716835041190237,3,6,222,0.013157894736842105,0.02631578947368421,0.9736842105263158,228,6900,4700,2200,0.6811594202898551,91,47,44,264.82160497891135,0.4794017440812015,0.8487462621956523,0.14881497425227927,963737.3692745757,-1456.304618110527,962281.0646564652,3481,0,425.68859649122805,60,168,34,38.57658911090249,0.5197368421052632,45.321038251366126,7568.252694745764,126.13754491242939,8
3680,29.81487856015464,1,3,220,0.004484304932735426,0.013452914798206279,0.9865470852017937,223,7600,5600,2000,0.7368421052631579,96,56,40,262.98704632171643,0.4784874560659314,0.8457374278991505,0.1487906577511457,968896.4473096164,-1238.5570260878894,967657.8902835285,3482,0,436.1031390134529,61,162,32,38.35590483722157,0.5218609865470851,45.060483870967744,7600.990713571684,124.60640514051941,0
3681,30.3373778737617,4,8,216,0.017857142857142856,0.03571428571428571,0.9642857142857143,224,6400,4400,2000,0.6875,84,44,40,261.9271631337174,0.47869454676489426,0.8468800324193748,0.14990771934189492,989276.4894363265,623.6768865879553,989900.1663229145,3483,0,434.9330357142857,54,170,36,37.93214797785026,0.5244605654761905,44.62121212121212,7747.522788822018,143.47264423744477,0
3682,30.15362470073902,3,2,217,0.0136986301369863,0.0091324200913242,0.9908675799086758,219,7250,5100,2150,0.7034482758620689,94,51,43,238.78369430560895,0.4785426528702889,0.8240069239263443,0.13531076010651175,980369.7230827772,-4230.739147385517,976138.9839353918,3484,0,444.2420091324201,74,145,36,38.911015795206964,0.5260178843226788,45.0,7689.174298688449,103.90776079308715,8
3683,30.194205800810877,4,0,221,0.01809954751131222,0.0,1.0,221,7300,5500,1800,0.7534246575342466,91,55,36,226.18807343820873,0.47875102838338135,0.8159357434749253,0.12962562962195387,984997.2489397369,-6941.073984077015,978056.1749556599,3485,0,439.36199095022624,65,156,37,38.79320110397102,0.5297417043740573,44.57070707070708,7712.484638262695,118.65360981942607,0
3684,30.264470409197653,1,2,220,0.0045045045045045045,0.009009009009009009,0.990990990990991,222,7850,5600,2250,0.7133757961783439,101,56,45,213.9800577383765,0.47833226325873385,0.8096530920060341,0.1237947454454999,990056.8785737725,-9879.51439170179,980177.3641820707,3486,0,438.3783783783784,71,151,38,38.739630467571644,0.5353322072072072,44.21296296296294,7741.259213463704,109.0318199079395,8
3685,30.482354780270025,2,3,219,0.009009009009009009,0.013513513513513514,0.9864864864864865,222,6000,4000,2000,0.6666666666666666,80,40,40,212.0768811675371,0.47828045805986985,0.8081549348165384,0.12334455654146013,998737.4226740438,-8038.176458797059,990699.2462152467,3487,0,438.5450450450451,74,148,40,38.58501528222379,0.5369275525525525,44.013888888888886,7803.059457710504,105.44674942852032,0
3686,30.408200098128095,1,1,219,0.004545454545454545,0.004545454545454545,0.9954545454545455,220,7100,4900,2200,0.6901408450704225,93,49,44,241.22083975761018,0.4779161477791615,0.8270495372890576,0.1396805833547884,995023.5727308815,-3095.915641447772,991927.6570894337,3488,0,443.4409090909091,67,153,37,38.00798403193613,0.5327651515151515,44.17892156862746,7779.058542260113,116.10535137701662,8
3687,29.987814897115836,1,3,217,0.004545454545454545,0.013636363636363636,0.9863636363636363,220,7250,5200,2050,0.7172413793103448,93,52,41,235.11751570811379,0.4776835132143351,0.8223107819756497,0.13447101562430308,977676.7155038622,-5276.215897012674,972400.4996068496,3489,0,444.2090909090909,64,156,37,38.64364984728672,0.5289772727272728,44.6474358974359,7657.465425811599,119.64789727830623,8
3688,29.831593845384955,8,6,219,0.035555555555555556,0.02666666666666667,0.9733333333333334,225,6250,4800,1450,0.768,77,48,29,223.4430818560089,0.4790873015873016,0.818517527428418,0.13034761112955134,978279.6411585574,-7532.036412508213,970747.6047460492,3490,0,434.96444444444444,75,150,38,38.17840736776382,0.533611111111111,43.90076754385965,7639.848286746412,101.86464382328549,0
3689,29.60995336777079,2,3,218,0.00904977375565611,0.013574660633484163,0.9864253393665159,221,6750,4400,2350,0.6518518518518519,91,44,47,229.83438037381953,0.47918466337583987,0.822235400320328,0.1346778257334562,972282.3974686883,-6257.215525882468,966025.1819428059,3491,0,426.5475113122172,61,160,40,37.84330678117965,0.5349264705882353,43.73319892473118,7588.048029546493,124.39422999256546,0
3690,29.882071129125094,2,3,217,0.00909090909090909,0.013636363636363636,0.9863636363636363,220,7450,5200,2250,0.697986577181208,97,52,45,227.6636668038066,0.47895651722706517,0.8183707759940952,0.13446334393687953,983471.5329803949,-6669.852920904588,976801.6800594903,3492,0,428.7181818181818,66,154,37,37.598094170403584,0.5371212121212121,43.439054726368155,7666.572415622228,116.1601881154883,0
3691,30.456790220841217,0,7,210,0.0,0.03225806451612903,0.967741935483871,217,6900,4900,2000,0.7101449275362319,89,49,40,228.39103242746054,0.47884664618535583,0.8175674431246438,0.1355733109096724,1003844.9195541432,-4446.164485193573,999398.7550689497,3493,1,433.33179723502303,66,151,44,37.38860461830367,0.5384504608294931,43.25248756218906,7819.705126041237,118.4803806975945,0
3692,30.62663600347425,0,2,208,0.0,0.009523809523809525,0.9904761904761905,210,6600,4900,1700,0.7424242424242424,83,49,34,229.5353788349973,0.4786345598845599,0.812275273229695,0.1369992183319701,1011031.142478214,-2186.5167394566156,1008844.6257387574,3494,2,444.6333333333333,69,141,37,37.15269734175015,0.5407242063492064,43.050595238095234,7869.495890952219,114.05066508626405,0
3693,30.60181767479327,0,3,205,0.0,0.014423076923076924,0.9855769230769231,208,7400,5600,1800,0.7567567567567568,92,56,36,224.2703787376242,0.4783368365229778,0.7998229517176625,0.13044839189294935,1002678.7583807473,-4025.7710211558706,998652.9873595914,3495,3,449.4855769230769,71,137,40,38.26932858596133,0.5388120993589743,44.010416666666664,7833.746555812959,110.33445853257689,8
3694,30.52457638530969,0,3,202,0.0,0.014634146341463415,0.9853658536585366,205,6850,4700,2150,0.6861313868613139,90,47,43,228.062882645262,0.47771700143472023,0.8012055025183902,0.133028150816456,1000973.0468741362,-2193.0402959345483,998780.0065782017,3496,4,456.9463414634146,73,132,40,38.06426235365249,0.5403963414634146,43.904842342342356,7817.196201829126,107.08487947711131,0
3695,31.02171022181205,0,4,198,0.0,0.019801980198019802,0.9801980198019802,202,7450,5900,1550,0.7919463087248322,90,59,31,226.941034013346,0.4774220892238477,0.7980655035605948,0.13287571901118925,1018400.9452336777,-1626.607289699822,1016774.3379439779,3497,5,463.65841584158414,78,124,41,37.9481208940119,0.5426980198019802,43.76318565400845,7948.904202801639,101.90902824104666,0
3696,31.32957583441364,0,1,197,0.0,0.005050505050505051,0.9949494949494949,198,5250,3100,2150,0.5904761904761905,74,31,43,228.36270551508878,0.47708418790271584,0.7963232323232337,0.13387374945097852,1028879.112904998,2141.5235741899487,1031020.636479188,3498,7,472.7171717171717,62,136,40,37.864381720430124,0.5443497474747474,43.716931216931215,8029.239838515392,129.5038683631515,0
3697,31.119634611925854,2,2,197,0.010050251256281407,0.010050251256281407,0.9899497487437185,199,6250,4600,1650,0.736,79,46,33,223.07196682825528,0.47697663401180984,0.792928058565789,0.13222557297987525,1025266.4386363005,-308.35980207997454,1024958.0788342205,3499,0,471.2562814070352,67,132,41,37.57963090051916,0.5469011725293133,43.30575980392157,7988.230961887891,119.2273277893715,0
3698,31.021219652162674,2,2,197,0.010050251256281407,0.010050251256281407,0.9899497487437185,199,6400,4700,1700,0.734375,81,47,34,225.71375868922343,0.47642886147911273,0.795469603611239,0.13503095102188536,1024737.8669204381,59.487122757771886,1024797.354043196,3500,0,468.27638190954775,72,127,40,37.16355317455911,0.5496231155778895,42.965182648401814,7973.533527317415,110.74352121274188,0
3699,30.661529216147837,0,1,196,0.0,0.005076142131979695,0.9949238578680203,197,5700,4400,1300,0.7719298245614035,70,44,26,229.33923557171988,0.47561962602299807,0.7974055398731497,0.137679936824568,1013868.4292876815,1403.962108627411,1015272.3913963089,3501,1,473.93908629441626,72,125,41,36.93899585691563,0.5509729272419628,42.836757990867575,7885.018258182301,109.51414247475418,0
3700,31.20041686791882,1,3,194,0.005076142131979695,0.015228426395939087,0.9847715736040609,197,5400,3500,1900,0.6481481481481481,73,35,38,233.10041810432648,0.47550524016713286,0.8019383501030579,0.14088092724956158,1033662.5480143629,3389.434424186344,1037051.9824385493,3502,0,474.1776649746193,61,136,40,36.59050486260689,0.552506345177665,42.590725806451616,8031.276660507131,131.66027312306773,0
3701,31.055275947701357,2,2,194,0.01020408163265306,0.01020408163265306,0.9897959183673469,196,6400,4400,2000,0.6875,84,44,40,225.1852282667577,0.4751466291644863,0.7931190424102255,0.13701635674449592,1030816.6853875564,824.9381200359217,1031641.6235075924,3503,0,475.8724489795918,65,131,39,36.543325676365505,0.5554315476190477,42.34532828282829,8001.536929391189,123.10056814447984,0
3702,31.49859979155161,0,1,193,0.0,0.005154639175257732,0.9948453608247423,194,7000,4900,2100,0.7,91,49,42,223.13702677449254,0.47499855331802077,0.7900190510567053,0.13648032970478796,1047069.5591376096,927.997650408945,1047997.5567880186,3504,1,479.2319587628866,65,129,41,36.40247852522903,0.5570768900343643,42.155934343434346,8121.727032742724,124.94964665758037,0
3703,31.609841614919247,0,1,192,0.0,0.0051813471502590676,0.9948186528497409,193,5850,3800,2050,0.6495726495726496,79,38,41,221.67643426095398,0.4743856145653425,0.7871654459384467,0.13629891025695148,1052311.6406744823,2204.5384472027736,1054516.1791216852,3505,2,482.5854922279793,65,128,40,36.24654667971539,0.5588838514680483,41.96654040404041,8156.396789177956,125.4830275258147,0
3704,31.876239190668326,0,4,188,0.0,0.020833333333333332,0.9791666666666666,192,6550,5400,1150,0.8244274809160306,77,54,23,224.57717182881007,0.47382028523123915,0.7887089659569426,0.13905970232117384,1063269.7211964566,2807.221375501503,1066076.942571958,3506,3,485.9895833333333,67,125,42,35.91207767431747,0.5608181423611112,41.712622549019606,8233.230223557877,122.884033187431,0
3705,31.99203883948214,0,1,187,0.0,0.005319148936170213,0.9946808510638298,188,6700,4600,2100,0.6865671641791045,88,46,42,224.24644388762252,0.47318617969431487,0.7761150874758873,0.13462191949627014,1057862.2318583846,3144.368723452905,1061006.6005818374,3507,4,496.3510638297872,80,108,38,37.070143854911514,0.5562943262411347,42.836934156378575,8227.17079054938,102.83963488186725,8
3706,31.876459596955513,1,2,186,0.005319148936170213,0.010638297872340425,0.9893617021276596,188,5250,3400,1850,0.6476190476190476,71,34,37,191.19637142043217,0.4729177333409185,0.7415233098332767,0.1128716998871593,1048967.1040944224,-2738.25919154981,1046228.8449028726,3508,0,497.07978723404256,70,118,50,38.55155553013839,0.5490359042553192,43.45657276995303,8177.696192963036,116.82423132804337,8
3707,31.56903943346967,1,1,186,0.0053475935828877,0.0053475935828877,0.9946524064171123,187,5400,3800,1600,0.7037037037037037,70,38,32,189.23681790618224,0.47283197247618497,0.7365505287860905,0.11238101678867873,1040636.9958820492,-3414.6332607666563,1037222.3626212826,3509,0,498.70588235294116,74,113,49,38.377192982456116,0.5509692513368984,43.236111111111086,8105.789333424302,109.537693694923,0
3708,31.875380638693503,2,4,184,0.010638297872340425,0.02127659574468085,0.9787234042553191,188,5800,3800,2000,0.6551724137931034,78,38,40,184.01143985899705,0.47252010088368035,0.7303275578055874,0.1099167608068144,1052497.848719425,-4665.671081728584,1047832.1776376965,3510,0,497.01063829787233,79,109,40,38.29212268612348,0.5528590425531915,43.020833333333314,8191.308753714211,103.6874525786609,0
3709,31.597121513792437,1,1,184,0.005405405405405406,0.005405405405405406,0.9945945945945946,185,5700,4300,1400,0.7543859649122807,71,43,28,189.23725569841838,0.4717538190364277,0.734904390556566,0.1134526675158756,1044403.6241326286,-3171.9848655321184,1041231.6392670964,3511,0,505.6216216216216,81,104,43,38.020627470355706,0.5545045045045045,42.88617886178859,8124.056649379498,100.29699567135182,0
3710,31.892565001418443,1,1,184,0.005405405405405406,0.005405405405405406,0.9945945945945946,185,6500,4500,2000,0.6923076923076923,85,45,40,231.1259375611606,0.47179543674108887,0.7764266172726182,0.13485660236993446,1045927.4818643173,4848.193973375164,1050775.6758376926,3512,0,506.56756756756755,79,106,37,37.97393741420513,0.5481981981981983,43.893229166666686,8167.901836105504,103.39116248234815,8
3711,31.57870631120637,1,2,183,0.005405405405405406,0.010810810810810811,0.9891891891891892,185,5500,3800,1700,0.6909090909090909,72,38,34,236.26722395066054,0.47187132784958874,0.7815616763991526,0.13884017766988183,1037784.9815693386,6538.915330614708,1044323.8968999533,3513,0,507.20540540540543,67,118,36,37.570207934990414,0.5499436936936937,43.62745098039213,8095.913431745509,120.83452883202253,0
3712,31.643480223322914,4,0,187,0.0213903743315508,0.0,1.0,187,6350,4700,1650,0.7401574803149606,80,47,33,249.9073344428759,0.47240910049259194,0.7922845985768097,0.14737094504932752,1040972.0374083786,8279.309419659423,1049251.3468280379,3514,0,501.6844919786096,69,118,34,37.08682630388118,0.5513591800356505,43.4970238095238,8116.646854306786,117.63256310589544,8
3713,32.064954723287904,2,0,189,0.010582010582010581,0.0,1.0,189,5650,4100,1550,0.7256637168141593,72,41,31,242.259838001247,0.47258457165372064,0.7869798793246912,0.1436232251557459,1056462.0398672083,7737.66452653943,1064199.7043937477,3515,0,497.36507936507934,73,116,37,37.08072859545222,0.5531856261022927,43.29954954954955,8231.088321141313,112.75463453618237,0
3714,32.04874679321709,2,4,187,0.010471204188481676,0.020942408376963352,0.9790575916230366,191,6350,4800,1550,0.7559055118110236,79,48,31,214.48808149319882,0.4727610912096996,0.770736678031761,0.12530370020492257,1051429.822651387,553.8330970463476,1051983.6557484332,3516,0,493.14659685863876,85,106,35,38.35272050942564,0.549956369982548,43.84689922480622,8209.385867041661,96.58101020049013,8
3715,31.567866862336903,1,1,187,0.005319148936170213,0.005319148936170213,0.9946808510638298,188,5900,4300,1600,0.7288135593220338,75,43,32,215.17055963334047,0.4717426138734024,0.7664829958962756,0.12636610342638022,1037245.351955433,1136.9325714664965,1038382.2845268996,3517,0,501.97872340425533,72,116,36,38.13421931533537,0.5511968085106382,43.65011415525115,8092.419066522321,112.39470925725446,0
3716,31.23625802233833,2,3,186,0.010582010582010581,0.015873015873015872,0.9841269841269842,189,5850,4400,1450,0.7521367521367521,73,44,29,216.35567538391084,0.4713474239183459,0.7720821301354321,0.12876892955607938,1030319.7921555636,933.1068986455448,1031252.8990542091,3518,0,500.2857142857143,76,113,33,37.59776940903824,0.5542879188712522,43.154761904761905,8022.884128951782,105.56426485462872,0
3717,31.623379724764646,2,2,186,0.010638297872340425,0.010638297872340425,0.9893617021276596,188,6050,4600,1450,0.7603305785123967,75,46,29,215.12983539023014,0.4707589031744226,0.771070924409551,0.12880749541941247,1044880.8421453269,1307.008714626068,1046187.850859953,3519,0,502.51063829787233,82,106,36,37.4039854188026,0.5568484042553192,42.93423694779118,8129.288239236406,99.13766145410251,0
3718,32.11309860851371,2,1,187,0.010638297872340425,0.005319148936170213,0.9946808510638298,188,6200,4700,1500,0.7580645161290323,77,47,30,203.31945646217653,0.4707037916714074,0.7590769683721368,0.12001041521925432,1056708.1263503192,-830.1356222576565,1055877.9907280616,3520,0,499.36170212765956,75,113,38,38.24625785827502,0.5534685283687943,43.462171052631575,8238.224597800854,109.84299463734472,8
3719,31.936167118602768,2,0,189,0.010582010582010581,0.0,1.0,189,5400,3600,1800,0.6666666666666666,72,36,36,198.85940567625926,0.47108474989680665,0.7557508505439083,0.11813874515373608,1052849.9461307093,-1326.1770892331065,1051523.769041476,3521,0,496.3809523809524,78,111,41,38.11631320393004,0.5559964726631393,43.222573839662445,8200.486794141214,105.13444607873352,0
3720,32.41762989025708,3,2,190,0.015625,0.010416666666666666,0.9895833333333334,192,6550,4900,1650,0.7480916030534351,82,49,33,196.7678802505401,0.47172627163321695,0.757936735243518,0.11786174300704796,1071249.7388220995,-2792.4919346063602,1068457.2468874932,3522,0,489.609375,83,109,36,37.86062137218016,0.5587565104166667,42.919146825396815,8333.951950085775,100.40905963958765,0
3721,32.13314694389696,0,0,190,0.0,0.0,1.0,190,5750,3900,1850,0.6782608695652174,76,39,37,199.9759862489708,0.47129745660447414,0.758795322701949,0.12012772886372058,1062720.4195596622,-1246.2871983271893,1061474.132361335,3523,1,495.4894736842105,88,102,38,37.6705614210734,0.5601973684210526,42.81367041198503,8264.206120613228,93.91143318878667,0
3722,32.50494043669243,1,2,189,0.005235602094240838,0.010471204188481676,0.9895287958115183,191,6000,5000,1000,0.8333333333333334,70,50,20,201.70420046572195,0.4714544870028474,0.7624469425158367,0.12166064911171796,1076265.4364907749,-782.548128747485,1075482.8883620275,3524,0,493.89005235602093,70,121,42,37.47375047510456,0.5615183246073299,42.66431924882629,8364.68097505259,119.49544250075128,0
3723,32.749125606905025,1,2,188,0.005263157894736842,0.010526315789473684,0.9894736842105263,190,5350,3000,2350,0.5607476635514018,77,30,47,207.20684401118785,0.470726584980971,0.7563137070636408,0.12281646791450883,1078938.7167440776,1362.6972756043615,1080301.414019682,3525,0,497.40526315789475,79,111,44,37.98844306922325,0.555921052631579,43.30729166666667,8406.461747584983,106.41090819727826,8
3724,32.51440052588313,1,2,187,0.005291005291005291,0.010582010582010581,0.9894179894179894,189,5950,4400,1550,0.7394957983193278,75,44,31,207.5461133846913,0.4698112499530939,0.7579572272632553,0.12358171381647445,1072618.800046063,773.5726185822341,1073392.3726646453,3526,0,500.84656084656086,79,110,41,37.806950288099216,0.5575947971781305,43.13802083333333,8351.713270496035,105.7178894999498,0
3725,32.063058855939786,2,1,188,0.010582010582010581,0.005291005291005291,0.9947089947089947,189,6350,4400,1950,0.6929133858267716,83,44,39,204.01110441919985,0.46995665878644605,0.7542379844878151,0.12232406706268592,1059839.5127333319,-906.1941000334091,1058933.3186332984,3527,0,501.07936507936506,83,106,38,37.636450596443815,0.5601300705467371,42.881944444444436,8243.991348202555,99.32519696629585,0
3726,31.974997977360754,1,0,189,0.005291005291005291,0.0,1.0,189,6200,4400,1800,0.7096774193548387,80,44,36,203.063797524658,0.46951574167886223,0.7548994673298937,0.12247866282031497,1058713.5737601183,-1002.7202442737225,1057710.8535158446,3528,0,502.031746031746,71,118,43,37.43938691178948,0.5617835097001764,42.66493055555555,8228.288324990091,115.89138485901537,0
3727,32.02813955761136,4,2,191,0.02072538860103627,0.010362694300518135,0.9896373056994818,193,6200,4400,1800,0.7096774193548387,80,44,36,187.64543516166688,0.4696315486470927,0.7473874106644378,0.11244707774095741,1058512.448073677,-5074.994211434179,1053437.4538622429,3529,0,492.6062176165803,90,103,41,38.078621252597245,0.561582469775475,42.90293040293044,8234.340824907964,91.49267583231071,8
3728,31.866933996487415,0,1,190,0.0,0.005235602094240838,0.9947643979057592,191,6650,4700,1950,0.706766917293233,86,47,39,190.8810778605413,0.46854849820887295,0.749681177953381,0.11470732651640891,1054028.9100787542,-4611.165109598832,1049417.7449691554,3530,1,498.72251308900525,90,101,42,37.89044535434003,0.56293630017452,42.799908424908445,8196.17834211402,91.06864824571134,0
3729,32.043683010806134,1,0,191,0.005235602094240838,0.0,1.0,191,6000,4900,1100,0.8166666666666667,71,49,22,194.526391217349,0.46826834757049696,0.7551961319232432,0.11760241613810249,1061688.9842920846,-2894.694658089564,1058794.289633995,3531,0,499.67015706806285,72,119,39,37.572408536585364,0.5651178010471204,42.57990867579909,8248.687807005463,114.56510843063143,0
3730,31.88516485593095,0,1,190,0.0,0.005235602094240838,0.9947643979057592,191,4850,2800,2050,0.5773195876288659,69,28,41,194.89326303046778,0.4679916414071829,0.7559897760937437,0.1183526671959089,1057777.1693225312,-1819.2711823200339,1055957.8981402111,3532,1,500.67015706806285,74,117,42,37.39654103310688,0.5664812390924956,42.41666666666667,8213.087047473553,110.98766280369667,0
3731,31.920078216857387,0,1,189,0.0,0.005263157894736842,0.9947368421052631,190,5250,3800,1450,0.7238095238095238,67,38,29,192.87602130148474,0.46766743247006404,0.7517295208614225,0.11748874538558587,1059856.3074566836,-2365.8264532943035,1057490.4810033892,3533,2,504.0578947368421,79,111,42,37.334362841695715,0.5679276315789474,42.3046875,8225.654531117509,104.122209254652,0
3732,31.968803394430715,2,1,190,0.010471204188481676,0.005235602094240838,0.9947643979057592,191,5950,4000,1950,0.6722689075630253,79,40,39,203.34126109086566,0.4674554514558648,0.7658469593713404,0.12275733121047963,1058781.5315228417,-1091.2056320852748,1057690.3258907564,3534,0,502.10994764397907,67,124,42,37.39838154474929,0.5634271378708551,42.63174019607845,8227.755297638369,122.80231787519953,7
3733,32.07581296836439,0,2,188,0.0,0.010526315789473684,0.9894736842105263,190,5400,3600,1800,0.6666666666666666,72,36,36,198.04930711685023,0.4671650190290541,0.7578221274833721,0.12015435106393398,1063814.193377539,-1262.4672201013873,1062551.7261574378,3535,1,502.79473684210524,72,118,44,37.35075350434927,0.5647478070175438,42.45148401826485,8261.07802890996,114.73719484597167,0
3734,32.13633707212119,0,0,188,0.0,0.0,1.0,188,6650,4500,2150,0.6766917293233082,88,45,43,196.24378054409675,0.4665289471688095,0.7533582714406621,0.11965525451852148,1067326.3041692714,-2358.7701991326776,1064967.5339701388,3536,2,509.07978723404256,75,113,44,37.21194072183224,0.5663785460992907,42.26973684210527,8282.506610528615,110.43342147371487,0
3735,32.21972090756287,1,1,188,0.005291005291005291,0.005291005291005291,0.9947089947089947,189,6500,4400,2100,0.676923076923077,86,44,42,193.635393969463,0.4661150512214342,0.7516563319658702,0.11894569717316607,1072332.3107116513,-2771.7021098327828,1069560.6086018186,3537,0,507.3809523809524,77,112,42,37.00475136739305,0.568342151675485,42.0005341880342,8312.670782761887,107.95676341249204,0
3736,32.42129430010124,0,0,188,0.0,0.0,1.0,188,5800,4200,1600,0.7241379310344828,74,42,32,171.75386728613765,0.46567086699283194,0.7186254479078642,0.10396962488566176,1074594.8244851877,-6486.836625800589,1068107.987859387,3538,1,511.02127659574467,82,106,46,38.11052888130635,0.5650487588652482,42.53263052208832,8347.425358516182,101.7978702258071,8
3737,32.168550449561366,0,1,187,0.0,0.005319148936170213,0.9946808510638298,188,5200,3300,1900,0.6346153846153846,71,33,38,173.1362147251663,0.4654255319148936,0.7217196681000364,0.10513158789997881,1067153.4113641018,-5847.419565074542,1061305.9917990272,3539,2,512.0212765957447,82,106,46,37.960030533359316,0.566156914893617,42.41967871485941,8285.985560075193,101.04860439116088,0
3738,32.481225965060304,2,1,188,0.010582010582010581,0.005291005291005291,0.9947089947089947,189,6200,4900,1300,0.7903225806451613,75,49,26,172.9159631814503,0.46584299598483997,0.7238042173269952,0.10582810738956677,1079920.6902728772,-6652.89473637821,1073267.795536499,3540,0,509.07936507936506,86,103,46,37.6746993545991,0.5685074955908289,42.13362068965514,8375.816135171164,97.39321087408331,0
3739,32.22310879227459,0,0,188,0.0,0.0,1.0,188,5550,3700,1850,0.6666666666666666,74,37,37,209.15262136241378,0.46539234649372324,0.7645724201858215,0.12511129532406123,1064410.8638868926,1374.8644777146924,1065785.7283646073,3541,1,512.4468085106383,79,109,40,37.59287402904425,0.5568484042553192,42.96874999999998,8282.34593176427,104.83982192106672,8
3740,32.52193251996637,2,1,189,0.010526315789473684,0.005263157894736842,0.9947368421052631,190,4550,2900,1650,0.6373626373626373,62,29,33,209.53314116323722,0.46568620625638174,0.7684712125976887,0.1260997218929184,1076140.8692501695,2547.435333624731,1078688.3045837942,3542,0,508.0421052631579,81,109,42,37.35612850394219,0.5587719298245615,42.74644308943088,8366.38281836683,103.28867676996087,0
3741,32.73035867494712,0,1,188,0.0,0.005291005291005291,0.9947089947089947,189,5400,4100,1300,0.7592592592592593,67,41,26,210.8766451737718,0.4655169987616796,0.7679518950276636,0.12730645043350897,1084003.6412244807,2518.210243514487,1086521.8514679952,3543,1,511.4550264550264,67,122,43,37.20444467591215,0.5601300705467371,42.63174019607845,8423.755454929362,125.72769335715465,0
3742,33.0900587039498,2,1,189,0.010526315789473684,0.005263157894736842,0.9947368421052631,190,6600,4800,1800,0.7272727272727273,84,48,36,196.70500258922442,0.46588461895479444,0.7541550735532783,0.11651838945130605,1089972.7463047556,-1719.3816231880442,1088253.3646815675,3544,0,509.4684210526316,76,114,42,38.28181275145382,0.5543859649122806,43.330627705627684,8493.204596726668,111.75269206219299,8
3743,32.79070002806524,3,2,190,0.015625,0.010416666666666666,0.9895833333333334,192,5550,4200,1350,0.7567567567567568,69,42,27,189.4312695812435,0.4664793075552647,0.7473700236927296,0.11296889264758375,1082211.6538261087,-2949.0544920209622,1079262.5993340877,3545,0,504.578125,80,112,39,38.21443170821232,0.5568033854166667,43.081275720164584,8424.544819453218,105.30681024316523,0
3744,32.543551502629896,1,3,188,0.005235602094240838,0.015706806282722512,0.9842931937172775,191,6000,4200,1800,0.7,78,42,36,189.12980286969,0.46608110590612656,0.7469607121529844,0.1134395852618747,1075825.8903459003,-3505.8522873544307,1072320.038058546,3546,0,507.34031413612564,83,108,44,38.00644039868174,0.5586823734729494,42.86954365079364,8367.938249095094,100.81853312162764,0
3745,32.043443548353466,4,1,191,0.020833333333333332,0.005208333333333333,0.9947916666666666,192,5950,4300,1650,0.7226890756302521,76,43,33,191.48088548002661,0.46638557118964513,0.751570376743874,0.11127135952435019,1049624.0373406624,-4153.411981777595,1045470.6253588848,3547,0,500.7916666666667,80,112,45,39.144747860456576,0.5470920138888888,44.04578189300414,8201.654538874534,102.52068173593167,8
3746,32.23782500604711,0,0,191,0.0,0.0,1.0,191,6350,4600,1750,0.7244094488188977,81,46,35,191.8817923383923,0.46600877192982454,0.7519205605558987,0.11185521023589766,1056964.6161436625,-3987.547003218302,1052977.0691404443,3548,1,504.3874345549738,81,110,46,39.01428713165986,0.5483202443280977,43.92784552845531,8255.209304775188,101.9161642564838,0
3747,32.05891235886598,1,0,192,0.005208333333333333,0.0,1.0,192,6600,4700,1900,0.7121212121212122,85,47,38,196.1025385529883,0.46602994109947643,0.7583648989899001,0.11500145715142034,1052936.778259302,-3703.2849695095647,1049233.4932897924,3549,0,502.7552083333333,67,125,48,38.67801536070768,0.5503472222222222,43.70404411764703,8216.56958756407,122.63536697856821,0
3748,32.236307649284285,3,1,194,0.015384615384615385,0.005128205128205128,0.9948717948717949,195,6100,4500,1600,0.7377049180327869,77,45,32,186.9945575923495,0.4664904396863159,0.7500691936409374,0.11069106409167792,1061641.812996259,-5395.75177144547,1056246.0612248136,3550,0,496.0051282051282,73,122,49,38.55675003656572,0.5524038461538461,43.355855855855815,8273.259587017796,113.33232310983281,0
3749,32.6101507606261,1,0,195,0.005128205128205128,0.0,1.0,195,6350,4500,1850,0.7086614173228346,82,45,37,222.26983058657694,0.4666160014098158,0.7855260298433997,0.12603870590239374,1060454.0894448338,1791.3901611490237,1062245.4796059828,3551,0,496.5025641025641,79,116,38,39.305498825691814,0.5376068376068376,44.97395833333332,8316.437666635682,105.27136286880611,7
3750,32.566998102473725,3,0,198,0.015151515151515152,0.0,1.0,198,6150,4500,1650,0.7317073170731707,78,45,33,199.9065664149564,0.46798248987335284,0.7648622981956319,0.11353916636189171,1059558.8866719631,-3387.444210191119,1056171.4424617721,3552,0,489.9646464646465,85,113,38,39.81342988287427,0.5387205387205387,44.91279069767439,8307.42466131408,97.73440778016565,8
3751,32.603064340354926,1,2,197,0.005025125628140704,0.010050251256281407,0.9899497487437185,199,7450,5700,1750,0.7651006711409396,92,57,35,199.29229234025067,0.46801135306160435,0.7655835640474664,0.11381310072243853,1062472.445879548,-4901.486142462342,1057570.9597370857,3553,0,488.49748743718595,70,129,42,39.61577878665978,0.5406197654941374,44.703638497652584,8323.443699919544,118.9063385702792,0
3752,32.952025491267186,3,3,197,0.015,0.015,0.985,200,6550,4900,1650,0.7480916030534351,82,49,33,202.38139460615741,0.46806323283082074,0.7703387937453474,0.11277934147554697,1065948.688326774,-3404.36357556482,1062544.324751209,3554,0,487.01,76,124,40,40.496245966741114,0.5280208333333334,45.64393939393938,8381.547392949167,110.28351832827852,8
3753,33.11721237243092,3,3,197,0.015,0.015,0.985,200,6300,4400,1900,0.6984126984126984,82,44,38,205.14927972019055,0.468490891959799,0.7724739674156764,0.11615095044468006,1076444.4636782457,-2133.638723524673,1074310.824954721,3555,0,487.855,81,119,33,39.802399398800894,0.5328645833333333,45.03302845528452,8443.795344601813,104.24438697039275,8
3754,33.46062532622335,4,2,199,0.01990049751243781,0.009950248756218905,0.9900497512437811,201,6650,4600,2050,0.6917293233082706,87,46,41,203.6985445435893,0.46896040630182423,0.7737946522839991,0.11636996489351635,1090531.8893738203,-2422.04827123642,1088109.8411025838,3556,0,485.93532338308455,71,130,39,39.48977399369111,0.5355514096185738,44.69039351851852,8542.819084662375,120.321395558625,0
3755,33.82164900925308,2,3,198,0.009950248756218905,0.014925373134328358,0.9850746268656716,201,5800,4200,1600,0.7241379310344828,74,42,32,184.5681067222368,0.46901637645107797,0.7468068647184134,0.10585753204652366,1103591.4958268218,-5262.441404096521,1098329.0544227252,3557,0,486.2636815920398,82,119,42,39.82569802669287,0.5395936981757877,44.54066265060241,8640.056043967688,105.36653712155717,7
3756,33.27920888834024,1,2,197,0.005025125628140704,0.010050251256281407,0.9899497487437185,199,6400,5200,1200,0.8125,76,52,24,182.75540841318406,0.4690645990897247,0.7428978185236641,0.10545100639458363,1087830.3674899922,-6438.623381020457,1081391.7441089717,3558,0,491.63819095477385,86,113,43,39.639916491063715,0.5414572864321607,44.312739463601524,8509.069753478263,98.94267155207282,0
3757,32.795106860661605,1,0,198,0.005050505050505051,0.0,1.0,198,5700,4100,1600,0.7192982456140351,73,41,32,180.15490353188275,0.46914096549248835,0.7386481297184282,0.10441804660398003,1073425.482841102,-6623.427138019346,1066802.0557030826,3559,0,493.83838383838383,89,109,46,39.534138544588224,0.5431923400673401,44.14351851851852,8390.84065117807,94.27910844020303,0
3758,32.42112491142051,2,1,199,0.01,0.005,0.995,200,6100,4500,1600,0.7377049180327869,77,45,32,193.0124056696128,0.46968226549413733,0.7634136556192377,0.1090620647637504,1053188.8219475455,-5444.298370311832,1047744.5235772337,3560,0,489.89,81,119,40,40.18954024420629,0.5344270833333333,45.10924796747967,8263.844910412237,102.02277667175602,8
3759,32.26064335244234,2,1,200,0.009950248756218905,0.004975124378109453,0.9950248756218906,201,6850,5300,1550,0.7737226277372263,84,53,31,191.75343606830484,0.469580223880597,0.7638135851355465,0.10925486473659238,1050588.7137751484,-6759.200847806898,1043829.5129273415,3561,0,488.4228855721393,84,117,42,39.89795918367351,0.5373134328358209,44.79166666666667,8233.185022237898,98.01410740759403,0
3760,32.52980721214403,0,2,198,0.0,0.01,0.99,200,6850,4900,1950,0.7153284671532847,88,49,39,188.3254372838407,0.46928444304857625,0.7573086830524827,0.10784438224791372,1060947.821660392,-6889.30751009336,1054058.5141502987,3562,1,491.685,75,125,40,39.789944903581265,0.5397395833333334,44.59978070175441,8308.119895711303,110.77493194281737,0
3761,32.50458910988029,4,2,200,0.019801980198019802,0.009900990099009901,0.9900990099009901,202,5650,3800,1850,0.672566371681416,75,38,37,200.62366746285696,0.46947656519383285,0.7700692399337017,0.11656749499252206,1064684.3343125703,-3329.824831992154,1061354.5094805781,3563,0,487.08415841584156,82,120,38,38.916266222091465,0.5430589933993399,44.051204819277125,8319.510420518349,101.45744415266279,0
3762,32.88829433986279,1,1,200,0.004975124378109453,0.004975124378109453,0.9950248756218906,201,6500,4900,1600,0.7538461538461538,81,49,32,204.14671875232898,0.4694973051409619,0.7742235262984478,0.11923160181057113,1078891.8647454998,-2649.553184724822,1076242.311560775,3564,0,490.0,87,114,42,38.6274492813901,0.5453980099502487,43.8565340909091,8424.121700050819,96.82898505805538,0
3763,32.92005046340206,2,4,198,0.009900990099009901,0.019801980198019802,0.9801980198019802,202,6250,4300,1950,0.688,82,43,39,204.64811251832722,0.4699948073165525,0.771303063340605,0.1189224976346081,1078337.188318,-2514.06595048047,1075823.1223675194,3565,0,488.0940594059406,87,115,32,38.80787625830521,0.5437809405940595,44.04592803030302,8426.020965555625,96.85081569604166,8
3764,32.45833458677605,0,1,197,0.0,0.005050505050505051,0.9949494949494949,198,6050,4600,1450,0.7603305785123967,75,46,29,206.83647267950388,0.46872329470679724,0.7703920805643618,0.12073092909163961,1064602.4919589655,-1610.2751514796469,1062992.2168074858,3566,1,498.2020202020202,88,110,34,38.58122362869199,0.5458228114478114,43.87874531835205,8313.269379241787,94.46897021865666,0
3765,32.53363581065859,1,1,197,0.005050505050505051,0.005050505050505051,0.9949494949494949,198,6650,4500,2150,0.6766917293233082,88,45,43,201.6189383183682,0.46810373190449334,0.7657748959411794,0.11839494516070467,1068945.3494488962,-3146.0747047513128,1065799.2747441449,3567,0,499.1868686868687,75,123,36,38.485637330909476,0.547611531986532,43.65405701754386,8339.865550531089,111.19820734041451,0
3766,32.70822016198628,1,3,195,0.005050505050505051,0.015151515151515152,0.9848484848484849,198,5400,3600,1800,0.6666666666666666,72,36,36,198.37053495752735,0.46811120938659007,0.7635037199680992,0.11733152769936893,1076935.228728102,-2273.5565125196085,1074661.6722155823,3568,0,500.030303030303,79,119,36,38.29493944929304,0.5495054713804715,43.385416666666686,8393.406288443093,106.24564922079865,0
3767,32.23104232954323,0,1,194,0.0,0.005128205128205128,0.9948717948717949,195,5700,3900,1800,0.6842105263157895,75,39,36,201.3997177523869,0.46734734337827116,0.7645498517709464,0.11962657933967115,1062516.6296594483,-1901.8901358737894,1060614.7395235745,3569,1,498.1948717948718,79,116,38,38.05780933062881,0.5512820512820513,43.22916666666668,8275.991598158786,104.75938731846564,0
3768,31.85433366016869,2,1,195,0.01020408163265306,0.00510204081632653,0.9948979591836735,196,5500,3600,1900,0.6545454545454545,74,36,38,196.95975933692327,0.46719213326356185,0.7612405855050912,0.1176873356271427,1051895.358714829,-3263.788659980117,1048631.570054849,3570,0,496.57142857142856,82,114,35,37.94786020087577,0.5529336734693877,43.009538152610446,8186.259919167609,99.83243803862938,0
3769,31.729764398288985,2,0,197,0.01015228426395939,0.0,1.0,197,6600,4700,1900,0.7121212121212122,85,47,38,214.41488590141614,0.4674453537760282,0.7798574304667509,0.12810993642607507,1047764.9862077783,-1068.718006152454,1046696.2682016259,3571,0,494.93908629441626,78,119,39,37.501389601505004,0.5540926395939086,43.0116033755274,8154.181277988497,104.54078561523714,8
3770,32.15887396938775,1,0,198,0.005050505050505051,0.0,1.0,198,6100,4400,1700,0.7213114754098361,78,44,34,215.84710896791353,0.4673896323642517,0.7829051753074594,0.12967912061212084,1063612.094949733,215.5191516410041,1063827.614101374,3572,0,493.4343434343434,82,116,41,37.25733583825369,0.5561868686868687,42.80873493975903,8270.981479099664,100.86562779389834,0
3771,31.733891494390154,3,3,198,0.014925373134328358,0.014925373134328358,0.9850746268656716,201,6850,5300,1550,0.7737226277372263,84,53,31,208.6760607445936,0.4677342454394693,0.7778953708137664,0.1266742241082976,1052645.211653499,-3117.628774097763,1049527.5828794013,3573,0,487.0547263681592,74,127,43,37.05569785207152,0.5589241293532339,42.43055555555556,8173.68080227036,110.45514597662648,0
3772,32.03588471180248,2,3,197,0.01,0.015,0.985,200,5750,3800,1950,0.6608695652173913,77,38,39,208.81561909919566,0.46711788107202684,0.7774219528831532,0.12768100367056673,1064836.7472300283,-1279.091077517649,1063557.6561525105,3574,0,488.79,76,124,45,36.78325637931339,0.5613541666666666,42.16720779220779,8259.901606090949,108.68291586961774,0
3773,32.532767694694996,1,3,195,0.005050505050505051,0.015151515151515152,0.9848484848484849,198,5600,4100,1500,0.7321428571428571,71,41,30,210.08681880764178,0.4672149797467056,0.776706646281865,0.12887828273232654,1082343.909316969,277.2377528456782,1082621.1470698148,3575,0,482.33838383838383,78,120,37,36.6298411968171,0.5627630471380471,42.04905063291139,8391.858312385519,107.58792708186563,0
3774,32.06532051077582,0,1,194,0.0,0.005128205128205128,0.9948717948717949,195,6850,4800,2050,0.7007299270072993,89,48,41,219.72624388409324,0.4665917702000176,0.7838101888026245,0.13152306991613136,1059399.048212257,705.5547276123511,1060104.6029398693,3576,2,490.7076923076923,74,121,37,37.29625927526833,0.5542735042735043,42.94444444444443,8242.568777964394,111.38606456708641,8
3775,31.801939096131097,1,3,192,0.005128205128205128,0.015384615384615385,0.9846153846153847,195,6600,5000,1600,0.7575757575757576,82,50,32,213.87711450911712,0.466801039739184,0.7791402344032343,0.12249993576813906,1037267.6052349297,-1230.4395237140607,1036037.1657112157,3577,0,491.6871794871795,67,128,42,39.129943121613834,0.535309829059829,44.592524509803944,8122.452980235857,121.23064149605756,8
3776,31.85900286466005,4,0,196,0.02040816326530612,0.0,1.0,196,6300,4500,1800,0.7142857142857143,81,45,36,221.30405939549078,0.4671763256584685,0.7894019311862286,0.12369190986064799,1031523.9154341787,156.08596982306653,1031680.0014040017,3578,0,490.0,64,132,38,39.89729621932534,0.5281143707482994,45.52884615384617,8107.197219357989,126.67495655246857,8
3777,32.157632945851844,1,1,196,0.005076142131979695,0.005076142131979695,0.9949238578680203,197,6650,4900,1750,0.7368421052631579,84,49,35,219.50541819241334,0.46767304637591073,0.788623369461668,0.12355191607979041,1043409.7679037169,-243.18051004912013,1043166.5873936678,3579,0,488.507614213198,66,131,41,39.66636150951076,0.5305626057529611,45.25808457711444,8191.8970120924105,124.11965169836985,0
3778,32.15067097266842,6,3,199,0.0297029702970297,0.01485148514851485,0.9851485148514851,202,6850,5400,1450,0.7883211678832117,83,54,29,205.61969090632343,0.4691332939264075,0.7795178689637048,0.11724966768929403,1047258.789524534,-4182.5942798068245,1043076.1952447272,3580,0,477.2277227722772,67,135,41,39.51281358780459,0.5338283828382838,44.76102941176472,8206.10416278497,122.47916660873089,0
3779,31.693268602233097,2,1,200,0.009950248756218905,0.004975124378109453,0.9950248756218906,201,6100,4300,1800,0.7049180327868853,79,43,36,211.264383738837,0.4691811774461028,0.7832332511142686,0.12158694513096432,1035199.4525358736,-2559.8451226452835,1032639.6074132284,3581,0,480.1542288557214,70,131,40,39.01050934695675,0.5363287728026533,44.410211267605646,8100.475826283812,115.72108323262589,0
3780,31.850302613692005,3,3,200,0.014778325123152709,0.014778325123152709,0.9852216748768473,203,6200,4500,1700,0.7258064516129032,79,45,34,209.73034744863034,0.4696467183664179,0.7769621726804079,0.11972474864869256,1037813.7820124928,-3267.790982308532,1034545.9910301842,3582,0,476.2857142857143,71,132,36,39.365318314914504,0.5354577175697866,44.71932870370371,8130.766632213488,114.51783989033082,8
3781,31.822908649817006,1,5,196,0.004975124378109453,0.024875621890547265,0.9751243781094527,201,5850,4000,1850,0.6837606837606838,77,40,37,238.83637014565005,0.46965796019900496,0.8003861087943274,0.13358888989609238,1030584.1876122947,3178.19729976454,1033762.3849120592,3583,0,480.33830845771143,71,130,36,39.42220690504615,0.5300062189054726,45.50057870370368,8098.911835343279,114.06918077948279,7
3782,32.105166059590886,4,2,198,0.02,0.01,0.99,200,6100,4300,1800,0.7049180327868853,79,43,36,241.05460994692248,0.469222675879397,0.8002197218978877,0.13623128256208422,1042977.6629657521,4182.914745912096,1047160.5777116641,3584,0,482.935,76,124,33,38.958399674486046,0.5330729166666667,45.10281385281383,8183.516489377814,107.67784854444491,0
3783,32.04185137636969,0,2,196,0.0,0.010101010101010102,0.98989898989899,198,6750,5600,1150,0.8296296296296296,79,56,23,241.17581645566526,0.46915057939804133,0.7973194170124625,0.13641252211477597,1041179.5269513769,3871.4644978838705,1045050.9914492609,3585,1,488.8030303030303,81,117,33,38.922870573383776,0.5342487373737373,45.071138211382085,8168.392700977913,100.84435433306065,0
3784,31.821609036132315,1,2,195,0.005076142131979695,0.01015228426395939,0.9898477157360406,197,6650,5000,1650,0.7518796992481203,83,50,33,241.9650218627026,0.46894531924444904,0.7966186689253489,0.1374792561603759,1035426.2796738871,4057.3884797013106,1039483.6681535884,3586,0,492.2284263959391,87,110,35,38.72562951448498,0.5362203891708968,44.89820075757573,8117.749719906265,93.30746804489961,0
3785,31.36236312631113,2,0,197,0.01015228426395939,0.0,1.0,197,6650,5200,1450,0.7819548872180451,81,52,29,236.7833606552738,0.4691352429296592,0.7930847367879328,0.13564203769817873,1022980.2998877636,2394.9426583127624,1025375.2425460763,3587,0,492.7208121827411,70,127,36,38.53849541424932,0.5386527072758037,44.58626760563379,8010.378222798548,114.43397461140783,0
3786,31.730169084635538,3,0,200,0.015,0.0,1.0,200,6650,5000,1650,0.7518796992481203,83,50,33,231.20161939656379,0.4693509212730318,0.7904895371926088,0.13359902931944384,1037641.0439148467,1330.8579410905513,1038971.9018559373,3588,0,486.315,79,121,39,38.34501171019808,0.5410416666666666,44.25781249999999,8114.742851449542,102.71826394239928,0
3787,31.881031639530047,1,6,195,0.004975124378109453,0.029850746268656716,0.9701492537313433,201,6400,4600,1800,0.71875,82,46,36,232.40643847499425,0.4694807213930348,0.7935477041696113,0.13521467575621632,1044669.4504588065,1957.5812729522868,1046627.0317317587,3589,0,484.8905472636816,82,119,35,38.05142252508417,0.5432213930348259,44.001004016064265,8161.5120906518,99.53063525185121,0
3788,31.601705644439633,1,2,194,0.00510204081632653,0.01020408163265306,0.9897959183673469,196,5450,3900,1550,0.7155963302752294,70,39,31,234.1321938086221,0.4676407421943136,0.7928387704726145,0.1369981664197097,1037246.9466003382,3920.5806257664426,1041167.5272261046,3590,0,497.984693877551,83,113,37,37.78843594211317,0.5450148809523809,43.78720238095239,8096.7614126955405,97.55134232163302,0
3789,31.367669239508796,1,2,193,0.005128205128205128,0.010256410256410256,0.9897435897435898,195,5450,3700,1750,0.6788990825688074,72,37,35,236.04712772560504,0.4675863512203718,0.7952908040587381,0.13854865924797763,1030498.7035072175,4199.251817567547,1034697.955324785,3591,0,501.2871794871795,65,130,37,37.62051546497548,0.5464209401709401,43.67108585858585,8040.4405953103005,123.69908608169693,0
3790,30.915333026892814,1,3,191,0.005154639175257732,0.015463917525773196,0.9845360824742269,194,5800,4000,1800,0.6896551724137931,76,40,36,235.43863666210626,0.46715197282908677,0.7944754328389374,0.13861254833947817,1016537.2236423913,3266.427610129296,1019803.6512525206,3592,0,504.78350515463916,64,130,41,37.52004957713619,0.547411941580756,43.5576923076923,7927.99934449259,123.87498975769672,0
3791,31.13489841284684,2,0,193,0.010362694300518135,0.0,1.0,193,5500,4100,1400,0.7454545454545455,69,41,28,230.01022466879408,0.46752100424582616,0.7887897148247962,0.13637007880990834,1025838.5193379899,3090.6696613667755,1028929.1889993566,3593,0,505.95336787564764,68,125,42,37.39267231239708,0.5506800518134716,43.29710144927536,7992.418668660133,117.53556865676667,0
3792,30.787719604051563,5,3,195,0.025252525252525252,0.015151515151515152,0.9848484848484849,198,6450,4200,2250,0.6511627906976745,87,42,45,193.00248948491907,0.46866935001452764,0.7593448791795883,0.1142317773510027,1013895.1041970188,-6913.144162680367,1006981.9600343384,3594,0,494.1515151515151,82,116,41,38.407746100053814,0.5512415824915825,43.36094377510043,7901.331302500706,96.35769881098423,8
3793,30.920718134528393,2,2,195,0.01015228426395939,0.01015228426395939,0.9898477157360406,197,5700,4200,1500,0.7368421052631579,72,42,30,185.3164060223756,0.46815217203632725,0.7488690084085701,0.1103474963133243,1020050.8341150418,-7293.569092334599,1012757.2650227072,3595,0,497.61928934010155,84,113,36,38.37716682569973,0.5531408629441624,43.1372549019608,7942.38054043773,94.55214929092536,0
3794,30.706339894883968,2,1,196,0.01015228426395939,0.005076142131979695,0.9949238578680203,197,7350,5200,2150,0.7074829931972789,95,52,43,200.5743338922247,0.4684586398010981,0.764073760018853,0.1203336459752104,1015162.7924830373,-6026.879821108558,1009135.9126619288,3596,0,497.9695431472081,88,109,39,37.702928235472655,0.5558904399323181,42.86048689138579,7895.8132899181355,89.72515102179699,0
3795,30.434653428540123,0,1,195,0.0,0.00510204081632653,0.9948979591836735,196,6200,4700,1500,0.7580645161290323,77,47,30,204.809076885643,0.4681318681318681,0.7677384472485074,0.12084757877734825,1001376.431626235,-4381.803484718571,996994.6281415165,3597,1,501.5,71,125,38,38.221253266407224,0.5502763605442177,43.47511574074072,7807.245948226874,109.96121053840668,8
3796,30.13488859763645,2,1,196,0.01015228426395939,0.005076142131979695,0.9949238578680203,197,6000,3900,2100,0.65,81,39,42,202.65131134507726,0.4684025259850133,0.7672364060165826,0.12032542045728421,993309.5484183992,-5140.903488285158,988168.644930114,3598,0,499.16751269035535,75,122,43,38.039655954732254,0.5525592216582065,43.24287280701753,7737.347424609662,103.16463232812883,0
3797,30.227407013051494,1,0,197,0.005076142131979695,0.0,1.0,197,6650,4200,2450,0.631578947368421,91,42,49,198.60270622519687,0.46826979522773576,0.7631521213970676,0.11866902875323457,998170.9076768822,-6402.111292022155,991768.7963848601,3599,0,499.53807106598987,82,115,39,37.90563803291496,0.5548857868020305,43.00953815261044,7768.155288733113,94.73360108211114,0
3798,30.022129255841584,2,3,196,0.010050251256281407,0.01507537688442211,0.9849246231155779,199,6200,4600,1600,0.7419354838709677,78,46,32,213.52146772958005,0.4685094242255046,0.7801134911847365,0.12597766596045168,987779.1298637437,-3817.5900797694276,983961.5397839743,3600,0,495.5075376884422,68,131,39,38.00097104519773,0.5473722780569514,43.4782608695652,7701.328809107154,113.25483542804638,8
3799,29.6352329750395,3,0,199,0.01507537688442211,0.0,1.0,199,6400,4800,1600,0.75,80,48,32,213.0287362192412,0.4687949427271035,0.7809064468643481,0.12703036594295766,978045.3541464665,-4529.646848215644,973515.7072982509,3601,0,490.85929648241205,71,128,37,37.61145211547845,0.550251256281407,43.08449074074073,7613.750971799051,107.23592918026831,0
3800,30.183510975746216,1,1,199,0.005,0.005,0.995,200,6350,4300,2050,0.6771653543307087,84,43,41,218.57119036108625,0.46901224874371855,0.7857031756318869,0.13122776137243375,998088.637820752,-2719.315669128767,995369.3221516232,3602,0,489.4,74,126,41,37.212410887880765,0.5522395833333333,42.83333333333332,7762.192905929373,104.89449872877532,0
3801,29.930148180879204,0,0,199,0.0,0.0,1.0,199,6400,4800,1600,0.75,80,48,32,205.30385477317094,0.46893452955010745,0.7744587629902926,0.1226911553165977,988396.5243340171,-5615.676701964639,982780.8476320524,3603,1,492.2562814070352,80,119,38,37.72789064585,0.5552240368509213,43.00411522633743,7691.924913151838,96.14906141439798,8
3802,29.886537906784962,1,3,197,0.005,0.015,0.985,200,5650,4200,1450,0.7433628318584071,71,42,29,202.86597753053633,0.46938546901172534,0.7737648838571167,0.12183849975251257,988361.1286599168,-5549.030696244562,982812.0979636722,3604,0,490.79,82,118,44,37.60400400156159,0.5569791666666667,42.82128514056223,7686.181410464783,93.73391963981443,0
3803,30.450177133901168,0,0,197,0.0,0.0,1.0,197,6700,4400,2300,0.6567164179104478,90,44,46,204.49865699538137,0.4689766134880348,0.772622131544572,0.12335270875638807,1008245.7415213853,-4863.019987512858,1003382.7215338724,3605,1,495.24365482233503,67,130,44,37.39985763041451,0.5595389170896785,42.66237745098039,7835.976189834636,116.95486850499456,0
3804,30.469364393798784,1,1,197,0.005050505050505051,0.005050505050505051,0.9949494949494949,198,7000,5200,1800,0.7428571428571429,88,52,36,199.44290445963142,0.4687622844348733,0.7683188378908359,0.12128398331259606,1011205.7046803004,-6264.439450482367,1004941.2652298181,3606,0,493.73737373737373,69,129,44,37.227745528408306,0.561763468013468,42.36607142857144,7849.942049848806,113.76727608476531,0
3805,30.761654478302148,1,0,198,0.005050505050505051,0.0,1.0,198,5900,4000,1900,0.6779661016949152,78,40,38,196.07233020930173,0.46892945957032256,0.7645076644634083,0.12027144598552987,1023397.1986020793,-5368.025308083517,1018029.1732939958,3607,0,494.19191919191917,72,126,44,36.9942929320868,0.5640256734006734,42.051940639269425,7934.9090754034105,110.20707049171403,0
3806,30.94186943351109,1,2,197,0.005025125628140704,0.010050251256281407,0.9899497487437185,199,6600,4500,2100,0.6818181818181818,87,45,42,194.94630576628617,0.4684565504289122,0.7649625402720905,0.12038587035315154,1031325.4596017925,-6189.3823215826005,1025136.0772802099,3608,0,492.7035175879397,79,120,46,36.77657513406295,0.5663735343383585,41.80989583333334,7988.8844921496475,101.125120153793,0
3807,30.823526989560975,0,2,195,0.0,0.01015228426395939,0.9898477157360406,197,6850,5100,1750,0.7445255474452555,86,51,35,193.8069399793359,0.46789750164025,0.761397925190874,0.12007729208118874,1028323.6817837104,-6390.746785042948,1021932.9349986674,3609,1,497.7208121827411,83,114,47,36.68526964314292,0.5682106598984771,41.69146825396825,7961.979999907672,95.92746987840569,0
3808,30.41473800386295,0,1,194,0.0,0.005128205128205128,0.9948717948717949,195,6100,4200,1900,0.6885245901639344,80,42,38,193.78566968486734,0.46725592563221424,0.7603437973159366,0.12060357872317716,1015948.4944408897,-5724.748127888051,1010223.7463130016,3610,2,500.84615384615387,68,127,44,36.52203434378833,0.5702457264957265,41.53079710144926,7861.273088226684,115.60695717980418,0
3809,30.449005830938095,0,1,193,0.0,0.005154639175257732,0.9948453608247423,194,6300,3900,2400,0.6190476190476191,87,39,48,207.33891498440428,0.4670234406993929,0.7647648002963165,0.12637079854888741,1011174.3679734215,-3168.840736870502,1008005.5272365509,3611,3,504.3814432989691,80,114,37,36.94049401197603,0.5679768041237113,42.283950617283914,7847.197490380562,98.08996862975702,8
3810,30.1471149593087,0,2,191,0.0,0.010362694300518135,0.9896373056994818,193,5600,4300,1300,0.7678571428571429,69,43,26,206.1426033469806,0.46660010074841685,0.7614683632261716,0.12593295859477874,1001802.0629106731,-2897.182942644229,998904.8799680289,3612,4,507.90673575129534,83,110,42,36.88554243430018,0.5691386010362695,42.19990079365075,7771.929227294882,93.63770153367328,0
3811,30.712100485327078,2,3,190,0.010362694300518135,0.015544041450777202,0.9844559585492227,193,6150,4500,1650,0.7317073170731707,78,45,33,202.93297230173928,0.466387584556707,0.7608722562632775,0.1248480212211527,1022593.9827994633,-3246.392722526629,1019347.5900769366,3613,0,507.31088082901556,85,108,36,36.70847023390437,0.5713514680483592,41.945251937984466,7925.40335319631,93.24003944936835,0
3812,30.32587565471962,0,2,188,0.0,0.010526315789473684,0.9894736842105263,190,7350,5200,2150,0.7074829931972789,95,52,43,198.42392632397176,0.4655289844982828,0.7523987671222869,0.12265430836999343,1011071.4787676687,-5225.845477747314,1005845.6332899214,3614,1,511.2157894736842,86,104,40,36.650612046181664,0.5737390350877193,41.7744252873563,7830.9166696040875,91.05717057679172,0
3813,30.783269950896827,1,1,188,0.005291005291005291,0.005291005291005291,0.9947089947089947,189,5700,4200,1500,0.7368421052631579,72,42,30,196.99380192014115,0.4650901534766783,0.7509770146876324,0.12241664935406582,1027831.9417137834,-3004.695613367967,1024827.2461004155,3615,0,512.7936507936508,75,114,41,36.49380326013933,0.5755621693121693,41.58442982456142,7954.876256225485,106.06501674967313,0
3814,30.803321461516976,1,3,186,0.005291005291005291,0.015873015873015872,0.9841269841269842,189,5700,4300,1400,0.7543859649122807,71,43,28,202.1034367888153,0.4646715167548501,0.7544576760566841,0.1261485088041604,1029760.6983219004,-1876.3647598185526,1027884.3335620819,3616,0,513.6560846560847,77,112,43,36.200418345212285,0.5773809523809523,41.426282051282065,7964.929355474012,103.44064098018197,0
3815,30.406815964401495,0,2,184,0.0,0.010752688172043012,0.989247311827957,186,5400,3400,2000,0.6296296296296297,74,34,40,202.6469815003519,0.4638289499176596,0.7520228942166611,0.12691479724032767,1017450.666719465,-1363.3387127558135,1016087.3280067092,3617,1,521.9247311827957,77,109,39,36.063735738991255,0.5785730286738351,41.30608974358976,7866.058120278101,102.15659896465067,0
3816,30.10106369379342,1,1,184,0.005405405405405406,0.005405405405405406,0.9945945945945946,185,5250,3400,1850,0.6476190476190476,71,34,37,199.19208575356228,0.46331399334116724,0.7456976654738936,0.1253593676184718,1008567.0880938602,-2070.2836200372085,1006496.8044738229,3618,0,524.6,81,104,44,35.97670690614063,0.5802927927927928,41.133130081300834,7792.168139635752,96.19960666216977,0
3817,30.052656746017277,0,2,182,0.0,0.010869565217391304,0.9891304347826086,184,5700,4000,1700,0.7017543859649122,74,40,34,197.45044648804262,0.4624527302605528,0.7421872501295315,0.12484378463062638,1008230.3203300167,-2684.8946176108875,1005545.4257124058,3619,1,528.375,81,103,37,35.85338915861573,0.5819746376811594,40.96798780487807,7784.6001487302165,96.10617467568169,0
3818,30.64906391724616,0,0,182,0.0,0.0,1.0,182,5900,4200,1700,0.711864406779661,76,42,34,199.43464089510948,0.46184961447392386,0.7429163803697627,0.1264269889641186,1028969.4573879566,-1257.5691547592733,1027711.8882331973,3620,4,535.010989010989,82,100,38,35.70817390742806,0.5832188644688645,40.87600401606427,7941.907915403921,96.85253555370635,0
3819,30.552425089903394,0,2,180,0.0,0.01098901098901099,0.989010989010989,182,4850,3000,1850,0.6185567010309279,67,30,37,200.7402294359147,0.4612658865075992,0.7447919404108425,0.12780379771760383,1026927.1523670313,-20.88156397423427,1026906.2708030571,3621,5,536.010989010989,83,99,42,35.51949811874245,0.5846497252747253,40.724206349206355,7921.504263141134,95.43981039929078,0
3820,30.311757053906387,1,1,180,0.0055248618784530384,0.0055248618784530384,0.994475138121547,181,5900,4200,1700,0.711864406779661,76,42,34,179.92183056850823,0.4609474114998977,0.717881611804857,0.11417061478781282,1017920.4903546791,-5470.776400438033,1012449.713954241,3622,0,538.9281767955802,81,100,42,36.17811831119392,0.5784415285451197,40.84095528455289,7855.566001737204,96.98229631774326,8
3821,30.194258387196328,0,1,179,0.0,0.005555555555555556,0.9944444444444445,180,5800,4300,1500,0.7413793103448276,73,43,30,181.8881545118696,0.4607664752741569,0.7192362724847212,0.1156736982634613,1014584.3769260054,-4891.824016870192,1009692.5529091351,3623,1,539.85,82,98,43,36.047839207332856,0.5795717592592593,40.76305220883538,7827.467385114652,95.45691933066648,0
3822,30.603099092164605,0,0,179,0.0,0.0,1.0,179,4950,3300,1650,0.6666666666666666,66,33,33,181.15330398533607,0.46030537944887323,0.7179277838679519,0.11557681466060564,1029218.4935945479,-3460.7338725069712,1025757.7597220408,3624,2,543.7821229050279,82,97,44,35.95189128155499,0.5805982309124766,40.650100401606466,7936.910676952681,96.79159362137415,0
3823,30.58922837449597,0,0,179,0.0,0.0,1.0,179,5500,3800,1700,0.6909090909090909,72,38,34,185.92456889422766,0.4598816772330676,0.7246705940814939,0.1190772644893609,1029821.2928258011,-3006.184018653416,1026815.1088071476,3625,3,544.7821229050279,75,104,43,35.6908937249102,0.5822276536312849,40.51535087719297,7937.435191693477,105.83246922257969,0
3824,30.214731292066233,0,0,179,0.0,0.0,1.0,179,5850,4300,1550,0.7350427350427351,74,43,31,186.37544125121445,0.45925266252380054,0.7254444924877654,0.12004208198508948,1018762.5320481441,-3675.536711864695,1015086.9953362795,3626,4,545.7821229050279,77,102,42,35.47800419988002,0.5842062383612663,40.31784188034187,7846.22662892929,101.89904712895182,0
3825,30.639022150479178,1,0,180,0.005555555555555556,0.0,1.0,180,6150,4400,1750,0.7154471544715447,79,44,35,188.83606067707726,0.45907433271260084,0.7311943260492073,0.12225956254348948,1034506.8328130923,-3079.560989611331,1031427.271823481,3627,0,543.7444444444444,78,102,45,35.229982748122566,0.5858796296296296,40.137130801687746,7961.944205454122,102.07620776223234,0
3826,30.85785582265293,1,2,179,0.0055248618784530384,0.011049723756906077,0.988950276243094,181,5750,3500,2250,0.6086956521739131,80,35,45,188.22601725642235,0.45855969920196443,0.7334984190290184,0.12268357070612695,1043759.1762389594,-2657.4734563395823,1041101.7027826199,3628,0,541.7348066298342,80,101,41,35.009167696744946,0.5879949355432781,39.90483539094648,8025.9790896753,100.32473862094125,0
3827,31.020309139867177,0,1,178,0.0,0.00558659217877095,0.994413407821229,179,5250,3500,1750,0.6666666666666666,70,35,35,188.34456250554172,0.4582025610445044,0.7310185093143022,0.12308098154431815,1049980.5512658746,-1498.3744865005683,1048482.1767793741,3629,2,547.9944134078212,80,99,44,34.914368327402116,0.5892690875232774,39.81481481481479,8071.024878057968,100.88781097572459,0
3828,31.364752664550732,0,0,178,0.0,0.0,1.0,178,5000,3500,1500,0.7,65,35,30,186.00527020861725,0.45751272244440216,0.7262895138517687,0.11858768584759877,1054629.637986579,-1366.6658432577974,1053262.972143321,3630,3,551.7134831460675,82,96,44,35.85162286857346,0.5831577715355805,40.67520080321287,8133.658186591551,99.19095349501892,8
3829,31.011033609674204,0,0,178,0.0,0.0,1.0,178,5350,3800,1550,0.7102803738317757,69,38,31,188.47296272200174,0.4570564601451575,0.7292748275815408,0.12069052702840763,1043977.7313463029,-1597.6847914737045,1042380.0465548292,3631,4,552.7134831460675,69,109,43,35.63035260270305,0.5845622659176031,40.52083333333333,8046.717158510242,116.61908925377163,0
3830,30.823634533526683,1,0,179,0.00558659217877095,0.0,1.0,179,4200,2400,1800,0.5714285714285714,60,24,36,185.98912160145116,0.45703999539681545,0.7271406007291252,0.1194845259181822,1038571.7527275365,-1367.3903980252371,1037204.3623295112,3632,0,550.6201117318436,71,108,45,35.579857047316494,0.5856610800744879,40.4079861111111,8001.5693639332685,112.69816005539815,0
3831,31.314215928175624,0,1,178,0.0,0.00558659217877095,0.994413407821229,179,5350,3900,1450,0.7289719626168224,68,39,29,220.90957396756784,0.45671698784340803,0.7632257217444174,0.1392998555205375,1049778.7308313907,5231.234437635478,1055009.965269026,3633,1,551.6201117318436,75,104,32,35.343443432846364,0.582169459962756,41.06359649122808,8108.390451138922,108.11187268185229,8
3832,31.263314170879877,1,1,178,0.00558659217877095,0.00558659217877095,0.994413407821229,179,5500,3900,1600,0.7090909090909091,71,39,32,219.48493755988343,0.4566019082292386,0.7626942097434324,0.138997813098873,1049304.2509337943,4761.295599505129,1054065.5465332994,3634,0,552.608938547486,79,100,34,35.224855094314336,0.5836824953445066,40.91145833333336,8099.966476200162,102.53122121772357,0
3833,31.549881341267678,0,1,177,0.0,0.0056179775280898875,0.9943820224719101,178,5500,4300,1200,0.7818181818181819,67,43,24,219.43396873190684,0.45647389915148434,0.7618225605490014,0.13938517616740043,1059792.4852005073,5410.89421195996,1065203.3794124674,3635,1,554.6741573033707,80,98,34,35.117423302737144,0.5847378277153559,40.8050411522634,8177.570195900915,102.21962744876143,0
3834,31.131798567411213,1,1,177,0.0056179775280898875,0.0056179775280898875,0.9943820224719101,178,5850,4200,1650,0.717948717948718,75,42,33,217.4231742623174,0.45583513193254194,0.7616868168912683,0.13876733871517827,1047101.8230787055,4082.8404299265635,1051184.663508632,3636,0,555.623595505618,83,95,38,34.9982568332138,0.5866104868913857,40.63740079365081,8074.424194412319,97.28221920978697,0
3835,31.584282047076215,0,2,175,0.0,0.011299435028248588,0.9887005649717514,177,5950,4600,1350,0.773109243697479,73,46,27,214.6868629388372,0.45510052859099465,0.7573139174212378,0.13754202337143778,1063412.0794026686,4310.120667644993,1067722.2000703136,3637,1,559.6440677966102,68,109,36,34.93319370915508,0.5883356873822976,40.5042270531401,8195.987682777679,120.52923062908351,0
3836,31.891356015487805,0,1,174,0.0,0.005714285714285714,0.9942857142857143,175,4350,2700,1650,0.6206896551724138,60,27,33,210.57258021647863,0.4545169677066229,0.7492473185822641,0.13537659097026902,1074759.2325284083,5912.964940997848,1080672.197469406,3638,2,566.4571428571429,72,103,41,34.915585724231406,0.5895833333333333,40.3824200913242,8279.556668746933,114.99384262148517,0
3837,31.662366331312906,1,0,175,0.005714285714285714,0.0,1.0,175,4850,3400,1450,0.7010309278350515,63,34,29,207.53762532607672,0.45415845648604264,0.7445288962237839,0.13423032286954711,1068766.7722443282,4511.863587800616,1073278.6358321288,3639,0,566.9885714285714,75,100,41,34.780303230117255,0.5913095238095238,40.17269736842104,8226.74723879793,109.68996318397241,0
3838,31.949379218656865,0,0,175,0.0,0.0,1.0,175,5300,3900,1400,0.7358490566037735,67,39,28,220.2797654313044,0.45379994526546247,0.7580329475917311,0.13942580470275376,1072172.8758063607,6935.597916886827,1079108.4737232476,3640,1,567.9885714285714,74,101,34,35.22377991029148,0.5814285714285714,40.930555555555586,8277.107924522381,111.85280979084298,8
3839,31.458748949452996,0,5,170,0.0,0.02857142857142857,0.9714285714285714,175,5950,4600,1350,0.773109243697479,73,46,27,255.28339300901945,0.4534948002189381,0.7719445458928025,0.15631911710927976,1046077.0806301885,12459.22129844876,1058536.3019286373,3641,2,568.9885714285714,78,97,36,35.53160258376791,0.5705357142857144,42.11497890295358,8112.7401365163605,104.00948892969693,8
3840,31.52757131693494,1,0,171,0.005847953216374269,0.0,1.0,171,4900,3300,1600,0.673469387755102,65,33,32,254.37860628209836,0.45306014218552915,0.7677630435443381,0.15640772077853976,1049576.0202678957,14297.93704457167,1063873.9573124673,3642,0,573.8947368421053,79,92,32,35.40231661368183,0.5724293372319689,41.96614583333333,8135.18073942316,102.9769713851033,0
3841,31.97543365785673,0,0,171,0.0,0.0,1.0,171,5300,4100,1200,0.7735849056603774,65,41,24,255.83693142966877,0.4523879142300195,0.7721547347770725,0.15845057346206076,1066643.271133892,15077.348283399784,1081720.6194172918,3643,1,574.8947368421053,81,90,37,35.0966306824702,0.5742568226120858,41.704776422764226,8259.101785635172,101.96421957574286,0
3842,32.221821169278975,1,0,172,0.005813953488372093,0.0,1.0,172,4800,3300,1500,0.6875,63,33,30,271.7549838802685,0.4524967133596265,0.7950570139407449,0.16310157005355908,1065383.525212552,18704.656544087862,1084088.1817566399,3644,0,572.546511627907,67,105,38,35.85791832965986,0.5588662790697674,42.84620098039214,8285.963725010472,123.67110037329061,8
3843,32.61972235813805,1,2,171,0.005780346820809248,0.011560693641618497,0.9884393063583815,173,6450,4400,2050,0.6821705426356589,85,44,41,272.38852057455273,0.452575390957566,0.7977370694436206,0.16450062740640198,1080450.3222713615,17810.452967559002,1098260.7752389205,3645,0,570.2312138728323,57,116,40,35.60775882120346,0.5608140655105973,42.618534482758626,8395.711945303106,147.29319202286152,0
3844,32.58467452778014,2,0,173,0.011560693641618497,0.0,1.0,173,5500,3900,1600,0.7090909090909091,71,39,32,261.4922257597876,0.45273082179504415,0.7892562419455722,0.15943126960076112,1082201.834731238,16497.47329703958,1098699.3080282775,3646,0,570.7283236994219,61,112,36,35.53210560625815,0.5633429672447013,42.271505376344095,8397.999113846581,137.67211662043576,0
3845,32.56237503312447,0,3,170,0.0,0.017341040462427744,0.9826589595375722,173,5100,3100,2000,0.6078431372549019,71,31,40,253.79268412222484,0.4525431845678183,0.7891971587425157,0.15187736232421234,1075745.900563142,14903.287907479706,1090649.1884706218,3647,1,571.7283236994219,67,106,35,36.42977751291215,0.5559368978805395,42.953431372549,8370.046768624781,124.9260711735042,8
3846,32.39602355114073,0,3,167,0.0,0.01764705882352941,0.9823529411764705,170,5250,3700,1550,0.7047619047619048,68,37,31,231.40100528637083,0.45223706346443904,0.7672055992489535,0.1423863350449539,1078713.507269384,10673.077999624722,1089386.5852690088,3648,2,566.2764705882353,64,106,38,35.96754745492562,0.5655024509803921,41.93910256410258,8360.14691096188,130.62729548377936,7
3847,32.07817273403448,0,1,166,0.0,0.005988023952095809,0.9940119760479041,167,4950,3100,1850,0.6262626262626263,68,31,37,230.6948975649063,0.45201915446216007,0.7625497491533166,0.14209241656794444,1068425.2972211873,10946.052899639475,1079371.3501208269,3649,3,574.2574850299401,65,102,39,35.94925243074668,0.5666167664670658,41.90340909090911,8279.267025247285,127.37333884995823,0
3848,32.31909468164011,0,4,162,0.0,0.024096385542168676,0.9759036144578314,166,5400,3800,1600,0.7037037037037037,70,38,32,232.58870952274268,0.45125806255324324,0.7625716751140474,0.14395165062897752,1077898.3216347806,11541.39592515283,1089439.7175599334,3650,4,578.6987951807229,65,101,41,35.722724680192314,0.5683985943775101,41.729797979797986,8347.05911253724,128.41629403903445,0
3849,32.29443343641678,0,0,162,0.0,0.0,1.0,162,4550,3200,1350,0.7032967032967034,59,32,27,232.18002081165477,0.44965637221072,0.7557248108323371,0.1439516129032255,1077602.4490415426,13089.551809030945,1090692.0008505736,3651,5,592.3024691358024,60,102,43,35.6686827956989,0.570923353909465,41.66666666666665,8342.728637740975,139.0454772956829,0
3850,32.47229252498052,0,1,161,0.0,0.006172839506172839,0.9938271604938271,162,5450,3800,1650,0.6972477064220184,71,38,33,231.3649390173972,0.4498137284973034,0.7544141533546584,0.14378832123820376,1084253.6255604886,12321.654791438705,1096575.2803519273,3652,6,593.3024691358024,60,102,44,35.60238110971605,0.5724022633744856,41.58128415300545,8391.448134913397,139.85746891522328,0
3851,32.3697155705302,1,0,162,0.006172839506172839,0.0,1.0,162,4700,3400,1300,0.723404255319149,60,34,26,226.27488459859856,0.4501172583902053,0.7493043949187617,0.14137953760861652,1082429.459838697,11885.320222224687,1094314.7800609216,3653,0,593.9814814814815,63,99,42,35.53827857847146,0.5744598765432098,41.389973958333314,8371.13298665612,132.87512677231936,0
3852,32.310082063851105,0,1,161,0.0,0.006172839506172839,0.9938271604938271,162,4400,2900,1500,0.6590909090909091,59,29,30,231.33878447963068,0.44975222375584695,0.7489878138774202,0.14178089860682355,1074649.5966725077,12921.626287148803,1087571.2229596565,3654,1,594.9814814814815,74,88,40,36.11672051696284,0.571437757201646,42.08333333333334,8333.308665634955,112.61227926533724,8
3853,32.037175256543826,0,1,160,0.0,0.006211180124223602,0.9937888198757764,161,3800,2700,1100,0.7105263157894737,49,27,22,233.4672503376945,0.4496635610766046,0.7519828701976201,0.14334185249376694,1066107.6887982476,13780.246133520519,1079887.934931768,3655,2,597.5527950310559,73,88,35,35.9955598297594,0.572463768115942,42.018581081081095,8264.99593083729,113.21912234023686,0
3854,32.22978920317755,0,2,158,0.0,0.0125,0.9875,160,4850,3000,1850,0.6185567010309279,67,30,37,229.8286948208024,0.4485799921383648,0.7465698831961762,0.14178917349983058,1073962.377927271,12515.474321134185,1086477.852248405,3656,10,602.275,75,85,37,35.911700292009556,0.5740885416666667,41.84484649122808,8320.286179301693,110.93714905735591,0
3855,31.936455321260386,0,0,158,0.0,0.0,1.0,158,3800,2600,1200,0.6842105263157895,50,26,24,234.4822860660486,0.4483315528501169,0.7485678937695417,0.14516004557629753,1065211.0200135936,14554.623023107168,1079765.6430367008,3657,11,603.6835443037975,76,82,38,35.664589007612285,0.5758834388185654,41.720779220779235,8248.522794825565,108.53319466875743,0
3856,32.313252232048676,0,0,158,0.0,0.0,1.0,158,3450,2200,1250,0.6376811594202898,47,22,25,216.19881975519496,0.4480065306780618,0.7255750861546062,0.1288642682721635,1066293.3188900086,11056.27141137356,1077349.5903013821,3658,12,604.6835443037975,76,82,35,37.546515710022796,0.564873417721519,43.10064935064933,8301.253515781931,109.22701994449909,8
3857,32.4596807103302,2,1,159,0.0125,0.00625,0.99375,160,4900,3700,1200,0.7551020408163265,61,37,24,215.95799912445383,0.449597910115304,0.732392864375033,0.1297784714543751,1073638.1506495483,9472.14935959073,1083110.300009139,3659,0,598.1125,79,81,40,37.245028181373264,0.5672526041666667,42.79947916666664,8348.646784780569,105.6790732250705,0
3858,32.41817646225693,0,1,158,0.0,0.006289308176100629,0.9937106918238994,159,5600,4000,1600,0.7142857142857143,72,40,32,217.60679340508685,0.4497585117957699,0.7339625262210507,0.1312594801584219,1073408.8088298682,9316.209780448247,1082725.0186103166,3660,1,602.3333333333334,67,92,40,37.062535964442326,0.5689858490566038,42.66237745098039,8342.416458171772,124.51367848017571,0
3859,32.37567092204419,0,1,157,0.0,0.006329113924050633,0.9936708860759493,158,5500,3800,1700,0.6909090909090909,72,38,34,216.71514266969936,0.4493754871133328,0.7301342556800485,0.1313461389550608,1073452.5162728475,9426.683042643544,1082879.1993154911,3661,2,607.0443037974684,70,88,41,36.90759362655729,0.5709388185654009,42.48826291079812,8337.115258563957,119.10164655091369,0
3860,32.45071033237888,0,0,157,0.0,0.0,1.0,157,4050,2400,1650,0.5925925925925926,57,24,33,202.49519795453583,0.44947329740323366,0.710572103493502,0.11745466633885554,1062387.5850484218,7575.676867764737,1069963.2619161864,3662,3,610.5350318471337,76,81,37,38.93371662701562,0.5538747346072187,44.11525974025977,8303.641584644922,109.25844190322266,8
3861,32.48467535747212,1,0,158,0.006329113924050633,0.0,1.0,158,5350,3800,1550,0.7102803738317757,69,38,31,202.09799990664803,0.450175024859577,0.7063980944222497,0.11387692392436101,1054364.8992508946,5667.007462075886,1060031.9067129705,3663,0,607.6645569620254,75,83,43,40.06743459393548,0.540743670886076,45.21655701754385,8276.55743174407,110.35409908992092,8
3862,32.61788600143624,2,1,159,0.0125,0.00625,0.99375,160,4800,3500,1300,0.7291666666666666,61,35,26,205.60164282358383,0.450903269129979,0.7106943439147979,0.11662014590890737,1060796.1237977277,6820.285150740327,1067616.408948468,3664,0,601.05625,78,82,38,39.719479198979776,0.5431640625,44.96308016877636,8318.76517721225,106.65083560528525,0
3863,32.66337582275441,5,0,164,0.03048780487804878,0.0,1.0,164,5150,3500,1650,0.6796116504854369,68,35,33,197.28445565503526,0.45354272656990374,0.7077589846250214,0.11346707131604666,1066679.7675466165,4137.867459734922,1070817.6350063514,3665,0,584.2256097560976,72,92,41,39.39302996463805,0.5465574186991871,44.43493150684933,8347.617879359786,115.93913721333037,0
3864,32.26723652015685,3,1,166,0.017964071856287425,0.005988023952095809,0.9940119760479041,167,4450,2800,1650,0.6292134831460674,61,28,33,193.72074298711965,0.45458781232715295,0.7078442215633005,0.11230990155539045,1056228.083674615,3072.6578266618526,1059300.7415012768,3666,0,574.7125748502993,75,92,34,39.177112349117934,0.5488398203592815,44.13377192982458,8256.0960986608,110.08128131547734,0
3865,31.784011324897314,1,0,167,0.005988023952095809,0.0,1.0,167,4500,3200,1300,0.7111111111111111,58,32,26,197.8831183168919,0.4544510376836688,0.7163555438408657,0.11532555959295215,1042011.4369507551,3339.2944931366223,1045350.7314438917,3667,0,575.7065868263473,77,90,37,38.869910642884456,0.5505863273453093,43.93696581196585,8138.710378520136,105.69753738337839,0
3866,32.082759300153135,3,1,169,0.01764705882352941,0.0058823529411764705,0.9941176470588236,170,6050,4400,1650,0.7272727272727273,77,44,33,193.14634529548968,0.45530151409676295,0.7156384662596511,0.11338475009125921,1054036.6290637285,666.664542247263,1054703.2936059758,3668,0,566.5294117647059,73,97,39,38.7145341387516,0.5528799019607843,43.66554054054053,8223.916763172681,112.65639401606413,0
3867,31.89426398955851,1,1,169,0.0058823529411764705,0.0058823529411764705,0.9941176470588236,170,4400,2900,1500,0.6590909090909091,59,29,30,192.17707406178565,0.45507381946861586,0.7130591818836234,0.11326644368246239,1049058.6605327756,1921.004780072813,1050979.6653128483,3669,0,567.5058823529412,75,95,44,38.587980281088015,0.5545955882352941,43.516995614035075,8180.3366507210285,109.07115534294705,0
3868,31.80908539048357,0,0,169,0.0,0.0,1.0,169,5000,3500,1500,0.7,65,35,30,194.93506258538437,0.4545954846435616,0.7161953683630287,0.11523142742851154,1047151.7484712917,2025.3183249288936,1049177.0667962206,3670,1,571.8343195266273,75,94,40,38.405455994159816,0.5555966469428009,43.40734649122805,8161.977626031242,108.82636834708323,0
3869,32.299626204496434,1,2,168,0.0058823529411764705,0.011764705882352941,0.9882352941176471,170,5550,3700,1850,0.6666666666666666,74,37,37,192.55183579799206,0.45467716672467806,0.7162222047805091,0.11488258029270165,1066144.9361280522,1507.632935637388,1067652.5690636896,3671,0,569.464705882353,78,92,37,38.11700280543297,0.5582107843137255,43.06434599156115,8298.92558308031,106.39648183436296,0
3870,32.34568129744776,2,0,170,0.011764705882352941,0.0,1.0,170,5750,4300,1450,0.7478260869565218,72,43,29,191.08704706372316,0.4556822137138879,0.7160384153661463,0.10887517797816802,1053358.0294484075,506.6150696317859,1053864.6445180392,3672,0,569.4,76,94,45,39.91496598639454,0.5436274509803922,44.79166666666667,8254.887414452827,108.61693966385299,8
3871,32.097694362735155,0,2,168,0.0,0.011764705882352941,0.9882352941176471,170,5300,4000,1300,0.7547169811320755,66,40,26,192.65789993085377,0.45546032022276367,0.7185139634640172,0.1101463970158621,1046349.0611053528,1017.4825414358884,1047366.5436467887,3673,1,570.4,71,99,43,39.74215961244267,0.5449754901960784,44.661458333333364,8195.778469443254,115.4334995696233,0
3872,31.672162205055344,5,1,172,0.028901734104046242,0.005780346820809248,0.9942196531791907,173,4300,2600,1700,0.6046511627906976,60,26,34,189.9306863760444,0.45734193664022943,0.7163868642826408,0.10965393506047708,1035474.2860154537,433.66837353223036,1035907.954388986,3674,0,559.5028901734104,76,97,47,39.43442933728351,0.5472663776493256,44.29112554112557,8098.852949133673,106.56385459386412,0
3873,31.549483259404138,3,2,173,0.017142857142857144,0.011428571428571429,0.9885714285714285,175,4650,3000,1650,0.6451612903225806,63,30,33,230.97334250091876,0.4583648056923919,0.774279139423603,0.12960354985955447,1022716.9535460342,7594.070638576926,1030311.024184611,3675,0,551.7942857142857,63,112,44,39.49650558254496,0.5329166666666667,45.37760416666667,8033.205014813136,127.51119071131961,8
3874,32.032187191799196,3,3,173,0.017045454545454544,0.017045454545454544,0.9829545454545454,176,4350,2900,1450,0.6666666666666666,58,29,29,227.3445580684973,0.4591977813852814,0.7715790271563654,0.12855048558674328,1040770.9167180471,7772.720822361753,1048543.6375404089,3676,0,549.6136363636364,67,109,37,39.28731496504613,0.5346827651515151,45.08272058823528,8165.558012541807,121.87400018719116,0
3875,32.26344280061128,4,0,177,0.022598870056497175,0.0,1.0,177,4900,2700,2200,0.5510204081632653,71,27,44,223.56564305740667,0.4598420647149461,0.7708297787952891,0.12788762547344862,1051925.2937387356,6734.870948610469,1058660.164687346,3677,0,544.0677966101695,61,116,42,38.931494944842854,0.5377236346516008,44.64045698924732,8238.778009517671,135.0619345822569,0
3876,32.22471846718043,1,0,178,0.0056179775280898875,0.0,1.0,178,5650,3700,1950,0.6548672566371682,76,37,39,217.43310658765955,0.45998513510654054,0.765392990719717,0.12514762240947608,1052584.2634821467,4523.33327084138,1057107.596752988,3678,0,542.0056179775281,64,114,40,38.849614395886896,0.5399110486891385,44.407051282051285,8236.410814632385,128.69391897863102,0
3877,32.23641856445274,3,2,179,0.016574585635359115,0.011049723756906077,0.988950276243094,181,5400,3700,1700,0.6851851851851852,71,37,34,210.97761469059253,0.46122749130345814,0.7619444574651517,0.12251309955601505,1055722.5131510515,2946.763519953294,1058669.2766710047,3679,0,534.0055248618785,70,111,40,38.67327830008408,0.5427601289134438,44.07276995305164,8250.177309834404,117.8596758547772,0
3878,32.00706396123347,4,0,183,0.02185792349726776,0.0,1.0,183,4800,3200,1600,0.6666666666666666,64,32,32,211.66804611405783,0.46210767829620286,0.7659177990632011,0.12414174736337534,1051263.799392695,3103.7908735785577,1054367.5902662736,3680,0,527.9016393442623,62,121,45,38.275353203019144,0.5457081056466302,43.70039682539682,8203.39779204828,132.31286761368193,0
3879,32.49796360914706,1,2,182,0.005434782608695652,0.010869565217391304,0.9891304347826086,184,6600,5200,1400,0.7878787878787878,80,52,28,209.71424154191072,0.4623258939177952,0.7640973295078359,0.12369372929268364,1069143.9053915967,1442.9406436709469,1070586.8460352677,3681,0,526.0271739130435,67,117,46,38.11019458544841,0.5476109601449275,43.48958333333333,8336.066186200469,124.41889830149954,0
3880,32.60376921421529,1,0,183,0.00546448087431694,0.0,1.0,183,5400,4000,1400,0.7407407407407407,68,40,28,213.2657880110973,0.4617211113112753,0.7672111579122454,0.12630852874252138,1073906.2934826647,3805.494385931353,1077711.7878685961,3682,0,529.8196721311475,67,116,44,37.8626405053218,0.5492372495446266,43.33639705882352,8368.200875983091,124.89852053706106,0
3881,32.2200888883631,5,2,186,0.026595744680851064,0.010638297872340425,0.9893617021276596,188,5000,3500,1500,0.7,65,35,30,204.70886960136065,0.46349011074449126,0.7638436842373968,0.12254436161421953,1064538.1376345844,984.0797605423859,1065522.2173951268,3683,0,516.7021276595744,75,113,42,37.67911890162622,0.5518617021276595,42.941337719298225,8282.452948207869,110.43270597610491,0
3882,31.898035816821015,1,0,187,0.0053475935828877,0.0,1.0,187,5300,3300,2000,0.6226415094339622,73,33,40,207.5070707712701,0.4633838383838384,0.7670377657903835,0.1250668100442485,1055944.7679532703,1123.2011388461979,1057067.9690921165,3684,0,520.4117647058823,62,125,44,37.3524718330977,0.553698752228164,42.69179894179893,8207.626213316256,132.38106795671382,0
3883,31.751267330848084,1,2,186,0.005319148936170213,0.010638297872340425,0.9893617021276596,188,5800,4000,1800,0.6896551724137931,76,40,36,211.6980865844867,0.4633407763492244,0.7715241519545031,0.12848986584538744,1053177.8994079249,1191.149227545152,1054369.04863547,3685,0,518.6382978723404,64,124,42,36.98331466733034,0.5559618794326241,42.435897435897424,8177.98667534277,127.78104180223077,0
3884,31.853808753273864,1,1,186,0.0053475935828877,0.0053475935828877,0.9946524064171123,187,5050,3500,1550,0.693069306930693,66,35,31,218.397735903724,0.4627357541256972,0.7770959955408303,0.1280834246537683,1046217.7109675495,3248.3158675379677,1049466.0268350875,3686,0,522.3582887700535,64,123,40,38.10443110527523,0.5426693404634582,43.70192307692308,8164.069926139572,127.56359259593081,8
3885,31.431204229030367,0,3,183,0.0,0.016129032258064516,0.9838709677419355,186,5800,4100,1700,0.7068965517241379,75,41,34,255.99911156281422,0.4625647825244599,0.799912391573476,0.15013847336237024,1032343.5906761293,9855.808408131013,1042199.3990842603,3687,1,525.3333333333334,63,123,38,37.13994464554094,0.5446348566308243,43.70117187500001,8055.780810458041,127.86953667393716,8
3886,31.68838927783838,3,0,186,0.016129032258064516,0.0,1.0,186,5250,3800,1450,0.7238095238095238,67,38,29,247.32257630007442,0.46305882495398626,0.7923344327808723,0.1458911400205553,1042541.4777081595,9118.808833293802,1051660.2865414533,3688,0,525.4086021505376,66,120,40,37.14151867789966,0.5465389784946236,43.48569651741294,8128.525104089801,123.15947127408789,0
3887,31.222726880801506,3,2,187,0.015873015873015872,0.010582010582010581,0.9894179894179894,189,5600,3700,1900,0.6607142857142857,75,37,38,241.33150647554638,0.4641062985477879,0.7947404884226839,0.14231375905299307,1027130.5616566672,6175.793158335503,1033306.3548150026,3689,0,518.0529100529101,69,120,35,37.30679884357291,0.5486111111111112,43.4970238095238,8008.722369707957,116.06844014069503,8
3888,31.7603899948217,2,5,184,0.010582010582010581,0.026455026455026454,0.9735449735449735,189,5500,3900,1600,0.7090909090909091,71,39,32,236.77138392685683,0.46447099328305,0.7905536622838523,0.14031609313962382,1046312.6131452258,6247.377086904125,1052559.9902321298,3690,0,518.1322751322751,73,116,35,37.23602732839777,0.5500440917107583,43.31362612612612,8152.459340590824,111.67752521357292,0
3889,31.64585342589817,2,2,184,0.010752688172043012,0.010752688172043012,0.989247311827957,186,5400,3600,1800,0.6666666666666666,72,36,36,237.17051413266114,0.4636255206819723,0.7863959354068559,0.1412607817550489,1044050.1166463277,6923.580589054727,1050973.6972353824,3691,0,527.1559139784946,76,110,32,37.035452215434276,0.552027329749104,43.127705627705616,8128.94297687977,106.95977601157593,0
3890,31.557884995504722,0,2,182,0.0,0.010869565217391304,0.9891304347826086,184,5950,4100,1850,0.6890756302521008,78,41,37,235.06217114891666,0.462684129246852,0.7824284707314735,0.1405195446031184,1042244.8161854149,6248.465872249273,1048493.2820576641,3692,1,533.804347826087,76,108,33,36.95114836649469,0.5535552536231885,42.99242424242423,8110.6155187310105,106.71862524646066,0
3891,31.09271448276593,0,2,180,0.0,0.01098901098901099,0.989010989010989,182,6500,4500,2000,0.6923076923076923,85,45,40,240.23391153822047,0.4618609981179042,0.7848575511968394,0.14436691373941246,1028424.3019472394,6512.478555550049,1034936.7805027895,3693,2,540.4560439560439,79,103,34,36.62065044972071,0.5555173992673993,42.79947916666668,7997.062359089556,101.22863745682982,0
3892,31.633588045251997,1,1,180,0.0055248618784530384,0.0055248618784530384,0.994475138121547,181,5750,4400,1350,0.7652173913043478,71,44,27,237.9164214572306,0.46131062001227746,0.7844293067852421,0.13920551367867895,1038278.3305836528,7454.692977810566,1045733.0235614633,3694,0,544.3149171270718,79,102,36,37.69338356117972,0.5461556169429098,43.789062500000036,8104.871249562896,102.59330695649236,8
3893,31.910082809245722,1,1,180,0.0055248618784530384,0.0055248618784530384,0.994475138121547,181,5650,4000,1650,0.7079646017699115,73,40,33,211.15669607308516,0.46156767955801103,0.757064314961293,0.12134283030497486,1041818.229490472,2147.37904958413,1043965.6085400562,3695,0,545.2486187845304,76,105,44,39.071240757407345,0.5440262430939227,44.46699134199136,8154.079466772799,107.29051929964209,8
3894,32.06472273055135,4,1,183,0.021739130434782608,0.005434782608695652,0.9945652173913043,184,5400,3800,1600,0.7037037037037037,70,38,32,208.84643738013966,0.46274971291676564,0.7524694261523985,0.1200020340189674,1046832.8945288982,1525.464110940216,1048358.3586398384,3696,0,536.7880434782609,77,107,43,39.13452492944501,0.5423460144927537,44.47115384615387,8193.46160158084,106.4085922283226,8
3895,31.770364065277313,2,1,184,0.010810810810810811,0.005405405405405406,0.9945945945945946,185,6450,5100,1350,0.7906976744186046,78,51,27,212.00879911355443,0.4630691833137485,0.758010230957741,0.11963737043648368,1031637.6437987171,293.2515964203794,1031930.8953951375,3697,0,534.7243243243244,81,104,38,39.757230031736505,0.5343468468468469,45.16006097560974,8096.357641177907,99.95503260713465,8
3896,31.93499894749807,2,2,184,0.010752688172043012,0.010752688172043012,0.989247311827957,186,6050,4400,1650,0.7272727272727273,77,44,33,215.45252243426165,0.46322532209628986,0.7646793675405832,0.12249138000595124,1039308.6885460517,1534.3357070179427,1040843.0242530697,3698,0,532.8333333333334,87,99,41,39.377783835196944,0.5365143369175627,44.874526515151494,8147.431727218526,93.64864054274167,0
3897,31.933918597585315,0,0,184,0.0,0.0,1.0,184,5000,3200,1800,0.64,68,32,36,232.82648016837442,0.46298420547240043,0.7742689190886218,0.13351793310597643,1041954.1129871064,6718.901724750101,1048673.0147118566,3699,1,537.7717391304348,71,113,40,38.59806545090709,0.5422894021739131,44.54571759259262,8157.656259802775,114.8965670394757,8
3898,32.265472850050365,1,1,184,0.005405405405405406,0.005405405405405406,0.9945945945945946,185,5100,3100,2000,0.6078431372549019,71,31,40,204.42554738230217,0.46313405797101453,0.7457339692633813,0.11358082852119122,1042796.2448008055,534.8386303227317,1043331.0834311282,3700,0,535.8594594594595,69,116,47,40.56159155204372,0.5279842342342342,45.75892857142857,8203.208387546283,118.88707808038092,8
3899,32.35310590073058,5,0,189,0.026455026455026454,0.0,1.0,189,4950,3400,1550,0.6868686868686869,65,34,31,210.96165283921852,0.4643021314120605,0.7688223439721682,0.11776537712154189,1047128.0119718984,1430.7712279673601,1048558.7831998657,3701,0,525.4761904761905,68,121,44,40.20933463873889,0.529376102292769,45.57669082125604,8231.384265474224,121.04976860991506,8
3900,31.8716130067075,1,1,189,0.005263157894736842,0.005263157894736842,0.9947368421052631,190,5350,4000,1350,0.7476635514018691,67,40,27,252.31610823533703,0.4647434558618769,0.8022281362362329,0.13439989834082844,1016663.4221891362,7954.111614396366,1024617.5338035325,3702,0,523.7052631578947,68,122,36,41.0454396031319,0.509923245614035,47.41847826086956,8050.180513514838,118.38500755168879,8
3901,31.661007578786123,7,5,191,0.03571428571428571,0.025510204081632654,0.9744897959183674,196,5450,4000,1450,0.7339449541284404,69,40,29,238.15363341031514,0.4665718210361067,0.7966839068655822,0.128227547447032,1013368.887254301,3617.496496916024,1016986.383751217,3703,0,508.19897959183675,80,116,36,40.965233302836246,0.5139243197278911,46.99074074074075,8010.528074910486,100.13160093638108,0
3902,31.25508943894881,3,5,189,0.015463917525773196,0.02577319587628866,0.9742268041237113,194,6250,4700,1550,0.752,78,47,31,224.551941008469,0.46630677670352366,0.7876776480535959,0.12401213466843998,1008277.5654606733,232.13687989743812,1008509.7023405707,3704,0,514.3505154639175,77,117,37,40.289826498422705,0.520189003436426,45.99358974358974,7938.993070630411,103.10380611208326,7
3903,31.549851589008668,5,1,193,0.02577319587628866,0.005154639175257732,0.9948453608247423,194,5500,4000,1500,0.7272727272727273,70,40,30,225.05326806248917,0.46712248277335616,0.7896920282753845,0.12367852731434048,1016247.8256394723,1441.97886431216,1017689.8045037845,3705,0,513.2164948453608,67,127,38,40.473487134608796,0.5164304123711341,46.18566176470586,8007.804702485937,119.5194731714319,8
3904,31.279435133661632,4,1,196,0.02030456852791878,0.005076142131979695,0.9949238578680203,197,6950,5200,1750,0.7482014388489209,87,52,35,217.36733143992564,0.468524465623813,0.7864258098668104,0.1208346345582198,1011089.614860754,-2394.429714219068,1008695.1851465349,3706,0,506.3604060913706,65,132,42,40.21182495344507,0.5198815566835872,45.738636363636374,7953.15183086001,122.35618201323092,0
3905,31.409482437807796,3,2,197,0.01507537688442211,0.010050251256281407,0.9899497487437185,199,6550,4200,2350,0.6412213740458015,89,42,47,209.47758096666774,0.46908257618056615,0.7799022397115181,0.1172115014111203,1017311.0417587365,-3729.2287763397185,1013581.8129823968,3707,0,502.20100502512565,68,131,44,40.15461573442474,0.5222466499162479,45.486111111111114,7994.149523233727,117.56102240049599,0
3906,31.80909964935424,2,5,194,0.010050251256281407,0.02512562814070352,0.9748743718592965,199,5150,3800,1350,0.7378640776699029,65,38,27,211.22176067381204,0.4692232204795019,0.7822611445065029,0.11910712790203813,1032670.6605861271,-1325.4969749618363,1031345.1636111652,3708,0,503.00502512562815,70,129,38,39.80560513588209,0.5247592127303182,45.187793427230055,8105.346870745097,115.79066958207281,0
3907,31.80241479795919,2,3,193,0.01020408163265306,0.015306122448979591,0.9846938775510204,196,6250,4700,1550,0.752,78,47,31,216.1228308699902,0.469548556602128,0.7838638104248306,0.12268626865176194,1034524.0307253688,-733.1475753199029,1033790.8831500489,3709,0,511.2704081632653,73,123,42,39.41983995584991,0.5270514455782314,44.93243243243245,8111.76458529031,111.12006281219602,0
3908,31.847064138640608,5,3,195,0.025252525252525252,0.015151515151515152,0.9848484848484849,198,6200,4600,1600,0.7419354838709677,78,46,32,202.6883384287863,0.4699634885231332,0.7752360713708026,0.11463728322752469,1034833.3154586881,-3850.2709477850253,1030983.0445109031,3710,0,506.94444444444446,73,125,38,39.906129210381025,0.5280408249158249,45.07319819819822,8118.670207640553,111.2146603786377,8
3909,32.20863977646798,5,2,198,0.025,0.01,0.99,200,5550,3600,1950,0.6486486486486487,75,36,39,199.21988310632386,0.4704067211055276,0.7731029826561835,0.11364604286890416,1049272.9710716465,-3742.792271296093,1045530.1788003504,3711,0,495.23,67,133,43,39.660537818320044,0.5309895833333333,44.745710784313744,8221.393452746455,122.707364966365,0
3910,32.06097853907913,3,3,198,0.014925373134328358,0.014925373134328358,0.9850746268656716,201,5400,3300,2100,0.6111111111111112,75,33,42,192.44002028076636,0.4708312603648424,0.766162392635046,0.1104419342911299,1046336.8772196885,-5328.582025465746,1041008.2951942227,3712,0,493.6467661691542,71,130,45,39.600262849916,0.5331674958540631,44.516782407407426,8191.041956331035,115.36678811733853,0
3911,32.41575676836117,1,0,199,0.005025125628140704,0.0,1.0,199,6100,3900,2200,0.639344262295082,83,39,44,188.89503318250388,0.47021301795171144,0.7599919100144683,0.10905445142436804,1059780.5200755033,-5862.544698833104,1053917.9753766702,3713,0,489.63316582914575,74,125,44,39.46146325566239,0.536536850921273,44.291666666666686,8288.979136976399,112.01323158076215,0
3912,31.937794070555817,1,5,195,0.005,0.025,0.975,200,5950,3900,2050,0.6554621848739496,80,39,41,163.8430255771806,0.47014447236180906,0.7227368263344862,0.09571235110048876,1047775.1710214253,-11615.869171040082,1036159.3018503851,3714,0,488.18,94,106,44,39.65182355207398,0.545625,43.848684210526336,8180.907974586191,87.03093589985309,8
3913,31.535544705741206,0,6,189,0.0,0.03076923076923077,0.9692307692307692,195,6300,4100,2200,0.6507936507936508,85,41,44,170.93467004486445,0.46892677768966434,0.7265459563634624,0.10008855155977607,1035284.4946450982,-9906.79730105505,1025377.6973440432,3715,2,499.34358974358975,91,104,44,39.381315084029325,0.5467948717948719,43.76132246376813,8080.626270783888,88.79809088773503,0
3914,31.72858956657602,0,3,186,0.0,0.015873015873015872,0.9841269841269842,189,5150,3700,1450,0.7184466019417476,66,37,29,185.4693467966229,0.4674014503358475,0.742005286941094,0.10953870106011791,1044233.4418051017,-4215.341129043889,1040018.1006760579,3716,3,515.8042328042328,73,116,47,38.68191960203374,0.5491622574955908,43.4403153153153,8140.276934690488,111.51064294096558,8
3915,31.83661526556587,0,3,183,0.0,0.016129032258064516,0.9838709677419355,186,5900,4100,1800,0.6949152542372882,77,41,36,186.20957812055863,0.46632035261067517,0.7391046195075099,0.11033469744296334,1048776.2275391852,-4041.5642254116906,1044734.6633137735,3717,4,524.9677419354839,74,112,45,38.5398066482694,0.550739247311828,43.31944444444442,8171.840093373878,110.43027153207943,0
3916,32.08742254928173,3,2,184,0.016129032258064516,0.010752688172043012,0.989247311827957,186,5150,3400,1750,0.6601941747572816,69,34,35,199.01179402153346,0.46624830475636925,0.753558142413058,0.11710773696008078,1054923.2437926712,-361.56653956135733,1054561.6772531099,3718,0,525.8064516129032,71,115,42,38.473256601218665,0.5491151433691757,43.57638888888886,8227.972761334848,115.8869403004908,7
3917,32.13449175144512,6,4,186,0.031578947368421054,0.021052631578947368,0.9789473684210527,190,5800,4000,1800,0.6896551724137931,76,40,36,214.92064679040922,0.4670571103685139,0.7727475226318634,0.12495228770811562,1052754.5261675827,1451.7367350937943,1054206.2629026766,3719,0,514.5,74,116,37,38.52640622173992,0.5408442982456141,44.0277777777778,8225.537263599128,111.15590896755579,8
3918,32.096332541456306,2,0,188,0.010638297872340425,0.0,1.0,188,6350,4900,1450,0.7716535433070866,78,49,29,208.34857588289367,0.4667962083285926,0.7622991600573623,0.12224237427259736,1054315.0823667648,-16.990811405757995,1054298.091555359,3720,0,519.8191489361702,64,124,46,38.34562961110415,0.5440492021276595,43.68589743589744,8226.742670962378,128.54285423378715,0
3919,32.239004735895286,1,2,187,0.005291005291005291,0.010582010582010581,0.9894179894179894,189,5350,3600,1750,0.6728971962616822,71,36,35,203.28910927456386,0.46666619760591393,0.758517877184544,0.11996674903541855,1060785.1889480192,-20.784761421426083,1060764.4041865978,3721,0,518.063492063492,66,123,48,38.25517676767676,0.5458002645502645,43.47014925373134,8270.267073107465,125.30707686526462,0
3920,32.11715042392192,5,3,189,0.026041666666666668,0.015625,0.984375,192,5900,3800,2100,0.6440677966101694,80,38,42,212.92164543070555,0.4676342531995346,0.7629022898912239,0.12725043927541824,1060635.1972659428,866.4382807167322,1061501.6355466596,3722,0,504.3541666666667,77,115,38,37.53009596064576,0.5517578125,43.00213675213673,8254.039032558074,107.19531211114382,8
3921,31.76780195720608,2,0,191,0.010471204188481676,0.0,1.0,191,7000,5500,1500,0.7857142857142857,85,55,30,216.19761018866026,0.46738196932120873,0.767535027661784,0.13024587735755905,1051498.3884587623,266.28774040251847,1051764.676199165,3723,0,507.9633507853403,69,122,40,37.14574898785425,0.5543193717277487,42.70833333333334,8173.59071190617,118.45783640443724,0
3922,32.05217542412409,0,4,187,0.0,0.020942408376963352,0.9790575916230366,191,5750,4200,1550,0.7304347826086957,73,42,31,212.8229248093345,0.46732685772021676,0.7644967660109849,0.12874314781034368,1062156.3550480914,1260.244417231428,1063416.599465323,3724,1,508.9633507853403,68,123,38,37.078397740378065,0.5557918848167539,42.55736714975846,8251.596429764333,121.34700632006373,0
3923,32.08690452940811,3,0,190,0.015789473684210527,0.0,1.0,190,5400,3400,2000,0.6296296296296297,74,34,40,218.5457974496253,0.4668233082706767,0.7640327253553463,0.13373504533453354,1066766.8852822997,3227.483927374683,1069994.3692096744,3725,0,510.2105263157895,74,116,45,36.503442672986445,0.5592105263157895,42.13888888888889,8273.964854069329,111.81033586580175,0
3924,32.16393754026206,3,1,192,0.015544041450777202,0.0051813471502590676,0.9948186528497409,193,5750,3900,1850,0.6782608695652174,76,39,37,248.91771591043874,0.46749739133563617,0.8003838836499795,0.1505097570315605,1065722.8692129191,8705.460479599858,1074428.329692519,3726,0,503.2642487046632,61,132,42,36.166133664012555,0.5562931778929188,42.5739247311828,8279.83620618104,135.73501977345967,8
3925,32.331569300151976,0,4,188,0.0,0.020833333333333332,0.9791666666666666,192,6250,4500,1750,0.72,80,45,35,246.58672622782564,0.46681505417393837,0.7968296284197205,0.1495996707137559,1072292.8544298715,8232.636906270569,1080525.4913361422,3727,1,506.7552083333333,64,128,43,36.1011293634497,0.5575086805555556,42.45192307692309,8326.933497159354,130.1083358931149,0
3926,32.708881973423345,2,0,190,0.010526315789473684,0.0,1.0,190,5050,3600,1450,0.7128712871287128,65,36,29,224.31497709036123,0.4660847721154739,0.7795942269230074,0.13454292568397266,1081289.9220059742,5459.904816561901,1086749.826822536,3728,0,510.7157894736842,70,120,39,37.101900985202946,0.5541118421052631,42.86971830985917,8410.44403559594,120.14920050851342,7
3927,32.70771577474524,0,3,187,0.0,0.015789473684210527,0.9842105263157894,190,5750,4300,1450,0.7478260869565218,72,43,29,226.56155210978582,0.46603719948018196,0.7774847513047864,0.13335585029246827,1075401.9887838638,4978.948744164335,1080380.9375280282,3729,1,511.7157894736842,67,123,41,37.756371963361204,0.5444627192982456,43.56617647058822,8387.364615031138,125.18454649300206,8
3928,32.76471265994877,2,1,188,0.010582010582010581,0.005291005291005291,0.9947089947089947,189,4800,2900,1900,0.6041666666666666,67,29,38,226.10380633836652,0.46497992419978235,0.7736395917279788,0.1342750102080743,1080050.9855627306,6240.72777504717,1086291.7133377776,3730,0,515.3227513227513,74,115,43,37.4305818503092,0.5473985890652557,43.236111111111086,8412.795040895397,113.68641947155942,0
3929,32.49592065059442,0,0,188,0.0,0.0,1.0,188,5350,4100,1250,0.7663551401869159,66,41,25,224.5434623813021,0.4650563441043729,0.7715209890741834,0.13400174367916295,1072697.612139837,5223.447183606317,1077921.059323443,3731,1,517.9414893617021,74,114,36,37.28603603603602,0.5490359042553192,43.05555555555552,8349.646278277649,112.83305781456282,0
3930,32.091093332879964,1,1,188,0.005291005291005291,0.005291005291005291,0.9947089947089947,189,5900,4400,1500,0.7457627118644068,74,44,30,212.2906027819518,0.4649353634282712,0.773109994649807,0.12585602835928633,1057323.2432915373,1191.9577307453765,1058515.2010222827,3732,0,516.1957671957672,73,116,44,37.8500402134971,0.5520282186948854,43.299549549549525,8237.798113997675,112.84654950681745,8
3931,32.38251320807436,2,2,188,0.010526315789473684,0.010526315789473684,0.9894736842105263,190,6750,5300,1450,0.7851851851851852,82,53,29,210.43851887878208,0.4649847999628702,0.7720290366593106,0.12567192122641405,1069168.0226027665,248.8270218163766,1069416.8496245828,3733,0,514.3315789473684,80,110,39,37.62219330730993,0.5543311403508773,43.029835390946495,8321.339749533694,104.01674686917117,0
3932,32.49409260999863,0,4,184,0.0,0.02127659574468085,0.9787234042553191,188,5300,3500,1800,0.660377358490566,71,35,36,203.88328908490388,0.46474760116812686,0.7535980977317982,0.11930524141560113,1066554.7170751018,590.5367412582946,1067145.2538163601,3734,1,520.6276595744681,88,100,40,38.56131895908517,0.5510859929078014,43.78511235955057,8325.470287049171,94.60761689828604,8
3933,32.52132176380796,0,2,182,0.0,0.010869565217391304,0.9891304347826086,184,5750,4000,1750,0.6956521739130435,75,40,35,201.38924805901368,0.4637334679654708,0.7454566261383522,0.11825611594267951,1068530.3638551685,488.1053010035398,1069018.469156172,3735,2,530.2391304347826,76,108,38,38.49279645363869,0.5529891304347826,43.655303030303045,8336.6683725974,109.69300490259737,0
3934,32.9889775298729,1,2,181,0.00546448087431694,0.01092896174863388,0.9890710382513661,183,5850,4100,1750,0.7008547008547008,76,41,35,196.7387895972058,0.4636401849516603,0.7361417053141099,0.1162589254618019,1085888.976373898,277.29656975022453,1086166.2729436483,3736,0,529.4863387978143,81,102,42,38.37178598541112,0.5549863387978142,43.419715447154495,8464.321241722277,104.49779310768243,0
3935,33.30355465289213,1,1,181,0.005494505494505495,0.005494505494505495,0.9945054945054945,182,5600,3800,1800,0.6785714285714286,74,38,36,196.99691168029088,0.4632308299435371,0.7371363487958473,0.1171902558321364,1098355.6746452067,1274.5351663258148,1099630.2098115324,3737,0,533.2582417582418,82,100,47,38.11327208756841,0.5570054945054945,43.17269076305222,8553.262329527959,104.30807718936535,0
3936,33.301964889133224,1,1,181,0.005494505494505495,0.005494505494505495,0.9945054945054945,182,5800,4100,1700,0.7068965517241379,75,41,34,199.77298588904077,0.463156836257665,0.7403934563648491,0.11955031038581021,1100179.3380777738,1757.2222762452657,1101936.560354019,3738,0,534.0494505494505,84,98,37,37.8183353198252,0.5587797619047619,42.95343137254903,8560.155803303585,101.90661670599506,0
3937,32.88862724410224,2,2,181,0.01092896174863388,0.01092896174863388,0.9890710382513661,183,5650,4000,1650,0.7079646017699115,73,40,33,197.71052164168216,0.46307847434896615,0.7391849368935173,0.11938004811150243,1089302.4243551076,823.3101089594516,1090125.734464067,3739,0,532.0382513661202,74,109,41,37.53642544924723,0.5613046448087431,42.625,8464.710436950812,114.38797887771368,0
3938,33.183023857505724,0,1,180,0.0,0.0055248618784530384,0.994475138121547,181,5850,4600,1250,0.7863247863247863,71,46,25,196.95186077010936,0.46280182115817475,0.7440203054542553,0.11517082684956047,1088951.1692189104,844.1918130903719,1089795.3610320007,3740,1,538.6132596685082,85,96,43,38.76486336343437,0.5513927255985267,43.81056201550389,8501.140232680558,100.01341450212422,8
3939,33.20261134074174,2,0,182,0.01098901098901099,0.0,1.0,182,6150,4800,1350,0.7804878048780488,75,48,27,201.30173695764685,0.4627381711290551,0.7342263908362476,0.12026033872731239,1096362.273008696,1589.925978297043,1097952.1989869932,3741,0,536.6373626373627,87,95,37,37.84296791033319,0.5584363553113554,43.0160984848485,8532.536602835067,98.07513336592031,8
3940,33.00537229949249,1,2,181,0.00546448087431694,0.01092896174863388,0.9890710382513661,183,4600,3200,1400,0.6956521739130435,60,32,28,206.5126766625713,0.462629356071979,0.7427124786354058,0.1240697038599163,1091605.4676591447,3886.073397157944,1095491.5410563026,3742,0,534.6994535519126,92,91,39,37.49782248933022,0.5605077413479053,42.80913978494626,8488.680093424653,92.26826188505058,0
3941,33.13776801460277,1,1,181,0.005494505494505495,0.005494505494505495,0.9945054945054945,182,7200,5100,2100,0.7083333333333334,93,51,42,204.59532931419477,0.4621765780260256,0.7403849763143493,0.1237128859713943,1097997.3031647142,1329.0239654160678,1099326.3271301303,3743,0,537.5604395604396,76,106,39,37.30621682694834,0.5630151098901099,42.57305194805192,8530.554485252578,112.24413796384971,0
3942,32.98757456887458,1,1,181,0.005494505494505495,0.005494505494505495,0.9945054945054945,182,5800,4100,1700,0.7068965517241379,75,41,34,212.52231095832815,0.46230432780847147,0.7593467558793505,0.12679641124203653,1088849.7707814965,4080.9739145854837,1092930.744696082,3744,0,537.8406593406594,75,107,37,37.60424446104054,0.559581043956044,43.06469298245611,8475.672599617836,113.00896799490448,8
3943,33.365648551695955,1,0,182,0.005494505494505495,0.0,1.0,182,5300,3300,2000,0.6226415094339622,73,33,40,208.1509874843062,0.4621500161900714,0.754865914280769,0.12487185702816335,1103061.9106051284,4220.685189756338,1107282.5957948847,3745,0,538.4560439560439,80,102,41,37.51031507876967,0.5616414835164836,42.86265432098764,8579.554305441838,107.24442881802297,0
3944,33.16098721290744,0,1,181,0.0,0.005494505494505495,0.9945054945054945,182,6950,5200,1750,0.7482014388489209,87,52,35,219.91009331181,0.46184961447392386,0.7611831719692177,0.1272614595807233,1084902.5174971134,4366.202771401762,1089268.7202685152,3746,1,539.4560439560439,75,107,41,38.57705308185534,0.5496794871794872,44.20230263157896,8482.504171525414,113.10005562033885,7
3945,33.36938725224146,6,1,186,0.03208556149732621,0.0053475935828877,0.9946524064171123,187,4800,3000,1800,0.625,66,30,36,212.83627470421007,0.46383186705767354,0.761923394635015,0.12466124661246616,1095584.7650589456,4436.036003566751,1100020.8010625124,3747,0,524.4385026737968,84,103,40,38.29607046070463,0.553030303030303,43.75000000000001,8550.905483386892,101.79649384984396,0
3946,33.78681283455131,1,1,186,0.0053475935828877,0.0053475935828877,0.9946524064171123,187,6100,4400,1700,0.7213114754098361,78,44,34,214.98838738196952,0.46367254135280705,0.7670457631889531,0.12402761589829783,1104364.9963742627,3985.1299303195256,1108350.1263045822,3748,0,525.4331550802139,74,113,42,38.82260941206294,0.5462344028520499,44.31944444444445,8638.63107598967,116.73825778364419,8
3947,33.559926877446514,4,2,188,0.021052631578947368,0.010526315789473684,0.9894736842105263,190,5950,4600,1350,0.773109243697479,73,46,27,227.60208426145599,0.46399447693307344,0.7828298038875807,0.13326276901033113,1101727.1778244418,6201.080392067194,1107928.258216509,3749,0,517.7736842105263,78,112,37,37.93118235304209,0.5483552631578947,43.76318565400845,8599.288752761351,110.24729170206861,8
3948,33.3509890076015,3,2,189,0.015706806282722512,0.010471204188481676,0.9895287958115183,191,5950,4300,1650,0.7226890756302521,76,43,33,213.64995809869268,0.4642796454487003,0.7629020194465219,0.12318332850933905,1089930.9318027503,2422.7395820253296,1092353.6713847755,3750,0,516.0471204188482,80,111,35,38.87942236753855,0.5428119546247818,44.34156378600823,8526.461695873428,106.58077119841785,8
3949,32.98694658267444,4,0,193,0.02072538860103627,0.0,1.0,193,5550,3800,1750,0.6846846846846847,73,38,35,221.84506773207622,0.46496968552101325,0.7799579074530232,0.12852141633416947,1079555.5485419761,3748.814757366764,1083304.3632993428,3751,0,511.6062176165803,75,118,42,38.485526268795304,0.5436636442141624,44.16118421052632,8439.34135022207,112.52455133629427,8
3950,33.18214653789024,0,3,190,0.0,0.015544041450777202,0.9844559585492227,193,6000,4600,1400,0.7666666666666667,74,46,28,218.4793261984821,0.46474929835924006,0.7765876983171691,0.12706883279860245,1087196.0933379945,2905.973983621572,1090102.067321616,3752,1,512.6062176165804,78,115,37,38.42094193193917,0.5451748704663213,44.01371308016879,8494.174484264295,108.89967287518327,0
3951,33.421235883836424,2,2,190,0.010416666666666666,0.010416666666666666,0.9895833333333334,192,5450,3400,2050,0.6238532110091743,75,34,41,219.91314111757782,0.464342118419139,0.7782990644038286,0.12836430593486783,1096185.9752140855,4363.140211673164,1100549.1154257588,3753,0,516.2447916666666,80,112,40,38.24615468300194,0.5464952256944444,43.878600823045275,8559.893696791254,106.99867120989067,0
3952,33.76579206109524,0,1,189,0.0,0.005263157894736842,0.9947368421052631,190,5900,4000,1900,0.6779661016949152,78,40,38,198.50684171597726,0.4635175902719762,0.7525000000000006,0.11219951923076914,1096966.3318579514,-348.93559882376167,1096617.3962591277,3754,1,522.6315789473684,84,106,34,40.03806089743588,0.5346491228070176,45.098039215686256,8606.96660380854,102.46388814057785,8
3953,34.13241847297302,1,1,189,0.005263157894736842,0.005263157894736842,0.9947368421052631,190,6400,4700,1700,0.734375,81,47,34,199.35732473447203,0.4629298941798942,0.7537179142752501,0.11323538081254202,1110513.4030383083,-122.20377770198093,1110391.1992606062,3755,0,523.6210526315789,87,103,36,39.82463263727765,0.5365679824561403,44.91003787878786,8706.837335375989,100.07859006179298,0
3954,33.73454327432851,2,1,190,0.010471204188481676,0.005235602094240838,0.9947643979057592,191,5200,3600,1600,0.6923076923076923,68,36,32,197.92752027279744,0.4630763754937081,0.7549849646394058,0.11306492709252734,1099435.7115727486,121.7168181907382,1099557.4283909393,3756,0,521.848167539267,73,118,41,39.63990507434158,0.5382853403141361,44.69313063063065,8612.66063297437,117.98165250649822,0
3955,33.87700496148946,7,1,196,0.03553299492385787,0.005076142131979695,0.9949238578680203,197,6200,4500,1700,0.7258064516129032,79,45,34,188.58116909157135,0.46472922925515386,0.7512395059103527,0.10914849483784912,1108378.8227440307,-3796.1251621181036,1104582.6975819126,3757,0,506.84263959390864,83,114,47,39.37245491564862,0.5418781725888324,44.19642857142858,8665.858858452457,104.40793805364406,0
3956,34.206452807541424,3,7,192,0.01507537688442211,0.035175879396984924,0.964824120603015,199,5700,4000,1700,0.7017543859649122,74,40,34,199.05725899442155,0.4650028340354973,0.7644248939511553,0.11509071976082602,1118810.4090396408,-958.5333284278017,1117851.875711213,3758,0,502.68341708542715,74,125,46,39.14494524391351,0.540462730318258,44.23611111111115,8748.775395151142,118.22669452906949,8
3957,33.807343927275575,4,4,192,0.02040816326530612,0.02040816326530612,0.9795918367346939,196,5600,3300,2300,0.5892857142857143,79,33,46,198.96683458066576,0.46352640415140417,0.7587125374908175,0.11574083648232306,1107738.1641559748,-719.3687867371673,1107018.7953692377,3759,0,511.1173469387755,76,120,34,38.91362363261639,0.5428890306122449,44.00703463203466,8654.442223158027,113.87423977839508,0
3958,33.2252948238296,4,5,191,0.02040816326530612,0.025510204081632654,0.9744897959183674,196,6050,4400,1650,0.7272727272727273,77,44,33,202.22589935995532,0.46378586691086693,0.7648139743564641,0.11867625899172943,1091469.88897679,-1105.3040154718137,1090364.5849613182,3760,0,512.0765306122449,71,125,40,38.494160504976364,0.5451211734693877,43.67766203703702,8516.385248752691,119.94908801060129,0
3959,33.21153039606893,1,2,190,0.005208333333333333,0.010416666666666666,0.9895833333333334,192,6550,5100,1450,0.7786259541984732,80,51,29,201.66895543031697,0.4626787240037813,0.7618570444845545,0.11890219191300506,1092496.146767073,-885.4886539680056,1091610.658113105,3761,0,523.015625,71,121,39,38.331323913738295,0.5476888020833333,43.504050925925895,8518.623009142091,119.98060576256466,0
3960,33.3979069437058,1,0,191,0.005235602094240838,0.0,1.0,191,5400,3700,1700,0.6851851851851852,71,37,34,197.82267245741372,0.462671075594746,0.7561195349153484,0.11717189060939052,1100089.945940169,-75.45339011707574,1100014.492550052,3762,0,526.3612565445026,74,117,43,38.25588474025976,0.549792757417103,43.333333333333314,8572.129448884434,115.83958714708695,0
3961,33.14787831560881,2,1,192,0.010362694300518135,0.0051813471502590676,0.9948186528497409,193,6450,4200,2250,0.6511627906976745,87,42,45,196.42145476739987,0.46331115968624065,0.755936836808309,0.11696502356025225,1093536.521962753,-2091.193102958937,1091445.3288597942,3763,0,521.8963730569948,77,116,44,38.09031749332775,0.5521912780656304,43.13568376068374,8514.50709832286,110.57801426393324,0
3962,33.09647814733425,1,2,191,0.0051813471502590676,0.010362694300518135,0.9896373056994818,193,5200,3900,1300,0.75,65,39,26,211.21072519732644,0.46315598913356365,0.7739580516403977,0.12248176436987879,1083455.6148245393,1967.489225241481,1085423.1040497809,3764,0,522.6632124352332,77,116,34,38.71955462769658,0.5423683074265976,44.12393162393164,8468.596705434395,109.98177539525187,8
3963,32.7583020691478,0,0,191,0.0,0.0,1.0,191,5250,3900,1350,0.7428571428571429,66,39,27,214.524904782128,0.462372554422706,0.7749840991494397,0.12481115253125674,1073415.6224138024,2604.8768379941166,1076020.4992517966,3765,1,529.1204188481676,82,109,37,38.50918799228685,0.5435209424083769,44.00100401606427,8386.092439840355,102.26941999805311,0
3964,32.91494200659264,2,2,191,0.010362694300518135,0.010362694300518135,0.9896373056994818,193,5550,3900,1650,0.7027027027027027,72,39,33,208.14316569724042,0.46286476324122044,0.7716766237277755,0.12196241747632663,1080793.6126711804,841.9608013471452,1081635.5734725276,3766,0,524.6269430051814,67,126,41,38.40069390479604,0.5458225388601037,43.734681372549005,8434.958100923504,125.89489702870902,0
3965,32.84867807810859,0,4,187,0.0,0.020942408376963352,0.9790575916230366,191,6300,4700,1600,0.746031746031746,79,47,32,199.7040306026211,0.462575778451364,0.757103607437837,0.11788856341518045,1080945.3189036518,-1326.172590781196,1079619.1463128706,3767,1,530.6649214659686,74,117,42,38.335092848248564,0.5513198080279231,43.458333333333314,8427.054621954732,113.87911651290179,8
3966,33.05611131738033,1,0,188,0.005319148936170213,0.0,1.0,188,5650,4200,1450,0.7433628318584071,71,42,29,197.40729226251676,0.4619760259035916,0.7508599702588896,0.11703834051233501,1089133.9486198514,-249.40325835456406,1088884.5453614967,3768,0,532.9308510638298,75,113,42,38.23020672041575,0.5532468971631206,43.29769736842104,8485.579891217294,113.14106521623059,0
3967,32.74180007550253,1,1,188,0.005291005291005291,0.005291005291005291,0.9947089947089947,189,5400,3400,2000,0.6296296296296297,74,34,40,194.18442811239044,0.4621292074749521,0.7449969510504992,0.11194927768358746,1069991.5046375508,-1644.8623173676147,1068346.642320183,3769,0,531.1058201058202,76,113,46,39.38082072176951,0.5453593474426808,44.34523809523814,8370.597102636022,110.1394355610003,8
3968,32.34240392811726,1,2,187,0.005291005291005291,0.010582010582010581,0.9894179894179894,189,5050,3800,1250,0.7524752475247525,63,38,25,201.89627922718634,0.46110313707831435,0.7535181456166165,0.11729545080361509,1059341.5692845145,-74.5757461532803,1059266.9935383613,3770,0,532.0529100529101,81,108,42,38.887441267950535,0.5476741622574957,44.05487804878051,8277.880517577623,102.19605577256326,0
3969,32.017596612403075,3,0,190,0.015789473684210527,0.0,1.0,190,7050,4800,2250,0.6808510638297872,93,48,45,200.54277890164252,0.46100204214239304,0.7562194235663893,0.11750893689126281,1051328.418103744,-2882.7354990417925,1048445.6826047023,3771,0,530.1368421052632,67,123,47,38.59546545918268,0.5504385964912281,43.73468137254899,8204.999597562604,122.46268056063589,0
3970,32.43933957066938,1,0,191,0.005235602094240838,0.0,1.0,191,6350,4400,1950,0.6929133858267716,83,44,39,197.39035732528947,0.4610028015063838,0.7539456311353461,0.115138593315051,1063766.9911108823,-2554.530702754654,1061212.4604081276,3772,0,528.3560209424083,80,111,41,38.849239228683366,0.5463023560209423,43.904320987654344,8307.57469406269,103.84468367578363,8
3971,32.634481189853375,4,2,193,0.020512820512820513,0.010256410256410256,0.9897435897435898,195,6000,3900,2100,0.65,81,39,42,191.97455001407724,0.46219050136575907,0.7528818047817734,0.11345290585284855,1074245.647881164,-3754.4350286867616,1070491.2128524773,3773,0,518.4974358974359,74,121,44,38.490919670888836,0.5497863247863248,43.41666666666665,8373.463965296503,113.15491844995275,0
3972,32.194082210765494,1,2,192,0.005154639175257732,0.010309278350515464,0.9896907216494846,194,5350,3900,1450,0.7289719626168224,68,39,29,189.7971190994417,0.4618977351637199,0.7489282951004808,0.11273491532051114,1061298.2160433352,-3863.7312179199166,1057434.4848254153,3774,0,521.9587628865979,77,117,48,38.35573022312375,0.5519759450171822,43.22916666666665,8266.501317660053,107.35715996961108,0
3973,32.67831295918085,1,3,190,0.0051813471502590676,0.015544041450777202,0.9844559585492227,193,5600,3900,1700,0.6964285714285714,73,39,34,192.66620445760736,0.46160315918249856,0.7510157251982557,0.11504591664057057,1078900.6467041434,-2626.461482531213,1076274.1852216122,3775,0,525.1450777202073,79,114,36,38.08298496748584,0.5541342832469776,43.03385416666664,8397.220133456114,106.29392573995081,0
3974,32.17314402245696,1,0,191,0.005235602094240838,0.0,1.0,191,4950,2800,2150,0.5656565656565656,71,28,43,192.02657397129363,0.46083976302011576,0.7490036460357838,0.11513164825723926,1063461.0580038847,-2307.44329592573,1061153.6147079591,3776,0,530.0575916230366,82,109,40,37.94672637932997,0.5557918848167539,42.88403614457829,8272.228935593257,100.88084067796655,0
3975,32.49414536402467,2,1,192,0.010362694300518135,0.0051813471502590676,0.9948186528497409,193,5750,3800,1950,0.6608695652173913,77,38,39,225.13990610313826,0.46145473517559005,0.790702912838982,0.12814088439702465,1057856.3270536826,3283.13482869536,1061139.461882378,3777,0,525.5544041450777,76,117,41,39.08740677906193,0.5344343696027634,44.832251082251084,8291.457925544291,109.098130599267,8
3976,32.80645384878531,1,1,192,0.0051813471502590676,0.0051813471502590676,0.9948186528497409,193,6400,4800,1600,0.75,80,48,32,198.565461045543,0.4618010578583765,0.7548679796805924,0.11325996409357574,1068712.2673931818,-2558.1311800087324,1066154.1362131732,3778,0,523.9948186528497,74,119,40,39.681616606812526,0.5422603626943006,44.75000000000002,8373.847344902502,113.16009925543922,8
3977,32.62419889995074,2,0,194,0.010309278350515464,0.0,1.0,194,5450,3700,1750,0.6788990825688074,72,37,35,194.8445824335275,0.4620017849829959,0.7520734546723753,0.1118278622402856,1064734.835829257,-2758.437102083476,1061976.3987271735,3779,0,522.1082474226804,78,116,41,39.53677659647673,0.5445124570446735,44.51476793248946,8335.001026970567,106.85898752526369,0
3978,32.95651261189669,3,0,197,0.015228426395939087,0.0,1.0,197,5950,4000,1950,0.6722689075630253,79,40,39,217.52233346620892,0.46228396180807346,0.7789597805385005,0.12389865223772588,1073150.5891550006,1336.8440627257478,1074487.4332177264,3780,0,515.1421319796955,87,110,41,39.25241005303276,0.5380710659898478,44.80350378787874,8410.386545926476,96.67110972329283,8
3979,32.50576424328766,2,4,195,0.010050251256281407,0.020100502512562814,0.9798994974874372,199,6300,4400,1900,0.6984126984126984,82,44,38,210.51675474971523,0.46291326159416607,0.7719780037251034,0.1209272193739505,1061141.8570513315,-1422.371984893337,1059719.4850664383,3781,0,510.95477386934675,73,126,41,39.102899588658715,0.5407244556113903,44.48198198198199,8305.80845360584,113.77819799460055,0
3980,32.905874966725946,4,1,198,0.020100502512562814,0.005025125628140704,0.9949748743718593,199,5950,4600,1350,0.773109243697479,73,46,27,207.28277034250337,0.4633774935282473,0.7696760468845432,0.12038414453993765,1077690.4876643994,-1072.6660290316868,1076617.8216353678,3782,0,511.27638190954775,81,118,35,38.76254322397048,0.5443362646566164,44.067581300813025,8421.680169647247,103.97136011910182,0
3981,33.343238820894854,1,3,196,0.005025125628140704,0.01507537688442211,0.9849246231155779,199,6050,4000,2050,0.6611570247933884,81,40,41,208.87852986272003,0.4631321591120586,0.777768261301417,0.12128530293801475,1091946.7088174075,-233.1553547563999,1091713.553462651,3783,0,512.2713567839196,79,120,38,38.72980793691175,0.5434463986599665,44.075520833333364,8533.351028967378,108.01710163249845,8
3982,33.05812430708466,3,2,197,0.01507537688442211,0.010050251256281407,0.9899497487437185,199,4950,3400,1550,0.6868686868686869,65,34,31,203.09249254793565,0.4631459062991727,0.7725686970241821,0.11883442921657081,1085046.450059654,-677.042385418531,1084369.4076742355,3784,0,512.9246231155779,82,117,43,38.58417013633767,0.545644891122278,43.78765060240968,8469.89969539586,103.2914596999495,0
3983,32.635311186641026,2,5,194,0.010050251256281407,0.02512562814070352,0.9748743718592965,199,5200,3400,1800,0.6538461538461539,70,34,36,198.79793970877154,0.46319560766796947,0.7681709236142893,0.11706410787831001,1073154.858333735,-2331.8050349592627,1070823.0532987758,3785,0,513.7638190954774,72,127,45,38.45205968543661,0.5475816582914572,43.55022831050226,8369.31810282975,116.24052920596874,0
3984,33.096969168890034,1,3,192,0.005128205128205128,0.015384615384615385,0.9846153846153847,195,5600,4100,1500,0.7321428571428571,71,41,30,217.2553587961787,0.4626453872587893,0.7882154140033799,0.12730773797166164,1086785.5583580758,2621.997283117874,1089407.5556411936,3786,0,524.5794871794872,60,135,40,38.16538393194289,0.5470619658119658,43.73292349726776,8481.663530012516,141.36105883354193,8
3985,33.209530220553894,0,2,190,0.0,0.010416666666666666,0.9895833333333334,192,6200,4600,1600,0.7419354838709677,78,46,32,218.36780158458427,0.46205779159394994,0.7855738011988007,0.12842900668987636,1091644.6066549197,3076.006573380746,1094720.6132283004,3787,1,531.4791666666666,60,132,39,37.997280497280485,0.548828125,43.59631147540985,8515.046042718894,141.9174340453149,0
3986,32.9828574080075,5,1,194,0.02564102564102564,0.005128205128205128,0.9948717948717949,195,5750,3800,1950,0.6608695652173913,77,38,39,204.0016550711009,0.4623579169970922,0.771747030734167,0.12131842051058084,1087678.8025060347,-372.34482060320715,1087306.4576854315,3788,0,523.8102564102564,69,126,45,37.94544559045077,0.5517094017094017,43.1845238095238,8470.50823136001,122.76098886029001,0
3987,33.41178522101764,0,2,192,0.0,0.010309278350515464,0.9896907216494846,194,6350,4600,1750,0.7244094488188977,81,46,35,204.14988918526475,0.46229223421113547,0.7705293423209381,0.12193712240632441,1103205.0795931106,-106.16105048913096,1103098.9185426214,3789,1,520.8092783505155,75,119,39,37.777403683752006,0.5539626288659794,43.0235745614035,8586.041133619217,114.48054844825623,0
3988,33.56173677441868,0,6,186,0.0,0.03125,0.96875,192,5650,4400,1250,0.7787610619469026,69,44,25,208.89128674041623,0.4617981702661431,0.7729363455770155,0.1251043530390204,1109008.4404835308,2282.4400277172235,1111290.880511248,3790,2,527.1510416666666,76,116,40,37.55470627444791,0.5555013020833333,42.92478354978354,8627.890745728842,113.52487823327424,0
3989,33.26877415060429,1,0,187,0.0053475935828877,0.0,1.0,187,4600,3600,1000,0.782608695652174,56,36,20,210.65913877507666,0.4614755237383321,0.7697935781622873,0.12658190728166094,1100369.3829752586,4360.573310406023,1104729.9562856646,3791,0,541.1604278074866,76,111,43,37.38494108983799,0.5572638146167558,42.8030303030303,8556.627897068285,112.58720917195112,0
3990,33.381934632196504,1,1,187,0.005319148936170213,0.005319148936170213,0.9946808510638298,188,5350,3800,1550,0.7102803738317757,69,38,31,205.99089968547267,0.4618160247658057,0.7659207280941212,0.12451334814081624,1105978.1854950497,2614.288292526515,1108592.4737875762,3792,0,539.2765957446809,67,121,45,37.283285725620914,0.5590093085106382,42.585784313725505,8592.984521437378,128.25350031996086,0
3991,32.888237914590654,0,1,186,0.0,0.0053475935828877,0.9946524064171123,187,5700,4000,1700,0.7017543859649122,74,40,34,205.32497880005786,0.46161688037873994,0.7629015175202585,0.12460605655930637,1090852.0114264316,1695.8332240267546,1092547.8446504583,3793,1,541.3155080213904,69,118,45,37.15213581388185,0.5606060606060606,42.44047619047621,8470.678896216341,122.76346226400494,0
3992,33.33071814840903,1,1,186,0.0053475935828877,0.0053475935828877,0.9946524064171123,187,5900,4000,1900,0.6779661016949152,78,40,38,201.43908463631647,0.46192594828742833,0.7587387189450499,0.12312657510657418,1107764.2107737947,1329.4017222292,1109093.6124960238,3794,0,542.096256684492,70,117,42,36.98666514918719,0.5623885918003565,42.180164319248846,8593.320276144295,122.7617182306328,0
3993,33.47740328106678,1,0,187,0.0053475935828877,0.0,1.0,187,5700,4400,1300,0.7719298245614035,70,44,26,226.68786572472874,0.4619606884787151,0.7789300482798929,0.13656561666831252,1108085.3389619184,7137.900106028124,1115223.2390679466,3795,0,542.7379679144385,70,117,38,36.87584345479081,0.557430926916221,42.70833333333334,8613.456885857828,123.04938408368325,7
3994,33.77736022118048,0,3,184,0.0,0.016042780748663103,0.983957219251337,187,6350,4600,1750,0.7244094488188977,81,46,35,230.14983797163364,0.4616396411937209,0.7820533501339684,0.13895988498837122,1118721.1213599623,7744.69696328793,1126465.8183232502,3796,1,543.7379679144385,63,124,39,36.703516621345294,0.55899064171123,42.626953125,8693.382115519646,137.99019230983563,0
3995,33.47014864480676,0,1,183,0.0,0.005434782608695652,0.9945652173913043,184,5300,3700,1600,0.6981132075471698,69,37,32,256.61516599721926,0.4613761681317811,0.7893308629011093,0.1505429025591311,1099403.5449225798,14324.724635647624,1113728.2695582274,3797,2,550.4184782608696,69,115,32,37.113185090571285,0.5463088768115942,43.690476190476176,8578.717860984365,124.32924436209224,7
3996,33.173363034511084,1,0,184,0.005434782608695652,0.0,1.0,184,5350,3700,1650,0.6915887850467289,70,37,33,256.6449625955896,0.4611992159657876,0.7882683740452363,0.1512885106261487,1091184.068329987,13859.378880290806,1105043.447210278,3798,0,550.7989130434783,73,111,33,36.92802947148894,0.5484601449275363,43.51069819819821,8508.612723139486,116.55633867314364,0
3997,33.593174102852394,1,1,184,0.005405405405405406,0.005405405405405406,0.9945945945945946,185,4800,3300,1500,0.6875,63,33,30,258.2761591121973,0.46149383078730905,0.7907999561313466,0.15313338465313653,1106844.2658051616,15374.297141503783,1122218.5629466653,3799,0,548.8162162162162,77,108,33,36.66588631082442,0.5505067567567568,43.29594017094019,8623.504174746697,111.99356071099606,0
3998,33.821999933103136,2,3,183,0.010752688172043012,0.016129032258064516,0.9838709677419355,186,6400,4600,1800,0.71875,82,46,36,259.36659096853145,0.4615234185798702,0.7937953546268335,0.15485711166650565,1116624.5755834386,14323.021912151977,1130947.5974955906,3800,0,546.763440860215,78,108,31,36.37323823207444,0.5526993727598566,43.037974683544306,8690.969603063217,111.4226872187592,0
3999,33.51011055967243,1,5,179,0.005434782608695652,0.02717391304347826,0.9728260869565217,184,5750,4400,1350,0.7652173913043478,71,44,27,250.6875206547213,0.46109712817771437,0.7936828717569344,0.14728008720001934,1101183.5472718196,12660.594650268813,1113844.1419220883,3801,0,552.3260869565217,63,121,36,37.20934385118403,0.5497622282608696,43.636067708333336,8590.783714606132,136.3616462635894,8
4000,33.612892574655085,3,1,181,0.016483516483516484,0.005494505494505495,0.9945054945054945,182,6950,5500,1450,0.7913669064748201,84,55,29,250.75288324237334,0.4607175743225467,0.7882970504253766,0.14882144804199007,1107813.3396713869,12207.477803392394,1120020.8174747792,3802,0,549.6868131868132,69,113,35,36.82107218068353,0.5527701465201464,43.258928571428555,8629.810053430383,125.06971091928091,0
4001,33.693125824347575,0,0,181,0.0,0.0,1.0,181,7050,5400,1650,0.7659574468085106,87,54,33,250.80807214348602,0.46031051770002046,0.7870571196885121,0.149477513384358,1111794.2837329328,12519.396184640937,1124313.6799175737,3803,1,553.4917127071823,70,111,41,36.66131258328573,0.5542702578268877,43.10446009389671,8655.61374977004,123.65162499671486,0
4002,33.928427847039195,1,2,180,0.005494505494505495,0.01098901098901099,0.989010989010989,182,5050,3800,1250,0.7524752475247525,63,38,25,270.4198555612299,0.4602729797826483,0.7988218204318491,0.15732103305299283,1111737.3803802421,18677.17236488938,1130414.5527451315,3804,0,551.445054945055,73,109,33,37.0807214340702,0.5452724358974359,44.0033783783784,8685.562905775036,118.98031377774022,8
4003,33.7671022600075,1,1,180,0.0055248618784530384,0.0055248618784530384,0.994475138121547,181,5750,4200,1550,0.7304347826086957,73,42,31,270.76631243985196,0.46039108860241457,0.8011175162830122,0.1584196228389984,1108291.414790331,18067.59589830514,1126359.010688636,3805,0,555.1657458563536,76,105,37,36.85329654856824,0.5474217311233887,43.79058441558443,8651.449536015762,113.83486231599686,0
4004,34.02963737911618,0,0,180,0.0,0.0,1.0,180,5700,3900,1800,0.6842105263157895,75,39,36,230.69234059584298,0.4603261431822884,0.7733130343851877,0.1363273493662892,1120154.1698325535,9982.197453373028,1130136.3672859266,3806,1,559.0722222222222,65,115,41,37.49942332533676,0.5504629629629629,43.4185606060606,8731.373340787426,134.32882062749886,8
4005,33.45358633562923,1,0,181,0.0055248618784530384,0.0,1.0,181,6650,5100,1550,0.7669172932330827,82,51,31,229.4716507688976,0.4606033865357069,0.7749555201797929,0.13655877776304673,1103419.6182647718,7790.704258800691,1111210.3225235725,3807,0,556.9779005524862,66,115,43,37.26543583535107,0.5527163904235728,43.15920398009949,8592.245744163452,130.18554157823414,0
4006,33.654733337742556,3,4,180,0.016304347826086956,0.021739130434782608,0.9782608695652174,184,5850,4400,1450,0.7521367521367521,73,44,29,224.18670516376426,0.46155126415617326,0.7740073434083006,0.13452716062055137,1112702.4667740013,7240.619970731032,1119943.0867447322,3808,0,548.8804347826087,71,113,38,37.08811559956487,0.5547441123188406,42.853009259259245,8654.213401982553,121.89032960538808,0
4007,33.1536657792178,1,0,181,0.0055248618784530384,0.0,1.0,181,6300,4900,1400,0.7777777777777778,77,49,28,227.80165841462062,0.4600828729281768,0.7759406535268389,0.1374226748668662,1097792.9531366548,7515.8110640826935,1105308.7642007375,3809,0,558.7900552486187,62,119,40,36.7964533538936,0.5567449355432781,42.65873015873015,8531.806451516946,137.60978147607977,0
4008,33.014361515776386,2,0,183,0.01092896174863388,0.0,1.0,183,5600,4000,1600,0.7142857142857143,72,40,32,220.69465817553356,0.4601423166996938,0.7699643876060152,0.1342074681065335,1095668.103530417,6161.619516496027,1101829.723046913,3810,0,553.672131147541,69,114,42,36.6802282485223,0.5589139344262295,42.36607142857142,8505.619656586845,123.26985009546152,0
4009,32.953190264436834,1,0,184,0.005434782608695652,0.0,1.0,184,6200,4400,1800,0.7096774193548387,80,44,36,234.69018401516746,0.46012017898154745,0.7820725465234823,0.1363256813428964,1079296.064437904,7660.038393955506,1086956.1028318594,3811,0,551.6576086956521,66,118,35,38.0543068885919,0.5413269927536232,44.06094527363184,8434.008366498114,127.78800555300172,8
4010,32.894026763675534,2,0,186,0.010752688172043012,0.0,1.0,186,7350,5500,1850,0.7482993197278912,92,55,37,230.01908256457457,0.4606358374503536,0.7812067324978313,0.13489634820390461,1080376.8563620485,5151.458664879379,1085528.315026928,3812,0,546.7150537634409,65,121,40,37.807323418929734,0.5444108422939068,43.70265151515151,8430.651840519662,129.7023360079948,0
4011,33.14193056813668,1,0,187,0.0053475935828877,0.0,1.0,187,5400,3900,1500,0.7222222222222222,69,39,30,230.38910409421322,0.4609544208690319,0.7820551953221622,0.13604004291094687,1090682.6075316216,7456.277760069978,1098138.8852916916,3813,0,544.7860962566845,68,119,40,37.537390647679565,0.5464015151515151,43.44806763285023,8502.626329633353,125.03862249460813,0
4012,33.0408322424152,1,0,188,0.005319148936170213,0.0,1.0,188,5400,3800,1600,0.7037037037037037,70,38,32,231.6743314366986,0.46131113228657034,0.7848463303687263,0.13750142761457002,1088966.3946259844,7457.1122864013205,1096423.5069123856,3814,0,542.8829787234042,71,117,39,37.31005109132574,0.5481493794326241,43.25810185185184,8482.965986312187,119.47839417341109,0
4013,32.652532240098566,1,2,187,0.005291005291005291,0.010582010582010581,0.9894179894179894,189,5500,3600,1900,0.6545454545454545,74,36,38,232.65565795988465,0.46134118541033436,0.7884105045741674,0.13903745817916882,1078300.4758195202,6874.541336049377,1085175.0171555695,3815,0,541.005291005291,73,116,34,37.024782731737574,0.5501543209876543,43.003941441441434,8391.572087661578,114.95304229673394,0
4014,32.357409765936076,0,1,186,0.0,0.0053475935828877,0.9946524064171123,187,5600,3800,1800,0.6785714285714286,74,38,36,205.28270196806938,0.46122874858643365,0.7597996082608462,0.11817300409481593,1056968.1779001527,395.4566907223234,1057363.6345908751,3816,1,546.3315508021391,71,116,41,39.154037187977615,0.5403854723707665,44.401041666666686,8270.52023053813,116.48620043011451,8
4015,32.73713410044791,1,2,185,0.0053475935828877,0.0106951871657754,0.9893048128342246,187,6550,5000,1550,0.7633587786259542,81,50,31,204.05288140284375,0.4614910969275296,0.7591942247063164,0.11811611252530843,1071118.9735700004,-237.01742355670558,1070881.9561464437,3817,0,547.3155080213904,72,115,43,38.97252282404565,0.5423908199643495,44.19235159817354,8374.409289650877,116.31124013403996,0
4016,32.90778611309498,5,0,190,0.02631578947368421,0.0,1.0,190,5900,4400,1500,0.7457627118644068,74,44,30,223.66941154167597,0.4623230530028775,0.7823049926412311,0.1287082678923536,1074824.7626877958,4181.0844361602685,1079005.847123956,3818,0,538.9684210526316,71,119,38,38.69886599494319,0.5438048245614036,44.41550925925927,8410.71975512062,118.4608416214172,8
4017,32.600883255269025,3,2,191,0.015544041450777202,0.010362694300518135,0.9896373056994818,193,6000,4000,2000,0.6666666666666666,80,40,40,218.12772591908322,0.4631661089522165,0.779975969920202,0.12627592669211535,1066692.3287717693,1935.034386063804,1068627.363157833,3819,0,531.5751295336787,75,118,43,38.608640520074324,0.5454987046632125,44.1885964912281,8339.677701156055,111.19570268208074,0
4018,32.822540312803916,1,6,186,0.005208333333333333,0.03125,0.96875,192,6000,4700,1300,0.7833333333333333,73,47,26,217.16425697584842,0.4630224240110529,0.7775012883873342,0.12614462934375498,1075015.2687998735,2290.9784173235707,1077306.2472171972,3820,0,532.4791666666666,76,116,36,38.50307010589005,0.5476345486111112,44.06114718614721,8400.563314095529,110.53372781704643,0
4019,32.55920556052887,4,1,189,0.021052631578947368,0.005263157894736842,0.9947368421052631,190,5900,4000,1900,0.6779661016949152,78,40,38,219.3112838691791,0.46291132924904854,0.7800235971568557,0.12806178443829333,1068031.1842566987,2946.25804633142,1070977.44230303,3821,0,538.4315789473684,81,109,40,38.24698498900629,0.5501644736842105,43.86432926829269,8339.573954737622,102.9577031449089,0
4020,32.9900608851139,1,3,187,0.005263157894736842,0.015789473684210527,0.9842105263157894,190,5300,3700,1600,0.6981132075471698,69,37,32,222.72922393943227,0.4629136498654043,0.7757764507312548,0.12944424055439346,1080666.449737849,4839.199937498766,1085505.6496753476,3822,0,539.4263157894737,74,116,36,38.34072657225028,0.5444627192982456,44.041666666666686,8444.08100071899,114.10920271241879,8
4021,33.38806250279406,3,2,188,0.015789473684210527,0.010526315789473684,0.9894736842105263,190,5500,3900,1600,0.7090909090909091,71,39,32,215.9783072100832,0.4635135291933537,0.7706448042707943,0.12665505082920758,1096585.4317171674,3867.7330507021115,1100453.1647678695,3823,0,538.7263157894737,68,122,43,38.16928786004593,0.5473135964912281,43.70471014492751,8557.20315685282,125.84122289489441,0
4022,33.25707804509889,1,1,188,0.005291005291005291,0.005291005291005291,0.9947089947089947,189,5050,3600,1450,0.7128712871287128,65,36,29,214.83106616498773,0.46351176404367894,0.7686905575291723,0.1267370950907609,1094181.3311037633,4162.828387768992,1098344.1594915322,3824,0,541.5079365079365,69,120,44,37.9713423831071,0.5493827160493827,43.48214285714283,8531.034394961467,123.63817963712272,0
4023,33.63630769480435,1,3,186,0.005291005291005291,0.015873015873015872,0.9841269841269842,189,6250,4800,1450,0.768,77,48,29,213.9164618518805,0.46362785657998423,0.7680176005193835,0.12696460617365538,1108598.9478764094,3379.5129084874393,1111978.4607848967,3825,0,542.1640211640212,73,116,44,37.76517124476853,0.5518628747795414,43.2573198198198,8635.875788929232,118.29966834149633,0
4024,33.1521482525367,0,1,185,0.0,0.005376344086021506,0.9946236559139785,186,5950,4500,1450,0.7563025210084033,74,45,29,215.6690126075346,0.46323077109367433,0.7666557944978907,0.12850137685611665,1093860.5321944458,4032.364181745222,1097892.8963761912,3826,1,545.1989247311828,76,110,43,37.57394631979912,0.5537074372759856,43.11417748917746,8516.316871853538,112.0568009454413,0
4025,32.655137035272546,0,1,184,0.0,0.005405405405405406,0.9945945945945946,185,5800,4600,1200,0.7931034482758621,70,46,24,235.8951189659586,0.4631891402271837,0.7813938872812136,0.13717293918481513,1069871.638372379,7675.499482431653,1077547.1378548106,3827,2,549.027027027027,76,109,36,37.98213279075503,0.5475225225225225,44.02056277056278,8359.04360093925,109.98741580183224,8
4026,32.671668548639765,4,3,185,0.02127659574468085,0.015957446808510637,0.9840425531914894,188,4850,3100,1750,0.6391752577319587,66,31,35,235.76720133998302,0.46386996529753105,0.7841120809998974,0.1336469070403344,1062346.1066067368,7643.2736818193625,1069989.3802885562,3828,0,541.2287234042553,79,109,33,38.974608543953714,0.5374002659574468,44.98697916666666,8331.700892254008,105.46456825637985,8
4027,32.21770431334089,2,0,187,0.0106951871657754,0.0,1.0,187,5750,4200,1550,0.7304347826086957,73,42,31,235.5573032445485,0.4641397370287313,0.7847589038190597,0.13472412191400804,1050380.2716241067,6334.948833010245,1056715.2204571168,3829,0,543.283422459893,71,116,35,38.63196411709159,0.54049688057041,44.64699074074075,8226.88774783663,115.87165842023423,0
4028,32.375039894971074,2,1,188,0.010582010582010581,0.005291005291005291,0.9947089947089947,189,5900,4000,1900,0.6779661016949152,78,40,38,234.27104760180572,0.46484506923336716,0.7850888795458031,0.13494378941156118,1057737.4755814793,5859.453298432635,1063596.9288799118,3830,0,538.5238095238095,77,112,37,38.38917985824493,0.5428240740740741,44.37767094017095,8275.783101357418,107.4777026150314,0
4029,32.79379815790057,3,2,189,0.015706806282722512,0.010471204188481676,0.9895287958115183,191,5850,3800,2050,0.6495726495726496,79,38,41,199.4647581778469,0.46528543216680446,0.7610167313705754,0.11538782756091129,1072774.5036087993,-1253.858611661964,1071520.6449971374,3831,0,533.3612565445026,75,116,45,39.11401957632268,0.5428119546247818,44.21600877192984,8388.12858035559,111.8417144047412,8
4030,32.817842518549845,3,2,190,0.015625,0.010416666666666666,0.9895833333333334,192,5350,3700,1650,0.6915887850467289,70,37,33,188.6312514747241,0.46583621927719604,0.7518219103213031,0.1073976443552878,1068501.627986218,-3439.440142035486,1065062.1878441826,3832,0,530.734375,74,118,47,40.00594168979847,0.5342339409722222,44.81944444444448,8374.475286018365,113.16858494619413,8
4031,32.45267582831465,2,1,191,0.010416666666666666,0.005208333333333333,0.9947916666666666,192,5150,3600,1550,0.6990291262135923,67,36,31,209.7520917846639,0.4655862556355439,0.7676894082765588,0.11831021060953857,1053649.5000962585,651.0373306108663,1054300.5374268694,3833,0,531.7083333333334,80,112,37,39.832513247539694,0.5333658854166667,45.17746913580245,8269.672987886455,103.37091234858069,7
4032,32.87444243451517,3,0,194,0.015463917525773196,0.0,1.0,194,6250,4600,1650,0.736,79,46,33,212.82568441628914,0.46577094795505936,0.774360085681002,0.12106409889038225,1070057.3381642418,497.137071895223,1070554.475236137,3834,0,527.1907216494845,83,111,42,39.42350141757795,0.5359213917525774,44.85367063492062,8387.793317090103,101.0577508083145,0
4033,32.69088492441302,4,3,195,0.020202020202020204,0.015151515151515152,0.9848484848484849,198,6600,4300,2300,0.6515151515151515,89,43,46,200.2179942446629,0.4666915559999316,0.7648064078265675,0.11525216603329888,1067846.775455536,-3439.572091531951,1064407.2033640041,3835,0,517.520202020202,74,124,44,39.28526146099369,0.5391940235690236,44.402777777777814,8355.699378666372,112.91485646846448,0
4034,32.32461806447355,3,3,195,0.015151515151515152,0.015151515151515152,0.9848484848484849,198,6450,4800,1650,0.7441860465116279,81,48,33,207.73577303682092,0.46695700661436707,0.7739970235268037,0.11961680793997498,1055979.7788188367,-2177.0448671633135,1053802.7339516734,3836,0,518.0353535353536,77,121,40,39.08111285266459,0.5376683501683501,44.39102564102566,8262.462470005694,107.30470740267135,8
4035,32.76560745421332,2,4,193,0.01015228426395939,0.02030456852791878,0.9796954314720813,197,5850,3900,1950,0.6666666666666666,78,39,39,237.72695466980252,0.4672521927552747,0.8020453356279715,0.13332248663262644,1061968.94294937,5241.728552252671,1067210.6715016228,3837,0,519.4365482233502,66,131,43,39.34543437550889,0.5263324873096447,45.39800995024876,8342.18886303169,126.3968009550256,7
4036,32.24973804394591,3,2,194,0.015306122448979591,0.01020408163265306,0.9897959183673469,196,6750,4900,1850,0.725925925925926,86,49,37,229.6405121509932,0.4674232513518228,0.7929846194169432,0.12982646776061152,1047785.4792715854,2172.7988168603715,1049958.2780884458,3838,0,521.0867346938776,69,127,42,39.23550301615098,0.5292304421768708,45.08928571428573,8220.803760309462,119.14208348274582,0
4037,32.216161434033914,1,4,191,0.005128205128205128,0.020512820512820513,0.9794871794871794,195,5900,4100,1800,0.6949152542372882,77,41,36,229.99025468949557,0.46701251211560485,0.7922780192351317,0.13044621009222782,1047713.2153071569,3292.7658460087987,1051005.9811531657,3839,0,524.4564102564102,71,124,44,39.099727705922376,0.5311431623931624,44.965277777777786,8216.23978239513,115.72168707598776,0
4038,32.2961314378189,2,2,191,0.010362694300518135,0.010362694300518135,0.9896373056994818,193,5550,3500,2050,0.6306306306306306,76,35,41,246.31133654713082,0.4668126169401266,0.8000130048204344,0.1390534360468057,1048844.2104725568,7518.443862243144,1056362.6543347999,3840,0,525.839378238342,70,123,34,38.866381708978565,0.530440414507772,45.14377934272301,8230.870000093199,117.58385714418856,8
4039,32.095875497651626,3,0,194,0.015463917525773196,0.0,1.0,194,5900,4600,1300,0.7796610169491526,72,46,26,250.180089632531,0.4681830119473675,0.801902872277803,0.1423907896266839,1044886.1626275152,7581.942764388594,1052468.1053919038,3841,0,523.3092783505155,75,119,38,38.44900941791548,0.5330756013745704,44.832785087719294,8189.815160907075,109.197535478761,0
4040,32.52595362028995,5,5,194,0.02512562814070352,0.02512562814070352,0.9748743718592965,199,5700,3700,2000,0.6491228070175439,77,37,40,251.87202178352587,0.4694928768421231,0.8142892816704355,0.14285714285714293,1057788.076901202,7785.444309522788,1065573.521210725,3842,0,511.1356783919598,65,134,36,38.5416666666667,0.5269577051926297,44.965277777777786,8295.247546563545,127.61919302405454,8
4041,32.41415885637478,2,2,194,0.01020408163265306,0.01020408163265306,0.9897959183673469,196,6350,4400,1950,0.6929133858267716,83,44,39,246.9955398912897,0.4690885007849293,0.8080072241040286,0.1411800779316443,1056593.6067498059,6644.781668970822,1063238.3884187767,3843,0,515.8010204081633,59,137,37,38.36360519933819,0.5297087585034014,44.6701388888889,8276.30267883169,140.27631659036763,0
4042,32.558330604499936,1,3,192,0.005128205128205128,0.015384615384615385,0.9846153846153847,195,5650,4400,1250,0.7787610619469026,69,44,25,266.03081173126935,0.4695149352365848,0.8110698786087172,0.1499334943536141,1056823.769026435,11579.53702620045,1068403.3060526354,3844,0,517.148717948718,69,126,40,38.43008994276371,0.5276709401709402,45.208333333333336,8295.591318604886,120.22596113920125,8
4043,32.06477556856041,3,2,193,0.015384615384615385,0.010256410256410256,0.9897435897435898,195,6150,4800,1350,0.7804878048780488,75,48,27,259.4256615994551,0.470187902017799,0.8069288751449555,0.14750201902368984,1043554.5506990118,8994.965946042557,1052549.5166450543,3845,0,518.0512820512821,77,118,37,38.25311453098825,0.5302884615384615,44.87179487179486,8180.6286386455195,106.24193037201974,0
4044,32.28584995730558,2,2,193,0.010256410256410256,0.010256410256410256,0.9897435897435898,195,5200,3700,1500,0.7115384615384616,67,37,30,243.17470424958933,0.46974733456692225,0.8003389177739277,0.13414130435182822,1041159.343039007,6436.723064041158,1047596.0661030482,3846,0,519.0102564102564,70,125,35,39.86303678028115,0.5216346153846154,46.03873239436618,8199.355380882578,117.13364829832254,8
4045,32.379269507572744,4,0,197,0.02030456852791878,0.0,1.0,197,6950,5700,1250,0.8201438848920863,82,57,25,228.82499451199328,0.4701550036258158,0.7894487146290563,0.12493416990084688,1040866.9209141156,1285.273493177442,1042152.1944072931,3847,0,514.7005076142132,71,126,36,40.6389079082506,0.5179780033840948,46.440972222222214,8210.05609649477,115.63459290837706,8
4046,32.64972657481018,7,3,201,0.03431372549019608,0.014705882352941176,0.9852941176470589,204,6500,4600,1900,0.7076923076923077,84,46,38,232.10642204971234,0.47168845986670527,0.7993004392590695,0.12854734227742298,1054180.956249183,1636.4339895884923,1055817.3902387714,3848,0,498.0049019607843,82,122,38,39.98532776899774,0.521905637254902,45.88353413654619,8296.833128598864,101.18089181218127,0
4047,32.47551359629413,5,6,200,0.024271844660194174,0.02912621359223301,0.970873786407767,206,7450,5400,2050,0.7248322147651006,95,54,41,227.1235746180904,0.4723754834635725,0.794392449112548,0.12731422393729624,1052412.431534904,-844.4653154554289,1051567.9662194487,3849,0,494.0533980582524,74,132,42,39.63447899618113,0.5251820388349515,45.41666666666666,8267.724503056528,111.72600679806119,0
4048,32.25477577350728,3,3,200,0.014778325123152709,0.014778325123152709,0.9852216748768473,203,6300,4800,1500,0.7619047619047619,78,48,30,237.2458809256995,0.4718557446877693,0.801127774169258,0.1346488211611428,1049173.035894841,2882.3962288727016,1052055.4321237137,3850,0,501.6009852216749,76,127,38,38.889294049008186,0.5281711822660098,44.94047619047621,8226.887749373782,108.24852301807607,0
4049,31.840691016048115,1,1,200,0.004975124378109453,0.004975124378109453,0.9950248756218906,201,7050,5100,1950,0.723404255319149,90,51,39,239.94419499742907,0.4717972636815921,0.8019215738462022,0.13676990871614447,1037042.9229596031,2516.4858654649042,1039559.408825068,3851,0,507.0995024875622,64,137,41,38.65168068985725,0.5299543946932006,44.77564102564105,8126.5199538715615,126.97687427924315,0
4050,31.60290792296278,5,3,202,0.024390243902439025,0.014634146341463415,0.9853658536585366,205,7550,5100,2450,0.6754966887417219,100,51,49,217.82519875019952,0.4728708353260003,0.7956271952593241,0.12226481288917204,1024547.4870633635,-3915.548000281076,1020631.9390630824,3852,0,498.1560975609756,68,137,39,39.81875358194503,0.520630081300813,45.36533816425121,8047.195771989946,118.34111429396978,8
4051,31.8323504762314,4,3,203,0.019417475728155338,0.014563106796116505,0.9854368932038835,206,6600,4800,1800,0.7272727272727273,84,48,36,214.95545073943924,0.47409276580629883,0.7952192981741322,0.121835358711212,1035018.7930231986,-3303.4137643816803,1031715.379258817,3853,0,495.4271844660194,72,134,38,39.50989032510772,0.5240190129449838,44.99143835616438,8117.521908686224,112.74335984286422,0
4052,31.81602971849413,2,3,202,0.00975609756097561,0.014634146341463415,0.9853658536585366,205,6750,4900,1850,0.725925925925926,86,49,37,212.24524358010254,0.4743683245655986,0.7922608479907056,0.12102918248886906,1036362.0773631298,-3757.415690576279,1032604.6616725535,3854,0,497.81463414634146,66,139,41,39.34323668554953,0.526930894308943,44.76057213930348,8120.705222147348,123.04098821435376,0
4053,31.77441721313689,2,2,202,0.00980392156862745,0.00980392156862745,0.9901960784313726,204,7500,5400,2100,0.72,96,54,42,204.23987661492833,0.47435123474677227,0.7802223153316261,0.11859186927227337,1040569.8884516715,-5794.826874683856,1034775.0615769876,3855,0,501.078431372549,79,125,34,38.848522428559335,0.5360498366013071,44.075520833333364,8131.851176096503,102.93482501387979,8
4054,31.815964207690392,2,2,202,0.00980392156862745,0.00980392156862745,0.9901960784313726,204,7650,5800,1850,0.7581699346405228,95,58,37,204.06081772726043,0.47393468881805595,0.7814734531241352,0.11948215171826648,1044482.8212398263,-5822.396279144978,1038660.4249606812,3856,0,502.02941176470586,84,120,39,38.533446522231266,0.5390114379084967,43.762254901960794,8152.450926698533,97.05298722260159,0
4055,32.025141408590294,1,2,201,0.0049261083743842365,0.009852216748768473,0.9901477832512315,203,7200,5700,1500,0.7916666666666666,87,57,30,206.43917416631655,0.4739936432066852,0.7827253817206496,0.12179708020964483,1053676.5407168355,-4295.977019199032,1049380.5636976366,3857,0,505.32512315270935,72,131,40,38.183280488031045,0.5407430213464697,43.47888127853882,8215.125101344589,114.09895974089707,0
4056,31.872078620366377,0,2,199,0.0,0.009950248756218905,0.9900497512437811,201,6650,4900,1750,0.7368421052631579,84,49,35,209.1760510649193,0.47386608623548926,0.782572367036154,0.12398947324508805,1050058.1047465976,-2920.5984520786005,1047137.506294519,3858,1,510.0547263681592,74,127,38,37.93612253363635,0.5428067993366501,43.305555555555564,8181.385514744618,110.55926371276512,0
4057,31.594320197480528,3,4,198,0.01485148514851485,0.019801980198019802,0.9801980198019802,202,6800,4600,2200,0.6764705882352942,90,46,44,205.0781058299525,0.47404427942794275,0.7799977530806108,0.122717395792334,1043746.1259917788,-4390.104302850894,1039356.0216889279,3859,0,504.3069306930693,79,123,34,37.68431394897251,0.5458436468646864,42.95572916666667,8121.138997636252,102.7992278181804,0
4058,31.943904720599914,0,2,196,0.0,0.010101010101010102,0.98989898989899,198,6450,4400,2050,0.6821705426356589,85,44,41,211.7758520557659,0.47330699123211817,0.78261665608533,0.12722454987273243,1056481.9051890308,-1302.5288694188139,1055179.376319612,3860,1,514.5555555555555,80,118,37,37.36457656216145,0.5481376262626263,42.81121399176955,8215.614075453675,102.69517594317094,0
4059,31.48454081628794,1,2,195,0.005076142131979695,0.01015228426395939,0.9898477157360406,197,6250,4700,1550,0.752,78,47,31,213.30147141428608,0.4731236403190718,0.7838526538196731,0.12887826767976454,1042991.4093972954,-1155.6795406193482,1041835.7298566761,3861,0,518.0406091370559,67,130,38,37.11074659287032,0.5499153976311337,42.60110294117647,8104.086080516032,120.95650866441838,0
4060,31.532278252541914,1,0,196,0.00510204081632653,0.0,1.0,196,5900,4200,1700,0.711864406779661,76,42,34,215.14738326537855,0.47262558869701726,0.7846870592794875,0.1305809144749423,1045908.4531043713,-95.10663589083197,1045813.3464684805,3862,0,521.6020408163265,68,128,40,36.89518492468202,0.5514455782312926,42.436594202898554,8121.56097926658,119.43472028333206,0
4061,31.30570327708231,3,3,196,0.01507537688442211,0.01507537688442211,0.9849246231155779,199,7000,5000,2000,0.7142857142857143,90,50,40,204.86768521738696,0.47312847909581573,0.7679241969920811,0.12295892461684846,1035097.0337762933,-4388.413342973031,1030708.6204333203,3863,0,514.7236180904523,90,109,40,37.57743526967884,0.5550146566164154,42.845695970696,8050.396338366079,89.44884820406754,8
4062,31.24723861494286,1,3,194,0.005076142131979695,0.015228426395939087,0.9847715736040609,197,6000,4300,1700,0.7166666666666667,77,43,34,210.90971987403222,0.47181467764770885,0.7732415296672046,0.12504362594241036,1029535.145541025,-1972.2061706943541,1027562.9393703307,3864,0,520.4720812182741,75,122,42,37.88359629451653,0.5474302030456852,43.29769736842105,8021.238103334207,106.94984137778943,8
4063,31.34478839240732,2,3,193,0.01020408163265306,0.015306122448979591,0.9846938775510204,196,6850,5100,1750,0.7445255474452555,86,51,35,211.12893931213088,0.4710938862724577,0.7719510790462925,0.12614662866932663,1035052.4941000711,-2344.0929576552053,1032708.4011424159,3865,0,524.0255102040817,78,118,36,37.58583461604242,0.5502763605442177,43.01160337552743,8055.246911498142,103.27239630125824,0
4064,31.69512587812905,2,1,194,0.010256410256410256,0.005128205128205128,0.9948717948717949,195,6550,5200,1350,0.7938931297709924,79,52,27,206.5114080445782,0.47089280993920174,0.7746909570793774,0.11830066148891256,1033834.3843926582,-2850.2811188346077,1030984.1032738236,3866,0,527.374358974359,70,125,38,39.31168265456565,0.535042735042735,44.58626760563379,8095.370399242183,115.64814856060262,8
4065,32.0646290719733,2,2,194,0.01020408163265306,0.01020408163265306,0.9897959183673469,196,5300,3800,1500,0.7169811320754716,68,38,30,205.24348531565562,0.47126613465899175,0.7742401705810598,0.11851408627603927,1048356.3710034881,-1466.3369124743353,1046890.0340910137,3867,0,506.4948979591837,73,123,41,39.03652427612022,0.5374149659863945,44.284909909909906,8199.409511844962,112.32067824445154,0
4066,32.24303711699316,5,4,195,0.02512562814070352,0.020100502512562814,0.9798994974874372,199,5450,3500,1950,0.6422018348623854,74,35,39,208.63956520077892,0.4718447033145525,0.7816686080740012,0.12203515613417287,1058179.430565454,-1094.3807404830509,1057085.049824971,3868,0,498.39195979899495,80,119,39,38.45612471974032,0.5407768006700168,43.80144032921812,8260.619668785233,103.25774585981542,0
4067,32.00247225202105,2,2,195,0.01015228426395939,0.01015228426395939,0.9898477157360406,197,5450,3400,2050,0.6238532110091743,75,34,41,220.56382343342966,0.47185568389792465,0.7895542315879625,0.12311249424331377,1035746.0168243577,839.6203153453525,1036585.637139703,3869,0,504.33502538071065,65,132,41,39.969241108354,0.5226311336717429,45.5808080808081,8142.043129775596,125.26220199654763,8
4068,31.725429597044812,5,1,199,0.025,0.005,0.995,200,6750,5100,1650,0.7555555555555555,84,51,33,224.0170156604301,0.4722974246231156,0.7965811011904751,0.12544952876984145,1027799.0414910438,-701.1052053049398,1027097.9362857388,3870,0,497.535,65,135,43,39.75229414682543,0.5184895833333334,45.454545454545475,8075.56389742963,124.23944457584047,8
4069,31.642546523708514,2,1,200,0.009950248756218905,0.004975124378109453,0.9950248756218906,201,6450,4500,1950,0.6976744186046512,84,45,39,223.71476047953558,0.47299233001658375,0.7969057627402489,0.12619515227457107,1027369.6941950031,-682.446987845844,1026687.2472071573,3871,0,492.0845771144279,67,134,39,39.473812744214,0.5209369817578773,45.1746323529412,8063.323551193245,120.34811270437679,0
4070,31.362704222054134,4,3,201,0.0196078431372549,0.014705882352941176,0.9852941176470589,204,5700,4200,1500,0.7368421052631579,72,42,30,214.14098960802852,0.47323239640683856,0.7897416945783706,0.1218807286055111,1021021.9325092578,-2771.4705921930954,1018250.4619170647,3872,0,485.828431372549,76,128,40,39.36806365532107,0.5278799019607843,44.832251082251084,8002.750636314742,105.29935047782556,8
4071,31.34849802958255,1,2,200,0.0049504950495049506,0.009900990099009901,0.9900990099009901,202,7750,5800,1950,0.7483870967741936,97,58,39,213.87556368334685,0.4729144089782113,0.7885017089028155,0.12246759984161051,1022399.9005684479,-4416.7289912251135,1017983.1715772228,3873,0,491.48514851485146,65,137,41,39.1399394388827,0.5301670792079207,44.60227272727272,8006.335150168936,123.17438692567593,0
4072,31.790242528797204,2,4,198,0.009900990099009901,0.019801980198019802,0.9801980198019802,202,5900,4200,1700,0.711864406779661,76,42,34,209.4997742250947,0.47274354301101756,0.7829571050655733,0.12065476793126884,1038579.4319351809,-2783.5686989505266,1035795.8632362303,3874,0,492.23762376237624,68,134,44,39.028909756673734,0.5323844884488449,44.38405797101449,8126.092791328418,119.50136457835909,0
4073,31.3552513947478,3,1,200,0.014925373134328358,0.004975124378109453,0.9950248756218906,201,7000,4900,2100,0.7,91,49,42,193.59462045747443,0.4719050580431177,0.7663198582841704,0.11218013537109667,1026222.9049141231,-7465.753243676405,1018757.1516704467,3875,0,495.4228855721393,74,127,43,39.19971318965675,0.5349295190713101,44.15277777777781,8022.15397142575,108.40748610034797,8
4074,31.112819873101323,5,3,202,0.024390243902439025,0.014634146341463415,0.9853658536585366,205,6450,5000,1450,0.7751937984496124,79,50,29,203.0518376587189,0.4733122110632871,0.7758643555873914,0.11828649826153705,1019877.2576378025,-6032.409730061447,1013844.8479077411,3876,0,486.7268292682927,81,124,40,38.75417576238672,0.5384654471544715,43.95325203252036,7966.336348605659,98.3498314642674,8
4075,31.031602878745268,2,0,204,0.00980392156862745,0.0,1.0,204,5250,3600,1650,0.6857142857142857,69,36,33,200.89137347967755,0.4733762757976754,0.7726648820661313,0.11804081112919032,1019777.4239474154,-5077.102531927531,1014700.3214154879,3877,0,489.72058823529414,69,135,41,38.48071937156566,0.5409517973856209,43.63095238095235,7955.542476116359,115.29771704516462,0
4076,31.42532344676634,2,0,206,0.009708737864077669,0.0,1.0,206,7900,5600,2300,0.7088607594936709,102,56,46,196.14026244985683,0.4735412226695082,0.7705793307462987,0.11634969868816193,1035563.3876406258,-8476.865072941284,1027086.5225676845,3878,0,485.95631067961165,74,132,42,38.24242137344009,0.5435376213592233,43.27777777777775,8067.578869305892,109.02133607170124,0
4077,31.64259736087211,2,2,206,0.009615384615384616,0.009615384615384616,0.9903846153846154,208,5850,4200,1650,0.717948717948718,75,42,33,195.0518380349518,0.473607530502911,0.772310420005516,0.11669762905373617,1045289.4101115814,-6672.8758558533555,1038616.5342557281,3879,0,482.27403846153845,77,131,40,37.94850063213312,0.5459234775641026,42.962072649572626,8133.347641622613,105.62789144964432,0
4078,31.83318415215325,1,0,207,0.004830917874396135,0.0,1.0,207,6700,4800,1900,0.7164179104477612,86,48,38,200.38853656983136,0.47337523255632163,0.7780371461939499,0.12059483410177158,1053346.542011895,-5884.285589069059,1047462.256422826,3880,0,484.64251207729467,80,127,43,37.59185662867427,0.5478059581320451,42.7469135802469,8189.184873709752,102.3648109213719,0
4079,32.26677060054377,1,3,205,0.004807692307692308,0.014423076923076924,0.9855769230769231,208,6400,4000,2400,0.625,88,40,48,199.53133421478395,0.4732910821565713,0.7786248265130158,0.12076201531397776,1069416.8218432288,-5323.566941177265,1064093.2549020515,3881,0,483.3076923076923,73,135,42,37.40226899945324,0.549629407051282,42.53941441441442,8307.421653771784,113.80029662701074,0
4080,31.880091472686544,1,2,204,0.0048543689320388345,0.009708737864077669,0.9902912621359223,206,7500,5400,2100,0.72,96,54,42,201.38470137552792,0.4735397426789802,0.7795253649383731,0.12213007696322356,1057205.8106686375,-6118.984705204671,1051086.825963433,3882,0,487.99029126213594,72,134,42,37.27940769060285,0.5505663430420712,42.465753424657535,8210.215338171334,114.03076858571298,0
4081,31.80717238146364,2,1,205,0.009708737864077669,0.0048543689320388345,0.9951456310679612,206,6700,4700,2000,0.7014925373134329,87,47,40,198.73551890794613,0.47293590654353146,0.777343989940779,0.12140358477231437,1056955.8070545292,-5889.067844450219,1051066.739210079,3883,0,488.09708737864077,75,131,42,37.07782843319684,0.5541059870550162,42.20120614035088,8199.85067602727,109.33134234703027,0
4082,31.592943207224945,2,2,205,0.00966183574879227,0.00966183574879227,0.9903381642512077,207,6250,4600,1650,0.736,79,46,33,213.55513469708333,0.4731026140112253,0.7925355920362702,0.1274606334269261,1042928.7362961632,-3105.4426481630626,1039823.2936480001,3884,0,486.67632850241546,72,135,40,37.563516965624466,0.5413647342995169,43.05079908675797,8117.781511593837,112.7469654388033,8
4083,32.07039590687731,2,0,207,0.00966183574879227,0.0,1.0,207,7150,5300,1850,0.7412587412587412,90,53,37,218.71134804380742,0.47298731297781527,0.798444078784587,0.13181704647534906,1061644.3323021047,-2111.2673878277965,1059533.0649142768,3885,0,487.52657004830917,65,142,44,37.0649445909751,0.5438305152979066,42.692550505050505,8251.951775091868,126.95310423218258,0
4084,31.682096506470405,0,0,207,0.0,0.0,1.0,207,5700,4000,1700,0.7017543859649122,74,40,34,221.76118671805148,0.47299903850663666,0.8009479779174713,0.1341096322015155,1049802.498165437,-538.9104374515473,1049263.5877279856,3886,1,488.52657004830917,66,141,41,36.85957442525266,0.544987922705314,42.568407960199,8155.9725428192905,123.57534155786804,0
4085,31.248478513690163,0,1,206,0.0,0.004830917874396135,0.9951690821256038,207,6800,4800,2000,0.7058823529411765,88,48,40,220.55013677783296,0.4728993715116552,0.8003183669374363,0.13371861147833164,1036184.8851664702,-2493.8563698824532,1033691.0287965877,3887,2,489.52657004830917,66,141,42,36.79540972389923,0.5463466183574879,42.47512437810945,8047.26054261137,121.9281900395662,0
4086,31.554346975470036,1,0,207,0.004830917874396135,0.0,1.0,207,7550,5800,1750,0.7682119205298014,93,58,35,218.06982716245727,0.4724743210918812,0.7987752796605514,0.1333775919621542,1048915.1412659981,-3202.6512872077874,1045712.4899787903,3888,0,490.4492753623188,67,140,43,36.53408190747784,0.5488123993558776,42.156862745098046,8136.071818184929,121.43390773410341,0
4087,31.362076007445737,1,2,206,0.004807692307692308,0.009615384615384616,0.9903846153846154,208,6700,5100,1600,0.7611940298507462,83,51,32,215.20888220992697,0.47238286572525706,0.7959354690552476,0.13241396453875387,1044265.6030011991,-3352.9533695672953,1040912.6496316318,3889,0,489.08653846153845,71,137,37,36.38790388892006,0.55078125,41.94155092592593,8093.248694224688,113.98941822851673,0
4088,31.654558168295527,0,2,204,0.0,0.009708737864077669,0.9902912621359223,206,6200,4500,1700,0.7258064516129032,79,45,34,217.22686687011046,0.471801247138685,0.7959619720531725,0.13414685765009518,1055084.5074486448,-1561.4596327473164,1053523.0478158975,3890,2,494.25728155339806,72,134,41,36.200766368225246,0.5526901294498382,41.80936073059362,8172.910609262853,113.51264735087295,0
4089,31.644195158839388,0,3,201,0.0,0.014705882352941176,0.9852941176470589,204,6550,4600,1950,0.7022900763358778,85,46,39,216.60797186448391,0.4712648708908851,0.7913958657426201,0.13459287754600405,1056550.464012545,-1578.549363552469,1054971.9146489927,3891,3,498.84313725490193,65,139,39,35.990337242207715,0.5543811274509804,41.58775252525254,8177.247590525239,125.80380908500366,0
4090,31.8057360964389,1,0,202,0.0049504950495049506,0.0,1.0,202,5550,3800,1750,0.6846846846846847,73,38,35,215.5152080305388,0.4706197765298918,0.7890699886738759,0.1344466922298665,1063111.8559835583,-126.64543959411094,1062985.2105439643,3892,0,504.56435643564356,65,137,46,35.873468847922496,0.5557446369636964,41.44570707070708,8223.50960751047,126.515532423238,0
4091,32.09792098384114,1,1,202,0.0049261083743842365,0.0049261083743842365,0.9950738916256158,203,6000,4200,1800,0.7,78,42,36,212.72405338900333,0.4704138825212571,0.7877551686818924,0.13371226213023085,1075113.754752881,-859.4888469391799,1074254.2659059416,3893,0,503.0738916256158,67,136,44,35.67067155934343,0.5578304597701149,41.1764705882353,8307.697195817716,123.99548053459279,0
4092,32.213112687159665,0,1,201,0.0,0.0049504950495049506,0.995049504950495,202,5900,4200,1700,0.711864406779661,76,42,34,212.4295335974814,0.47006612974730305,0.7865769733161394,0.1338474847899681,1079681.3231281668,-428.76001879438536,1079252.5631093725,3894,1,506.4950495049505,66,136,45,35.59143497668087,0.5588902640264026,41.09141791044776,8340.251330523473,126.36744440187081,0
4093,32.37967201400006,0,1,200,0.0,0.004975124378109453,0.9950248756218906,201,6150,4000,2150,0.6504065040650406,83,40,43,221.26668458299747,0.46975953565505807,0.7905310948850799,0.13862058780091563,1083560.8209761137,1601.1820802831226,1085162.0030563967,3895,2,509.87064676616916,69,132,38,35.57035519125682,0.5621372305140961,41.294642857142854,8376.794612550455,121.40282047174573,8
4094,31.990553990208078,1,1,200,0.004975124378109453,0.004975124378109453,0.9950248756218906,201,7200,5000,2200,0.6944444444444444,94,50,44,223.55657179039076,0.46977819237147594,0.7905437811219498,0.14078399451555207,1072066.6351558287,533.5083372592026,1072600.143493088,3896,0,510.771144278607,72,129,43,35.32250730309209,0.564262023217247,41.110159817351594,8282.029409879344,115.02818624832422,0
4095,31.507197608576156,1,1,200,0.004975124378109453,0.004975124378109453,0.9950248756218906,201,5950,4600,1350,0.773109243697479,73,46,27,222.85489187806394,0.4697647180762852,0.7913691702322989,0.14103925137977605,1057300.2253562699,974.9054808847641,1058275.1308371546,3897,0,511.13432835820896,73,128,34,35.16128740128956,0.56643864013267,40.93468468468468,8162.422083167726,111.81400113928392,0
4096,31.517554171815156,0,1,199,0.0,0.005,0.995,200,6700,5000,1700,0.746268656716418,84,50,34,244.8945690226023,0.46923994974874367,0.811971257975765,0.15000121630021956,1048117.9204925735,4635.677284779148,1052753.5977773527,3898,1,514.685,68,132,38,35.78874709750435,0.5552083333333333,42.10446859903382,8128.236381599024,119.53288796469153,8
4097,31.959118086087678,2,2,199,0.009950248756218905,0.009950248756218905,0.9900497512437811,201,5800,4400,1400,0.7586206896551724,72,44,28,244.03657754294437,0.4691728855721393,0.8128129316990269,0.15063413096692668,1065100.1268325697,5984.677938555367,1071084.804771125,3899,0,511.2437810945274,71,130,36,35.525415615952184,0.5573175787728026,41.82581018518519,8251.019419071697,116.21154111368588,0
4098,31.501975008172867,2,4,197,0.009950248756218905,0.01990049751243781,0.9800995024875622,201,7250,5400,1850,0.7448275862068966,91,54,37,236.32914364027326,0.4690630182421227,0.8071932528791799,0.1470574765285094,1052219.5559741436,2284.029316983902,1054503.5852911274,3900,0,511.9651741293532,63,138,39,35.42821158690176,0.5598569651741294,41.53645833333336,8142.112030107229,129.23987349376554,0
4099,31.448398640500937,0,1,196,0.0,0.005076142131979695,0.9949238578680203,197,6000,4300,1700,0.7166666666666667,77,43,34,235.58767281980766,0.4683226717082772,0.8030872656738739,0.14731303570859708,1051847.0763004594,4160.440973588958,1056007.5172740484,3901,1,522.4822335025381,64,133,40,35.26899126339923,0.561442470389171,41.3621794871795,8133.745282997543,127.0897700468366,0
4100,31.67864099375111,0,2,194,0.0,0.01020408163265306,0.9897959183673469,196,6650,4400,2250,0.6616541353383458,89,44,45,234.62889489394817,0.4677366780045351,0.8007310697918493,0.14738236167564775,1060875.0988102166,3932.390410869869,1064807.4892210865,3902,2,525.0663265306123,66,130,40,35.12805879290322,0.5637223639455782,41.20024875621891,8198.424408923842,124.21855165036123,0
4101,31.535228115993657,0,1,193,0.0,0.005154639175257732,0.9948453608247423,194,6550,4400,2150,0.6717557251908397,87,44,43,233.92786365437945,0.4672165171020066,0.7971205119089935,0.14747626186906548,1057123.9973513512,4108.151663635985,1061232.1490149873,3903,3,530.7268041237113,69,125,42,35.01436781609196,0.5663122852233677,41.07142857142858,8165.371565748368,118.33871834417924,0
4102,31.3699878517968,0,4,189,0.0,0.02072538860103627,0.9792746113989638,193,5900,4400,1500,0.7457627118644068,74,44,30,237.23972142850062,0.4672410225964306,0.7960374498937584,0.14453918550315567,1041645.6417430398,4923.944374866316,1046569.5861179061,3904,4,532.1917098445596,65,128,42,36.18426424955088,0.5514356649395509,42.297979797979814,8084.109243120897,124.37091143262919,8
4103,31.3506291856677,1,2,188,0.005263157894736842,0.010526315789473684,0.9894736842105263,190,6350,4400,1950,0.6929133858267716,83,44,39,231.31577875159803,0.46695674371112966,0.7877509162021483,0.14209872965006612,1043421.4092545762,3921.967169562833,1047343.376424139,3905,0,533.7105263157895,68,122,39,36.030817242051896,0.5544956140350877,41.99879227053143,8088.500192981058,118.94853224972144,0
4104,31.15321956632296,0,1,187,0.0,0.005319148936170213,0.9946808510638298,188,5600,4400,1200,0.7857142857142857,68,44,24,245.20037655464344,0.4668602087837069,0.8006302997266863,0.14233208793335306,1020134.893980557,6827.492028113147,1026962.3860086701,3906,1,539.7925531914893,67,121,33,37.81201364779124,0.5328568262411347,44.087009803921596,7972.513573452744,118.99273990227977,8
4105,31.021811354810204,3,1,189,0.015789473684210527,0.005263157894736842,0.9947368421052631,190,5550,4100,1450,0.7387387387387387,70,41,29,223.56429645578368,0.46822438039543307,0.7870390172656627,0.12602032129825969,1006999.1813946408,1475.8127040084,1008474.9940986492,3907,0,534.9421052631579,65,125,37,39.50564709283119,0.5248355263157894,45.202020202020186,7904.294862879638,121.60453635199443,7
4106,31.037593238132086,4,3,190,0.02072538860103627,0.015544041450777202,0.9844559585492227,193,5850,4300,1550,0.7350427350427351,74,43,31,217.43221379264668,0.4693763043321819,0.7843873786213218,0.12370776564681855,1010325.0742738455,-514.5564900836544,1009810.5177837618,3908,0,527.0259067357513,75,118,42,39.298632001146004,0.5280656303972366,44.84649122807017,7919.350818545312,105.59134424727083,0
4107,30.694615329011956,5,1,194,0.02564102564102564,0.005128205128205128,0.9948717948717949,195,5850,3900,1950,0.6666666666666666,78,39,39,227.29362831223781,0.4705998325843687,0.7932663902963302,0.1316159359505676,1004395.7126602043,808.5491583587709,1005204.261818563,3909,0,519.374358974359,67,128,34,38.3642714570858,0.5326923076923077,44.178921568627445,7852.329595503968,117.1989491866264,0
4108,30.48955528985637,2,1,195,0.01020408163265306,0.00510204081632653,0.9948979591836735,196,6300,4700,1600,0.746031746031746,79,47,32,215.70080697576057,0.47116365777080066,0.7829860220837002,0.12114499211605491,988632.4218001101,-2850.237763063131,985782.184037047,3910,0,517.7142857142857,69,127,42,39.84927394378541,0.5238095238095238,45.342261904761905,7764.401185644528,112.52755341513809,7
4109,30.744319684694922,1,3,193,0.00510204081632653,0.015306122448979591,0.9846938775510204,196,6550,4800,1750,0.732824427480916,83,48,35,216.10948914050329,0.47129175388103955,0.7834139181488511,0.1220965904012347,998677.7346732869,-2585.252988752116,996092.4816845348,3911,0,518.6989795918367,70,126,40,39.60611773057807,0.5256696428571428,45.11443661971831,7836.283243576957,111.94690347967081,0
4110,30.613136392382604,1,0,194,0.005154639175257732,0.0,1.0,194,6900,5100,1800,0.7391304347826086,87,51,36,226.16279627319398,0.47126388814700065,0.7913742816714318,0.12345583833261455,984031.3922655728,-1189.7417409229447,982841.6505246499,3912,0,523.1546391752578,65,129,39,40.71448023653908,0.5101481958762887,46.44886363636362,7761.995519943565,119.41531569143946,8
4111,30.919969913512222,3,2,195,0.015228426395939087,0.01015228426395939,0.9898477157360406,197,5850,3900,1950,0.6666666666666666,78,39,39,219.79530833574876,0.4720391329120481,0.7878119344609935,0.12071538192941986,995771.796312875,-1476.8061994742875,994294.9901134007,3913,0,516.1725888324873,71,126,39,40.6312944172082,0.5123202199661591,46.209490740740705,7847.19491063116,110.52387198072057,0
4112,31.44955551184545,1,2,194,0.00510204081632653,0.01020408163265306,0.9897959183673469,196,7150,5500,1650,0.7692307692307693,88,55,33,221.63121074487273,0.4723699415663702,0.7893133124563512,0.12252515321126657,1014871.0415393558,-1364.580462744836,1013506.461076611,3914,0,517.5561224489796,77,119,41,40.323062871261094,0.5150403911564626,45.953525641025614,7989.648697941118,103.7616714018327,0
4113,31.44767479016676,4,1,197,0.020202020202020204,0.005050505050505051,0.9949494949494949,198,6550,5200,1350,0.7938931297709924,79,52,27,215.61848883596093,0.4731499641080859,0.7875181738045347,0.12066430020058949,1018590.7970315064,-2224.598320369892,1016366.1987111366,3915,0,513.0050505050505,64,134,41,39.992864038953904,0.5184659090909092,45.480769230769226,8004.037997074172,125.06309370428394,0
4114,31.06285999925256,4,1,200,0.01990049751243781,0.004975124378109453,0.9950248756218906,201,6750,5600,1150,0.8296296296296296,79,56,23,206.26240258127012,0.47384535655058047,0.7815040384766183,0.11660973452861931,1009224.1247823986,-5317.001455880435,1003907.1233265181,3916,0,505.8457711442786,69,132,38,39.83143607705779,0.5217143449419569,45.08928571428572,7918.25583016663,114.75733087198014,0
4115,30.877007900705703,1,2,199,0.004975124378109453,0.009950248756218905,0.9900497512437811,201,5750,4100,1650,0.7130434782608696,74,41,33,207.19216998626476,0.47390132669983415,0.782841689917021,0.11769369655920815,1004617.8921963037,-4320.207781764065,1000297.6844145396,3917,0,506.8407960199005,71,130,42,39.622088626739256,0.523528192371476,44.907407407407405,7876.49599689298,110.93656333652085,0
4116,30.52389536000865,1,0,200,0.005,0.0,1.0,200,6000,4100,1900,0.6833333333333333,79,41,38,209.25168522591594,0.47411641541038524,0.7841857753595036,0.11938017429851,994416.8361679481,-4383.32024296682,990033.5159249812,3918,0,509.175,62,138,43,39.40074815390597,0.5255208333333333,44.74206349206348,7791.466543779959,125.6688152222574,0
4117,31.06244654367788,1,1,200,0.004975124378109453,0.004975124378109453,0.9950248756218906,201,5150,3400,1750,0.6601941747572816,69,34,35,206.1147437277259,0.47448279436152574,0.7826696559247333,0.1183463513912886,1013892.4719436934,-3554.3625955712005,1010338.1093481221,3919,0,507.636815920398,63,138,43,39.23243937656601,0.527363184079602,44.49869791666665,7936.4955378036075,125.97611964767631,0
4118,31.331260407859478,3,4,199,0.014778325123152709,0.019704433497536946,0.9802955665024631,203,7100,5200,1900,0.7323943661971831,90,52,38,196.74399961890063,0.4752312669690614,0.7742279549850029,0.11397166943997653,1025349.2514006034,-7353.737454640004,1017995.5139459635,3920,0,503.3546798029557,72,131,41,39.13038931340287,0.5303776683087028,44.16381278538813,8015.6702033749,111.32875282465139,0
4119,31.30128254256399,1,1,199,0.005,0.005,0.995,200,5650,4200,1450,0.7433628318584071,71,42,29,185.33271415372514,0.4746021775544389,0.7529390648837841,0.10531169983758026,1018523.6992625775,-7896.847677154975,1010626.8515854225,3921,0,511.275,90,110,40,40.16675266983753,0.5355208333333333,44.89468864468863,7985.123428841314,88.72359365379238,8
4120,31.48234711247482,2,1,200,0.009950248756218905,0.004975124378109453,0.9950248756218906,201,5550,4000,1550,0.7207207207207207,71,40,31,217.36003827166786,0.47481032338308454,0.7901795715139495,0.1234063089916382,1024156.3554288665,-1227.8670775617802,1022928.4883513047,3922,0,509.6517412935323,76,125,41,39.38267921859808,0.5310945273631841,44.92694805194806,8030.298360466912,105.66182053245936,8
4121,31.93717470794553,3,1,202,0.014778325123152709,0.0049261083743842365,0.9950738916256158,203,5400,3800,1600,0.7037037037037037,70,38,32,212.00556113488327,0.4754040059178332,0.7868886963352502,0.12153703312791826,1041956.4172900678,-1819.8890148652627,1040136.5282752025,3923,0,505.5024630541872,66,137,43,39.14295496043821,0.5337643678160919,44.55845771144279,8158.081163736721,123.60729035964728,0
4122,32.133358310668925,0,2,200,0.0,0.009900990099009901,0.9900990099009901,202,6800,4800,2000,0.7058823529411765,88,48,40,211.1516422495268,0.4753368060686665,0.784640012914334,0.12141219429347844,1049292.9966878982,-2888.012109684406,1046404.9845782138,3924,1,503.990099009901,68,134,43,39.04834692028986,0.5356848184818481,44.444444444444464,8211.858234948768,120.76262110218777,0
4123,32.587737892157364,4,3,201,0.0196078431372549,0.014705882352941176,0.9852941176470589,204,6750,5300,1450,0.7851851851851852,82,53,29,205.22157928747632,0.4759349141955633,0.777908585415169,0.11909315270462316,1067024.0766749494,-3754.726769400655,1063269.3499055486,3925,0,499.86764705882354,74,130,38,38.845545002261446,0.5389093137254901,44.09722222222226,8339.292648097298,112.69314389320674,0
4124,32.07611936641481,2,3,200,0.009852216748768473,0.014778325123152709,0.9852216748768473,203,6400,4800,1600,0.75,80,48,32,206.83580761515134,0.47537047423954215,0.7800542288573149,0.12087704802452079,1052439.3059933125,-3463.573235788389,1048975.7327575241,3926,0,502.8472906403941,74,129,42,38.53488939492519,0.5406403940886699,43.83333333333336,8216.83257769665,111.03827807698175,0
4125,31.78032671585018,1,1,200,0.004975124378109453,0.004975124378109453,0.9950248756218906,201,7150,5300,1850,0.7412587412587412,90,53,37,208.4607540774588,0.47456985903814264,0.7808260419947313,0.12260822953799752,1044679.1878312175,-3795.077747135396,1040884.1100840821,3927,0,508.7164179104478,66,135,39,38.249479545638266,0.5425995024875622,43.59452736318408,8148.649692129991,123.46438927469684,0
4126,31.40867056975138,2,2,200,0.009900990099009901,0.009900990099009901,0.9900990099009901,202,6500,4900,1600,0.7538461538461538,81,49,32,203.68970260247147,0.47442706024333775,0.7724960747427778,0.1181015634722856,1028155.0899722088,-5015.0790988686385,1023140.0108733402,3928,0,507.15346534653463,84,118,35,38.918091543337006,0.541615099009901,44.129901960784316,8036.539617963718,95.67309069004426,8
4127,31.199184204361607,0,4,196,0.0,0.02,0.98,200,6150,4400,1750,0.7154471544715447,79,44,35,207.6294143902219,0.47439384422110553,0.7727602552837256,0.12065495370491139,1021968.0741421891,-3711.873448071079,1018256.200694118,3929,1,512.705,87,113,35,38.731568622916924,0.5433333333333333,44.04592803030302,7985.558239238971,91.78802573837898,0
4128,30.742634431897724,3,0,199,0.01507537688442211,0.0,1.0,199,5700,3700,2000,0.6491228070175439,77,37,40,204.9621542835573,0.47406751772329664,0.7712335210926016,0.1198313618299681,1008808.0286806852,-4146.506636611726,1004661.5220440734,3930,0,516.0201005025126,91,108,39,38.567171985031976,0.5453831658291457,43.817934782608695,7875.711578986839,86.54628108776747,0
4129,30.602875658179716,1,0,200,0.005,0.0,1.0,200,5400,4000,1400,0.7407407407407407,68,40,28,202.17730077593933,0.4739777010050252,0.770123997467284,0.1188481452948392,1005815.7248311393,-4729.378335128883,1001086.3464960104,3931,0,514.435,76,124,39,38.43119019980301,0.5471354166666667,43.614718614718626,7846.126886821215,103.2385116687002,0
4130,31.029833073394975,1,0,201,0.004975124378109453,0.0,1.0,201,6900,4600,2300,0.6666666666666666,92,46,46,198.36119522864018,0.4740464344941957,0.7680591512530186,0.11744961006764039,1021984.5243426628,-6555.585649242903,1015428.9386934199,3932,0,512.8706467661691,79,122,38,38.255341771937836,0.5493884742951907,43.346354166666686,7963.9197878866125,100.80911123907104,0
4131,31.284577049523076,0,3,198,0.0,0.014925373134328358,0.9850746268656716,201,6650,5200,1450,0.7819548872180451,81,52,29,208.40415162615116,0.4737582918739635,0.772825118514713,0.12229248388746061,1027693.000162075,-4014.9024338174977,1023678.0977282575,3933,1,513.8706467661691,74,127,35,38.33875191908246,0.5467454394693201,43.68055555555557,8018.845409013211,108.36277579747582,8
4132,31.20419151522838,0,0,198,0.0,0.0,1.0,198,6450,5000,1450,0.7751937984496124,79,50,29,209.75916595815843,0.4738069143208737,0.7721901129785904,0.12359325968676894,1026274.6667829963,-2995.896370322501,1023278.7704126738,3934,2,519.939393939394,74,124,38,38.1480378353009,0.5485585016835017,43.527777777777764,8003.008340558403,108.14876135889733,0
4133,31.574730504902533,3,3,198,0.014925373134328358,0.014925373134328358,0.9850746268656716,201,5350,3300,2050,0.616822429906542,74,33,41,206.7688674599016,0.4743936567164179,0.769467524833775,0.12277357077260703,1040777.9079191769,-2509.906140453091,1038268.0017787238,3935,0,513.1641791044776,81,120,40,37.932911141895886,0.550787728026534,43.241869918699194,8107.068762259806,100.08726866987415,0
4134,31.93838792545887,0,3,195,0.0,0.015151515151515152,0.9848484848484849,198,6450,4300,2150,0.6666666666666666,86,43,43,196.42337453830416,0.47407770599394966,0.7567693824238313,0.11674718148546766,1053067.7660201814,-4680.575156160003,1048387.1908640213,3936,1,521.4444444444445,85,113,40,38.16088667201237,0.5549242424242424,43.204941860465155,8201.620184201329,96.48964922589799,8
4135,32.42808821182378,2,2,195,0.01015228426395939,0.01015228426395939,0.9898477157360406,197,6100,4500,1600,0.7377049180327869,77,45,32,197.6533046803134,0.4734247125246038,0.7567524610845642,0.11803103019056564,1070657.9837268656,-3176.182266804348,1067481.8014600612,3937,0,524.9289340101523,86,111,34,37.95254403131117,0.5571594754653131,43.03160919540233,8332.99364466199,96.89527493793013,0
4136,32.483821836785076,1,2,194,0.00510204081632653,0.01020408163265306,0.9897959183673469,196,6300,4300,2000,0.6825396825396826,83,43,40,202.55517142881348,0.47313361241932667,0.7609580216462009,0.12162936894379409,1074197.8254844795,-1983.1350621062038,1072214.6904223734,3938,0,528.5663265306123,86,110,36,37.61891459875537,0.5589923469387755,42.82806513409964,8353.927313605265,97.13868969308447,0
4137,32.20701480744884,3,3,194,0.015228426395939087,0.015228426395939087,0.9847715736040609,197,6050,4100,1950,0.6776859504132231,80,41,39,200.34522309998604,0.473563917952968,0.7614706201808563,0.12108299344125947,1067007.421254116,-2696.0320279009375,1064311.3892262152,3939,0,526.7969543147208,79,118,39,37.43408240174005,0.561230964467005,42.59114583333331,8290.37077771421,104.94140224954695,0
4138,31.968912160920137,0,1,193,0.0,0.005154639175257732,0.9948453608247423,194,5300,3900,1400,0.7358490566037735,67,39,28,209.0989384320062,0.47322581147730713,0.7696989138539916,0.12330747107145619,1051681.0335325168,-118.92246385540602,1051562.1110686613,3940,1,533.1907216494845,73,121,40,38.13316320930742,0.5536404639175257,43.4966216216216,8200.13397235759,112.33060236106287,8
4139,31.827206963310818,3,5,191,0.015306122448979591,0.025510204081632654,0.9744897959183674,196,5650,4000,1650,0.7079646017699115,73,40,33,224.9213923607219,0.4732916884702599,0.7889716822676303,0.13165811168909752,1044763.0722906145,2147.9129813341788,1046910.9852719486,3941,0,528.7295918367347,89,107,38,38.01005812027584,0.5514455782312926,43.77314814814815,8154.985043446481,91.62904543198293,8
4140,32.28833410431507,1,0,192,0.005208333333333333,0.0,1.0,192,7050,5400,1650,0.7659574468085106,87,54,33,221.41965572042642,0.4728670147978476,0.7808400326620459,0.13075651791776657,1062621.23332598,1607.0455288508801,1064228.278854831,3942,0,537.5104166666666,74,118,38,37.76380016601705,0.5539822048611112,43.444444444444464,8283.75149409599,111.94258775805392,0
4141,31.940475200735936,1,4,189,0.0051813471502590676,0.02072538860103627,0.9792746113989638,193,6100,4400,1700,0.7213114754098361,78,44,34,234.95408442536967,0.4732207109959701,0.7843474194966868,0.13594562905630014,1044922.6925196829,4401.770903250802,1049324.4634229338,3943,0,535.720207253886,74,119,40,38.198403648802774,0.5437176165803108,44.208333333333336,8170.107385721581,110.40685656380515,8
4142,32.03241658439333,2,0,191,0.010471204188481676,0.0,1.0,191,5800,4000,1800,0.6896551724137931,76,40,36,243.08056540002784,0.47283342518600163,0.7902430821033064,0.14202484643688285,1050931.8155077181,7092.219982098914,1058024.0354898171,3944,0,541.2408376963351,78,113,34,37.61560371304543,0.5469568062827226,43.842299578059084,8205.350171215869,105.1967970668701,0
4143,31.708960983660074,1,3,189,0.005208333333333333,0.015625,0.984375,192,5350,4200,1150,0.7850467289719626,65,42,23,228.44730858473974,0.4730732348022106,0.7823405470781688,0.13203890859579576,1037020.3692073543,3630.902458594852,1040651.2716659491,3945,0,539.4166666666666,70,122,42,38.4062595609607,0.5431857638888888,44.24882629107983,8109.603988661459,115.85148555230656,8
4144,31.394056763321405,2,2,189,0.010471204188481676,0.010471204188481676,0.9895287958115183,191,4800,3300,1500,0.6875,63,33,30,224.9430883682423,0.4725670524478736,0.7786567138389235,0.13057041336317557,1028014.6310975541,3248.957201364754,1031263.5882989189,3946,0,542.4031413612565,73,118,33,38.331270627062736,0.5452116055846422,44.08783783783785,8034.120945343262,110.05645130607208,0
4145,31.785896563814642,2,0,191,0.010471204188481676,0.0,1.0,191,6650,5100,1550,0.7669172932330827,82,51,31,229.772430779311,0.4730584642233857,0.7849649010919311,0.13443497270711724,1043265.0098854344,3092.7074536758228,1046357.7173391102,3947,0,543.2722513089005,76,115,38,37.9035983948466,0.5477203315881327,43.790584415584426,8143.845982441661,107.15586819002186,0
4146,31.65260823830331,2,1,192,0.010362694300518135,0.0051813471502590676,0.9948186528497409,193,5650,3900,1750,0.6902654867256637,74,39,35,227.96403105243934,0.4732476971790443,0.7861283839625255,0.13438962135950458,1041179.5203215212,3220.2961003475184,1044399.8164218687,3948,0,538.6321243523316,68,125,40,37.661369432999756,0.5500863557858376,43.50845410628017,8118.62641861066,119.39156497956853,0
4147,32.11376316432629,0,3,189,0.0,0.015625,0.984375,192,6100,4000,2100,0.6557377049180327,82,40,42,228.33618180242794,0.47279997909394994,0.7857308454847804,0.13567780548664043,1058766.524953269,3850.941145610561,1062617.4660988795,3949,1,542.3177083333334,73,119,41,37.3517615027592,0.55224609375,43.215090090090065,8246.329781019649,112.96342165780341,0
4148,31.842060726929674,2,1,190,0.010471204188481676,0.005235602094240838,0.9947643979057592,191,5750,4000,1750,0.6956521739130435,75,40,35,254.13346087540543,0.4724510884541196,0.8032581821285407,0.14629442337197085,1040134.0883150585,8916.575127598067,1049050.6634426566,3950,0,545.2198952879581,63,128,37,37.905416878926815,0.5385580279232112,44.401041666666664,8138.797552989963,129.18726274587243,8
4149,32.04484340851682,2,3,189,0.010416666666666666,0.015625,0.984375,192,5650,3900,1750,0.6902654867256637,74,39,35,256.9501195221529,0.47242332933391507,0.8061604364865678,0.14957879998515305,1050211.3145508114,9920.384559469694,1060131.6991102812,3951,0,543.1927083333334,67,125,35,37.40133678374121,0.5413411458333333,43.97977941176471,8204.127878163941,122.4496698233424,0
4150,32.22612024419381,1,0,190,0.005263157894736842,0.0,1.0,190,6150,4500,1650,0.7317073170731707,78,45,33,257.922441388061,0.47213113803026086,0.8049553668475915,0.15113680363012297,1058187.733799123,10436.072749674051,1068623.806548797,3952,0,549.478947368421,61,129,40,37.123503026726986,0.5438048245614036,43.73319892473119,8258.484746046523,135.38499583682824,0
4151,32.44064636471402,2,0,192,0.010416666666666666,0.0,1.0,192,4700,3100,1600,0.6595744680851063,63,31,32,256.10746213359727,0.47241253544938916,0.8032971687800612,0.15123660499065936,1067624.9952760595,11585.345610109316,1079210.3408861689,3953,0,544.7447916666666,64,128,41,36.874960959460324,0.5460611979166667,43.44551282051284,8322.793391870337,130.043646747974,0
4152,32.5003880972659,3,1,194,0.015384615384615385,0.005128205128205128,0.9948717948717949,195,5900,3800,2100,0.6440677966101694,80,38,42,214.55706353262153,0.47264296413780954,0.7797508883232598,0.12375357081432264,1062252.6219684938,682.7606598777852,1062935.3826283715,3954,0,537.348717948718,73,122,43,38.841497825249135,0.5431089743589743,44.327139639639654,8309.467187649816,113.82831763903857,8
4153,32.24914891576856,4,3,195,0.020202020202020204,0.015151515151515152,0.9848484848484849,198,5900,4000,1900,0.6779661016949152,78,40,38,215.73602805667431,0.47285994462390396,0.7865193466151275,0.12569390725570326,1057171.2328654483,113.98455083426552,1057285.2174162825,3955,0,530.1515151515151,78,120,37,38.42381602210896,0.5455597643097643,43.947784810126606,8257.466017870705,105.86494894706033,0
4154,32.29606209905381,4,0,199,0.020100502512562814,0.0,1.0,199,6200,4700,1500,0.7580645161290323,77,47,30,206.26518004140328,0.4730734903473597,0.7792927340666036,0.1179836829836832,1052969.027205922,-2561.8308050696014,1050407.1964008524,3956,0,527.4221105527638,69,130,43,39.37572843822846,0.5391541038525963,44.64285714285716,8247.030143151278,119.52217598769968,8
4155,32.35492711340836,2,1,200,0.009950248756218905,0.004975124378109453,0.9950248756218906,201,5700,3900,1800,0.6842105263157895,75,39,36,207.29372071093067,0.47314365671641795,0.7818162258359387,0.11945673836585519,1057217.327951353,-2069.09729777882,1055148.2306535742,3957,0,523.1641791044776,74,127,43,39.061877467492465,0.5413557213930349,44.361111111111136,8271.177617352758,111.77267050476699,0
4156,31.991717434221282,1,1,200,0.004975124378109453,0.004975124378109453,0.9950248756218906,201,6550,5000,1550,0.7633587786259542,81,50,31,205.2036741983255,0.4730669568822554,0.7802961916400359,0.11912505327665963,1047617.8444879712,-3754.9938310674484,1043862.8506569037,3958,0,523.9004975124378,77,124,39,38.832374454243485,0.5437396351575456,44.083867521367544,8187.1965971152,106.32722853396363,0
4157,32.168189372146905,3,0,203,0.014778325123152709,0.0,1.0,203,7100,4800,2300,0.676056338028169,94,48,46,199.91851692011576,0.472996837861126,0.7778208311437373,0.11743699413950073,1057044.292609149,-5435.4545405412555,1051608.8380686077,3959,0,519.7044334975369,66,137,43,38.51608142802276,0.5466954022988506,43.641169154228855,8246.599417868938,124.94847602831724,0
4158,31.725502217162568,4,0,207,0.01932367149758454,0.0,1.0,207,6250,4400,1850,0.704,81,44,37,188.34873310103256,0.4736468739740162,0.7677423622009378,0.11151862348522804,1044889.6999949442,-8289.269755127014,1036600.4302398171,3960,0,510.64251207729467,74,133,46,38.51319966809173,0.5488627214170693,43.34722222222221,8142.438270429783,110.03294960040247,0
4159,32.22892643515514,1,3,205,0.004807692307692308,0.014423076923076924,0.9855769230769231,208,6250,3600,2650,0.576,89,36,53,186.82175325113303,0.4738823663755729,0.7669774869150277,0.11121880410387092,1063138.7396153042,-8126.511343173974,1055012.2282721302,3961,0,509.1826923076923,80,128,46,38.34697675194844,0.5507311698717949,43.145576131687235,8278.14233139599,103.47677914244987,0
4160,32.08531903463157,1,5,201,0.0048543689320388345,0.024271844660194174,0.9757281553398058,206,7400,5500,1900,0.7432432432432432,93,55,38,195.1299953122649,0.47364580866682454,0.7696398432269851,0.11795627309580929,1063040.2065564243,-7113.7938955792215,1055926.412660845,3962,0,514.2669902912621,74,132,40,37.5603620373368,0.5594154530744336,42.58333333333333,8259.295874831396,111.61210641664049,8
4161,32.418015309474605,1,2,200,0.0049504950495049506,0.009900990099009901,0.9900990099009901,202,5700,4100,1600,0.7192982456140351,73,41,32,195.4668766583858,0.4725311150518037,0.7664364600865503,0.11877788382781627,1075651.1275698345,-4049.1667439707817,1071601.9608258638,3963,0,525.3762376237623,75,127,40,37.35773033608225,0.5611592409240924,42.39309210526315,8351.10468395798,111.34806245277306,0
4162,32.51538504896457,1,0,201,0.004975124378109453,0.0,1.0,201,6250,4400,1850,0.704,81,44,37,210.2662879984669,0.4722647180762853,0.7783749182187443,0.122520102764267,1065932.0068893626,-1624.0867305233214,1064307.9201588393,3964,0,528.6417910447761,85,116,38,38.559799747713654,0.5453461857379768,43.943798449612416,8325.765987586166,97.95018808924901,8
4163,32.799287370517945,2,4,199,0.009852216748768473,0.019704433497536946,0.9802955665024631,203,5850,4000,1850,0.6837606837606838,77,40,37,178.02262241944518,0.4723983482092051,0.7436309962813379,0.10380339751022194,1075455.5911536976,-8158.915073432571,1067296.676080265,3965,0,524.423645320197,92,111,39,39.35917202466865,0.5479782430213465,43.91801075268819,8399.306755736528,91.29681256235357,8
4164,33.07216291334642,1,0,200,0.005,0.0,1.0,200,6950,5400,1550,0.7769784172661871,85,54,31,182.13455593129197,0.47207757537688444,0.7473931989520395,0.10695329982992002,1086639.5304903428,-7367.0783313508055,1079272.452158992,3966,0,531.365,75,125,43,38.98511156855408,0.5506770833333333,43.654057017543856,8477.914788491194,113.03886384654926,0
4165,32.721894151034746,1,1,200,0.004975124378109453,0.004975124378109453,0.9950248756218906,201,5000,3000,2000,0.6,70,30,40,212.2125405111674,0.4725860281923715,0.7842417866614055,0.12226458552293232,1069139.124581939,176.94595748416214,1069316.0705394233,3967,0,529.7164179104477,73,128,39,38.944566813509574,0.539075456053068,44.369369369369394,8364.718437257814,114.58518407202484,8
4166,32.478629879267785,1,1,200,0.004975124378109453,0.004975124378109453,0.9950248756218906,201,6650,4600,2050,0.6917293233082706,87,46,41,208.74822176688645,0.47279539800995024,0.781080320239099,0.12086432558517614,1062739.5561316258,-2481.0014912381503,1060258.5546403877,3968,0,530.592039800995,76,125,42,38.84276396968098,0.540941127694859,44.18290043290046,8308.588893627688,109.32353807404853,0
4167,32.12715155993638,2,0,202,0.009900990099009901,0.0,1.0,202,6400,4500,1900,0.703125,83,45,38,241.40270994976729,0.4727917754462014,0.7965710269657096,0.13685849766285207,1044679.7187644851,3637.7030278616567,1048317.4217923468,3969,0,528.9158415841584,81,121,30,38.82601701951017,0.534447194719472,44.98221544715448,8192.995014808495,101.14808660257401,8
4168,31.713292102313417,2,1,203,0.00980392156862745,0.004901960784313725,0.9950980392156863,204,6850,4800,2050,0.7007299270072993,89,48,41,238.11610672137408,0.47299041743134035,0.7986370959786939,0.13592524407292242,1033341.3940064542,1561.0459309709267,1034902.4399374251,3970,0,524.7205882352941,72,132,31,38.64169927333706,0.5367136437908497,44.7203196347032,8095.759071209873,112.44109821124823,0
4169,31.92884739053348,2,2,203,0.00975609756097561,0.00975609756097561,0.9902439024390244,205,5700,3800,1900,0.6666666666666666,76,38,38,248.4161977852186,0.47354734576757535,0.810453716671512,0.13896251548833707,1034049.588665824,4674.933427546537,1038724.5220933706,3971,0,518.8146341463415,67,138,37,39.17403996629348,0.5252032520325203,45.496323529411754,8126.009046359094,121.28371710983723,8
4170,31.984520772923798,1,4,200,0.004901960784313725,0.0196078431372549,0.9803921568627451,204,6050,4200,1850,0.6942148760330579,79,42,37,255.35343947537817,0.4737576064908722,0.8218471466438613,0.14041969602098617,1030451.4303282493,5775.863389328153,1036227.2937175775,3972,0,522.2205882352941,69,135,34,39.678840817602655,0.5189950980392157,46.16071428571428,8118.927906912692,117.66562183931438,8
4171,32.27868553622813,5,5,200,0.024390243902439025,0.024390243902439025,0.975609756097561,205,6000,3700,2300,0.6166666666666667,83,37,46,250.09027478479697,0.4748356049736968,0.8210372096895029,0.13930884127746254,1044037.5715089547,5220.7286288651785,1049258.30013782,3973,0,511.0487804878049,59,146,38,39.29891922639361,0.5221544715447155,45.65972222222221,8209.769845585774,139.14864145060633,0
4172,31.78741188680279,1,2,199,0.004975124378109453,0.009950248756218905,0.9900497512437811,201,6300,4700,1600,0.746031746031746,79,47,32,250.18961798782706,0.4748652570480929,0.816850939185729,0.14009490780340164,1029781.9407849641,5028.150075150765,1034810.0908601149,3974,0,520.905472636816,60,141,40,39.08926494923745,0.5239946102819237,45.45765027322405,8091.242513399638,134.85404188999397,0
4173,31.56114757787661,8,5,202,0.03864734299516908,0.024154589371980676,0.9758454106280193,207,5550,4200,1350,0.7567567567567568,69,42,27,230.80622162774876,0.4762616669011772,0.8066973550823244,0.13130071254244843,1027329.7929072706,472.8215733092102,1027802.6144805799,3975,0,506.18840579710144,69,138,36,38.96219720828962,0.5277777777777778,44.851190476190496,8052.7892317005235,116.70709031450033,0
4174,31.125909904219974,4,3,203,0.019417475728155338,0.014563106796116505,0.9854368932038835,206,6450,4000,2450,0.6201550387596899,89,40,49,229.81178175979431,0.47590871418422925,0.8070045166126298,0.1318686020165823,1015771.8839044385,-962.7306996836246,1014809.1532047548,3976,0,509.5194174757282,61,145,41,38.65168354596868,0.5300364077669903,44.52284946236559,7951.958770221252,130.35997983969267,0
4175,31.03635805120899,2,3,202,0.00975609756097561,0.014634146341463415,0.9853658536585366,205,6300,4300,2000,0.6825396825396826,83,43,40,250.20497171588886,0.4761039375099633,0.8179995751406024,0.143688126538082,1013095.6877244336,3396.3155785162153,1016492.0033029498,3977,0,510.0829268292683,65,140,36,38.09885055696253,0.5367378048780488,44.491792929292934,7930.044199668925,122.00067999490653,8
4176,31.41025531498494,4,3,203,0.019417475728155338,0.014563106796116505,0.9854368932038835,206,6800,5000,1800,0.7352941176470589,86,50,36,243.61173740435373,0.4766526560896677,0.8128296859455169,0.14118793913574376,1028076.5725259343,2090.304003551273,1030166.8765294856,3978,0,507.8252427184466,70,136,34,37.913226102414136,0.5391383495145632,44.146126760563384,8036.435481778506,114.80622116826437,0
4177,31.84154503443459,0,3,200,0.0,0.014778325123152709,0.9852216748768473,203,7700,5800,1900,0.7532467532467533,96,58,38,246.12719383124522,0.47595067388512247,0.8117705425735033,0.14316155712196094,1043298.838629108,3056.8430958358567,1046355.6817249439,3979,1,516.320197044335,71,132,36,37.70981688708035,0.5404351395730707,44.010416666666664,8151.103846054475,114.80427952189402,0
4178,31.44841597820402,0,2,198,0.0,0.01,0.99,200,6200,4300,1900,0.6935483870967742,81,43,38,245.00186742175381,0.4749748743718593,0.8095579633446606,0.14311840293159475,1031710.5873212052,4354.204106497974,1036064.7914277031,3980,2,523.69,72,128,38,37.57416021391566,0.5423958333333334,43.84988584474886,8055.515342818791,111.88215753914989,0
4179,31.14416411852497,0,4,194,0.0,0.020202020202020204,0.9797979797979798,198,5900,4000,1900,0.6779661016949152,78,40,38,243.19287776675134,0.47449964962655317,0.8067150446412195,0.1423886195467727,1022415.3296532035,4228.825258241002,1026644.1549114445,3981,3,529.9040404040404,74,124,38,37.532409164001685,0.5438762626262627,43.7638888888889,7980.259497537065,107.84134456131169,0
4180,31.367845349424318,0,0,194,0.0,0.0,1.0,194,5750,4300,1450,0.7478260869565218,72,43,29,246.41641247203128,0.4737811147908766,0.8054333194578842,0.14458956879512722,1030410.3384616227,6232.003795560939,1036642.3422571836,3982,4,541.4639175257732,61,133,37,37.366719105051544,0.5448346219931272,43.68279569892473,8040.118424912924,131.80522008053973,0
4181,30.977194979767994,2,2,194,0.01020408163265306,0.01020408163265306,0.9897959183673469,196,6750,4900,1850,0.725925925925926,86,49,37,242.05835887274122,0.47389292255363685,0.8049930834041812,0.14346119420450976,1020535.5624478133,3455.83268347754,1023991.3951312909,3983,0,536.9285714285714,63,133,37,37.09716409866208,0.5475659013605443,43.310546875,7951.519238703145,126.21459109052611,0
4182,30.532858120335238,0,0,194,0.0,0.0,1.0,194,6300,4600,1700,0.7301587301587301,80,46,34,239.43001254189596,0.4736887497106636,0.7999261413291479,0.140599210008082,1003208.2051143517,2939.63062653226,1006147.835740884,3984,1,542.6649484536083,64,130,38,37.51614987080104,0.5422573024054983,43.65384615384614,7826.980745078212,122.29657414184706,8
4183,30.93138980778903,1,1,194,0.005128205128205128,0.005128205128205128,0.9948717948717949,195,5400,4000,1400,0.7407407407407407,68,40,28,238.75643706167745,0.47371794871794876,0.799962029173231,0.14093951538498065,1017848.6093763387,4203.581488575468,1022052.1908649141,3985,0,540.876923076923,67,128,39,37.333863278995224,0.54375,43.45894607843136,7935.17134054904,118.43539314252298,0
4184,30.83503888402316,1,0,195,0.005128205128205128,0.0,1.0,195,5850,4200,1650,0.717948717948718,75,42,33,226.52801940596413,0.47362542955326464,0.7843387321648196,0.13395633541751262,1015194.6863219992,1144.0083207961616,1016338.6946427954,3986,0,541.8051282051282,75,120,37,37.58078730904818,0.5496260683760683,43.393640350877185,7912.4670776683115,105.49956103557749,8
4185,31.191133694027684,0,1,194,0.0,0.005128205128205128,0.9948717948717949,195,6500,4900,1600,0.7538461538461538,81,49,32,225.89876076454607,0.4733313507798044,0.7843329617242674,0.13390905921609642,1027639.5664847598,928.5009163043824,1028568.0674010642,3987,1,542.8051282051282,76,119,39,37.504830917874386,0.55133547008547,43.303571428571416,8006.6526223508245,105.35069239935295,0
4186,31.18856486568446,2,4,192,0.01020408163265306,0.02040816326530612,0.9795918367346939,196,6000,4400,1600,0.7333333333333333,76,44,32,243.20965032759173,0.4732420852956567,0.8033870276023265,0.14106780547718462,1021060.9996309541,4466.377736677262,1025527.3773676314,3988,0,540.9183673469388,73,123,36,37.89264495544065,0.5470344387755102,44.115990990990994,7980.655013068873,109.32404127491607,8
4187,30.858709110158443,0,2,190,0.0,0.010416666666666666,0.9895833333333334,192,6000,4500,1500,0.75,75,45,30,241.83067383547558,0.47267726966986623,0.7979180234451329,0.14038979193738121,1010519.9681422861,4474.9449640105595,1014994.9131062967,3989,1,548.1354166666666,74,118,37,37.894483338760494,0.5482313368055556,44.08333333333334,7897.257973108065,106.71970233929818,0
4188,30.888386110019407,3,0,193,0.015544041450777202,0.0,1.0,193,5800,4100,1700,0.7068965517241379,75,41,34,212.6653392340762,0.4728035495826137,0.7790101840271568,0.12052740963807371,1004301.2758155902,-1683.9856970924343,1002617.2901184977,3990,0,546.1917098445596,76,117,39,39.57150751547302,0.5351360103626943,44.99458874458874,7876.705603001424,103.64086319738715,8
4189,30.660488523951933,4,2,195,0.02030456852791878,0.01015228426395939,0.9898477157360406,197,5700,3600,2100,0.631578947368421,78,36,42,207.89929207712964,0.47373873407230915,0.7796345664585083,0.11941322974678106,1000877.383574954,-3483.6600997514793,997393.7234752026,3991,0,536.0812182741116,67,130,40,39.17316147082334,0.5384940778341794,44.48529411764706,7834.205707406834,116.92844339413186,0
4190,31.151340969449862,3,1,197,0.015151515151515152,0.005050505050505051,0.9949494949494949,198,6400,4800,1600,0.75,80,48,32,204.1148325914997,0.4741738450494795,0.7769752987622704,0.11830329072650188,1019617.9519649164,-4376.170485478628,1015241.7814794378,3992,0,533.530303030303,73,125,39,38.92174662558685,0.5416666666666667,44.14414414414414,7970.253004796178,109.18154801090655,0
4191,31.268682944586814,4,4,197,0.01990049751243781,0.01990049751243781,0.9800995024875622,201,6650,5100,1550,0.7669172932330827,82,51,31,218.3301189815709,0.474606135986733,0.786817156544084,0.12224342668346223,1012948.1233089785,-2618.583143158331,1010329.5401658202,3993,0,526.5273631840796,69,132,37,39.90396326610151,0.5277777777777778,45.461309523809526,7959.089609630325,115.34912477725109,8
4192,30.835719390824416,1,0,198,0.005050505050505051,0.0,1.0,198,6650,5100,1550,0.7669172932330827,82,51,31,221.73385124112724,0.4743458271377053,0.7870573972854553,0.12484392324743618,1000609.1732478461,-1876.2148857110196,998732.9583621351,3994,0,534.7727272727273,70,128,33,39.59773093757198,0.5292508417508417,45.24647887323943,7855.508091289241,112.22154416127486,0
4193,31.290200322401827,4,3,199,0.019801980198019802,0.01485148514851485,0.9851485148514851,202,6450,4800,1650,0.7441860465116279,81,48,33,196.72449112065576,0.47542711360688306,0.7725187292111748,0.10983889649112732,1012785.6706854412,-7002.0508640228945,1005783.6198214183,3995,0,525.1633663366337,70,132,44,40.56397282128164,0.5232054455445545,45.56924882629108,7961.189172404529,113.73127389149327,8
4194,31.657290744493128,2,2,199,0.009950248756218905,0.009950248756218905,0.9900497512437811,201,6450,4700,1750,0.7286821705426356,82,47,35,201.52056240108854,0.475719320066335,0.7763428821874061,0.11353480333800865,1027464.5338496427,-5238.953858289604,1022225.5799913531,3996,0,528.4925373134329,74,127,44,40.08792611571449,0.5257566334991708,45.222222222222214,8065.574186346956,108.99424576144534,0
4195,31.423585925977054,3,0,202,0.01485148514851485,0.0,1.0,202,6550,5100,1450,0.7786259541984732,80,51,29,195.19149367584583,0.47635789698372827,0.7713238710681056,0.110944918320807,1022589.3291124669,-7029.852286711266,1015559.4768257557,3997,0,524.8564356435644,78,124,42,39.90431827579072,0.5287747524752475,44.88396624472574,8016.660607803337,102.7777001000428,0
4196,31.10977155961866,1,1,202,0.0049261083743842365,0.0049261083743842365,0.9950738916256158,203,6950,4700,2250,0.6762589928057554,92,47,45,195.52803098101944,0.47646076183973074,0.772374512873464,0.11166707388516589,1013818.8350874616,-7903.999880775367,1005914.8352066863,3998,0,523.2660098522167,69,134,42,39.71059687572863,0.5306855500821018,44.70238095238097,7942.250608286014,115.10508127950744,0
4197,30.83418840461386,4,2,204,0.019417475728155338,0.009708737864077669,0.9902912621359223,206,6950,5200,1750,0.7482014388489209,87,52,35,188.81125073896732,0.4767528021153998,0.7674379956405974,0.10889056538650482,1007758.0121392969,-10094.789857152478,997663.2222821444,3999,0,516.6019417475728,76,130,42,39.504404994973314,0.5334243527508091,44.33170995670998,7883.324224280314,103.72795031947783,0
4198,31.24204008262427,1,1,204,0.004878048780487805,0.004878048780487805,0.9951219512195122,205,5550,3600,1950,0.6486486486486487,75,36,39,187.07437288116412,0.4768511876295234,0.7645100538164249,0.1082375227183926,1022060.6321877227,-8309.729637390894,1013750.9025503318,4000,0,517.7951219512195,76,129,48,39.42478051618364,0.5348577235772358,44.20995670995673,7991.4027852037725,105.15003664741806,0
4199,30.89587897352107,2,5,201,0.009708737864077669,0.024271844660194174,0.9757281553398058,206,6250,4600,1650,0.736,79,46,33,195.8664130106296,0.4765732299313284,0.7733770471732286,0.11416445993678323,1012931.7615930367,-7770.1378464464915,1005161.6237465902,4001,0,516.2233009708738,79,127,41,38.91678531475644,0.5369639967637541,43.932291666666686,7911.436925693606,100.14477121131146,0
4200,30.690662733225683,1,1,201,0.0049504950495049506,0.0049504950495049506,0.995049504950495,202,7350,5000,2350,0.6802721088435374,97,50,47,203.7112324923494,0.4758960970723938,0.7790038655534657,0.11955454785964864,1008222.0378281988,-6672.7692096142855,1001549.2686185845,4002,0,526.7623762376238,69,133,44,38.453979196903745,0.5388820132013201,43.675595238095205,7866.765856842373,114.01109937452715,0
4201,30.59412700904229,2,1,202,0.009852216748768473,0.0049261083743842365,0.9950738916256158,203,6600,5000,1600,0.7575757575757576,82,50,32,200.60295292329192,0.4757515160383033,0.7770748418394153,0.11831970576613245,1006509.9716982638,-6818.225506118201,999691.7461921456,4003,0,525.1379310344828,71,132,42,38.343908629441614,0.5408969622331692,43.48958333333331,7847.7122666423,110.53115868510282,0
4202,30.557827388492534,4,2,204,0.019417475728155338,0.009708737864077669,0.9902912621359223,206,6650,4800,1850,0.7218045112781954,85,48,37,196.1406477342788,0.4763610979556398,0.7740476592176779,0.11690869116365113,1008366.689621753,-8293.660868784093,1000073.0287529689,4004,0,517.9320388349514,76,130,38,38.0618088467614,0.5442455501618123,43.10064935064932,7850.2860133586055,103.2932370178764,0
4203,31.008778425351903,1,3,202,0.004878048780487805,0.014634146341463415,0.9853658536585366,205,6050,4000,2050,0.6611570247933884,81,40,41,199.6529504171051,0.47627530687071573,0.774774742812107,0.11953715840058564,1024564.5747123265,-6138.531953167827,1018426.0427591586,4005,0,519.5463414634146,77,128,39,37.80299193031671,0.5460873983739838,42.93536324786322,7971.260362040522,103.5228618446821,0
4204,31.227421517171432,1,4,199,0.0049261083743842365,0.019704433497536946,0.9802955665024631,203,5900,3700,2200,0.6271186440677966,81,37,44,199.9000615048177,0.4754161992553935,0.7726015650015008,0.12021117138828473,1033082.4291469889,-5197.351774794411,1027885.0773721945,4006,0,523.9556650246305,78,125,42,37.632317510764786,0.5482348111658457,42.7742616033755,8032.496557976998,102.9807251022692,0
4205,30.989078133037467,1,1,199,0.005,0.005,0.995,200,6100,4100,2000,0.6721311475409836,81,41,40,211.08916426777952,0.47468645309882745,0.7803831508805323,0.12780931819210578,1027189.2097085019,-2734.297635549953,1024454.912072952,4007,0,532.37,67,133,43,37.08948119942886,0.55015625,42.52450980392159,7978.928083028441,119.08847885117075,0
4206,30.821030196562337,1,1,199,0.005,0.005,0.995,200,6300,4500,1800,0.7142857142857143,81,45,36,217.79873378976353,0.4745404103852597,0.7873248534517088,0.1330184758922473,1024120.239916899,-1689.5816995258429,1022430.6582173732,4008,0,532.625,70,130,42,36.5948627473299,0.5525,42.20950704225354,7945.368567837442,113.5052652548206,0
4207,30.80817082473303,2,1,200,0.009950248756218905,0.004975124378109453,0.9950248756218906,201,5500,3600,1900,0.6545454545454545,74,36,38,213.48876549198732,0.474384328358209,0.7845092374492126,0.13151928178306885,1026179.2238189004,-1884.4528666752676,1024294.7709522252,4009,0,530.5621890547263,76,125,37,36.3864283592781,0.5550891376451078,41.896645021645035,7951.692250609898,104.62752961328813,0
4208,30.814137685820285,0,1,199,0.0,0.005,0.995,200,6500,4800,1700,0.7384615384615385,82,48,34,216.5172553896195,0.4741295016750419,0.7876295644977751,0.13374263947932602,1027145.05620257,-2021.074308800563,1025123.9818937695,4010,1,534.215,77,123,39,36.20974276749077,0.55640625,41.800213675213676,7956.2037662613475,103.32732163975776,0
4209,30.71627153693272,1,1,199,0.005,0.005,0.995,200,5750,4000,1750,0.6956521739130435,75,40,35,216.4739808570746,0.4739928810720268,0.7869646776581076,0.13416456054953987,1024837.629124121,-1379.8637382749375,1023457.7653858461,4011,0,534.865,78,122,42,36.087893250302,0.5580208333333334,41.67985232067511,7934.631799578718,101.72604871254767,0
4210,31.082339621477455,2,1,200,0.009950248756218905,0.004975124378109453,0.9950248756218906,201,5850,4100,1750,0.7008547008547008,76,41,35,198.80081801508769,0.47375518242122716,0.7658556434285739,0.12108411374483886,1032007.6472797954,-5017.2071045901,1026990.4401752052,4012,0,533.0248756218906,72,129,43,37.18586761910035,0.5609970978441128,42.308789954337904,8009.645708108761,111.24507927928835,8
4211,30.93870050936744,0,1,199,0.0,0.005,0.995,200,5650,4100,1550,0.7256637168141593,72,41,31,198.22467095194352,0.4731192420435511,0.7639696969696974,0.1211372989150768,1028205.7145599732,-4886.852112088164,1023318.8624478851,4013,1,536.625,73,127,47,37.07702020202019,0.5622395833333333,42.18750000000001,7976.383725071308,109.26553048042888,0
4212,31.40301353911008,1,4,196,0.005,0.02,0.98,200,5550,3400,2150,0.6126126126126126,77,34,43,196.3895333313714,0.4727978433835846,0.7615233350812791,0.12057786222244893,1045006.0395670917,-4504.350312190691,1040501.689254901,4014,0,536.71,76,124,38,36.95190963118338,0.5638020833333333,42.01839826839828,8101.399732018818,106.59736489498445,0
4213,31.918826551652128,0,0,196,0.0,0.0,1.0,196,5200,3600,1600,0.6923076923076923,68,36,32,200.3123563526388,0.47207777341705914,0.7619775733516605,0.12315742719447374,1062584.2618021963,-1830.248539034469,1060754.0132631618,4015,3,547.545918367347,75,121,41,36.7995060023372,0.5645727040816326,41.96820175438597,8236.072213012669,109.81429617350226,0
4214,31.59761783729158,0,1,195,0.0,0.00510204081632653,0.9948979591836735,196,5600,3700,1900,0.6607142857142857,75,37,38,203.30535856448415,0.4716318899354614,0.7647688122718412,0.12557560108614166,1053247.0927620505,-1973.8444298017885,1051273.2483322488,4016,4,548.545918367347,76,120,45,36.55264329875301,0.5659545068027211,41.80194805194808,8158.443371787779,107.34793910247078,0
4215,31.82661528631658,0,0,195,0.0,0.0,1.0,195,7350,5400,1950,0.7346938775510204,93,54,39,201.676592933881,0.4708322319147062,0.7633471123891689,0.12546160141816987,1062985.47927909,-3474.1420401610085,1059511.337238929,4017,5,552.2564102564103,68,127,42,36.333479361370735,0.5680021367521367,41.545893719806756,8225.719409748472,120.96646190806575,0
4216,31.356958412553677,1,1,195,0.00510204081632653,0.00510204081632653,0.9948979591836735,196,5250,3400,1850,0.6476190476190476,71,34,37,198.41726752953326,0.4709995857317286,0.7611260953615724,0.12413401087812853,1048936.9771195243,-2824.558237851208,1046112.418881673,4018,0,550.4336734693877,70,126,44,36.21171298922295,0.5699936224489797,41.34389671361502,8110.668673904342,115.8666953414906,0
4217,31.63438953223882,0,3,192,0.0,0.015384615384615385,0.9846153846153847,195,6000,4400,1600,0.7333333333333333,76,44,32,200.35890760980737,0.47055687725790823,0.7623656429733177,0.1259184712912221,1059538.3943124716,-2542.4089489808957,1056995.9853634906,4019,1,554.1333333333333,70,125,45,35.99687281522212,0.5713141025641026,41.18251173708919,8187.533241464551,116.96476059235073,0
4218,31.541280064159565,1,1,192,0.0051813471502590676,0.0051813471502590676,0.9948186528497409,193,6250,4600,1650,0.736,79,46,33,200.07367684258904,0.47004983448474386,0.7568887264979465,0.12646977317063732,1058097.2831861258,-2510.5172191596585,1055586.765966966,4020,0,560.1450777202073,70,123,40,35.794746530727814,0.5731865284974094,40.97711267605633,8169.913432111734,116.71304903016764,0
4219,31.249447186248148,0,2,190,0.0,0.010416666666666666,0.9895833333333334,192,4800,3200,1600,0.6666666666666666,64,32,32,199.53610409171998,0.4697259944008145,0.7555398075797903,0.12644446122582864,1049019.981959935,-1336.5279370699118,1047683.4540228652,4021,1,563.9895833333334,70,122,40,35.71888624653189,0.57421875,40.88908450704223,8097.072869077534,115.67246955825048,0
4220,30.822404083911437,0,0,190,0.0,0.0,1.0,190,5750,4400,1350,0.7652173913043478,71,44,27,198.3466178980094,0.4690128098022835,0.7528586864265636,0.12622625921502295,1035882.21707774,-2657.253140388082,1033224.963937352,4022,2,570.5473684210526,72,118,44,35.59680408020986,0.5762061403508771,40.73915525114152,7991.042519985472,110.98670166646488,0
4221,30.96249144159252,0,0,190,0.0,0.0,1.0,190,5700,4300,1400,0.7543859649122807,71,43,28,192.49009209547484,0.46883934372969466,0.7491175076155259,0.11658196071081356,1026392.6181505325,-4185.918081217729,1022206.7000693148,4023,3,571.5473684210526,74,116,44,37.557536364780574,0.5625548245614035,42.513888888888886,7972.411511606704,107.7352906973879,8
4222,31.023055313999865,0,0,190,0.0,0.0,1.0,190,5600,3600,2000,0.6428571428571429,76,36,40,226.33813495057586,0.46895827531792444,0.7768509578965193,0.13282652325006095,1019125.064768634,2533.3732882232966,1021658.4380568573,4024,4,572.5473684210526,71,119,36,37.87611004496621,0.5508771929824561,43.677662037037024,7951.90206883874,111.99862068786958,7
4223,31.496245801145268,1,1,190,0.005235602094240838,0.005235602094240838,0.9947643979057592,191,6100,4600,1500,0.7540983606557377,76,46,30,220.32423450732543,0.4693143198309911,0.7683836762273621,0.13027151122615233,1036926.4698339896,1392.0061413116282,1038318.4759753012,4025,0,570.5445026178011,76,115,38,37.744710389427816,0.5530650087260035,43.398268398268414,8081.991211527681,106.34198962536422,0
4224,31.483494643489944,0,0,190,0.0,0.0,1.0,190,5750,4400,1350,0.7652173913043478,71,44,27,224.80305287360923,0.46912419938735733,0.7704699238465447,0.1333137568198697,1037393.6340553915,2891.8511934602557,1040285.4852488518,4026,1,574.521052631579,78,112,40,37.517549266355054,0.5541666666666667,43.28850210970466,8082.175068751441,103.61762908655695,0
4225,31.100561995744084,1,1,190,0.005235602094240838,0.005235602094240838,0.9947643979057592,191,6550,4600,1950,0.7022900763358778,85,46,39,221.6944634670266,0.46937517222375313,0.7679933380409665,0.13219654417808133,1026402.5137692499,759.5509182565493,1027162.0646875064,4027,0,572.5078534031413,82,109,32,37.38917248790974,0.5561191099476439,43.08483935742974,7990.205881210868,97.4415351367179,0
4226,30.675055926141162,1,0,191,0.005235602094240838,0.0,1.0,191,5900,4200,1700,0.711864406779661,76,42,34,218.43953134281915,0.46970584182970515,0.7664278980235717,0.13084281780606768,1013665.8898406494,184.94038299888325,1013850.8302236483,4028,0,571.6282722513089,83,108,35,37.30348471692957,0.5577552356020943,42.91914682539684,7885.969548671071,95.01168130929001,0
4227,30.320586928070256,0,1,190,0.0,0.005235602094240838,0.9947643979057592,191,6800,5000,1800,0.7352941176470589,86,50,36,215.3377612845037,0.46943143198309906,0.7643535770832295,0.12956036069310242,1003226.9507069796,-1793.47087489581,1001433.4798320838,4029,1,572.6282722513089,87,104,37,37.21624026013867,0.5594458987783595,42.755681818181834,7799.798711184027,89.65285874924169,0
4228,30.41484166204563,3,0,193,0.015544041450777202,0.0,1.0,193,5650,4000,1650,0.7079646017699115,73,40,33,212.45695097944315,0.4698541846574554,0.7640428649644071,0.1286749236918616,1008238.2751087564,-1408.5540419242507,1006829.7210668321,4030,0,567.6580310880829,74,119,37,37.0434174802668,0.561690414507772,42.51388888888888,7831.399299620309,105.8297202651393,0
4229,30.42416307276325,2,1,194,0.010256410256410256,0.005128205128205128,0.9948717948717949,195,4900,3100,1800,0.6326530612244898,67,31,36,210.20871391486676,0.4699290686404089,0.764390343062813,0.128177502996619,1010477.3549986843,-1417.7709531263436,1009059.5840455579,4031,0,562.8256410256411,77,118,42,36.84986916420539,0.5637286324786325,42.26762820512818,7841.291708617179,101.83495725476857,0
4230,30.187587046310448,2,3,193,0.01020408163265306,0.015306122448979591,0.9846938775510204,196,5550,3900,1650,0.7027027027027027,72,39,33,215.57756925941908,0.4700113378684807,0.7815082364139889,0.12532530391250554,988951.5579565084,-2110.8454040837846,986840.7125524245,4032,0,551.9081632653061,77,119,37,38.51231935096781,0.545812074829932,44.03044871794874,7727.103110531993,100.35198844846744,8
4231,30.64659443477344,0,2,191,0.0,0.010362694300518135,0.9896373056994818,193,6050,4400,1650,0.7272727272727273,77,44,33,230.6687529569439,0.46936618451352907,0.7902900664701509,0.13468864123844826,1005281.2174508142,1727.392960083735,1007008.610410898,4033,1,561.4507772020726,80,113,38,37.95752372345234,0.5495466321243523,43.865740740740755,7849.642764369666,98.12053455462083,8
4232,30.239483169857547,7,1,197,0.03535353535353535,0.005050505050505051,0.9949494949494949,198,5100,3500,1600,0.6862745098039216,67,35,32,226.99271224834806,0.4709451751012665,0.7907874825358765,0.13451251505378015,996189.7284435682,525.5616746700052,996715.2901182382,4034,0,547.3888888888889,71,127,41,37.48943185661141,0.5525568181818181,43.31597222222221,7761.992337957326,109.32383574587783,0
4233,30.242242072607393,2,6,193,0.010050251256281407,0.03015075376884422,0.9698492462311558,199,6600,4800,1800,0.7272727272727273,84,48,36,225.0245839747804,0.47082635399218314,0.7906811501972322,0.13433945879694725,998411.1055699041,-1466.59126666659,996944.5143032375,4035,0,545.5929648241206,74,125,34,37.25947246094803,0.5547529313232831,43.04166666666665,7770.996119240374,105.01346107081586,0
4234,30.25884543516829,1,2,192,0.005154639175257732,0.010309278350515464,0.9896907216494846,194,6350,4700,1650,0.7401574803149606,80,47,33,211.0024890591605,0.46903488506668095,0.7673211074492612,0.12537343662086692,997600.6172016661,-3050.7573366984407,994549.8598649676,4036,0,559.9587628865979,81,113,45,37.79826687774149,0.5547143470790379,43.21646341463416,7769.973343832508,95.92559683743838,8
4235,30.645349821066652,2,2,192,0.010309278350515464,0.010309278350515464,0.9896907216494846,194,5600,4300,1300,0.7678571428571429,69,43,26,204.50673945857994,0.46912168598543524,0.7665770468316089,0.11871745660215798,1003521.4912965461,-3354.6183676663463,1000166.8729288797,4037,0,558.819587628866,83,111,40,38.85118355381109,0.545801116838488,44.08482142857143,7842.610171842175,94.48927917882139,8
4236,31.176840790750358,3,3,192,0.015384615384615385,0.015384615384615385,0.9846153846153847,195,4900,3100,1800,0.6326530612244898,67,31,36,202.13368638329055,0.4694279231650366,0.7676124334628243,0.11820533300171762,1023126.2280427604,-2538.3447780570696,1020587.8832647033,4038,0,556.5846153846154,87,108,43,38.630706232962176,0.5480769230769231,43.809185606060616,7987.220232412549,91.80712910819022,0
4237,31.62309053483972,3,3,192,0.015384615384615385,0.015384615384615385,0.9846153846153847,195,5350,3600,1750,0.6728971962616822,71,36,35,199.39109268536933,0.4690248039474844,0.7645610403533254,0.11804635263459592,1041490.4873254943,-2817.214742150732,1038673.2725833436,4039,0,557.5230769230769,72,123,44,38.23309333185074,0.5511752136752137,43.35045662100454,8116.051745999181,112.72294091665529,0
4238,31.238114035834947,2,1,193,0.010309278350515464,0.005154639175257732,0.9948453608247423,194,6650,5000,1650,0.7518796992481203,83,50,33,195.369059961598,0.4687410973416662,0.7568876126164972,0.11649522278943106,1030933.289292915,-5167.50647754519,1025765.7828153698,4040,0,556.0051546391752,79,115,36,38.06663161184599,0.553747852233677,43.085937499999986,8025.51078178459,101.58874407322266,0
4239,31.29619478222025,1,2,192,0.005154639175257732,0.010309278350515464,0.9896907216494846,194,5650,3900,1750,0.6902654867256637,74,39,35,219.57341484236292,0.4686314833609316,0.7830171939599331,0.12792102955857346,1025911.7726444175,602.5902493036638,1026514.3628937211,4041,0,556.5721649484536,77,117,36,38.32815026339124,0.5449957044673539,43.95032051282054,8013.380643155896,104.0698784825441,8
4240,30.88740038225748,1,1,192,0.0051813471502590676,0.0051813471502590676,0.9948186528497409,193,5350,4400,950,0.822429906542056,63,44,19,216.57453729216547,0.4683103501007484,0.778715227730115,0.12667639259937022,1013688.9905733713,-42.15518168163726,1013646.8353916897,4042,0,560.419689119171,80,113,38,38.252831877656234,0.5465241796200345,43.80144032921813,7913.307489909181,98.91634362386476,0
4241,30.9856966618385,0,0,192,0.0,0.0,1.0,192,5800,4400,1400,0.7586206896551724,72,44,28,221.69298104839504,0.4679728403141361,0.7830893022985845,0.13026352924630769,1018268.8288612025,948.610435779467,1019217.4392969819,4043,1,563.7135416666666,69,123,38,37.94743053943195,0.5487196180555556,43.63095238095237,7943.773543008218,115.12715279722056,0
4242,31.024552695524385,6,3,195,0.030303030303030304,0.015151515151515152,0.9848484848484849,198,6200,3900,2300,0.6290322580645161,85,39,46,217.49424371621964,0.46928998102855973,0.7866306942136334,0.12798366452942456,1019979.7667298784,-1432.0544058479145,1018547.7123240305,4044,0,547.60101010101,71,127,40,37.99932295192957,0.5515572390572391,43.57638888888888,7955.427835293295,112.0482793703281,8
4243,30.583828420387277,2,1,196,0.01015228426395939,0.005076142131979695,0.9949238578680203,197,6500,4800,1700,0.7384615384615385,82,48,34,215.26998341873386,0.4696068148071411,0.7839202735609097,0.12758152688183655,1007569.4793079837,-2520.106979229807,1005049.3723287538,4045,0,547.1015228426396,75,122,42,37.78566851772744,0.5535638747884941,43.31140350877192,7850.51999255772,104.6735999007696,0
4244,30.812070125783602,1,3,194,0.005076142131979695,0.015228426395939087,0.9847715736040609,197,5750,3600,2150,0.6260869565217392,79,36,43,212.5156892655615,0.4697212006630063,0.782258992957763,0.1264633693600297,1016281.5790647174,-1954.8439474339657,1014326.7351172834,4046,0,547.6040609137056,75,122,38,37.70239651706773,0.5548329103214891,43.16063596491226,7913.75249571074,105.51669994280986,0
4245,30.440213381128643,0,3,191,0.0,0.015463917525773196,0.9845360824742269,194,6000,4200,1800,0.7,78,42,36,213.10050726570202,0.4692312999661699,0.7801722268358622,0.12732461332337577,1005182.0540829507,-1959.0388761087333,1003223.015206842,4047,2,556.8350515463917,78,116,40,37.53516760732,0.5560567010309279,43.011603375527415,7822.781629723036,100.29207217593635,0
4246,30.166198666836596,2,0,193,0.010362694300518135,0.0,1.0,193,6200,4500,1700,0.7258064516129032,79,45,34,214.26675714480425,0.46925149323546345,0.78186541611424,0.12885357039256,997980.8761490366,-2033.1747950031813,995947.7013540334,4048,0,558.0621761658031,79,114,42,37.26192736016199,0.5579123488773747,42.77343749999999,7759.547586762441,98.2221213514233,0
4247,30.48661706203613,2,3,192,0.010256410256410256,0.015384615384615385,0.9846153846153847,195,5750,3700,2050,0.6434782608695652,78,37,41,214.2804529219185,0.46940919904837436,0.7820587899971918,0.12513489907492203,1000069.730540758,-1890.9210372448665,998178.8095035132,4049,0,553.3282051282051,74,121,39,38.37255539890831,0.5459935897435897,43.86111111111113,7808.808220251012,105.52443540879746,8
4248,30.42780838935295,0,1,191,0.0,0.005208333333333333,0.9947916666666666,192,6000,3900,2100,0.65,81,39,42,215.7740777947655,0.46881533140634085,0.781512948872896,0.1263343691893894,998897.0020830781,-1292.7841127135148,997604.2179703646,4050,1,559.71875,73,119,39,38.235169569118646,0.5471462673611112,43.76407657657658,7796.697580396844,106.80407644379238,0
4249,30.714255571292203,0,4,187,0.0,0.020942408376963352,0.9790575916230366,191,6050,4100,1950,0.6776859504132231,80,41,39,250.65484233770943,0.468582942959493,0.8093889406457955,0.14150553351473336,997471.4524848934,5754.2099317933125,1003225.6624166867,4051,2,560.3507853403141,70,121,35,38.75568476195958,0.53168630017452,45.143779342723,7827.719095201236,111.82455850287481,8
4250,31.047175227233293,1,0,188,0.005319148936170213,0.0,1.0,188,6500,5000,1500,0.7692307692307693,80,50,30,251.82441214939342,0.46876955569461826,0.808530578038192,0.14283902628835637,1009715.0313590888,6754.178842081743,1016469.2102011705,4052,0,561.2872340425532,72,116,36,38.54044275350158,0.5340757978723405,44.962899543378995,7918.181547322211,109.97474371280849,0
4251,31.159579126705164,1,0,189,0.005291005291005291,0.0,1.0,189,6000,4000,2000,0.6666666666666666,80,40,40,244.22198333781202,0.4691733273293557,0.8016306704831286,0.13543219076005963,1006465.2250908869,5360.186686446876,1011825.4117773338,4053,0,559.3121693121693,67,122,40,39.62602459016394,0.5238095238095238,45.83333333333334,7919.726361370914,118.20487106523751,8
4252,31.089774576980123,4,0,193,0.02072538860103627,0.0,1.0,193,6950,5200,1750,0.7482014388489209,87,52,35,251.64285798477624,0.46964166846574557,0.8097523839845528,0.14184784564616781,1009205.3359066251,5241.8630042061095,1014447.1989108312,4054,0,548.699481865285,65,128,37,38.7902110175091,0.5275259067357513,45.20202020202022,7921.611754589168,121.87095007060259,0
4253,31.236351017180656,2,1,194,0.010256410256410256,0.005128205128205128,0.9948717948717949,195,5950,4200,1750,0.7058823529411765,77,42,35,246.16086373365022,0.46966472816988286,0.8088417329796642,0.13999578459907164,1016670.9721818491,5102.920929042777,1021773.8931108918,4055,0,544.0615384615385,73,122,40,38.58155172413794,0.5300747863247863,44.86204954954955,7969.5785780743245,109.17230928868938,0
4254,31.4420702564701,3,0,197,0.015228426395939087,0.0,1.0,197,6300,4700,1600,0.746031746031746,79,47,32,238.57325015959574,0.4705197434303671,0.8054163317730172,0.13701744669286808,1026359.4864191522,3272.383701430306,1029631.8701205825,4056,0,533.2791878172588,61,136,41,38.39344423987375,0.5327305414551607,44.489247311827974,8033.7870373050955,131.70142684106713,0
4255,31.2079171588389,0,2,195,0.0,0.01015228426395939,0.9898477157360406,197,6550,5100,1450,0.7786259541984732,80,51,29,237.239848761015,0.47057261991090854,0.804044371284613,0.1369836076131851,1020332.4697900906,2462.704163790921,1022795.1739538815,4057,1,534.2791878172588,65,132,40,38.22007571081759,0.5345283417935702,44.28661616161617,7980.28209923468,122.77357075745661,0
4256,31.65527315837787,3,3,195,0.015151515151515152,0.015151515151515152,0.9848484848484849,198,6650,4900,1750,0.7368421052631579,84,49,35,231.1833149595224,0.4707651814250799,0.7993650924062126,0.13498909657135152,1038368.2796181869,1760.6842061896104,1040128.9638243765,4058,0,530.5909090909091,71,127,38,37.944344027715005,0.5379840067340067,43.86574074074073,8107.999942070614,114.19718228268471,0
4257,32.11436911226754,2,2,195,0.01015228426395939,0.01015228426395939,0.9898477157360406,197,5850,4000,1850,0.6837606837606838,77,40,37,229.84605685668947,0.4712082167892538,0.7981662343906128,0.13515359961416307,1055585.779722836,3274.4458286575737,1058860.2255514937,4059,0,534.1878172588832,63,134,40,37.710343532448825,0.5398688663282571,43.603515625,8234.011338306487,130.69859267153154,0
4258,32.261362740374416,2,1,196,0.01015228426395939,0.005076142131979695,0.9949238578680203,197,5700,3300,2400,0.5789473684210527,81,33,48,222.87677966204993,0.4718189940950999,0.7920195551774076,0.13184063068815693,1062255.383049565,2250.411790552879,1064505.7948401177,4060,0,534.2385786802031,64,133,40,37.661977768063444,0.5421954314720812,43.381410256410255,8278.865409641274,129.3572720256449,0
4259,32.598709354242075,0,1,195,0.0,0.00510204081632653,0.9948979591836735,196,6750,4700,2050,0.6962962962962963,88,47,41,220.36337752815322,0.47161553724053723,0.7886454424403824,0.13124887251334383,1075483.0604511718,1449.4159350671757,1076932.476386239,4061,1,537.9030612244898,66,130,42,37.46759371343259,0.5442708333333333,43.12810945273633,8373.692101224959,126.87412274583271,0
4260,32.10762830257277,0,1,194,0.0,0.005128205128205128,0.9948717948717949,195,6550,4700,1850,0.7175572519083969,84,47,37,220.87438307421417,0.4713267688783153,0.7880733159703106,0.13195828527254383,1060217.0264020208,1284.9563262650454,1061501.982728286,4062,2,539.2871794871795,67,128,39,37.33855905261483,0.5462606837606838,43.014705882352956,8251.188302756786,123.15206422025054,0
4261,31.678394912479508,0,0,194,0.0,0.0,1.0,194,5500,3800,1700,0.6909090909090909,72,38,34,224.3455344393792,0.4711648460730374,0.7897056029607334,0.1346150010995899,1047343.5987542224,2693.371880836041,1050036.9706350584,4063,3,542.3659793814433,70,124,40,37.08611475628082,0.5481636597938144,42.85504694835683,8145.939372521003,116.37056246458576,0
4262,31.747108069379774,0,2,192,0.0,0.010309278350515464,0.9896907216494846,194,6600,4400,2200,0.6666666666666666,88,44,44,226.39434183770624,0.4708181988141659,0.7814085460855049,0.13414536170255284,1045827.6408640427,1953.8920858189213,1047781.5329498616,4064,4,543.3659793814433,74,120,38,37.5083419006908,0.5510094501718212,43.31944444444442,8148.865336530605,110.11980184500818,8
4263,31.75704652787632,1,0,193,0.0051813471502590676,0.0,1.0,193,6400,4600,1800,0.71875,82,46,36,223.29487854599827,0.470651401482441,0.7770391990775349,0.1331637338385657,1048097.3512047878,1806.9541483311086,1049904.305353119,4065,0,544.4766839378239,80,113,33,37.34441218673872,0.5534866148531952,43.081275720164605,8158.979880837352,101.9872485104669,0
4264,31.76700390011352,1,0,194,0.005154639175257732,0.0,1.0,194,5850,4200,1650,0.717948717948718,75,42,33,221.84138256105535,0.47084268112458383,0.7829691073877667,0.13167087383186546,1046995.7246376202,1803.3958178246012,1048799.1204554448,4066,0,542.6649484536083,75,119,36,37.56094739839134,0.5547680412371134,43.25657894736841,8155.969257907407,108.74625677209876,8
4265,31.80235517523396,1,3,192,0.005128205128205128,0.015384615384615385,0.9846153846153847,195,5850,3900,1950,0.6666666666666666,78,39,39,222.21868314791016,0.47058220988633365,0.7850772722245101,0.1326624164582357,1049911.99055465,1812.0119924510582,1051724.0025471011,4067,0,540.876923076923,77,118,33,37.332118479635504,0.5567307692307693,43.04220085470085,8171.863193465225,106.1280934216263,0
4266,31.932109833577083,1,2,191,0.0051813471502590676,0.010362694300518135,0.9896373056994818,193,5600,4100,1500,0.7321428571428571,71,41,30,212.0365288754303,0.46996212938975246,0.7687573310592559,0.1256534279335775,1051959.5190102868,410.76898568184606,1052370.2879959687,4068,0,545.0362694300518,78,115,43,37.8722110922758,0.5563471502590673,43.314873417721536,8196.497654670997,105.08330326501277,8
4267,31.900827829981406,3,3,191,0.015463917525773196,0.015463917525773196,0.9845360824742269,194,5650,4400,1250,0.7787610619469026,69,44,25,222.42039277190509,0.46958351138650006,0.7766071712587803,0.13199764332040245,1051367.5681582987,2319.117491482618,1053686.6856497813,4069,0,543.0463917525773,80,114,41,37.550924998330345,0.5570768900343643,43.261316872428004,8190.1765277488785,102.37720659686099,8
4268,31.509932470177308,1,0,192,0.005208333333333333,0.0,1.0,192,5950,4400,1550,0.7394957983193278,75,44,31,226.7248926065145,0.46887952661431065,0.7784565719203413,0.135394617423407,1040350.7325085696,2824.681620223192,1043175.4141287928,4070,0,549.4427083333334,83,109,35,37.2046214972815,0.5595703125,43.03075396825399,8097.083589372749,97.55522396834637,0
4269,31.959023113555293,0,6,186,0.0,0.03125,0.96875,192,5000,3300,1700,0.66,67,33,34,226.19827316328715,0.4684699271015125,0.7768206732634837,0.1356494810438873,1056449.8209917366,4393.425038399068,1060843.2460301358,4071,1,550.4427083333334,86,106,36,37.05985642219634,0.5609266493055556,42.87595785440614,8217.433205981824,95.5515489067654,0
4270,32.04399735859736,5,1,190,0.02617801047120419,0.005235602094240838,0.9947643979057592,191,5650,4300,1350,0.7610619469026548,70,43,27,204.8676425632555,0.4681397538348489,0.768230706087403,0.11970544359687542,1051330.4688445774,-773.2810585779011,1050557.1877859996,4072,0,554.1256544502618,80,111,42,38.59213146576971,0.5476112565445026,43.840020576131685,8208.389704036783,102.60487130045979,8
4271,31.787213607461304,1,1,190,0.005235602094240838,0.005235602094240838,0.9947643979057592,191,6300,4700,1600,0.746031746031746,79,47,32,203.03124256858155,0.468592128226325,0.7664973273080851,0.11911072689458756,1044130.7248853358,-2101.7683044994433,1042028.9565808363,4073,0,551.979057591623,68,123,42,38.48571190167668,0.549792757417103,43.689613526570035,8147.393004641847,119.81460300943893,0
4272,31.871051875110567,0,1,189,0.0,0.005263157894736842,0.9947368421052631,190,6250,4600,1650,0.736,79,46,33,202.79794403075263,0.4685684117701661,0.7645384827782793,0.11947488048631216,1048164.4647263244,-1736.8803094816508,1046427.5844168428,4074,1,555.021052631579,71,119,40,38.33188779827381,0.5513157894736842,43.53298611111109,8173.873503907434,115.1249789282737,0
4273,31.932748930686383,2,0,191,0.010471204188481676,0.0,1.0,191,5900,4500,1400,0.7627118644067796,73,45,28,201.68136016936577,0.46916505924497104,0.7641900018331327,0.1198826765270689,1052907.9759268006,-1629.6174563820496,1051278.3584704185,4075,0,553.0104712041884,75,116,44,38.02261243951036,0.5537739965095986,43.20175438596489,8200.273903033663,109.33698537378218,0
4274,32.41465263060891,3,2,192,0.015463917525773196,0.010309278350515464,0.9896907216494846,194,5450,3900,1550,0.7155963302752294,70,39,31,202.71127098204786,0.46979272385734383,0.7696691278202243,0.12151599140289929,1071389.0453123,-813.4729817002863,1070575.5723305999,4076,0,545.4432989690722,79,115,39,37.67872818123499,0.5563251718213058,42.890624999999986,8334.111078697928,105.49507694554339,0
4275,32.51386227379952,5,1,196,0.025380710659898477,0.005076142131979695,0.9949238578680203,197,5850,4100,1750,0.7008547008547008,76,41,35,201.60273254013728,0.4703535602058082,0.7718927881700037,0.1220977277263563,1077811.5557077145,-1792.0490411976461,1076019.506666517,4077,0,538.1065989847716,69,128,44,37.32391059353867,0.5591159052453469,42.514880952380956,8371.83569826717,121.33095214879957,0
4276,32.0028259465055,2,0,198,0.010101010101010102,0.0,1.0,198,5900,4000,1900,0.6779661016949152,78,40,38,196.25936742934888,0.47053337948007995,0.7652637939622577,0.11959253079315531,1062711.201730437,-3786.5943576601103,1058924.607372777,4078,0,535.9545454545455,74,124,44,37.23389921853949,0.5611321548821548,42.29166666666668,8247.394936630717,111.45128292744212,0
4277,31.891771276882587,1,1,198,0.005025125628140704,0.005025125628140704,0.9949748743718593,199,7400,5300,2100,0.7162162162162162,95,53,42,222.82240285210003,0.4705440079183798,0.7901790577810115,0.13349675106561484,1053937.2932033164,-231.83197459982603,1053705.4612287167,4079,0,534.2562814070352,76,123,37,37.18274222970602,0.5530778894472361,42.911255411255404,8199.015440285113,107.88178210901465,7
4278,31.40182868010935,1,1,198,0.005025125628140704,0.005025125628140704,0.9949748743718593,199,5750,3900,1850,0.6782608695652174,76,39,37,219.7894494523801,0.4703335702079421,0.7889844808217716,0.13258109409252947,1039767.4395692621,155.9826202880422,1039923.4221895501,4080,0,530.2412060301508,65,134,38,37.00494480220792,0.5554334170854272,42.660984848484865,8080.915666495977,124.3217794845535,0
4279,31.421189457712686,0,1,197,0.0,0.005050505050505051,0.9949494949494949,198,5500,4100,1400,0.7454545454545455,69,41,28,218.5721398477278,0.46997203421695805,0.7864642379303646,0.13261831061926593,1042132.068331146,456.2072358155692,1042588.2755669616,4081,1,533.9090909090909,67,131,40,36.81854566902595,0.5567655723905724,42.44791666666668,8092.5928056453,120.78496724843733,0
4280,31.139694285891636,1,1,197,0.005050505050505051,0.005050505050505051,0.9949494949494949,198,5500,4400,1100,0.8,66,44,22,220.6520014299748,0.4700922080363705,0.7877994130800603,0.13462794717385024,1034420.9269842949,549.4095720268197,1034970.3365563217,4082,0,531.8232323232323,71,127,41,36.55796287980842,0.5587121212121212,42.24537037037037,8026.400367439882,113.04789249915326,0
4281,31.615874565425703,2,1,198,0.010050251256281407,0.005025125628140704,0.9949748743718593,199,5500,3200,2300,0.5818181818181818,78,32,46,218.35534408579124,0.46961237162242186,0.7858222624225331,0.13403146430585428,1052017.3259010187,642.7210362662113,1052660.046937285,4083,0,530.1155778894472,77,122,36,36.394270590671404,0.5607726130653266,42.02724358974359,8156.034307963792,105.92252348004925,0
4282,31.703921951219957,0,0,198,0.0,0.0,1.0,198,6250,4600,1650,0.736,79,46,33,227.04457267933603,0.469496145892085,0.7930991840602832,0.13371762568850337,1042573.5136985229,1492.1315808947847,1044065.6452794177,4084,1,533.7929292929293,70,128,39,37.72192028985507,0.5452441077441077,43.54460093896712,8130.641955799922,116.15202793999887,8
4283,31.531213361304385,0,1,197,0.0,0.005050505050505051,0.9949494949494949,198,6900,5300,1600,0.7681159420289855,85,53,32,223.56647999043557,0.4694352578235827,0.7906721892022472,0.132339742311221,1038420.8664049811,-68.78042984422791,1038352.0859751368,4085,2,534.7929292929293,73,125,38,37.618153064209444,0.5467171717171717,43.35585585585584,8092.301266938334,110.85344201285389,0
4284,31.187467478821702,0,2,195,0.0,0.01015228426395939,0.9898477157360406,197,5150,3600,1550,0.6990291262135923,67,36,31,224.78730910574046,0.469246391449981,0.7903754323948167,0.1333430237968708,1027725.284323968,1653.920232623182,1029379.2045565912,4086,3,538.3604060913706,74,123,42,37.50698802567988,0.5476945854483926,43.277777777777764,8006.5159566463635,108.19616157630222,0
4285,31.224620708347295,2,1,196,0.01015228426395939,0.005076142131979695,0.9949238578680203,197,5550,4100,1450,0.7387387387387387,70,41,29,228.95980415092214,0.46923452121965536,0.7951320756027553,0.1370225272022567,1031563.9950610624,2287.338055664485,1033851.3331167268,4087,0,533.6852791878173,76,121,40,37.06647018577969,0.5502326565143825,42.95183982683981,8026.2313051853835,105.6083066471761,0
4286,31.6477937410292,2,3,195,0.010101010101010102,0.015151515151515152,0.9848484848484849,198,5700,4000,1700,0.7017543859649122,74,40,34,227.10136699240064,0.46956023859577156,0.7943799911401663,0.13653053678331686,1046905.6346724234,2250.7401492306026,1049156.374821654,4088,0,531.959595959596,81,117,43,36.9431548794943,0.5519781144781144,42.784552845528445,8140.30141855128,100.4975483771763,0
4287,32.07518307600726,5,2,198,0.025,0.01,0.99,200,6300,4200,2100,0.6666666666666666,84,42,42,220.1456340696862,0.469651905360134,0.7884746000561325,0.13426547315821427,1065377.0635660705,607.6218364103761,1065984.685402481,4089,0,527.03,71,129,41,36.585800823276216,0.5555729166666667,42.25983796296294,8267.062883377692,116.4375053996858,0
4288,31.6862897181258,0,0,198,0.0,0.0,1.0,198,6400,4600,1800,0.71875,82,46,36,224.2363213449478,0.4696526389102531,0.790851099953916,0.13751359947539554,1054086.0207918028,1272.874336697566,1055358.8951285004,4090,1,529.4090909090909,73,125,37,36.27687731936256,0.5572916666666667,42.06081081081081,8173.135878307104,111.9607654562617,0
4289,31.65840095941284,0,4,194,0.0,0.020202020202020204,0.9797979797979798,198,5650,4000,1650,0.7079646017699115,73,40,33,230.42427464717358,0.4691949101847579,0.7975816390929251,0.14230444597907252,1055228.3540804174,3380.0456152221773,1058608.3996956395,4091,2,530.4090909090909,73,125,40,35.858048922327626,0.5591329966329966,41.80743243243243,8173.963828794336,111.97210724375803,0
4290,31.97516054919469,2,1,195,0.01020408163265306,0.00510204081632653,0.9948979591836735,196,5900,4200,1700,0.711864406779661,76,42,34,230.7655601720268,0.4689380559916274,0.7968014649349069,0.14296540917166387,1066722.5133305152,4132.563667365703,1070855.076997881,4092,0,536.4642857142857,75,121,44,35.73326789062221,0.5608524659863945,41.69407894736842,8259.3732964655,110.12497728620666,0
4291,32.221972485149,0,2,193,0.0,0.010256410256410256,0.9897435897435898,195,7450,5400,2050,0.7248322147651006,95,54,41,236.96945671310482,0.4683143889329456,0.801900289041825,0.14734164987247853,1076037.6069565827,4547.60942467415,1080585.216381257,4093,1,540.1948717948718,60,135,40,35.440068719439694,0.5620192307692308,41.564207650273225,8327.31099027058,138.78851650450966,0
4292,31.747316752593182,0,1,192,0.0,0.0051813471502590676,0.9948186528497409,193,6250,4300,1950,0.688,82,43,39,233.8662227038842,0.4679550320236039,0.7965308283413073,0.1461709179703832,1061713.3356117946,4809.777478774458,1066523.1130905692,4094,2,546.5388601036269,64,129,42,35.32991490064859,0.5634715025906736,41.37820512820514,8210.548040919071,128.2898131393605,0
4293,31.309639976213898,1,2,191,0.0051813471502590676,0.010362694300518135,0.9896373056994818,193,5500,3800,1700,0.6909090909090909,72,38,34,232.2039567276073,0.46770990752734604,0.7948599875995752,0.1461759709972471,1049142.2581696957,4622.996703428067,1053765.2548731237,4095,0,547.419689119171,68,125,42,35.11196641007698,0.5657923143350605,41.1231884057971,8105.339769204648,119.19617307653894,0
4294,30.948464467595958,1,2,190,0.005208333333333333,0.010416666666666666,0.9895833333333334,192,7100,5100,2000,0.7183098591549296,91,51,40,207.29612532034963,0.4671968168266434,0.7701895669068004,0.12963545204939514,1035154.8049989303,-2583.2839633958715,1032571.5210355344,4096,0,551.0104166666666,70,122,39,35.99703140658384,0.5677083333333333,41.358568075117375,8004.55516577538,114.35078808250543,8
4295,31.195454103342804,0,2,188,0.0,0.010526315789473684,0.9894736842105263,190,6550,4300,2250,0.6564885496183206,88,43,45,208.7365586951814,0.4668813236795693,0.7693473869941718,0.13108193311966093,1044614.7268308788,-940.1433518031017,1043674.5834790757,4097,1,556.2,72,118,38,35.808153212762825,0.5697368421052631,41.210045662100455,8073.070142954123,112.12597420769616,0
4296,31.250357678675947,2,0,190,0.010526315789473684,0.0,1.0,190,6550,4300,2250,0.6564885496183206,88,43,45,232.29542959373603,0.46651640675763484,0.7884698766646618,0.14248439407564836,1039642.524517875,3750.8413713592754,1043393.3658892344,4098,0,556.1631578947369,69,121,34,36.06159378485443,0.5568530701754386,42.05357142857143,8060.918154794185,116.82490079411863,8
4297,30.887892779677866,0,0,190,0.0,0.0,1.0,190,6400,4200,2200,0.65625,86,42,44,246.54759468886118,0.4667525294718277,0.80301164245165,0.14501240246753375,1015349.3603079981,5666.38851056187,1021015.74881856,4099,1,557.1631578947369,59,131,33,37.2721155799309,0.543859649122807,43.59374999999997,7919.84875803923,134.23472471252933,8
4298,30.54331624449108,2,1,191,0.010416666666666666,0.005208333333333333,0.9947916666666666,192,6850,4800,2050,0.7007299270072993,89,48,41,226.85044897028982,0.46738315335951136,0.7899848696461831,0.1345515132451966,1006465.3275987162,413.4222877598304,1006878.7498864761,4100,0,552.3489583333334,68,124,38,37.458345584631985,0.5486111111111112,43.282004830917884,7841.018912101026,115.3091016485445,8
4299,30.701298029836973,3,1,193,0.015463917525773196,0.005154639175257732,0.9948453608247423,194,5350,3900,1450,0.7289719626168224,68,39,29,226.10868916792617,0.46747469419368626,0.7929308772816717,0.1359032226472486,1015530.5891309661,1774.0580636670288,1017304.6471946331,4101,0,547.5824742268042,73,121,39,36.97711434617629,0.5517074742268041,42.7927927927928,7896.5951238905245,108.17253594370581,0
4300,31.16604328943338,2,0,195,0.010256410256410256,0.0,1.0,195,6200,4200,2000,0.6774193548387096,82,42,40,219.79714264631195,0.46783637324874433,0.7876073715088521,0.13313766381051756,1033177.9687009472,217.9130731179248,1033395.8817740652,4102,0,545.0358974358975,67,128,41,36.84961677276064,0.5541132478632478,42.509191176470594,8024.969694425348,119.77566708097535,0
4301,30.753071756384568,0,1,194,0.0,0.005128205128205128,0.9948717948717949,195,5750,4000,1750,0.6956521739130435,75,40,35,250.25366634038994,0.46780883778306454,0.807268166441435,0.14664642579454013,1009824.950405847,5792.479240213103,1015617.4296460601,4103,1,546.0358974358975,58,137,35,37.31915260075783,0.5411324786324787,43.73234463276836,7881.017594348904,135.87961369567077,8
4302,31.302985227791453,0,2,192,0.0,0.010309278350515464,0.9896907216494846,194,6300,4800,1500,0.7619047619047619,78,48,30,247.86794844959368,0.46799828178694153,0.8043928038179724,0.14578899763648115,1028994.3135156261,5910.941891483194,1034905.2554071093,4104,2,549.8247422680413,59,135,37,37.23826088428467,0.5426331615120275,43.59374999999999,8026.281056063385,136.038661967176,0
4303,31.61758702686929,2,3,191,0.010309278350515464,0.015463917525773196,0.9845360824742269,194,6000,4500,1500,0.75,75,45,30,238.73855173012709,0.46815463472392854,0.7965265880008694,0.1415290200448996,1041708.3041975162,4939.1863738724705,1046647.4905713886,4105,0,544.7268041237113,64,130,43,37.17289403587629,0.5448346219931272,43.301282051282065,8116.194054429393,126.81553210045927,0
4304,31.21602855908266,1,1,191,0.005208333333333333,0.005208333333333333,0.9947916666666666,192,5700,3600,2100,0.631578947368421,78,36,42,238.20226483652863,0.4682154186663758,0.7921249646978126,0.14199329812982672,1030115.5779353838,4975.172741519574,1035090.7506769033,4106,0,547.5364583333334,66,126,40,36.97752763656903,0.5472547743055556,43.09701492537313,8019.490919003132,121.50743816671412,0
4305,31.72184232692439,1,1,191,0.005208333333333333,0.005208333333333333,0.9947916666666666,192,6650,5100,1550,0.7669172932330827,82,51,31,239.46462532963193,0.46817621982257124,0.793789448633542,0.14352532400448162,1048442.6543848049,5162.985482372327,1053605.6398671772,4107,0,548.53125,71,121,41,36.73969060079156,0.5491536458333333,42.89641203703703,8155.799479047629,114.87041519785393,0
4306,31.991884886892812,0,0,191,0.0,0.0,1.0,191,5150,3700,1450,0.7184466019417476,66,37,29,240.54226500654883,0.4679526040231469,0.7941736734488043,0.14457856138814634,1058220.3291542272,7559.342970146547,1065779.6721243737,4108,1,551.3664921465969,73,118,42,36.60587237302975,0.5507198952879582,42.79279279279278,8228.543365052134,112.71977212400184,0
4307,32.454504739913574,0,0,191,0.0,0.0,1.0,191,5750,4400,1350,0.7652173913043478,71,44,27,244.68137860012854,0.46782056581243686,0.7973419724128636,0.14774434524144175,1074929.4902028702,8653.04591215447,1083582.5361150247,4109,2,552.3664921465969,61,130,42,36.3268245316274,0.5520287958115183,42.624327956989255,8352.999968258351,136.9344257091533,0
4308,32.56728651003742,1,0,192,0.005208333333333333,0.0,1.0,192,5850,4200,1650,0.717948717948718,75,42,33,246.10666285186144,0.4676030077443281,0.7971895737621224,0.14974622702410234,1081004.7989552217,8958.496719543804,1089963.2956747655,4110,0,550.484375,65,127,38,36.00427514037778,0.5540907118055556,42.34532828282831,8391.11351446283,129.09405406865892,0
4309,32.373205070718484,2,3,191,0.010309278350515464,0.015463917525773196,0.9845360824742269,194,6900,5100,1800,0.7391304347826086,87,51,36,247.78397756894304,0.4677011555650517,0.8013733838771739,0.15202458975657274,1077076.8560574427,7676.477508273224,1084753.333565716,4111,0,545.7989690721649,68,126,37,35.652347788767315,0.5564862542955327,42.044082125603886,8350.859828553288,122.80676218460718,0
4310,32.60712985536203,1,0,192,0.005208333333333333,0.0,1.0,192,7650,5800,1850,0.7581699346405228,95,58,37,244.85309585192954,0.46718091004944734,0.7972984912742493,0.15072969656423366,1085875.763967685,7126.008503613814,1093001.7724712987,4112,0,551.1197916666666,68,124,40,35.60422150726334,0.5584852430555556,41.92330917874399,8415.140170250887,123.75206132721893,0
4311,32.25801607639429,0,0,192,0.0,0.0,1.0,192,5900,4300,1600,0.7288135593220338,75,43,32,244.621716110842,0.4670871736838278,0.7973597103251358,0.15112427289264932,1075317.3346907333,8309.194355156915,1083626.5290458903,4113,1,552.1197916666666,72,120,42,35.4788385373492,0.56005859375,41.795091324200925,8329.178095067875,115.68302909816492,0
4312,31.983794622730606,1,2,191,0.0051813471502590676,0.010362694300518135,0.9896373056994818,193,6550,4600,1950,0.7022900763358778,85,46,39,243.37177063866054,0.46724552029360966,0.7957872882352124,0.15138649202323123,1068208.9869125157,6844.382511405635,1075053.3694239215,4114,0,550.2538860103627,61,132,41,35.2590928297471,0.5619602763385148,41.54905913978494,8266.241812524597,135.51216086105896,0
4313,32.40922451347762,0,1,190,0.0,0.005235602094240838,0.9947643979057592,191,5350,3200,2150,0.5981308411214953,75,32,43,242.72318012048632,0.4667688527601727,0.7931575635034349,0.15160505339793917,1083648.8543252214,9055.339211147737,1092704.1935363691,4115,1,555.8534031413612,62,129,44,35.12534633418582,0.5640270506108203,41.40211640211639,8380.956868233938,135.17672368119256,0
4314,32.56701161024981,0,2,188,0.0,0.010526315789473684,0.9894736842105263,190,5750,4300,1450,0.7478260869565218,72,43,29,241.84301764790877,0.46646013181100904,0.790981169474728,0.1515649719296517,1089936.0863634,8968.686433895105,1098904.7727972951,4116,2,559.7052631578947,64,126,42,35.025138338288734,0.5653508771929825,41.28205128205127,8425.670439677424,131.65110061995975,0
4315,32.617085987290906,1,1,188,0.005291005291005291,0.005291005291005291,0.9947089947089947,189,5850,4200,1650,0.717948717948718,75,42,33,234.2914806910332,0.4666216368344028,0.7848891857470084,0.1390516311098165,1074993.5572392547,6722.366451780836,1081715.9236910355,4117,0,561.2328042328043,69,120,35,37.24370399350837,0.5496582892416226,43.25892857142854,8374.145603254843,121.36442903267888,7
4316,32.929862406587475,1,0,189,0.005291005291005291,0.0,1.0,189,6500,5000,1500,0.7692307692307693,80,50,30,235.5725895605192,0.46653955120267177,0.7849018539520582,0.14034162880623033,1086484.268235957,6889.182517021765,1093373.4507529787,4118,0,562.1640211640212,70,119,42,37.06772231423838,0.5516424162257496,43.11913145539904,8459.05165605835,120.84359508654785,0
4317,32.72314258438614,4,0,193,0.02072538860103627,0.0,1.0,193,6100,4000,2100,0.6557377049180327,82,40,42,225.9077087441316,0.4666900546919977,0.7814156091878524,0.13599383236457113,1082888.903938076,4226.590222618695,1087115.4941606948,4119,0,551.4922279792746,75,118,40,36.923947789025014,0.5542962003454232,42.73574561403507,8418.494878137668,112.2465983751689,0
4318,32.668032482722076,3,0,196,0.015306122448979591,0.0,1.0,196,5750,4100,1650,0.7130434782608696,74,41,33,221.99070073726054,0.4672809829059829,0.7805919041497447,0.13486895237179322,1083886.7541621851,3172.5560152596277,1087059.3101774447,4120,0,544.0357142857143,70,126,42,36.68175950184151,0.5566007653061225,42.40023474178404,8415.277498996986,120.21824998567122,0
4319,32.24038930689699,1,0,197,0.005076142131979695,0.0,1.0,197,4700,3700,1000,0.7872340425531915,57,37,20,218.54079646411338,0.46748851824993953,0.7790831148828659,0.13339298974310074,1071104.8423524592,2716.0210688549914,1073820.8634213142,4121,0,542.269035532995,71,126,44,36.597596396699764,0.5579526226734348,42.23090277777778,8310.576045731827,117.05036684129333,0
4320,32.107465753036344,1,1,197,0.005050505050505051,0.005050505050505051,0.9949494949494949,198,5600,3300,2300,0.5892857142857143,79,33,46,256.9553792367223,0.46728067476798446,0.8086799575672108,0.1554022688442781,1063914.8496170759,9475.728731787349,1073390.5783488632,4122,0,540.5252525252525,65,133,38,35.95139016614553,0.5605008417508417,42.56628787878788,8265.544095608844,127.16221685552068,8
4321,32.0221455801646,0,2,195,0.0,0.01015228426395939,0.9898477157360406,197,6050,4400,1650,0.7272727272727273,77,44,33,258.1382303018203,0.4666932128181222,0.8055846811718013,0.1572101205624542,1063183.248569767,9439.648454468119,1072622.8970242352,4123,1,544.258883248731,70,127,34,35.66029947620134,0.5618126057529611,42.31220657276996,8251.716035358157,117.88165764797367,0
4322,32.24057363320384,2,1,196,0.01015228426395939,0.005076142131979695,0.9949238578680203,197,6100,4500,1600,0.7377049180327869,77,45,32,253.03144276728364,0.4672942781173383,0.8032087134484949,0.1553536767703855,1072876.2185300277,8794.283497072003,1081670.5020270997,4124,0,544.5837563451777,73,124,33,35.49084001746059,0.5642978003384095,42.01858108108108,8317.468932653808,113.93793058429874,0
4323,31.888832935678415,0,2,194,0.0,0.01020408163265306,0.9897959183673469,196,5650,3800,1850,0.672566371681416,75,38,37,245.55057427712117,0.46684600122100123,0.8053528674039461,0.1443250987318359,1048039.4289410097,6619.33672830606,1054658.7656693158,4125,1,548.3622448979592,63,133,34,37.324360927712874,0.548203656462585,43.61979166666666,8175.665631556072,129.77247034215986,8
4324,32.01998883288743,4,0,198,0.020202020202020204,0.0,1.0,198,5800,4000,1800,0.6896551724137931,76,40,36,211.39125434690231,0.46761822967406724,0.7795584509968587,0.1220383627695319,1046831.9201585384,-1141.7774614619602,1045690.1426970764,4126,0,543.6565656565657,70,128,42,38.887414653738055,0.5425084175084175,44.29284037558686,8187.740395663088,116.96771993804411,8
4325,32.45591540947243,4,1,201,0.019801980198019802,0.0049504950495049506,0.995049504950495,202,6950,4900,2050,0.7050359712230215,90,49,41,212.28458060034805,0.4683400243009375,0.7841259407195662,0.12393413396566222,1064581.268680929,-2151.1623726161115,1062430.1063083129,4127,0,533.8712871287129,76,126,44,38.43454550256169,0.545276402640264,43.87175324675328,8312.876710599934,109.37995671842019,0
4326,32.24318450651451,1,0,202,0.0049504950495049506,0.0,1.0,202,6900,4900,2000,0.7101449275362319,89,49,40,213.58756757556628,0.46798443836921005,0.7855259973383595,0.1253659445245668,1059261.3552892567,-2050.9887393941926,1057210.3665498625,4128,0,534.8514851485148,65,137,40,38.196218931510785,0.5473906765676568,43.67108585858585,8264.860473016108,127.1516995848632,0
4327,32.4548986352755,3,2,203,0.014634146341463415,0.00975609756097561,0.9902439024390244,205,6800,5000,1800,0.7352941176470589,86,50,36,204.16144810657542,0.4681252989000478,0.7783915580148979,0.12119873248870087,1069722.5869589197,-4120.7775148311,1065601.8094440885,4129,0,528.009756097561,74,131,43,38.00815481986367,0.5501524390243903,43.24999999999999,8332.795224606969,112.60534087306715,0
4328,32.52365558186664,2,2,203,0.00975609756097561,0.00975609756097561,0.9902439024390244,205,5600,3900,1700,0.6964285714285714,73,39,34,208.33487153606708,0.46795990754025185,0.7890861327187921,0.11810720962218355,1057561.7632836895,-2534.601180967285,1055027.1621027223,4130,0,528.770731707317,75,130,38,39.67067075137051,0.5292682926829269,44.983552631578945,8294.067101921744,110.58756135895659,8
4329,32.62330783591046,4,5,202,0.01932367149758454,0.024154589371980676,0.9758454106280193,207,7650,5800,1850,0.7581699346405228,95,58,37,196.09051614232342,0.4691012773009396,0.7762380102744577,0.10838634996722452,1052691.11102127,-7765.4513402807315,1044925.6596809893,4131,0,522.6859903381643,81,126,39,40.97888955562226,0.5223429951690821,45.96036585365854,8287.613187278166,102.31621218861933,8
4330,33.0217651968589,0,2,200,0.0,0.009900990099009901,0.9900990099009901,202,6800,4400,2400,0.6470588235294118,92,44,48,219.87686434033654,0.46846265783294744,0.7932282070869714,0.12213328346971691,1067152.5644657437,-271.56807050444786,1066880.9963952394,4132,1,535.7029702970297,64,138,44,40.17928433350146,0.5233601485148515,45.76923076923079,8395.148767355322,131.1741994899269,8
4331,33.26166168885383,3,2,201,0.014778325123152709,0.009852216748768473,0.9901477832512315,203,5900,4100,1800,0.6949152542372882,77,41,36,211.67376262512613,0.4693266432554586,0.7857982256564802,0.11860802676803259,1077762.6051927758,-873.1868284373563,1076889.4183643386,4133,0,531.2807881773399,69,134,42,40.043001402934486,0.5257081280788177,45.43154761904762,8467.36973975034,122.71550347464262,0
4332,32.929647910028585,4,3,202,0.01951219512195122,0.014634146341463415,0.9853658536585366,205,6750,5100,1650,0.7555555555555555,84,51,33,207.078474091161,0.46989677985015144,0.7828152399171049,0.11734446865165833,1070625.1776748088,-3409.314376704296,1067215.8632981044,4134,0,527.0243902439024,74,131,44,39.719498910675384,0.5291158536585365,45.000000000000014,8397.060217057324,113.47378671699086,0
4333,32.51058886346786,3,3,202,0.014634146341463415,0.014634146341463415,0.9853658536585366,205,5950,4200,1750,0.7058823529411765,77,42,35,207.04386320436691,0.47026940857643873,0.7842814743579118,0.11850642909479506,1060169.2876656998,-3049.691006214387,1057119.5966594855,4135,0,526.5219512195122,65,140,47,39.33052911851347,0.5314532520325204,44.61805555555555,8302.61739898631,127.73257536902014,0
4334,32.956489320617266,2,0,204,0.00980392156862745,0.0,1.0,204,6700,4500,2200,0.6716417910447762,89,45,44,206.85993504257945,0.47058219839660004,0.7824667545225834,0.11949203306577208,1077634.4674891094,-2916.1208111117776,1074718.3466779976,4136,0,529.8088235294117,67,137,40,38.98082145281738,0.534109477124183,44.27083333333332,8427.935550220325,125.79008283910933,0
4335,33.1200734802426,5,4,205,0.023923444976076555,0.019138755980861243,0.9808612440191388,209,6900,4600,2300,0.6666666666666666,92,46,46,197.37402433299678,0.47154777788001473,0.7770147282914495,0.11529648912468686,1086551.719682957,-5808.5828880473855,1080743.1367949096,4137,0,518.11004784689,72,137,41,38.79414795833103,0.5372308612440191,43.84988584474886,8483.710602794456,117.82931392770077,0
4336,33.00410815383151,2,1,206,0.00966183574879227,0.004830917874396135,0.9951690821256038,207,6700,5200,1500,0.7761194029850746,82,52,30,200.60829930281625,0.47117083313790786,0.7784751664957841,0.11788555116334029,1084628.592273329,-4582.900545767983,1080045.691727561,4138,0,523.2222222222222,67,140,43,38.48440487571705,0.538647342995169,43.627450980392155,8461.3473355166,126.2887662017403,0
4337,33.37656806467376,1,3,204,0.004830917874396135,0.014492753623188406,0.9855072463768116,207,5950,4300,1650,0.7226890756302521,76,43,33,203.35258341288318,0.4712626831136751,0.780830290201884,0.12007553170668989,1098404.3977882783,-2677.3256155363015,1095727.072172742,4139,0,524.1304347826087,68,139,45,38.231017810207526,0.5404589371980677,43.44806763285024,8562.82303277575,125.92386812905515,0
4338,33.17801482097136,2,2,204,0.009708737864077669,0.009708737864077669,0.9902912621359223,206,6850,4300,2550,0.6277372262773723,94,43,51,201.55178196458687,0.4718066737706212,0.7763737537676798,0.11957260462355736,1093353.8888556706,-3976.5150766457973,1089377.3737790247,4140,0,526.6893203883495,69,137,45,38.09944740706393,0.5425262944983819,43.27380952380952,8517.665352550552,123.44442539928336,0
4339,33.432376173070544,0,2,202,0.0,0.00980392156862745,0.9901960784313726,204,7150,5400,1750,0.7552447552447552,89,54,35,207.28414957799083,0.4713951672623072,0.7799245783283622,0.12363624071559194,1103442.1837350526,-2204.7850671995966,1101237.398667853,4141,1,532.6372549019608,70,134,46,37.74947179077204,0.5444240196078431,43.07511737089202,8589.609324278345,122.70870463254778,0
4340,33.04887946941548,1,0,203,0.0049261083743842365,0.0,1.0,203,6200,4700,1500,0.7580645161290323,77,47,30,206.65652748021984,0.47134667284462434,0.7792140125210432,0.12392607127228111,1092465.534620357,-1646.9732447072229,1090818.5613756496,4142,0,534.4433497536946,73,130,41,37.56364283368007,0.5465414614121511,42.87725225225224,8497.618699160204,116.4057356049343,0
4341,33.45464691272927,2,3,202,0.00975609756097561,0.014634146341463415,0.9853658536585366,205,6350,3900,2450,0.6141732283464567,88,39,49,201.03267953253672,0.4708173919974494,0.7749064462548887,0.12150465725205524,1108357.066100988,-2786.801824579391,1105570.2642764086,4143,0,530.219512195122,69,136,46,37.41448915096159,0.548729674796748,42.589285714285715,8611.584557982009,124.80557330408709,0
4342,33.2739151763911,0,2,200,0.0,0.009900990099009901,0.9900990099009901,202,6800,4600,2200,0.6764705882352942,90,46,44,203.3445765641465,0.46975364514063345,0.7752588047184097,0.12339142902120966,1103611.9986981037,-2317.297086724566,1101294.7016113792,4144,1,538.6881188118812,70,132,45,37.206992309883226,0.550072194719472,42.44424882629108,8569.888217745685,122.42697453922408,0
4343,33.404008822637614,2,0,202,0.009900990099009901,0.0,1.0,202,6450,4700,1750,0.7286821705426356,82,47,35,200.97490952393235,0.4699440093263058,0.771950484084954,0.12245637199737563,1109215.4233248313,-2265.1061309484708,1106950.3171938828,4145,0,539.1336633663366,72,130,45,37.115287006275395,0.551980198019802,42.294520547945204,8608.39610925849,119.56105707303459,0
4344,33.04962085482271,1,5,198,0.0049261083743842365,0.024630541871921183,0.9753694581280788,203,6300,4800,1500,0.7619047619047619,78,48,30,206.22993240062806,0.4701791607732202,0.783394463194236,0.1264895080761057,1099483.821060463,-1550.7051814231313,1097933.11587904,4146,0,537.4729064039409,74,129,47,36.73596902146604,0.5563423645320197,42.05555555555557,8524.966090496806,115.20224446617306,8
4345,32.508575574322855,1,3,196,0.005025125628140704,0.01507537688442211,0.9849246231155779,199,7400,5800,1600,0.7837837837837838,90,58,32,208.281374567867,0.4692824391316854,0.7814286271011295,0.12855244994350576,1083385.0645610935,-2070.2139133832657,1081314.8506477103,4147,0,548.2412060301508,76,123,43,36.451783343813325,0.558574120603015,41.82900432900435,8392.771323868794,110.43120162985255,0
4346,32.27481795358938,1,1,196,0.005076142131979695,0.005076142131979695,0.9949238578680203,197,7500,5800,1700,0.7733333333333333,92,58,34,224.06999818745356,0.46905107220553194,0.7937981033545813,0.13186259805065964,1061106.2600889879,652.4155549669113,1061758.675643955,4148,0,554.4822335025381,64,133,40,37.82797429327336,0.5412965313028765,43.57371794871794,8276.111571720874,129.31424330813866,8
4347,32.67085233401692,1,2,195,0.005076142131979695,0.01015228426395939,0.9898477157360406,197,6000,4300,1700,0.7166666666666667,77,43,34,217.5513534370721,0.4689679805932525,0.787246748422959,0.12880563655094976,1076016.794047394,1417.7819732057342,1077434.5760205998,4149,0,554.5482233502538,69,128,42,37.764719951295845,0.5433058375634519,43.34821428571427,8385.032592333146,121.52221148308907,0
4348,32.21179367770016,1,2,194,0.00510204081632653,0.01020408163265306,0.9897959183673469,196,6450,4500,1950,0.6976744186046512,84,45,39,213.5383122776471,0.4690492543171115,0.7824049089622724,0.12721477746407994,1062792.3873584915,-260.62146038744413,1062531.765898104,4150,0,557.3163265306123,70,126,44,37.633740742856084,0.5456526360544218,43.11913145539905,8274.593537307073,118.20847910438677,0
4349,31.797594535439725,1,0,195,0.005128205128205128,0.0,1.0,195,6700,4400,2300,0.6567164179104478,90,44,46,217.8528751081107,0.46921975504449737,0.7860662407590162,0.1306235255202879,1051064.63016985,95.49032138890288,1051160.120491239,4151,0,559.4666666666667,71,124,41,37.28055367994596,0.547809829059829,42.881944444444436,8175.7356782962015,115.15120673656622,0
4350,32.159424219147745,2,2,195,0.01015228426395939,0.01015228426395939,0.9898477157360406,197,7050,5400,1650,0.7659574468085106,87,54,33,222.61672677925606,0.46965537484029146,0.7897603138338083,0.13154358738803096,1058565.5706090927,680.8804820420664,1059246.4510911347,4152,0,554.7766497461929,72,125,39,37.709943829597876,0.5472186971235194,43.421803652968016,8251.407061707938,114.6028758570547,8
4351,32.216445516186766,3,0,198,0.015151515151515152,0.0,1.0,198,5000,4000,1000,0.8,60,40,20,232.5271389435187,0.4694293826590781,0.7944426653145285,0.13436873601545324,1053551.9703367713,4395.885078143303,1057947.8554149147,4153,0,552.6515151515151,73,125,38,38.31003229120798,0.5389835858585859,44.25675675675676,8239.138262078846,112.86490769971023,8
4352,31.82910164337761,3,5,196,0.014925373134328358,0.024875621890547265,0.9751243781094527,201,6800,5300,1500,0.7794117647058824,83,53,30,229.88019449146276,0.46995232172470974,0.7965168562638945,0.13380415583455124,1043103.3229421595,957.7589505269789,1044061.0818926864,4154,0,545.3880597014926,79,122,36,38.099082833214666,0.5414593698175787,43.984375,8148.747350417846,103.14870063820058,0
4353,31.631129137568035,1,1,196,0.005076142131979695,0.005076142131979695,0.9949238578680203,197,6500,4800,1700,0.7384615384615385,82,48,34,204.1933546632901,0.4699467350391933,0.7655510536713501,0.11752030839647368,1033177.2939504776,-3706.4124772621976,1029470.8814732154,4155,0,556.1269035532995,78,119,42,39.190290101802134,0.5403976311336718,44.409282700421954,8084.622985266635,103.64901263162352,8
4354,31.362979106346792,3,2,197,0.01507537688442211,0.010050251256281407,0.9899497487437185,199,6700,5000,1700,0.746268656716418,84,50,34,197.6948840522113,0.47012313249750437,0.7615002617561017,0.11463604368761404,1026686.6432374115,-5905.86062144491,1020780.7826159666,4156,0,551.5025125628141,82,117,38,39.06801795173635,0.5428706030150754,44.12650602409641,8024.955045434271,97.86530543212525,0
4355,30.896716767677923,3,1,199,0.015,0.005,0.995,200,5950,3900,2050,0.6554621848739496,80,39,41,203.8989428015913,0.47052188023450586,0.7712735443980085,0.11947342616287752,1014518.1310949008,-4578.165123340928,1009939.9659715599,4157,0,547.145,70,130,41,38.510119081696935,0.54578125,43.735328638497634,7917.736968618359,113.11052812311942,0
4356,31.11993944351975,3,4,198,0.01485148514851485,0.019801980198019802,0.9801980198019802,202,6800,5400,1400,0.7941176470588235,82,54,28,187.82141385403094,0.47031190992233557,0.7571138183777224,0.10918804680987912,1019492.0283233684,-8903.513165478216,1010588.5151578902,4158,0,542.6782178217821,88,114,39,39.22325102880658,0.5455342409240924,44.03089887640449,7965.742926378472,90.51980598157354,8
4357,31.61376026784665,0,2,196,0.0,0.010101010101010102,0.98989898989899,198,5800,3600,2200,0.6206896551724138,80,36,44,191.02261496418038,0.46944166709395135,0.7572897282654574,0.11144546112651009,1036751.9010438998,-5791.388158701745,1030960.5128851981,4159,1,552.8737373737374,91,107,41,39.00504922115627,0.5471380471380471,43.89719202898551,8096.372775118019,88.9711293969013,0
4358,31.521243494330896,2,2,196,0.010101010101010102,0.010101010101010102,0.98989898989899,198,7250,5300,1950,0.7310344827586207,92,53,39,198.16688760841345,0.4691724777384676,0.7650734974172395,0.11690499167653304,1037067.8977303997,-5747.496493633407,1031320.4012367664,4160,0,553.6868686868687,73,125,41,38.39921847847958,0.5501893939393939,43.48254504504503,8085.749158181155,110.76368709837197,0
4359,31.86143196544969,1,5,192,0.005076142131979695,0.025380710659898477,0.9746192893401016,197,6950,4700,2250,0.6762589928057554,92,47,45,187.00531887521356,0.468765107565869,0.7525634027475883,0.10716577867646053,1039372.0833941046,-7476.378422977859,1031895.7049711267,4161,0,557.2233502538071,75,122,46,39.79573585175648,0.5389699661590525,44.57236842105265,8138.290105648624,108.51053474198166,8
4360,32.33445075798714,5,1,196,0.025380710659898477,0.005076142131979695,0.9949238578680203,197,6550,4500,2050,0.6870229007633588,86,45,41,233.5527100032278,0.4700093235263649,0.7983732726631936,0.12868453609534108,1042356.0819832304,2739.017547106172,1045095.0995303366,4162,0,558.010152284264,78,119,38,40.15358051617594,0.524164551607445,46.08386075949368,8210.238900930384,105.25947308885108,8
4361,32.763382063946274,5,2,199,0.024875621890547265,0.009950248756218905,0.9900497512437811,201,5450,3900,1550,0.7155963302752294,70,39,31,223.07474894765983,0.4709473466003317,0.7969033458957333,0.12381051228596834,1058544.010402309,1576.8878741088874,1060120.898276418,4163,0,547.860696517413,62,139,42,40.129710333463414,0.52337271973466,45.80026455026455,8328.44305309375,134.32972666280241,8
4362,33.189752197668476,6,1,204,0.02926829268292683,0.004878048780487805,0.9951219512195122,205,6200,4000,2200,0.6451612903225806,84,40,44,205.18127045775574,0.4727751873106966,0.7854811342965318,0.11255622584514591,1068481.0942277452,-3353.538325251778,1065127.5559024934,4164,0,537.9268292682926,73,132,43,41.0492714227597,0.5186991869918699,46.25563063063062,8421.712740923002,115.36592795784934,8
4363,33.611407512347434,8,10,202,0.03773584905660377,0.04716981132075472,0.9528301886792453,212,4950,3100,1850,0.6262626262626263,68,31,37,193.7072186995413,0.47445620584816234,0.7800938551597476,0.10770419657625124,1086537.6622880348,-5255.96228517672,1081281.7000028582,4165,0,519.4528301886793,70,142,44,40.80525263016176,0.5221108490566038,45.730633802816904,8546.351285159824,122.09073264514035,0
4364,33.12246819026365,3,0,205,0.014634146341463415,0.0,1.0,205,6900,5000,1900,0.7246376811594203,88,50,38,217.47949640851573,0.47428164355172964,0.7900170429608009,0.12228577728410522,1074381.9552354147,-1168.790685000943,1073213.1645504138,4166,0,535.3219512195122,69,136,44,39.75836449326169,0.5250508130081301,45.29761904761906,8436.371511079677,122.26625378376343,0
4365,32.73188226141122,3,5,203,0.014423076923076924,0.02403846153846154,0.9759615384615384,208,6850,4900,1950,0.7153284671532847,88,49,39,210.53666584788897,0.47462558451009534,0.7856947574059914,0.11931266122753512,1064218.2021634956,-3638.6095963725993,1060579.592567123,4167,0,528.5865384615385,75,133,39,39.628516079906845,0.5279947916666667,44.99725877192983,8346.719702214312,111.28959602952416,0
4366,32.88545289379006,2,1,204,0.00975609756097561,0.004878048780487805,0.9951219512195122,205,6050,3900,2150,0.6446280991735537,82,39,43,213.4973081060826,0.4744041925713374,0.7871227161120085,0.12128998014180103,1070003.7278149666,-1361.4168896060664,1068642.3109253605,4168,0,535.380487804878,74,131,41,39.45652075279939,0.5293191056910569,44.902777777777786,8388.987684725606,113.36469844223791,0
4367,33.07991128373176,2,1,205,0.009708737864077669,0.0048543689320388345,0.9951456310679612,206,6600,5100,1500,0.7727272727272727,81,51,30,210.6507766129162,0.4743922172231431,0.78545153974796,0.12022108895332777,1077801.741229717,-2392.0452350413498,1075409.6959946756,4169,0,533.757281553398,65,141,44,39.35122212604591,0.5308454692556634,44.72853535353536,8444.357403773323,129.9131908272819,0
4368,32.660556980178065,2,2,205,0.00966183574879227,0.00966183574879227,0.9903381642512077,207,7450,5500,1950,0.738255033557047,94,55,39,211.05907524862175,0.47505980019698885,0.7863815510489158,0.11905371137810598,1060415.7312621078,-4087.9272761457296,1056327.8039859622,4170,0,530.0579710144928,75,132,37,39.79713496844518,0.5272745571658615,45.175438596491226,8322.71210766818,110.96949476890906,8
4369,32.44458821829045,0,1,204,0.0,0.004878048780487805,0.9951219512195122,205,5900,4200,1700,0.711864406779661,76,42,34,210.13507961384977,0.4749442053244062,0.7827156506798338,0.11886341805892806,1054287.4837815622,-2591.4431319353052,1051696.0406496269,4171,1,536.0926829268293,78,127,37,39.711561670287225,0.5286585365853659,45.06856540084387,8271.14541946764,106.04032589061077,0
4370,32.12728621418935,4,2,206,0.019230769230769232,0.009615384615384616,0.9903846153846154,208,6550,4500,2050,0.6870229007633588,86,45,41,206.6510107015446,0.47550428511705684,0.7840312776304144,0.11797006516426857,1046847.4023218004,-4883.585251982272,1041963.817069818,4172,0,529.3028846153846,70,138,38,39.4428879310345,0.5316005608974359,44.718309859154964,8201.507924397003,117.1643989199572,0
4371,31.78004799924749,3,5,204,0.014354066985645933,0.023923444976076555,0.9760765550239234,209,5900,4200,1700,0.711864406779661,76,42,34,214.175464625361,0.4759059471230524,0.7974763567014185,0.1208676001115198,1031971.5617153846,-3495.4022578893782,1028476.1594574952,4173,0,527.2296650717703,73,136,37,39.69955994991901,0.5237739234449761,45.15765765765768,8098.901871880351,110.94386125863494,8
4372,32.246768162470175,1,0,205,0.004878048780487805,0.0,1.0,205,6500,4900,1600,0.7538461538461538,81,49,32,203.3919136874154,0.4752998963813167,0.78019704155375,0.1109410438294984,1036297.6477524545,-5345.087654772671,1030952.5600976818,4174,0,538.2926829268292,70,135,45,41.322458526234534,0.5146341463414634,46.47887323943659,8175.236998936029,116.78909998480042,8
4373,32.56817174924105,4,4,205,0.019138755980861243,0.019138755980861243,0.9808612440191388,209,6650,4700,1950,0.706766917293233,86,47,39,195.9358989008706,0.4763247991044044,0.7748933126214683,0.1077792926505196,1049355.388082766,-7328.721753906626,1042026.6663288594,4175,0,528.9712918660288,75,134,38,41.17471383834566,0.5169457735247209,46.14857456140348,8267.476822473796,110.23302429965062,0
4374,32.78887600902678,1,3,203,0.0048543689320388345,0.014563106796116505,0.9854368932038835,206,6950,5300,1650,0.762589928057554,86,53,33,202.15200802712945,0.4757296353303339,0.7806135858614025,0.11150375465387748,1057356.5751573162,-5400.649026252357,1051955.9261310638,4176,0,537.0873786407767,74,132,39,40.90784796281101,0.518456715210356,46.04166666666664,8327.008303125704,112.52713923142842,0
4375,33.12604214059876,3,1,205,0.014563106796116505,0.0048543689320388345,0.9951456310679612,206,6550,4500,2050,0.6870229007633588,86,45,41,200.18804068127258,0.47569016891625227,0.778952436129108,0.11167359058091735,1071918.1737062174,-4832.960207020616,1067085.2134991968,4177,0,537.9174757281553,67,139,41,40.510841311896556,0.5216929611650485,45.60355392156865,8427.147393212726,125.77831930168249,0
4376,33.37136511633476,3,5,203,0.014423076923076924,0.02403846153846154,0.9759615384615384,208,6500,4700,1800,0.7230769230769231,83,47,36,219.69960749240187,0.47620734237582063,0.8012934779270136,0.12017328608266113,1073371.0989315622,-936.1581742096428,1072434.9407573526,4178,0,533.4951923076923,71,137,39,40.79636310915904,0.516426282051282,46.36863425925925,8464.02491108888,119.21161846604056,8
4377,32.936138638333446,6,2,207,0.028708133971291867,0.009569377990430622,0.9904306220095693,209,6600,4700,1900,0.7121212121212122,85,47,38,200.90057789031593,0.47587815145380935,0.7807848482839908,0.10995047210101411,1059551.1611903212,-5827.111882501841,1053724.0493078195,4179,0,531.6698564593302,74,135,40,41.25132325831826,0.518092105263158,46.34722222222222,8354.343054887273,112.89652776874694,8
4378,33.37327107699101,2,5,204,0.009569377990430622,0.023923444976076555,0.9760765550239234,209,6900,4500,2400,0.6521739130434783,93,45,48,202.87350439257574,0.4759337427922954,0.7839070204875871,0.11192472970796628,1076269.7200122033,-5030.678045901723,1071239.0419663016,4180,0,532.5071770334928,77,132,38,40.881349581952946,0.5207834928229664,46.03365384615383,8475.687714625206,110.07386642370398,0
4379,33.39103503760058,3,1,206,0.014492753623188406,0.004830917874396135,0.9951690821256038,207,5900,4000,1900,0.6779661016949152,78,40,38,194.31836527839044,0.47602324781514316,0.7725986507863953,0.10670951900856744,1075310.118258699,-5509.49913053136,1069800.6191281676,4181,0,537.9903381642512,81,126,46,41.28291120232255,0.5203804347826086,46.21443089430894,8474.162830045529,104.61929419809294,7
4380,33.3229667917806,2,2,206,0.009615384615384616,0.009615384615384616,0.9903846153846154,208,7600,5700,1900,0.75,95,57,38,196.10000773857985,0.4763505667038275,0.7763583161909362,0.10860760428591777,1075923.3204219826,-7002.285707826352,1068921.0347141563,4182,0,536.3125,83,125,44,40.89970069620665,0.523036858974359,45.88293650793649,8467.934467970786,102.02330684302153,0
4381,33.65356776308029,3,1,208,0.014354066985645933,0.004784688995215311,0.9952153110047847,209,6050,4300,1750,0.7107438016528925,78,43,35,203.41473972495783,0.4762845433075696,0.7872931954817184,0.11272313520562303,1086787.462559048,-3636.282233441038,1083151.180325607,4183,0,534.6267942583733,75,134,44,40.6911785855535,0.5212818979266347,45.86074561403507,8552.69261873672,114.03590158315627,8
4382,33.54200105170962,4,2,210,0.018867924528301886,0.009433962264150943,0.9905660377358491,212,6800,5000,1800,0.7352941176470589,86,50,36,215.03196317840514,0.4775962025693761,0.7943615340390555,0.11858343163293172,1081573.7721620037,-2685.413689946585,1078888.3584720572,4184,0,528.0377358490566,76,136,37,40.58904219049646,0.5179834905660378,46.04978354978353,8517.998427254986,112.07892667440771,6
4383,33.75048219372965,6,2,214,0.027777777777777776,0.009259259259259259,0.9907407407407407,216,6550,4700,1850,0.7175572519083969,84,47,37,209.2542374774102,0.47794017370083264,0.7919572027689354,0.11708653135186341,1093132.8864888798,-4001.462275257987,1089131.4242136218,4185,0,519.2222222222222,71,145,41,40.160300136425604,0.521508487654321,45.48611111111109,8589.966475001293,120.98544330987735,0
4384,33.60315415398173,4,3,215,0.01834862385321101,0.013761467889908258,0.9862385321100917,218,6600,4500,2100,0.6818181818181818,87,45,42,206.08134899592022,0.4782162939162051,0.791716932699102,0.11677138025877722,1092499.952490389,-5171.227202560866,1087328.7252878284,4186,0,513.4357798165138,78,140,35,39.74761707775305,0.5250382262996942,45.00263713080166,8568.715693352407,109.85532940195394,0
4385,33.17529977429455,2,2,215,0.009216589861751152,0.009216589861751152,0.9907834101382489,217,5750,4200,1550,0.7304347826086957,73,42,31,227.29975389024705,0.47795681145815555,0.8131122298423143,0.12725110211052368,1074675.9643227863,-295.28355953343726,1074380.6807632528,4187,0,516.7327188940092,67,150,41,39.680127587867105,0.52088133640553,45.4656862745098,8444.252160687469,126.03361433861893,8
4386,32.828613320026804,5,3,217,0.022727272727272728,0.013636363636363636,0.9863636363636363,220,6500,4800,1700,0.7384615384615385,82,48,34,224.96959212350876,0.4786992355057424,0.8060394362789565,0.12385688533393108,1058027.828071642,-2895.1822126804445,1055132.6458589616,4188,0,510.6363636363636,73,147,41,40.403221335107546,0.5160511363636364,46.11486486486484,8334.696929054051,114.173930534987,7
4387,32.55697576958897,4,0,221,0.01809954751131222,0.0,1.0,221,7100,4900,2200,0.6901408450704225,93,49,44,223.96237974951205,0.4781314273961333,0.8065803365630599,0.12450550515437157,1052397.4356369823,-4160.513174491348,1048236.922462491,4189,0,509.2217194570136,64,157,43,40.04264885079208,0.5190422322775263,45.737179487179496,8278.028486543262,129.34419510223847,0
4388,32.693462247277644,3,2,222,0.013392857142857142,0.008928571428571428,0.9910714285714286,224,6350,4500,1850,0.7086614173228346,82,45,37,220.35642615070736,0.4784839279041213,0.8049150022869336,0.12363710856479873,1059776.935985507,-4444.268373857095,1055332.66761165,4190,0,503.38839285714283,68,156,44,39.76972904067355,0.5213448660714286,45.38043478260872,8324.395142853076,122.4175756301923,0
4389,32.84771338327688,7,2,227,0.03056768558951965,0.008733624454148471,0.9912663755458515,229,7450,5400,2050,0.7248322147651006,95,54,41,210.07681639005207,0.47947071554431936,0.8075423922377432,0.11862619877310286,1066835.0370214523,-8426.538361834078,1058408.4986596182,4191,0,491.5633187772926,78,151,38,39.780360253160204,0.5231986899563319,45.13449367088607,8371.749103182465,107.3301167074675,8
4390,32.92629890551195,2,0,229,0.008733624454148471,0.0,1.0,229,7850,5000,2850,0.6369426751592356,107,50,57,226.35616764826852,0.47938692254654103,0.8166257957680643,0.12725074807890716,1067952.3227778077,-5302.480996989713,1062649.841780818,4192,0,492.5414847161572,74,155,40,39.540389718980606,0.5237445414847162,45.30555555555556,8386.14540735109,113.32628928852824,8
4391,32.46123849105612,5,5,229,0.021367521367521368,0.021367521367521368,0.9786324786324786,234,7550,5000,2550,0.6622516556291391,101,50,51,222.68160956195766,0.4803393584241224,0.817833940703024,0.12643440322904367,1056017.7312544466,-7318.854375658956,1048698.8768787875,4193,0,482.9957264957265,85,149,37,39.24484978710603,0.5272881054131053,44.92490310077517,8280.053553574919,97.41239474794023,0
4392,32.73450521338732,3,6,226,0.01293103448275862,0.02586206896551724,0.9741379310344828,232,6900,5200,1700,0.7536231884057971,86,52,34,244.04911709890877,0.4797548297009504,0.8322986716378589,0.14038188386689104,1069044.0724598258,-1120.1475952716464,1067923.924864554,4194,0,488.0689655172414,71,161,36,38.19281300122654,0.5314744971264368,44.429976851851855,8365.958255128577,117.83039795955742,7
4393,32.9658879878087,3,4,225,0.013100436681222707,0.017467248908296942,0.982532751091703,229,8350,6300,2050,0.7544910179640718,104,63,41,240.0442021376581,0.4788841645598713,0.8287274529422199,0.13977636209262712,1080485.3334339135,-2277.152042882577,1078208.181391031,4195,0,495.31441048034935,75,154,38,37.82342969307638,0.5351164483260553,43.969298245614056,8440.279435475195,112.53705913966927,0
4394,32.81634578016711,0,5,220,0.0,0.022222222222222223,0.9777777777777777,225,6300,4400,1900,0.6984126984126984,82,44,38,235.55402610563635,0.47853257275132277,0.8222898254756281,0.13756878255040558,1076517.397001853,-584.3985926903661,1075932.9984091625,4196,1,503.99555555555554,76,149,38,37.824702475265,0.5366203703703704,43.858225108225135,8405.637053594273,110.60048754729307,0
4395,33.227962664109455,0,2,218,0.0,0.00909090909090909,0.990909090909091,220,6300,4900,1400,0.7777777777777778,77,49,28,243.9987721899364,0.4778945274664453,0.8263054979029509,0.14297998714948945,1091089.3376221112,2944.891745864982,1094034.229367976,4197,2,515.9090909090909,59,161,42,37.47974674254226,0.5378787878787878,43.73263888888887,8515.242307029821,144.3261407971156,0
4396,32.97007334472718,1,1,218,0.0045662100456621,0.0045662100456621,0.995433789954338,219,7000,5200,1800,0.7428571428571429,88,52,36,237.2350716580714,0.477678633767612,0.8214487697597905,0.14019093076884795,1085270.1241015461,692.827131918827,1085962.951233465,4198,0,519.2054794520548,62,157,43,37.33231838295312,0.540144596651446,43.419312169312164,8459.484096618315,136.44329188094056,0
4397,32.87300099791064,2,3,217,0.00909090909090909,0.013636363636363636,0.9863636363636363,220,6000,4000,2000,0.6666666666666666,80,40,40,230.00285562577247,0.47769259374567596,0.816331724556268,0.13552475954564724,1081168.506617769,-265.6312130524102,1080902.8754047165,4199,0,501.7772727272727,69,151,39,37.62782854656222,0.5440814393939394,43.52678571428571,8431.04422915162,122.18904679929884,8
4398,33.22153310215157,3,4,216,0.013636363636363636,0.01818181818181818,0.9818181818181818,220,6550,4800,1750,0.732824427480916,83,48,35,224.65398007079122,0.4776601632766016,0.8110257177033489,0.13338830066703208,1095048.7079872803,-1348.5898758561316,1093700.1181114241,4200,0,499.0,73,147,39,37.47510051169588,0.5465909090909091,43.243243243243235,8529.853093795657,116.84730265473502,0
4399,33.03167647737976,2,3,215,0.009174311926605505,0.013761467889908258,0.9862385321100917,218,5150,3500,1650,0.6796116504854369,68,35,33,221.3561646694208,0.47703471370791584,0.8049899759823329,0.13227086352044679,1090788.2794223474,-459.4580001424856,1090328.8214222048,4201,0,504.29357798165137,79,139,32,37.31913200249953,0.5490730122324159,43.0078125,8488.882794714118,107.45421259131795,0
4400,33.2604816541478,2,4,213,0.009216589861751152,0.018433179723502304,0.9815668202764977,217,6900,4900,2000,0.7101449275362319,89,49,40,221.44694826933437,0.476285593389088,0.8047763600408102,0.13281630784959403,1099509.5819783872,-1603.3916955987725,1097906.1902827884,4202,0,507.5069124423963,82,135,36,37.177453468697124,0.5508352534562212,42.871485943775106,8552.21822452537,104.2953442015289,0
4401,32.74446755708386,0,1,212,0.0,0.004694835680751174,0.9953051643192489,213,6950,4600,2350,0.6618705035971223,93,46,47,223.3289375545255,0.47525983996220506,0.8039640023178536,0.134216117502715,1083076.4982929595,-1173.5352691916014,1081902.963023768,4203,1,517.8920187793427,81,132,40,37.05317454437693,0.5522300469483568,42.79725609756097,8421.966903306344,103.97490004081907,0
4402,32.21936276607135,3,3,212,0.013953488372093023,0.013953488372093023,0.986046511627907,215,8350,6400,1950,0.7664670658682635,103,64,39,219.22372449862985,0.4749710207925813,0.8020422675641412,0.1329756468229668,1068518.2760851176,-4501.08876435298,1064017.1873207646,4204,0,514.0418604651163,74,141,39,36.81240899530819,0.5547480620155039,42.458333333333336,8297.828385711962,112.13281602313462,0
4403,31.994007593050824,0,1,211,0.0,0.0047169811320754715,0.9952830188679245,212,7550,5700,1850,0.7549668874172185,94,57,37,215.1927104268572,0.47428388327520943,0.7948539652342137,0.1312089405598776,1062599.1942771387,-4217.279857221638,1058381.9144199172,4205,1,520.3915094339623,75,137,39,36.72356945330783,0.5568985849056604,42.26973684210527,8245.823996432679,109.94431995243572,0
4404,32.05196771981817,5,1,215,0.023148148148148147,0.004629629629629629,0.9953703703703703,216,6100,4400,1700,0.7213114754098361,78,44,34,211.42518845275066,0.4749048952052828,0.7954108965507907,0.12360241786468487,1051754.506973252,-4826.5210314302,1046927.9859418217,4206,0,511.56481481481484,88,128,37,38.4039389924464,0.5424382716049383,43.82022471910112,8211.065887773633,93.30756690651856,8
4405,31.900265241216214,0,1,214,0.0,0.004651162790697674,0.9953488372093023,215,8050,5300,2750,0.6583850931677019,108,53,55,213.86376252619263,0.47455263348547416,0.7978712349041912,0.12584732161401774,1048770.1601593348,-6191.2135046257745,1042578.946654709,4207,1,514.9255813953488,71,144,39,38.09241706161137,0.5445251937984497,43.576388888888864,8179.981208554865,115.21100293739246,0
4406,32.06860376016666,2,2,214,0.009259259259259259,0.009259259259259259,0.9907407407407407,216,7500,5300,2200,0.7066666666666667,97,53,44,212.0565297066923,0.4741494401378122,0.7970049155984249,0.12581662521178458,1056823.1862452189,-5878.748522254104,1050944.4377229647,4208,0,513.4768518518518,75,141,40,37.826163846030646,0.546778549382716,43.27028508771929,8232.963500982452,109.77284667976603,0
4407,32.24103843078614,1,2,213,0.004651162790697674,0.009302325581395349,0.9906976744186047,215,6550,4400,2150,0.6717557251908397,87,44,43,209.5779426161534,0.4738906397160038,0.7938123139498612,0.12479944731514199,1063620.202004532,-4967.733267782656,1058652.4687367494,4209,0,516.6883720930233,77,138,43,37.752374267789676,0.5484980620155039,43.135683760683754,8281.572291369384,107.5528869009011,0
4408,32.63869710687333,1,3,211,0.004672897196261682,0.014018691588785047,0.985981308411215,214,7750,5700,2050,0.7354838709677419,98,57,41,209.10562540122208,0.47375883024000703,0.7928702292728562,0.12538568523987037,1078884.2877746534,-5429.845253865583,1073454.442520788,4210,0,519.5327102803739,84,130,35,37.50337607041294,0.5513045171339563,42.87990196078433,8392.064999991584,99.90553571418552,0
4409,32.38179296494611,0,1,210,0.0,0.004739336492890996,0.995260663507109,211,6450,4400,2050,0.6821705426356589,85,44,41,208.4095473956582,0.47304126231851346,0.7904795546242058,0.12542959413818083,1071518.4598920557,-3987.0645495606423,1067531.395342495,4211,1,526.2132701421801,85,126,40,37.38322386490266,0.5528732227488151,42.744670542635674,8330.388817617413,98.00457432491075,0
4410,32.123844460867325,2,1,211,0.009433962264150943,0.0047169811320754715,0.9952830188679245,212,7050,5400,1650,0.7659574468085106,87,54,33,204.87090476150428,0.47287037244031116,0.7882454630621385,0.1245542580275699,1066040.0681028152,-5769.881347151961,1060270.1867556632,4212,0,522.1179245283018,74,138,42,37.09701331608172,0.5555719339622642,42.375000000000014,8275.905429230977,111.83655985447267,0
4411,31.688158446125506,0,1,210,0.0,0.004739336492890996,0.995260663507109,211,7350,5700,1650,0.7755102040816326,90,57,33,202.96955580460377,0.472409350786128,0.7859543526409589,0.12392133565705653,1052836.6510656625,-6811.24251967911,1046025.4085459834,4213,1,524.4123222748815,76,135,41,36.9891979357999,0.5575138230647709,42.221320346320354,8168.531644898847,107.48067953814272,0
4412,31.83745325892172,0,4,206,0.0,0.01904761904761905,0.9809523809523809,210,7000,5000,2000,0.7142857142857143,90,50,40,203.39655617939488,0.47227870813397127,0.7858208127122213,0.12457313340882661,1058732.3442045522,-5931.49745461127,1052800.846749941,4214,2,527.6761904761905,77,133,42,36.86192455077416,0.5591765873015873,42.1073717948718,8210.644496301267,106.63174670521127,0
4413,31.519992278749374,0,1,205,0.0,0.0048543689320388345,0.9951456310679612,206,7100,5200,1900,0.7323943661971831,90,52,38,206.00444259537315,0.47155606204120293,0.7844608920939682,0.12631015251704905,1048501.0976302564,-5100.823164408319,1043400.2744658481,4215,3,531.9174757281553,77,129,36,36.75377964171069,0.5607301779935275,42.0673076923077,8130.03646997552,105.58488922046129,0
4414,31.1446043713782,0,2,203,0.0,0.00975609756097561,0.9902439024390244,205,6100,4600,1500,0.7540983606557377,76,46,30,204.5780055669541,0.47141220309261916,0.7739369458718937,0.1223845704237513,1028808.555776619,-5005.679509799797,1023802.8762668192,4216,4,532.0634146341464,88,117,36,37.70747006056194,0.5571646341463414,42.965823970037476,8005.227722376426,90.96849684518666,8
4415,31.316114162955532,0,0,203,0.0,0.0,1.0,203,6450,4900,1550,0.7596899224806202,80,49,31,211.22125545198222,0.4712745289307256,0.7799986430919388,0.1267669868620257,1035428.9700769463,-3309.0786017983573,1032119.8914751479,4217,5,537.7339901477833,89,114,37,37.41560896570354,0.5587027914614122,42.84722222222226,8053.025746210116,90.48343535067546,0
4416,31.253879580666208,0,2,201,0.0,0.009852216748768473,0.9901477832512315,203,6350,4700,1650,0.7401574803149606,80,47,33,211.8920979539974,0.47099814661269085,0.7821797278240161,0.12775440034428215,1034723.7832453458,-3100.0413530491733,1031623.7418922966,4218,6,538.7339901477833,70,133,38,37.22656175760689,0.5602935139573071,42.67899061032865,8042.279841040284,114.8897120148612,0
4417,30.98787348502703,2,2,201,0.009852216748768473,0.009852216748768473,0.9901477832512315,203,7250,5200,2050,0.7172413793103448,93,52,41,217.04327257245427,0.47098392105220377,0.7858872192529984,0.12911491712045658,1021982.8511068114,-3487.099496570405,1018495.751610241,4219,0,539.4137931034483,73,130,41,37.598600073079375,0.5518267651888342,43.17286036036034,7958.526910674473,109.02091658458181,7
4418,31.128110118034183,0,1,200,0.0,0.004975124378109453,0.9950248756218906,201,6500,4600,1900,0.7076923076923077,84,46,38,214.32753515000525,0.4707690713101161,0.7822480936577534,0.12800155117318787,1027768.0644828579,-2644.200806699857,1025123.8636761581,4220,1,545.2786069651742,74,127,39,37.52015547868698,0.5531198175787728,43.02777777777774,7999.059630609205,108.0954004136379,0
4419,31.231858241127,2,1,201,0.009900990099009901,0.0049504950495049506,0.995049504950495,202,6700,5400,1300,0.8059701492537313,80,54,26,213.86877928074466,0.47109645666059147,0.7851140829954235,0.12431985169803379,1023132.9800492856,-3336.7597029974268,1019796.2203462882,4221,0,543.3564356435644,76,126,38,38.559779257615006,0.5418729372937294,44.034090909090935,7994.290987288537,105.18803930642811,8
4420,31.570899675655546,0,2,199,0.0,0.009950248756218905,0.9900497512437811,201,7000,4400,2600,0.6285714285714286,96,44,52,212.74650892855985,0.47092247097844114,0.7814376841095585,0.12429761765941884,1035780.6219585531,-3128.2577324928316,1032652.3642260602,4222,1,546.9950248756219,77,124,42,38.39384243087777,0.5434805140961858,43.84348290598292,8087.091702440588,105.02716496676088,0
4421,32.06805646072371,0,2,197,0.0,0.010050251256281407,0.9899497487437185,199,6950,5200,1750,0.7482014388489209,87,52,35,212.61637207266776,0.47086759555352525,0.779157210507043,0.12444461873843686,1052642.738368728,-1988.1839758802835,1050654.5543928477,4223,2,553.3618090452261,78,121,42,38.3286374708385,0.5449120603015075,43.7763713080169,8216.59379146607,105.34094604443679,0
4422,32.18395755060769,0,1,196,0.0,0.005076142131979695,0.9949238578680203,197,5700,3700,2000,0.6491228070175439,77,37,40,245.2149522911019,0.47065571152318797,0.8094886054537489,0.13843370075558378,1045199.4988333727,6159.709048221733,1051359.2078815945,4224,3,559.0507614213197,67,130,33,38.89454478972571,0.529399323181049,45.143995098039206,8202.27484328215,122.42201258630075,8
4423,32.107253506708005,3,1,198,0.01507537688442211,0.005025125628140704,0.9949748743718593,199,6300,4100,2200,0.6507936507936508,85,41,44,239.7466779028716,0.4714544946957007,0.808622853485079,0.13721437305922116,1046993.197621153,4102.628183315293,1051095.8258044682,4225,0,554.1155778894472,60,139,38,38.49827259556448,0.5324539363484087,44.62090163934427,8199.521451380102,136.65869085633503,0
4424,31.803654466586558,4,3,199,0.019801980198019802,0.01485148514851485,0.9851485148514851,202,6850,5400,1450,0.7883211678832117,83,54,29,223.60859437322094,0.4722489039948771,0.798993271057231,0.12658703047347508,1033711.2772497307,-1020.6548612880961,1032690.6223884425,4226,0,546.1336633663366,71,131,42,39.33643770451495,0.5284653465346535,45.03761574074075,8108.7355709585645,114.20754325293753,8
4425,32.10745995266379,3,0,202,0.01485148514851485,0.0,1.0,202,6800,4800,2000,0.7058823529411765,88,48,40,216.62288778586233,0.4730298589560449,0.7928595407524441,0.12386852929491352,1046719.9082912352,-1851.3021526000825,1044868.6061386351,4227,0,545.6485148514852,60,142,45,39.12369870037229,0.5313531353135313,44.65505464480873,8198.477607106899,136.64129345178165,0
4426,31.69110301993096,4,2,204,0.019417475728155338,0.009708737864077669,0.9902912621359223,206,6250,4200,2050,0.672,83,42,41,218.7742892154838,0.4738081142947352,0.7988564867876826,0.12435290538436293,1031304.2238305077,-2325.430293310746,1028978.7935371969,4228,0,536.0339805825242,79,127,41,39.30150436380341,0.5306432038834952,44.882812500000014,8084.945071217577,102.3410768508554,8
4427,31.813790650565352,1,0,205,0.004878048780487805,0.0,1.0,205,7000,5000,2000,0.7142857142857143,90,50,40,216.9914566636007,0.47353837876614063,0.7965821003444344,0.12389919904508796,1036697.5095754609,-3009.0994555388975,1033688.410119922,4229,0,538.3073170731707,63,142,40,39.1707177770694,0.5326219512195122,44.71028645833332,8121.733501857356,128.9164047913866,0
4428,31.825929762076353,2,0,207,0.00966183574879227,0.0,1.0,207,7100,4800,2300,0.676056338028169,94,48,46,214.15377276281674,0.47367423354126603,0.7950431070844084,0.12346180590822789,1040061.1571167563,-3953.395859877255,1036107.7612568791,4230,0,534.096618357488,69,138,42,38.87029491656964,0.5350744766505636,44.345238095238095,8136.450495721307,117.91957240175807,0
4429,32.2943699389749,2,0,209,0.009569377990430622,0.0,1.0,209,5800,4300,1500,0.7413793103448276,73,43,30,210.50376458549863,0.4744691985645933,0.7939099236170373,0.12206457640849572,1057179.182613689,-3091.960443679783,1054087.2221700093,4231,0,529.976076555024,71,138,36,38.739916694937605,0.536981658692185,44.1261574074074,8263.284530392195,116.38428916045345,0
4430,32.409985056259316,3,1,211,0.014150943396226415,0.0047169811320754715,0.9952830188679245,212,6200,4400,1800,0.7096774193548387,80,44,36,208.7755954160045,0.47493218873885956,0.7967179527018582,0.12223916232062508,1063974.7334951416,-4173.6083013933185,1059801.1251937484,4232,0,523.4622641509434,77,135,42,38.41375888188181,0.5397012578616351,43.763354700854705,8304.625845011333,107.85228370144588,0
4431,32.06613224149594,2,6,207,0.009389671361502348,0.028169014084507043,0.971830985915493,213,6400,4000,2400,0.625,88,40,48,205.65383962597107,0.47484738093129003,0.7941476630694766,0.12118810549447152,1054657.7995384207,-5621.114806689397,1049036.6847317314,4233,0,521.9859154929577,68,145,44,38.24901406792632,0.5418133802816901,43.52355072463767,8224.207739293071,120.94423146019223,0
4432,31.842932450566984,4,0,211,0.018957345971563982,0.0,1.0,211,7850,5500,2350,0.7006369426751592,102,55,47,201.76253327549622,0.47440476190476194,0.7884856490334768,0.11986584716183726,1049782.322674272,-7688.651837880949,1042093.6708363912,4234,0,526.8483412322275,70,141,46,38.04100959890298,0.5444806477093207,43.22183098591548,8176.569890695735,116.80814129565336,0
4433,31.632195898773034,0,1,210,0.0,0.004739336492890996,0.995260663507109,211,6600,4500,2100,0.6818181818181818,87,45,42,203.3390638770499,0.4741518092228993,0.7902231969844922,0.12128316371304124,1044026.8779636442,-6341.710394478798,1037685.1675691655,4235,1,527.8483412322275,70,141,41,37.85083085883966,0.545862954186414,43.07511737089201,8127.0982185931925,116.10140312275989,0
4434,31.686513692736387,2,3,209,0.009433962264150943,0.014150943396226415,0.9858490566037735,212,6700,4700,2000,0.7014925373134329,87,47,40,208.9855595076132,0.47419213314852904,0.7957566266900917,0.1259010565814161,1048807.7874783848,-5262.863543577394,1043544.9239348074,4236,0,525.9622641509434,66,146,46,37.33130904183534,0.5484964622641509,42.70833333333334,8152.675918860321,123.52539271000487,0
4435,31.358046344926496,0,1,208,0.0,0.004784688995215311,0.9952153110047847,209,6000,4400,1600,0.7333333333333333,76,44,32,216.06553245116683,0.4737206324377377,0.7951293252895091,0.12808008366950527,1033138.7588479802,-3154.8647947151044,1029983.8940532651,4237,1,534.1148325358852,69,140,41,37.757246376811565,0.5432615629984051,43.3035714285714,8049.498503719914,116.65939860463644,8
4436,30.961946003373942,1,2,207,0.004784688995215311,0.009569377990430622,0.9904306220095693,209,5500,3600,1900,0.6545454545454545,74,36,38,211.58697530864322,0.47403117715617715,0.7907522594364707,0.12594462815990562,1021304.1041293917,-4081.070747392152,1017223.0333819996,4238,0,534.3588516746412,72,137,37,37.716087962962916,0.5448564593301435,43.15068493150682,7952.554624154196,110.45214755769717,0
4437,31.031497030601166,1,1,207,0.004807692307692308,0.004807692307692308,0.9951923076923077,208,6200,4500,1700,0.7258064516129032,79,45,34,215.71247981545568,0.47388526957141086,0.7841606334841627,0.12355499180804401,1012147.8291622968,-4133.416366314177,1008014.4127959827,4239,0,537.3846153846154,77,131,38,39.08186274509805,0.5333032852564102,44.59134615384615,7925.712883416762,102.93133614826964,8
4438,31.421715414889466,7,4,210,0.03271028037383177,0.018691588785046728,0.9813084112149533,214,6050,4200,1850,0.6942148760330579,79,42,37,212.69682565085338,0.4754787160136311,0.7880634260394508,0.12374614501335822,1029615.2133349684,-5050.822496364885,1024564.3908386035,4240,0,523.2616822429907,86,128,36,38.55642860483607,0.5372371495327103,44.00143678160921,8043.914000068899,93.53388372173139,0
4439,31.35168479959881,0,0,210,0.0,0.0,1.0,210,5850,4300,1550,0.7350427350427351,74,43,31,215.77691544580125,0.47500949343054605,0.7854980095837354,0.12560938203739816,1027491.4455222996,-3508.213047649773,1023983.2324746498,4241,1,531.9761904761905,85,125,37,38.45581799687755,0.5380952380952381,43.98013565891475,8026.6540892578,94.43122457950352,0
4440,31.25153050187737,0,1,209,0.0,0.004761904761904762,0.9952380952380953,210,6900,5300,1600,0.7681159420289855,85,53,32,217.38743190968705,0.47472326649958224,0.7872829230710936,0.1269421395111241,1025144.7002928158,-4329.285253503754,1020815.4150393121,4242,2,532.9761904761905,91,119,39,38.2951330563169,0.5395337301587302,43.863224637681164,8004.66624788803,87.96336536140691,0
4441,31.684216048024137,0,1,208,0.0,0.004784688995215311,0.9952153110047847,209,6400,4600,1800,0.71875,82,46,36,215.87032408491646,0.4748660057048215,0.7839352608399244,0.12653364843174572,1040485.7616898473,-3278.0002836538497,1037207.7614061935,4243,3,535.4066985645933,73,136,41,38.18956204914134,0.5409688995215312,43.72184684684688,8119.972372893196,111.2324982588109,0
4442,32.018723540168835,1,1,208,0.004784688995215311,0.004784688995215311,0.9952153110047847,209,7250,5300,1950,0.7310344827586207,92,53,39,213.70439650586542,0.47484779474911054,0.781153762720725,0.126544068786769,1054577.661033918,-3976.423476035311,1050601.2375578827,4244,0,535.8086124401914,81,128,39,37.85863360390683,0.5437101275917066,43.34349593495939,8217.813648444866,101.45448948697366,0
4443,32.08061307461635,4,3,209,0.018867924528301886,0.014150943396226415,0.9858490566037735,212,5950,3800,2150,0.6386554621848739,81,38,43,212.54228722466775,0.47485115055590327,0.7849933532178233,0.12698751022019233,1059341.992110161,-3319.006008753685,1056022.9861014073,4245,0,529.1603773584906,88,124,33,37.55057233076775,0.5463836477987422,43.01264044943823,8244.31204680896,93.68536416828364,0
4444,32.44677862455159,2,1,210,0.009478672985781991,0.004739336492890996,0.995260663507109,211,7050,5300,1750,0.75177304964539,88,53,35,218.634990643537,0.4745467539306402,0.7910579942323497,0.13142977196213992,1073310.6170190712,-2317.348658084903,1070993.2683609864,4246,0,532.1848341232228,91,120,37,37.164027307009476,0.5485288309636651,42.78759057971017,8345.714107947739,91.71114404338175,0
4445,32.130832882980414,0,2,208,0.0,0.009523809523809525,0.9904761904761905,210,7250,5000,2250,0.6896551724137931,95,50,45,215.52000212017143,0.47445270372901954,0.7870486029227177,0.13017851784543852,1064307.8389930385,-3374.0744567412785,1060933.7645362972,4247,1,528.3666666666667,75,135,36,37.06517253314873,0.5498511904761905,42.61239035087718,8270.078271785726,110.26771029047634,0
4446,32.35138653233148,2,0,210,0.009523809523809525,0.0,1.0,210,5700,4100,1600,0.7192982456140351,73,41,32,236.72906623015285,0.47423862687020585,0.816449223617703,0.1404108047172568,1066044.976383611,2772.7663637275355,1068817.7427473387,4248,0,528.3142857142857,68,142,42,37.20474370283248,0.5449404761904761,43.28200483091788,8305.183091520188,122.13504546353218,8
4447,31.841656169701658,3,2,211,0.014084507042253521,0.009389671361502348,0.9906103286384976,213,6900,5200,1700,0.7536231884057971,86,52,34,230.60201355369315,0.47441923553902027,0.8137935907993983,0.13800531841051056,1051948.9205195473,-983.6921545117557,1050965.2283650355,4249,0,521.8591549295775,76,137,39,37.02425749521953,0.5472906885758999,42.951839826839816,8184.839135288136,107.69525178010706,0
4448,32.244412918529044,2,0,213,0.009389671361502348,0.0,1.0,213,7250,5500,1750,0.7586206896551724,90,55,35,232.44537610706465,0.47420885375143945,0.8169682104987694,0.14048503381997374,1068249.894150121,-188.05031558866858,1068061.8438345322,4250,0,522.7746478873239,61,152,41,36.60736625111502,0.5493935837245696,42.59072580645161,8300.010926155628,136.06575288779717,0
4449,32.70641508042679,2,4,211,0.009302325581395349,0.018604651162790697,0.9813953488372094,215,6450,4800,1650,0.7441860465116279,81,48,33,229.14700123107622,0.4741840541911179,0.8163365078525646,0.13947044123372426,1085718.4854819274,307.8270258658508,1086026.3125077933,4251,0,518.9023255813953,63,152,40,36.42964489503716,0.551453488372093,42.333984375,8427.331659150985,133.76716919287279,0
4450,32.60867435501507,1,0,212,0.0047169811320754715,0.0,1.0,212,7150,5000,2150,0.6993006993006993,93,50,43,227.8294216102683,0.4735373073713076,0.8125498873200356,0.1399186314656105,1085208.653276383,-101.50803951663238,1085107.1452368663,4252,0,526.2688679245283,66,146,36,36.130905749065924,0.5538030660377358,42.008706467661696,8412.754077225136,127.46597086704752,0
4451,32.30655277479687,0,0,212,0.0,0.0,1.0,212,6200,4000,2200,0.6451612903225806,84,40,44,228.58234193590908,0.47335194417121224,0.8124559718047988,0.14108605650810951,1076660.3721776416,621.1098683906139,1077281.4820460323,4253,1,527.2688679245283,70,142,38,35.9266967854369,0.5557684748427674,41.828051643192495,8340.645674561352,119.15208106516218,0
4452,31.831519333336026,0,3,209,0.0,0.014150943396226415,0.9858490566037735,212,7600,5600,2000,0.7368421052631579,96,56,40,235.76307510303607,0.4732117574294316,0.8166548665085087,0.14611418625354805,1062036.9397884065,77.81895950658509,1062114.7587479132,4254,2,528.2688679245283,71,141,40,35.590929244842734,0.5572916666666667,41.68113425925927,8222.68196899184,115.81242209847662,0
4453,31.52234501015089,3,2,210,0.014150943396226415,0.009433962264150943,0.9905660377358491,212,5550,3900,1650,0.7027027027027027,72,39,33,233.51161943633508,0.47298913529464365,0.8145824306919822,0.14630142652505118,1054889.9938289672,1315.8141572375484,1056205.8079862047,4255,0,527.8915094339623,63,149,39,35.251192723078525,0.559748427672956,41.292317708333336,8155.072817974425,129.44560028530833,0
4454,31.862923360479062,0,3,207,0.0,0.014285714285714285,0.9857142857142858,210,7350,5100,2250,0.6938775510204082,96,51,45,238.03345986775895,0.4725056011240221,0.8153146300620295,0.14971637242149743,1067429.1431019579,1466.7704192474312,1068895.9135212053,4256,1,532.8714285714286,64,146,41,34.992441596499916,0.5608630952380953,41.15384615384617,8247.595162154801,128.86867440866877,0
4455,32.32388270445585,0,3,204,0.0,0.014492753623188406,0.9855072463768116,207,6550,4600,1950,0.7022900763358778,85,46,39,253.55012460845307,0.47215870894110656,0.8247415963854452,0.1534754427731984,1071348.736334154,6378.121119326749,1077726.8574534806,4257,2,540.9130434782609,59,148,34,36.0066868959317,0.5485104669887279,42.53472222222223,8322.277439359039,141.05554981964474,8
4456,31.888216837747237,1,0,205,0.004878048780487805,0.0,1.0,205,6200,3900,2300,0.6290322580645161,85,39,46,253.7358897660057,0.4718256814921091,0.8233508611935756,0.15408019972747375,1057867.1964497522,6483.774869089835,1064350.9713188421,4258,0,546.9170731707317,60,145,40,35.88225382303547,0.5501524390243903,42.41803278688527,8213.829623985348,136.8971603997558,0
4457,32.12453059428473,1,2,204,0.0048543689320388345,0.009708737864077669,0.9902912621359223,206,6050,4000,2050,0.6611570247933884,81,40,41,256.17794102642506,0.4719413529086747,0.8254094341472977,0.15655318618281597,1067615.1677605053,7449.891097093787,1075065.058857599,4259,0,545.257281553398,61,145,39,35.58291245791247,0.5519822006472492,42.18750000000002,8282.105543839072,135.77222203014873,0
4458,32.55368792795866,2,4,202,0.009708737864077669,0.019417475728155338,0.9805825242718447,206,6300,4500,1800,0.7142857142857143,81,45,36,238.18968681075827,0.4721500315731313,0.807597109962046,0.14310962735019192,1076685.6624637078,3791.084147172536,1080476.7466108804,4260,0,544.3446601941747,73,133,40,36.68079424589056,0.5519316343042071,42.806869369369345,8372.584911764194,114.69294399676977,8
4459,32.876460993584764,2,0,204,0.00980392156862745,0.0,1.0,204,6150,4200,1950,0.6829268292682927,81,42,39,225.9933778927088,0.4713031045751634,0.7947628314071145,0.14161378425810153,1100253.8978733649,2780.0189840045205,1103033.9168573695,4261,0,549.8872549019608,73,131,38,35.43984756152858,0.5693933823529411,41.28659909909912,8505.581033236178,116.51480867446818,8
4460,32.678205555286496,0,4,200,0.0,0.0196078431372549,0.9803921568627451,204,5800,3700,2100,0.6379310344827587,79,37,42,224.78040829526674,0.4710988562091503,0.7938881759015823,0.14130336984846312,1094577.5526807904,2607.9178404846252,1097185.470521275,4262,1,550.8872549019608,75,129,42,35.3553272611735,0.5705167483660131,41.1732456140351,8457.993883032248,112.7732517737633,0
4461,32.16119107426471,1,0,201,0.004975124378109453,0.0,1.0,201,6250,4600,1650,0.736,79,46,33,225.28661380304055,0.4707400497512438,0.7918274058939636,0.14237321194884253,1078822.573174741,2158.8568809641733,1080981.4300557051,4263,0,552.6467661691543,77,124,36,35.150328692962105,0.572294776119403,40.98557692307693,8330.212351567372,108.18457599438146,0
4462,32.39182483677989,2,4,199,0.009852216748768473,0.019704433497536946,0.9802955665024631,203,5700,3800,1900,0.6666666666666666,76,38,38,223.55119150796304,0.4708487782275765,0.7955419478173593,0.13479037415840806,1072412.3963116969,1647.813796678025,1074060.210108375,4264,0,548.192118226601,66,137,39,36.92475781926572,0.5557779146141215,42.677238805970156,8335.15380711357,126.29020919869045,8
4463,32.2335893194504,1,2,198,0.005,0.01,0.99,200,7100,5100,2000,0.7183098591549296,91,51,40,218.34839429718005,0.46970006281407034,0.78664997217585,0.12847808269549144,1059709.0435119222,-822.8463853944995,1058886.1971265278,4265,0,557.1,72,128,38,37.97985067705434,0.5458854166666667,43.578767123287655,8265.37671333506,114.79689879632026,8
4464,31.747208926125428,3,2,199,0.014925373134328358,0.009950248756218905,0.9900497512437811,201,5800,4100,1700,0.7068965517241379,75,41,34,215.52030491211104,0.46959991708126037,0.7861525306353068,0.12777713804048477,1046008.1853968838,-912.7993885401334,1045095.3860083437,4266,0,551.0199004975125,75,126,40,37.76524151494117,0.5479892205638475,43.29769736842104,8149.581633462185,108.66108844616247,0
4465,31.65878482511998,1,1,199,0.005,0.005,0.995,200,5800,3900,1900,0.6724137931034483,77,39,38,216.2351544569655,0.46958542713567836,0.786535942616561,0.12899684144488474,1044954.9395751483,-608.8014480800457,1044346.1381270683,4267,0,552.62,77,123,40,37.51315686886013,0.5506249999999999,43.068910256410234,8134.126085075845,105.63800110488111,0
4466,31.81583277260352,0,2,197,0.0,0.010050251256281407,0.9899497487437185,199,5850,4100,1750,0.7008547008547008,76,41,35,187.37183374664946,0.46922745038322927,0.7474313676248643,0.11117982266646498,1048517.6749612024,-6357.464105349066,1042160.2108558534,4268,1,556.1005025125628,81,118,40,38.456828302820405,0.5538630653266332,43.26727642276424,8168.165400588407,100.84154815541243,8
4467,31.981790526070093,0,2,195,0.0,0.01015228426395939,0.9898477157360406,197,6400,4500,1900,0.703125,83,45,38,195.88472118329827,0.4686377723678304,0.7648832749542163,0.11458214832283367,1049625.452357659,-4678.882183604852,1044946.5701740542,4269,2,556.1624365482234,84,113,44,38.780433846742554,0.5455795262267343,43.79901960784317,8193.766087475844,97.54483437471242,8
4468,31.78052939374928,1,2,194,0.00510204081632653,0.01020408163265306,0.9897959183673469,196,7150,5600,1550,0.7832167832167832,87,56,31,185.8374298453226,0.46861263736263736,0.7474839045729755,0.1101027553649063,1046897.2257485061,-7439.46205093946,1039457.7636975667,4270,0,558.4489795918367,82,114,46,38.5532792228959,0.5538903061224489,43.32329317269079,8157.321626016133,99.47953202458699,8
4469,31.889009983899154,2,1,195,0.01020408163265306,0.00510204081632653,0.9948979591836735,196,7550,5800,1750,0.7682119205298014,93,58,35,185.17845653604024,0.4685619440083726,0.7465835995860266,0.11066362427343789,1053083.6866012665,-7748.317662378551,1045335.368938888,4271,0,559.2295918367347,87,109,38,38.24525394193421,0.5566007653061225,43.00426136363639,8195.339675194602,94.1993066114322,0
4470,31.760197108673417,0,0,195,0.0,0.0,1.0,195,5950,4000,1950,0.6722689075630253,79,40,39,220.72444971083388,0.46807538109084496,0.7861694615789006,0.12949691380543712,1043257.9741570618,1104.5084504510041,1044362.4826075127,4272,1,563.0974358974358,66,129,37,38.03037425694529,0.5472222222222223,43.687810945273604,8140.525645733617,123.34129766263057,8
4471,31.292493171425203,0,0,195,0.0,0.0,1.0,195,6400,4500,1900,0.703125,83,45,38,235.1242365708954,0.4678672129703057,0.7969648923536947,0.13387575972098326,1018854.8834407591,2511.4953291073125,1021366.3787698664,4273,2,564.0974358974358,80,115,37,38.817425120529464,0.5359508547008547,44.81738683127571,7985.300180048725,99.81625225060907,8
4472,31.338289894749465,6,2,199,0.029850746268656716,0.009950248756218905,0.9900497512437811,201,7050,5400,1650,0.7659574468085106,87,54,33,227.5010540583667,0.46932110281923717,0.7950794641674834,0.1312944954612716,1024443.1955320914,-637.6186387052412,1023805.5768933862,4274,0,548.2288557213931,74,127,41,38.488479992757576,0.5396973466003316,44.305555555555586,8013.026624476979,108.28414357401323,0
4473,31.25761527713722,7,4,202,0.03398058252427184,0.019417475728155338,0.9805825242718447,206,5350,3700,1650,0.6915887850467289,70,37,33,236.47092803279952,0.4714154629410372,0.8099296526511397,0.1343810315120915,1017127.8020244762,1554.2310545379596,1018682.0330790142,4275,0,534.7233009708738,72,134,36,38.858979378752274,0.5317556634304207,44.89155251141553,7974.081705545956,110.75113479924939,8
4474,31.103573488495336,6,1,207,0.028846153846153848,0.004807692307692308,0.9951923076923077,208,5650,4000,1650,0.7079646017699115,73,40,33,227.33868983185153,0.472391575312771,0.8048678641085578,0.13073737891984782,1015706.6606406413,-1068.1157032941655,1014638.5449373472,4276,0,530.4903846153846,67,141,39,38.629455633479196,0.534755608974359,44.43933823529412,7948.849823967041,118.63954961144837,0
4475,31.508778403358257,1,1,207,0.004807692307692308,0.004807692307692308,0.9951923076923077,208,6650,4900,1750,0.7368421052631579,84,49,35,223.59392704014527,0.47245834881704446,0.8019604464653329,0.12931131958162928,1030655.9484380211,-2160.317812291388,1028495.6306257297,4277,0,531.1778846153846,69,139,42,38.50724342564578,0.5367588141025641,44.22619047619048,8059.120285668492,116.79884471983323,0
4476,32.02868601965102,1,1,207,0.004807692307692308,0.004807692307692308,0.9951923076923077,208,5600,4000,1600,0.7142857142857143,72,40,32,196.95601578272377,0.47250479995045214,0.7748700884750592,0.1147277435410784,1049878.7429972857,-5844.013144855854,1044034.7298524298,4278,0,532.1586538461538,80,128,39,38.91281600535744,0.5407652243589743,43.955761316872454,8200.760527922544,102.50950659903181,8
4477,31.64596769718546,2,5,204,0.009569377990430622,0.023923444976076555,0.9760765550239234,209,5950,4000,1950,0.6722689075630253,79,40,39,222.9627877671383,0.4721190268065268,0.8026229528610966,0.13025349049063523,1038213.1477852499,-1453.4204546607257,1036759.7273305891,4279,0,530.5933014354067,74,135,41,38.135968479459244,0.5412181020733653,43.84722222222224,8106.202531099929,109.54327744729633,8
4478,31.273676350038464,0,3,201,0.0,0.014705882352941176,0.9852941176470589,204,5950,4200,1750,0.7058823529411765,77,42,35,225.1000413347753,0.47109634083518465,0.8007990824934081,0.1319592423997528,1027039.2042716488,-512.6865332035841,1026526.5177384452,4280,1,540.8529411764706,63,141,40,37.948526609932706,0.5423815359477124,43.71744791666666,8014.897588016016,127.22059663517486,0
4479,30.86185404309689,1,1,201,0.0049504950495049506,0.0049504950495049506,0.995049504950495,202,7300,5700,1600,0.7808219178082192,89,57,32,224.97836274183408,0.47039759946143866,0.7977088062659878,0.1329886425032674,1015964.1321528614,-1986.0105887642758,1013978.1215640971,4281,0,547.0990099009902,66,136,42,37.63519449830344,0.5446575907590758,43.40796019900497,7918.906080958803,119.98342546907277,0
4480,31.32111956110205,0,0,201,0.0,0.0,1.0,201,6450,4400,2050,0.6821705426356589,85,44,41,225.8067761896175,0.47013266998341624,0.7976789783744356,0.13387058102932733,1031957.8642040985,-45.3843041099326,1031912.4798999885,4282,1,550.7910447761194,66,135,43,37.50264974865242,0.5461235489220564,43.29912935323382,8040.158660966338,121.82058577221724,0
4481,31.64661735474067,2,1,202,0.009852216748768473,0.0049261083743842365,0.9950738916256158,203,5800,3400,2400,0.5862068965517241,82,34,48,234.60544435899592,0.4702604496902892,0.8055971371067365,0.14039188042863818,1045485.5773438037,2655.321688732714,1048140.8990325364,4283,0,546.3546798029556,71,132,41,36.92384992776872,0.5483887520525452,42.9542824074074,8134.627467327485,114.57221784968289,0
4482,31.891088111555458,0,1,201,0.0,0.0049504950495049506,0.995049504950495,202,6650,4500,2150,0.6766917293233082,88,45,43,238.70183247643075,0.4698295855704973,0.8083593225626802,0.14352365684523435,1054993.755199528,3315.7885234634327,1058309.5437229916,4284,1,550.0247524752475,72,130,41,36.639784200599124,0.550072194719472,42.77968036529679,8203.035877552747,113.93105385489928,0
4483,31.760162240072997,0,2,199,0.0,0.009950248756218905,0.9900497512437811,201,6100,4100,2000,0.6721311475409836,81,41,40,236.7047986012879,0.469632048092869,0.8054582811234334,0.1428622578792177,1051794.7577078776,3492.9732586269693,1055287.7309665044,4285,2,551.6268656716418,61,140,38,36.549321060190614,0.5518760364842454,42.641129032258085,8173.759495857538,133.99605730913999,0
4484,31.967596217020077,2,1,200,0.009950248756218905,0.004975124378109453,0.9950248756218906,201,6800,4900,1900,0.7205882352941176,87,49,38,231.54661534357217,0.46960095356550585,0.7968599539701462,0.13703681977403004,1052732.917079724,1751.3487621149407,1054484.265841839,4286,0,552.2835820895523,69,132,35,37.420754571108255,0.548922056384743,43.36309523809523,8204.064945814385,118.89949196832443,8
4485,32.188621668121485,3,3,200,0.014778325123152709,0.014778325123152709,0.9852216748768473,203,6300,4500,1800,0.7142857142857143,81,45,36,227.0094441403785,0.4696406216976377,0.7958004750696392,0.1355078611294455,1062631.2206936267,1345.4645471740978,1063976.6852408007,4287,0,539.9261083743843,73,130,36,37.21307658595374,0.5515188834154352,43.046171171171146,8270.98958234636,113.30122715542959,0
4486,32.22850340091673,0,0,200,0.0,0.0,1.0,200,6850,5100,1750,0.7445255474452555,86,51,35,231.1204158775284,0.4691787060301507,0.7955591572123182,0.13844786077323712,1065020.5495825966,2379.5984675283553,1067400.148050125,4288,1,547.705,74,126,36,36.97494597514853,0.5533854166666667,42.91666666666664,8285.41108265229,111.96501463043636,0
4487,32.14407218401612,2,0,202,0.009900990099009901,0.0,1.0,202,5750,3700,2050,0.6434782608695652,78,37,41,222.34652440033574,0.46928055678702196,0.7887972003307209,0.13405913877024433,1064198.9023076845,1174.1854397532898,1065373.0877474379,4289,0,543.2722772277227,69,133,38,36.9571188989128,0.555332095709571,42.67857142857143,8271.358574494148,119.87476194919056,0
4488,32.23263672454216,0,1,201,0.0,0.0049504950495049506,0.995049504950495,202,6300,4300,2000,0.6825396825396826,83,43,40,220.54476436965456,0.4692564405694301,0.7871755540807148,0.13323820062332062,1067736.0638243358,396.7197210243148,1068132.7835453602,4290,1,544.2722772277227,70,132,35,36.92893581851345,0.5564150165016502,42.60563380281691,8296.499100577603,118.52141572253718,0
4489,32.05149301716783,2,1,202,0.009852216748768473,0.0049261083743842365,0.9950738916256158,203,6300,4500,1800,0.7142857142857143,81,45,36,217.69891651553075,0.4692768537937537,0.7862901762435133,0.13228268393991488,1063478.824559583,-596.362431233827,1062882.4621283493,4291,0,541.039408866995,72,131,40,36.78636053102901,0.5583949096880132,42.39440639269406,8256.643884687928,114.67560950955456,0
4490,31.77501227995475,0,1,201,0.0,0.0049504950495049506,0.995049504950495,202,5150,3200,1950,0.6213592233009708,71,32,39,220.18749678141342,0.4691225185951431,0.7892028333268117,0.12955217833883162,1044614.0459076312,452.190374221158,1045066.2362818524,4292,1,544.1336633663366,73,129,35,37.9350570926658,0.5467718646864687,43.58108108108108,8147.714297461366,111.61252462275844,8
4491,32.0304710605708,1,1,201,0.0049504950495049506,0.0049504950495049506,0.995049504950495,202,6850,4900,1950,0.7153284671532847,88,49,39,221.01870114690587,0.46918409191665433,0.790221714479139,0.1306019597686264,1054327.096674348,-644.7989018093895,1053682.2977725386,4293,0,544.9752475247525,75,127,38,37.750178062678046,0.5484220297029703,43.42105263157895,8218.344548435944,109.57792731247925,0
4492,32.11788750660995,0,2,199,0.0,0.009950248756218905,0.9900497512437811,201,6450,4900,1550,0.7596899224806202,80,49,31,217.6901039187368,0.46883499170812604,0.7859444913795788,0.12912088113302767,1058356.9251932527,-571.2341943128622,1057785.6909989398,4294,1,548.6666666666666,79,122,38,37.69273686346117,0.5498030679933665,43.28125000000002,8245.263933337576,104.37042953591867,0
4493,31.905755620392362,2,0,201,0.009950248756218905,0.0,1.0,201,7000,5300,1700,0.7571428571428571,87,53,34,232.0149750058591,0.4690049751243781,0.8042205912346176,0.1325395201282086,1039839.5213601078,1051.6681116941422,1040891.189471802,4295,0,549.1542288557214,62,139,36,38.768943073635135,0.5330638474295191,44.69246031746033,8145.77996915476,131.3835478895929,8
4494,31.89601321913437,2,0,203,0.009852216748768473,0.0,1.0,203,6000,4000,2000,0.6666666666666666,80,40,40,224.78647179641357,0.46956949389520236,0.7983752280471019,0.12935536939202225,1041788.7796358997,236.0048262892078,1042024.784462189,4296,0,544.7339901477833,68,135,39,38.66902933648359,0.5353550903119868,44.414251207729485,8152.1664221006495,119.88480032500955,0
4495,31.70355061008698,0,1,202,0.0,0.0049261083743842365,0.9950738916256158,203,5400,3700,1700,0.6851851851851852,71,37,34,222.91815885597217,0.4695156399876441,0.7969619417060447,0.12866653421639876,1036423.7150139881,207.53326911722434,1036631.2482831053,4297,1,545.7339901477833,69,134,38,38.60059118508606,0.5365353037766831,44.30059523809526,8106.579019838213,117.48665246142338,0
4496,31.839298074079398,6,4,204,0.028846153846153848,0.019230769230769232,0.9807692307692307,208,4950,3300,1650,0.6666666666666666,66,33,33,214.27149757910706,0.47028240353647965,0.7937104944590667,0.1252297863629016,1044686.6923371453,-1780.6835863906654,1042906.0087507546,4298,0,532.4134615384615,76,132,40,38.34220092240529,0.5399138621794872,43.83116883116887,8156.235772873023,107.31889174832925,0
4497,31.683478690023644,3,3,204,0.014492753623188406,0.014492753623188406,0.9855072463768116,207,6700,4600,2100,0.6865671641791045,88,46,42,218.1075863985177,0.47008035895752237,0.7973577742677431,0.12816884009710613,1041228.1625580849,-2680.047714858627,1038548.1148432263,4299,0,535.6328502415458,67,140,43,38.035771191841945,0.5420692431561998,43.62745098039215,8122.774193569764,121.23543572492186,0
4498,31.72673936314266,0,0,204,0.0,0.0,1.0,204,6800,5000,1800,0.7352941176470589,86,50,36,226.41734388056955,0.4688647010528349,0.7997956174883043,0.13009053765838044,1035780.5394615409,-696.264282386991,1035084.2751791539,4300,1,544.3382352941177,71,133,37,38.68781376212583,0.5362540849673203,44.473379629629626,8107.026484835432,114.18347161740044,7
4499,32.09259261495287,4,3,205,0.019230769230769232,0.014423076923076924,0.9855769230769231,208,6550,4700,1850,0.7175572519083969,84,47,37,218.61967588443318,0.4699059558094884,0.7962177345854728,0.1267332638508274,1050482.4734721035,-2218.772425450305,1048263.7010466532,4301,0,534.8509615384615,77,131,37,38.54362397132762,0.5388120993589743,44.13728632478632,8211.297835334944,106.64023162772655,0
4500,32.06680459361177,4,5,204,0.019138755980861243,0.023923444976076555,0.9760765550239234,209,6450,4800,1650,0.7441860465116279,81,48,33,202.97499596548565,0.46999792970187704,0.7732029172213006,0.11769435366532253,1049717.798375809,-5636.70682195411,1044081.091553855,4302,0,533.2631578947369,79,130,38,38.93403431547167,0.5393740031897927,44.127604166666686,8205.01011808683,103.86088757071936,8
4501,31.886839059230716,3,2,205,0.014492753623188406,0.00966183574879227,0.9903381642512077,207,5600,3700,1900,0.6607142857142857,75,37,38,207.09643826725951,0.4701145584165846,0.7789758645761815,0.12101129173165201,1046183.2343955168,-3667.8356763530237,1042515.3987191637,4303,0,532.1594202898551,81,126,42,38.533918092404306,0.5415660225442834,43.83892276422766,8168.1670430562945,100.84156843279376,0
4502,32.137944248709154,0,2,203,0.0,0.00975609756097561,0.9902439024390244,205,7650,5900,1750,0.7712418300653595,94,59,35,208.0158418618931,0.4699067431850789,0.7790079021977383,0.12223269987884566,1056148.831540266,-4710.862335139751,1051437.9692051264,4304,1,538.2926829268292,68,137,39,38.296308836807604,0.5431910569105691,43.62922705314006,8239.229607964577,121.16514129359672,0
4503,32.02383178301486,7,9,201,0.03333333333333333,0.04285714285714286,0.9571428571428572,210,6250,4100,2150,0.656,84,41,43,205.69169979473008,0.47033682691577433,0.7766372063737175,0.12283410383707248,1057317.938866506,-4753.6951862173055,1052564.2436802888,4305,0,525.8761904761905,83,127,33,37.74510986712995,0.5487103174603174,43.03075396825398,8229.139908328834,99.14626395576909,8
4504,31.745280057789692,3,3,201,0.014705882352941176,0.014705882352941176,0.9852941176470589,204,6250,4300,1950,0.688,82,43,39,208.81762603509898,0.47002680382497825,0.7764571582057476,0.12512159025895014,1049132.9552498083,-3234.5093779094104,1045898.4458718989,4306,0,533.8088235294117,83,121,37,37.53818573541706,0.5502450980392157,42.90674603174603,8161.497348190675,98.33129335169488,0
4505,32.08570278533487,1,2,200,0.0049504950495049506,0.009900990099009901,0.9900990099009901,202,6100,4500,1600,0.7377049180327869,77,45,32,214.3058345081523,0.4690568403855311,0.780298600227894,0.12880084942143094,1061304.254891788,-1011.2611976725439,1060292.9936941154,4307,0,540.049504950495,83,119,39,37.28308864889189,0.551825495049505,42.795138888888886,8252.598728554436,99.42890034402934,0
4506,32.45330243063899,0,0,200,0.0,0.0,1.0,200,5900,4000,1900,0.6779661016949152,78,40,38,226.67997480846734,0.46886987018425463,0.7872363841364769,0.13192709860536228,1063525.7424376947,2315.997700786813,1065841.7401384816,4308,1,545.17,82,118,31,38.185184731277666,0.5426562500000001,43.98845381526106,8308.420134068878,101.32219675693753,8
4507,32.330289087341946,3,2,201,0.014778325123152709,0.009852216748768473,0.9901477832512315,203,7050,5600,1450,0.7943262411347518,85,56,29,221.26351025971243,0.46946686663740267,0.787867112660025,0.13005010498548386,1062548.0644255697,-629.37708910739,1061918.6873364623,4309,0,538.0985221674877,71,132,37,37.947033180971715,0.545309934318555,43.61979166666664,8288.846251689563,116.74431340407835,0
4508,32.290329055870735,2,3,200,0.009852216748768473,0.014778325123152709,0.9852216748768473,203,6600,5200,1400,0.7878787878787878,80,52,28,216.64746764485184,0.4701425807605391,0.7841914935467778,0.12824404643184795,1063420.9058332306,-1122.510742127477,1062298.3950911032,4310,0,539.0344827586207,73,130,41,37.79572546438497,0.5474137931034483,43.355855855855836,8287.123864676689,113.52224472159848,0
4509,32.11971895339449,2,3,199,0.009900990099009901,0.01485148514851485,0.9851485148514851,202,5750,4200,1550,0.7304347826086957,73,42,31,207.75579180421892,0.4699229717747894,0.7810621801360929,0.12401362380670401,1060353.5429085654,-2091.0820201246147,1058262.4608884407,4311,0,542.2029702970297,76,126,37,37.708179776069635,0.5517223597359736,43.046536796536785,8253.273022196603,108.59569766048162,8
4510,31.97907058153912,2,2,199,0.009950248756218905,0.009950248756218905,0.9900497512437811,201,5850,4300,1550,0.7350427350427351,74,43,31,205.67395134779866,0.46919465174129354,0.7785064421482348,0.12332847636168656,1057081.3628421945,-2567.1798416263273,1054514.183000568,4312,0,545.8756218905472,78,123,41,37.591452991452954,0.5537935323383085,42.879746835443015,8222.466723892516,105.41624004990405,0
4511,31.94353059309115,3,1,201,0.01485148514851485,0.0049504950495049506,0.995049504950495,202,6400,5000,1400,0.78125,78,50,28,197.90586608854093,0.46914047748058385,0.771163766862123,0.11990767180658679,1059027.8626940772,-4882.4347243263255,1054145.427969751,4313,0,544.059405940594,69,133,43,37.40392394822005,0.5563118811881188,42.50000000000001,8225.459127720987,119.20955257566648,0
4512,32.43584762744683,0,1,200,0.0,0.004975124378109453,0.9950248756218906,201,6600,5000,1600,0.7575757575757576,82,50,32,222.27526902187162,0.46868988391376454,0.7969196701535197,0.13014555737126807,1064829.1801002095,537.0384938226794,1065366.2185940323,4314,1,547.4029850746268,81,120,38,38.067181845223324,0.5466417910447761,43.76270325203253,8311.273913785979,102.60831992328369,8
4513,32.42922965596845,0,3,197,0.0,0.015,0.985,200,7100,5200,1900,0.7323943661971831,90,52,38,235.73810351472966,0.4685170644891122,0.8057285749567789,0.13577575834013436,1059477.7380437923,2851.8545365040322,1062329.5925802963,4315,2,550.255,65,135,37,38.355406684778146,0.5368229166666667,44.38131313131315,8289.51710082177,127.53103232033492,8
4514,32.6298806562121,2,1,198,0.010050251256281407,0.005025125628140704,0.9949748743718593,199,6300,4700,1600,0.746031746031746,79,47,32,231.2352699194728,0.4689038627480839,0.8011035665837534,0.1337100676782167,1067279.1442517457,3258.5162000955343,1070537.6604518413,4316,0,541.0,66,133,41,38.317706117156014,0.5382642378559463,44.23196517412937,8345.6804520421,126.44970381881969,0
4515,32.33032152227462,3,5,196,0.014925373134328358,0.024875621890547265,0.9751243781094527,201,5600,3700,1900,0.6607142857142857,75,37,38,226.4281878601682,0.46998756218905474,0.7986209936663844,0.1319666720087932,1059933.8622609654,2199.7807366761995,1062133.6429976416,4317,0,532.6417910447761,72,129,36,38.13748026376894,0.5405783582089552,43.935502283105045,8278.647541627022,114.98121585593087,0
4516,31.84863292562179,3,5,194,0.01507537688442211,0.02512562814070352,0.9748743718592965,199,5600,4100,1500,0.7321428571428571,71,41,30,229.79902860415652,0.46985453361081503,0.8001641439474994,0.13489490119084552,1046330.1237094528,2689.1292055397007,1049019.2529149924,4318,0,538.4974874371859,62,137,39,37.77682814078994,0.5431323283082077,43.66732804232803,8163.845176023699,131.67492219393063,0
4517,32.13317192819507,1,2,193,0.005128205128205128,0.010256410256410256,0.9897435897435898,195,5950,4000,1950,0.6722689075630253,79,40,39,225.65403311018406,0.4694851969336506,0.7926492843862147,0.13336828069867718,1057770.2244425034,2788.0234498632562,1060558.2478923667,4319,0,549.1179487179487,64,131,38,37.62348281389877,0.5455662393162393,43.41346153846155,8244.939354845072,128.82717741945424,0
4518,31.839346151654357,4,0,197,0.02030456852791878,0.0,1.0,197,5350,3900,1450,0.7289719626168224,68,39,29,221.79086484321306,0.4700924151386443,0.7899627511066649,0.12966505553195154,1044783.8990168994,1594.704907444533,1046378.603924344,4320,0,543.3807106598985,74,123,44,38.137593747176304,0.5395516074450084,43.81944444444445,8156.621385656466,110.22461331968198,8
4519,31.67481779135304,0,1,196,0.0,0.005076142131979695,0.9949238578680203,197,5100,4000,1100,0.7843137254901961,62,40,22,219.79844522552577,0.4700373804344073,0.7876966070540072,0.12918899661165997,1041005.7344155373,1262.2883790783972,1042268.0227946157,4321,1,544.3807106598985,63,134,44,37.984594548840384,0.5414022842639594,43.61979166666667,8120.7963842674735,128.9015299090075,0
4520,31.608290101063837,3,1,198,0.01507537688442211,0.005025125628140704,0.9949748743718593,199,6000,3800,2200,0.6333333333333333,82,38,44,207.32833258625502,0.47083481379963793,0.7760994992934647,0.12295019131816698,1041504.1654281998,-2613.3356000265135,1038890.8298281733,4322,0,539.7788944723618,69,130,45,37.96633770022994,0.544074539363484,43.28869047619047,8114.205543652545,117.59718179206587,0
4521,31.959699848658726,2,4,196,0.01,0.02,0.98,200,8250,6600,1650,0.8,99,66,33,207.92080224273178,0.4709751884422111,0.776428571428571,0.12437444352337959,1055709.7995967625,-4349.194306465545,1051360.605290297,4323,0,538.04,71,129,39,37.62453562985474,0.5465104166666667,42.96875,8214.641601725569,115.69917748909252,0
4522,32.07746491667208,2,1,197,0.010101010101010102,0.005050505050505051,0.9949494949494949,198,4850,2900,1950,0.5979381443298969,68,29,39,207.90523010316932,0.46999446666324834,0.7757026077046045,0.12505530807707183,1061277.053370503,-320.99000315829835,1060956.0633673447,4324,0,544.3636363636364,72,126,42,37.41736931639578,0.5484532828282829,42.76541095890412,8251.433505320336,114.60324312944911,0
4523,32.10107186940307,2,2,197,0.010050251256281407,0.010050251256281407,0.9899497487437185,199,6450,4500,1950,0.6976744186046512,84,45,39,221.70867418231603,0.4704255706140128,0.7928141230444432,0.12711593523759623,1047343.6610934864,191.0349028578721,1047534.6959963442,4325,0,542.5829145728643,69,130,41,38.89010252825356,0.5326633165829145,44.55357142857142,8200.104162353755,118.8420893094747,8
4524,32.34418739056854,1,2,196,0.005050505050505051,0.010101010101010102,0.98989898989899,198,6600,4400,2200,0.6666666666666666,88,44,44,217.82325456333112,0.4700751166487207,0.7893309819962713,0.12550768477220486,1056824.3474181262,-159.81622872317075,1056664.531189403,4326,0,546.2828282828283,70,128,39,38.79789849250075,0.5344065656565656,44.366197183098585,8268.267621673494,118.11810888104992,0
4525,32.095314322500485,4,3,197,0.02,0.015,0.985,200,5950,4200,1750,0.7058823529411765,77,42,35,202.35723418806546,0.47074905778894477,0.774676863915513,0.11655107739698159,1048572.2191189083,-3512.7651785307885,1045059.4539403775,4327,0,523.655,70,130,40,39.20823049991393,0.53234375,44.38086854460097,8204.176370905676,117.2025195843668,7
4526,32.16566964699818,1,0,198,0.005050505050505051,0.0,1.0,198,6700,4800,1900,0.7164179104477612,86,48,38,198.74671993431014,0.47046127518843256,0.7682945931676886,0.1150446383035973,1052421.3558453526,-4466.941507382885,1047954.4143379697,4328,0,529.4646464646464,72,126,46,39.10825849277627,0.5345643939393939,44.19235159817355,8228.224311668693,114.28089321762074,0
4527,31.896072722646544,2,2,198,0.01,0.01,0.99,200,5950,4200,1750,0.7058823529411765,77,42,35,193.14556136695117,0.47067629815745393,0.7640240938391623,0.11247608905941399,1045444.4761486101,-5565.40795525921,1039879.0681933509,4329,0,525.16,76,124,38,39.0212758462785,0.536875,43.966450216450255,8166.464723333538,107.45348320175708,0
4528,32.113781900085385,0,3,195,0.0,0.015151515151515152,0.9848484848484849,198,5900,4000,1900,0.6779661016949152,78,40,38,197.6093853222754,0.4704607410825685,0.7668463065548257,0.11557524827774239,1053915.4372341225,-3847.283653301003,1050068.1535808216,4330,1,530.7323232323232,76,122,40,38.74144137008485,0.538510101010101,43.8041125541126,8227.418853136165,108.25551122547586,0
4529,32.23016596139609,4,2,197,0.020100502512562814,0.010050251256281407,0.9899497487437185,199,6250,4400,1850,0.704,81,44,37,196.84767839399387,0.47052180092381096,0.7675192071866763,0.11612674792404531,1060391.8739150842,-4302.864286391612,1056089.0096286926,4331,0,528.8190954773869,73,126,44,38.43305849750313,0.5407768006700168,43.48254504504506,8267.600145193172,113.2547965094955,0
4530,31.72941829779932,1,0,198,0.005050505050505051,0.0,1.0,198,6350,4400,1950,0.6929133858267716,83,44,39,197.57465715619114,0.4702882248884787,0.7685291338652458,0.11722077414491225,1045636.2519118054,-4631.75520368823,1041004.4967081171,4332,0,531.9949494949495,73,125,42,38.19908981247941,0.5429819023569024,43.27139639639638,8145.849252748618,111.58697606504956,0
4531,31.55340048300487,0,2,196,0.0,0.010101010101010102,0.98989898989899,198,5800,4500,1300,0.7758620689655172,71,45,26,212.5711086066682,0.47014027756413546,0.7829927700394015,0.12325475009768633,1032901.7826521796,-1486.9845959643771,1031414.7980562152,4333,1,532.9949494949495,76,122,38,38.689705156674066,0.5364057239057238,44.12878787878788,8073.606828132507,106.2316687912172,8
4532,31.680865583934487,1,1,196,0.005076142131979695,0.005076142131979695,0.9949238578680203,197,6250,4400,1850,0.704,81,44,37,211.60514615932738,0.47003522221071165,0.7812086994066523,0.12346667516487161,1038984.7276947687,-1679.096967767815,1037305.6307270009,4334,0,535.274111675127,79,118,42,38.473878099208584,0.5385998307952622,43.89322916666668,8113.684181906375,102.70486306210601,0
4533,32.033550996529605,1,1,196,0.005076142131979695,0.005076142131979695,0.9949238578680203,197,6800,5400,1400,0.7941176470588235,82,54,28,206.77966651369337,0.4702456490210298,0.7755548226592288,0.12125863794229871,1052093.0345306934,-2689.7106356731256,1049403.3238950204,4335,0,535.8324873096446,69,128,43,38.40570506493251,0.5402918781725888,43.70535714285711,8210.02751210156,118.98590597248638,0
4534,32.497489496730466,3,2,197,0.01507537688442211,0.010050251256281407,0.9899497487437185,199,6100,4200,1900,0.6885245901639344,80,42,38,206.95778984139451,0.47024262727780314,0.7773557305455168,0.12270061557263225,1070728.4567134334,-1580.881015660394,1069147.575697773,4336,0,531.4120603015075,75,124,42,37.985043248438295,0.5428706030150754,43.297697368421034,8342.180383556206,111.22907178074941,0
4535,32.23313152498564,2,0,199,0.010050251256281407,0.0,1.0,199,5950,4300,1650,0.7226890756302521,76,43,33,199.23860516646988,0.470208788047984,0.7723091870976331,0.11425644856850822,1051716.9655919576,-3841.475749109134,1047875.4898428484,4337,0,531.1909547738693,71,128,43,39.456082101527265,0.5363798157453936,44.5457175925926,8234.091483458811,115.97311948533537,8
4536,32.373123851702374,3,4,198,0.01485148514851485,0.019801980198019802,0.9801980198019802,202,6300,4400,1900,0.6984126984126984,82,44,38,216.13734017293757,0.4707747360556951,0.789976316260965,0.12550600388643174,1060191.3125329488,-870.6139269346077,1059320.6986060143,4338,0,524.2871287128713,73,129,38,38.54223960911577,0.5398617986798679,44.07376126126126,8285.131823589536,113.49495648752789,8
4537,32.10004967199694,3,0,201,0.014925373134328358,0.0,1.0,201,5900,3700,2200,0.6271186440677966,81,37,44,210.2861395407351,0.47147077114427866,0.7818379107419478,0.1174876944803823,1039204.8471106418,-2393.9249018168202,1036810.9222088249,4339,0,527.3432835820895,71,130,39,40.193124099765,0.5269485903814262,45.54398148148147,8168.050833782983,115.04296948990117,8
4538,31.77376403208686,3,1,203,0.014705882352941176,0.004901960784313725,0.9950980392156863,204,6700,4000,2700,0.5970149253731343,94,40,54,233.03134043007637,0.47252406709810363,0.8062582257021136,0.1272264274770417,1021391.5280123918,103.24737533024745,1021494.7753877221,4340,0,520.5735294117648,64,140,38,40.53361880082587,0.5161356209150327,46.44230769230769,8056.482283905099,125.88253568601718,8
4539,32.25523797644727,6,5,204,0.028708133971291867,0.023923444976076555,0.9760765550239234,209,5550,3500,2050,0.6306306306306306,76,35,41,221.15681350089807,0.47380881180223283,0.8006372317214938,0.1220499170389268,1040314.048849401,-1335.4919832497708,1038978.5568661512,4341,0,509.066985645933,71,138,40,40.40450251590245,0.5188397129186603,46.02141203703703,8192.139795667399,115.38225064320281,0
4540,32.74069544397316,0,3,201,0.0,0.014705882352941176,0.9852941176470589,204,7350,5400,1950,0.7346938775510204,93,54,39,226.19834153938106,0.4733647050774333,0.800698832289569,0.12524245015759458,1057033.379151994,-330.1605368100154,1056703.2186151838,4342,1,520.0686274509804,68,136,40,40.14587789131814,0.5201695261437909,45.8937198067633,8319.61633020771,122.34729897364278,0
4541,33.165811202909616,4,0,205,0.01951219512195122,0.0,1.0,205,6550,4800,1750,0.732824427480916,83,48,35,220.32777004709112,0.4740305675115575,0.7972241991838129,0.12359324556033463,1075015.2769479272,-178.85625270126457,1074836.420695226,4343,0,517.3707317073171,67,138,41,39.77930780338128,0.5233739837398375,45.38909313725492,8444.377267211443,126.03548160017078,0
4542,33.6071609635703,4,1,208,0.019138755980861243,0.004784688995215311,0.9952153110047847,209,6050,4500,1550,0.743801652892562,76,45,31,211.16683034636338,0.47519284443626547,0.7928793751292811,0.11967931034356963,1092702.4152915608,-1701.498890212899,1091000.9164013478,4344,0,508.44976076555025,71,138,40,39.60933658610387,0.5261662679425838,44.99421296296298,8570.020531595675,120.70451452951656,0
4543,33.21383482421311,6,1,213,0.028037383177570093,0.004672897196261682,0.9953271028037384,214,6750,5000,1750,0.7407407407407407,85,50,35,242.77718444681827,0.476380022084741,0.8244166225827316,0.13688500825192923,1078236.6635218016,2804.2522674308047,1081040.9157892324,4345,0,497.2289719626168,64,150,43,39.006158280922456,0.5233158099688473,45.192307692307686,8463.140604246593,132.23657194135302,8
4544,33.115424211358054,2,5,210,0.009302325581395349,0.023255813953488372,0.9767441860465116,215,6500,4700,1800,0.7230769230769231,83,47,36,241.77934396681218,0.4765694052017677,0.8249244606463013,0.13765047112692208,1078173.692155386,2636.0255943210545,1080809.7177497072,4346,0,495.86511627906975,69,146,39,38.65173781198971,0.5260174418604651,44.82142857142857,8450.346642505474,122.46879192036918,0
4545,32.640539430182905,2,1,211,0.009433962264150943,0.0047169811320754715,0.9952830188679245,212,6750,5000,1750,0.7407407407407407,85,50,35,237.54200230870674,0.4760578743032579,0.8152664359194379,0.13396821282943527,1059708.8054754208,1195.070303360083,1060903.8757787808,4347,0,503.3207547169811,71,141,34,39.12930080054507,0.5281544811320755,45.18229166666668,8317.387456363038,117.14630220229631,8
4546,32.550333213767395,3,2,212,0.014018691588785047,0.009345794392523364,0.9906542056074766,214,6300,3900,2400,0.6190476190476191,87,39,48,231.702855511682,0.47672463911193014,0.8131083316575383,0.13160143452657241,1059024.4350891584,-24.20286663944171,1059000.232222519,4348,0,499.5747663551402,77,137,38,39.00139390607819,0.5304225077881619,44.911858974358964,8303.203989265083,107.83381804240368,0
4547,32.51407113304754,1,2,211,0.004694835680751174,0.009389671361502348,0.9906103286384976,213,6850,4600,2250,0.6715328467153284,91,46,45,232.80658909682126,0.476624553400065,0.8130272561459961,0.13298631305800207,1059652.2464583637,-111.19497464880897,1059541.051483715,4349,0,502.5633802816901,63,150,38,38.75031875557821,0.5321791862284819,44.694010416666664,8301.037106005593,131.76249374612053,0
4548,32.7334996260992,3,2,212,0.014018691588785047,0.009345794392523364,0.9906542056074766,214,6700,4900,1800,0.7313432835820896,85,49,36,219.7329757785402,0.4768009667558832,0.807317976746593,0.12541432210886833,1066540.1598075053,-2629.1913796353165,1063910.96842787,4350,0,500.32710280373834,62,152,42,39.11630718742578,0.5322235202492211,44.72552910052911,8356.026797740518,134.77462577000836,8
4549,32.72190280872559,1,4,209,0.004694835680751174,0.018779342723004695,0.9812206572769953,213,6500,4500,2000,0.6923076923076923,85,45,40,199.52679008018873,0.4764962943278117,0.7851699089007351,0.11462708469573099,1068233.111844053,-6471.775227276981,1061761.336616776,4351,0,503.55399061032864,72,141,42,39.3793860873774,0.5383411580594679,44.477739726027394,8361.174566150805,116.12742452987229,7
4550,32.48011565395287,2,3,208,0.009478672985781991,0.014218009478672985,0.985781990521327,211,7900,5900,2000,0.7468354430379747,99,59,40,198.26810309623838,0.47638982923343115,0.7815020732023665,0.11467667671546268,1062461.474036358,-7969.5557859954315,1054491.9182503626,4352,0,508.90521327014216,74,137,46,39.150964740805094,0.5403830963665086,44.22222222222223,8307.691803933296,112.26610545855806,0
4551,32.472094386706225,1,4,205,0.004784688995215311,0.019138755980861243,0.9808612440191388,209,7550,5800,1750,0.7682119205298014,93,58,35,195.56588469178485,0.47612447859158386,0.776572869147186,0.1136624237615846,1063712.3991976224,-7744.8287186593,1055967.5704789632,4353,0,510.04784688995215,78,131,42,39.034381653959734,0.5425637958532695,44.040084388185655,8311.554538960198,106.55839152513074,0
4552,32.868335058090665,1,0,206,0.0048543689320388345,0.0,1.0,206,7850,5800,2050,0.7388535031847133,99,58,41,192.29846853634123,0.4759994869366169,0.7699900464884262,0.11237391355368043,1078411.8053870439,-7574.612274512031,1070837.193112532,4354,0,516.5291262135922,84,122,44,38.909785676697155,0.5449029126213591,43.8357843137255,8419.691271069492,100.23441989368443,0
4553,32.70582588821521,2,1,207,0.009615384615384616,0.004807692307692308,0.9951923076923077,208,6350,4400,1950,0.6929133858267716,83,44,39,187.19646965452037,0.4763191154155828,0.7662284359889375,0.11009957038285628,1075096.8029128392,-7699.134791571361,1067397.6681212678,4355,0,512.5528846153846,73,135,45,38.795349528776676,0.5473257211538461,43.59515765765763,8385.932130543848,114.8757826101897,0
4554,33.15381361741067,2,3,206,0.009569377990430622,0.014354066985645933,0.9856459330143541,209,6250,4400,1850,0.704,81,44,37,185.12009282695485,0.47626441540915226,0.7649051862962317,0.10969608498746428,1092187.9282454809,-7612.813867743813,1084575.114377737,4356,0,511.0622009569378,76,133,44,38.56538333157652,0.5493919457735248,43.31709956709953,8510.017039728675,111.97390841748256,0
4555,33.57065833138614,1,1,206,0.004830917874396135,0.004830917874396135,0.9951690821256038,207,6500,4700,1800,0.7230769230769231,83,47,36,198.16447793335615,0.47593432922158124,0.7768969303842614,0.116283797782515,1102790.3788945116,-4193.224059288188,1098597.1548352235,4357,0,516.7777777777778,74,133,39,38.60121466630543,0.5488627214170693,43.680555555555564,8604.812493135176,116.28124990723211,8
4556,33.741476339428004,2,2,206,0.009615384615384616,0.009615384615384616,0.9903846153846154,208,6800,5100,1700,0.75,85,51,34,195.914364043085,0.4759131518642388,0.7751064145713706,0.1160097834445051,1111318.730530424,-4855.339531792442,1106463.3909986317,4358,0,515.1153846153846,81,127,39,38.31522635781694,0.5516826923076923,43.34349593495937,8659.969359270935,106.91320196630784,0
4557,33.48686927589802,0,3,203,0.0,0.014563106796116505,0.9854368932038835,206,6200,4500,1700,0.7258064516129032,79,45,34,198.5406149008641,0.47540551740468856,0.774112149532709,0.11621359843759589,1099236.4641701381,-3751.383296441604,1095485.0808736966,4359,1,521.0242718446602,86,120,42,38.686818535825545,0.5479368932038835,43.77394636015327,8580.208363316817,99.76986468973043,8
4558,33.31530512497909,1,1,203,0.004901960784313725,0.004901960784313725,0.9950980392156863,204,6550,4700,1850,0.7175572519083969,84,47,37,194.144926685523,0.4743960084033614,0.765975130697994,0.11421582668027534,1095213.709144846,-4823.962946618932,1090389.7461982272,4360,0,526.9362745098039,75,129,43,38.6073693963367,0.5499897875816994,43.585526315789465,8542.52642925037,113.90035239000494,0
4559,33.54051570202135,1,1,203,0.004901960784313725,0.004901960784313725,0.9950980392156863,204,7600,5500,2100,0.7236842105263158,97,55,42,193.42619170256893,0.474090642003928,0.7621268192715951,0.1144873945482773,1104563.1456193405,-5669.711449568184,1098893.4341697723,4361,0,527.8578431372549,79,125,42,38.39527312700828,0.5522875816993464,43.359375,8607.858912589076,108.96023939986172,0
4560,33.57018669034921,1,2,202,0.004901960784313725,0.00980392156862745,0.9901960784313726,204,6300,4200,2100,0.6666666666666666,84,42,42,193.46525377964355,0.4737359742747674,0.7612441771485261,0.11507169860732734,1107100.4113269264,-4262.90759261762,1102837.5037343088,4362,0,528.8284313725491,81,123,44,38.20974715998087,0.5540747549019608,43.17835365853659,8621.550613805772,106.43889646673792,0
4561,33.62448835435161,0,2,200,0.0,0.009900990099009901,0.9900990099009901,202,6650,4700,1950,0.706766917293233,86,47,39,199.17789656531897,0.47339519399701163,0.7644683897954008,0.11890421189080926,1110059.0253734945,-2830.1556525517444,1107228.8697209428,4363,1,534.4752475247525,83,119,34,37.925142367646366,0.5555899339933994,43.04315476190477,8640.04245027929,104.09689699131675,0
4562,33.21798460796402,0,1,199,0.0,0.005,0.995,200,6300,3800,2500,0.6031746031746031,88,38,50,204.60609359678813,0.4727397403685092,0.7680290753098185,0.12264673839030371,1097928.1850907214,-1371.440599755094,1096556.7444909662,4364,2,540.645,84,116,34,37.63157372100412,0.5570833333333334,42.89215686274511,8540.604375920197,101.67386161809758,0
4563,32.70713712067887,0,1,198,0.0,0.005025125628140704,0.9949748743718593,199,5850,3100,2750,0.5299145299145299,86,31,55,202.24042204558225,0.4721746358052891,0.766839233595594,0.12179724424922633,1082487.986728028,-1865.4345409702219,1080622.5521870577,4365,4,544.3517587939698,85,114,41,37.517213172637824,0.558574120603015,42.72044573643411,8414.87765964559,98.99856070171282,0
4564,32.88780944767324,1,1,198,0.005025125628140704,0.005025125628140704,0.9949748743718593,199,6200,5000,1200,0.8064516129032258,74,50,24,203.40513005509786,0.47187114021284876,0.768191493219432,0.12320154433668404,1090238.2924400102,-1647.987667038251,1088590.304772972,4366,0,545.3266331658291,73,126,39,37.273808222173614,0.5606155778894473,42.51126126126127,8468.240574561374,116.00329554193664,0
4565,33.05700506544939,0,1,197,0.0,0.005050505050505051,0.9949494949494949,198,6400,4600,1800,0.71875,82,46,36,203.11992730349317,0.4710386436274761,0.7656083683797927,0.12361448732205811,1097320.1489880562,-1422.4822217774672,1095897.6667662787,4367,1,548.969696969697,75,123,43,37.10464430732131,0.5625,42.33826754385966,8517.525194975115,113.5670025996682,0
4566,32.81926082038106,4,3,198,0.01990049751243781,0.014925373134328358,0.9850746268656716,201,6350,4700,1650,0.7401574803149606,80,47,33,202.02916770069385,0.4715215588723051,0.7672137294684058,0.12405592694348347,1092173.0394380838,-2419.837971437498,1089753.2014666463,4368,0,540.955223880597,80,121,33,36.801816958277264,0.5649357379767828,42.01388888888888,8466.913468591334,105.83641835739168,0
4567,32.40488438350296,1,1,198,0.005025125628140704,0.005025125628140704,0.9949748743718593,199,5600,4100,1500,0.7321428571428571,71,41,30,208.63441925141802,0.4708390437033653,0.7733132527029563,0.1285880761385648,1079502.682628621,-355.71694588603896,1079146.965682735,4369,0,547.251256281407,82,117,34,36.49474886954829,0.5662688442211055,41.88002008032128,8364.348106369283,102.0042451996254,0
4568,32.70479994721917,0,4,194,0.0,0.020202020202020204,0.9797979797979798,198,6850,5100,1750,0.7445255474452555,86,51,35,192.56655836274325,0.47054299338563293,0.7579352573574905,0.11686332370765654,1084767.6576158397,-4672.005109940594,1080095.652505899,4370,1,550.7575757575758,69,129,49,37.480741083121494,0.5605008417508417,42.4404761904762,8423.432700691523,122.07873479263077,8
4569,32.38692689619055,0,1,193,0.0,0.005154639175257732,0.9948453608247423,194,6300,4100,2200,0.6507936507936508,85,41,44,198.11004766276383,0.46986227587557644,0.7633023801241654,0.11588733733974413,1062931.164219798,-2984.531278835477,1059946.6329409627,4371,2,558.6237113402062,86,108,38,38.72227155185845,0.5486469072164948,43.79789272030653,8297.598919117445,96.48370836183075,8
4570,32.03623638237272,2,2,193,0.010256410256410256,0.010256410256410256,0.9897435897435898,195,6750,4900,1850,0.725925925925926,86,49,37,194.0541943223666,0.4696449026345934,0.7595173845931757,0.11459619813052196,1054324.6023711574,-4830.777746523456,1049493.8246246339,4372,0,556.5846153846154,74,121,41,38.46587628121837,0.5516025641025641,43.444444444444414,8219.074422988666,111.06857328363063,0
4571,31.75300042715722,1,1,193,0.005154639175257732,0.005154639175257732,0.9948453608247423,194,6200,4600,1600,0.7419354838709677,78,46,32,190.36102929825373,0.46953844167868525,0.7519957583352266,0.11304972014409488,1046703.9247379045,-5149.672703274346,1041554.2520346302,4373,0,560.2113402061856,78,116,41,38.347968982693935,0.5536941580756014,43.23575949367086,8153.035038476112,104.52609023687323,0
4572,31.633143535943663,3,4,192,0.015306122448979591,0.02040816326530612,0.9795918367346939,196,5450,3700,1750,0.6788990825688074,72,37,35,185.3232050666934,0.4694787851037851,0.7479743806279229,0.11076585253817184,1044676.6263512359,-5929.435869265728,1038747.1904819702,4374,0,555.1989795918367,85,111,38,38.236206679862995,0.555750425170068,42.99903100775194,8129.748541008392,95.64410048245166,0
4573,31.41140753471337,2,4,190,0.010309278350515464,0.020618556701030927,0.979381443298969,194,5850,4400,1450,0.7521367521367521,73,44,29,185.7926151990383,0.46926913626408845,0.7446984037624764,0.11164322447358117,1038945.3170645781,-6044.326498755678,1032900.9905658223,4375,0,559.5,88,106,41,38.02341676147137,0.5577749140893471,42.80196629213483,8078.952253924691,91.80627561278058,0
4574,31.052136715194802,1,0,191,0.005235602094240838,0.0,1.0,191,4650,3300,1350,0.7096774193548387,60,33,27,194.82911816817082,0.468620832185175,0.7474442470625873,0.11917057884825043,1032239.5283861922,-2627.936589238062,1029611.591796954,4376,0,562.17277486911,78,113,47,37.13095542487,0.5668630017452008,42.15453586497889,8006.652603713505,102.64939235530134,8
4575,30.784685759514765,2,2,191,0.010362694300518135,0.010362694300518135,0.9896373056994818,193,6000,4300,1700,0.7166666666666667,77,43,34,197.01467699463697,0.4687668663644214,0.7508112274594576,0.12120400207356241,1025003.7506079286,-4211.843431137803,1020791.9071767908,4377,0,557.3367875647668,81,112,36,36.862098388631814,0.5687607944732297,41.94613821138209,7944.107044191803,98.0753956073062,0
4576,31.076699436823308,0,1,190,0.0,0.005235602094240838,0.9947643979057592,191,6600,4000,2600,0.6060606060606061,92,40,52,193.5720610961773,0.468411867364747,0.7506400550358001,0.11791986542440347,1031870.83817579,-4851.727013854273,1027019.1111619357,4378,1,564.1465968586388,76,115,41,37.31418534656237,0.5644633507853403,42.30248917748919,8008.3880894487265,105.3735274927464,8
4577,30.909959091477837,1,1,190,0.005235602094240838,0.005235602094240838,0.9947643979057592,191,5700,3700,2000,0.6491228070175439,77,37,40,192.957478173347,0.4682488288784789,0.749471701568003,0.1181547388263721,1027828.5325575224,-4234.559672617699,1023593.9728849047,4379,0,565.1361256544502,78,113,37,37.13889456999692,0.5662630890052356,42.11497890295359,7971.215452414613,102.19506990275144,0
4578,30.91467776074965,1,0,191,0.005235602094240838,0.0,1.0,191,6150,4400,1750,0.7154471544715447,79,44,35,192.34891948246303,0.4682407917700009,0.7467986541809428,0.1183752892846483,1029433.2956129804,-4747.923581914446,1024685.372031066,4380,0,561.9057591623036,81,110,40,36.96955246533758,0.5680628272251309,41.9334349593496,7978.044699055261,98.49437900068223,0
4579,30.474794106312313,0,1,190,0.0,0.005235602094240838,0.9947643979057592,191,5150,3600,1550,0.6990291262135923,67,36,31,192.21557046269623,0.46785501056305684,0.747483438454112,0.11866917539744365,1015684.87699541,-4303.910391598694,1011380.9666038112,4381,1,562.9057591623036,81,110,40,36.85646690284065,0.5694262652705061,41.81910569105692,7868.009596248639,97.13592094134123,0
4580,30.72838968107956,0,1,189,0.0,0.005263157894736842,0.9947368421052631,190,5950,4400,1550,0.7394957983193278,75,44,31,194.78407908428684,0.4677138447971781,0.7507640067911705,0.12076612903225807,1025346.6140110246,-4005.7608095341297,1021340.8532014905,4382,2,564.7315789473685,83,107,43,36.63474462365592,0.571436403508772,41.66666666666667,7938.167334278901,95.64057029251688,0
4581,31.175717268369336,0,1,188,0.0,0.005291005291005291,0.9947089947089947,189,5200,3700,1500,0.7115384615384616,67,37,30,194.97050840933264,0.4674800180119329,0.7479045776918121,0.12144548535858488,1041615.7866181519,-2383.128103174169,1039232.6585149778,4383,3,566.6772486772487,74,115,43,36.46001235761876,0.5730820105820106,41.50000000000002,8058.922913873516,108.90436370099346,0
4582,30.91518678715474,1,1,188,0.005291005291005291,0.005291005291005291,0.9947089947089947,189,6550,4600,1950,0.7022900763358778,85,46,39,193.21116252901408,0.4671962362565199,0.7462360446048233,0.1210506675456691,1034568.2077965164,-4371.9747712149765,1030196.2330253014,4384,0,567.5502645502645,77,112,43,36.29422190102553,0.5751212522045855,41.29273504273507,7997.983419347836,103.8699145369849,0
4583,30.686386726946616,1,1,188,0.005291005291005291,0.005291005291005291,0.9947089947089947,189,4900,3600,1300,0.7346938775510204,62,36,26,193.7241619058807,0.46715167548500885,0.7483058649521548,0.12189720341462407,1028130.3993891975,-2865.2600096736824,1025265.1393795238,4385,0,568.3280423280423,78,111,47,36.12448213800596,0.5766644620811288,41.13924050632913,7943.501374253947,101.83976120838393,0
4584,31.043778653104944,1,0,189,0.005291005291005291,0.0,1.0,189,5850,4700,1150,0.8034188034188035,70,47,23,194.84804778253616,0.4671012514540884,0.7497837115323462,0.11795000144393206,1028938.7524364548,-3552.658559991736,1025386.093876463,4386,0,569.1428571428571,76,113,39,37.51576292559898,0.5665233686067019,42.53246753246753,7992.7650882831795,105.16796168793657,8
4585,31.484576846412292,0,2,187,0.0,0.010582010582010581,0.9894179894179894,189,5750,3500,2250,0.6086956521739131,80,35,45,189.91448383057877,0.4669159724567526,0.7430688781594887,0.11538298530816797,1044625.5002575928,-3872.097464464134,1040753.4027931286,4387,1,570.1428571428571,80,109,39,37.507488392990865,0.5676807760141094,42.39969135802467,8110.436713097739,101.38045891372174,0
4586,32.005890869782576,1,1,187,0.005319148936170213,0.005319148936170213,0.9946808510638298,188,6300,4700,1600,0.746031746031746,79,47,32,190.28609899476774,0.466088647741495,0.7416163645084144,0.11614520615909406,1063309.9146780751,-3433.3808626901737,1059876.5338153848,4388,0,574.0797872340426,82,106,43,37.326448058165774,0.5695367907801419,42.23142570281123,8250.112858615223,100.61113242213686,0
4587,32.123578520311874,0,0,187,0.0,0.0,1.0,187,5500,3800,1700,0.6909090909090909,72,38,34,205.37603090413063,0.46592226822302724,0.7550742460830866,0.11631793714186492,1044251.3591200184,-7.160119537580613,1044244.1990004808,4389,1,577.8770053475936,81,106,33,39.78365384615387,0.5427807486631016,45.02032520325202,8190.8596044168835,101.12172351131954,8
4588,32.06803874304488,1,1,187,0.005319148936170213,0.005319148936170213,0.9946808510638298,188,6400,4600,1800,0.71875,82,46,36,203.82495161689897,0.4661206479690522,0.7560080322583267,0.11591168414844316,1043721.7351227751,-1452.6935674191673,1042269.0415553559,4390,0,575.7978723404256,85,103,37,39.664039751867314,0.5443816489361701,44.8643410852713,8181.700194809751,96.25529640952648,0
4589,31.748288634805856,0,0,187,0.0,0.0,1.0,187,6950,5200,1750,0.7482014388489209,87,52,35,205.81375900326594,0.46613070937074735,0.7593535063935897,0.11752997007109577,1034597.3684277843,-1763.1253097982308,1032834.243117986,4391,1,579.8663101604278,72,115,39,39.45174948298027,0.5459001782531194,44.7060502283105,8105.146004071224,112.57147227876699,0
4590,31.38316021019566,1,0,188,0.005319148936170213,0.0,1.0,188,4800,3200,1600,0.6666666666666666,64,32,32,215.99258535921712,0.46636539045018394,0.7754100072465215,0.12340765552686075,1022859.4705150892,1786.012299142751,1024645.482814232,4392,0,577.7765957446809,68,120,37,39.171397035635444,0.54510195035461,44.685990338164245,8012.560469124824,117.83177160477682,8
4591,31.905517542369683,5,1,192,0.025906735751295335,0.0051813471502590676,0.9948186528497409,193,5950,4300,1650,0.7226890756302521,76,43,33,211.7327170563,0.46677101324122044,0.7761833391330075,0.12259233556444094,1043986.6360486994,-340.77459578834987,1043645.861452911,4393,0,563.7823834196892,76,117,40,38.76641547682004,0.548089378238342,44.18290043290044,8161.976957876242,107.39443365626634,0
4592,32.27065556632277,1,2,191,0.0051813471502590676,0.010362694300518135,0.9896373056994818,193,6250,4300,1950,0.688,82,43,39,220.93546929683515,0.4666968012377663,0.7782311952831873,0.12664485907613424,1052808.023461254,1670.5269485773606,1054478.5504098313,4394,0,564.2279792746114,67,126,44,38.91835332333835,0.5418825561312608,44.56188725490198,8243.155354908627,123.03216947624817,8
4593,31.99831559805593,3,1,193,0.015463917525773196,0.005154639175257732,0.9948453608247423,194,6250,4900,1350,0.784,76,49,27,224.86411502296107,0.46734059790253374,0.7803788832373995,0.12759266154778948,1040760.3717154872,1755.9319873539807,1042516.3037028412,4395,0,562.2783505154639,85,109,33,39.21394904307357,0.5375859106529209,44.94912790697673,8161.19829879191,96.014097632846,8
4594,31.96865600871137,3,1,195,0.015306122448979591,0.00510204081632653,0.9948979591836735,196,6500,4400,2100,0.676923076923077,86,44,42,185.5633817075945,0.46751700680272107,0.7426246120467024,0.1056063941236835,1040722.1515561751,-7076.015627846615,1033646.1359283285,4396,0,557.2448979591836,94,102,38,40.10060805294145,0.5406037414965986,44.835526315789465,8157.265284854383,86.77941792398279,8
4595,31.476064288268205,4,0,199,0.020100502512562814,0.0,1.0,199,6500,4600,1900,0.7076923076923077,84,46,38,185.65138159821686,0.46805999695446937,0.7474897539234562,0.10667965335228244,1027630.0153090624,-8143.813577215232,1019486.2017318472,4397,0,549.1909547738693,83,116,38,39.72528228024196,0.5428706030150754,44.469246031746025,8043.1024395343875,96.904848669089,0
4596,31.510606395999208,3,3,199,0.01485148514851485,0.01485148514851485,0.9851485148514851,202,5700,3700,2000,0.6491228070175439,77,37,40,227.63931812609502,0.46860171091736036,0.7945316421043029,0.12906770840070964,1024660.2900499807,550.5939475727637,1025210.8839975535,4398,0,542.019801980198,77,125,37,39.17334345761763,0.5343440594059405,44.97863247863247,8035.877934535249,104.36205109786037,8
4597,31.160620180090206,4,2,201,0.019704433497536946,0.009852216748768473,0.9901477832512315,203,5250,3600,1650,0.6857142857142857,69,36,33,224.93811853470595,0.46922808044351233,0.7901550489789855,0.12883735627688714,1016355.0439318668,-126.60173094125639,1016228.4422009256,4399,0,535.7044334975369,72,131,40,38.84679311693394,0.5373563218390804,44.59189497716897,7958.674951533072,110.537152104626,0
4598,31.6456847336023,5,9,197,0.024271844660194174,0.043689320388349516,0.9563106796116505,206,5150,3300,1850,0.6407766990291263,70,33,37,194.0689022368376,0.4700015786565633,0.768474473661491,0.11427108147869126,1040590.8227891502,-5960.736268716417,1034630.0865204338,4400,0,527.5679611650486,73,133,41,38.57608775204011,0.5458131067961165,43.552927927927925,8115.443193648176,111.17045470750926,8
4599,31.878601238167338,2,2,197,0.010050251256281407,0.010050251256281407,0.9899497487437185,199,5800,4300,1500,0.7413793103448276,73,43,30,195.43753769518963,0.4690931509398846,0.7630116556316575,0.11570571273817123,1049905.6030660723,-4561.806824877249,1045343.796241195,4401,0,546.2663316582915,72,127,42,38.33456114014602,0.5472675879396984,43.350456621004525,8181.628451336632,113.63372849078655,0
4600,31.564399073325806,1,3,195,0.005050505050505051,0.015151515151515152,0.9848484848484849,198,6500,4600,1900,0.7076923076923077,84,46,38,194.58972070932913,0.46851178878463146,0.760786190006479,0.11586420781707354,1041272.1279484711,-5575.829488020022,1035696.2984604511,4402,0,549.6717171717172,74,124,36,38.14063570166901,0.5494002525252526,43.13888888888886,8107.666617528918,109.56306239903944,0
4601,31.296915232712756,2,1,196,0.01015228426395939,0.005076142131979695,0.9949238578680203,197,5450,3700,1750,0.6788990825688074,72,37,35,193.05313950393202,0.46710003798473704,0.7581494358361185,0.11581450718215097,1034669.9857835677,-4900.742178798998,1029769.2436047686,4403,0,553.4010152284264,80,117,42,37.898537134283565,0.5516603214890017,42.86265432098763,8047.605710880742,100.59507138600927,0
4602,30.994276909831758,0,2,194,0.0,0.01020408163265306,0.9897959183673469,196,5700,4300,1400,0.7543859649122807,71,43,28,197.0851615872382,0.46674843014128725,0.7618344567045983,0.11844414564134122,1025186.097288074,-4490.206471798278,1020695.8908162757,4404,1,557.2142857142857,81,115,42,37.72817166329169,0.5530399659863945,42.797256097560954,7971.81306648068,98.41744526519358,0
4603,30.6394539533328,1,3,192,0.005128205128205128,0.015384615384615385,0.9846153846153847,195,6350,4500,1850,0.7086614173228346,82,45,37,200.06914060724728,0.4665642347343378,0.765090679537594,0.12101389900845812,1015307.5464260763,-4723.6583468964145,1010583.8880791799,4405,0,559.3333333333334,70,125,43,37.41107216808192,0.5556089743589744,42.56161971830986,7887.771398461431,112.68244854944902,0
4604,30.41780062832719,0,1,191,0.0,0.005208333333333333,0.9947916666666666,192,5500,3800,1700,0.6909090909090909,72,38,34,200.95210997106827,0.4658015652268761,0.763651553125237,0.12198877049281086,1008996.8122807409,-3347.9923236204786,1005648.8199571205,4406,1,566.84375,70,122,44,37.25364547732969,0.5575086805555556,42.42957746478875,7834.725760430087,111.92465372042982,0
4605,30.90487608434738,2,0,193,0.010362694300518135,0.0,1.0,193,5300,3600,1700,0.6792452830188679,70,36,34,210.72368369328748,0.4660423862982153,0.7728632122227546,0.12672002532332352,1022411.8068841489,-810.7235603728932,1021601.0833237759,4407,0,564.7357512953367,78,115,41,37.353906089809286,0.5526230569948187,42.77426160337549,7949.529570852353,101.91704578015836,8
4606,31.17537682723115,0,2,191,0.0,0.010362694300518135,0.9896373056994818,193,5700,4000,1700,0.7017543859649122,74,40,34,209.64120047861806,0.46573204519286127,0.7716641144511351,0.12629604028833818,1031889.4123548965,-1034.6929665487824,1030854.7193883478,4408,1,565.7357512953367,69,124,41,37.31443994601892,0.5539183937823835,42.708333333333336,8021.164662839681,116.2487632295606,0
4607,31.309007289931394,3,2,192,0.015463917525773196,0.010309278350515464,0.9896907216494846,194,5850,4400,1450,0.7521367521367521,73,44,29,204.77131299254972,0.46571530634047326,0.7670706362091835,0.12408673990139503,1038037.4491967291,-2137.941718509844,1035899.5074782192,4409,0,563.7371134020618,72,122,42,37.22131404928146,0.5560030068728523,42.49429223744291,8062.248081536824,111.97566779912256,0
4608,31.274337996975245,0,0,192,0.0,0.0,1.0,192,6650,4800,1850,0.7218045112781954,85,48,37,204.89763684190842,0.4653260662085515,0.7658015243395908,0.12469958302845757,1038152.4652388782,-2507.002638190545,1035645.4626006876,4410,1,568.5885416666666,72,120,43,37.057881523324276,0.5585394965277778,42.33732876712328,8058.229469340486,111.91985374084008,0
4609,31.244994279225434,0,1,191,0.0,0.005208333333333333,0.9947916666666666,192,5900,4100,1800,0.6949152542372882,77,41,36,207.73973009939715,0.46496873182082604,0.7678411648586818,0.1269770447711743,1038442.4455586046,-1154.8493271794987,1037287.5962314251,4411,2,569.5885416666666,72,120,42,36.82442716404694,0.5601128472222222,42.18036529680366,8055.573011373368,111.88295849129678,0
4610,31.1995074146109,0,3,188,0.0,0.015706806282722512,0.9842931937172775,191,6300,4400,1900,0.6984126984126984,82,44,38,207.35478191247483,0.46459538899605035,0.7648770725726317,0.12732611814956118,1038270.2105473906,-1441.941385145261,1036828.2691622453,4412,3,571.1832460732984,74,117,35,36.664423508299684,0.56228184991274,42.01388888888889,8049.039586477753,108.77080522267234,0
4611,30.980566622258205,1,3,186,0.005291005291005291,0.015873015873015872,0.9841269841269842,189,6250,4600,1650,0.736,79,46,33,209.2874854884448,0.4643115126271155,0.7649647918645888,0.12913298378477928,1032372.2710137598,-837.4806623068489,1031534.7903514529,4413,0,577.3756613756614,77,112,37,36.43731786594931,0.564429012345679,41.840277777777786,7997.934473489248,103.86927887648375,0
4612,31.4945235590739,0,3,183,0.0,0.016129032258064516,0.9838709677419355,186,6000,4600,1400,0.7666666666666667,74,46,28,213.53403543110997,0.4640735493558074,0.7666589703023321,0.13234307181873758,1050805.0758746928,1676.5296606033771,1052481.605535296,4414,1,587.1989247311828,79,107,40,36.16366962380499,0.5665882616487455,41.6796875,8135.67516781858,102.9832299723871,0
4613,31.472482259957253,1,1,183,0.005434782608695652,0.005434782608695652,0.9945652173913043,184,5750,3800,1950,0.6608695652173913,77,38,39,214.31378500110242,0.46377059079749744,0.7651549610471289,0.13327268215088856,1051047.5425045893,2500.7954100532297,1053548.3379146426,4415,0,594.3152173913044,67,117,41,36.020698733527,0.5675951086956521,41.559436274509814,8133.766057103858,121.39949338960982,0
4614,31.785894062431,1,0,184,0.005434782608695652,0.0,1.0,184,5400,3600,1800,0.6666666666666666,72,36,36,211.21648487915186,0.46376935336976316,0.7618791816543489,0.13207125219253574,1063129.7155843836,2710.104299261152,1065839.8198836448,4416,0,595.1467391304348,71,113,40,35.90000419533481,0.5692934782608696,41.36284722222222,8221.013138803222,115.7889174479327,0
4615,31.91810561025828,0,0,184,0.0,0.0,1.0,184,6600,4900,1700,0.7424242424242424,83,49,34,211.90029060166688,0.4636289053219292,0.7622699735674794,0.13344349088462493,1069638.746881716,1931.3522606077167,1071570.0991423237,4417,1,596.1467391304348,72,112,38,35.62427658049934,0.5711616847826086,41.1101598173516,8263.273260372667,114.7676841718426,0
4616,31.929262524764695,0,3,181,0.0,0.016304347826086956,0.9836956521739131,184,5900,4500,1400,0.7627118644067796,73,45,28,214.88883933092478,0.4634191613209788,0.7673854464635788,0.12797050326980816,1053355.003963316,2570.846841019761,1055925.850804336,4418,2,597.1467391304348,75,109,44,37.613443341692914,0.5541213768115942,43.13322368421053,8201.566734876851,109.35422313169134,8
4617,32.146007083743356,2,1,182,0.01092896174863388,0.00546448087431694,0.994535519125683,183,5850,4000,1850,0.6837606837606838,77,40,37,228.72816800336267,0.4632548689925739,0.7825642932243557,0.13447259246144194,1056571.6471030035,5883.539441232927,1062455.1865442365,4419,0,599.4972677595629,66,117,38,37.74571483435408,0.5494649362477231,43.61007462686566,8241.912357245184,124.87745995826037,8
4618,32.25380888243084,3,0,185,0.016216216216216217,0.0,1.0,185,5100,3200,1900,0.6274509803921569,70,32,38,221.51050899046112,0.46337029964747356,0.7793277679462127,0.13159799485237766,1063327.8972109081,5007.660746988955,1068335.557957897,4420,0,593.9675675675676,70,115,41,37.533924694320646,0.5518018018018018,43.22183098591549,8282.073988560793,118.31534269372561,0
4619,32.68967620944401,1,1,185,0.005376344086021506,0.005376344086021506,0.9946236559139785,186,5300,3500,1800,0.660377358490566,71,35,36,217.43635054743672,0.46371996996996995,0.7729634768309772,0.12380559551578496,1064348.4984929867,3785.610644591655,1068134.1091375784,4421,0,591.7688172043011,81,105,39,39.26846873755474,0.5375784050179211,44.817073170731696,8341.847252226991,102.98576854601224,8
4620,32.28338650627558,0,1,184,0.0,0.005405405405405406,0.9945945945945946,185,5100,3400,1700,0.6666666666666666,68,34,34,215.6624224832714,0.46354289071680377,0.7700529476845268,0.12292758081546454,1051457.4569280492,3251.9724598405583,1054709.4293878898,4422,1,595.8486486486487,66,119,39,39.27189936647173,0.5382882882882882,44.77611940298507,8239.491182944947,124.84077549916586,0
4621,32.182736640551866,5,1,188,0.026455026455026454,0.005291005291005291,0.9947089947089947,189,5400,4000,1400,0.7407407407407407,68,40,28,202.34333733088516,0.4648087170250291,0.7596845151776583,0.11653513043423903,1051407.1531513273,-650.9535475589055,1050756.1996037683,4423,0,584.074074074074,73,116,43,39.21121528351415,0.5414462081128748,44.38344594594596,8226.440240087042,112.69096219297317,0
4622,31.84375355841826,2,3,187,0.010526315789473684,0.015789473684210527,0.9842105263157894,190,6650,5000,1650,0.7518796992481203,83,50,33,223.8618143894824,0.46524586930288686,0.7844829119694021,0.13083479374318693,1044832.8822809592,2129.636952241797,1046962.5192332009,4424,0,581.8315789473684,76,114,41,38.096526897620045,0.5473135964912281,43.831168831168846,8157.377129088351,107.33390959326778,8
4623,31.600200733677266,1,1,187,0.005319148936170213,0.005319148936170213,0.9946808510638298,188,6200,4600,1600,0.7419354838709677,78,46,32,222.96259192047643,0.46453663670497214,0.7821520208509831,0.13076320055760668,1037894.2039185483,2482.316368983803,1040376.5202875321,4425,0,588.6542553191489,63,125,41,37.98666677250693,0.5488696808510638,43.701171875,8099.094416556247,128.55705423105152,0
4624,31.519311974626174,0,1,186,0.0,0.0053475935828877,0.9946524064171123,187,6200,3900,2300,0.6290322580645161,85,39,46,222.74012169778553,0.4644943265673816,0.780418004429529,0.13122575169738124,1036601.7974759494,2578.5621043873143,1039180.3595803367,4426,1,589.5935828877006,66,121,42,37.81977449078563,0.5508021390374331,43.53233830845772,8083.684240258616,122.48006424634266,0
4625,31.832720948156215,0,0,186,0.0,0.0,1.0,186,7200,5500,1700,0.7638888888888888,89,55,34,222.7323895352074,0.46429938002518645,0.779282332522004,0.1317518710979447,1048133.9868637474,2290.6774894452096,1050424.6643531926,4427,2,593.747311827957,67,119,39,37.66664676854508,0.5523073476702509,43.38235294117647,8168.837949195968,121.92295446561145,0
4626,31.838747538811866,2,2,186,0.010638297872340425,0.010638297872340425,0.9893617021276596,188,5750,4200,1550,0.7304347826086957,73,42,31,215.29459201507106,0.46511560378503436,0.7743481562009289,0.12824069176549877,1050436.147071023,1880.644344307797,1052316.7914153307,4428,0,588.4202127659574,69,119,39,37.59462016761288,0.5540226063829787,43.125,8178.578274032296,118.53011991351153,0
4627,32.15304864296657,1,1,186,0.0053475935828877,0.0053475935828877,0.9946524064171123,187,6350,4700,1650,0.7401574803149606,80,47,33,217.8497910193025,0.4648728748586433,0.7753713771612318,0.13017500783867383,1061772.32473242,2511.375810607257,1064283.7005430274,4429,0,592.3850267379679,72,115,39,37.409425319267044,0.5554812834224598,43.0079908675799,8263.076570488394,114.76495236789437,0
4628,32.526820511018784,3,0,189,0.015873015873015872,0.0,1.0,189,5800,4400,1400,0.7586206896551724,72,44,28,196.05460806528865,0.4655334158880258,0.7496594572917146,0.1155424095215987,1069839.3167260578,-1650.6144132870486,1068188.7023127708,4430,0,587.1005291005291,76,113,42,38.491613481723704,0.5517526455026456,43.520021645021664,8342.478220622415,109.76945027134757,8
4629,32.57382342362542,3,1,191,0.015625,0.005208333333333333,0.9947916666666666,192,6600,5100,1500,0.7727272727272727,81,51,30,195.39976957660633,0.4662202543266434,0.7526930416790312,0.11626228785461544,1074347.9407247887,-3014.5319874548804,1071333.4087373337,4431,0,578.9114583333334,81,111,45,38.14711313351138,0.5545247395833333,43.16565040650407,8366.076752780233,103.284898182472,0
4630,32.78265648035073,2,3,190,0.010362694300518135,0.015544041450777202,0.9844559585492227,193,4650,3000,1650,0.6451612903225806,63,30,33,193.20870531435372,0.46644717904432925,0.7500211229394138,0.11547893829183047,1082639.0028487204,-1414.9439873548808,1081224.0588613655,4432,0,576.7305699481865,85,108,36,38.0335485593993,0.5564550949913645,42.99903100775196,8425.174481590195,99.11969978341406,0
4631,32.68503480553252,0,2,188,0.0,0.010526315789473684,0.9894736842105263,190,6650,5300,1350,0.7969924812030075,80,53,27,198.70953081170236,0.46560266406757633,0.7555598945621407,0.11909781884752882,1080275.786985912,-1717.7810441573301,1078558.0059417547,4433,2,586.8315789473684,82,108,39,37.78769647564192,0.5575657894736843,42.89658634538153,8403.434023922431,102.48090273076136,0
4632,32.56777389177141,0,2,186,0.0,0.010638297872340425,0.9893617021276596,188,5800,4300,1500,0.7413793103448276,73,43,30,202.86873222319275,0.46530701255357076,0.7587510540996365,0.12209347553982992,1077669.0154163295,325.0693827454693,1077994.084799075,4434,3,592.9574468085107,84,104,41,37.52620045731708,0.5589539007092199,42.74509803921569,8378.219479608659,99.74070809057928,0
4633,32.58789528849955,0,1,185,0.0,0.005376344086021506,0.9946236559139785,186,5800,3400,2400,0.5862068965517241,82,34,48,180.94753261531466,0.46462389809164,0.7314406248810352,0.10391940551493227,1063755.1438092142,-4503.226284174649,1059251.9175250395,4435,4,599.2956989247311,75,111,47,39.866743553982054,0.5461469534050178,44.49013157894738,8326.528837283582,111.02038449711443,8
4634,32.659494081073206,3,0,188,0.015957446808510637,0.0,1.0,188,6200,5100,1100,0.8225806451612904,73,51,22,169.6887594157139,0.4656975338491296,0.711597855622901,0.09631087637585627,1062351.0575929054,-7746.193394618162,1054604.8641982873,4436,0,593.8404255319149,91,97,42,40.6107578313431,0.5406139184397163,44.93885869565214,8330.167834741012,91.54030587627486,8
4635,32.484637058869396,3,0,191,0.015706806282722512,0.0,1.0,191,5700,3800,1900,0.6666666666666666,76,38,38,170.5760595208929,0.46664370349958667,0.718977745346161,0.09760634586982884,1059236.2382900657,-7763.931274149518,1051472.307015916,4437,0,585.4973821989529,82,109,39,40.27248787759651,0.5428664921465969,44.62851405622489,8295.650036067665,101.16646385448372,0
4636,32.94146793277158,2,0,193,0.010362694300518135,0.0,1.0,193,5500,4100,1400,0.7454545454545455,69,41,28,171.0599500656689,0.4671848013816926,0.7216534877924434,0.09851521105885987,1076185.3003185494,-7281.5592532207465,1068903.7410653287,4438,0,580.419689119171,86,107,44,40.01202242103456,0.5451208981001727,44.38457854406128,8420.347209012622,97.9110140582863,0
4637,32.721757843331005,3,2,194,0.015306122448979591,0.01020408163265306,0.9897959183673469,196,5600,4300,1300,0.7678571428571429,69,43,26,165.6477349674469,0.46744396476539335,0.7180358802222604,0.09606038394994373,1071191.0963518382,-9311.924234404605,1061879.1721174335,4439,0,572.5204081632653,91,105,36,39.88510737938253,0.5473001700680272,44.12364130434781,8372.72424707238,92.00795875903714,0
4638,32.33087600928329,1,0,195,0.005128205128205128,0.0,1.0,195,5600,3700,1900,0.6607142857142857,75,37,38,169.40727188115684,0.467340734866508,0.7245287590739777,0.098603056108673,1059540.5192333444,-8701.226237827113,1050839.2929955171,4440,0,574.3641025641026,92,103,39,39.64813842586521,0.5490918803418803,43.98521505376343,8277.182268640065,89.96937248521809,0
4639,32.28056946945065,1,1,195,0.00510204081632653,0.00510204081632653,0.9948979591836735,196,6100,4200,1900,0.6885245901639344,80,42,38,169.76430278686772,0.46735511512297223,0.7267317455119076,0.09928613498936474,1059378.3875730142,-9331.073329238287,1050047.314243776,4441,0,572.4285714285714,93,103,42,39.456138169182616,0.5509672619047619,43.80540780141843,8270.107331163874,88.92588528133197,0
4640,32.30032899437522,3,1,197,0.015151515151515152,0.005050505050505051,0.9949494949494949,198,5200,3500,1700,0.6730769230769231,69,35,34,189.03109217207333,0.46805619648259245,0.7543505255609768,0.1058074474510288,1046274.1581348558,-5244.330635270473,1041029.8274995853,4442,0,567.6161616161617,77,121,41,40.66140012592469,0.5314604377104377,45.472756410256395,8221.313705980167,106.7703078698723,8
4641,32.20394022611762,3,2,198,0.015,0.01,0.99,200,5900,3900,2000,0.6610169491525424,79,39,40,185.6870271514385,0.468483040201005,0.7513487738419622,0.10484175225319624,1045890.3609942932,-7058.345628125185,1038832.0153661681,4443,0,562.915,86,114,36,40.40644868301544,0.5341666666666667,45.13888888888887,8207.531988184099,95.43641846725696,0
4642,32.408049234207596,3,0,201,0.014925373134328358,0.0,1.0,201,6300,4300,2000,0.6825396825396826,83,43,40,191.01972965261947,0.46860696517412936,0.7601260518751971,0.10849960922545909,1054410.2835669373,-6217.366538020745,1048192.9170289165,4444,0,560.9800995024875,87,114,40,40.037316318638794,0.5363287728026533,44.910037878787854,8266.968051576321,95.02262128248645,0
4643,32.49750154015805,1,2,200,0.0049504950495049506,0.009900990099009901,0.9900990099009901,202,5700,3700,2000,0.6491228070175439,77,37,40,188.76833544509043,0.46865404824064494,0.7603876922911195,0.10794730473275319,1059454.3607758186,-6101.712767260866,1053352.6480085577,4445,0,559.1980198019802,74,128,40,39.8326307678361,0.5381600660066006,44.65277777777781,8298.146747441822,112.13711820867327,0
4644,32.56777746953733,4,0,204,0.0196078431372549,0.0,1.0,204,6000,5000,1000,0.8333333333333334,70,50,20,202.51251520261422,0.469169061302682,0.7664209914735114,0.11727315653096915,1065708.1737421,-3636.151452700262,1062072.0222893995,4446,0,554.5098039215686,82,122,44,38.99596497252748,0.5411049836601307,44.17670682730926,8331.596083572462,101.60483028746904,0
4645,32.48770161995976,2,1,205,0.009708737864077669,0.0048543689320388345,0.9951456310679612,206,6400,3700,2700,0.578125,91,37,54,203.38424476286636,0.4694806219906859,0.7706097532519507,0.11867371951697439,1065455.0379273535,-4260.64635647042,1061194.391570883,4447,0,550.1165048543689,87,119,40,38.68321316324652,0.5435881877022654,43.89204545454548,8320.358809771014,95.63630815828752,0
4646,32.61369676434,0,0,205,0.0,0.0,1.0,205,5550,4000,1550,0.7207207207207207,71,40,31,208.92413288232342,0.4691365773951857,0.7699482829278328,0.12100137391590665,1067250.5445646248,-1955.1210817291976,1065295.4234828956,4448,1,553.770731707317,78,127,47,38.82707538741709,0.5402439024390244,44.17194092827007,8343.498742375132,106.96793259455298,8
4647,32.75482789191534,2,2,205,0.00966183574879227,0.00966183574879227,0.9903381642512077,207,6500,4500,2000,0.6923076923076923,85,45,40,204.96441649918103,0.4693807357378485,0.7691364086971297,0.11950157497675568,1073967.9666715774,-3874.956474469167,1070093.0101971081,4449,0,549.4106280193237,84,123,35,38.672872001020906,0.5424718196457328,43.92156862745101,8387.804946439579,99.85482079094737,0
4648,32.850771938622216,0,2,203,0.0,0.00975609756097561,0.9902439024390244,205,7550,5600,1950,0.7417218543046358,95,56,39,198.44236359011668,0.46912561772676553,0.7694223715987543,0.11556062071712514,1076736.2602627194,-5815.982310056335,1070920.2779526631,4450,1,555.7463414634146,76,129,35,38.88565993870865,0.5407520325203252,43.966450216450234,8410.899752575317,110.66973358651732,8
4649,32.87651730300631,3,1,205,0.014563106796116505,0.0048543689320388345,0.9951456310679612,206,6250,4500,1750,0.72,80,45,35,195.60958876854173,0.4696902873154945,0.7757688093876391,0.11158457918011178,1071025.0792216351,-5549.444938532113,1065475.634283103,4451,0,553.9077669902913,68,138,45,39.75337118523777,0.5345368122977346,44.74637681159421,8391.850159408696,123.40956116777494,8
4650,32.33390033309391,1,1,205,0.0048543689320388345,0.0048543689320388345,0.9951456310679612,206,5900,4300,1600,0.7288135593220338,75,43,32,192.33815532706114,0.4696922606361986,0.7725514698814246,0.11044970324299772,1055431.7236559559,-6500.041839670791,1048931.681816285,4452,0,554.8689320388349,69,137,44,39.57969326344396,0.5364583333333333,44.494047619047606,8261.503998797929,119.73194201156419,0
4651,31.83729734948317,3,2,206,0.014423076923076924,0.009615384615384616,0.9903846153846154,208,6000,4100,1900,0.6833333333333333,79,41,38,184.5932425439315,0.47027562941285767,0.7631476623798714,0.10449287388051826,1034783.4165506819,-9397.194761644618,1025386.2217890373,4453,0,550.1682692307693,87,121,41,40.33386144513055,0.5329026442307692,45.0402462121212,8117.229493495668,93.30148843098469,8
4652,31.347788054013925,2,3,205,0.009615384615384616,0.014423076923076924,0.9855769230769231,208,5900,3700,2200,0.6271186440677966,81,37,44,196.9168317568058,0.4701454694661216,0.7711676418548425,0.10903679801313187,1012083.4054748206,-7640.748464051874,1004442.6570107688,4454,0,551.0817307692307,89,119,35,40.88737379488348,0.5243389423076923,45.89120370370371,7965.748688956912,89.50279425794282,8
4653,31.12075808479727,4,1,208,0.019138755980861243,0.004784688995215311,0.9952153110047847,209,6650,5300,1350,0.7969924812030075,80,53,27,198.3029448427043,0.470315183719789,0.7704403116236482,0.11151449890780407,1009484.4475236955,-8413.252256628552,1001071.1952670669,4455,0,546.2105263157895,82,127,42,40.242773261065906,0.5294059011164274,45.29367469879515,7926.6539323664,96.66651137032196,8
4654,31.541297905622784,7,5,210,0.03255813953488372,0.023255813953488372,0.9767441860465116,215,6000,4500,1500,0.75,75,45,30,194.33623329278126,0.4714355574875027,0.7716192666581814,0.11042777397151655,1026333.6455524749,-9109.237044337093,1017224.4085081378,4456,0,531.8976744186047,90,125,39,39.93706811451135,0.532751937984496,44.894688644688614,8046.352622764443,89.40391803071604,0
4655,31.784951941564245,3,0,213,0.014084507042253521,0.0,1.0,213,6150,4600,1550,0.7479674796747967,77,46,31,195.6672320237123,0.47075969970768,0.7731837761966986,0.1116454206252949,1035542.2881515878,-8225.661366775432,1027316.6267848124,4457,0,537.2488262910798,75,138,41,39.742178550973655,0.534330985915493,44.736842105263165,8113.527206136153,108.18036274848204,0
4656,31.616968415562482,2,3,212,0.009302325581395349,0.013953488372093023,0.986046511627907,215,6100,4200,1900,0.6885245901639344,80,42,38,192.41873168481385,0.4710407157864232,0.7748477626577328,0.10921707956384857,1028454.5499242428,-9521.21598162052,1018933.3339426223,4458,0,533.2418604651162,85,130,40,40.02912590622723,0.5320251937984496,44.93701550387595,8064.318324792998,94.8743332328588,8
4657,32.00072668731057,2,4,210,0.009345794392523364,0.018691588785046728,0.9813084112149533,214,5600,4200,1400,0.75,70,42,28,191.07376399306472,0.4708323278194609,0.7731510765416973,0.1087662300078816,1041834.3636085114,-8586.557337600783,1033247.8062709107,4459,0,536.6121495327103,87,127,43,39.951494874054845,0.5335377725856698,44.82717803030302,8165.715733881991,93.85880153887345,0
4658,31.944881846782163,1,1,210,0.004739336492890996,0.004739336492890996,0.995260663507109,211,6550,4400,2150,0.6717557251908397,87,44,43,187.66091039305158,0.47064432408034307,0.7723812346404324,0.10459693555837242,1033431.487983345,-9963.061227240023,1023468.426756105,4460,0,545.0236966824644,73,138,45,40.86284818299208,0.5250789889415481,45.636261261261254,8125.619580114758,111.30985726184599,8
4659,31.73433594157598,7,7,210,0.03225806451612903,0.03225806451612903,0.967741935483871,217,6000,3900,2100,0.65,81,39,42,180.96224214668217,0.472542242703533,0.7707575768232557,0.10229680212193819,1031011.194348343,-12085.180518479297,1018926.0138298636,4461,0,530.852534562212,82,135,42,40.48001493443616,0.5291378648233487,45.09287148594375,8089.308450167492,98.65010305082308,0
4660,31.383632559994304,3,1,212,0.014084507042253521,0.004694835680751174,0.9953051643192489,213,6300,4600,1700,0.7301587301587301,80,46,34,183.55593824592464,0.4714545132429799,0.7702304255750481,0.10438271178207849,1021439.4511292732,-11401.744637312957,1010037.7064919602,4462,0,540.962441314554,84,129,47,40.18204524712996,0.5311521909233177,44.86519607843136,8007.056939540677,95.3221064231033,0
4661,31.76959092709614,3,2,213,0.013953488372093023,0.009302325581395349,0.9906976744186047,215,7050,5200,1850,0.7375886524822695,89,52,37,179.23220791176377,0.47220260088386584,0.7659146601742186,0.10258777347790089,1036005.3680989414,-12912.894093437259,1023092.4740055042,4463,0,536.2790697674419,71,144,46,40.04078857919781,0.5333817829457365,44.618055555555564,8113.379905166421,114.27295641079466,0
4662,32.20769702771813,1,0,214,0.004672897196261682,0.0,1.0,214,6950,4900,2050,0.7050359712230215,90,49,41,178.29402391042598,0.47260248928670673,0.7627375361900042,0.1026319963097778,1052063.457303769,-12234.674557638906,1039828.78274613,4464,0,539.1495327102804,74,140,47,39.845632052745,0.5354361370716512,44.40277777777781,8232.197894459749,111.2459174926993,0
4663,31.779176302014065,5,5,214,0.0228310502283105,0.0228310502283105,0.9771689497716896,219,5950,4500,1450,0.7563025210084033,74,45,29,198.3618128613405,0.47294223814111963,0.7908398346571095,0.11561183690778068,1041872.183575161,-8416.46897924535,1033455.7145959156,4465,0,527.8173515981736,78,141,43,38.855239443872286,0.5380041856925419,43.93459915611816,8137.547518263668,104.32753228543164,8
4664,32.078414433280656,1,1,214,0.004651162790697674,0.004651162790697674,0.9953488372093023,215,7000,4900,2100,0.7,91,49,42,186.10567834554865,0.4718457943925234,0.7702841674519791,0.10642466240693392,1045791.6592792846,-11074.446768342175,1034717.2125109425,4466,0,538.5441860465116,74,141,41,39.900620977245964,0.5373062015503876,44.65277777777779,8191.134018831493,110.69100025447965,8
4665,31.62243322680695,2,4,212,0.009259259259259259,0.018518518518518517,0.9814814814814815,216,7150,5300,1850,0.7412587412587412,90,53,37,183.04922617880547,0.4719952268159633,0.7683089055433314,0.10564555339462539,1033746.0065587541,-12504.718686797736,1021241.2878719564,4467,0,536.8425925925926,78,138,44,39.623298267326774,0.5395447530864197,44.303797468354446,8085.736090905107,103.66328321673214,0
4666,31.98040033566876,3,2,213,0.013953488372093023,0.009302325581395349,0.9906976744186047,215,6650,4300,2350,0.6466165413533834,90,43,47,184.13295210641712,0.47236108092443674,0.76893051537292,0.10695025042170855,1047411.8619618219,-11077.39235713788,1036334.469604684,4468,0,539.953488372093,82,133,39,39.35112538616191,0.5421027131782945,44.06375502008034,8184.943574865687,99.81638505933765,0
4667,32.39761885300687,2,2,213,0.009302325581395349,0.009302325581395349,0.9906976744186047,215,6750,5100,1650,0.7555555555555555,84,51,33,183.60154573917865,0.4724896761573571,0.7682376566902509,0.10719045516843476,1062674.3138994314,-10728.270670148198,1051946.043229283,4469,0,540.8651162790698,85,130,42,39.16855827737318,0.5442344961240311,43.87112403100778,8297.965700892562,97.62312589285368,0
4668,32.816023156192,2,1,214,0.009302325581395349,0.004651162790697674,0.9953488372093023,215,6450,4800,1650,0.7441860465116279,81,48,33,181.24418229687865,0.4723746649279142,0.7666600802398618,0.10642689836825414,1078213.1617537178,-10366.027431242965,1067847.134322475,4470,0,541.8093023255814,76,139,46,39.00920453146165,0.5465600775193798,43.65530303030304,8412.21351172461,110.6870198911133,0
4669,33.25821045957662,3,1,216,0.013824884792626729,0.004608294930875576,0.9953917050691244,217,7700,5600,2100,0.7272727272727273,98,56,42,178.4820982846854,0.47237334300506345,0.7659510622336425,0.10590496789000295,1096052.4514220336,-11974.851728024256,1084077.5996940094,4471,0,537.6451612903226,81,136,47,38.685056902523506,0.549347158218126,43.26727642276423,8538.470952592032,105.41322163693866,0
4670,32.98110884250197,1,3,214,0.004608294930875576,0.013824884792626729,0.9861751152073732,217,6400,4500,1900,0.703125,83,45,38,175.05526965559827,0.472569800022757,0.7561082360056361,0.10161561500151411,1079993.073359948,-11988.304263359389,1068004.7690965885,4472,0,538.4930875576036,98,119,36,39.606803168599086,0.5432507680491552,44.086700336700325,8440.304390439063,86.12555500448023,8
4671,33.38896494628801,0,4,210,0.0,0.018691588785046728,0.9813084112149533,214,6700,4600,2100,0.6865671641791045,88,46,42,178.37010609181786,0.4720627111579132,0.75924930247384,0.10391756121006472,1094517.7434809797,-10454.150795183936,1084063.5926857959,4473,1,545.696261682243,98,116,39,39.382747757002925,0.5454147196261683,43.949915824915834,8549.24728501601,87.23721719404092,0
4672,33.655246837965535,1,1,210,0.004739336492890996,0.004739336492890996,0.995260663507109,211,6050,4000,2050,0.6611570247933884,81,40,41,184.73490516456377,0.4712028887384338,0.7650653655408584,0.10811145520658591,1104700.627437463,-7434.646871020885,1097265.9805664422,4474,0,554.1943127962086,99,112,42,39.04799535173667,0.5473439968404423,43.78125000000002,8623.105275765049,87.10207349257625,0
4673,33.53066273815082,2,2,210,0.009433962264150943,0.009433962264150943,0.9905660377358491,212,7150,5100,2050,0.7132867132867133,92,51,41,183.18414439869974,0.47118067975200456,0.7651068764495679,0.10811456365491935,1103322.0950353895,-9127.77720495211,1094194.3178304373,4475,0,551.7924528301887,76,136,42,38.76661129568106,0.5503636006289307,43.46590909090911,8601.7580831109,113.18102740935396,0
4674,33.80466056243208,2,1,211,0.009433962264150943,0.0047169811320754715,0.9952830188679245,212,6850,4800,2050,0.7007299270072993,89,48,41,179.46443770957328,0.4710819435750693,0.7607098311040954,0.10686932343909945,1115209.1193665632,-9221.924492858183,1105987.194873705,4476,0,551.3490566037735,82,130,46,38.52522760215633,0.5526238207547169,43.13504016064258,8683.23277775226,105.89308265551537,0
4675,33.742470873413396,0,1,210,0.0,0.004739336492890996,0.995260663507109,211,5850,4200,1650,0.717948717948718,75,42,33,179.709555443958,0.4707881967953058,0.7604877404179391,0.10745319666968799,1114463.1863894789,-7994.063243058065,1106469.1231464208,4477,1,554.8767772511849,82,129,44,38.365622507609416,0.5537124802527646,42.984437751004016,8672.34012320071,105.76024540488672,0
4676,33.76142888440664,1,4,207,0.004739336492890996,0.018957345971563982,0.981042654028436,211,6600,4900,1700,0.7424242424242424,83,49,34,180.64937094449309,0.47078255472805236,0.7616052327188241,0.10862423213935098,1116883.2945249022,-8447.14708513274,1108436.1474397695,4478,0,554.5355450236967,89,122,46,38.131074514038886,0.5556872037914692,42.77777777777778,8684.189763044596,97.57516587690557,0
4677,34.083941801639035,1,2,206,0.004807692307692308,0.009615384615384616,0.9903846153846154,208,5700,3400,2300,0.5964912280701754,80,34,46,185.70483174471198,0.47028917766010153,0.7651118208789982,0.11196427584445597,1128415.2230355612,-5389.568173601852,1123025.6548619594,4479,0,562.5721153846154,71,137,48,37.900830241013566,0.5568409455128205,42.67939814814815,8770.500417881254,123.52817489973597,0
4678,33.92345532818155,2,1,207,0.009615384615384616,0.004807692307692308,0.9951923076923077,208,5800,4200,1600,0.7241379310344828,74,42,32,179.03373227882867,0.4703593382261861,0.7560735978061099,0.10851469206216927,1124789.8816677642,-7124.933891111637,1117664.9477766524,4480,0,562.9903846153846,74,134,49,37.87574384696978,0.5591947115384616,42.48611111111111,8735.760906108517,118.0508230555205,0
4679,33.988417514264306,1,1,207,0.004807692307692308,0.004807692307692308,0.9951923076923077,208,6500,4600,1900,0.7076923076923077,84,46,38,175.25177734530834,0.47011692137371486,0.7510963601143148,0.10686205532344695,1128856.8940504813,-8533.164589829921,1120323.7294606513,4481,0,562.3269230769231,77,131,48,37.750822581480904,0.5610476762820513,42.2676282051282,8759.915459505677,113.76513583773607,0
4680,33.41304016849521,0,4,203,0.0,0.01932367149758454,0.9806763285024155,207,5950,4200,1750,0.7058823529411765,77,42,35,202.76348074027635,0.4699308584650501,0.7840223779481628,0.12126743164472759,1103659.9641924063,-2593.6128213321367,1101066.351371074,4482,1,565.9661835748792,77,130,40,37.76390765180643,0.5523852657004831,42.975427350427324,8587.972370230424,111.53210870429122,8
4681,32.99853122797731,1,0,204,0.004901960784313725,0.0,1.0,204,6300,4400,1900,0.6984126984126984,82,44,38,204.27944780559568,0.4692193687819956,0.783588069571673,0.12302217644592339,1092124.3657298966,-2480.287526732253,1089644.0782031643,4483,0,574.3970588235294,79,125,42,37.46568019636621,0.5548917483660131,42.72135416666665,8489.81742882292,107.46604340282177,0
4682,32.78870257843401,0,1,203,0.0,0.004901960784313725,0.9950980392156863,204,6700,5000,1700,0.746268656716418,84,50,34,184.85098289609115,0.46897336520815225,0.750331925927046,0.10830807514578068,1076630.4978023958,-7696.758853063759,1068933.7389493322,4484,1,575.3970588235294,78,126,42,38.99976417116885,0.5491217320261438,43.736814345991576,8402.53737621134,107.72483815655563,8
4683,32.986693441149264,3,2,204,0.014563106796116505,0.009708737864077669,0.9902912621359223,206,6250,4600,1650,0.736,79,46,33,182.03037569199486,0.46947371536822163,0.7564470185328971,0.10288299501709652,1071643.6522092135,-8435.660676083602,1063207.99153313,4485,0,570.6893203883495,87,119,39,40.45946719915788,0.5335760517799353,45.099431818181785,8408.32690058831,96.64743563894609,8
4684,32.453893249506386,4,1,207,0.019230769230769232,0.004807692307692308,0.9951923076923077,208,6950,5100,1850,0.7338129496402878,88,51,37,181.69117106656702,0.4703303062678063,0.7605781785539416,0.10374853729029439,1057572.3430023454,-10119.688502457971,1047452.6544998875,4486,0,565.0480769230769,74,134,44,40.06990914531312,0.5366586538461539,44.70833333333334,8285.20849748859,111.96227699308905,0
4685,31.99511392374973,2,3,206,0.009569377990430622,0.014354066985645933,0.9856459330143541,209,7750,6200,1550,0.8,93,62,31,179.00043372956716,0.47073020181572817,0.757554648535687,0.10289029848539863,1044673.5719110254,-12150.595504422025,1032522.9764066035,4487,0,563.311004784689,80,129,45,39.8830791941355,0.5390749601275917,44.45730452674897,8176.117654048749,102.20147067560936,0
4686,32.48767853234553,3,1,208,0.014354066985645933,0.004784688995215311,0.9952153110047847,209,6000,3800,2200,0.6333333333333333,82,38,44,177.12854858297158,0.4710321202919887,0.7526546020717231,0.10249659566431767,1062852.1386248327,-10147.708665415204,1052704.4299594176,4488,0,560.2870813397129,86,123,45,39.67412079510704,0.5415669856459331,44.20498084291188,8310.186352550649,96.630073866868,0
4687,32.10277357944173,4,3,209,0.018867924528301886,0.014150943396226415,0.9858490566037735,212,6950,5000,1950,0.7194244604316546,89,50,39,175.80254387696772,0.4714452181883215,0.7549378256883725,0.10256584317650602,1052788.762085947,-12333.411492041263,1040455.3505939057,4489,0,552.8915094339623,91,121,41,39.39483951545166,0.5445656446540881,43.897192028985515,8221.610457352743,90.34736766321696,0
4688,32.14933834820347,3,4,208,0.014150943396226415,0.018867924528301886,0.9811320754716981,212,6450,4600,1850,0.7131782945736435,83,46,37,181.85131989513502,0.4717451526125965,0.7638820844336622,0.10674469669680973,1056196.8778015529,-10435.840740533382,1045761.0370610195,4490,0,553.8679245283018,76,136,43,39.00741503061006,0.5465310534591195,43.66883116883117,8240.877475943718,108.4325983676805,0
4689,32.0110340835164,1,0,209,0.004784688995215311,0.0,1.0,209,6750,5000,1750,0.7407407407407407,85,50,35,188.72680564150076,0.4709803628389155,0.7692203690483919,0.11172075866807057,1054234.5651961034,-8757.53562273673,1045477.0295733667,4491,0,550.1866028708134,78,131,44,38.51084052609946,0.5482954545454546,43.35443037974682,8215.490076497377,105.32679585253048,0
4690,32.39689676063421,1,3,207,0.004761904761904762,0.014285714285714285,0.9857142857142858,210,5500,4000,1500,0.7272727272727273,70,40,30,187.1750457357762,0.4708456747930432,0.7677491532769019,0.11136860137392365,1068512.555864623,-7500.222697357604,1061012.3331672654,4492,0,548.5619047619048,81,129,45,38.35835229333599,0.5500992063492063,43.16565040650407,8320.635908365133,102.72390010327325,0
4691,32.8477924294096,1,1,207,0.004807692307692308,0.004807692307692308,0.9951923076923077,208,5350,3600,1750,0.6728971962616822,71,36,35,186.45178917051527,0.47072175383996034,0.7652621774861206,0.11137808936729152,1084616.1624804751,-6504.27518845128,1078111.887292024,4493,0,553.7163461538462,86,122,39,38.228191150662376,0.5515324519230769,43.01963601532568,8441.237654602737,98.1539262163109,0
4692,32.37153394890681,1,1,207,0.004807692307692308,0.004807692307692308,0.9951923076923077,208,6750,5300,1450,0.7851851851851852,82,53,29,186.7991666711528,0.4705770779140344,0.7655608602534347,0.11028827511680366,1065293.4590920606,-8550.813916274827,1056742.6451757858,4494,0,554.7067307692307,76,132,39,38.66009280742457,0.5493790064102564,43.45238095238094,8304.839959511191,109.2742099935683,8
4693,32.297827321618065,0,2,205,0.0,0.00966183574879227,0.9903381642512077,207,6700,4800,1900,0.7164179104477612,86,48,38,185.4779131267606,0.4701927286087269,0.7634428129676611,0.11011054647573981,1064554.2196306621,-8609.740986523779,1055944.4786441384,4495,1,558.3140096618357,78,129,42,38.48678016296904,0.5508756038647342,43.24894514767931,8292.501234263498,106.31411838799356,0
4694,32.110082075817694,2,2,205,0.00966183574879227,0.00966183574879227,0.9903381642512077,207,6150,4100,2050,0.6666666666666666,82,41,41,181.94074822009364,0.4702669902912621,0.757957257462224,0.10861541948567902,1060067.099305984,-8976.11975775319,1051090.979548231,4496,0,558.1207729468599,80,127,37,38.36759504862954,0.5530897745571659,43.042695473251015,8250.92013833475,103.13650172918437,0
4695,32.576263584447304,0,1,204,0.0,0.004878048780487805,0.9951219512195122,205,5850,4200,1650,0.717948717948718,75,42,33,185.5016942645479,0.4695321217918062,0.761400647441125,0.11096374075097463,1076076.4607678668,-6927.198673872648,1069149.262093994,4497,3,564.5658536585366,79,126,40,38.20077676460654,0.5542174796747967,42.968749999999986,8373.117749439936,105.9888322713916,0
4696,32.54364696082084,1,0,205,0.004878048780487805,0.0,1.0,205,6650,4700,1950,0.706766917293233,86,47,39,189.4438078177346,0.4694514187788937,0.7606277165683575,0.11092633414548943,1068379.6145626125,-7170.419524482782,1061209.1950381298,4498,0,565.3609756097561,91,114,42,38.90703938550366,0.5467479674796748,43.761322463768124,8338.941059446772,91.63671493897552,8
4697,32.82396906814417,1,3,203,0.0048543689320388345,0.014563106796116505,0.9854368932038835,206,6050,4500,1550,0.743801652892562,76,45,31,185.80446243536989,0.4694480621990686,0.7580295415634064,0.1094220315124975,1079385.0604239893,-7139.087817430457,1072245.9726065588,4499,0,563.6116504854369,76,130,41,38.78206818941113,0.5484425566343042,43.54707792207791,8417.802781720871,110.76056291737989,0
4698,32.482607586857924,1,4,200,0.004901960784313725,0.0196078431372549,0.9803921568627451,204,5800,4000,1800,0.6896551724137931,76,40,36,181.29834975098413,0.46886419797804174,0.7494153512068842,0.10725788820874252,1069576.4949950841,-7817.5093049899715,1061758.985690094,4500,0,569.8872549019608,80,124,42,38.72452601687133,0.5498876633986929,43.37705761316872,8335.782335336282,104.19727919170353,0
4699,32.48357426990937,3,1,202,0.014778325123152709,0.0049261083743842365,0.9950738916256158,203,5950,4000,1950,0.6722689075630253,79,40,39,175.14141100627646,0.46924128989253605,0.7385810475996146,0.10415049401383443,1071199.2905357168,-9027.728957330595,1062171.5615783862,4501,0,571.2758620689655,84,119,46,38.68840268499078,0.5526990968801313,43.186274509803916,8342.227725492889,99.3122348272963,0
4700,32.241432860530686,1,1,202,0.0049261083743842365,0.0049261083743842365,0.9950738916256158,203,5650,3900,1750,0.6902654867256637,74,39,35,175.6627188432407,0.4691762587588808,0.7394543333423427,0.10477294169412628,1064127.7153727154,-8864.486464236508,1055263.228908479,4502,0,570.7487684729064,84,119,34,38.56278321011212,0.5538793103448276,43.075980392156865,8283.598528443938,98.61426819576116,0
4701,31.923536240885948,0,4,198,0.0,0.019801980198019802,0.9801980198019802,202,6500,5100,1400,0.7846153846153846,79,51,28,174.51938474003492,0.4688639106447958,0.73657490131758,0.10435189729330349,1054392.4225376868,-10097.616628833568,1044294.8059088532,4503,2,574.5742574257425,86,116,36,38.49828410820214,0.5549195544554455,42.98371647509579,8204.868641605106,95.4054493209896,0
4702,31.709694161839998,1,1,198,0.005025125628140704,0.005025125628140704,0.9949748743718593,199,6450,5100,1350,0.7906976744186046,78,51,27,202.84240714172063,0.46799549092262666,0.7744167154620152,0.116312772986903,1034610.726942366,-4277.413938472628,1030333.3130038934,4504,0,583.7688442211055,72,127,39,39.36745894313485,0.5384736180904522,44.5490867579909,8100.2703322668995,112.50375461481805,8
4703,32.06766616128065,6,0,204,0.029411764705882353,0.0,1.0,204,5850,4200,1650,0.717948717948718,75,42,33,203.74843815077048,0.4689155116069416,0.7806522609043622,0.11608922638822979,1044304.2867463506,-4094.9265242552774,1040209.3602220953,4505,0,569.5588235294117,82,122,45,39.591836734693906,0.5337520424836601,44.79166666666667,8183.935634910176,99.80409310866068,8
4704,32.52815610556825,3,2,205,0.014492753623188406,0.00966183574879227,0.9903381642512077,207,6650,4400,2250,0.6616541353383458,89,44,45,200.3648709151143,0.4696631255569626,0.7794453572409301,0.11534716243358263,1062559.7371704264,-5470.071084449776,1057089.6660859766,4506,0,562.2898550724638,76,131,41,39.27801153805437,0.536382850241546,44.39935064935066,8314.21782276256,109.39760293108633,0
4705,32.7634853525592,0,5,200,0.0,0.024390243902439025,0.975609756097561,205,5850,4100,1750,0.7008547008547008,76,41,35,229.95969266977062,0.46923720707795313,0.8054647235499681,0.12730129405883522,1057708.757901148,1796.076180214241,1059504.8340813622,4507,1,567.5219512195122,76,129,37,40.05772063390653,0.5184451219512195,45.90097402597401,8325.169715599515,109.54170678420415,8
4706,32.6561855680387,5,0,205,0.024390243902439025,0.0,1.0,205,6200,4300,1900,0.6935483870967742,81,43,38,219.08948669140355,0.47030627291567034,0.7966834590240264,0.12289122389797383,1058477.3011536326,-819.7502831496495,1057657.550870483,4508,0,565.1317073170732,65,140,40,39.81320770311595,0.5216463414634147,45.391414141414145,8314.545227013905,127.91608041559854,0
4707,32.15528588213255,3,2,206,0.014423076923076924,0.009615384615384616,0.9903846153846154,208,6550,5200,1350,0.7938931297709924,79,52,27,215.72741143759652,0.4711978779573888,0.7969480931875206,0.1222549115812483,1045472.792234261,-3042.5721605730378,1042430.220073688,4509,0,557.9663461538462,70,138,42,39.49595343574401,0.5242888621794872,44.99706572769955,8199.692252308525,117.13846074726465,0
4708,31.786090721926556,3,1,208,0.014354066985645933,0.004784688995215311,0.9952153110047847,209,6850,4900,1950,0.7153284671532847,88,49,39,210.32357192386823,0.47132253711201083,0.7925168485008627,0.12034133280455439,1036435.0206927096,-5052.656876184172,1031382.3638165254,4510,0,555.9952153110048,64,145,38,39.26040686120695,0.526664673046252,44.631410256410255,8117.169161120185,126.83076814250289,0
4709,31.315854121064397,2,2,208,0.009523809523809525,0.009523809523809525,0.9904761904761905,210,6300,4500,1800,0.7142857142857143,81,45,36,238.3954464916429,0.4715035695298853,0.8134336479058861,0.1309178039840945,1008490.0961020163,-216.11065147213594,1008273.9854505442,4511,0,554.3285714285714,73,137,31,40.163243940318324,0.5137896825396826,46.21340090090089,7947.544115268427,108.8704673324442,8
4710,31.761325376501038,2,0,210,0.009523809523809525,0.0,1.0,210,6650,4700,1950,0.706766917293233,86,47,39,238.1029411245887,0.47225782258676996,0.8137546977466033,0.13158025392694328,1024810.0465242589,152.057234290608,1024962.1037585496,4512,0,555.2285714285714,76,134,34,39.920052721269556,0.5160218253968254,45.968614718614724,8068.373483765387,106.16280899691299,0
4711,32.03167008621505,6,1,215,0.027777777777777776,0.004629629629629629,0.9953703703703703,216,6150,4000,2150,0.6504065040650406,83,40,43,229.047218772085,0.47346262202124606,0.8114727713398464,0.12874033330982781,1038878.7140144685,-1759.543982692816,1037119.1700317757,4513,0,540.7777777777778,69,147,37,39.47895364689845,0.5199170524691358,45.31250000000002,8158.065975082944,118.23284021859338,0
4712,31.7800932780352,5,3,217,0.022727272727272728,0.013636363636363636,0.9863636363636363,220,7550,5500,2050,0.7284768211920529,96,55,41,227.00214745751455,0.47460521308980214,0.8152031893129696,0.12929192363143066,1034828.1285516167,-4568.358513868311,1030259.7700377484,4514,0,531.8545454545455,75,145,40,39.01239996777483,0.523532196969697,44.80537280701755,8110.10905624641,108.13478741661879,0
4713,31.365529930806336,2,2,217,0.0091324200913242,0.0091324200913242,0.9908675799086758,219,7250,5300,1950,0.7310344827586207,92,53,39,228.23655660258285,0.4737294555457808,0.8164918706907995,0.13081130800749952,1023235.4920434677,-4342.050940490048,1018893.4411029776,4515,0,535.2648401826484,64,155,41,38.73739987870425,0.5254946727549468,44.567307692307686,8011.781755883353,125.18408993567739,0
4714,31.318182455467543,4,2,219,0.01809954751131222,0.00904977375565611,0.9909502262443439,221,7050,5500,1550,0.7801418439716312,86,55,31,238.34579027039362,0.4742509941039353,0.8217983818105505,0.1348216003252139,1017686.5529567944,-2737.738857592033,1014948.8140992024,4516,0,530.7285067873303,63,158,37,38.99217104003067,0.517015460030166,45.068359375,7983.995634765428,126.73008944072107,8
4715,31.146298831114695,4,6,217,0.017937219730941704,0.026905829596412557,0.9730941704035875,223,6200,4200,2000,0.6774193548387096,82,42,40,227.21622544325083,0.4752917154822984,0.815277871313685,0.1301942229468593,1016008.653661411,-4629.269739475211,1011379.3839219358,4517,0,526.8071748878924,62,161,42,38.7730882099085,0.5204596412556054,44.57671957671956,7955.4898204870715,128.31435194333986,0
4716,31.21214032718831,2,2,217,0.0091324200913242,0.0091324200913242,0.9908675799086758,219,6800,5000,1800,0.7352941176470589,86,50,36,244.4861658620875,0.47563815229078515,0.8271908271908277,0.136309410282013,1009816.3736442203,-1222.7733165936033,1008593.6003276267,4518,0,534.6940639269407,59,160,40,39.40588315588316,0.5101312785388128,45.62499999999999,7939.588195728514,134.56929145302567,8
4717,31.468065083125047,4,3,218,0.01809954751131222,0.013574660633484163,0.9864253393665159,221,6550,4800,1750,0.732824427480916,83,48,35,234.33896744680672,0.47626491155902917,0.8208117333760776,0.13225694887674244,1021864.701411786,-2857.4562001643353,1019007.2452116217,4519,0,527.4253393665158,65,156,39,39.18265260832768,0.5135746606334841,45.15467171717173,8019.489376534436,123.37675963899132,0
4718,31.13570397986358,2,3,217,0.00909090909090909,0.013636363636363636,0.9863636363636363,220,7400,5300,2100,0.7162162162162162,95,53,42,242.50616289752034,0.47680616092431166,0.8287444573496654,0.13541918840241168,1007827.0915893166,-2519.1438309012074,1005307.9477584154,4520,0,530.7772727272727,57,163,43,39.39370544222487,0.5082859848484849,45.563936781609215,7922.045946169712,138.9832622135037,8
4719,31.42419752591374,7,5,219,0.03125,0.022321428571428572,0.9776785714285714,224,6050,4600,1450,0.7603305785123967,75,46,29,228.46324515637602,0.47819156390134526,0.8215028955066093,0.1300042938045922,1022957.7642162334,-4108.349905849644,1018849.4143103837,4521,0,521.4776785714286,63,161,45,39.01103793242753,0.5123697916666667,44.84049479166667,8018.182692281098,127.27274114731901,0
4720,31.280808795698324,2,0,221,0.00904977375565611,0.0,1.0,221,6350,3900,2450,0.6141732283464567,88,39,49,215.38196008972253,0.4777132181543946,0.8077579547054659,0.1191112328124082,1009531.7474674693,-7063.014691531176,1002468.7327759381,4522,0,527.5927601809955,77,144,36,40.468180543874425,0.5173453996983408,45.94017094017091,7947.196935488235,103.21034981153552,8
4721,30.94818670702802,5,4,222,0.022123893805309734,0.017699115044247787,0.9823008849557522,226,6650,4600,2050,0.6917293233082706,87,46,41,208.0530499639749,0.4783824975417896,0.8073712646721118,0.11647345478622163,1002524.380579015,-10134.34899145809,992390.0315875569,4523,0,516.8982300884956,70,156,39,40.17090322208773,0.5205567846607669,45.466549295774655,7877.348755578496,112.53355365112137,0
4722,30.722959697221988,5,1,226,0.022026431718061675,0.004405286343612335,0.9955947136563876,227,6450,4300,2150,0.6666666666666666,86,43,43,209.17268770156727,0.47865905162891637,0.8016699241368861,0.11714762796863169,995350.4536909636,-10209.974079297697,985140.4796116658,4524,0,514.784140969163,78,149,37,40.12647845981179,0.5234489720998532,45.45094936708859,7820.500223561012,100.26282337898733,8
4723,30.791713721550842,4,4,226,0.017391304347826087,0.017391304347826087,0.9826086956521739,230,6800,5000,1800,0.7352941176470589,86,50,36,205.01306142107015,0.47909902854249736,0.8002303954773917,0.11572887147971114,999961.2360627415,-11798.977138476177,988162.2589242653,4525,0,509.03913043478263,84,146,31,39.92224065525421,0.5260416666666667,45.1470588235294,7847.358805801086,93.42093816429865,0
4724,30.521191196296503,3,4,225,0.013100436681222707,0.017467248908296942,0.982532751091703,229,7250,5400,1850,0.7448275862068966,91,54,37,208.4489626523449,0.47878441099108765,0.8049666159552538,0.11824690688302474,992637.0868273635,-11667.165792118376,980969.9210352451,4526,0,512.231441048035,86,143,34,39.642994069135995,0.5280658660844251,44.959291187739446,7784.146236497947,90.51332833137148,0
4725,30.840567687289703,6,0,231,0.025974025974025976,0.0,1.0,231,6350,4700,1650,0.7401574803149606,80,47,33,213.71448786863309,0.47882865926344187,0.8119285103611125,0.12305942532507959,1007498.8598508555,-9486.579427748364,998012.2804231072,4527,0,508.57575757575756,77,154,38,38.928291536050196,0.5311598124098125,44.39102564102565,7883.1258751966625,102.37825811943718,0
4726,30.677087023369708,0,2,229,0.0,0.008658008658008658,0.9913419913419913,231,8000,5700,2300,0.7125,103,57,46,215.28820174590612,0.47873690319342493,0.8128900193652477,0.12446930698257383,1003359.5891347188,-10997.703670134917,992361.8854645839,4528,1,509.57575757575756,78,153,38,38.73161227681258,0.5329635642135642,44.23786919831225,7846.037143885866,100.59021979340854,0
4727,30.305510474559718,1,3,227,0.004347826086956522,0.013043478260869565,0.9869565217391304,230,8150,5700,2450,0.6993865030674846,106,57,49,218.50432394613316,0.4785511992911841,0.8176847224169825,0.12541675010152992,989084.1608379107,-10926.166822056719,978157.994015854,4529,0,512.7304347826087,66,164,39,38.929288626544135,0.5294384057971014,44.51181592039801,7742.699838750614,117.31363392046384,7
4728,30.885936673641332,5,5,227,0.021551724137931036,0.021551724137931036,0.978448275862069,232,7450,5900,1550,0.7919463087248322,90,59,31,213.516506434913,0.4788494551425586,0.8142332209410947,0.12411079366265332,1011790.5854195856,-10643.201791494865,1001147.3836280907,4530,0,508.8060344827586,72,160,39,38.57012115806298,0.5327765804597702,44.03538812785389,7905.706792976313,109.80148323578213,0
4729,31.253189285830068,1,2,226,0.0043859649122807015,0.008771929824561403,0.9912280701754386,228,7550,5600,1950,0.7417218543046358,95,56,39,215.80519437225308,0.478512555710127,0.8147625075901876,0.12635126603394886,1025989.8249728405,-8867.213279556643,1017122.6116932839,4531,0,518.0964912280701,71,157,43,38.23477170496674,0.5344937865497076,43.76446759259257,8008.177596084097,112.79123374766334,0
4730,31.423988330640988,2,2,226,0.008771929824561403,0.008771929824561403,0.9912280701754386,228,8700,6500,2200,0.7471264367816092,109,65,44,215.51404260654408,0.47860996792642396,0.8142695226243295,0.12727183305974588,1034181.8750616262,-9723.856663010773,1024458.0183986154,4532,0,518.8464912280701,67,161,40,37.9144773505294,0.5374177631578947,43.44362745098038,8062.024457131951,120.32872324077539,0
4731,31.009699394092397,2,1,227,0.008771929824561403,0.0043859649122807015,0.9956140350877193,228,7150,5100,2050,0.7132867132867133,92,51,41,212.1376345478841,0.47892716142411834,0.8102289567518945,0.12584357270444516,1021877.3176570822,-9394.272606817953,1012483.0450502642,4533,0,519.7850877192982,65,163,44,37.83044387065044,0.5376005116959064,43.276515151515156,7960.918092555357,122.47566296239012,8
4732,31.168117982232474,3,2,228,0.013043478260869565,0.008695652173913044,0.991304347826087,230,6850,5000,1850,0.7299270072992701,87,50,37,213.48501674384985,0.479131067653946,0.8138171095242146,0.12391825902864087,1020613.232480872,-9272.87339496532,1011340.3590859066,4534,0,516.1826086956522,76,154,37,38.62487004634279,0.5331521739130435,44.08820346320346,7976.289067503943,104.95117194084136,7
4733,30.729706893453397,0,2,226,0.0,0.008771929824561403,0.9912280701754386,228,6650,4500,2150,0.6766917293233082,88,45,43,212.72117183603993,0.478725091454775,0.8098407650589174,0.12208135110343284,1002889.7124764966,-9582.82502793811,993306.8874485585,4535,1,521.609649122807,71,157,36,39.08211346433358,0.530016447368421,44.516782407407405,7850.924392816743,110.57639989882738,8
4734,30.6240050319528,3,3,226,0.013100436681222707,0.013100436681222707,0.9868995633187773,229,7750,5700,2050,0.7354838709677419,98,57,41,201.32645093222976,0.4788817704742205,0.7984396063102779,0.1164916498842356,1001862.7419550009,-13209.705968193248,988653.0359868077,4536,0,520.2794759825327,81,148,35,39.05753377036157,0.5326146288209608,44.20731707317075,7833.396409087969,96.70859764306135,0
4735,30.75977557419495,2,3,225,0.008771929824561403,0.013157894736842105,0.9868421052631579,228,7500,5200,2300,0.6933333333333334,98,52,46,203.96095326089028,0.4788820780843445,0.7998169433581983,0.11890340829529239,1008521.464315405,-11960.20015083189,996561.2641645732,4537,0,522.6052631578947,82,146,37,38.70278703522188,0.5349506578947368,43.925702811245,7876.787911845861,96.05838916885197,0
4736,30.660719311941445,0,0,225,0.0,0.0,1.0,225,7300,4800,2500,0.6575342465753424,98,48,50,205.23536460401422,0.4784019510582011,0.798875717100465,0.12004798661966644,1006259.3150927591,-10996.000516150201,995263.314576609,4538,1,530.3555555555556,82,143,39,38.54207488325007,0.5368055555555555,43.80020080321286,7855.270130948472,95.79597720668868,0
4737,31.00924539959438,1,0,226,0.004424778761061947,0.0,1.0,226,7500,5400,2100,0.72,96,54,42,204.50489366874763,0.4784365781710915,0.7981324739159081,0.12013848909413555,1018979.6075394561,-11022.736741904302,1007956.8707975518,4539,0,529.0044247787611,74,152,39,38.39617871203092,0.5384402654867257,43.638888888888886,7949.564605357118,107.42654872104214,0
4738,31.07026316232718,1,2,225,0.004405286343612335,0.00881057268722467,0.9911894273127754,227,7350,5000,2350,0.6802721088435374,97,50,47,202.32268320221254,0.4784568177978766,0.7969341679343769,0.119236423712488,1021931.704047808,-11398.007117527768,1010533.6969302802,4540,0,527.669603524229,76,151,41,38.33084990417918,0.5401064610866373,43.520021645021636,7968.900423357135,104.85395293890967,0
4739,31.14106851386434,1,2,224,0.004424778761061947,0.008849557522123894,0.9911504424778761,226,8000,5800,2200,0.725,102,58,44,201.6326041282883,0.4780522779416585,0.7971871279498155,0.11954910291653136,1026051.0962758177,-11822.929097844466,1014228.1671779732,4541,0,530.862831858407,77,149,39,38.11994936357646,0.5423119469026549,43.29594017094016,7994.038714923861,103.81868460940079,0
4740,31.49978507784915,4,3,225,0.017543859649122806,0.013157894736842105,0.9868421052631579,228,7400,5100,2300,0.6891891891891891,97,51,46,208.1872897490882,0.4785242290748899,0.8035427162611208,0.12025877560800283,1030002.1275977861,-10113.329723924548,1019888.7978738616,4542,0,526.7456140350877,83,145,37,38.946877121520686,0.5344480994152047,44.270833333333336,8055.413788137473,97.053178170331,8
4741,31.10878846627952,1,1,225,0.004424778761061947,0.004424778761061947,0.995575221238938,226,7000,4900,2100,0.7,91,49,42,196.1739956577871,0.47850254015077026,0.7862479044447857,0.11131328015537544,1011828.0804052834,-12501.128509629792,999326.9518956536,4543,0,532.1858407079646,85,141,38,39.945693039527626,0.5271478613569321,44.94912790697671,7934.323628081891,93.34498385978695,8
4742,31.061234117045,1,5,221,0.004424778761061947,0.022123893805309734,0.9778761061946902,226,7400,5200,2200,0.7027027027027027,96,52,44,193.67739116058593,0.47841527368076037,0.7840769378050363,0.11025059238103276,1011253.9490546391,-13428.594669251877,997825.3543853872,4544,0,533.1504424778761,89,137,43,39.88425295958629,0.5291297935103245,44.82638888888886,7926.007275213934,89.05626151925769,0
4743,31.414441410088127,1,2,220,0.0045045045045045045,0.009009009009009009,0.990990990990991,222,7050,5200,1850,0.7375886524822695,89,52,37,193.1010006241178,0.4778757830228419,0.7803811005249861,0.11026055296213474,1023691.0179589869,-11914.848020439356,1011776.1699385475,4545,0,541.8423423423424,75,147,42,39.77974336948355,0.5304992492492493,44.709429824561425,8019.810659324352,106.93080879099136,0
4744,31.149299196815846,2,1,221,0.009009009009009009,0.0045045045045045045,0.9954954954954955,222,7450,5300,2150,0.7114093959731543,96,53,43,190.26652607829064,0.4780116655116655,0.776771537516378,0.10932897261930721,1016954.4826234216,-13151.520682299233,1003802.9619411223,4546,0,530.527027027027,80,142,42,39.60828720013423,0.5333145645645645,44.470164609053505,7959.575296305714,99.49469120382142,0
4745,31.496302755502192,3,1,223,0.013392857142857142,0.004464285714285714,0.9955357142857143,224,6500,4400,2100,0.676923076923077,86,44,42,184.78023446601566,0.47817654948750804,0.7720000280915591,0.10703980722363975,1030746.5202191254,-13207.683263776129,1017538.8369553493,4547,0,525.6026785714286,87,137,34,39.436961165347995,0.5359933035714286,44.16429924242424,8057.878686726666,92.61929524973179,0
4746,31.181367885029264,1,2,222,0.004464285714285714,0.008928571428571428,0.9910714285714286,224,7100,4700,2400,0.6619718309859155,95,47,48,185.25697556908213,0.4780230688127269,0.7741633380588384,0.10801104509919078,1022376.1564006399,-14019.537074254838,1008356.6193263851,4548,0,526.5982142857143,90,134,39,39.17767422108981,0.5381324404761905,43.921703296703306,7984.871576877198,88.72079529863554,0
4747,31.25309408404869,1,2,221,0.004484304932735426,0.008968609865470852,0.9910313901345291,223,6600,4700,1900,0.7121212121212122,85,47,38,187.04876851033148,0.4779151348658075,0.7760894320037266,0.10936041496340272,1025564.4194769578,-12833.887661764209,1012730.5318151936,4549,0,527.1345291479821,92,131,42,39.0253366561735,0.5398449177877429,43.81720430107528,8006.505016693143,87.02722844231677,0
4748,30.9391814828928,0,5,216,0.0,0.02262443438914027,0.9773755656108597,221,7100,4500,2600,0.6338028169014085,97,45,52,200.76451919161096,0.4775195392842451,0.7900563042868929,0.11318589704533433,1004363.773643903,-10971.877978182478,993391.8956657205,4550,1,532.8144796380091,84,137,34,40.080519751186316,0.5277620663650076,45.19607843137251,7883.4247719644545,93.85029490433874,8
4749,30.99378944769925,3,1,218,0.0136986301369863,0.0045662100456621,0.995433789954338,219,7200,5300,1900,0.7361111111111112,91,53,38,198.9640700161805,0.47744997416670154,0.78913091610545,0.11315465072482833,1008777.4048800734,-10857.908356940512,997919.4965231329,4551,0,536.2739726027397,88,131,41,39.78555973515601,0.5306316590563166,44.861891385767755,7907.6968184736415,89.86019111901865,0
4750,31.080472970890884,3,2,219,0.013574660633484163,0.00904977375565611,0.9909502262443439,221,6250,4300,1950,0.688,82,43,39,193.3227165070527,0.47778177704648295,0.7853460196899957,0.11074604433166123,1013787.1146347444,-11252.384207792777,1002534.7304269515,4552,0,532.1131221719457,75,146,42,39.648343171451586,0.5336067119155354,44.58607456140352,7938.385605983466,105.84514141311288,0
4751,31.614733651938604,3,0,222,0.013513513513513514,0.0,1.0,222,6700,4800,1900,0.7164179104477612,86,48,38,189.57610608058732,0.4779679283355754,0.7818577740043704,0.10972435230724947,1034362.4327574328,-11881.919544360366,1022480.5132130724,4553,0,528.581081081081,83,139,46,39.347004072134965,0.5364583333333333,44.196428571428584,8087.161777928969,97.43568407143336,0
4752,31.601864008271562,1,3,220,0.004484304932735426,0.013452914798206279,0.9865470852017937,223,6300,4300,2000,0.6825396825396826,83,43,40,190.16671032619314,0.47798415006935185,0.7853619440761237,0.10885285498901995,1030553.9951700226,-11704.587385000226,1018849.4077850224,4554,0,527.2062780269058,76,147,40,39.759243563936884,0.5338191330343797,44.61580086580087,8070.616730900315,106.1923254065831,8
4753,31.64414235823966,1,0,221,0.004524886877828055,0.0,1.0,221,8250,6300,1950,0.7636363636363637,102,63,39,198.699464165793,0.4777192170574524,0.787871090909465,0.11460238024601484,1034254.1703290935,-11348.850108874476,1022905.320220219,4555,0,532.89592760181,80,141,38,39.248528746039,0.5376131221719457,44.32870370370371,8090.498896915678,101.13123621144598,8
4754,31.678338736346642,3,0,224,0.013392857142857142,0.0,1.0,224,7100,5300,1800,0.7464788732394366,89,53,36,197.9604275773454,0.4777832552583814,0.7912110008651445,0.11520075983686107,1038098.6702048662,-10799.508675754074,1027299.1615291121,4556,0,526.7455357142857,85,139,39,38.92430765833965,0.5402250744047619,43.99224806201552,8109.9002850221195,95.41059158849552,0
4755,31.602362695411625,2,3,223,0.008849557522123894,0.01327433628318584,0.9867256637168141,226,7000,5300,1700,0.7571428571428571,87,53,34,206.84976391518578,0.47800966896099645,0.7989658470849403,0.11839533179736934,1030552.0606855593,-9566.109908976672,1020985.9507765826,4557,0,523.0752212389381,71,155,41,39.335486063902145,0.533462389380531,44.61805555555557,8070.672834192824,113.671448368913,8
4756,31.232256244622658,4,4,223,0.01762114537444934,0.01762114537444934,0.9823788546255506,227,6350,4400,1950,0.6929133858267716,83,44,39,199.45726645410747,0.478343924213481,0.793705003907462,0.11541496316615527,1021774.3347395789,-10989.936851975592,1010784.3978876033,4558,0,521.5418502202643,79,148,44,39.1037265631628,0.5368024963289281,44.20572916666669,7989.03221257314,101.1269900325714,0
4757,31.222404946840488,2,4,221,0.008888888888888889,0.017777777777777778,0.9822222222222222,225,6200,4300,1900,0.6935483870967742,81,43,38,201.64479412756634,0.47823495370370367,0.7941309396212917,0.11721781490406304,1022832.6403032696,-9950.224563818037,1012882.4157394515,4559,0,526.7822222222222,80,145,38,38.87147893220793,0.5387037037037037,44.03292181069962,7991.907768285999,99.89884710357498,0
4758,30.891693960482154,0,2,219,0.0,0.00904977375565611,0.9909502262443439,221,7450,5200,2250,0.697986577181208,97,52,45,204.23365241189367,0.47770464829288356,0.7941856879990898,0.11902965533878655,1012765.126307472,-10281.855843766356,1002483.2704637056,4560,1,537.2217194570136,83,138,42,38.70632355077729,0.5402055052790347,43.93601190476192,7910.250354538675,95.30422113902019,0
4759,30.925985873540036,0,5,214,0.0,0.0228310502283105,0.9771689497716896,219,7550,5600,1950,0.7417218543046358,95,56,39,206.1692916006453,0.47781303673913955,0.7933317493140495,0.12089866918333877,1015711.7667000426,-9468.2849178026,1006243.4817822401,4561,2,540.6301369863014,70,149,41,38.42199038296412,0.5421423135464232,43.705985915492946,7926.145059050306,113.23064370071866,0
4760,31.359301884524687,1,3,212,0.004651162790697674,0.013953488372093023,0.986046511627907,215,6850,4600,2250,0.6715328467153284,91,46,45,234.57032520625216,0.477493117438238,0.81595515458295,0.13432324072048143,1022764.8981439145,-1867.9410465686278,1020896.9570973458,4562,0,549.339534883721,59,156,41,38.6097846282827,0.5343023255813953,44.600694444444436,8009.143924014611,135.74820210194255,8
4761,31.403298353007884,5,1,216,0.02304147465437788,0.004608294930875576,0.9953917050691244,217,6600,4600,2000,0.696969696969697,86,46,40,223.75069923805708,0.477913253114866,0.8078467221754153,0.12973699342086428,1027988.1836333523,-3997.385020715531,1023990.7986126367,4563,0,544.5483870967741,65,152,40,38.403651616086826,0.5374423963133641,44.12878787878786,8035.200014188157,123.61846175674088,0
4762,31.34656875664769,1,3,214,0.004608294930875576,0.013824884792626729,0.9861751152073732,217,6700,4900,1800,0.7313432835820896,85,49,36,224.44248593509343,0.4776919056152927,0.8087854299059978,0.13048097063684216,1026924.8350553666,-4002.887430337756,1022921.9476250289,4564,0,545.5437788018434,66,151,41,38.284793083900205,0.5386904761904762,44.02985074626864,8023.785883231435,121.57251338229447,0
4763,31.22117686962525,1,4,211,0.004651162790697674,0.018604651162790697,0.9813953488372094,215,6950,4600,2350,0.6618705035971223,93,46,47,226.73643117077762,0.477194269361733,0.8092954002445187,0.13259449300415652,1024585.1998061978,-3487.8416731089874,1021097.3581330888,4565,0,548.6837209302325,70,145,43,37.99989501011724,0.5412790697674419,43.808685446009385,7998.594344151924,114.26563348788463,0
4764,30.787935584025465,1,1,211,0.0047169811320754715,0.0047169811320754715,0.9952830188679245,212,6600,4600,2000,0.696969696969697,86,46,40,226.15075552449977,0.4766912761930311,0.8059397783034061,0.1334624941788746,1013049.2711463874,-3179.628389340063,1009869.6427570474,4566,0,552.622641509434,62,150,44,37.667445482866015,0.5441725628930818,43.46891534391534,7898.062509691719,127.38810499502773,0
4765,30.901222757697887,1,2,210,0.0047169811320754715,0.009433962264150943,0.9905660377358491,212,6400,4000,2400,0.625,88,40,48,223.7346535180739,0.4762353199797311,0.8046273216640705,0.13277970115937646,1018427.8457816413,-3228.479758177101,1015199.3660234642,4567,0,553.5849056603773,65,147,44,37.516585213417756,0.5460888364779874,43.260732323232325,7933.557301128026,122.05472770966193,0
4766,31.363141534638952,1,0,211,0.004739336492890996,0.0,1.0,211,6350,4500,1850,0.7086614173228346,82,45,37,223.32873900563703,0.47617354998871586,0.8033616761927076,0.12673811254254247,1020141.208523097,-2984.6300585703107,1017156.5784645267,4568,0,546.5355450236967,81,130,34,39.247974565859806,0.5305094786729858,44.94410569105689,7999.354112455244,98.7574581784598,8
4767,31.17561528423866,2,1,212,0.009389671361502348,0.004694835680751174,0.9953051643192489,213,6650,4800,1850,0.7218045112781954,85,48,37,206.93361999462468,0.47647138069507194,0.790387131532363,0.11475409836065581,1006983.1985473295,-7574.264290166984,999408.9342571625,4569,0,542.3943661971831,69,144,39,40.573770491803266,0.5223982785602503,45.83333333333334,7923.802218077348,114.83771330546881,8
4768,30.800497144171732,5,1,216,0.02304147465437788,0.004608294930875576,0.9953917050691244,217,6450,4400,2050,0.6821705426356589,85,44,41,194.89410514923304,0.47712031347784034,0.7815000149381439,0.10921731002675011,998046.4235555042,-10947.32707675141,987099.0964787528,4570,0,533.2995391705069,76,141,42,40.466021008254536,0.5252496159754224,45.42748917748918,7840.9598925733735,103.17052490228123,0
4769,30.66565082674783,5,5,216,0.02262443438914027,0.02262443438914027,0.9773755656108597,221,7100,4600,2500,0.647887323943662,96,46,50,201.37052247620068,0.477923179761415,0.7925702764166644,0.11404935460333751,996858.0410144299,-11152.435089264756,985705.6059251651,4571,0,524.4615384615385,81,140,38,39.88578616978872,0.5279034690799397,45.020325203252014,7819.1176752347465,96.53231697820675,8
4770,30.88251546720556,0,2,214,0.0,0.009259259259259259,0.9907407407407407,216,5850,4000,1850,0.6837606837606838,77,40,37,204.6511161573791,0.4777409919609532,0.7941445797643596,0.11675312676231935,1006093.962431223,-7870.349525850237,998223.6129053727,4572,1,533.7916666666666,63,153,44,39.51897224170543,0.5315393518518519,44.74283854166664,7882.98323685192,125.12671804526857,8
4771,30.772976836367647,0,0,214,0.0,0.0,1.0,214,6100,3900,2200,0.639344262295082,83,39,44,204.14137408886876,0.4774298699779153,0.7917625893796412,0.11695202085651983,1003778.7094466145,-7917.446994483453,995861.262452131,4573,2,539.1448598130842,64,150,44,39.36922240348019,0.5330996884735202,44.58333333333332,7859.931166955545,122.8114244836804,0
4772,30.36933537421879,3,0,217,0.013824884792626729,0.0,1.0,217,7050,5300,1750,0.75177304964539,88,53,35,196.08887611321973,0.47773635290436367,0.7854321504570487,0.1131204276302858,992650.053012766,-11520.473346199668,981129.5796665662,4574,0,532.6774193548387,72,145,49,39.307191092755914,0.5354742703533026,44.32077625570777,7764.808094110351,107.84455686264376,0
4773,30.865344934873164,4,10,211,0.01809954751131222,0.04524886877828054,0.9547511312217195,221,6500,4500,2000,0.6923076923076923,85,45,40,191.31492814439932,0.478244549568079,0.7829255840483114,0.11120250909114766,1011107.5667864651,-12012.005702797665,999095.5610836674,4575,0,524.0180995475113,79,142,39,39.13949367517887,0.5379901960784313,44.03645833333334,7900.403004293471,100.00510132017052,0
4774,31.420549349490603,5,3,213,0.023148148148148147,0.013888888888888888,0.9861111111111112,216,6800,5000,1800,0.7352941176470589,86,50,36,197.67464920252294,0.4771205677576802,0.7866374921419155,0.11597097582246182,1032093.8698019328,-9196.241268565655,1022897.6285333672,4576,0,535.9953703703703,67,149,41,38.622101362658405,0.5413290895061729,43.68872549019608,8053.441049566121,120.20061268009137,0
4775,31.377846721315098,2,4,211,0.009302325581395349,0.018604651162790697,0.9813953488372094,215,5650,3500,2150,0.6194690265486725,78,35,43,179.03740237543985,0.47725766137796133,0.7609872470895243,0.10335558434297823,1025824.9426642846,-11917.7933946904,1013907.1492695942,4577,0,538.3906976744186,87,128,42,39.71642286208067,0.5376453488372093,44.29450757575757,8023.487747086266,92.22399709294558,8
4776,31.525863390750718,1,2,210,0.0047169811320754715,0.009433962264150943,0.9905660377358491,212,7200,5300,1900,0.7361111111111112,91,53,38,176.54583506535934,0.47695441741929717,0.7538517769266213,0.10237785268432044,1032034.6867945947,-13159.714880686428,1018874.9719139084,4578,0,546.2075471698113,88,124,36,39.607157015216664,0.5404874213836478,44.124531835205985,8066.6950544076635,91.66698925463254,0
4777,31.158206307641574,1,2,209,0.004739336492890996,0.009478672985781991,0.990521327014218,211,5550,3700,1850,0.6666666666666666,74,37,37,177.5317243837222,0.4766597081170541,0.7536548845133835,0.10344962501772405,1021450.9491283438,-11482.010325571198,1009968.9388027727,4579,0,549.4834123222748,91,120,37,39.39664861080405,0.5420616113744076,43.94248188405797,7978.292976079181,87.6735491876833,0
4778,31.258549886024518,0,2,207,0.0,0.009569377990430622,0.9904306220095693,209,6700,4800,1900,0.7164179104477612,86,48,38,184.9952304491169,0.4762960449638081,0.7599426378009699,0.10810051460110677,1025579.1750719111,-10554.548832751525,1015024.6262391595,4580,1,555.0430622009569,94,115,37,39.09883928316643,0.5438098086124402,43.8377192982456,8007.261430233566,85.1836322365273,0
4779,31.156476543654723,1,1,207,0.004807692307692308,0.004807692307692308,0.9951923076923077,208,7150,4900,2250,0.6853146853146853,94,49,45,184.4817460103524,0.4760946016041125,0.7587196495006834,0.1084175232307112,1023932.6457348419,-10970.62354356691,1012962.022191275,4581,0,558.3605769230769,82,126,36,38.8948379674956,0.545723157051282,43.62449799196791,7987.757314681048,97.41167456928108,0
4780,30.916679657143813,1,1,207,0.004807692307692308,0.004807692307692308,0.9951923076923077,208,7000,4800,2200,0.6857142857142857,92,48,44,183.49351954443455,0.47612363356249227,0.7575409996095255,0.10822821362351458,1017121.5657671639,-11272.95681856714,1005848.6089485968,4582,0,559.3317307692307,83,125,40,38.7827834179357,0.5475260416666667,43.48958333333336,7930.450380803878,95.54759494944432,0
4781,30.529847764434617,2,1,208,0.009569377990430622,0.004784688995215311,0.9952153110047847,209,5650,4100,1550,0.7256637168141593,72,41,31,197.24375725759992,0.4764187292970188,0.7759359838814448,0.11314553803318762,996227.9226751631,-8150.052289323092,988077.8703858401,4583,0,556.2727272727273,76,133,41,39.49573713196357,0.5369318181818181,44.534632034632054,7799.3187930680015,102.62261569826317,8
4782,30.12620034481558,4,3,209,0.018867924528301886,0.014150943396226415,0.9858490566037735,212,7550,6100,1450,0.8079470198675497,90,61,29,190.49273732347268,0.47684124340516854,0.7715567574211781,0.11034201954397398,985890.3667703222,-12389.009066615665,973501.3577037065,4584,0,549.377358490566,84,128,33,39.29322747014115,0.539750393081761,44.16666666666667,7707.2862548819985,91.75340779621426,0
4783,30.612103351758936,2,3,208,0.009478672985781991,0.014218009478672985,0.985781990521327,211,6300,4300,2000,0.6825396825396826,83,43,40,191.01351183673495,0.4763014368464606,0.7722715775220033,0.1112169436100231,1003313.8774211732,-10170.698559850232,993143.1788613229,4585,0,552.8483412322275,88,123,36,39.08190476190474,0.5417654028436019,43.97237827715355,7837.544017084803,89.06300019414549,0
4784,30.970829445449855,1,2,207,0.004784688995215311,0.009569377990430622,0.9904306220095693,209,5150,3300,1850,0.6407766990291263,70,33,37,189.46391230312292,0.47581009998773155,0.7679160284463207,0.11101138971556161,1016941.22953236,-8415.26721409005,1008525.9623182699,4586,0,555.6028708133971,77,132,37,38.88137952299061,0.544706937799043,43.736645299145316,7936.688651559031,103.07387859167574,0
4785,31.50537429716531,1,2,206,0.004807692307692308,0.009615384615384616,0.9903846153846154,208,6150,4300,1850,0.6991869918699187,80,43,37,189.72692277722606,0.4755797682088443,0.7673987443123005,0.11170917022712995,1035962.8414480253,-8439.991596102642,1027522.8498519227,4587,0,557.2067307692307,79,129,39,38.689229499873086,0.5466245993589743,43.55468750000003,8079.405557066092,102.27095641855813,0
4786,31.477889630721684,1,2,205,0.004830917874396135,0.00966183574879227,0.9903381642512077,207,6000,4200,1800,0.7,78,42,36,190.90715468221964,0.4751457874083454,0.766949679159572,0.1128770296307896,1036319.5108492044,-7831.838168421259,1028487.6726807831,4588,0,558.1932367149758,82,125,37,38.49988995402528,0.5484601449275363,43.39859437751008,8077.270725272878,98.50330152771802,0
4787,31.19530142510971,0,1,204,0.0,0.004878048780487805,0.9951219512195122,205,7650,5500,2150,0.7189542483660131,98,55,43,194.01977028161986,0.47484955364259523,0.7681147331821727,0.11542766536332172,1028846.9117067212,-8726.671707141202,1020120.23999958,4589,1,564.2536585365854,87,118,41,38.18697093300149,0.5506605691056911,43.16998106060609,8011.889855831113,92.09068799805877,0
4788,30.860571286130362,3,0,207,0.014492753623188406,0.0,1.0,207,7100,5400,1700,0.7605633802816901,88,54,34,212.34681252495872,0.4750422119037569,0.7866130179141875,0.12726346279812323,1019957.0770346316,-5183.073155884698,1014774.0038787469,4590,0,559.7246376811594,81,126,40,37.43942182584776,0.5510768921095008,42.898882113821124,7934.287376270191,97.95416513913815,8
4789,30.770211178484082,0,3,204,0.0,0.014492753623188406,0.9855072463768116,207,6850,5100,1750,0.7445255474452555,86,51,35,217.48081338452477,0.47485753482482057,0.7890032817472403,0.1309313081554723,1018284.5987244481,-3958.5274424946347,1014326.0712819535,4591,1,560.7246376811594,84,123,42,37.13777608409152,0.5526368760064413,42.732843137254896,7916.164745954839,94.24005649946237,0
4790,31.324337226203088,0,3,201,0.0,0.014705882352941176,0.9852941176470589,204,6150,4600,1550,0.7479674796747967,77,46,31,253.39233918597378,0.4743638116166007,0.8172195919479555,0.15142165044089095,1034422.6565038826,5472.955327697377,1039895.6118315799,4592,2,568.6372549019608,69,135,37,36.49392009264621,0.5473345588235294,43.005952380952365,8050.168212745906,116.66910453254937,8
4791,31.35764303544858,1,0,202,0.0049504950495049506,0.0,1.0,202,6400,4500,1900,0.703125,83,45,38,247.31586561607602,0.4741828194013431,0.8108943406655942,0.1485358601185303,1037013.9663622861,4494.001349369595,1041507.9677116558,4593,0,573.3613861386139,73,129,38,36.460499908775745,0.5492471122112211,42.82094594594593,8064.528973221325,110.47299963316884,0
4792,30.91669728853242,2,3,201,0.00980392156862745,0.014705882352941176,0.9852941176470589,204,6150,4500,1650,0.7317073170731707,78,45,33,264.7276503245671,0.47437135773849765,0.8239458325136071,0.15399526740670366,1013024.1273764764,6685.09939249401,1019709.2267689704,4594,0,568.7303921568628,72,132,34,37.230002787068,0.5368668300653594,44.0068493150685,7914.462747663709,109.92309371755151,8
4793,31.28797201877977,2,2,201,0.009852216748768473,0.009852216748768473,0.9901477832512315,203,6500,4700,1800,0.7230769230769231,83,47,36,261.07288241415205,0.4739966915410753,0.8205212140473541,0.15304953394173051,1027512.8225616795,6551.146860735754,1034063.9694224152,4595,0,572.1083743842364,62,141,33,37.0260752688172,0.5389983579638752,43.716931216931215,8018.577484971663,129.33189491889777,0
4794,31.708335124611697,1,4,198,0.0049504950495049506,0.019801980198019802,0.9801980198019802,202,7750,6100,1650,0.7870967741935484,94,61,33,222.8905769520846,0.4738847019030261,0.7957602129440506,0.1304569435449265,1040832.0401502384,-1751.6692121396236,1039080.3709380988,4596,0,573.3267326732673,77,125,42,38.06573369470795,0.5390882838283828,43.7767094017094,8124.413965021355,105.51186967560201,8
4795,32.057717725551896,4,1,201,0.019801980198019802,0.0049504950495049506,0.995049504950495,202,7150,5300,1850,0.7412587412587412,90,53,37,214.08336090223398,0.4738626381294846,0.7864524188705548,0.12670149767055267,1055700.731047472,-2348.4078780826676,1053352.3231693893,4597,0,570.4554455445544,69,133,45,37.8689261277977,0.5426464521452146,43.36309523809521,8227.193450816432,119.23468769299177,0
4796,32.21841727218704,2,2,201,0.009852216748768473,0.009852216748768473,0.9901477832512315,203,6550,4600,1950,0.7022900763358778,85,46,39,211.5089689705131,0.474202962168138,0.784697737101818,0.1260980952411979,1063234.6140149052,-2173.268603189662,1061061.3454117156,4598,0,568.3399014778325,75,128,42,37.658272869540426,0.5449507389162562,43.09210526315786,8277.165753150604,110.36221004200806,0
4797,32.30459228170059,2,0,203,0.009852216748768473,0.0,1.0,203,6400,4600,1800,0.71875,82,46,36,211.79519008034788,0.4740617226747305,0.78502390478005,0.12693685233292248,1067692.273595669,-1773.5823932977846,1065918.6912023714,4599,0,568.9655172413793,76,127,45,37.45242480049106,0.5468493431855501,42.89772727272724,8305.58409515305,109.28400125201381,0
4798,32.63268987697907,2,1,204,0.00975609756097561,0.004878048780487805,0.9951219512195122,205,6000,4200,1800,0.7,78,42,36,214.90611845695946,0.4741511238641798,0.7892987689204072,0.1298138027990208,1080945.8360271805,-539.6252234369504,1080406.2108037437,4600,0,564.4048780487805,63,142,43,37.079223051304766,0.5492378048780489,42.61067708333334,8399.305952385226,133.3223167045274,0
4799,32.89568178201081,1,2,203,0.004878048780487805,0.00975609756097561,0.9902439024390244,205,5900,4500,1400,0.7627118644067796,73,45,28,215.38971918718218,0.4737157261278495,0.7899325763598517,0.1309608595178954,1091680.899663388,127.36848410174025,1091808.2681474898,4601,0,565.3707317073171,64,141,48,36.82274819606868,0.5509146341463415,42.37179487179489,8474.855453968079,132.41961646825123,0
4800,32.41392927257125,0,1,202,0.0,0.0049261083743842365,0.9950738916256158,203,6500,4400,2100,0.676923076923077,86,44,42,220.50811141720078,0.47350286136988085,0.791919191919191,0.13475495697717957,1077232.939997268,407.72023103979154,1077640.6602283076,4602,1,570.5270935960591,67,136,43,36.50252525252528,0.5529556650246306,42.18750000000004,8356.716140584867,124.72710657589354,0
4801,32.41885419207345,2,3,201,0.00980392156862745,0.014705882352941176,0.9852941176470589,204,5600,3500,2100,0.625,77,35,42,215.6961526870773,0.47360668405293155,0.7882618125974634,0.13257552610568119,1079138.5635972226,153.20727683639598,1079291.770874059,4603,0,568.1715686274509,69,135,39,36.41375656035525,0.5547385620915033,41.9791666666667,8364.739774350695,121.2281126717492,0
4802,32.617393800829554,0,2,199,0.0,0.009950248756218905,0.9900497512437811,201,6200,4800,1400,0.7741935483870968,76,48,28,216.7850390190005,0.47315298507462683,0.7875368558281184,0.13335471307657032,1085997.9157072878,685.6201062319496,1086683.5358135197,4604,3,576.8557213930349,69,132,40,36.35525392614806,0.5556073797678276,41.949404761904795,8416.937885419498,121.9846070350652,0
4803,32.56032059348797,0,0,199,0.0,0.0,1.0,199,6950,5400,1550,0.7769784172661871,85,54,31,226.17998146318877,0.4726103158892104,0.798509950359978,0.13487253562200432,1074581.4049379148,1859.760449908797,1076441.1653878237,4605,4,582.8442211055276,71,128,37,37.27357622855426,0.5490473199329984,43.084490740740726,8365.251346920673,117.82044150592498,8
4804,32.03762920534823,3,1,201,0.01485148514851485,0.0049504950495049506,0.995049504950495,202,6950,4800,2150,0.6906474820143885,91,48,43,231.67362054661155,0.4732135526985534,0.8067529164449871,0.13618410822578125,1052964.179206971,1438.8047405538077,1054402.9839475248,4606,0,575.1732673267327,61,141,39,37.675840978593264,0.5431105610561056,43.61559139784945,8213.948616828167,134.6548953578388,6
4805,31.56175116759541,4,3,202,0.01951219512195122,0.014634146341463415,0.9853658536585366,205,6200,4500,1700,0.7258064516129032,79,45,34,244.8108821385683,0.4742109038737446,0.8202575433820629,0.13942837680161144,1027703.611175385,3118.60552576739,1030822.2167011524,4607,0,566.7317073170732,66,139,38,38.559816823037224,0.5302845528455284,44.80721393034824,8054.331213695717,122.03532141963208,8
4806,31.94156702869284,6,2,206,0.028846153846153848,0.009615384615384616,0.9903846153846154,208,6450,4900,1550,0.7596899224806202,80,49,31,228.20658389908195,0.4747576799207234,0.8086570510842166,0.1317126777965454,1044189.9998599397,-391.7934380759498,1043798.2064218638,4608,0,556.3413461538462,65,143,44,38.467211386128454,0.5332532051282051,44.302398989899,8167.3820617401125,125.65203171907865,0
4807,31.87395656622287,2,5,203,0.009615384615384616,0.02403846153846154,0.9759615384615384,208,5800,3900,1900,0.6724137931034483,77,39,38,226.05750038220873,0.47505574136008916,0.8070358865598466,0.13137239012884755,1044091.4842209797,-195.05778133117474,1043896.4264396486,4609,0,556.5961538461538,70,138,37,38.2573369253697,0.5356570512820513,44.04342723004694,8158.348683308722,116.54783833298174,0
4808,32.006841501991644,4,3,204,0.01932367149758454,0.014492753623188406,0.9855072463768116,207,7300,5400,1900,0.7397260273972602,92,54,38,245.0581835548461,0.47584834201022463,0.8176221331882405,0.1365057942615399,1035244.9152833858,2039.0476947474845,1037283.9629781332,4610,0,559.5748792270531,59,148,39,39.42690557451648,0.5193236714975845,45.65972222222223,8140.628958405873,137.9767620068792,8
4809,32.43631081935099,6,6,204,0.02857142857142857,0.02857142857142857,0.9714285714285714,210,6850,5200,1650,0.7591240875912408,85,52,33,240.01538110556882,0.4768891926786664,0.8160441805528957,0.1357660135159455,1054020.2131882547,1746.2126322704644,1055766.4258205253,4611,0,552.4380952380952,63,147,41,38.9496078869523,0.5228174603174602,45.06835937500001,8269.0419329996,131.25463385713653,0
4810,32.78174927562813,3,1,206,0.014492753623188406,0.004830917874396135,0.9951690821256038,207,5900,4300,1600,0.7288135593220338,75,43,32,243.28068681443446,0.4763759908071854,0.8168461905757185,0.13894073776887042,1068310.270289163,4679.851257372328,1072990.1215465355,4612,0,560.9855072463768,57,150,44,38.49095732207765,0.5250100644122383,44.701867816091955,8369.11935978904,146.82665543489543,0
4811,32.560650438994934,4,2,208,0.01904761904761905,0.009523809523809525,0.9904761904761905,210,7150,5500,1650,0.7692307692307693,88,55,33,236.5191739670671,0.47708618136249714,0.8125462197551159,0.13665454104402774,1064759.8889655685,1217.2258822804633,1065977.114847849,4613,0,553.347619047619,62,148,45,38.21388547660609,0.528125,44.26256613756613,8326.977188160286,134.30608368000463,0
4812,32.400543206031095,1,4,205,0.004784688995215311,0.019138755980861243,0.9808612440191388,209,6550,4900,1650,0.7480916030534351,82,49,33,258.2741872763604,0.4766784750337382,0.8268786617617878,0.14317356416146948,1046434.4219509,5703.399973475235,1052137.8219243751,4614,0,556.755980861244,74,135,36,39.283112009763734,0.5159988038277512,45.847222222222214,8234.68805732169,111.27956834218499,8
4813,31.92849683825155,5,3,207,0.023809523809523808,0.014285714285714285,0.9857142857142858,210,7400,5600,1800,0.7567567567567568,92,56,36,249.47106717584398,0.4775224044960887,0.8252857515171816,0.13694141412785593,1028083.7466219105,1895.4298831815572,1029979.1765050921,4615,0,553.0428571428571,62,148,35,39.89933541829553,0.5128968253968254,46.23015873015873,8102.489574627723,130.685315719802,8
4814,32.295995692534255,2,2,207,0.009569377990430622,0.009569377990430622,0.9904306220095693,209,6400,4800,1600,0.75,80,48,32,249.60827128582991,0.4775497254938044,0.8251573598026691,0.13819440053995408,1042653.7215916327,3850.998599244949,1046504.7201908777,4616,0,554.6746411483253,65,144,38,39.55383022774326,0.5153010366826156,45.89646464646465,8206.52668323551,126.25425666516169,0
4815,32.14130658818707,3,2,208,0.014285714285714285,0.009523809523809525,0.9904761904761905,210,6850,4600,2250,0.6715328467153284,91,46,45,240.82138299456275,0.4780136895268474,0.8198764963133942,0.13517517123541023,1042008.2294789852,1337.5725829692592,1043345.8020619544,4617,0,549.9047619047619,59,151,38,39.23241801322696,0.5184027777777778,45.36458333333336,8184.314995294138,138.71720331007012,0
4816,32.49922827127149,8,7,209,0.037037037037037035,0.032407407407407406,0.9675925925925926,216,6850,4600,2250,0.6715328467153284,91,46,45,226.68969802675147,0.4794892154751651,0.8110521091599991,0.1288130872316721,1057506.7598441239,-2104.8223899372856,1055401.9374541866,4618,0,533.8333333333334,70,146,36,39.11138428801474,0.5222318672839505,44.89436619718311,8290.736226245168,118.43908894635955,0
4817,32.506587287928,3,5,207,0.014150943396226415,0.02358490566037736,0.9764150943396226,212,7200,5000,2200,0.6944444444444444,94,50,44,221.1317441846766,0.47902927434498793,0.8059360073660589,0.1251255720839183,1056408.338216524,-2878.9163197888224,1053529.4218967352,4619,0,542.7641509433962,70,142,38,39.418124532427925,0.5214720911949686,45.05575117370893,8287.36747802708,118.39096397181542,8
4818,32.27768037850476,4,0,211,0.018957345971563982,0.0,1.0,211,7050,4800,2250,0.6808510638297872,93,48,45,215.53906625813238,0.479085797036034,0.8001518274649564,0.12342014048793702,1052704.253276243,-3870.2216405748222,1048834.0316356684,4620,0,545.431279620853,65,146,43,39.097453961191455,0.5243878357030016,44.60227272727273,8243.646210305618,126.82532631239413,0
4819,32.063476698592915,2,3,210,0.009389671361502348,0.014084507042253521,0.9859154929577465,213,5600,3000,2600,0.5357142857142857,82,30,52,211.3590742708708,0.4792617075619334,0.7985245277307975,0.12201772324471703,1048248.4423199238,-3888.635925075938,1044359.8063948478,4621,0,541.3004694835681,68,145,46,38.88888888888888,0.5265062597809076,44.293478260869556,8198.840101460828,120.57117796265923,0
4820,32.2379812093032,2,2,210,0.009433962264150943,0.009433962264150943,0.9905660377358491,212,5850,4200,1650,0.717948717948718,75,42,33,208.41652687096484,0.47933153745268114,0.7953073541102229,0.12107313723822738,1055894.7394617521,-4236.817132012055,1051657.9223297401,4622,0,543.1933962264151,70,142,38,38.723846374319265,0.5292845911949686,44.05809859154928,8251.050208278935,117.87214583255621,0
4821,31.881872669200956,2,1,211,0.009433962264150943,0.0047169811320754715,0.9952830188679245,212,7800,5800,2000,0.7435897435897436,98,58,40,206.068775190426,0.4794838333482369,0.7934294368208821,0.12046736310627491,1046163.8349511744,-7083.659976618754,1039080.1749745557,4623,0,542.938679245283,72,140,41,38.54230490725783,0.5323801100628931,43.821347031963455,8167.455194494324,113.43687770131005,0
4822,31.774876671893157,0,5,206,0.0,0.023696682464454975,0.976303317535545,211,7700,5500,2200,0.7142857142857143,99,55,44,206.44433209930753,0.4791497404649063,0.7924536592691851,0.12107556415522476,1043631.3555704046,-6809.644368274687,1036821.7112021298,4624,1,546.4360189573459,63,148,41,38.410027835989894,0.5342614533965244,43.701171874999986,8143.8636548225895,129.26767706067602,0
4823,31.52299173740439,1,3,204,0.004830917874396135,0.014492753623188406,0.9855072463768116,207,6350,4500,1850,0.7086614173228346,82,45,37,220.613409204353,0.47826575520222625,0.8002968618595159,0.12610978139098797,1027567.468926937,-2410.9674985081033,1025156.5014284289,4625,0,557.8454106280193,66,141,39,39.03430656193545,0.5288848631239935,44.66728855721392,8048.850953099992,121.9522871681817,7
4824,31.865205354293046,0,1,203,0.0,0.004901960784313725,0.9950980392156863,204,6350,4600,1750,0.7244094488188977,81,46,35,226.94090017316915,0.4780523559998712,0.8030708348733262,0.12815164231962692,1034931.3249827216,-176.35069820197805,1034754.9742845196,4626,1,562.5490196078431,66,138,37,39.34974785985891,0.5273182189542484,45.1337064676617,8121.366781295511,123.05101183781078,8
4825,31.49968779967052,3,2,204,0.014563106796116505,0.009708737864077669,0.9902912621359223,206,6650,4700,1950,0.706766917293233,86,47,39,227.40524781341082,0.47850659089115166,0.8056865464632452,0.1295681063122924,1025807.7040881214,-1195.188968586972,1024612.5151195345,4627,0,557.2961165048544,72,134,41,38.98809523809525,0.5299352750809061,44.79166666666667,8038.982823874258,111.65253922047582,0
4826,31.50983250092642,4,1,207,0.019230769230769232,0.004807692307692308,0.9951923076923077,208,6850,4600,2250,0.6715328467153284,91,46,45,223.2277747175408,0.478579737241422,0.8032905732314723,0.1288390872176301,1030076.3254718594,-2461.6708151391867,1027614.6546567202,4628,0,552.8798076923077,65,143,42,38.59451834248916,0.532802483974359,44.30239898989899,8056.988578716994,123.95367044179991,0
4827,31.80361591986796,1,2,206,0.004807692307692308,0.009615384615384616,0.9903846153846154,208,8650,6600,2050,0.7630057803468208,107,66,41,219.1574437879829,0.47868231682769724,0.8000454587303785,0.1274224386115931,1041931.3672891995,-4580.59698847632,1037350.7703007231,4629,0,553.1394230769231,67,141,40,38.415868741272675,0.5355068108974359,44.02573529411764,8140.907200076474,121.5060776130817,0
4828,31.585312204709044,3,1,208,0.014354066985645933,0.004784688995215311,0.9952153110047847,209,6950,4700,2250,0.6762589928057554,92,47,45,218.14766772221853,0.47907081953134584,0.8006638786355984,0.12821873365523823,1038064.0970058942,-3459.747658398804,1034604.3493474954,4630,0,551.3205741626795,63,146,41,38.02691721686136,0.5385267145135566,43.619791666666664,8097.8489233166765,128.5372844970901,0
4829,31.546813920426736,2,3,207,0.009523809523809525,0.014285714285714285,0.9857142857142858,210,6850,4500,2350,0.656934306569343,92,45,47,217.293032703816,0.47872664616085664,0.800836649769679,0.12862766671993991,1038938.0948955147,-3699.1981137257385,1035238.8967817889,4631,0,549.6190476190476,65,145,42,37.77872158333845,0.540625,43.35542929292929,8096.318515783753,124.55874639667313,0
4830,31.904102852841454,2,2,207,0.009569377990430622,0.009569377990430622,0.9904306220095693,209,7600,5700,1900,0.75,95,57,38,217.030898586017,0.47843726996687524,0.7998974408281647,0.12946543508711655,1053037.8220766063,-3691.6510459302226,1049346.171030676,4632,0,549.0813397129186,68,141,35,37.49449145073154,0.543859649122807,43.070652173913054,8197.100338956978,120.54559321995555,0
4831,31.780603532405273,2,2,207,0.009569377990430622,0.009569377990430622,0.9904306220095693,209,6300,4700,1600,0.746031746031746,79,47,32,215.02154524714933,0.47850915531836585,0.7983462034200399,0.12919882473784014,1051137.7457979084,-2896.5475261858146,1048241.1982717225,4633,0,549.1818181818181,75,134,39,37.274014122035666,0.5464015151515151,42.804276315789465,8173.835324637932,108.98447099517243,0
4832,32.23106173965165,0,3,204,0.0,0.014492753623188406,0.9855072463768116,207,6750,5100,1650,0.7555555555555555,84,51,33,229.6889399370849,0.478338062629958,0.8089654355343696,0.13362517791733236,1056119.5557559787,365.79624168291866,1056485.3519976616,4634,1,555.4685990338164,73,134,38,38.123419113603866,0.5405092592592593,44.003378378378365,8251.042916628694,113.02798515929717,8
4833,32.30932148787293,3,1,206,0.014492753623188406,0.004830917874396135,0.9951690821256038,207,6750,4700,2050,0.6962962962962963,88,47,41,222.71929453844496,0.47885789440770443,0.8033197524146802,0.13068109401722106,1061328.293765482,-874.3422277719183,1060453.9515377101,4635,0,555.3816425120773,62,145,41,37.97520750010753,0.5431763285024155,43.683862433862444,8281.40049115422,133.57097566377774,0
4834,32.09429001430777,2,2,206,0.009615384615384616,0.009615384615384616,0.9903846153846154,208,7100,5600,1500,0.7887323943661971,86,56,30,222.66262537348592,0.47868667162145423,0.8030903805946845,0.1318623311661923,1057098.2487520352,-1624.7457310313598,1055473.503021004,4636,0,553.5721153846154,65,143,41,37.62477964989955,0.5457732371794872,43.33964646464648,8237.331821538428,126.72818186982197,0
4835,32.317679500144656,1,1,206,0.004830917874396135,0.004830917874396135,0.9951690821256038,207,6650,5000,1650,0.7518796992481203,83,50,33,224.04434008423058,0.47856084767756357,0.8025066581687499,0.133104092926744,1065435.3171895351,-309.0494915674881,1065126.2676979676,4637,0,556.304347826087,68,139,43,37.468644051188576,0.5474033816425121,43.22161835748793,8298.481440488544,122.03649177189035,0
4836,32.5879736401038,0,5,201,0.0,0.024271844660194174,0.9757281553398058,206,6000,4100,1900,0.6833333333333333,79,41,38,214.97608666930822,0.47820615281395534,0.7911254324294159,0.1227225691616136,1061858.6121664632,-1545.158192070035,1060313.4539743932,4638,1,559.9320388349514,70,136,41,39.230363984674334,0.5302892394822006,44.71830985915495,8319.11298911105,118.844471273015,8
4837,32.687325153764995,1,1,201,0.0049504950495049506,0.0049504950495049506,0.995049504950495,202,5650,4000,1650,0.7079646017699115,73,40,33,211.8408884941167,0.47753548675763097,0.7840460116711865,0.12125211944546593,1065932.6525735504,-888.3759607854154,1065044.276612765,4639,0,553.2920792079208,71,131,38,39.20802175390891,0.5318172442244224,44.61805555555558,8347.752656456356,117.57398107685009,0
4838,32.46147720569712,7,4,204,0.03365384615384615,0.019230769230769232,0.9807692307692307,208,5800,4100,1700,0.7068965517241379,75,41,34,199.8088992560314,0.47805232333085595,0.7783047176703881,0.1159520935052727,1062889.9083924966,-4925.027474749899,1057964.8809177468,4640,0,538.1586538461538,80,128,34,38.984056987788364,0.5359074519230769,44.09722222222225,8306.98218770798,103.83727734634974,0
4839,32.41479785856032,2,2,204,0.009708737864077669,0.009708737864077669,0.9902912621359223,206,7150,5500,1650,0.7692307692307693,88,55,33,214.53482252128478,0.47777202225905757,0.7945009060983821,0.12257976986500735,1056496.1075819456,-3018.9590130956253,1053477.14856885,4641,0,544.3737864077669,67,139,39,39.207028359432826,0.5336266181229774,44.684436274509814,8276.002388306162,123.52242370606213,8
4840,31.989497282365964,1,2,203,0.004878048780487805,0.00975609756097561,0.9902439024390244,205,5500,4100,1400,0.7454545454545455,69,41,28,205.39959989336592,0.4772995377012594,0.7799656239617199,0.1181332800620518,1044670.013149067,-3585.0394557166273,1041084.9736933503,4642,0,547.0195121951219,75,130,42,39.18601844899716,0.539989837398374,44.43530701754388,8175.386051631013,109.00514735508018,8
4841,32.387062929250845,1,3,201,0.004901960784313725,0.014705882352941176,0.9852941176470589,204,6250,4100,2150,0.656,84,41,43,225.43367616012947,0.4773269221481696,0.7915375058429892,0.12925945316519682,1056693.4714120307,592.8587669646913,1057286.3301789954,4643,0,549.8578431372549,77,127,36,38.79260769552488,0.537530637254902,44.55128205128206,8273.233703401596,107.44459355067008,8
4842,31.95655004229051,1,2,200,0.0049504950495049506,0.009900990099009901,0.9900990099009901,202,5800,3800,2000,0.6551724137931034,78,38,40,224.06328515563337,0.4773959205622054,0.788532427075741,0.12480324983168752,1033598.9339328369,118.31453407022127,1033717.2484669071,4644,0,555.7128712871287,72,130,37,39.96332192549368,0.5259385313531353,45.66210045662099,8127.761814409021,112.88558075568085,8
4843,32.012035740842094,3,0,203,0.014778325123152709,0.0,1.0,203,6800,4800,2000,0.7058823529411765,88,48,40,215.83120183547422,0.47762319335381814,0.7845578986036954,0.12148512166305582,1038688.9523555744,-2563.7030159735605,1036125.2493396008,4645,0,553.9310344827586,75,128,44,39.75954123175146,0.52498973727422,45.25767543859647,8154.8203985648015,108.73093864753069,8
4844,31.929551693767927,2,3,202,0.00975609756097561,0.014634146341463415,0.9853658536585366,205,7600,5700,1900,0.75,95,57,38,228.50449155211146,0.4777249721026622,0.7934321383429626,0.1290638942589343,1037092.0444330077,-1203.9619388193787,1035888.0824941883,4646,0,549.5170731707317,74,131,32,39.300991771565556,0.5301321138211382,45.12499999999998,8138.044487949054,109.9735741614737,8
4845,32.42217592431849,4,1,205,0.019417475728155338,0.0048543689320388345,0.9951456310679612,206,6150,4400,1750,0.7154471544715447,79,44,35,224.98606749137505,0.47795060778277687,0.7964272380507511,0.12865498315656068,1056990.2079396015,211.6140522445403,1057201.821991846,4647,0,547.7766990291262,67,139,37,38.908865258863784,0.5330198220064725,44.65379901960786,8278.879449792692,123.56536492227899,0
4846,32.49500896396031,1,2,204,0.0048543689320388345,0.009708737864077669,0.9902912621359223,206,6850,5500,1350,0.8029197080291971,82,55,27,224.22380429778514,0.4781341266082564,0.7955913438786175,0.12877461444655686,1060726.3868914929,-481.97884242880536,1060244.408049064,4648,0,548.6990291262136,68,138,39,38.76058591826685,0.5347390776699029,44.489734299516925,8302.808374321121,122.10012315178119,0
4847,32.76288548219963,4,3,205,0.019230769230769232,0.014423076923076924,0.9855769230769231,208,6800,5100,1700,0.75,85,51,34,219.61191534050397,0.4780145817849622,0.7913803561169359,0.12472375210259773,1065913.3848642006,-1582.5439925785122,1064330.840871622,4649,0,544.3509615384615,75,133,38,39.313051868966376,0.5313000801282051,44.91502192982457,8357.31992474258,111.43093232990107,8
4848,32.54607757952822,1,5,201,0.0048543689320388345,0.024271844660194174,0.9757281553398058,206,6650,4600,2050,0.6917293233082706,87,46,41,226.23567978522195,0.4781760596732181,0.8004565218230242,0.12749556981432053,1056402.0489506943,-50.832865828092054,1056351.216084866,4650,0,550.0242718446602,71,135,40,39.44699572237049,0.5257888349514563,45.211226851851826,8292.375177272384,116.7940165813012,8
4849,32.869797235688566,4,5,200,0.01951219512195122,0.024390243902439025,0.975609756097561,205,6150,4700,1450,0.7642276422764228,76,47,29,218.7742892154865,0.47814741750358675,0.7917407038103483,0.12435290538436287,1069661.750312008,-347.10217489986553,1069314.6481371082,4651,0,553.4146341463414,79,126,35,39.301504363803424,0.5288109756097561,44.88281249999997,8385.650224464063,106.14747119574764,0
4850,33.254835570753826,1,5,196,0.004975124378109453,0.024875621890547265,0.9751243781094527,201,7250,5600,1650,0.7724137931034483,89,56,33,210.14615252511643,0.47719734660033164,0.7832686347665525,0.11828517234499725,1079013.8621416735,-2099.8776699322493,1076913.9844717411,4652,0,565.3980099502487,75,126,39,39.90436349940816,0.5279850746268657,45.257675438596486,8471.414116201066,112.9521882160142,8
4851,33.25417869587862,7,4,199,0.034482758620689655,0.019704433497536946,0.9802955665024631,203,6700,5100,1600,0.7611940298507462,83,51,32,206.10078058026377,0.4779818807003853,0.781649418189218,0.11724093583828067,1082423.876133226,-2682.3188420457436,1079741.5572911804,4653,0,558.2266009852217,84,119,41,39.594340377841796,0.5319683908045977,44.85294117647057,8484.70588784546,101.00840342673168,0
4852,33.12821128758263,1,0,200,0.005,0.0,1.0,200,6800,4500,2300,0.6617647058823529,91,45,46,205.03834670622683,0.4772550251256282,0.7766720312679614,0.11695925101622781,1079213.7780137532,-2543.958242695637,1076669.8197710577,4654,0,567.465,70,130,44,39.514000651415884,0.5332291666666666,44.74765258215964,8456.053696909694,120.80076709870991,0
4853,32.82312239678063,4,3,201,0.0196078431372549,0.014705882352941176,0.9852941176470589,204,5900,4200,1700,0.711864406779661,76,42,34,197.2036831032451,0.47759506101291094,0.7722094099440133,0.11353707742668288,1072222.3572447791,-4410.7604091371195,1067811.596835642,4655,0,557.3186274509804,78,126,43,39.35549393861233,0.5357434640522876,44.39609704641351,8389.718191740423,107.56048963769773,0
4854,32.46519459865011,2,1,202,0.009852216748768473,0.0049261083743842365,0.9950738916256158,203,7400,5800,1600,0.7837837837837838,90,58,32,217.97684248082751,0.4776485961404022,0.7908805254378111,0.12415259263684482,1057139.411405592,-1913.6178079536048,1055225.7935976384,4656,0,560.1330049261084,77,126,42,39.24236180159438,0.5310960591133005,44.80502136752138,8284.954641901797,107.59681353119217,8
4855,32.866507878925226,2,4,200,0.00980392156862745,0.0196078431372549,0.9803921568627451,204,6350,4500,1850,0.7086614173228346,82,45,37,203.58590401942217,0.4778938874400335,0.7735510581629799,0.11310828616292418,1062203.9827545062,-3900.0483835787763,1058303.9343709273,4657,0,558.3725490196078,71,133,41,40.58504761091827,0.5230800653594772,45.76099537037035,8355.948248789788,117.68941195478574,8
4856,33.17036213172073,3,1,202,0.014778325123152709,0.0049261083743842365,0.9950738916256158,203,6650,4600,2050,0.6917293233082706,87,46,41,200.9882555280452,0.4775093888699215,0.7711292311130731,0.11283035889664135,1075409.788776602,-4021.0525152015807,1071388.7362614004,4658,0,561.871921182266,76,127,42,40.241880500805706,0.5267857142857143,45.35984848484847,8446.506039033779,111.13823735570762,0
4857,33.49240481635852,6,2,206,0.028846153846153848,0.009615384615384616,0.9903846153846154,208,7200,5100,2100,0.7083333333333334,93,51,42,211.2690464197069,0.47849941548990466,0.7870544400977384,0.12003315481580075,1089776.9600427493,-2752.7721683201544,1087024.1878744292,4659,0,549.3221153846154,76,132,40,39.51041611426348,0.5278946314102564,44.899891774891785,8543.916093372225,112.41994859700296,8
4858,33.74680303500508,1,0,207,0.004830917874396135,0.0,1.0,207,6400,4800,1600,0.75,80,48,32,215.65809479720411,0.47844945515376075,0.7919043199632867,0.12283134964536399,1098869.9574029122,-403.9597113206728,1098465.9976915915,4660,0,552.9710144927536,76,131,42,39.30171225614931,0.5288848631239935,44.8051948051948,8612.008826465571,113.3159056113891,0
4859,33.25999964597589,6,3,210,0.028169014084507043,0.014084507042253521,0.9859154929577465,213,6750,4400,2350,0.6518518518518519,91,44,47,201.57534872748022,0.479412112085511,0.7826226146414226,0.1162704562511575,1087092.5984070895,-5523.786075405405,1081568.8123316842,4661,0,538.3661971830986,75,138,44,39.17189342768306,0.5324726134585289,44.32565789473686,8503.728527906213,113.3830470387495,0
4860,33.389561824197024,1,2,209,0.004739336492890996,0.009478672985781991,0.990521327014218,211,7150,5100,2050,0.7132867132867133,92,51,41,206.4158479201145,0.47943560520574735,0.7844465590382137,0.1144304247531163,1078389.2035823832,-4830.6756309295415,1073558.5279514536,4662,0,543.9620853080569,83,128,43,40.59958729771485,0.5221169036334914,45.8457341269841,8486.09957325039,102.24216353313723,8
4861,33.3866684038416,3,1,211,0.014150943396226415,0.0047169811320754715,0.9952830188679245,212,7850,5500,2350,0.7006369426751592,102,55,47,207.37669730308025,0.47994724134847533,0.7862498109399909,0.11615048361662911,1081672.8094147777,-5387.253044204072,1076285.5563705736,4663,0,539.8584905660377,72,140,44,40.16924528654444,0.5251572327044025,45.44805936073058,8498.64123367763,118.0366838010782,0
4862,33.59581156748145,3,1,213,0.014018691588785047,0.004672897196261682,0.9953271028037384,214,6950,5200,1750,0.7482014388489209,87,52,35,204.1858806286808,0.4802357107337692,0.7845827259404765,0.11557781580316615,1091922.3795718155,-5158.973469793007,1086763.4061020224,4664,0,535.3691588785047,78,136,38,39.836315680595746,0.527988707165109,45.04219409282699,8565.514404915855,109.81428724251097,0
4863,33.78651976847238,2,3,212,0.009302325581395349,0.013953488372093023,0.986046511627907,215,7350,5300,2050,0.7210884353741497,94,53,41,202.7728730344751,0.4804870318046801,0.7836514684226612,0.1154563909726906,1100060.8067964963,-5737.501938650577,1094323.3048578457,4665,0,533.8465116279069,81,134,40,39.642655648479995,0.5303779069767443,44.817073170731696,8621.743001893687,106.44127162831712,0
4864,34.03495458451399,3,1,214,0.013953488372093023,0.004651162790697674,0.9953488372093023,215,8000,5700,2300,0.7125,103,57,46,198.57385468605884,0.48045895819749335,0.7818475589030698,0.11390852587762922,1110604.0346382905,-6892.615162396905,1103711.4194758937,4666,0,534.6186046511627,76,139,42,39.461757749064475,0.5325581395348837,44.534632034632054,8694.7521966175,114.40463416601975,0
4865,33.811996082537874,2,3,213,0.009259259259259259,0.013888888888888888,0.9861111111111112,216,7100,5600,1500,0.7887323943661971,86,56,30,196.36939708667504,0.4805214613838645,0.7813487834180406,0.11329363221980804,1105209.4213031114,-6894.138456838653,1098315.2828462727,4667,0,533.0833333333334,78,138,45,39.296151135406454,0.5347222222222222,44.3169831223629,8645.153165038211,110.83529698766938,0
4866,33.91642883520253,2,3,212,0.009302325581395349,0.013953488372093023,0.986046511627907,215,6950,4900,2050,0.7050359712230215,90,49,41,193.3330854015491,0.48067901905382887,0.7782752532010182,0.11227084133575314,1110752.8025927034,-7000.94671126659,1103751.8558814367,4668,0,531.7023255813954,80,135,40,39.123557442674596,0.5367732558139535,44.071502057613195,8680.18068736331,108.50225859204139,0
4867,33.85026399991215,3,3,212,0.013953488372093023,0.013953488372093023,0.986046511627907,215,6850,5000,1850,0.7299270072992701,87,50,37,190.64490605292,0.4812187567920017,0.7747765147764454,0.11140761731127297,1110628.9457149722,-7502.849796902611,1103126.0959180696,4669,0,532.3302325581395,84,131,44,38.952144030362454,0.5392926356589147,43.835784313725526,8671.226328310935,103.22888486084446,0
4868,34.016503225060475,2,2,212,0.009345794392523364,0.009345794392523364,0.9906542056074766,214,6100,4400,1700,0.7213114754098361,78,44,34,200.77779818139877,0.4810794282830942,0.7807763270383219,0.11822996687143159,1118572.9313481143,-3983.0779477226934,1114589.8534003915,4670,0,533.8878504672897,72,142,42,38.4012862601083,0.5421047507788161,43.55022831050228,8723.524485741804,121.1600623019695,0
4869,33.98908327373678,0,0,212,0.0,0.0,1.0,212,7300,5300,2000,0.726027397260274,93,53,40,200.81421139183433,0.48073759650064085,0.7817434339937368,0.1188431586667362,1119288.7885211415,-4746.180922681408,1114542.60759846,4671,1,536.2216981132076,72,140,45,38.21112501158369,0.5442708333333333,43.36472602739723,8722.797698032982,121.14996802823586,0
4870,33.53390363616262,3,4,211,0.013953488372093023,0.018604651162790697,0.9813953488372094,215,6700,4800,1900,0.7164179104477612,86,48,38,191.98077460065943,0.48084112149532715,0.7752790492202346,0.11461067589485735,1107076.7345284203,-7192.510192573409,1099884.224335847,4672,0,529.7255813953489,77,138,38,38.109105122741354,0.5468992248062016,43.04220085470082,8616.79807509881,111.90646850777675,0
4871,33.63955729908421,0,3,208,0.0,0.014218009478672985,0.985781990521327,211,7100,5200,1900,0.7323943661971831,90,52,38,192.42527531041435,0.48038723388249455,0.7727824181962604,0.11532773122908829,1111813.921135805,-6511.780026298781,1105302.1411095064,4673,1,540.1706161137441,76,135,43,37.950429711479416,0.549318720379147,42.89772727272724,8648.806635133777,113.8000873043918,0
4872,33.34306461971776,4,1,211,0.018867924528301886,0.0047169811320754715,0.9952830188679245,212,7900,6200,1700,0.7848101265822784,96,62,34,188.70385429422322,0.48004784047214527,0.7671081148270671,0.11425296917893502,1105209.2533239804,-8588.550819225078,1096620.7025047552,4674,0,536.2405660377359,73,139,43,37.66669172452756,0.5528694968553459,42.525337837837824,8584.994298412941,117.60266162209508,0
4873,33.06103334456539,0,2,209,0.0,0.009478672985781991,0.990521327014218,211,6550,5100,1450,0.7786259541984732,80,51,29,189.8214128196398,0.47964154066049797,0.7678768947449777,0.11543426388776304,1097220.366021875,-7094.8159894492255,1090125.550032426,4675,1,539.739336492891,75,136,47,37.4752287599085,0.5541567930489731,42.36567982456139,8517.656850024578,113.5687580003277,0
4874,33.49136434394617,1,4,206,0.004761904761904762,0.01904761904761905,0.9809523809523809,210,5700,3800,1900,0.6666666666666666,76,38,38,177.75603284073912,0.479810795929217,0.7555077686078497,0.10353657078733172,1097802.2971144693,-8671.803764295904,1089130.4933501733,4676,0,543.0142857142857,84,126,42,39.407038242473575,0.5392361111111111,43.95833333333336,8575.184745564611,102.08553268529299,8
4875,33.209803046525636,2,1,207,0.009615384615384616,0.004807692307692308,0.9951923076923077,208,7750,5600,2150,0.7225806451612903,99,56,43,177.51114316147812,0.4797724668648582,0.7522248076203335,0.10423833314125906,1091161.9202138733,-10611.320033712622,1080550.6001801607,4677,0,547.9182692307693,75,133,46,39.10363087918162,0.5420673076923077,43.654057017543835,8513.198278223193,113.50931037630924,0
4876,32.81896285710092,4,9,202,0.018957345971563982,0.04265402843601896,0.957345971563981,211,5650,4200,1450,0.7433628318584071,71,42,29,173.59148232590925,0.480291318739186,0.7506349364702951,0.1029280022272265,1081349.240326556,-10307.396491943764,1071041.843834612,4678,0,540.872037914692,79,132,45,38.83807802857385,0.5449249605055293,43.294270833333314,8424.815790725792,106.64323785728851,0
4877,32.48813765217895,1,0,203,0.0049261083743842365,0.0,1.0,203,6950,4900,2050,0.7050359712230215,90,49,41,188.16908322040467,0.4790203466159424,0.7536813531435931,0.11243999986439891,1072839.2727969536,-7174.963518990657,1065664.309277963,4679,0,561.0295566502463,79,124,35,38.17201406833191,0.5470545977011494,43.00781249999997,8349.197563034508,105.68604510170263,0
4878,32.757677216385986,1,6,198,0.004901960784313725,0.029411764705882353,0.9705882352941176,204,6100,4100,2000,0.6721311475409836,81,41,40,187.73959129629463,0.47890305547506357,0.7550065462771429,0.11286672341352012,1083620.4614211337,-6212.307490499093,1077408.1539306347,4680,0,559.2745098039215,81,123,37,37.955600553141025,0.5487132352941176,42.78455284552844,8425.780592954527,104.02198262906823,0
4879,32.764840822504624,2,2,198,0.01,0.01,0.99,200,6750,4400,2350,0.6518518518518519,91,44,47,189.07432261949438,0.47825638609715243,0.752840988827117,0.11399218923434323,1084734.0599009295,-5730.9284803875835,1079003.1314205418,4681,0,557.67,74,126,40,37.815305590039756,0.55015625,42.68055555555555,8431.030637757534,113.9328464561829,0
4880,32.97854724901795,1,1,198,0.005025125628140704,0.005025125628140704,0.9949748743718593,199,6200,4600,1600,0.7419354838709677,78,46,32,246.74019127629373,0.4779516268209736,0.8020481296876822,0.1458728010825439,1085688.9710033757,7576.62087438674,1093265.5918777625,4682,0,558.6030150753769,68,131,40,37.07149300857012,0.5453308207705192,43.40277777777775,8462.203617022251,124.44417083856251,8
4881,33.24648729313726,1,2,197,0.005025125628140704,0.010050251256281407,0.9899497487437185,199,6050,4600,1450,0.7603305785123967,75,46,29,242.16885552099424,0.47752863644823446,0.7994592158630032,0.1440677454158395,1096485.4923429051,7256.927355210486,1103742.4196981157,4683,0,559.1859296482412,71,128,43,36.95170497220967,0.5475816582914572,43.17129629629626,8538.652234198016,120.26270752391572,0
4882,33.67250661365734,2,2,197,0.010050251256281407,0.010050251256281407,0.9899497487437185,199,5600,4100,1500,0.7321428571428571,71,41,30,208.28677333187125,0.4775783378170313,0.7672389463336291,0.12473697734750645,1112655.083839073,950.2674488285256,1113605.3512879016,4684,0,559.6834170854271,85,114,38,37.57185261967585,0.5498848408710217,42.92635658914728,8656.313957948914,101.83898774057546,8
4883,34.023924400265315,0,1,196,0.0,0.005076142131979695,0.9949238578680203,197,6000,3700,2300,0.6166666666666667,83,37,46,208.2097538929405,0.47739152767706067,0.7664319725728674,0.12526795334782628,1125750.8237487322,1478.4603914996478,1127229.2841402318,4685,1,566.2791878172588,85,112,39,37.400728254386806,0.5515016920473773,42.75678294573643,8752.423769535297,102.96969140629761,0
4884,34.3111708540609,0,5,191,0.0,0.025510204081632654,0.9744897959183674,196,6800,4800,2000,0.7058823529411765,88,48,40,209.84831180176874,0.4770081109366824,0.7659129052009317,0.12675713540776998,1136541.0672967322,1700.2448531200198,1138241.3121498523,4686,2,570.1479591836735,74,122,40,37.209848730124506,0.5535714285714286,42.611111111111114,8831.314142603573,119.3420830081564,0
4885,34.00762873843002,0,1,190,0.0,0.005235602094240838,0.9947643979057592,191,6750,5100,1650,0.7555555555555555,84,51,33,229.16545846975578,0.4760069348764582,0.786522455287868,0.1338274029480441,1115571.466639474,6180.089321642498,1121751.5559611164,4687,3,585.8010471204188,74,117,38,37.991292520695495,0.5416666666666667,43.86111111111111,8710.6762388073,117.71184106496352,8
4886,34.273497884725984,3,0,193,0.015544041450777202,0.0,1.0,193,6100,4800,1300,0.7868852459016393,74,48,26,227.00428580025724,0.47644555987334486,0.7882071760182305,0.13407389850665147,1128001.1134314807,6512.217427281614,1134513.3308587624,4688,0,577.4559585492228,66,127,43,37.61501131176018,0.5444732297063903,43.439054726368155,8793.241015139116,133.2309244718048,0
4887,34.06258381992964,0,0,193,0.0,0.0,1.0,193,7800,5700,2100,0.7307692307692307,99,57,42,228.22234570974763,0.4760475136729994,0.7882206943942229,0.1353951825372957,1122504.1246425589,4836.104878958234,1127340.2295215172,4689,1,578.4559585492228,69,124,41,37.41474418424918,0.5466860967184801,43.27380952380952,8744.757381866444,126.73561422994847,0
4888,34.24751140310416,0,1,192,0.0,0.0051813471502590676,0.9948186528497409,193,6500,4200,2300,0.6461538461538462,88,42,46,225.92053404785952,0.47558200201496836,0.7870105474341023,0.13478877190410057,1130434.3053042141,5977.664392069781,1136411.9696962838,4690,2,579.4559585492228,72,121,41,37.26038079899294,0.5481433506044905,43.06506849315068,8799.381996636603,122.21363884217504,0
4889,34.029377077723794,0,0,192,0.0,0.0,1.0,192,6900,5000,1900,0.7246376811594203,88,50,38,231.33713950106045,0.47561434245927864,0.7904901556900255,0.13852536768117507,1124410.5752119382,6723.585218854284,1131134.1604307925,4691,3,582.9166666666666,74,118,40,36.98358456246511,0.5499674479166667,42.93055555555555,8747.913060160954,118.2150413535264,0
4890,33.7400429576554,1,1,192,0.0051813471502590676,0.0051813471502590676,0.9948186528497409,193,6150,4500,1650,0.7317073170731707,78,45,33,226.83571890762852,0.4756123614709269,0.7880037181760282,0.136555102782392,1116546.7280321892,5904.535949428254,1122451.2639816175,4692,0,580.8911917098445,77,116,42,36.89935458194904,0.5515975820379966,42.735042735042725,8680.130709619012,112.72897025479236,0
4891,33.36252882517367,2,2,192,0.010309278350515464,0.010309278350515464,0.9896907216494846,194,5950,4300,1650,0.7226890756302521,76,43,33,224.36776820338085,0.4752200069440735,0.7871357695816894,0.13598753737022218,1106180.5614595471,4888.252760928521,1111068.8142204757,4693,0,578.8659793814433,65,129,43,36.70962041350005,0.553747852233677,42.48737373737376,8591.272416533087,132.17342179281673,0
4892,33.61051873485963,1,3,190,0.0051813471502590676,0.015544041450777202,0.9844559585492227,193,7150,5300,1850,0.7412587412587412,90,53,37,221.0270782585306,0.4744620754173863,0.7821539818238545,0.13485065243099778,1116484.2396218316,3604.649881062456,1120088.8895028941,4694,0,582.3523316062176,69,124,42,36.549985085541685,0.5564011226252159,42.24702380952383,8663.211235215877,125.5537860176214,0
4893,33.29247617178408,1,1,190,0.005235602094240838,0.005235602094240838,0.9947643979057592,191,6600,5100,1500,0.7727272727272727,81,51,30,218.75960417814113,0.47412739965095985,0.7786094548520686,0.13438305274918402,1108045.1627065502,3679.1042410380946,1111724.2669475884,4695,0,587.8115183246073,71,120,43,36.35541084880092,0.5590641361256545,41.99942129629632,8589.478118799614,120.9785650535157,0
4894,33.14345713872414,0,1,189,0.0,0.005263157894736842,0.9947368421052631,190,6150,4600,1550,0.7479674796747967,77,46,31,218.9691611989528,0.4733245149911816,0.7789213837268738,0.13519246442165514,1104642.2150771215,4226.515852078433,1108868.7309291998,4696,1,591.4947368421052,75,115,44,36.16403222381483,0.5615131578947368,41.817434210526336,8557.062803209301,114.09417070945734,0
4895,33.402053391149764,1,0,190,0.005263157894736842,0.0,1.0,190,6500,4800,1700,0.7384615384615385,82,48,34,217.42392266860472,0.473188758934373,0.7778324813377575,0.13475453053515266,1114450.6080890032,3961.644566225001,1118412.2526552281,4697,0,590.2736842105263,80,110,46,36.063021688986254,0.5637061403508772,41.67952674897122,8628.434239558013,107.85542799447516,0
4896,33.243664816413755,1,1,190,0.005235602094240838,0.005235602094240838,0.9947643979057592,191,6650,5400,1250,0.8120300751879699,79,54,25,219.02295591569282,0.47315146505005967,0.7794776485875967,0.13674135896358114,1111413.7881778996,3835.0266264362217,1115248.8148043358,4698,0,588.1780104712042,66,125,42,35.754369087702436,0.5659358638743455,41.417910447761194,8596.216312602513,130.24570170609869,0
4897,32.684168744310526,2,1,191,0.010416666666666666,0.005208333333333333,0.9947916666666666,192,6100,4100,2000,0.6721311475409836,81,41,40,209.99192136787332,0.47243696371436883,0.7704865046755447,0.13219077604481375,1095195.3980582245,1496.437182299952,1096691.8352405245,4699,0,583.7708333333334,70,122,47,35.687635779729845,0.568359375,41.123826291079816,8461.1525453838,120.87360779119714,0
4898,32.24009887442415,0,0,191,0.0,0.0,1.0,191,5850,4200,1650,0.717948717948718,75,42,33,212.610476836216,0.4720010103793515,0.7725854379715416,0.134431138488604,1081620.720357861,1942.779422243114,1083563.499780104,4700,1,575.3507853403141,72,119,37,35.46016269119889,0.5698625654450262,40.96746575342465,8351.234515802225,115.98936827503091,0
4899,32.43382611076014,0,0,191,0.0,0.0,1.0,191,6050,4400,1650,0.7272727272727273,77,44,33,213.00650373968506,0.47174152659134744,0.773621957851576,0.1351519118359049,1089155.088754528,2149.423497177641,1091304.5122517056,4701,2,576.3507853403141,75,116,38,35.32411325012341,0.5712260034904014,40.844298245614034,8405.410966313768,112.0721462175169,0
4900,32.1452603535797,0,3,188,0.0,0.015706806282722512,0.9842931937172775,191,5550,3900,1650,0.7027027027027027,72,39,33,211.24974386145922,0.47155552493799946,0.7627039772273705,0.12973422279622338,1069781.2598217675,1448.203425027462,1071229.4632467949,4702,3,577.3507853403141,75,116,38,36.559273672280376,0.5634816753926701,42.009320175438596,8293.177571757546,110.57570095676728,8
4901,32.5150761434317,3,2,189,0.015706806282722512,0.010471204188481676,0.9895287958115183,191,6450,4800,1650,0.7441860465116279,81,48,33,211.06860722861813,0.47146482042803345,0.7633424943116514,0.13053491536057538,1084208.8505391825,1118.4904056492642,1085327.3409448317,4703,0,578.1623036649214,80,111,44,36.30598160782168,0.5658267888307156,41.75668724279836,8396.800977832463,104.96001222290579,0
4902,32.969116355585385,0,3,186,0.0,0.015873015873015872,0.9841269841269842,189,6000,4200,1800,0.7,78,42,36,217.9535245834848,0.4710824045930429,0.7681154188626573,0.1285174231164686,1084556.1727728813,3476.5680929248565,1088032.7408658061,4704,1,582.6296296296297,74,115,41,37.909492094433595,0.5512014991181657,43.5,8456.578345207652,114.27808574604936,8
4903,32.96939463906549,2,1,187,0.010638297872340425,0.005319148936170213,0.9946808510638298,188,5850,4100,1750,0.7008547008547008,76,41,35,214.30226769833754,0.4710320903022718,0.7660702461662852,0.12323907729057179,1076632.729797091,2694.9670947541194,1079327.6968918452,4705,0,584.7234042553191,73,115,37,38.96303818966308,0.5431626773049645,44.43975225225228,8425.666662052918,115.42009126099887,8
4904,32.51837515417135,1,0,188,0.005319148936170213,0.0,1.0,188,5950,4600,1350,0.773109243697479,73,46,27,220.79299796195812,0.471100831531839,0.7819385664272203,0.12621869685613268,1060030.0243079967,3259.441399329862,1063289.4657073265,4706,0,585.6489361702128,65,123,37,39.0277949478716,0.5396165780141844,44.665404040404034,8303.066181252896,127.73947971158302,8
4905,32.22640693987761,4,2,190,0.020833333333333332,0.010416666666666666,0.9895833333333334,192,4850,2600,2250,0.5360824742268041,71,26,45,210.54925585284533,0.47204781577225136,0.776406901564711,0.12141069928827519,1053217.6951049594,1100.8403910795569,1054318.535496039,4707,0,574.4270833333334,70,122,42,38.95388595585141,0.5419379340277778,44.33685446009389,8239.104567698156,117.70149382425937,0
4906,32.09975653758789,0,0,190,0.0,0.0,1.0,190,6400,4600,1800,0.71875,82,46,36,212.41403227566175,0.47156838856400257,0.7753860735803737,0.12296318282730517,1050282.9129259486,218.96571296554293,1050501.878638914,4708,1,581.4421052631579,70,120,43,38.75638047717371,0.5438048245614036,44.19014084507042,8211.43419878787,117.30620283982672,0
4907,32.34569834723371,3,2,191,0.015544041450777202,0.010362694300518135,0.9896373056994818,193,5950,4500,1450,0.7563025210084033,74,45,29,205.26831247464142,0.47203669221358663,0.7660248357310329,0.11761532628988777,1055126.2117019957,-1233.204615233809,1053893.007086762,4709,0,573.3886010362694,72,121,42,39.33461359404099,0.5410729706390328,44.57762557077627,8261.815074421884,114.74743158919283,8
4908,32.19570053893079,3,3,191,0.015463917525773196,0.015463917525773196,0.9845360824742269,194,4900,3000,1900,0.6122448979591837,68,30,38,204.9678723763795,0.4717524215230668,0.7665377773648145,0.11863916635537954,1053386.6934707202,-517.9141299432522,1052868.7793407768,4710,0,571.3969072164948,74,120,46,38.951252398016486,0.5436533505154639,44.194444444444464,8235.839062861533,111.29512247110179,0
4909,32.14414633329064,1,3,189,0.005208333333333333,0.015625,0.984375,192,5500,3700,1800,0.6727272727272727,73,37,36,203.1920964143397,0.4711968031922629,0.7626026995305153,0.11825113807719834,1053378.5125877403,-1092.3623418953484,1052286.150245845,4711,0,572.8958333333334,77,115,42,38.78847157016172,0.5457356770833333,43.990384615384635,8229.210539652582,106.87286415133224,0
4910,32.43990600234382,2,0,191,0.010471204188481676,0.0,1.0,191,5950,4400,1550,0.7394957983193278,75,44,31,215.00250121090386,0.47143841278589144,0.7710293718611976,0.12320250434529395,1058223.9255156566,1354.158165417466,1059578.083681074,4712,0,575.4921465968587,71,120,38,39.082943925233636,0.5420484293193717,44.57465277777778,8285.97425450492,116.70386273950591,8
4911,32.40191302390836,2,1,192,0.010362694300518135,0.0051813471502590676,0.9948186528497409,193,5800,4000,1800,0.6896551724137931,76,40,36,203.5986174028188,0.4717735769286126,0.7633954228864501,0.11433593001165415,1050607.6726529412,-1619.546083013704,1048988.1265699274,4713,0,570.5181347150259,76,117,41,40.161606636917405,0.530440414507772,45.34632034632033,8251.266379356715,108.56929446521994,8
4912,32.360778692679474,2,2,192,0.010309278350515464,0.010309278350515464,0.9896907216494846,194,6200,5000,1200,0.8064516129032258,74,50,24,202.37611155700054,0.4718898563110945,0.7621981395090893,0.11439575990116663,1051346.545493796,-2446.514844816494,1048900.0306489796,4714,0,568.319587628866,78,116,36,39.93626715635559,0.532860824742268,45.09493670886073,8248.926340807933,105.75546590779402,0
4913,32.02569602516788,2,1,193,0.010309278350515464,0.005154639175257732,0.9948453608247423,194,6950,4800,2150,0.6906474820143885,91,48,43,237.90268861241435,0.47264380018873636,0.8016033268963831,0.13482118555083672,1041257.8285215086,3793.607388798181,1045051.4359103068,4715,0,569.1288659793814,75,119,38,38.930674997760455,0.5316258591065293,44.99725877192982,8166.640276154718,108.88853701539624,7
4914,32.181169091224845,1,2,192,0.005154639175257732,0.010309278350515464,0.9896907216494846,194,6450,4300,2150,0.6666666666666666,86,43,43,241.52547418741023,0.4726560413439453,0.8055801904815318,0.13792746011362644,1048713.6298750422,5408.211348474182,1054121.8412235165,4716,0,570.1185567010309,59,135,40,38.53883316332313,0.5339884020618557,44.70486111111113,8215.696032751097,139.24908530086606,0
4915,32.59983951211278,2,1,193,0.010309278350515464,0.005154639175257732,0.9948453608247423,194,5200,3300,1900,0.6346153846153846,71,33,38,239.29537054675302,0.4732692119366843,0.8035521409431516,0.13757512314004364,1064480.4251063205,6945.047553116785,1071425.4726594372,4717,0,570.3298969072165,63,131,40,38.33467348151922,0.5361361683848798,44.44986979166669,8330.893232091248,132.23640050938488,0
4916,32.331067215034935,1,3,191,0.005154639175257732,0.015463917525773196,0.9845360824742269,194,7300,5600,1700,0.7671232876712328,90,56,34,239.32641542062737,0.47356689457472,0.8039373009403243,0.13850290231852203,1057762.5059958266,4530.101785264142,1062292.6077810908,4718,0,571.0618556701031,66,128,42,38.0789217771835,0.5385524054982818,44.20087064676617,8270.258844666816,125.30695219192145,0
4917,32.202698035575395,4,4,191,0.020512820512820513,0.020512820512820513,0.9794871794871794,195,5650,3800,1850,0.672566371681416,75,38,37,238.28048570376342,0.47385342320909335,0.8046550361217621,0.13919711070148885,1056467.0309796017,5697.0954543663565,1062164.126433968,4719,0,567.3794871794872,73,122,38,37.74494651132971,0.5414529914529915,43.84853603603603,8248.768245402089,112.99682527948067,0
4918,32.28378556515468,1,2,190,0.005208333333333333,0.010416666666666666,0.9895833333333334,192,5200,3400,1800,0.6538461538461539,70,34,36,239.767115893141,0.4726687481820826,0.804299210575486,0.1407054390636063,1060536.64445077,7256.362507790021,1067793.00695856,4720,0,577.171875,57,135,40,37.53240610986546,0.54296875,43.678160919540225,8275.03928853964,145.17612786911647,0
4919,32.43063489365517,0,2,188,0.0,0.010526315789473684,0.9894736842105263,190,5950,4400,1550,0.7394957983193278,75,44,31,242.30253184807634,0.4722355657662675,0.8036881302783043,0.14258200778470412,1066206.8761592212,7718.92511344128,1073925.8012726624,4721,1,583.6526315789474,59,131,39,37.36317986910404,0.5447916666666667,43.57638888888887,8315.980510057025,140.94882220435636,0
4920,32.90648870155125,3,1,190,0.015706806282722512,0.005235602094240838,0.9947643979057592,191,5650,4200,1450,0.7433628318584071,71,42,29,234.38154436439322,0.4729470928630477,0.7971372086347306,0.13915937177086718,1084653.7153749962,6994.56258203349,1091648.2779570296,4722,0,580.890052356021,67,124,42,37.22660988803371,0.5476657940663177,43.24448529411763,8448.922443730056,126.10332005567248,0
4921,32.36481226268948,0,0,190,0.0,0.0,1.0,190,5450,3700,1750,0.6788990825688074,72,37,35,235.3565670737613,0.4726010628422909,0.7967857600204908,0.1401906508221964,1067792.2758253412,6812.3848772260535,1074604.6607025673,4723,1,584.9052631578948,69,121,39,37.07927818329278,0.5489583333333333,43.124999999999986,8313.711149978326,120.48856739099023,0
4922,32.49726704803826,1,2,189,0.005235602094240838,0.010471204188481676,0.9895287958115183,191,5700,4300,1400,0.7543859649122807,71,43,28,231.8643158605373,0.4726543124827776,0.7954679748801043,0.13907097877384555,1074294.3577322992,5918.105257686857,1080212.4629899862,4724,0,582.8376963350786,70,121,41,36.907784624747975,0.5512652705061082,42.869718309859145,8356.031430221787,119.37187757459695,0
4923,32.913612395255704,2,3,188,0.010471204188481676,0.015706806282722512,0.9842931937172775,191,5350,3800,1550,0.7102803738317757,69,38,31,229.44172950580915,0.4726451272159456,0.7938056451105944,0.13835801437927894,1089723.187926535,6455.5945840896475,1096178.7825106247,4725,0,582.3193717277487,58,133,44,36.768867924528315,0.5535013089005236,42.67302259887006,8469.560393023525,146.02690332799182,0
4924,32.676994524276935,0,1,187,0.0,0.005319148936170213,0.9946808510638298,188,6700,4700,2000,0.7014925373134329,87,47,40,229.99483389860973,0.4721236536200553,0.790996269032973,0.139611363500019,1083919.7585100916,5559.18896358983,1089478.9474736813,4726,1,591.6648936170212,63,125,43,36.507701421800945,0.5554632092198581,42.43164062499999,8416.559868923858,133.5961883956168,0
4925,32.59402329651988,1,1,187,0.005319148936170213,0.005319148936170213,0.9946808510638298,188,5900,4400,1500,0.7457627118644068,74,44,30,268.7896543719719,0.4721479500891266,0.818655731004724,0.15783375149347684,1070919.0673576137,14070.393195081497,1084989.4605526952,4727,0,592.5585106382979,54,134,35,36.76502278044577,0.5448803191489362,43.65530303030303,8355.305024969633,154.727870832771,8
4926,32.07877578112128,2,0,189,0.010582010582010581,0.0,1.0,189,5550,4400,1150,0.7927927927927928,67,44,23,234.65690947976057,0.47214248189425495,0.7922326968012254,0.13840542265722358,1055353.13016216,6179.180786728634,1061532.3109488885,4728,0,590.021164021164,63,126,42,37.4703891708968,0.5472332451499118,43.48958333333332,8228.540141771968,130.61174828209474,7
4927,32.151325328169584,1,1,189,0.005263157894736842,0.005263157894736842,0.9947368421052631,190,6100,3900,2200,0.639344262295082,83,39,44,232.1518177179902,0.47243919985148053,0.7892955950871052,0.13762427151024295,1059293.4418697911,5083.379605363588,1064376.8214751547,4729,0,587.9105263157895,64,126,41,37.341974653514775,0.5489035087719298,43.301282051282044,8253.203992093266,128.95631237645728,0
4928,31.862466528008426,1,2,188,0.005263157894736842,0.010526315789473684,0.9894736842105263,190,5500,3900,1600,0.7090909090909091,71,39,32,220.20798621085763,0.4726335514712708,0.7756467439785892,0.12838212634822815,1044692.4843870386,2509.9256392979228,1047202.4100263366,4730,0,586.0736842105263,77,113,37,38.28460451977403,0.5455592105263158,43.923611111111136,8159.22536958555,105.96396583877338,8
4929,32.074166581687855,1,1,188,0.005291005291005291,0.005291005291005291,0.9947089947089947,189,6200,4500,1700,0.7258064516129032,79,45,34,232.3079886759882,0.4722421573042141,0.7794601580978118,0.13424077921044575,1048896.0828831655,4733.387868942471,1053629.470752108,4731,0,589.8783068783068,75,114,38,38.31601595298072,0.5440917107583774,44.25712719298248,8202.739504491747,109.36986005988996,8
4930,32.248259293734925,3,4,187,0.015706806282722512,0.020942408376963352,0.9790575916230366,191,6450,5000,1450,0.7751937984496124,79,50,29,229.7913139425591,0.47264168274088364,0.7778360050485171,0.1340242312129863,1057468.7263270984,3949.4256151743575,1061418.151942273,4732,0,584.6753926701571,78,113,30,38.02346136683492,0.5468477312390925,43.90822784810131,8258.513871346633,105.87838296598248,0
4931,32.043651742397195,0,2,185,0.0,0.0106951871657754,0.9893048128342246,187,6050,4000,2050,0.6611570247933884,81,40,41,235.06816282445885,0.47151903283307456,0.7803779893722054,0.13758689197084364,1051844.3532735389,6001.023940259119,1057845.377213798,4733,1,597.5775401069519,79,108,35,37.75303215096389,0.5485182709447416,43.776041666666714,8210.351288891941,103.92849732774609,0
4932,31.897657791277403,3,1,187,0.015957446808510637,0.005319148936170213,0.9946808510638298,188,6400,5100,1300,0.796875,77,51,26,247.66796337701317,0.47141550043615127,0.8001043841336122,0.14646043760196187,1050186.1369833583,8019.4923426881605,1058205.6293260464,4734,0,593.4255319148937,69,119,34,37.03752029691488,0.5517508865248226,43.39285714285714,8185.166829654566,118.62560622687776,8
4933,31.860682815673997,2,1,188,0.010582010582010581,0.005291005291005291,0.9947089947089947,189,6400,4900,1500,0.765625,79,49,30,248.6909695516677,0.4714435813726594,0.8030776334371255,0.14872142683387263,1052355.9295679575,8142.283287540422,1060498.2128554978,4735,0,591.2116402116402,76,113,33,36.58701335157989,0.5543430335097002,42.978896103896105,8188.867868168159,107.74826142326525,0
4934,31.695654603064764,0,0,188,0.0,0.0,1.0,188,6050,4400,1650,0.7272727272727273,77,44,33,245.85157152269974,0.4713917965638867,0.8001046540062069,0.1476380173044954,1048154.8973643372,7888.105743247424,1056043.0031075845,4736,1,595.218085106383,79,109,36,36.50284584746767,0.556072695035461,42.82552083333334,8151.313464389764,103.1811830935413,0
4935,32.124347158344946,1,2,187,0.005291005291005291,0.010582010582010581,0.9894179894179894,189,7050,4900,2150,0.6950354609929078,92,49,43,246.6311729519913,0.471191461218057,0.8020254732583509,0.14890588863191592,1063962.245583968,7631.251321001479,1071593.4969049694,4737,0,593.063492063492,64,125,37,36.28061436280614,0.5579254850088183,42.62820512820511,8267.900887227845,129.18595136293507,0
4936,31.627085154079204,1,2,186,0.005319148936170213,0.010638297872340425,0.9893617021276596,188,6050,4400,1650,0.7272727272727273,77,44,33,244.85164005394435,0.4710415718511776,0.7887178446928724,0.1444624676318267,1040584.9094645495,7307.78433955586,1047892.6938041054,4738,0,596.9042553191489,68,120,39,37.19728401600755,0.5470412234042553,43.478260869565204,8113.034887350724,119.30933657868711,7
4937,31.75541326935457,1,1,186,0.0053475935828877,0.0053475935828877,0.9946524064171123,187,6400,4600,1800,0.71875,82,46,36,252.78106562913806,0.47090089701569776,0.7959711333783301,0.15065338526773966,1047854.3051927962,9175.545578142785,1057029.850770939,4739,0,599.5935828877006,70,117,36,36.61062726061297,0.5496880570409982,43.1044600938967,8157.824036772243,116.5403433824606,0
4938,31.59836867131504,1,0,187,0.0053475935828877,0.0,1.0,187,5150,3300,1850,0.6407766990291263,70,33,37,272.7075492509842,0.4707463630613536,0.8044351908486056,0.15746079773179797,1033094.1668794078,13796.51567903425,1046890.6825584421,4740,0,600.4064171122994,63,124,37,37.313625803577104,0.5337009803921569,44.28710937500001,8080.110191976426,128.25571733295914,8
4939,32.08252868971944,3,3,187,0.015789473684210527,0.015789473684210527,0.9842105263157894,190,5150,3600,1550,0.6990291262135923,67,36,31,270.90558928734515,0.47116170054766543,0.8016908647370282,0.1576532938618669,1051349.7359026913,13813.303950362744,1065163.039853054,4741,0,591.9105263157895,68,122,31,37.05613378149936,0.5361842105263157,43.99154589371981,8213.398573675466,120.78527314228626,0
4940,32.08361936169376,3,0,190,0.015789473684210527,0.0,1.0,190,5800,4200,1600,0.7241379310344828,74,42,32,267.03681670963095,0.4714662814443516,0.802738553701327,0.15640727835849788,1053370.3934962328,12457.73533908101,1065828.1288353137,4742,0,592.8947368421053,61,129,37,36.907181571815705,0.5383223684210526,43.74999999999999,8221.427461434012,134.7774993677707,0
4941,32.42421156035286,0,1,189,0.0,0.005263157894736842,0.9947368421052631,190,6400,4700,1700,0.734375,81,47,34,264.31850128455693,0.4714453958971503,0.8003329565934578,0.15543371253013336,1065789.5005287451,11941.576692914748,1077731.07722166,4743,1,593.8947368421053,62,128,36,36.82409556974269,0.5399671052631578,43.60119047619047,8313.529243822597,134.08918135197737,0
4942,32.14412977528822,1,1,189,0.005263157894736842,0.005263157894736842,0.9947368421052631,190,5300,3400,1900,0.6415094339622641,72,34,38,262.6672107507163,0.4712510442773601,0.7975942347102303,0.15522285878496492,1058088.8830018714,12285.051124888356,1070373.9341267599,4744,0,594.7315789473685,65,125,41,36.67900750445961,0.5416666666666667,43.418560606060595,8247.587085809015,126.88595516629253,0
4943,31.87133688458586,5,4,190,0.02577319587628866,0.020618556701030927,0.979381443298969,194,6450,4900,1550,0.7596899224806202,80,49,31,252.4211354478136,0.47159773783451736,0.7926941828873442,0.15054132307843165,1051885.2137866155,7853.61200495638,1059738.825791572,4745,0,583.0257731958762,72,122,32,36.59411737480329,0.5450493986254296,43.079337899543354,8188.404974414441,113.72784686686724,0
4944,32.05065746949692,0,1,189,0.0,0.005263157894736842,0.9947368421052631,190,5750,3900,1850,0.6782608695652174,76,39,37,258.56301943975717,0.4712272579597141,0.7943747008586457,0.15434301363156624,1058076.658951033,10965.899147421393,1069042.5580984543,4746,1,596.1894736842105,73,117,33,36.40229538731236,0.5459978070175439,43.046171171171146,8235.539153268473,112.81560483929415,0
4945,31.949193308965928,1,0,190,0.005263157894736842,0.0,1.0,190,5000,3100,1900,0.62,69,31,38,278.1369812711646,0.47139608279959155,0.8141074776980639,0.16159060487019955,1046465.563488269,15212.154566571302,1061677.7180548403,4747,0,597.1052631578947,64,126,33,36.93569594890742,0.5381578947368422,44.0544871794872,8177.252665665016,127.76957290101588,8
4946,32.29943985958816,3,3,190,0.015544041450777202,0.015544041450777202,0.9844559585492227,193,4900,3600,1300,0.7346938775510204,62,36,26,270.6759712828468,0.4721603788860103,0.810812864271734,0.1580421774801329,1059484.9939499225,13855.425959399765,1073340.4199093222,4748,0,588.8082901554404,70,123,36,36.934476075915576,0.5399935233160622,43.86737089201881,8272.94044995151,118.18486357073584,0
4947,31.80313859597339,2,0,192,0.010416666666666666,0.0,1.0,192,5600,4300,1300,0.7678571428571429,69,43,26,260.87673389068,0.47246707297120416,0.8020935827038236,0.15340019369092478,1045355.763804807,10541.799483038918,1055897.5632878458,4749,0,591.5833333333334,63,129,38,36.914727882519706,0.5422634548611112,43.60351562499999,8154.212928098437,129.43195123965774,0
4948,31.556623830785796,1,2,191,0.0051813471502590676,0.010362694300518135,0.9896373056994818,193,5700,3700,2000,0.6491228070175439,77,37,40,239.74781367296407,0.4723177982872769,0.7946765929678665,0.1404868767558091,1036203.9241713206,5385.525067883846,1041589.4492392045,4750,0,589.5129533678756,61,132,41,37.589258397255186,0.5448510362694301,43.73319892473117,8086.915041851045,132.57237773526305,8
4949,31.079663392185996,1,3,189,0.005208333333333333,0.015625,0.984375,192,5550,3900,1650,0.7027027027027027,72,39,33,235.05800318228367,0.4718932927937754,0.7891458125052071,0.13850766873819087,1022196.0935687388,4105.074522999629,1026301.1680917384,4751,0,592.390625,64,128,42,37.49700595684412,0.5470377604166667,43.52564102564102,7971.136745649749,124.54901165077733,0
4950,31.15520557814815,0,1,188,0.0,0.005291005291005291,0.9947089947089947,189,5000,3100,1900,0.62,69,31,38,233.47843109428803,0.47116918083230136,0.7842080192740564,0.13812885246029777,1025869.7779060196,5103.693250508471,1030973.4711565281,4752,1,602.5661375661375,66,123,41,37.3852689930934,0.5484457671957672,43.37686567164178,7995.146506108709,121.13858342588954,0
4951,31.080087195840868,3,6,185,0.015706806282722512,0.031413612565445025,0.9685863874345549,191,5450,3600,1850,0.6605504587155964,73,36,37,227.50623018836723,0.4716600073482135,0.7776924174350999,0.1355655680916241,1025517.0222948369,3012.3023472592613,1028529.3246420962,4753,0,596.6020942408377,74,117,35,37.26672884227218,0.5507198952879582,43.111111111111086,7984.129066309283,107.89363603120653,0
4952,31.029456281844563,1,0,186,0.005376344086021506,0.0,1.0,186,5550,3700,1850,0.6666666666666666,74,37,37,230.01499113706106,0.4706226387678001,0.7752810709799967,0.1371971770664581,1024139.6601380799,4363.494969954361,1028503.1551080343,4754,0,611.1612903225806,73,113,37,37.164648622982,0.5516353046594982,43.07432432432431,7972.264021061714,109.20909617892758,0
4953,30.874057985860194,0,2,184,0.0,0.010752688172043012,0.989247311827957,186,4850,3200,1650,0.6597938144329897,65,32,33,231.5195524957312,0.470694686622106,0.7776883928072087,0.13878256075925563,1020462.7761067624,5201.417052557682,1025664.19315932,4755,1,612.1612903225806,73,113,39,36.93876037959665,0.5531474014336917,42.89132882882882,7937.988022406175,108.73956195076953,0
4954,30.87623970086877,2,2,184,0.010752688172043012,0.010752688172043012,0.989247311827957,186,5750,3700,2050,0.6434782608695652,78,37,41,236.0906449353115,0.47053061125641776,0.7809622568636412,0.1432018137441765,1023965.2470352732,5399.723112781022,1029364.9701480543,4756,0,612.3064516129032,66,120,40,36.37928866083108,0.5558915770609318,42.45957711442789,7951.87982967809,120.48302772239529,0
4955,30.457233916638174,0,2,182,0.0,0.010869565217391304,0.9891304347826086,184,5200,3500,1700,0.6730769230769231,69,35,34,239.32970469025912,0.47002393185237984,0.7807247152378134,0.14551869029214737,1010761.9111537173,6381.0699417164315,1017142.9810954337,4757,1,616.070652173913,67,117,42,36.20550402346692,0.5567821557971014,42.37132352941178,7846.656862898641,117.1142815358006,0
4956,30.266671069166193,0,2,180,0.0,0.01098901098901099,0.989010989010989,182,5650,4100,1550,0.7256637168141593,72,41,31,241.76562092387303,0.469324241596341,0.7788480849047861,0.1474079528718705,1005223.9281798899,6555.717432789368,1011779.6456126793,4758,2,623.3186813186813,68,114,42,36.03951890034366,0.5586652930402931,42.2705314009662,7800.613050917984,114.7148978076174,0
4957,30.432180191877922,0,0,180,0.0,0.0,1.0,180,5550,3800,1750,0.6846846846846847,73,38,35,238.43210624749662,0.46887026691495964,0.772682799895914,0.14586032860699358,1011668.3335311458,6692.842317545437,1018361.1758486913,4759,3,630.0833333333334,68,112,41,36.00178083528493,0.5599537037037037,42.1497584541063,7846.945013243923,115.39625019476358,0
4958,30.672742757090397,0,3,177,0.0,0.016666666666666666,0.9833333333333333,180,5600,3500,2100,0.625,77,35,42,238.84636107794316,0.4686277932960894,0.7742766559360048,0.14641873265219532,1020262.5259465828,7137.19833330672,1027399.7242798895,4760,4,631.0833333333334,68,112,36,35.91381328650866,0.5612847222222221,42.074275362318865,7911.2894022477785,116.34249120952616,0
4959,30.94109456144386,0,0,177,0.0,0.0,1.0,177,5200,3900,1300,0.75,65,39,26,244.40160618240446,0.46804646036637565,0.7752598594984152,0.15011713535098736,1029752.1608648621,9734.616417035073,1039486.7772818973,4761,5,641.9604519774011,67,110,37,35.69820488461389,0.5622645951035782,42.00367647058825,7982.688642828429,119.14460660937954,0
4960,30.550297799295972,2,1,178,0.0111731843575419,0.00558659217877095,0.994413407821229,179,5500,4100,1400,0.7454545454545455,69,41,28,238.65320245745292,0.4685610340426422,0.772628515093188,0.14760774996069123,1018719.0659507276,7324.113498721457,1026043.1794494491,4762,0,635.7765363128492,71,108,40,35.590336134453786,0.5643040037243947,41.753472222222236,7889.508329245298,111.11983562317322,0
4961,31.0641109549082,0,2,176,0.0,0.011235955056179775,0.9887640449438202,178,5650,3900,1750,0.6902654867256637,74,39,35,204.6117296756994,0.4679174866163059,0.741967546011143,0.12776062114692832,1038583.3122600262,1251.265586768599,1039834.5778467949,4763,1,640.0955056179776,73,105,43,36.12230085283978,0.5726825842696629,41.41328828828832,8032.766304077547,110.03789457640475,8
4962,31.114761314790286,1,0,177,0.005649717514124294,0.0,1.0,177,6450,4700,1750,0.7286821705426356,82,47,35,199.43858958711348,0.46821766392740966,0.7419428299397277,0.11963892063081086,1028632.5788426283,-820.1938544544628,1027812.3849881738,4764,0,643.4689265536723,79,98,40,37.73631085004388,0.5587335216572504,42.864583333333314,8000.707115162431,101.27477360965104,8
4963,31.26714947693818,4,0,181,0.022099447513812154,0.0,1.0,181,5550,3700,1850,0.6666666666666666,74,37,37,191.23725671595093,0.4679621956210354,0.7369266097054654,0.11580297576637578,1036440.6454992427,-2108.7868411630147,1034331.8586580796,4765,0,630.2265193370166,71,110,45,37.59628261317448,0.56146408839779,42.52025462962963,8050.657685779362,113.38954487013186,0
4964,31.605290462498946,0,1,180,0.0,0.0055248618784530384,0.994475138121547,181,5550,3900,1650,0.7027027027027027,72,39,33,206.76653548889678,0.46783686310620015,0.7511215317034097,0.12187544241536713,1039578.9949167485,1240.0294291930318,1040819.0243459415,4766,1,631.2265193370166,74,107,39,38.21061442934245,0.5495511049723757,43.513888888888886,8106.318041263432,109.54483839545178,8
4965,31.80429610419218,0,3,177,0.0,0.016666666666666666,0.9833333333333333,180,4600,3100,1500,0.6739130434782609,61,31,30,208.00387913641762,0.4672841661493896,0.7520284573380489,0.12301791520244688,1047144.7189423009,2962.0327114423476,1050106.7516537432,4767,2,635.7277777777778,74,106,43,38.05127823482715,0.5508680555555556,43.38888888888888,8161.335761403513,110.28832110004747,0
4966,31.457400332815215,0,2,175,0.0,0.011299435028248588,0.9887005649717514,177,5700,4200,1500,0.7368421052631579,72,42,30,205.45882900172646,0.4669256120527307,0.7452638567552243,0.12183174643692286,1036508.2610228865,1491.9547120752745,1038000.2157349618,4768,3,645.7627118644068,74,103,41,38.017367310501534,0.552436440677966,43.29166666666664,8075.376810436381,109.12671365454568,0
4967,31.626025332685938,1,0,176,0.005681818181818182,0.0,1.0,176,5700,4100,1600,0.7192982456140351,73,41,32,211.37131592982024,0.4667207792207792,0.7502393100213487,0.1261718031040533,1044055.4619512131,3236.6753792685035,1047292.1373304815,4769,0,650.1988636363636,76,100,38,37.61527763153276,0.5543323863636364,43.04653679653677,8126.416736594047,106.92653600781641,0
4968,31.707042079318597,0,0,176,0.0,0.0,1.0,176,6200,5100,1100,0.8225806451612904,73,51,22,208.29920142705058,0.46629531926406925,0.7468530840825174,0.12472362503138029,1047659.407272956,2245.3235804983588,1049904.7308534544,4770,1,651.1988636363636,78,98,41,37.57779373546707,0.5559303977272727,42.93248945147676,8150.850374187626,104.49808172035418,0
4969,32.03359905155026,3,1,178,0.01675977653631285,0.00558659217877095,0.994413407821229,179,5850,4800,1050,0.8205128205128205,69,48,21,208.91020808181415,0.46615351620530204,0.751914491104974,0.1263615105553811,1061505.6947739264,2701.8751150505223,1064207.5698889769,4771,0,641.268156424581,70,109,42,37.183469159020525,0.5587174115456238,42.56161971830987,8246.677854424213,117.80968363463163,0
4970,31.73238288919542,2,2,178,0.011111111111111112,0.011111111111111112,0.9888888888888889,180,5800,4200,1600,0.7241379310344828,74,42,32,208.85721651927904,0.4661267587419822,0.7526193770786307,0.12728887882939266,1053776.7013422344,2217.7737350412294,1055994.4750772757,4772,0,638.3666666666667,73,107,41,36.90349391886971,0.5612847222222221,42.28603603603603,8177.878180396802,112.02572849858633,0
4971,31.31698491080132,0,1,177,0.0,0.0056179775280898875,0.9943820224719101,178,4850,3500,1350,0.7216494845360825,62,35,27,210.82029819755456,0.4656864300979708,0.75131339701765,0.1288846656136988,1040891.1392676505,3438.1960743197988,1044329.3353419703,4773,1,645.8483146067416,73,105,45,36.73791584771056,0.5625,42.17342342342343,8074.351008252226,110.60754805824968,0
4972,31.262945302926948,0,0,177,0.0,0.0,1.0,177,5700,3800,1900,0.6666666666666666,76,38,38,212.36693450481445,0.46525370227700735,0.7531188988531687,0.130387554443233,1040344.9533760917,3086.9737152069724,1043431.9270912986,4774,2,638.6440677966102,76,101,38,36.53972207656004,0.5640889830508475,42.01839826839827,8065.26470409656,106.12190400127054,0
4973,30.945876110545925,1,1,177,0.0056179775280898875,0.0056179775280898875,0.9943820224719101,178,5050,3600,1450,0.7128712871287128,65,36,29,208.6191112233403,0.46531414651177555,0.7503341774418462,0.1288292854701846,1031459.0064142542,2386.4122362903963,1033845.4186505446,4775,0,636.0505617977528,79,99,42,36.42355682754216,0.5659527153558053,41.80989583333334,7989.918976510639,101.13821489253974,0
4974,30.98337791988421,0,1,176,0.0,0.005649717514124294,0.9943502824858758,177,5550,4100,1450,0.7387387387387387,70,41,29,209.97437864022356,0.4649326956000685,0.7505620987831876,0.13024054684078384,1033979.5203835343,2471.8414638498466,1036451.3618473841,4776,1,640.6271186440678,66,111,42,36.22645483540953,0.5676789077212806,41.65111940298508,8004.521002716367,121.28062125327828,0
4975,31.075262202507677,0,1,175,0.0,0.005681818181818182,0.9943181818181818,176,6000,4400,1600,0.7333333333333333,76,44,32,214.1281642371015,0.4644724025974026,0.7535841232227489,0.1336717238284866,1038889.6011433752,3291.104627569175,1042180.7057709444,4777,2,644.6022727272727,67,109,42,35.88467614533967,0.5693655303030303,41.42156862745099,8035.392554815111,119.93123216141957,0
4976,30.916566784943083,0,1,174,0.0,0.005714285714285714,0.9942857142857143,175,5900,4300,1600,0.7288135593220338,75,43,32,213.82071492318704,0.4639094143404488,0.7513550289148432,0.13421244732438342,1035144.0206967313,3367.0469107674803,1038511.0676074987,4778,3,641.7142857142857,70,105,44,35.69341289639794,0.5711309523809525,41.22652582159625,8000.387396608368,114.29124852297669,0
4977,31.287449505485228,2,1,175,0.011363636363636364,0.005681818181818182,0.9943181818181818,176,5450,4100,1350,0.7522935779816514,68,41,27,198.35740118894614,0.4637878787878788,0.738164676796591,0.12324078534124121,1044611.5413914389,791.2861204770529,1045402.8275119159,4779,0,637.3522727272727,68,108,42,36.46545344783936,0.5712594696969697,41.59118357487923,8084.95279567318,118.89636464225265,8
4978,31.646708790181894,0,1,174,0.0,0.005714285714285714,0.9942857142857143,175,6000,4400,1600,0.7333333333333333,76,44,32,203.91165775260924,0.4639655172413793,0.7419431012127233,0.12093937142832015,1042808.2519737084,1528.1518756116889,1044336.4038493201,4780,1,640.7314285714285,75,100,41,38.04925253603845,0.5570833333333334,43.28399122807016,8124.216771382996,108.32289028510661,8
4979,31.65714646389521,3,0,177,0.01694915254237288,0.0,1.0,177,4350,2800,1550,0.6436781609195402,59,28,31,219.8989797334589,0.46430004494093474,0.765456536581119,0.1309833053194949,1044444.6948882095,6184.464558788121,1050629.1594469976,4781,0,634.2146892655368,69,108,41,37.47634495809678,0.55420197740113,43.12499999999999,8131.929497913066,117.85405069439227,8
4980,31.769916670790327,2,0,179,0.0111731843575419,0.0,1.0,179,4850,3500,1350,0.7216494845360825,62,35,27,225.97539440201774,0.4647137133052957,0.7739946217431595,0.1291393811287594,1035531.845266818,6150.9434300035655,1041682.7886968215,4782,0,628.1173184357542,63,116,36,38.90807940757742,0.5404445996275605,44.67773437499999,8111.567103103626,128.75503338259725,8
4981,32.23162393074701,2,0,181,0.011049723756906077,0.0,1.0,181,6450,4000,2450,0.6201550387596899,89,40,49,221.94772919376786,0.4650309494577451,0.7719874570703311,0.1278440371783358,1053048.6408284632,4094.350912491959,1057142.9917409553,4783,0,622.1657458563536,67,114,37,38.704592896666085,0.5427601289134438,44.37806372549018,8239.11011844934,122.97179281267671,0
4982,32.19766045334476,3,2,182,0.016304347826086956,0.010869565217391304,0.9891304347826086,184,6700,5000,1700,0.746268656716418,84,50,34,207.57496190814652,0.4653594480082363,0.7629411550864358,0.11815269108388654,1048228.2785670246,17.188998918328252,1048245.4675659429,4784,0,613.0054347826087,82,102,41,39.5326127942816,0.5426856884057971,44.8293172690763,8215.899000218425,100.19389024656617,8
4983,31.86591131415455,1,0,183,0.00546448087431694,0.0,1.0,183,6050,4200,1850,0.6942148760330579,79,42,37,222.9333098044728,0.4643632778878681,0.7759932228031352,0.12707441770425087,1037866.3779271871,3624.997353217602,1041491.3752804047,4785,0,617.2950819672132,63,120,39,39.085583933847786,0.5412682149362478,44.77539062500001,8132.964767533496,129.09467884973805,8
4984,32.34531759059287,4,1,186,0.0213903743315508,0.0053475935828877,0.9946524064171123,187,5750,4000,1750,0.6956521739130435,75,40,35,220.24225504226501,0.46494115730358615,0.777082793385363,0.12744519471164575,1058196.117957669,3461.8998591935315,1061658.0178168626,4786,0,605.0695187165776,70,117,40,38.57112130771438,0.5447303921568627,44.20481220657277,8273.776587323742,118.19680839033917,0
4985,32.05970471755501,2,0,188,0.010638297872340425,0.0,1.0,188,6250,4700,1550,0.752,78,47,31,258.5307724496862,0.4652187156293852,0.8050780151173966,0.14815089836232906,1045832.8240438959,10225.993570661165,1056058.817614557,4787,0,602.8297872340426,61,127,38,37.969685259488266,0.5360704787234043,44.573252688172055,8188.906095782765,134.24436222594696,8
4986,32.16456603092698,8,3,193,0.04081632653061224,0.015306122448979591,0.9846938775510204,196,5900,4400,1500,0.7457627118644068,74,44,30,246.3572757683648,0.46755025728240013,0.8026118228271126,0.14346116187143002,1054240.1290912116,6843.945241720096,1061084.0743329318,4788,0,579.1836734693877,71,125,38,37.659454992371565,0.540125425170068,43.96701388888889,8235.189887866254,115.98858996994724,0
4987,32.47135789270271,0,3,190,0.0,0.015544041450777202,0.9844559585492227,193,5500,4000,1500,0.7272727272727273,70,40,30,255.7404905858365,0.4668114925158319,0.8077980224445891,0.14920474611184364,1064880.2140195963,10366.597669704483,1075246.811689301,4789,1,589.160621761658,70,123,39,37.347115604949586,0.5410729706390328,43.89671361502347,8316.021469703906,118.8003067100558,0
4988,32.78053619845005,2,3,189,0.010416666666666666,0.015625,0.984375,192,5750,4300,1450,0.7478260869565218,72,43,29,250.64302579170854,0.4670752436009307,0.8026147817592468,0.14734355478608901,1077399.437426006,9858.53099654775,1087257.9684225537,4790,0,593.046875,60,132,42,37.18723635717774,0.5432942708333333,43.61338797814208,8404.490616180487,140.0748436030081,0
4989,33.017987994717416,1,2,188,0.005263157894736842,0.010526315789473684,0.9894736842105263,190,6000,4300,1700,0.7166666666666667,77,43,34,249.86615208842608,0.46685289612921194,0.7990518176885515,0.14778668751571541,1087127.4916796004,10327.272635104866,1097454.7643147053,4791,0,599.4368421052632,62,128,44,36.97433419243989,0.5452302631578947,43.386243386243386,8472.86993515235,136.65919250245727,0
4990,32.74555633773103,1,0,189,0.005291005291005291,0.0,1.0,189,6200,4600,1600,0.7419354838709677,78,46,32,253.31841580386208,0.46669903185860634,0.8020248407810369,0.1507006875787586,1079964.5432144997,10714.981442287663,1090679.5246567873,4792,0,603.5343915343915,62,127,42,36.66535226077812,0.546792328042328,43.17129629629629,8409.99878627605,135.64514171412984,0
4991,32.22246654065308,0,0,189,0.0,0.0,1.0,189,5350,3200,2150,0.5981308411214953,75,32,43,253.701195228335,0.4664926451273969,0.8017817252485273,0.1512243076089137,1063311.5128778224,10802.680343430466,1074114.1932212529,4793,1,604.5343915343915,63,126,37,36.58134820070957,0.5478395061728395,43.09895833333333,8277.985219363078,131.39659078354092,0
4992,31.81206457670866,2,1,190,0.010471204188481676,0.005235602094240838,0.9947643979057592,191,6000,4300,1700,0.7166666666666667,77,43,34,243.4394433826788,0.4665897400569487,0.7902828298011628,0.14486540900438244,1049264.6254972809,6886.479278438384,1056151.1047757193,4794,0,599.1937172774869,75,116,42,36.90815278296599,0.550392670157068,43.16063596491227,8170.59043452496,108.94120579366613,8
4993,31.37201089539536,1,0,191,0.005235602094240838,0.0,1.0,191,6700,4700,2000,0.7014925373134329,87,47,40,241.81102940392572,0.46600877192982454,0.7898046629819118,0.14493605037622526,1036889.3075922785,5246.254169362177,1042135.5617616406,4795,0,600.17277486911,77,114,40,36.678223907472805,0.5529013961605584,42.89529914529913,8065.891476470996,104.75183735676619,0
4994,31.478664708239577,0,1,190,0.0,0.005235602094240838,0.9947643979057592,191,5600,3700,1900,0.6607142857142857,75,37,38,242.60522134196046,0.4658089923762285,0.7901809559560853,0.1458888282318914,1041387.3481731513,6729.2016212526405,1048116.549794404,4796,1,601.17277486911,77,114,42,36.534696623574376,0.5541012216404886,42.77510683760682,8097.096166471684,105.15709307106083,0
4995,31.52930930979803,0,0,190,0.0,0.0,1.0,190,6400,4800,1600,0.75,80,48,32,231.75119094709044,0.46545240415854455,0.7840742399252361,0.13481179791859263,1033095.6281887376,3484.2284389947954,1036579.8566277324,4797,2,605.1736842105263,76,114,36,38.07436717222432,0.5449013157894738,44.00703463203465,8071.281386219044,106.20107087130322,8
4996,31.847510992747782,0,0,190,0.0,0.0,1.0,190,7200,5200,2000,0.7222222222222222,92,52,40,222.37141164703098,0.4651489835700362,0.7765715753730658,0.12593919371163637,1035266.426895589,842.7313559102286,1036109.1582514992,4798,3,606.1736842105263,76,114,40,39.35165534804754,0.5325657894736842,45.021645021645035,8120.425963085945,106.84771004060454,8
4997,32.04622218096661,1,2,189,0.005235602094240838,0.010471204188481676,0.9895287958115183,191,6400,5000,1400,0.78125,78,50,28,223.137712076597,0.46483765040874436,0.780324417928216,0.1269169526361603,1043066.8273905596,1949.5090813850793,1045016.3364719447,4799,0,603.9947643979058,78,113,42,39.16440568475457,0.5344677137870855,44.85759493670888,8176.35020044445,104.82500256980065,0
4998,31.64979000307355,5,2,192,0.02577319587628866,0.010309278350515464,0.9896907216494846,194,6100,4500,1600,0.7377049180327869,77,45,32,210.92495883126477,0.4657631581290173,0.7765238205219738,0.1218401821013536,1034907.0941475339,-1242.4527545497185,1033664.6413929842,4800,0,595.5360824742268,61,133,46,38.876866938221326,0.5364583333333333,44.270833333333314,8093.774422660957,132.6848266009993,8
4999,31.722635257467942,0,2,190,0.0,0.010416666666666666,0.9895833333333334,192,5600,3900,1700,0.6964285714285714,73,39,34,209.27731168178752,0.46605096076934266,0.772728636895069,0.12132612775277432,1038394.3887294016,-537.5227722517402,1037856.8659571499,4801,1,602.4166666666666,64,128,42,38.779933400141935,0.5379231770833333,44.134615384615365,8116.724271165559,126.82381673696186,0
5000,31.28724154939304,1,0,191,0.005235602094240838,0.0,1.0,191,6450,4900,1550,0.7596899224806202,80,49,31,222.2962603839141,0.46609603196472854,0.7817919907807538,0.12473170381386468,1014208.7473743988,440.9623579966242,1014649.7097323954,4802,0,604.9947643979058,70,121,40,39.71838087006625,0.525414485165794,45.37852112676057,7966.403713170732,113.80576733101046,8
