period,mktsize,entries,exits,surviv,entryrate,exitrate,survivrate,firms,totresinv,totinninv,totimiinv,costshareinn,firmsres,firmsinn,firmsimi,hindex,div,gini,pcm,cs,totprofits,ts,maxage,minage,avgage,actfirms,inactfirms,profitablefirms,wmc,avgproxopt,price,totoutput,avgoutput,magtechshock
1,4,40,23,17,1.0,0.575,0.42500000000000004,40,0,0,0,0,0,0,0,359.1789324643019,1.0001869658119658,0.1014024591063789,0.15411026358065588,118385.82900732338,904.3391363503561,119290.16814367374,0,0,0.0,38,2,17,47.96538222271016,0.49698464912280693,56.70405982905983,973.1837606837605,25.61009896536212,0
2,4,35,38,14,0.6730769230769231,0.7307692307692307,0.2692307692307693,52,900,800,100,0.8888888888888888,10,8,2,306.6614789250285,1.0044306184012066,-0.07736891075569685,0.1433231999789656,122140.63587120654,-1508.8343933784568,120631.80147782808,1,0,0.3269230769230769,45,7,8,45.29756177647455,0.5261574074074072,52.87590579710147,988.4963768115974,21.966586151368833,0
3,4,36,33,17,0.72,0.66,0.33999999999999997,50,250,100,150,0.4,4,1,3,333.0142608353668,0.9991496598639455,-0.14596045467570962,0.15825357679007943,122854.92643946545,-417.51149635562626,122437.41494310982,2,0,0.48,43,7,14,43.90074266883177,0.5360949612403102,52.15435606060605,991.3825757575738,23.055408738548227,0
4,4,28,30,15,0.6222222222222222,0.6666666666666666,0.33333333333333337,45,550,500,50,0.9090909090909091,6,5,1,332.442975050494,0.9885942760942762,-0.12272084232009084,0.16436886413487276,124531.68945312503,479.9370659722233,125011.62651909725,3,0,0.7777777777777778,39,6,12,42.173258888193146,0.5592948717948718,50.46875,998.1250000000002,25.592948717948723,0
5,4,31,29,17,0.6739130434782609,0.6304347826086957,0.3695652173913043,46,500,400,100,0.8,6,4,2,368.06653163256055,0.9940821256038648,-0.29674116302315234,0.18057705553543496,124206.3077701794,1743.2369815712693,125949.54475175067,4,0,0.8260869565217391,37,9,14,41.62255252447476,0.559403153153153,50.794956140350884,996.8201754385974,26.941085822664796,0
6,4,20,19,18,0.5405405405405406,0.5135135135135135,0.4864864864864865,37,800,700,100,0.875,9,7,2,366.63153121463444,0.9859234234234234,-0.19199715348919977,0.1827144016960849,124862.97616814783,1755.7408289088867,126618.71699705672,5,0,1.4864864864864864,37,0,17,40.976298226366794,0.5661599099099099,50.13706140350877,999.4517543859644,27.012209577999037,0
7,4,18,14,22,0.5,0.3888888888888889,0.6111111111111112,36,400,200,200,0.5,6,2,4,362.15806085090304,0.9815476190476191,-0.1891573033707865,0.18355391466816803,125563.69714308891,1894.7810141222194,127458.47815721112,6,0,1.75,36,0,22,40.3625936329588,0.5752314814814816,49.43693693693693,1002.2522522522513,27.840340340340315,0
8,4,10,9,23,0.3125,0.28125,0.71875,32,900,700,200,0.7777777777777778,11,7,4,349.9665189285583,0.9685399865591399,-0.12769091766184748,0.17972780232903068,126107.23913695053,2426.662298489983,128533.90143544052,7,0,2.53125,32,0,23,40.10737481667715,0.5895182291666665,48.895202020202035,1004.4191919191937,31.388099747474804,0
9,4,6,3,26,0.20689655172413793,0.10344827586206896,0.896551724137931,29,950,700,250,0.7368421052631579,12,7,5,366.0241395644436,0.9561781609195402,-0.03537668562299101,0.19123970173784904,126812.07561728393,3483.256172839504,130295.33179012344,8,0,3.586206896551724,29,0,21,38.977753263467555,0.6048850574712643,48.19444444444444,1007.2222222222222,34.73180076628352,0
10,4,1,1,26,0.037037037037037035,0.037037037037037035,0.962962962962963,27,800,600,200,0.75,10,6,4,386.9244423036573,0.9507359924026592,-0.010430190581055765,0.200767164575213,126529.95068470087,4391.506120677422,130921.4568053783,9,0,4.777777777777778,27,0,22,38.74257383030123,0.6084104938271606,48.47470238095237,1006.1011904761898,37.26300705467369,0
11,4,2,4,24,0.07142857142857142,0.14285714285714285,0.8571428571428572,28,900,700,200,0.7777777777777778,11,7,4,377.64571245682214,0.9475859788359788,0.0013280280056171545,0.19885185714436865,127128.23533904733,4001.8866015986114,131130.12194064594,10,0,5.392857142857143,28,0,23,38.359571638884944,0.6112351190476191,47.88074712643677,1008.477011494252,36.017036124794714,0
12,4,6,5,25,0.2,0.16666666666666666,0.8333333333333334,30,1050,600,450,0.5714285714285714,15,6,9,357.1990045349167,0.9464080459770116,-0.03363447145830556,0.19190841592678928,127940.47948100934,3140.0423820672945,131080.52186307663,11,0,5.366666666666666,30,0,21,38.04221469376912,0.6135416666666667,47.07661290322581,1011.6935483870966,33.72311827956989,0
13,4,5,6,24,0.16666666666666666,0.2,0.8,30,800,400,400,0.5,12,4,8,375.76952930819056,0.9501915708812261,-0.0389468056669342,0.19443344524784786,126415.27380332984,3500.6015868886525,129915.87539021848,12,0,5.866666666666666,30,0,14,39.141439454691266,0.5979166666666667,48.58870967741935,1005.6451612903223,33.52150537634408,4
14,4,7,9,22,0.22580645161290322,0.2903225806451613,0.7096774193548387,31,500,300,200,0.6,7,3,4,368.6964147346823,0.9558243727598567,-0.07024162250135613,0.19179160739563209,126632.9023573133,3137.8194173176976,129770.721774631,13,0,6.064516129032258,31,0,14,39.094976282880545,0.5974462365591398,48.37239583333333,1006.5104166666661,32.46807795698923,0
15,4,6,5,23,0.21428571428571427,0.17857142857142858,0.8214285714285714,28,650,500,150,0.7692307692307693,8,5,3,412.07217086725706,0.9505070546737213,-0.05091250561384897,0.2129749668928408,126368.66866494915,4814.602325274145,131183.2709902233,14,0,7.178571428571429,28,0,15,38.277007716490424,0.6034226190476191,48.63505747126437,1005.4597701149426,35.90927750410509,0
16,4,0,0,23,0.0,0.0,1.0,23,550,300,250,0.5454545454545454,8,3,5,476.5451148467157,0.9369235836627141,0.0372606208596169,0.24052395166672813,125390.93017578124,7350.887044270833,132741.81722005206,15,1,9.73913043478261,23,0,21,37.677132085283425,0.6127717391304348,49.609375,1001.5624999999999,43.54619565217391,0
17,4,8,8,23,0.25806451612903225,0.25806451612903225,0.7419354838709677,31,850,800,50,0.9411764705882353,9,8,1,379.5313873861964,0.9482974910394265,-0.06688094326111216,0.20031397748421315,127223.34120008684,3457.050238715281,130680.39143880212,16,0,7.967741935483871,31,0,17,38.21416279469971,0.603494623655914,47.786458333333336,1008.854166666667,32.543682795698935,0
18,4,7,5,25,0.23333333333333334,0.16666666666666666,0.8333333333333334,30,650,500,150,0.7692307692307693,8,5,3,380.55604014579166,0.9436302681992338,-0.03204667465282407,0.20205777594454663,127464.99098522961,3701.51444531161,131166.50543054123,17,0,8.566666666666666,30,0,17,37.93979324726031,0.6086805555555554,47.547043010752695,1009.8118279569901,33.660394265233,0
19,4,5,4,26,0.16666666666666666,0.13333333333333333,0.8666666666666667,30,800,400,400,0.5,12,4,8,373.6233656533339,0.939176245210728,-0.03652227832403232,0.20056272823872956,127906.4866603074,3557.7704069834504,131464.25706729086,18,0,9.1,30,0,19,37.661661794667395,0.6131944444444445,47.11021505376343,1011.559139784945,33.7186379928315,0
20,4,1,2,25,0.037037037037037035,0.07407407407407407,0.9259259259259259,27,950,700,250,0.7368421052631579,12,7,5,420.56407834214883,0.9343542260208927,-0.0030781746424368706,0.21370744795395166,125670.5397002551,5170.502940759643,130841.04264101475,19,0,11.074074074074074,27,0,19,38.78809241120017,0.599537037037037,49.330357142857146,1002.6785714285714,37.136243386243386,6
21,4,3,1,27,0.10714285714285714,0.03571428571428571,0.9642857142857143,28,750,700,50,0.9333333333333333,8,7,1,400.0020070162351,0.9409171075837742,0.03224588892969393,0.20746770763908717,126513.17256242565,4521.104587792308,131034.27715021795,20,0,11.428571428571429,28,0,20,38.43098400457013,0.6049107142857143,48.491379310344826,1006.0344827586205,35.92980295566502,0
22,4,1,2,26,0.03571428571428571,0.07142857142857142,0.9285714285714286,28,750,400,350,0.5333333333333333,11,4,7,421.2646462211177,0.9371693121693121,0.0229628563201838,0.20811552152573864,124497.63220042287,4889.290196855601,129386.92239727847,21,0,12.392857142857142,28,0,18,39.99244169306074,0.5840773809523809,50.502873563218394,997.9885057471272,35.64244663382597,8
23,4,11,7,30,0.2972972972972973,0.1891891891891892,0.8108108108108107,37,650,600,50,0.9230769230769231,7,6,1,345.2892025062272,0.9507632632632632,0.03742807226116418,0.1820338662064907,127177.19144397782,1409.3360665816633,128586.52751055948,22,0,9.621621621621621,36,1,19,39.12512560008934,0.591724537037037,47.83220720720721,1008.6711711711716,28.018643643643657,0
24,4,4,2,32,0.11764705882352941,0.058823529411764705,0.9411764705882353,34,800,500,300,0.625,11,5,6,366.8558611232502,0.9523544266191326,0.059327241160037625,0.1937347212718228,127246.5236477557,2536.226601547486,129782.7502493032,23,0,10.911764705882353,33,1,22,38.51003583141017,0.598800505050505,47.763480392156865,1008.9460784313727,30.574123588829476,0
25,4,2,3,31,0.058823529411764705,0.08823529411764706,0.9117647058823529,34,550,300,250,0.5454545454545454,8,3,5,367.46007353258574,0.9495692216280452,0.061037625346399116,0.19449878956390595,127339.27455786234,2558.4198385236455,129897.694396386,24,0,11.852941176470589,33,1,14,38.3995062327991,0.5997474747474747,47.67156862745098,1009.313725490196,30.58526440879382,0
26,4,1,2,30,0.03125,0.0625,0.9375,32,950,600,350,0.631578947368421,13,6,7,387.6866658946734,0.9448924731182796,0.06509004647560035,0.20428713700817291,127157.6690673829,3459.4665527343905,130617.13562011729,25,0,13.40625,31,1,24,38.076103795507365,0.6028225806451613,47.85156250000001,1008.5937500000007,32.53528225806454,0
27,4,2,4,28,0.0625,0.125,0.875,32,550,300,250,0.5454545454545454,8,3,5,416.26075770964536,0.9458585349462366,-0.005589464882942874,0.2141465357109153,126178.84157489309,4120.953036054801,130299.79461094788,26,0,13.375,30,2,19,38.36845039018953,0.595486111111111,48.8239247311828,1004.7043010752691,33.490143369175634,7
28,4,6,7,27,0.17647058823529413,0.20588235294117646,0.7941176470588236,34,750,500,250,0.6666666666666666,10,5,5,385.21958882589973,0.9513517528223411,-0.005833738454059434,0.20265900107797352,127092.01388888895,2991.666666666674,130083.68055555562,27,0,12.911764705882353,32,2,20,38.20592286501376,0.599609375,47.91666666666667,1008.3333333333339,31.510416666666686,0
29,4,1,1,27,0.03571428571428571,0.03571428571428571,0.9642857142857143,28,750,600,150,0.8,9,6,3,438.45252316245995,0.9365630511463844,0.05020592810042279,0.2278206297643347,126586.7942434461,5500.459867017218,132087.2541104633,28,0,15.642857142857142,26,2,21,37.3875428104074,0.6125801282051282,48.41820987654321,1006.327160493827,38.70489078822412,0
30,4,2,3,26,0.06896551724137931,0.10344827586206896,0.896551724137931,29,1300,900,400,0.6923076923076923,17,9,8,412.61598697080234,0.9405788177339901,0.020304767889404163,0.21823905816889444,127309.42000264241,4705.980397014147,132015.40039965656,29,0,15.344827586206897,28,1,21,37.29089550113897,0.613095238095238,47.70114942528736,1009.1954022988509,36.042692939244674,0
31,4,3,3,26,0.10344827586206896,0.10344827586206896,0.896551724137931,29,550,400,150,0.7272727272727273,7,4,3,409.8715320846039,0.9386288998357963,0.027203610143719192,0.21795740321896878,127527.01190712122,4653.938350508666,132180.95025762988,30,0,16.0,28,1,20,37.135787102892365,0.6153273809523809,47.48563218390805,1010.0574712643684,36.07348111658458,0
32,4,2,2,26,0.07142857142857142,0.07142857142857142,0.9285714285714286,28,650,400,250,0.6153846153846154,9,4,5,418.3810065086932,0.9313822751322751,0.03169340238305707,0.22215442176588363,127467.41470025509,5065.9890518707425,132533.40375212583,31,0,17.142857142857142,27,1,20,36.982390215148826,0.6180555555555556,47.544642857142854,1009.8214285714284,37.400793650793645,0
33,4,4,5,25,0.13333333333333333,0.16666666666666666,0.8333333333333334,30,950,400,550,0.42105263157894735,15,4,11,394.0794933021728,0.9386973180076629,0.02071330589849074,0.21280292638317325,128144.53125000001,4101.620075113378,132246.1513251134,32,0,16.866666666666667,28,2,21,36.899862825788745,0.6216517857142857,46.875,1012.5000000000001,36.16071428571429,0
34,4,0,0,25,0.0,0.0,1.0,25,950,600,350,0.631578947368421,13,6,7,442.04775577572474,0.9247222222222222,0.03071939018580272,0.23371744064817288,127294.08399593196,6254.012830785664,133548.0968267176,33,1,19.76,25,0,22,36.56420385368693,0.6237499999999999,47.71634615384615,1009.1346153846155,40.36538461538462,0
35,4,2,2,25,0.07407407407407407,0.07407407407407407,0.9259259259259259,27,900,600,300,0.6666666666666666,12,6,6,419.9519081088605,0.9311490978157645,-0.002441882647916227,0.22486786568949602,127805.74876434942,5334.453612174026,133140.20237652346,34,0,19.22222222222222,27,0,21,36.593849644346335,0.6215277777777778,47.20982142857142,1011.1607142857138,37.45039682539681,0
36,4,4,3,26,0.13793103448275862,0.10344827586206896,0.896551724137931,29,750,500,250,0.6666666666666666,10,5,5,391.9866129379714,0.9339080459770115,-0.005951003405296307,0.21373370134877742,128531.54176311729,4276.528742283955,132808.07050540124,35,0,18.75862068965517,29,0,20,36.555922704652325,0.6224856321839081,46.49305555555556,1014.0277777777778,34.96647509578544,0
37,4,2,1,27,0.07142857142857142,0.03571428571428571,0.9642857142857143,28,1100,700,400,0.6363636363636364,15,7,8,398.98694707921845,0.9248236331569665,0.01702222402137399,0.21762363775000956,128544.89736094596,4657.547232131062,133202.44459307703,36,0,20.357142857142858,28,0,21,36.36476338906205,0.6257440476190477,46.479885057471265,1014.080459770115,36.21715927750411,0
38,4,2,2,27,0.06896551724137931,0.06896551724137931,0.9310344827586207,29,750,500,250,0.6666666666666666,10,5,5,388.5013813808062,0.9290845648604269,0.012450011318192233,0.21390979673617896,128919.13580246919,4217.05246913581,133136.188271605,37,0,20.586206896551722,29,0,21,36.24749270605397,0.6264367816091954,46.111111111111114,1015.555555555556,35.01915708812262,0
39,4,0,0,27,0.0,0.0,1.0,27,750,600,150,0.8,9,6,3,410.3090766823164,0.9217711301044634,0.03955833768040384,0.22409188034188038,128596.93877551012,5152.8982426303755,133749.8370181405,38,2,23.11111111111111,27,0,21,36.024305555555564,0.6296296296296295,46.42857142857142,1014.2857142857135,37.56613756613754,0
40,4,1,1,27,0.03571428571428571,0.03571428571428571,0.9642857142857143,28,850,600,250,0.7058823529411765,11,6,5,398.00839721864895,0.9239969135802468,0.026526713699488447,0.218889131762194,128872.93411035147,4658.501990025112,133531.4361003766,39,0,23.25,28,0,22,36.053429083533814,0.6290922619047619,46.156609195402304,1015.3735632183912,36.26334154351397,0
41,4,1,0,28,0.03571428571428571,0.0,1.0,28,1050,700,350,0.6666666666666666,14,7,7,401.87244813635016,0.9201388888888888,0.0530948009764558,0.22389133007501918,129384.04439572593,4799.176534218514,134183.22092994445,40,0,24.214285714285715,28,0,24,35.43226003860095,0.6343005952380952,45.6537356321839,1017.3850574712638,36.335180623973706,0
42,4,0,2,26,0.0,0.07142857142857142,0.9285714285714286,28,950,600,350,0.631578947368421,13,6,7,446.0889385339933,0.9179343033509699,0.028649921507064136,0.2387887847446671,127793.2098765432,5818.89695817002,133612.10683471322,41,1,25.214285714285715,26,2,19,35.946085164835154,0.625,47.22222222222222,1011.1111111111111,38.888888888888886,8
43,4,1,1,26,0.037037037037037035,0.037037037037037035,0.962962962962963,27,1300,1100,200,0.8461538461538461,15,11,4,445.56216023980073,0.9151234567901235,0.0204237158969669,0.24060356652949247,128144.53125,6019.270833333333,134163.80208333334,42,0,25.555555555555557,26,1,20,35.59670781893004,0.6286057692307692,46.875,1012.5,38.94230769230769,0
44,4,3,2,27,0.10344827586206896,0.06896551724137931,0.9310344827586207,29,1000,500,500,0.5,15,5,10,413.1146699238346,0.9170771756978653,0.0031401154626307104,0.22824585513291865,129055.35737878192,4862.932273087601,133918.2896518695,43,0,24.0,28,1,19,35.482949189291105,0.6309523809523809,45.97701149425288,1016.0919540229888,36.288998357963884,0
45,4,1,0,28,0.03571428571428571,0.0,1.0,28,650,400,250,0.6153846153846154,9,4,5,424.7817165538085,0.9123126102292769,0.015282197286886623,0.23376697046477324,128898.98667800451,5350.786564625846,134249.77324263036,44,0,25.785714285714285,27,1,20,35.347059398202425,0.632716049382716,46.13095238095238,1015.4761904761903,37.610229276895936,0
46,4,1,2,27,0.034482758620689655,0.06896551724137931,0.9310344827586207,29,1150,900,250,0.782608695652174,14,9,5,412.9412029117605,0.9108169129720853,0.006579748994760548,0.22878300787789396,129164.87327008195,4867.499628418551,134032.3728985005,45,0,25.862068965517242,28,1,20,35.37514723203768,0.6320684523809523,45.86925287356322,1016.5229885057474,36.304392446633834,0
47,4,1,0,28,0.03571428571428571,0.0,1.0,28,850,400,450,0.47058823529411764,13,4,9,419.7918692971587,0.9053681657848324,0.02754445349881962,0.23391336677951685,129390.57019292082,5263.42186614228,134653.9920590631,46,0,27.071428571428573,27,1,21,34.969802788747515,0.6377314814814815,45.64732142857142,1017.4107142857134,37.681878306878275,0
48,4,0,1,27,0.0,0.03571428571428571,0.9642857142857143,28,1000,700,300,0.7,13,7,6,421.93584479884856,0.9040454144620811,0.02971925720134516,0.2355607544962713,129466.28146701376,5325.292968749982,134791.57443576373,47,1,28.071428571428573,27,1,19,34.837726032070954,0.6385030864197532,45.57291666666666,1017.7083333333322,37.69290123456786,0
49,4,2,2,27,0.06896551724137931,0.06896551724137931,0.9310344827586207,29,900,500,400,0.5555555555555556,13,5,8,395.6065100029159,0.8986042692939245,-0.008166598611678566,0.22478894269075214,130156.27170138895,4498.13368055556,134654.4053819445,48,0,26.551724137931036,29,0,20,34.8037464271131,0.6390086206896551,44.895833333333336,1020.4166666666672,35.18678160919542,0
50,4,1,3,25,0.03571428571428571,0.10714285714285714,0.8928571428571429,28,650,500,150,0.7692307692307693,8,5,3,402.33236151603484,0.8936838624338623,0.005102040816326481,0.22923588039867115,130262.58680555563,4881.770833333344,135144.357638889,49,0,27.892857142857142,28,0,21,34.523809523809526,0.6432291666666666,44.79166666666667,1020.833333333334,36.45833333333336,0
51,4,0,0,25,0.0,0.0,1.0,25,750,600,150,0.8,9,6,3,439.7063103147908,0.8880555555555556,0.026826045926391817,0.24740289566207438,129772.26382725184,6412.336661735701,136184.60048898755,50,1,30.4,25,0,21,34.0719041627346,0.6491666666666667,45.2724358974359,1018.9102564102567,40.75641025641027,0
52,4,0,0,25,0.0,0.0,1.0,25,750,600,150,0.8,9,6,3,438.11984490986583,0.8865277777777778,0.02713612071675575,0.24754160331408248,129935.60209155173,6385.473167324147,136321.07525887588,51,2,31.4,25,0,22,33.945038247930405,0.6508333333333333,45.112179487179496,1019.551282051283,40.78205128205132,0
53,4,1,1,25,0.038461538461538464,0.038461538461538464,0.9615384615384616,26,650,400,250,0.6153846153846154,9,4,5,424.96974968291227,0.8896153846153846,0.011932730106301248,0.24188897800368175,130223.20578036885,5868.184632677945,136091.39041304679,52,0,31.153846153846153,26,0,22,33.98630430400162,0.6498397435897436,44.83024691358025,1020.6790123456791,39.256885090218425,0
54,4,1,1,25,0.038461538461538464,0.038461538461538464,0.9615384615384616,26,850,600,250,0.7058823529411765,11,6,5,427.6547447898968,0.8907051282051281,0.012084258495018929,0.2441580195232741,130341.36671715438,5948.220783798203,136289.5875009526,53,0,32.11538461538461,26,0,22,33.797100901717805,0.6510416666666666,44.714506172839506,1021.1419753086418,39.27469135802468,0
55,4,1,1,25,0.038461538461538464,0.038461538461538464,0.9615384615384616,26,550,200,350,0.36363636363636365,9,2,7,427.3024447460112,0.8907692307692308,0.014436153148755126,0.24420445417349756,130380.7656035665,5942.403978052124,136323.16958161863,54,0,33.07692307692308,26,0,22,33.765865820489566,0.6514423076923077,44.675925925925924,1021.2962962962961,39.280626780626775,0
56,4,1,1,25,0.038461538461538464,0.038461538461538464,0.9615384615384616,26,800,600,200,0.75,10,6,4,429.09237588003964,0.8864102564102564,0.014741072880608108,0.24622614498072973,130538.42068663315,6002.608215211101,136541.02890184426,55,0,34.03846153846154,26,0,21,33.55922178596599,0.6530448717948718,44.52160493827161,1021.9135802469136,39.30436847103514,0
57,4,0,0,25,0.0,0.0,1.0,25,1050,800,250,0.7619047619047619,13,8,5,442.39573116879654,0.8809722222222223,0.04175658720200781,0.25366143722412293,130508.0950032873,6547.244822485208,137055.3398257725,56,7,36.4,25,0,21,33.25033981597658,0.6566666666666667,44.55128205128205,1021.7948717948716,40.87179487179486,0
58,4,0,0,25,0.0,0.0,1.0,25,650,400,250,0.6153846153846154,9,4,5,441.09329481207186,0.8791666666666667,0.04010659978052944,0.2537181359428501,130630.9357792982,6524.085973454966,137155.02175275318,57,8,37.4,25,0,21,33.15811647593665,0.6579166666666667,44.431089743589745,1022.2756410256414,40.89102564102566,0
59,4,1,1,25,0.038461538461538464,0.038461538461538464,0.9615384615384616,26,550,400,150,0.7272727272727273,7,4,3,429.6634333354723,0.8772435897435897,0.0280157672019008,0.2498524873077001,131051.45759506933,6061.603842783103,137113.06143785242,58,0,36.92307692307692,26,0,21,33.02153981411705,0.6582532051282051,44.020061728395056,1023.9197530864195,39.38152896486229,0
60,4,0,2,23,0.0,0.08,0.92,25,800,500,300,0.625,11,5,6,442.1305126280441,0.8751388888888889,0.042010333489901575,0.25648388593599597,130958.793685281,6580.175717044703,137538.9694023257,59,10,39.4,25,0,21,32.79692474296749,0.6612500000000001,44.11057692307692,1023.5576923076917,40.942307692307665,0
61,4,1,0,24,0.041666666666666664,0.0,1.0,24,700,300,400,0.42857142857142855,11,3,8,468.41156016056885,0.8703955314009661,-0.004276838013904882,0.2567198910727007,128735.83680555559,7260.270833333343,135996.10763888893,60,0,39.25,24,0,20,34.407675042426234,0.6427951388888888,46.29166666666667,1014.8333333333337,42.284722222222236,7
62,4,2,1,25,0.07692307692307693,0.038461538461538464,0.9615384615384616,26,900,800,100,0.8888888888888888,10,8,2,438.17294697637806,0.8803846153846154,-0.016566556868824023,0.24500656330932705,129527.44904667989,6151.925090401061,135679.37413708094,61,0,37.15384615384615,25,1,20,34.36188077246012,0.6466666666666667,45.51282051282052,1017.9487179487186,40.717948717948744,0
63,4,0,0,25,0.0,0.0,1.0,25,800,500,300,0.625,11,5,6,453.3430963471311,0.8758333333333334,-0.008076040642412075,0.25193985190438933,129286.12499999999,6722.194444444444,136008.31944444444,62,1,39.64,24,1,21,34.2237517753742,0.6484375,45.75,1016.9999999999999,42.37499999999999,0
64,4,0,1,24,0.0,0.04,0.96,25,850,600,250,0.7058823529411765,11,6,5,455.19762373757845,0.8729166666666667,-0.010988867059593899,0.2546105389916785,129540.49999999999,6793.305555555557,136333.80555555553,63,2,40.64,24,1,20,33.915220475878634,0.6510416666666666,45.5,1017.9999999999999,42.416666666666664,0
65,4,1,1,24,0.04,0.04,0.96,25,1150,900,250,0.782608695652174,14,9,5,439.77750416428233,0.8716666666666667,-0.0503410341034104,0.24873815635531812,129976.45270894973,6432.143994493758,136408.59670344347,64,0,39.2,25,0,20,33.86096050081199,0.6512499999999999,45.07211538461539,1019.7115384615387,40.78846153846155,0
66,4,2,2,24,0.07692307692307693,0.07692307692307693,0.9230769230769231,26,550,300,250,0.5454545454545454,8,3,5,432.61016428968435,0.8773717948717948,-0.025413027465011284,0.2377729549592173,128848.62075617278,5948.244598765421,134796.8653549382,65,0,38.61538461538461,26,0,21,35.2000683994528,0.6358173076923077,46.18055555555555,1015.2777777777773,39.04914529914528,5
67,4,0,0,24,0.0,0.0,1.0,24,800,600,200,0.75,10,6,4,464.28242604847077,0.8692632850241545,0.0020545693622617822,0.25310880645868244,128524.49999999999,7134.333333333332,135658.8333333333,66,1,42.625,24,0,21,34.73044049967127,0.640625,46.5,1013.9999999999999,42.24999999999999,0
68,4,1,1,24,0.04,0.04,0.96,25,350,200,150,0.5714285714285714,5,2,3,451.88050251387745,0.8709722222222223,-0.015103393843725277,0.24827953021903001,128835.06238186233,6643.610546104548,135478.67292796687,67,0,41.88,25,0,21,34.7249079189687,0.6395833333333333,46.19391025641026,1015.2243589743596,40.608974358974386,0
69,4,0,0,24,0.0,0.0,1.0,24,650,300,350,0.46153846153846156,10,3,7,472.12016661703444,0.8688858695652173,-0.002566102808343018,0.2587524477525761,128735.8368055555,7355.756944444438,136091.59374999994,68,3,44.625,24,0,21,34.313584606120344,0.642795138888889,46.291666666666664,1014.8333333333329,42.28472222222221,0
70,4,1,1,24,0.04,0.04,0.96,25,1000,800,200,0.8,12,8,4,460.6614229795563,0.8748611111111111,-0.020986914709127946,0.2551943585990678,129160.66026154667,6899.866709812626,136060.5269713593,69,0,43.8,25,0,21,34.166765200483475,0.6429166666666667,45.87339743589744,1016.5064102564102,40.66025641025641,0
71,4,1,1,24,0.04,0.04,0.96,25,650,500,150,0.7692307692307693,8,5,3,464.01499255705943,0.8745833333333334,-0.021960289946423295,0.25784931197610295,129282.86540516093,6997.837565746197,136280.70297090712,70,0,44.76,25,0,21,33.95577266519592,0.6441666666666668,45.75320512820512,1016.9871794871783,40.67948717948713,0
72,4,0,0,24,0.0,0.0,1.0,24,1000,700,300,0.7,13,7,6,475.9149606720033,0.86556461352657,-0.007685686178061868,0.2636335463341095,129159.0312499999,7493.743055555541,136652.77430555545,71,6,47.625,24,0,22,33.78081106192271,0.6471354166666667,45.87499999999999,1016.4999999999992,42.354166666666636,0
73,4,2,1,25,0.07692307692307693,0.038461538461538464,0.9615384615384616,26,950,800,150,0.8421052631578947,11,8,3,449.13632726673757,0.8756410256410256,-0.032078460606625336,0.2530798895281172,129829.72298430117,6462.248990245391,136291.97197454656,72,0,44.88461538461539,26,0,20,33.772776600040395,0.6458333333333333,45.21604938271605,1019.1358024691358,39.19753086419753,0
74,4,0,0,25,0.0,0.0,1.0,25,600,500,100,0.8333333333333334,7,5,2,463.45250330965405,0.8659722222222223,-0.017011638880151114,0.26076380672944943,129772.26382725174,7028.656106180129,136800.91993343187,73,1,47.68,25,0,22,33.46702317290553,0.6491666666666667,45.27243589743589,1018.9102564102558,40.756410256410234,0
75,4,1,3,23,0.038461538461538464,0.11538461538461539,0.8846153846153846,26,550,400,150,0.7272727272727273,7,4,3,451.71555562515465,0.8704487179487179,-0.03346834735849713,0.25581731851984957,130026.38996056227,6546.988597393669,136573.37855795593,74,0,46.80769230769231,26,0,22,33.50544711756695,0.6478365384615385,45.02314814814814,1019.9074074074063,39.22720797720793,0
76,4,1,2,22,0.041666666666666664,0.08333333333333333,0.9166666666666666,24,950,600,350,0.631578947368421,13,6,7,456.7606025958363,0.8604317632850241,-0.047651254303984314,0.25302297141071795,129159.03125,6998.95138888889,136157.98263888888,75,0,49.291666666666664,24,0,21,34.2675711865333,0.6471354166666666,45.875,1016.5,42.354166666666664,5
77,4,2,2,22,0.08333333333333333,0.08333333333333333,0.9166666666666666,24,650,500,150,0.7692307692307693,8,5,3,458.88202096210705,0.8552234299516908,-0.05327868852459006,0.2544709388971686,129201.38888888899,7057.638888888909,136259.0277777779,76,0,50.083333333333336,24,0,21,34.17008196721312,0.6475694444444444,45.83333333333334,1016.6666666666675,42.36111111111115,0
78,4,3,3,22,0.12,0.12,0.88,25,800,300,500,0.375,13,3,10,441.309743368838,0.8668055555555556,-0.06155202266645676,0.24701681053940314,129568.23545878529,6435.944947813935,136004.18040659922,77,0,48.96,25,0,21,34.24022115535968,0.6470833333333333,45.47275641025641,1018.108974358974,40.724358974358964,0
79,4,1,1,22,0.043478260869565216,0.043478260869565216,0.9565217391304348,23,650,400,250,0.6153846153846154,9,4,5,469.6729458935375,0.8494729907773386,-0.03243604500055697,0.2601641530942916,129157.26649908374,7532.334768036273,136689.60126712002,78,0,54.17391304347826,23,0,21,33.941253914033595,0.6517210144927537,45.876736111111114,1016.4930555555557,44.195350241545896,0
80,4,2,1,23,0.08333333333333333,0.041666666666666664,0.9583333333333334,24,1000,700,300,0.7,13,7,6,448.7373060016276,0.8552989130434783,-0.03971663121147673,0.2518120915496737,129667.78124999999,6837.354166666667,136505.13541666666,79,0,52.833333333333336,24,0,22,33.94902634593356,0.65234375,45.375,1018.4999999999999,42.43749999999999,0
81,4,3,2,24,0.11538461538461539,0.07692307692307693,0.9230769230769231,26,500,100,400,0.2,9,1,8,420.9994750917129,0.8656410256410256,-0.06843549437261676,0.24011487303506646,130301.97378448401,5771.412513336376,136073.3862978204,80,0,49.65384615384615,26,0,24,34.00720475614671,0.6506410256410258,44.75308641975308,1020.9876543209872,39.26875593542258,0
82,4,1,1,24,0.04,0.04,0.96,25,750,600,150,0.8,9,6,3,435.25852550387106,0.8572222222222222,-0.06010994188785934,0.2472159707299865,130139.91938383479,6328.901884040127,136468.8212678749,81,0,52.6,25,0,24,33.80893016072457,0.6529166666666666,44.911858974358985,1020.3525641025652,40.81410256410261,0
83,4,1,1,24,0.04,0.04,0.96,25,550,400,150,0.7272727272727273,7,4,3,436.31820074968766,0.8580555555555556,-0.055183673469387906,0.24859990507831037,130262.58680555553,6367.187499999995,136629.77430555553,82,0,53.56,25,0,24,33.65646258503401,0.6541666666666668,44.791666666666664,1020.8333333333331,40.83333333333333,0
84,4,0,0,24,0.0,0.0,1.0,24,550,400,150,0.7272727272727273,7,4,3,451.5240637664848,0.8513737922705313,-0.04747998693024036,0.25614261300413854,130092.50347222235,6947.979166666689,137040.48263888905,83,3,56.791666666666664,24,0,24,33.44258835702227,0.6566840277777778,44.95833333333334,1020.1666666666677,42.506944444444485,0
85,4,1,0,25,0.04,0.0,1.0,25,450,300,150,0.6666666666666666,6,3,3,436.07694475361666,0.8530555555555556,-0.05806775407779141,0.250038363286786,130508.09500328738,6382.314266929665,136890.40927021706,84,0,55.48,25,0,20,33.411752404851526,0.6566666666666666,44.55128205128206,1021.7948717948723,40.87179487179489,0
86,4,0,0,25,0.0,0.0,1.0,25,600,500,100,0.8333333333333334,7,5,2,437.99529996938963,0.8519444444444444,-0.061310755722797206,0.25166973182024927,130589.98243343194,6439.559705785664,137029.5421392176,85,1,56.48,25,0,20,33.27911048395527,0.6575000000000001,44.47115384615385,1022.1153846153845,40.88461538461538,0
87,4,1,0,26,0.038461538461538464,0.0,1.0,26,350,0,350,0.0,7,0,7,422.94293591204683,0.8580769230769231,-0.06292757589109721,0.24569206977587715,131011.95749504646,5882.116388507847,136894.07388355432,86,0,55.26923076923077,26,0,22,33.23378303688071,0.6578525641025641,44.05864197530864,1023.7654320987651,39.3755935422602,0
88,4,0,1,25,0.0,0.038461538461538464,0.9615384615384616,26,1250,900,350,0.72,16,9,7,420.68605748294357,0.8558974358974359,-0.055676552363299714,0.24589396317665035,131249.04740131088,5842.928859929897,137091.97626124078,87,1,56.26923076923077,26,0,23,33.050326305220864,0.6602564102564102,43.827160493827165,1024.6913580246921,39.41120607787278,0
89,4,2,0,27,0.07407407407407407,0.0,1.0,27,700,500,200,0.7142857142857143,9,5,4,404.753942441751,0.8564814814814815,-0.04269003022445528,0.23969076814640686,131747.91677738802,5265.097744827102,137013.01452221512,88,0,54.851851851851855,27,0,19,32.952390443059386,0.6616512345679012,43.34077380952381,1026.6369047619046,38.02358906525573,0
90,4,0,0,27,0.0,0.0,1.0,27,750,600,150,0.8,9,6,3,406.23751545311086,0.8541073124406459,-0.039660695027926574,0.24153811965312855,131900.73441485967,5316.605327026641,137217.3397418863,89,1,55.851851851851855,27,0,20,32.759458448017774,0.6631944444444444,43.191964285714285,1027.2321428571427,38.04563492063491,0
91,4,0,1,26,0.0,0.037037037037037035,0.962962962962963,27,400,200,200,0.5,6,2,4,405.8372461796878,0.8541073124406459,-0.03725162010214156,0.24154313341591072,131938.95266439902,5309.14824263037,137248.1009070294,90,2,56.851851851851855,27,0,20,32.73102549246811,0.6635802469135803,43.1547619047619,1027.3809523809518,38.0511463844797,0
92,4,0,1,25,0.0,0.038461538461538464,0.9615384615384616,26,650,300,350,0.46153846153846156,10,3,7,423.26277360999484,0.8468589743589744,-0.028564326099272952,0.2507539833327959,131763.4774853301,5954.114988187797,137717.5924735179,91,3,59.88461538461539,26,0,19,32.46154616964778,0.6654647435897435,43.32561728395063,1026.6975308641986,39.48836657169995,1
93,4,0,0,25,0.0,0.0,1.0,25,900,800,100,0.8888888888888888,10,8,2,431.1051521031086,0.8436111111111111,-0.009154353976736473,0.2435782395808148,129935.60209155151,6203.181500657452,136138.78359220896,92,4,62.8,25,0,21,34.123834224038575,0.6508333333333334,45.11217948717948,1019.5512820512812,40.78205128205125,4
94,4,1,1,25,0.038461538461538464,0.038461538461538464,0.9615384615384616,26,600,400,200,0.6666666666666666,8,4,4,419.00091237540715,0.8514102564102564,-0.02542786717514689,0.23897500312721498,130301.97378448404,5719.329180003041,136021.30296448708,93,0,61.34615384615385,26,0,21,34.05821745264005,0.6506410256410258,44.75308641975308,1020.9876543209874,39.26875593542259,0
95,4,0,1,24,0.0,0.04,0.96,25,800,600,200,0.75,10,6,4,433.18034898108647,0.8418055555555556,-0.014698492462311474,0.2462939698492463,130180.80210387906,6278.35305719922,136459.1551610783,94,6,64.8,25,0,21,33.820142378559474,0.6533333333333333,44.871794871794876,1020.5128205128208,40.82051282051283,0
96,4,1,1,24,0.04,0.04,0.96,25,1000,800,200,0.8,12,8,4,434.98542274052477,0.8458333333333333,-0.02546938775510199,0.24784053156146196,130262.5868055557,6332.465277777803,136595.0520833335,95,0,65.36,25,0,22,33.69047619047619,0.6541666666666666,44.79166666666668,1020.8333333333345,40.83333333333338,0
97,4,1,0,25,0.04,0.0,1.0,25,350,300,50,0.8571428571428571,4,3,1,432.26281516919494,0.8511111111111112,-0.01860348344578666,0.24706824404244657,130385.31201203982,6272.144405407637,136657.45641744745,96,0,66.32,25,0,23,33.6345716303154,0.6554166666666666,44.671474358974365,1021.314102564103,40.852564102564116,0
98,4,2,3,24,0.07407407407407407,0.1111111111111111,0.8888888888888888,27,500,400,100,0.8,6,4,2,407.1109357133041,0.8626543209876544,-0.04252500282746052,0.2358636819629649,130909.00308691194,5258.897348001714,136167.90043491364,97,0,62.333333333333336,27,0,20,33.74366850855508,0.6531635802469136,44.1592261904762,1023.363095238096,37.902336860670225,0
99,4,0,0,24,0.0,0.0,1.0,24,850,400,450,0.47058823529411764,13,4,9,447.8860783093235,0.8371074879227053,-0.008504789897670229,0.25491211371433997,130220.05555555565,6864.750000000019,137084.80555555568,98,10,71.08333333333333,24,0,22,33.404773568473765,0.657986111111111,44.83333333333334,1020.6666666666674,42.52777777777781,0
100,4,0,0,24,0.0,0.0,1.0,24,900,600,300,0.6666666666666666,12,6,6,447.2428539874233,0.8343900966183575,-0.005777596519847661,0.2562241770974678,130475.3472222223,6870.833333333353,137346.18055555565,99,11,72.08333333333333,24,0,23,33.16000543773791,0.6605902777777777,44.58333333333334,1021.6666666666673,42.56944444444447,0
101,4,1,1,24,0.04,0.04,0.96,25,750,400,350,0.5333333333333333,11,4,7,433.16308227792615,0.8408333333333333,-0.028341425215348437,0.2507476228780198,130876.7906856099,6338.198810404359,137214.98949601426,100,0,70.16,25,0,22,33.10999086400418,0.6604166666666667,44.19070512820514,1023.2371794871804,40.92948717948721,0
102,4,0,0,24,0.0,0.0,1.0,24,800,300,500,0.375,13,3,10,445.93877457345627,0.8315972222222222,-0.010347120447266933,0.25859395794670387,130944.03124999997,6878.604166666667,137822.63541666663,101,13,74.08333333333333,24,0,22,32.7145416056017,0.6653645833333333,44.125,1023.4999999999998,42.64583333333332,0
103,4,1,1,24,0.04,0.04,0.96,25,800,600,200,0.75,10,6,4,431.8229520251757,0.8355555555555556,-0.019509144911677323,0.2531962808528919,131369.19391539294,6345.646624342554,137714.8405397355,102,0,72.08,25,0,22,32.64274269188682,0.6654166666666667,43.709935897435905,1025.1602564102573,41.00641025641029,0
104,4,1,1,24,0.04,0.04,0.96,25,1150,900,250,0.782608695652174,14,9,5,432.4959379760244,0.8376388888888889,-0.018197156694266692,0.254683210578154,131533.53378225677,6377.543813691655,137911.07759594842,103,0,73.04,25,0,22,32.45830729573505,0.6670833333333333,43.54967948717949,1025.8012820512824,41.0320512820513,0
105,4,0,0,24,0.0,0.0,1.0,24,600,400,200,0.6666666666666666,8,4,4,446.5595048326009,0.826766304347826,0.0005080474719556527,0.2618481901072765,131370.83680555565,6932.979166666687,138303.81597222234,104,16,77.08333333333333,24,0,22,32.263385357394455,0.669704861111111,43.70833333333334,1025.1666666666677,42.71527777777782,0
106,4,0,0,24,0.0,0.0,1.0,24,750,500,250,0.6666666666666666,10,5,5,447.66495397251106,0.8238224637681159,-0.0027082656266927962,0.2633776411803857,131499.01388888896,6973.50000000002,138472.513888889,105,17,78.08333333333333,24,0,22,32.10445780522155,0.6710069444444444,43.58333333333334,1025.6666666666674,42.73611111111114,0
107,4,1,1,24,0.04,0.04,0.96,25,500,300,200,0.6,7,3,4,433.20482701019114,0.8320833333333333,-0.011359026369168523,0.25731322857352334,131862.52170138896,6424.696180555567,138287.21788194453,106,0,75.92,25,0,21,32.10573022312373,0.6704166666666665,43.22916666666667,1027.083333333334,41.08333333333336,0
108,4,0,0,24,0.0,0.0,1.0,24,600,400,200,0.6666666666666666,8,4,4,448.2839624013776,0.821256038647343,0.0037214463570420797,0.26492635705064166,131670.01388888905,7005.111111111137,138675.12500000017,107,19,80.08333333333333,24,0,21,31.91444733138464,0.6727430555555556,43.41666666666668,1026.3333333333346,42.76388888888894,0
109,4,0,0,24,0.0,0.0,1.0,24,1150,1100,50,0.9565217391304348,12,11,1,448.25325006320685,0.8207276570048309,0.002535291254259331,0.26640161814267543,131883.92013888896,7023.479166666687,138907.39930555565,108,20,81.08333333333333,24,0,21,31.697563416085256,0.6749131944444444,43.20833333333334,1027.1666666666674,42.79861111111114,0
110,4,1,0,25,0.04,0.0,1.0,25,1000,700,300,0.7,13,7,6,432.1464271503578,0.8270833333333333,-0.006155763239875212,0.2597734140735297,132315.55103550304,6435.938527284699,138751.48956278776,109,0,78.8,25,0,22,31.673156801661477,0.6749999999999999,42.78846153846155,1028.8461538461545,41.15384615384618,0
111,4,0,0,25,0.0,0.0,1.0,25,800,500,300,0.625,11,5,6,457.7237672503901,0.8270833333333333,0.0036014481347395044,0.2562043254045577,129568.23545878539,6861.29217003617,136429.52762882155,110,1,79.8,25,0,18,33.822439529880896,0.6470833333333332,45.472756410256416,1018.1089743589748,40.72435897435899,7
112,4,1,1,25,0.038461538461538464,0.038461538461538464,0.9615384615384616,26,500,300,200,0.6,7,3,4,444.2644041028262,0.8307051282051282,-0.006446165492342892,0.2505863696924993,129869.0444720698,6339.238730757502,136208.2832028273,111,0,77.6923076923077,26,0,18,33.856611153166796,0.6462339743589742,45.17746913580247,1019.2901234567901,39.20346628679962,0
113,4,3,2,26,0.10714285714285714,0.07142857142857142,0.9285714285714286,28,1000,900,100,0.9,11,9,2,421.26304975502785,0.8465608465608465,-0.013685288565806086,0.2420731289141573,130592.80659598362,5402.784796538517,135995.59139252215,112,0,73.03571428571429,28,0,18,33.7037883047512,0.6465773809523809,44.4683908045977,1022.1264367816093,36.504515599343186,0
114,4,0,0,26,0.0,0.0,1.0,26,950,700,250,0.7368421052631579,12,7,5,444.3148688046647,0.8331410256410257,0.0083202511773941,0.253156146179402,130262.58680555552,6375.520833333327,136638.10763888885,113,1,79.65384615384616,26,0,19,33.45238095238095,0.6502403846153847,44.791666666666664,1020.833333333333,39.262820512820504,0
115,4,0,0,26,0.0,0.0,1.0,26,850,600,250,0.7058823529411765,11,6,5,442.31747739896986,0.8324358974358974,0.004708864291693704,0.25227348538548133,130301.97378448401,6326.968068891927,136628.94185337593,114,2,80.65384615384616,26,0,19,33.46306932688432,0.6506410256410258,44.75308641975308,1020.9876543209872,39.26875593542258,0
116,4,2,2,26,0.07142857142857142,0.07142857142857142,0.9285714285714286,28,900,700,200,0.7777777777777778,11,7,4,419.2481998735088,0.8460648148148148,-0.024573313812398467,0.24298656856786027,130923.44441554368,5377.883678491214,136301.3280940349,115,0,75.82142857142857,28,0,19,33.4184449436099,0.6499255952380952,44.145114942528735,1023.4195402298851,36.55069786535304,0
117,4,1,1,26,0.037037037037037035,0.037037037037037035,0.962962962962963,27,1150,900,250,0.782608695652174,14,9,5,432.0564636893685,0.8365384615384616,-0.016288539848748895,0.2500690441353617,130870.93431122447,5908.726615646255,136779.6609268707,116,0,79.5925925925926,27,0,19,33.14426992437465,0.6527777777777778,44.19642857142857,1023.2142857142854,37.896825396825385,0
118,4,1,0,27,0.037037037037037035,0.0,1.0,27,900,600,300,0.6666666666666666,12,6,6,428.68442401298,0.8327397910731245,-0.009345391903531342,0.24910040854808296,131023.24263038544,5833.524659863936,136856.76729024938,117,0,80.55555555555556,27,0,20,33.07533914728682,0.654320987654321,44.047619047619044,1023.8095238095234,37.91887125220457,0
119,4,0,0,27,0.0,0.0,1.0,27,600,300,300,0.5,9,3,6,430.5826560116098,0.8304843304843306,-0.003917327177533458,0.25094838453242224,131137.5319984763,5893.109366142262,137030.64136461855,118,1,81.55555555555556,27,0,20,32.91034069446462,0.6554783950617284,43.93601190476189,1024.255952380951,37.935405643738925,0
120,4,0,0,27,0.0,0.0,1.0,27,650,500,150,0.7692307692307693,8,5,3,430.5826560116098,0.8304843304843306,-0.003917327177533458,0.25094838453242224,131137.5319984763,5893.109366142262,137030.64136461855,119,2,82.55555555555556,27,0,20,32.91034069446462,0.6554783950617284,43.93601190476189,1024.255952380951,37.935405643738925,0
121,4,1,1,27,0.03571428571428571,0.03571428571428571,0.9642857142857143,28,850,600,250,0.7058823529411765,11,6,5,419.51211048786377,0.8336640211640212,-0.020604010727294675,0.2466620629870157,131475.43640177033,5431.107560443911,136906.54396221426,120,0,80.57142857142857,28,0,20,32.85029653497711,0.6555059523809523,43.60632183908046,1025.574712643678,36.62766830870278,0
122,4,1,1,27,0.03571428571428571,0.03571428571428571,0.9642857142857143,28,850,600,250,0.7058823529411765,11,6,5,415.616078793475,0.8371362433862434,-0.03706766917293247,0.24134185504511088,130996.97625594532,5288.889921059589,136285.8661770049,121,0,81.53571428571429,28,0,19,33.43654970760235,0.6506696428571429,44.07327586206897,1023.7068965517243,36.56096059113301,2
123,4,0,1,26,0.0,0.037037037037037035,0.962962962962963,27,750,500,250,0.6666666666666666,10,5,5,427.9985365315965,0.8258547008547009,-0.024429256943434563,0.2479651167420208,130909.00308691173,5805.772348001686,136714.7754349134,122,5,85.55555555555556,27,0,20,33.20927851291746,0.6531635802469136,44.15922619047618,1023.3630952380943,37.90233686067016,0
124,4,0,0,26,0.0,0.0,1.0,26,700,400,300,0.5714285714285714,10,4,6,439.85180927543087,0.8191666666666667,-0.009869222646413878,0.25420903606685524,130814.5463010592,6307.802974013097,137122.3492750723,123,11,89.65384615384616,26,0,20,33.00240106602303,0.655849358974359,44.25154320987654,1022.9938271604931,39.34591642924973,0
125,4,1,1,26,0.037037037037037035,0.037037037037037035,0.962962962962963,27,950,400,550,0.42105263157894735,15,4,11,425.0923023466103,0.8246676163342831,-0.032830972128096825,0.2484877414226448,131251.87119118468,5758.832022392271,137010.70321357696,124,0,87.29629629629629,27,0,20,32.93457740342724,0.6566358024691359,43.82440476190475,1024.7023809523798,37.951940035273324,0
126,4,0,0,26,0.0,0.0,1.0,26,1000,700,300,0.7,13,7,6,435.49601339389994,0.8156410256410256,-0.014705541520847465,0.2540265849656157,131169.9936175887,6224.801859472629,137394.79547706133,125,13,91.65384615384616,26,0,20,32.751456261926286,0.6594551282051282,43.904320987654316,1024.3827160493822,39.39933523266855,0
127,4,0,0,26,0.0,0.0,1.0,26,1050,1000,50,0.9523809523809523,11,10,1,437.0282763747299,0.8156410256410256,-0.004073627036813132,0.2523191128755842,130775.08192348713,6230.481729157119,137005.56365264425,126,14,92.65384615384616,26,0,18,33.114878797022726,0.6554487179487181,44.29012345679011,1022.8395061728384,39.339981006647626,1
128,4,0,0,26,0.0,0.0,1.0,26,700,500,200,0.7142857142857143,9,5,4,439.67568231608686,0.8151282051282052,-0.0006265227984685318,0.2543673450048565,130854.01663237311,6306.665809327846,137160.68244170095,127,15,93.65384615384616,26,0,18,32.96662895927602,0.65625,44.21296296296296,1023.1481481481482,39.351851851851855,0
129,4,1,1,26,0.037037037037037035,0.037037037037037035,0.962962962962963,27,800,400,400,0.5,12,4,8,428.5875064407537,0.8245489078822412,-0.015062266333145224,0.2502820171199821,131213.7525908801,5847.315006731851,137061.06759761195,128,0,91.14814814814815,27,0,18,32.88383563301864,0.65625,43.86160714285714,1024.553571428571,37.94642857142856,0
130,4,0,0,26,0.0,0.0,1.0,26,950,800,150,0.8421052631578947,11,8,3,439.01585630246365,0.8137179487179487,-0.0015648908053969013,0.255553440563434,131090.96364883397,6310.202331961593,137401.16598079557,129,17,95.65384615384616,26,0,19,32.74186256781196,0.6586538461538463,43.98148148148148,1024.0740740740737,39.38746438746437,0
131,4,0,0,26,0.0,0.0,1.0,26,1000,800,200,0.8,12,8,4,437.5512592538827,0.8111538461538461,0.003753475440221976,0.2557517923807907,131249.0474013108,6285.637193263218,137534.684594574,130,18,96.65384615384616,26,0,20,32.61828564257027,0.6602564102564104,43.82716049382716,1024.6913580246915,39.41120607787275,0
132,4,1,1,26,0.037037037037037035,0.037037037037037035,0.962962962962963,27,350,300,50,0.8571428571428571,4,3,1,424.43119631243803,0.8219373219373219,-0.006318809742572817,0.24983810727426423,131518.85640323826,5764.14111217402,137282.99751541228,131,0,94.03703703703704,27,0,20,32.68004376420524,0.6593364197530864,43.56398809523809,1025.7440476190466,37.99052028218691,0
133,4,0,0,26,0.0,0.0,1.0,26,650,400,250,0.6153846153846154,9,4,5,440.8412745417504,0.8112820512820513,0.0068772287315335134,0.2587411155525961,131407.22641365638,6385.945835238521,137793.1722488949,132,20,98.65384615384616,26,0,20,32.37288029299619,0.6618589743589745,43.672839506172835,1025.308641975308,39.43494776828108,0
134,4,1,1,26,0.037037037037037035,0.037037037037037035,0.962962962962963,27,1000,700,300,0.7,13,7,6,427.45641671917684,0.814221272554606,-0.01082125603864692,0.2533891130036356,131786.11288265296,5866.56391723355,137652.6767998865,133,0,95.96296296296296,27,0,17,32.33091787439615,0.662037037037037,43.30357142857142,1026.7857142857135,38.0291005291005,0
135,4,1,1,26,0.037037037037037035,0.037037037037037035,0.962962962962963,27,650,300,350,0.46153846153846156,10,3,7,428.4032263615416,0.8174264007597342,-0.015327891287896911,0.25420556019956986,131824.3145239866,5894.792330994893,137719.10685498148,134,0,96.92592592592592,27,0,17,32.26781746606773,0.6624228395061729,43.266369047619044,1026.9345238095232,38.0346119929453,0
136,4,1,0,27,0.037037037037037035,0.0,1.0,27,500,400,100,0.8,6,4,2,450.5676059199655,0.8194444444444445,0.024802985864674554,0.25596868879811147,130148.67942619766,6328.155780541398,136476.83520673905,135,0,97.88888888888889,27,0,20,33.40944168975742,0.6454475308641974,44.90327380952382,1020.3869047619056,37.79210758377428,5
137,4,2,1,28,0.06896551724137931,0.034482758620689655,0.9655172413793104,29,800,600,200,0.75,10,6,4,428.94296937543805,0.8387725779967159,0.0070229650958635315,0.2477776446627531,130794.81336805559,5420.703125000008,136215.5164930556,136,0,92.06896551724138,29,0,18,33.301510522742696,0.6454741379310345,44.270833333333336,1022.916666666667,35.272988505747136,0
138,4,0,1,27,0.0,0.03571428571428571,0.9642857142857143,28,850,600,250,0.7058823529411765,11,6,5,443.49932733733715,0.8283179012345678,0.02226560147734813,0.2555777095271118,130702.97275482239,5993.336099550811,136696.3088543732,137,1,96.35714285714286,28,0,18,33.02304341717016,0.6476934523809523,44.36063218390805,1022.5574712643685,36.51990968801316,0
139,4,0,0,27,0.0,0.0,1.0,27,600,200,400,0.3333333333333333,10,2,8,453.1667430413329,0.8161206077872745,0.033223845660135476,0.2599746052184488,130528.56445312499,6430.240885416666,136958.80533854166,138,2,100.85185185185185,27,0,19,32.95425586136595,0.6493055555555556,44.53125,1021.8749999999999,37.84722222222222,0
140,4,1,0,28,0.03571428571428571,0.0,1.0,28,850,500,350,0.5882352941176471,12,5,7,439.47695132443323,0.8225308641975309,0.027913692147268687,0.2549538926087347,130960.20775531774,5910.798569824285,136871.00632514202,139,0,98.21428571428571,28,0,20,32.86338433464347,0.6502976190476191,44.10919540229885,1023.5632183908045,36.55582922824302,0
141,4,0,0,28,0.0,0.0,1.0,28,1150,800,350,0.6956521739130435,15,8,7,441.9815213274143,0.8229166666666666,0.0289679751029015,0.25421976752179104,130629.5234880765,5947.167104307065,136576.69059238356,140,1,99.21428571428571,28,0,18,33.136858749121586,0.6469494047619047,44.43247126436783,1022.2701149425299,36.50964696223321,1
142,4,1,1,28,0.034482758620689655,0.034482758620689655,0.9655172413793104,29,850,500,350,0.5882352941176471,12,5,7,431.65068399093616,0.8313834154351395,0.024981404291748888,0.25072475899899077,131008.00781250012,5509.939236111126,136517.94704861124,141,0,96.75862068965517,29,0,19,33.01494030660697,0.6476293103448274,44.06250000000001,1023.7500000000009,35.30172413793107,0
143,4,1,1,28,0.034482758620689655,0.034482758620689655,0.9655172413793104,29,1250,1000,250,0.8,15,10,5,432.92486389580324,0.8307676518883416,0.01767147879422537,0.25263083829869026,131185.80246913576,5558.719135802463,136744.52160493823,142,0,97.65517241379311,29,0,19,32.80120209689081,0.6494252873563219,43.888888888888886,1024.4444444444441,35.32567049808428,0
144,4,0,0,28,0.0,0.0,1.0,28,900,800,100,0.8888888888888888,10,8,2,443.429204120152,0.8231922398589064,0.03401026422356779,0.2577387037977328,131033.74991742636,6020.838287752684,137054.58820517905,143,2,102.14285714285714,28,0,19,32.687225184769396,0.6510416666666666,44.037356321839084,1023.8505747126438,36.566091954022994,0
145,4,0,0,28,0.0,0.0,1.0,28,850,700,150,0.8235294117647058,10,7,3,443.39907866123673,0.8228064373897707,0.03734791236545121,0.2579677741729496,131070.52873976075,6023.310336570203,137093.83907633094,144,3,103.14285714285714,28,0,19,32.65048407464571,0.6514136904761905,44.001436781609186,1023.9942528735622,36.571223316912935,0
146,4,1,0,29,0.034482758620689655,0.0,1.0,29,500,200,300,0.4,8,2,6,430.49707091112475,0.8263546798029556,0.03755567789399916,0.252651177050907,131404.4009530895,5514.34770666837,136918.74865975787,145,0,100.55172413793103,27,2,20,32.64090469279149,0.658179012345679,43.675595238095234,1025.2976190476186,37.97398589065254,0
147,4,0,0,29,0.0,0.0,1.0,29,900,500,400,0.5555555555555556,13,5,8,431.9660029595157,0.8264573070607553,0.03726459463245724,0.2540195983273875,131480.6990504535,5559.038407029475,137039.73745748296,146,1,101.55172413793103,27,2,20,32.52563358483267,0.6589506172839507,43.601190476190474,1025.5952380952378,37.985008818342145,0
148,4,0,0,29,0.0,0.0,1.0,29,750,500,250,0.6666666666666666,10,5,5,429.99430444114796,0.8231732348111658,0.03792041251846756,0.2538032497784031,131622.8303771964,5519.413479323548,137142.24385651996,147,2,102.55172413793103,28,1,19,32.431683468682905,0.6569940476190477,43.462643678160916,1026.1494252873558,36.64819376026271,0
149,4,1,0,30,0.03333333333333333,0.0,1.0,30,950,800,150,0.8421052631578947,11,8,3,415.0992157285162,0.8284003831417625,0.039721583997837095,0.2474874373227473,132005.2107445989,4959.051890432115,136964.26263503102,148,0,100.1,29,1,20,32.42597535703022,0.6576867816091954,43.090277777777786,1027.63888888889,35.43582375478931,0
150,4,0,0,30,0.0,0.0,1.0,30,950,600,350,0.631578947368421,13,6,7,415.2765429490103,0.8280172413793103,0.03946763950817411,0.24805986233782296,132076.58420138893,4969.6614583333385,137046.24565972228,149,1,101.1,29,1,21,32.34909133900823,0.6584051724137931,43.020833333333336,1027.916666666667,35.44540229885059,0
151,4,1,2,29,0.03225806451612903,0.06451612903225806,0.935483870967742,31,750,400,350,0.5333333333333333,11,4,7,402.894928712551,0.8332437275985664,0.02688523208529081,0.2422749944457642,132328.84807853508,4462.924362643076,136791.77244117815,150,0,98.80645161290323,30,1,21,32.41209449161767,0.657986111111111,42.7755376344086,1028.8978494623655,34.29659498207885,0
152,4,0,0,29,0.0,0.0,1.0,29,700,600,100,0.8571428571428571,8,6,2,421.39311597586806,0.8172208538587848,0.04669680815169719,0.25163992918959616,132065.50774540898,5330.299164354614,137395.8069097636,151,3,106.3103448275862,28,1,21,32.20313810455689,0.6614583333333333,43.031609195402304,1027.8735632183914,36.70977011494255,0
153,4,0,0,29,0.0,0.0,1.0,29,850,400,450,0.47058823529411764,13,4,9,422.0263985885072,0.8166050903119868,0.04936022554760355,0.2522638999081678,132102.43107164087,5350.14264599022,137452.57371763108,152,4,107.3103448275862,28,1,21,32.14942930351736,0.6618303571428571,42.99568965517241,1028.0172413793102,36.714901477832505,0
154,4,0,0,29,0.0,0.0,1.0,29,450,300,150,0.6666666666666666,6,3,3,421.6148602544941,0.8156814449917897,0.04574253323247568,0.2525102556352648,132176.29320666534,5345.497877857051,137521.79108452238,153,5,108.3103448275862,28,1,21,32.08513809324206,0.6625744047619048,42.923850574712645,1028.3045977011495,36.725164203612486,0
155,4,0,1,28,0.0,0.034482758620689655,0.9655172413793104,29,1050,800,250,0.7619047619047619,13,8,5,416.48122717767865,0.8133210180623973,0.04059911385089565,0.25016825390873987,132287.12511560318,5219.020841590711,137506.1459571939,154,6,109.3103448275862,28,1,21,32.10486499068902,0.663690476190476,42.816091954022994,1028.7356321839086,36.74055829228245,0
156,4,0,0,28,0.0,0.0,1.0,28,850,500,350,0.5882352941176471,12,5,7,428.0758630621139,0.8075396825396824,0.05073556758543707,0.25736665367056116,132321.43964356565,5728.722895408148,138050.1625389738,155,7,111.85714285714286,27,1,21,31.771887956802615,0.6674382716049383,42.78273809523809,1028.8690476190468,38.10626102292766,0
157,4,0,0,28,0.0,0.0,1.0,28,750,600,150,0.8,9,6,3,426.42360399247684,0.8080357142857142,0.05191660298643086,0.25715536781307397,132436.2936906532,5694.792330994876,138131.08602164808,156,8,112.85714285714286,27,1,21,31.69802057732158,0.6685956790123457,42.67113095238094,1029.315476190475,38.12279541446204,0
158,4,0,0,28,0.0,0.0,1.0,28,750,600,150,0.8,9,6,3,425.64736543152145,0.8061067019400352,0.05367464905037167,0.2574720077610251,132551.19756235817,5684.013605442164,138235.21116780033,157,9,113.85714285714286,27,1,21,31.601637764932565,0.6697530864197532,42.5595238095238,1029.761904761904,38.13932980599644,0
159,4,0,0,28,0.0,0.0,1.0,28,600,500,100,0.8333333333333334,7,5,2,426.05176381959,0.8049492945326279,0.05108969331737301,0.2582425839894221,132627.82782383772,5701.263995181383,138329.09181901912,158,10,114.85714285714286,27,1,19,31.51365212366368,0.6705246913580247,42.48511904761904,1030.0595238095227,38.15035273368603,0
160,4,0,0,28,0.0,0.0,1.0,28,850,400,450,0.47058823529411764,13,4,9,429.3288507049776,0.804508377425044,0.04621302751536671,0.2612945184519045,132781.1547796201,5801.3561153628,138582.5108949829,159,11,115.85714285714286,27,1,19,31.274063913754937,0.6720679012345678,42.33630952380952,1030.6547619047612,38.17239858906523,0
161,4,0,0,28,0.0,0.0,1.0,28,650,500,150,0.7692307692307693,8,5,3,432.2361251281514,0.8020833333333333,0.04540021432693098,0.26468735153607276,133011.3112953514,5898.4587585033905,138909.7700538548,160,12,116.85714285714286,27,1,19,30.966291594537427,0.6743827160493827,42.113095238095234,1031.5476190476184,38.20546737213402,0
162,4,1,1,28,0.034482758620689655,0.034482758620689655,0.9655172413793104,29,850,700,150,0.8235294117647058,10,7,3,419.6126119963959,0.8089080459770115,0.0435122447120202,0.25989959456210876,133435.10794441137,5398.2108353150925,138833.31877972645,161,0,113.79310344827586,28,1,19,30.864100959532742,0.6752232142857143,41.70258620689655,1033.1896551724135,36.89963054187191,0
163,4,0,1,27,0.0,0.03571428571428571,0.9642857142857143,28,750,400,350,0.5333333333333333,11,4,7,431.64829283520567,0.8004298941798942,0.05442029880232058,0.2670679544440282,133395.34837372435,5915.9748795351215,139311.32325325947,162,14,118.85714285714286,27,1,19,30.593368865840763,0.6782407407407408,41.741071428571416,1033.0357142857133,38.26058201058198,0
164,4,0,0,27,0.0,0.0,1.0,27,850,600,250,0.7058823529411765,11,6,5,433.1425598335067,0.79320987654321,0.017921146953404854,0.268548387096774,133472.22222222213,6162.49999999998,139634.7222222221,163,15,118.29629629629629,27,0,19,30.47715053763439,0.6790123456790125,41.66666666666666,1033.3333333333326,38.27160493827158,0
165,4,0,0,27,0.0,0.0,1.0,27,600,400,200,0.6666666666666666,8,4,4,432.31198445927663,0.7916666666666667,0.02299218308432316,0.26859025438766826,133549.11821499412,6146.976863662103,139696.09507865622,164,16,119.29629629629629,27,0,19,30.42098569920339,0.679783950617284,41.59226190476189,1033.6309523809505,38.28262786596113,0
166,4,0,0,27,0.0,0.0,1.0,27,1050,700,350,0.6666666666666666,14,7,7,429.8101962468796,0.790954415954416,0.021194481758673334,0.2675915092762827,133626.03635204062,6086.766581632631,139712.80293367326,165,17,120.29629629629629,27,0,20,30.408031088082915,0.6805555555555556,41.51785714285713,1033.9285714285697,38.293650793650734,0
167,4,0,0,27,0.0,0.0,1.0,27,650,500,150,0.7692307692307693,8,5,3,425.64821829341184,0.7885802469135803,0.017306329491626915,0.2658293589719229,133741.45507812485,5985.36241319443,139726.8174913193,166,18,121.29629629629629,27,0,20,30.399253105068826,0.681712962962963,41.40624999999999,1034.3749999999989,38.31018518518514,0
168,4,1,1,27,0.03571428571428571,0.03571428571428571,0.9642857142857143,28,750,600,150,0.8,9,6,3,412.2786320247357,0.7982804232804233,0.0011498354545811384,0.2592390769956581,133992.36400118883,5448.437706434099,139440.80170762294,167,0,117.92857142857143,28,0,20,30.492529373670077,0.6808035714285716,41.163793103448256,1035.3448275862052,36.976600985221616,0
169,4,0,0,27,0.0,0.0,1.0,27,700,500,200,0.7142857142857143,9,5,4,422.38502650855276,0.7873931623931625,0.012528564808157228,0.26434231226948385,133818.4285758573,5904.580100269266,139723.00867612657,168,20,123.29629629629629,27,0,20,30.406089697492696,0.6824845679012347,41.331845238095234,1034.6726190476181,38.32120811287474,0
170,4,0,0,27,0.0,0.0,1.0,27,450,400,50,0.8888888888888888,5,4,1,425.83282877900734,0.7872744539411206,0.015504866568696984,0.26733692752588195,133933.9303429704,6006.692885487513,139940.6232284579,169,21,124.29629629629629,27,0,20,30.200546290971836,0.683641975308642,41.22023809523809,1035.1190476190466,38.337742504409135,0
171,4,1,1,27,0.03571428571428571,0.03571428571428571,0.9642857142857143,28,700,500,200,0.7142857142857143,9,5,4,411.91785525607975,0.7915013227513227,-0.04930603747397688,0.2587504923382785,133955.17747142958,5435.705880895762,139390.88335232533,170,0,120.82142857142857,28,0,17,30.539266712930825,0.6804315476190477,41.19971264367816,1035.2011494252877,36.9714696223317,4
172,4,0,0,27,0.0,0.0,1.0,27,800,500,300,0.625,11,5,6,426.2490292218993,0.7838319088319089,-0.04324715857646533,0.26703925668550355,133856.92362882657,6011.276750283454,139868.20037911003,171,23,126.29629629629629,27,0,17,30.2673521234781,0.6828703703703702,41.29464285714286,1034.821428571429,38.32671957671959,0
173,4,0,0,27,0.0,0.0,1.0,27,850,700,150,0.8235294117647058,10,7,3,426.09285826490884,0.7835944919278253,-0.039352850047115195,0.2677803084868089,133972.44200414565,6016.940148455247,139989.38215260088,172,24,127.29629629629629,27,0,18,30.15502970629102,0.6840277777777777,41.18303571428573,1035.267857142859,38.34325396825403,0
174,4,0,0,27,0.0,0.0,1.0,27,800,600,200,0.75,10,6,4,426.68801352894315,0.7821699905033239,-0.03635067332811914,0.26928152875566425,134126.544009531,6046.037724985842,140172.58173451683,173,25,128.2962962962963,27,0,18,29.98446703059906,0.6855709876543209,41.0342261904762,1035.863095238096,38.36529982363319,0
175,4,0,0,27,0.0,0.0,1.0,27,700,400,300,0.5714285714285714,10,4,6,427.0749006736725,0.782051282051282,-0.03902106903686642,0.27009287315084296,134203.6282286351,6063.000239158151,140266.62846779323,174,26,129.2962962962963,27,0,18,29.896865575183117,0.6863425925925926,40.95982142857142,1036.1607142857135,38.376322751322725,0
176,4,0,0,27,0.0,0.0,1.0,27,900,700,200,0.7777777777777778,11,7,4,432.19868898975403,0.7825261158594492,-0.05029509879394378,0.26358032722896274,132857.85147392296,6084.197845805,138942.04931972796,175,27,130.2962962962963,27,0,18,31.12249807544264,0.6728395061728395,42.261904761904766,1030.9523809523814,38.18342151675487,4
177,4,0,0,27,0.0,0.0,1.0,27,550,400,150,0.7272727272727273,7,4,3,431.16478145100007,0.7813390313390314,-0.049389843010855916,0.26321945116070283,132896.20812517704,6060.032906391707,138956.24103156876,176,28,131.2962962962963,27,0,18,31.110339394814066,0.6732253086419753,42.22470238095237,1031.1011904761895,38.18893298059961,0
178,4,0,0,27,0.0,0.0,1.0,27,550,200,350,0.36363636363636365,9,2,7,430.0416907088842,0.7801519468186136,-0.046083885068158525,0.2630731648987887,132972.93803589136,6036.781418296472,139009.71945418784,177,29,132.2962962962963,27,0,19,31.0616854229789,0.673996913580247,42.15029761904761,1031.3988095238087,38.19995590828921,0
179,4,0,0,27,0.0,0.0,1.0,27,850,800,50,0.9411764705882353,9,8,1,430.0416907088842,0.7801519468186136,-0.046083885068158525,0.2630731648987887,132972.93803589136,6036.781418296472,139009.71945418784,178,30,133.2962962962963,27,0,19,31.0616854229789,0.673996913580247,42.15029761904761,1031.3988095238087,38.19995590828921,0
180,4,0,0,27,0.0,0.0,1.0,27,900,500,400,0.5555555555555556,13,5,8,427.77969447647195,0.7782526115859449,-0.039782499545983674,0.26249773464600484,133088.07442247728,5986.475162981856,139074.54958545914,179,31,134.2962962962963,27,0,20,31.00362945870589,0.6751543209876544,42.038690476190474,1031.8452380952378,38.216490299823626,0
181,4,0,0,27,0.0,0.0,1.0,27,700,500,200,0.7142857142857143,9,5,4,428.3065170506438,0.7770655270655271,-0.03768324921893795,0.2630917356728268,133126.46429014305,6003.786449475609,139130.25073961867,180,32,135.2962962962963,27,0,20,30.951243691420327,0.6755401234567902,42.00148809523809,1031.9940476190468,38.2220017636684,0
182,4,0,0,27,0.0,0.0,1.0,27,650,500,150,0.7692307692307693,8,5,3,426.86536586274394,0.7764719848053182,-0.034388483062069986,0.2624767887964531,133164.85969387754,5968.693310657598,139133.55300453515,181,33,136.2962962962963,27,0,20,30.94963475586313,0.6759259259259259,41.964285714285715,1032.142857142857,38.22751322751323,0
183,4,0,0,27,0.0,0.0,1.0,27,700,600,100,0.8571428571428571,8,6,2,424.7612976933676,0.7763532763532764,-0.037074410434652316,0.2614524509404517,133203.26063368056,5915.917968750002,139119.17860243056,182,34,137.2962962962963,27,0,20,30.965144635048787,0.6763117283950617,41.927083333333336,1032.2916666666667,38.233024691358025,0
184,4,1,1,27,0.03571428571428571,0.03571428571428571,0.9642857142857143,28,900,500,400,0.5555555555555556,13,5,8,414.96987767197646,0.7843915343915343,-0.04837364470392014,0.2577973488749739,133546.4662604043,5483.552153520942,139030.01841392525,183,0,133.35714285714286,28,0,20,30.871791307571115,0.6763392857142857,41.5948275862069,1033.6206896551726,36.91502463054188,0
185,4,0,0,27,0.0,0.0,1.0,27,700,400,300,0.5714285714285714,10,4,6,428.92964868794206,0.7746913580246914,-0.04123645328082726,0.2651113705737316,133356.91975357852,6040.147348001705,139397.06710158024,184,36,139.2962962962963,27,0,20,30.702378379676322,0.6778549382716049,41.77827380952381,1032.8869047619048,38.255070546737215,0
186,4,0,0,27,0.0,0.0,1.0,27,350,100,250,0.2857142857142857,6,1,5,427.0931198378198,0.7739791073124407,-0.04391945964979671,0.26424959339698256,133395.3483737244,5994.44710175736,139389.79547548178,185,37,140.2962962962963,27,0,20,30.71101027561701,0.6782407407407407,41.74107142857142,1033.0357142857138,38.26058201058199,0
187,4,0,0,27,0.0,0.0,1.0,27,600,500,100,0.8333333333333334,7,5,2,426.7190374230105,0.7735042735042735,-0.040615417433271794,0.26484036773036707,133510.66745057396,5994.308700042515,139504.97615061648,186,38,141.2962962962963,27,0,20,30.604301655867534,0.6793981481481481,41.629464285714285,1033.4821428571427,38.2771164021164,0
188,4,1,1,27,0.03571428571428571,0.03571428571428571,0.9642857142857143,28,600,300,300,0.5,9,3,6,415.6290166243279,0.7793209876543209,-0.056085611139762515,0.2602921893676878,133843.64884727172,5525.860830360673,139369.5096776324,187,0,137.21428571428572,28,0,18,30.55545913172268,0.6793154761904763,41.30747126436781,1034.7701149425282,36.95607553366172,0
189,4,1,0,28,0.03571428571428571,0.0,1.0,28,400,200,200,0.5,6,2,4,416.18977002089446,0.7740850970017636,-0.04383139408115111,0.261963290178217,134029.55569180203,5556.345991874744,139585.90168367678,188,0,138.17857142857142,28,0,19,30.353880486563998,0.6811755952380952,41.12787356321839,1035.4885057471258,36.981732348111635,0
190,4,0,1,27,0.0,0.03571428571428571,0.9642857142857143,28,600,300,300,0.5,9,3,6,415.5455225732485,0.7725970017636684,-0.038785417079453155,0.2623540470887147,134141.16172876203,5548.351829832209,139689.51355859425,189,1,139.17857142857142,28,0,19,30.258321775312073,0.6822916666666667,41.020114942528735,1035.919540229885,36.997126436781606,0
191,4,0,0,27,0.0,0.0,1.0,27,750,600,150,0.8,9,6,3,426.9002680512415,0.76329534662868,-0.02384335765568668,0.26885058510122944,134049.48193470077,6045.151954010749,140094.6338887115,190,2,143.37037037037038,27,0,19,30.056551468122812,0.6847993827160495,41.10863095238094,1035.5654761904748,38.354276895943514,0
192,4,0,0,27,0.0,0.0,1.0,27,1200,1100,100,0.9166666666666666,13,11,2,426.1527282335844,0.7624643874643875,-0.020263942103022625,0.26866150258204224,134088.0102040816,6028.394274376411,140116.40447845802,191,3,144.37037037037038,27,0,20,30.037116858237546,0.6851851851851852,41.07142857142857,1035.7142857142853,38.35978835978835,0
193,4,0,0,27,0.0,0.0,1.0,27,750,400,350,0.5333333333333333,11,4,7,426.1527282335844,0.7624643874643875,-0.020263942103022625,0.26866150258204224,134088.0102040816,6028.394274376411,140116.40447845802,192,4,145.37037037037038,27,0,20,30.037116858237546,0.6851851851851852,41.07142857142857,1035.7142857142853,38.35978835978835,0
194,4,1,0,28,0.03571428571428571,0.0,1.0,28,700,400,300,0.5714285714285714,10,4,6,412.4644209801224,0.7678571428571428,-0.030706962751850808,0.2625368774809986,134439.00490487512,5490.261263046629,139929.26616792174,193,0,141.14285714285714,28,0,22,30.038907361226553,0.6852678571428572,40.73275862068965,1037.0689655172412,37.03817733990147,0
195,4,0,0,28,0.0,0.0,1.0,28,600,200,400,0.3333333333333333,10,2,8,412.2649484585891,0.7659832451499118,-0.0298294892590103,0.26348473077592316,134588.05035341528,5497.187128418553,140085.23748183384,194,1,142.14285714285714,28,0,22,29.894477522385305,0.6867559523809523,40.589080459770116,1037.6436781609198,37.05870279146142,0
196,4,0,0,28,0.0,0.0,1.0,28,1000,700,300,0.7,13,7,6,410.17277702251806,0.7644400352733686,-0.028085224128389763,0.2637659103486443,134811.77335182985,5459.2238902100735,140270.9972420399,195,2,143.14285714285714,28,0,19,29.724393562073423,0.6889880952380952,40.37356321839081,1038.505747126437,37.08949096880132,0
197,4,0,0,28,0.0,0.0,1.0,28,800,600,200,0.75,10,6,4,409.5168841530271,0.7631172839506173,-0.029501817319848245,0.2644309023388115,134961.02523450906,5453.763707226833,140414.7889417359,196,3,144.14285714285714,28,0,19,29.59186025073747,0.6904761904761905,40.22988505747126,1039.080459770114,37.11001642036121,0
198,4,0,0,28,0.0,0.0,1.0,28,600,300,300,0.5,9,3,6,409.9241371555955,0.7616843033509699,-0.031784430664718144,0.26524071629549,135035.68214096976,5470.8770973708615,140506.55923834062,197,4,145.14285714285714,28,0,19,29.506497097041755,0.6912202380952381,40.1580459770115,1039.3678160919542,37.12027914614122,0
199,4,0,1,27,0.0,0.03571428571428571,0.9642857142857143,28,950,700,250,0.7368421052631579,12,7,5,411.2211179177669,0.7574404761904762,-0.0404900045389065,0.2674599885540624,135222.4147220571,5521.262509908845,140743.67723196594,198,5,146.14285714285714,28,0,19,29.285812957590828,0.6930803571428571,39.97844827586207,1040.0862068965519,37.14593596059114,0
200,4,0,0,27,0.0,0.0,1.0,27,800,500,300,0.625,11,5,6,423.73403977541864,0.7497625830959165,-0.03266726061685965,0.27401467905477056,135014.34948979583,6042.03514739228,141056.3846371881,199,11,152.37037037037038,27,0,19,29.16905307369225,0.6944444444444444,40.17857142857142,1039.2857142857138,38.49206349206347,0
201,4,0,0,27,0.0,0.0,1.0,27,650,400,250,0.6153846153846154,9,4,5,423.7222365361943,0.7497625830959165,-0.01792889273079412,0.2618927910772684,133356.9197535786,5901.258459112827,139258.17821269145,200,12,153.37037037037038,27,0,21,30.836845075157285,0.6778549382716048,41.77827380952382,1032.8869047619055,38.255070546737244,5
202,4,0,0,27,0.0,0.0,1.0,27,1050,800,250,0.7619047619047619,13,8,5,424.61389962250576,0.7471509971509972,-0.012496820499209305,0.2638278200066366,133551.96663999383,5941.654096069853,139493.6207360637,201,13,154.37037037037038,26,1,22,30.61703742410671,0.6834935897435898,41.5895061728395,1033.6419753086413,39.755460588793895,0
203,4,0,0,27,0.0,0.0,1.0,27,700,500,200,0.7142857142857143,9,5,4,424.3164763013862,0.7451329534662868,-0.005238900494047849,0.26478296314449623,133711.52692043892,5947.200788751711,139658.72770919063,202,14,155.37037037037038,26,1,19,30.463854073410925,0.685096153846154,41.43518518518518,1034.259259259259,39.779202279202266,0
204,4,0,1,26,0.0,0.037037037037037035,0.962962962962963,27,850,700,150,0.8235294117647058,10,7,3,425.44186686550535,0.7428774928774929,-0.0048035513151794,0.2672157343570982,133951.04595336068,5997.6766117969655,139948.72256515763,203,15,156.37037037037038,26,1,20,30.193425760286214,0.6875,41.203703703703695,1035.1851851851845,39.81481481481479,0
205,4,0,0,26,0.0,0.0,1.0,26,500,400,100,0.8,6,4,2,425.44186686550535,0.7394871794871795,0.00123847529929777,0.2672157343570982,133951.04595336068,6197.676611796965,140148.72256515763,204,16,156.96153846153845,26,0,20,30.193425760286214,0.6875,41.203703703703695,1035.1851851851845,39.81481481481479,0
206,4,0,0,26,0.0,0.0,1.0,26,750,500,250,0.6666666666666666,10,5,5,426.2332756085162,0.7404487179487179,-0.0020122223878373813,0.2680036594243236,133990.98663027724,6222.283426687983,140213.27005696524,205,17,157.96153846153845,26,0,20,30.132719729716303,0.6879006410256411,41.16512345679011,1035.3395061728384,39.82075023741686,0
207,4,0,0,26,0.0,0.0,1.0,26,900,700,200,0.7777777777777778,11,7,4,427.4090951562939,0.737051282051282,-0.0018560527943909388,0.27020947880219887,134190.7793209874,6270.871913580201,140461.6512345676,206,18,158.96153846153845,26,0,21,29.90113941018765,0.6899038461538463,40.9722222222222,1036.111111111109,39.85042735042727,0
208,4,0,0,26,0.0,0.0,1.0,26,850,700,150,0.8235294117647058,10,7,3,426.56305814636977,0.735897435897436,-0.007112750263435386,0.2702639149538693,134270.73807346413,6254.98733043739,140525.7254039015,207,19,159.96153846153845,26,0,22,29.842602243398847,0.6907051282051284,40.89506172839504,1036.4197530864176,39.862298195631446,0
209,4,0,0,26,0.0,0.0,1.0,26,800,400,400,0.5,12,4,8,429.5626703498535,0.7362179487179488,-0.0026274514293569418,0.27305880625171847,134390.72085524307,6345.847384163986,140736.56823940706,208,20,160.96153846153845,26,0,22,29.644168279009772,0.6919070512820513,40.779320987654316,1036.8827160493825,39.88010446343779,0
210,4,0,0,26,0.0,0.0,1.0,26,700,400,300,0.5714285714285714,10,4,6,431.1745894970279,0.7348076923076923,-0.00015450997447707948,0.2746847787686749,134470.7391451377,6396.07315005331,140866.812295191,209,21,161.96153846153845,26,0,22,29.521896543173145,0.6927083333333334,40.702160493827144,1037.1913580246894,39.8919753086419,0
211,4,0,0,26,0.0,0.0,1.0,26,700,500,200,0.7142857142857143,9,5,4,430.75475951433947,0.7335897435897436,-0.0027799386811881988,0.27532271891391813,134590.81123304373,6395.126505105926,140985.93773814966,210,22,162.96153846153845,26,0,23,29.4120563156851,0.6939102564102564,40.58641975308642,1037.6543209876543,39.90978157644824,0
212,4,0,0,26,0.0,0.0,1.0,26,800,500,300,0.625,11,5,6,429.0167199701425,0.7316666666666667,-0.005249433884581434,0.27481585319230284,134670.88906035668,6355.212620027435,141026.1016803841,211,23,163.96153846153845,26,0,23,29.376672613737732,0.6947115384615385,40.50925925925926,1037.962962962963,39.921652421652425,0
213,4,0,0,26,0.0,0.0,1.0,26,550,300,250,0.5454545454545454,8,3,5,429.0167199701425,0.7316666666666667,-0.005249433884581434,0.27481585319230284,134670.88906035668,6355.212620027435,141026.1016803841,212,24,164.96153846153845,26,0,23,29.376672613737732,0.6947115384615385,40.50925925925926,1037.962962962963,39.921652421652425,0
214,4,0,0,26,0.0,0.0,1.0,26,950,700,250,0.7368421052631579,12,7,5,427.5532815104604,0.7307692307692307,-0.004939174974847083,0.27448267919869995,134750.9907026367,6322.645652339558,141073.63635497625,213,25,165.96153846153845,26,0,23,29.334187970669834,0.6955128205128205,40.43209876543209,1038.2716049382707,39.93352326685657,0
215,4,0,0,26,0.0,0.0,1.0,26,900,700,200,0.7777777777777778,11,7,4,426.68586025624325,0.7283333333333334,-0.004011887072808529,0.27453115100616793,134831.11615988414,6306.106157597921,141137.22231748205,214,26,166.96153846153845,26,0,17,29.276250619118382,0.6963141025641026,40.35493827160494,1038.5802469135801,39.945394112060775,0
216,4,0,0,26,0.0,0.0,1.0,26,700,600,100,0.8571428571428571,8,6,2,424.48311361491625,0.7285897435897436,-0.0003085150143971038,0.2737184215378942,134911.26543209873,6253.510802469137,141164.77623456786,215,27,167.96153846153845,26,0,18,29.253008021390386,0.6971153846153847,40.27777777777778,1038.8888888888887,39.95726495726495,0
217,4,0,0,26,0.0,0.0,1.0,26,550,200,350,0.36363636363636365,9,2,7,424.9482889469794,0.7278846153846154,0.0010793215692994629,0.2749305212351496,135031.53399348422,6276.283864883405,141307.81785836763,216,28,168.96153846153845,26,0,19,29.120267260579073,0.6983173076923077,40.16203703703704,1039.351851851852,39.97507122507123,0
218,4,0,0,26,0.0,0.0,1.0,26,650,500,150,0.7692307692307693,8,5,3,433.2147715910768,0.7278846153846154,-0.022890065400186677,0.2609854843487708,132398.0034722223,6271.354166666687,138669.357638889,217,29,169.96153846153845,26,0,21,31.562078272604587,0.671875,42.70833333333334,1029.1666666666674,39.583333333333364,6
219,4,0,0,26,0.0,0.0,1.0,26,700,600,100,0.8571428571428571,8,6,2,432.13181253558287,0.7264102564102564,-0.019922523519646074,0.26115792148889583,132517.14677640598,6252.974965706438,138770.12174211242,218,30,170.96153846153845,26,0,22,31.46919964028777,0.6730769230769231,42.59259259259259,1029.6296296296293,39.60113960113959,0
220,4,1,1,26,0.037037037037037035,0.037037037037037035,0.962962962962963,27,700,600,100,0.8571428571428571,8,6,2,419.99795939189886,0.7420465337132004,-0.025738870183314555,0.2566654196283826,132934.5703125,5766.449652777779,138701.01996527778,219,0,165.59259259259258,27,0,19,31.359427609427616,0.673611111111111,42.1875,1031.25,38.19444444444444,0
221,4,0,0,26,0.0,0.0,1.0,26,450,400,50,0.8888888888888888,5,4,1,434.0040198438263,0.7255769230769231,-0.016641513346620673,0.2636801492718133,132715.8380248819,6319.841439948175,139035.6794648301,220,32,172.96153846153845,26,0,19,31.219734411661925,0.6750801282051282,42.39969135802469,1030.4012345679014,39.63081671415005,0
222,4,0,0,26,0.0,0.0,1.0,26,600,500,100,0.8333333333333334,7,5,2,434.0040198438263,0.7255769230769231,-0.016641513346620673,0.2636801492718133,132715.8380248819,6319.841439948175,139035.6794648301,221,33,173.96153846153845,26,0,19,31.219734411661925,0.6750801282051282,42.39969135802469,1030.4012345679014,39.63081671415005,0
223,4,0,0,26,0.0,0.0,1.0,26,700,500,200,0.7142857142857143,9,5,4,434.09565706743524,0.7254487179487179,-0.018185900314324543,0.26485781596963787,132874.89819101506,6336.083247599447,139210.98143861452,222,34,174.96153846153845,26,0,20,31.056353839245617,0.6766826923076923,42.24537037037037,1031.0185185185182,39.654558404558394,0
224,4,0,0,26,0.0,0.0,1.0,26,850,700,150,0.8235294117647058,10,7,3,434.1955977295655,0.7251282051282051,-0.01646871979008413,0.26576587685205266,132994.25582990397,6349.104080932779,139343.35991083673,223,35,175.96153846153845,26,0,20,30.933011669658885,0.6778846153846154,42.129629629629626,1031.4814814814813,39.672364672364665,0
225,4,1,0,27,0.037037037037037035,0.0,1.0,27,700,500,200,0.7142857142857143,9,5,4,421.8872078408071,0.73005698005698,-0.01942016923290346,0.2610286093432159,133395.34837372444,5855.55821286847,139250.9065865929,224,0,170.40740740740742,27,0,21,30.845457601075566,0.6782407407407407,41.74107142857142,1033.035714285714,38.260582010582,0
226,4,0,0,27,0.0,0.0,1.0,27,450,300,150,0.6666666666666666,6,3,3,422.9686688269154,0.7287511870845205,-0.017923728135452288,0.2619689088015409,133433.78252993905,5887.6618746456825,139321.44440458473,225,1,171.40740740740742,27,0,21,30.77875198041193,0.6786265432098766,41.703869047619044,1033.1845238095236,38.2660934744268,0
227,4,0,0,27,0.0,0.0,1.0,27,750,600,150,0.8,9,6,3,422.5621384794832,0.7270892687559355,-0.012242590992950886,0.26253279193904216,133549.11821499435,5886.560196995466,139435.67841198982,226,2,172.40740740740742,27,0,22,30.672929263844885,0.6797839506172839,41.592261904761905,1033.6309523809525,38.2826278659612,0
228,4,0,0,27,0.0,0.0,1.0,27,850,600,250,0.7058823529411765,11,6,5,423.05199843009825,0.7253086419753086,-0.02058856439521084,0.2642079461893632,133741.455078125,5915.91796875,139657.373046875,227,3,173.40740740740742,27,0,19,30.466389728096672,0.681712962962963,41.40625,1034.375,38.31018518518518,0
229,4,0,0,27,0.0,0.0,1.0,27,250,100,150,0.4,4,1,3,423.05199843009825,0.7253086419753086,-0.02058856439521084,0.2642079461893632,133741.455078125,5915.91796875,139657.373046875,228,4,174.40740740740742,27,0,19,30.466389728096672,0.681712962962963,41.40625,1034.375,38.31018518518518,0
230,4,0,0,27,0.0,0.0,1.0,27,900,700,200,0.7777777777777778,11,7,4,421.70956370591455,0.7242402659069326,-0.022070963687299328,0.2641953428838674,133856.9236288265,5889.748972505664,139746.67260133216,229,5,175.40740740740742,27,0,19,30.384790528233157,0.6828703703703705,41.294642857142854,1034.8214285714282,38.32671957671956,0
231,4,0,0,27,0.0,0.0,1.0,27,800,700,100,0.875,9,7,2,421.620034383545,0.7219848053181387,-0.016101207590569544,0.2646921443295971,133933.93034297042,5893.8456632652915,139827.7760062357,230,6,176.40740740740742,27,0,19,30.309564884032955,0.683641975308642,41.22023809523809,1035.1190476190468,38.33774250440914,0
232,4,1,1,27,0.03571428571428571,0.03571428571428571,0.9642857142857143,28,850,700,150,0.8235294117647058,10,7,3,409.24759783463276,0.7332451499118166,-0.026129747712781093,0.25942989198409827,134290.04202999064,5391.5754227770985,139681.61745276774,231,0,171.07142857142858,28,0,20,30.271867202661486,0.6837797619047619,40.876436781609186,1036.4942528735623,37.01765188834151,0
233,4,0,0,27,0.0,0.0,1.0,27,550,500,50,0.9090909090909091,6,5,1,420.6500198176775,0.7286324786324787,-0.013409961685823646,0.26519240379810094,134088.0102040816,5880.8248299319675,139968.83503401355,232,1,178.14814814814815,27,0,21,30.179597701149422,0.6851851851851851,41.07142857142857,1035.7142857142853,38.35978835978835,0
234,4,0,0,27,0.0,0.0,1.0,27,100,100,0,1.0,1,1,0,420.6500198176775,0.7286324786324787,-0.013409961685823646,0.26519240379810094,134088.0102040816,5880.8248299319675,139968.83503401355,233,2,179.14814814814815,27,0,21,30.179597701149422,0.6851851851851851,41.07142857142857,1035.7142857142853,38.35978835978835,0
235,4,1,0,28,0.03571428571428571,0.0,1.0,28,800,500,300,0.625,11,5,6,407.944610012176,0.7365520282186948,-0.015209990895776349,0.2596599819283849,134439.0049048751,5368.733485268851,139807.73839014396,234,0,173.71428571428572,28,0,22,30.156091253348116,0.6852678571428572,40.73275862068965,1037.068965517241,37.03817733990146,0
236,4,0,0,28,0.0,0.0,1.0,28,1000,700,300,0.7,13,7,6,407.7501428180195,0.7354497354497354,-0.00831783835107025,0.26059925056918015,134588.05035341516,5375.659350640759,139963.70970405592,235,1,174.71428571428572,28,0,22,30.011596510661867,0.6867559523809523,40.58908045977011,1037.6436781609189,37.058702791461386,0
237,4,0,0,28,0.0,0.0,1.0,28,700,600,100,0.8571428571428571,8,6,2,408.2369974742452,0.7347332451499118,-0.010754336346195714,0.26117766454884606,134625.32461768392,5391.807661183766,140017.13227886768,236,2,175.71428571428572,28,0,22,29.96158106050118,0.6871279761904763,40.553160919540225,1037.7873563218386,37.063834154351376,0
238,4,0,1,27,0.0,0.03571428571428571,0.9642857142857143,28,700,500,200,0.7142857142857143,9,5,4,407.56427724763836,0.7340718694885361,-0.009317844784972884,0.261282333905429,134699.88862878174,5379.772550865353,140079.66117964708,237,3,176.71428571428572,28,0,23,29.90426758938868,0.687872023809524,40.48132183908045,1038.0747126436772,37.07409688013133,0
239,4,0,0,27,0.0,0.0,1.0,27,650,600,50,0.9230769230769231,7,6,1,417.57391009822425,0.7301756885090219,0.007139669790272363,0.26660488106271246,134550.78125,5836.979166666667,140387.76041666666,238,4,182.44444444444446,27,0,23,29.79417670682731,0.6898148148148149,40.625,1037.5,38.425925925925924,0
240,4,0,0,27,0.0,0.0,1.0,27,550,200,350,0.36363636363636365,9,2,7,417.3214958790157,0.7293447293447294,0.004164210101396337,0.26672619530379243,134589.38148827234,5833.408402423456,140422.7898906958,239,5,183.44444444444446,27,0,23,29.761968784358714,0.6902006172839507,40.58779761904761,1037.648809523809,38.4314373897707,0
241,4,0,0,27,0.0,0.0,1.0,27,350,300,50,0.8571428571428571,4,3,1,418.34684590698583,0.7282763532763533,0.0005948018566315216,0.26766522049131364,134627.98726261331,5864.2387684240275,140492.22603103734,240,6,184.44444444444446,27,0,23,29.69661122263645,0.6905864197530864,40.550595238095234,1037.7976190476186,38.436948853615505,0
242,4,0,0,27,0.0,0.0,1.0,27,650,500,150,0.7692307692307693,8,5,3,418.7808533243035,0.7281576448243116,0.0008916913474092958,0.2690840510586546,134782.46572066328,5888.863201530615,140671.3289221939,241,7,185.44444444444446,27,0,19,29.530309544282034,0.6921296296296295,40.401785714285715,1038.3928571428573,38.458994708994716,0
243,4,0,0,27,0.0,0.0,1.0,27,600,500,100,0.8333333333333334,7,5,2,420.66972007697007,0.7268518518518519,0.001782616307756335,0.2711630023875649,134898.3826929209,5949.532977253398,140847.9156701743,242,8,186.44444444444446,27,0,19,29.364972783268875,0.693287037037037,40.29017857142857,1038.8392857142853,38.47552910052909,0
244,4,0,0,27,0.0,0.0,1.0,27,400,300,100,0.75,5,3,2,422.1891634332426,0.7250712250712251,-0.003861229122577914,0.27272404516691323,134975.68835476888,5997.05459006518,140972.74294483406,243,9,187.44444444444446,27,0,20,29.247965296672877,0.6940586419753086,40.2157738095238,1039.136904761904,38.48655202821866,0
245,4,0,0,27,0.0,0.0,1.0,27,50,0,50,0.0,1,0,1,422.1891634332426,0.7250712250712251,-0.003861229122577914,0.27272404516691323,134975.68835476888,5997.05459006518,140972.74294483406,244,10,188.44444444444446,27,0,20,29.247965296672877,0.6940586419753086,40.2157738095238,1039.136904761904,38.48655202821866,0
246,4,0,0,27,0.0,0.0,1.0,27,350,200,150,0.5714285714285714,5,2,3,421.7309922223153,0.7253086419753086,-0.0017815954823829916,0.2730112122959102,135053.01616089136,5991.2085016298115,141044.22466252118,245,11,189.44444444444446,27,0,20,29.182325220711054,0.6948302469135803,40.141369047619044,1039.4345238095232,38.49757495590826,0
247,4,0,0,27,0.0,0.0,1.0,27,600,500,100,0.8333333333333334,7,5,2,420.2621773872759,0.7251899335232669,-0.0014842379233386271,0.272643624271578,135130.36611128823,5958.036378613942,141088.40248990216,246,12,190.44444444444446,27,0,20,29.14296192929727,0.6956018518518519,40.066964285714285,1039.7321428571424,38.508597883597865,0
248,4,0,2,25,0.0,0.07407407407407407,0.9259259259259259,27,750,500,250,0.6666666666666666,10,5,5,418.93569599734764,0.7263770180436847,-0.0029672018227093755,0.2726592658306758,135246.4325573979,5931.911670918358,141178.34422831627,247,13,191.44444444444446,27,0,20,29.06115879828327,0.6967592592592593,39.95535714285714,1040.1785714285709,38.52513227513226,0
249,4,0,0,25,0.0,0.0,1.0,25,500,300,200,0.6,7,3,4,445.85225925809067,0.7008333333333333,0.021833899351651587,0.28596345895781305,134717.09863987518,7012.784557856689,141729.88319773186,248,100,206.6,25,0,21,28.893305546979516,0.6991666666666667,40.4647435897436,1038.1410256410265,41.525641025641065,0
250,4,0,0,25,0.0,0.0,1.0,25,700,200,500,0.2857142857142857,12,2,10,445.85225925809067,0.7008333333333333,0.021833899351651587,0.28596345895781305,134717.09863987518,7012.784557856689,141729.88319773186,249,101,207.6,25,0,21,28.893305546979516,0.6991666666666667,40.4647435897436,1038.1410256410265,41.525641025641065,0
251,4,0,0,25,0.0,0.0,1.0,25,650,200,450,0.3076923076923077,11,2,9,472.75166313899376,0.7,0.005105008077544326,0.28973592028023465,133042.01388888876,7643.371959237319,140685.38584812608,250,102,208.6,24,1,20,29.890280021540118,0.6866319444444445,42.08333333333332,1031.6666666666656,42.986111111111065,8
252,4,0,0,25,0.0,0.0,1.0,25,550,400,150,0.7272727272727273,7,4,3,466.48542748565455,0.6990277777777778,0.016834241245136106,0.2819537978923171,132521.73028127057,7363.89120027943,139885.62148155,251,103,209.6,25,0,20,30.580252918287933,0.6770833333333333,42.58814102564103,1029.6474358974363,41.18589743589745,1
253,4,0,0,25,0.0,0.0,1.0,25,750,500,250,0.6666666666666666,10,5,5,467.18250776685227,0.6990277777777778,0.012943372744243842,0.2833065245212573,132645.51487508224,7393.932856673251,140039.4477317555,252,104,210.6,25,0,20,30.436501763119686,0.6783333333333332,42.46794871794872,1030.1282051282055,41.20512820512822,0
254,4,0,0,25,0.0,0.0,1.0,25,500,300,200,0.6,7,3,4,467.2793680815325,0.6980555555555555,0.01358842743817057,0.28367696481550275,132686.7892474113,7400.3598064595735,140087.14905387087,253,105,211.6,25,0,20,30.392071084149944,0.67875,42.42788461538462,1030.2884615384621,41.21153846153848,0
255,4,1,1,25,0.038461538461538464,0.038461538461538464,0.9615384615384616,26,600,300,300,0.5,9,3,6,454.4962629054042,0.7187179487179487,-0.0031082356733360683,0.2776000026265002,132914.6781169029,6881.844897881422,139796.52301478432,254,0,204.42307692307693,26,0,20,30.490185074329037,0.6770833333333333,42.20679012345679,1031.172839506173,39.6604938271605,0
256,4,0,0,25,0.0,0.0,1.0,25,800,700,100,0.875,9,7,2,466.7090741542487,0.6988888888888889,0.010351477449455748,0.28364266037918906,132728.07004026964,7389.07893655491,140117.14897682454,255,107,213.6,25,0,20,30.364826334888555,0.6791666666666667,42.38782051282052,1030.4487179487185,41.21794871794874,0
257,4,0,0,25,0.0,0.0,1.0,25,500,300,200,0.6,7,3,4,466.7090741542487,0.6988888888888889,0.010351477449455748,0.28364266037918906,132728.07004026964,7389.07893655491,140117.14897682454,256,108,214.6,25,0,20,30.364826334888555,0.6791666666666667,42.38782051282052,1030.4487179487185,41.21794871794874,0
258,4,1,1,25,0.038461538461538464,0.038461538461538464,0.9615384615384616,26,600,500,100,0.8333333333333334,7,5,2,453.98616223541,0.7115384615384616,-0.006212752249246778,0.278472612908803,133073.8573578723,6882.737959152566,139956.59531702485,257,0,207.30769230769232,26,0,20,30.34200817628875,0.6786858974358974,42.05246913580247,1031.7901234567903,39.68423551756886,0
259,4,0,0,25,0.0,0.0,1.0,25,700,600,100,0.8571428571428571,8,6,2,461.7246093750001,0.6969444444444445,0.006825000000000303,0.27160271139705894,131492.43918474697,7142.659023668654,138635.0982084156,258,110,216.6,25,0,21,31.75065104166667,0.6666666666666665,43.5897435897436,1025.6410256410263,41.02564102564105,7
260,4,0,0,25,0.0,0.0,1.0,25,500,400,100,0.8,6,4,2,463.51358795313973,0.6981944444444445,0.0071488829870332005,0.27294852589586477,131533.5337822569,7193.516035913903,138727.0498181708,259,111,217.6,25,0,21,31.662858667916485,0.6670833333333333,43.5496794871795,1025.8012820512836,41.03205128205134,0
261,4,0,0,25,0.0,0.0,1.0,25,500,200,300,0.4,8,2,6,465.39976709827926,0.6981944444444445,0.011044822739340932,0.2746502035696114,131615.74223886436,7250.787156886937,138866.5293957513,260,112,218.6,25,0,19,31.530630173356247,0.6679166666666667,43.46955128205129,1026.1217948717958,41.04487179487183,0
262,4,0,0,25,0.0,0.0,1.0,25,800,300,500,0.375,13,3,10,466.9012852834404,0.6970833333333334,0.01363934426229485,0.2761313695512869,131697.97637758878,7297.9908879848845,138995.96726557368,261,113,219.6,25,0,19,31.408242258652084,0.66875,43.38942307692308,1026.442307692308,41.05769230769232,0
263,4,1,1,25,0.038461538461538464,0.038461538461538464,0.9615384615384616,26,650,500,150,0.7692307692307693,8,5,3,449.2695398100805,0.7138461538461538,-0.004365904365904116,0.2681124673060156,132040.8950617283,6664.390432098753,138705.28549382708,262,0,212.1153846153846,26,0,19,31.511824324324323,0.6682692307692308,43.05555555555555,1027.7777777777771,39.52991452991451,0
264,4,0,0,25,0.0,0.0,1.0,25,450,300,150,0.6666666666666666,6,3,3,461.8076499257325,0.6975,0.012983770287140928,0.2740058722892681,131821.37573964504,7175.223948060495,138996.59968770554,263,115,221.6,25,0,19,31.413207449022053,0.6699999999999999,43.269230769230774,1026.9230769230774,41.076923076923094,0
265,4,0,0,25,0.0,0.0,1.0,25,650,400,250,0.6153846153846154,9,4,5,463.17741633222266,0.6984722222222223,0.013304212168486984,0.2754144006205517,131903.67408366204,7218.960593359628,139122.63467702168,264,116,222.6,25,0,19,31.294201768070725,0.6708333333333334,43.18910256410256,1027.2435897435896,41.089743589743584,0
266,4,0,0,25,0.0,0.0,1.0,25,550,300,250,0.5454545454545454,8,3,5,462.1971853136822,0.6983333333333334,0.010057713305257066,0.275129633709008,131944.83288646454,7196.906075361614,139141.73896182617,265,117,223.6,25,0,20,31.2774593147195,0.67125,43.14903846153847,1027.4038461538464,41.096153846153854,0
267,4,0,0,25,0.0,0.0,1.0,25,500,300,200,0.6,7,3,4,456.76343486039684,0.6983333333333334,0.05005347593582887,0.25700016980906226,129772.2638272518,6855.0449950690345,136627.30882232083,266,118,224.6,25,0,20,33.63741218412499,0.6491666666666667,45.2724358974359,1018.9102564102564,40.756410256410255,7
268,4,0,0,25,0.0,0.0,1.0,25,650,300,350,0.46153846153846156,10,3,7,456.4916594037549,0.6961111111111111,0.05558000628733084,0.2579218416631165,129935.60209155171,6862.903722879701,136798.5058144314,267,119,225.6,25,0,21,33.47676307240909,0.6508333333333333,45.112179487179496,1019.5512820512829,40.78205128205131,0
269,4,1,0,26,0.038461538461538464,0.0,1.0,26,650,500,150,0.7692307692307693,8,5,3,442.63943498605164,0.716474358974359,0.046610711337929045,0.25271312694587617,130341.36671715441,6338.8457837982,136680.21250095262,268,0,217.8846153846154,26,0,22,33.414563498060545,0.6510416666666666,44.714506172839506,1021.141975308642,39.2746913580247,0
270,4,0,0,26,0.0,0.0,1.0,26,800,600,200,0.75,10,6,4,443.57715149342886,0.7142948717948718,0.048165537438841666,0.25376293567286135,130420.17044372049,6370.2815405426045,136790.45198426308,269,1,218.8846153846154,26,0,23,33.31004179886185,0.6518429487179487,44.63734567901235,1021.4506172839508,39.286562203228875,0
271,4,2,2,26,0.07142857142857142,0.07142857142857142,0.9285714285714286,28,600,300,300,0.5,9,3,6,417.93536472760843,0.7409060846560847,0.022240601503759283,0.2426886286621199,130996.97625594535,5349.653809948477,136346.63006589384,270,0,204.17857142857142,28,0,20,33.377192982456144,0.6506696428571428,44.07327586206897,1023.7068965517245,36.56096059113302,0
272,4,1,0,27,0.037037037037037035,0.0,1.0,27,650,400,250,0.6153846153846154,9,4,5,426.2508602342101,0.7241215574548908,0.04312192390122016,0.2471967467698902,130947.07739866783,5763.260877267574,136710.33827593538,271,0,212.62962962962962,27,0,21,33.21520306290587,0.6535493827160493,44.12202380952381,1023.5119047619049,37.907848324514994,0
273,4,0,0,27,0.0,0.0,1.0,27,1050,800,250,0.7619047619047619,13,8,5,426.23894093795985,0.7250712250712251,0.04641874835160742,0.2479247804390617,131061.33355034716,5772.688802083328,136834.02235243047,272,1,213.62962962962962,27,0,22,33.09914377755172,0.6547067901234568,44.010416666666664,1023.9583333333328,37.924382716049365,0
274,4,0,0,27,0.0,0.0,1.0,27,1000,800,200,0.8,12,8,4,421.977398576726,0.7226970560303894,0.04278926609305844,0.24593314431867938,131137.53199847642,5667.414921697847,136804.94692017426,273,2,214.62962962962962,27,0,22,33.13069034820089,0.6554783950617283,43.936011904761905,1024.255952380952,37.93540564373897,0
275,4,0,1,26,0.0,0.037037037037037035,0.962962962962963,27,700,500,200,0.7142857142857143,9,5,4,432.92781033581815,0.7234093067426401,0.05307951855768733,0.24767062892072444,130420.17044372052,5936.354962098729,136356.52540581924,274,3,215.62962962962962,26,1,21,33.58198620133957,0.6518429487179487,44.63734567901235,1021.450617283951,39.28656220322888,4
276,4,1,0,27,0.037037037037037035,0.0,1.0,27,950,700,250,0.7368421052631579,12,7,5,432.4570452118193,0.722934472934473,0.059371069182390546,0.24891641394685518,130656.72451322207,5900.684204008541,136557.4087172306,275,0,216.44444444444446,26,1,21,33.35251572327045,0.6542467948717948,44.40586419753087,1022.3765432098766,39.322174738841404,0
277,4,2,1,28,0.06896551724137931,0.034482758620689655,0.9655172413793104,29,650,600,50,0.9230769230769231,7,6,1,407.9287906024741,0.7451765188834154,0.03178040868812748,0.23870025130167727,131291.310051691,4911.501065200142,136202.81111689113,276,0,202.44827586206895,28,1,22,33.33420954250199,0.6536458333333334,43.78591954022988,1024.8563218390796,36.60201149425284,0
278,4,0,0,28,0.0,0.0,1.0,28,400,200,200,0.5,6,2,4,417.84484717444315,0.7341820987654321,0.05268946625715931,0.24376643457193795,131175.63952664402,5362.2130102040865,136537.8525368481,277,1,210.67857142857142,27,1,23,33.19775324423785,0.6558641975308641,43.898809523809526,1024.4047619047622,37.940917107583786,0
279,4,0,0,28,0.0,0.0,1.0,28,400,300,100,0.75,5,3,2,418.93212174934405,0.7322530864197531,0.053731672141655196,0.24490359773084602,131254.50026423577,5397.345256969226,136651.845521205,278,2,211.67857142857142,28,0,23,33.089713030473,0.6532738095238095,43.821839080459775,1024.7126436781614,36.59688013136291,0
280,4,1,1,28,0.034482758620689655,0.034482758620689655,0.9655172413793104,29,800,400,400,0.5,12,4,8,407.76794376564516,0.7464080459770115,0.04077473936326892,0.2404517660140769,131585.97414205965,4931.329064275323,136517.30320633497,279,0,205.3448275862069,28,1,20,33.039256873453766,0.656622023809524,43.4985632183908,1026.0057471264363,36.643062397372724,0
281,4,0,0,28,0.0,0.0,1.0,28,750,500,250,0.6666666666666666,10,5,5,417.4412686371845,0.7315917107583774,0.05271121797529199,0.24547826138630335,131480.69905045352,5377.093962585033,136857.79301303855,280,4,213.67857142857142,27,1,23,32.89804604372216,0.6589506172839507,43.601190476190474,1025.595238095238,37.98500881834215,0
282,4,0,0,28,0.0,0.0,1.0,28,700,500,200,0.7142857142857143,9,5,4,416.26426859749057,0.7281194885361552,0.05630891950688932,0.24552114046019644,131595.1877170138,5355.674913194434,136950.86263020823,281,5,214.67857142857142,27,1,20,32.8119712351946,0.660108024691358,43.48958333333333,1026.0416666666658,38.00154320987651,0
283,4,0,0,28,0.0,0.0,1.0,28,750,600,150,0.8,9,6,3,413.6613190035545,0.7271825396825397,0.04946568363500825,0.24472004961290889,131709.72620819148,5296.643813775493,137006.37002196698,282,6,215.67857142857142,27,1,20,32.76251570503528,0.6612654320987654,43.37797619047618,1026.4880952380943,38.0180776014109,0
284,4,0,0,28,0.0,0.0,1.0,28,950,700,250,0.7368421052631579,12,7,5,411.5631004447664,0.7247574955908289,0.044986960301361734,0.2444585644810478,131862.5217013888,5253.949652777758,137116.47135416654,283,7,216.67857142857142,27,1,21,32.66142663962137,0.6628086419753088,43.22916666666666,1027.0833333333323,38.040123456790084,0
285,4,0,0,28,0.0,0.0,1.0,28,650,400,250,0.6153846153846154,9,4,5,440.1765619075022,0.7247574955908289,0.06603937589638798,0.24074215623793022,128652.84684118284,5779.16196321065,134432.0088043935,284,8,217.67857142857142,26,2,20,35.209410810262646,0.6338141025641024,46.37345679012346,1014.5061728395069,39.01946818613488,7
286,4,1,1,28,0.034482758620689655,0.034482758620689655,0.9655172413793104,29,750,500,250,0.6666666666666666,10,5,5,424.1029980810318,0.7385057471264368,0.06666471683581454,0.23474996936034587,129128.3628121285,5152.74516118379,134281.1079733123,285,0,211.13793103448276,28,1,21,35.1289345961738,0.6316964285714285,45.90517241379311,1016.3793103448282,36.299261083743865,0
287,4,1,0,29,0.034482758620689655,0.0,1.0,29,950,800,150,0.8421052631578947,11,8,3,424.73998358601983,0.7451765188834154,0.07372732592159159,0.23644320258909052,129352.72285997734,5188.275320284676,134540.99818026202,286,0,211.75862068965517,27,2,22,34.882728691242434,0.6373456790123456,45.68452380952381,1017.2619047619048,37.67636684303351,0
288,4,0,0,29,0.0,0.0,1.0,29,400,200,200,0.5,6,2,4,427.9125623280462,0.7450738916256158,0.07949491180119184,0.2386677080912872,129428.42306193318,5276.809630102048,134705.23269203524,287,1,212.75862068965517,27,2,17,34.72445646875304,0.6381172839506173,45.61011904761905,1017.5595238095243,37.68738977072312,0
289,4,2,3,28,0.06451612903225806,0.0967741935483871,0.9032258064516129,31,800,500,300,0.625,11,5,6,405.043623336643,0.7686379928315412,0.060650257212267134,0.22931652476183279,130014.58574459885,4332.315779320999,134346.90152391986,288,0,199.96774193548387,29,2,19,34.70751622860775,0.6375718390804597,45.03472222222223,1019.8611111111118,35.16762452107282,0
290,4,1,0,29,0.034482758620689655,0.0,1.0,29,700,500,200,0.7142857142857143,9,5,4,427.52958635794863,0.7397372742200328,0.08023928797237478,0.24018896729618514,129713.14944180219,5291.241825208099,135004.3912670103,289,0,214.6551724137931,28,1,20,34.44258345086977,0.6376488095238095,45.33045977011495,1018.678160919541,36.381362889983606,0
291,4,2,1,30,0.06451612903225806,0.03225806451612903,0.967741935483871,31,500,400,100,0.8,6,4,2,403.64461536822074,0.7603942652329749,0.062497806170802805,0.23040335498347508,130333.487654321,4322.843290798724,134656.33094511973,290,0,201.74193548387098,29,2,22,34.41807217990569,0.6408045977011494,44.72222222222222,1021.1111111111112,35.21072796934866,0
292,4,0,0,30,0.0,0.0,1.0,30,550,300,250,0.5454545454545454,8,3,5,412.32819658475626,0.7473659003831418,0.08040816326530598,0.23493118177503572,130262.58680555562,4742.18750000001,135004.77430555562,291,1,209.46666666666667,28,2,22,34.2687074829932,0.6432291666666666,44.79166666666667,1020.8333333333339,36.45833333333336,0
293,4,0,0,30,0.0,0.0,1.0,30,700,400,300,0.5714285714285714,10,4,6,411.8903414967702,0.7475095785440613,0.08209025236889023,0.23490311129021246,130299.25724996685,4733.801113092862,135033.0583630597,292,2,210.46666666666667,28,2,22,34.24248287831879,0.6436011904761905,44.75574712643677,1020.9770114942519,36.463464696223284,0
294,4,1,1,30,0.03225806451612903,0.03225806451612903,0.967741935483871,31,850,700,150,0.8235294117647058,10,7,3,401.2175744601859,0.7576164874551972,0.0703023289454654,0.23048869090183505,130581.79253472218,4278.342013888884,134860.13454861107,293,0,204.6451612903226,29,2,17,34.22722176926213,0.6433189655172413,44.479166666666664,1022.0833333333329,35.244252873563205,0
295,4,1,0,31,0.03225806451612903,0.0,1.0,31,850,600,250,0.7058823529411765,11,6,5,400.7212632643193,0.7628136200716846,0.07914901447078426,0.23105016925725808,130723.78713348777,4276.760223765448,135000.5473572532,294,0,205.61290322580646,29,2,18,34.09544909230839,0.6447557471264367,44.340277777777786,1022.6388888888898,35.26340996168586,0
296,4,0,0,31,0.0,0.0,1.0,31,800,500,300,0.625,11,5,6,402.39587524524933,0.7612903225806451,0.07818145982524127,0.23244279381813823,130794.81336805562,4326.25868055556,135121.07204861118,295,1,206.61290322580646,29,2,19,33.98039714867616,0.6454741379310345,44.270833333333336,1022.9166666666672,35.27298850574714,0
297,4,0,0,31,0.0,0.0,1.0,31,400,300,100,0.75,5,3,2,399.8978509253095,0.7616487455197133,0.07677822252196242,0.2312125251111327,130830.33371913583,4263.7538580246965,135094.08757716054,296,2,207.61290322580646,29,2,19,34.008168160014485,0.6458333333333333,44.236111111111114,1023.0555555555558,35.277777777777786,0
298,4,0,1,30,0.0,0.03225806451612903,0.967741935483871,31,1100,900,200,0.8181818181818182,13,9,4,402.9506302704968,0.7613799283154122,0.08097566527606936,0.23362259594518428,130936.92370756181,4352.2231867284045,135289.14689429023,297,3,208.61290322580646,29,2,20,33.82172501922468,0.6469109195402298,44.13194444444445,1023.472222222223,35.292145593869755,0
299,4,0,0,30,0.0,0.0,1.0,30,650,300,350,0.46153846153846156,10,3,7,416.02162431696695,0.7533524904214559,0.08729980331553788,0.23997098232481123,130739.7051294755,4878.108898137139,135617.81402761262,298,4,216.3,28,2,20,33.68806780930972,0.648065476190476,44.32471264367816,1022.7011494252874,36.52504105090312,0
300,4,1,1,30,0.03225806451612903,0.03225806451612903,0.967741935483871,31,850,400,450,0.47058823529411764,13,4,9,404.67288049200823,0.7666666666666667,0.0733672981065272,0.2351177216405513,131018.32807622272,4403.912843970405,135422.24092019312,299,0,210.29032258064515,30,1,21,33.694914883374906,0.6447916666666667,44.05241935483871,1023.7903225806455,34.12634408602152,0
301,4,0,0,30,0.0,0.0,1.0,30,900,500,400,0.5555555555555556,13,5,8,415.7603794204714,0.7525862068965518,0.09283387622149841,0.24082723864544284,130901.38888888885,4884.722222222217,135786.11111111107,300,6,218.3,29,1,21,33.53013029315961,0.646551724137931,44.166666666666664,1023.3333333333329,35.28735632183906,0
302,4,1,0,31,0.03225806451612903,0.0,1.0,31,950,700,250,0.7368421052631579,12,7,5,404.11062702182187,0.7657706093189964,0.08573653515714286,0.23584465537215346,131190.39231414022,4403.0863394611915,135593.4786536014,301,0,212.2258064516129,30,1,22,33.53450537916558,0.6465277777777778,43.88440860215053,1024.4623655913967,34.14874551971322,0
303,4,0,0,31,0.0,0.0,1.0,31,850,500,350,0.5882352941176471,12,5,7,404.19062727212645,0.7629032258064516,0.08654602675058998,0.2367402245451026,131328.125,4416.391707133774,135744.51670713376,302,1,213.2258064516129,29,2,22,33.39261517615175,0.6508620689655173,43.75,1025.0,35.3448275862069,0
304,4,1,0,32,0.03125,0.0,1.0,32,800,400,400,0.5,12,4,8,391.9002090433044,0.7740255376344086,0.07320205479452069,0.2319625561634693,131728.82080078116,3924.9104817708194,135653.73128255198,303,0,207.53125,31,1,17,33.30162354134956,0.6491935483870969,43.35937499999999,1026.5624999999993,33.11491935483869,0
305,4,0,0,32,0.0,0.0,1.0,32,900,600,300,0.6666666666666666,12,6,6,390.9843899673954,0.7729754704301076,0.07106017872987724,0.23243977787888334,131895.95752292202,3913.8520982530295,135809.80962117505,304,1,208.53125,31,1,19,33.1560030844636,0.6508736559139785,43.19661458333333,1027.213541666666,33.135920698924714,0
306,4,0,0,32,0.0,0.0,1.0,32,900,500,400,0.5555555555555556,13,5,8,383.2334188916129,0.7725974462365592,0.04259194451514392,0.2217561270729229,130861.4179823133,3630.0937228732587,134491.51170518657,305,2,209.53125,31,1,20,34.402837872232126,0.6404569892473118,44.205729166666664,1023.1770833333328,33.00571236559138,2
307,4,1,0,33,0.030303030303030304,0.0,1.0,33,550,300,250,0.5454545454545454,8,3,5,373.731333811841,0.7803819444444445,0.04384077461000535,0.21779515660069376,131134.0679522499,3201.7820247933996,134335.84997704328,306,0,204.15151515151516,32,1,21,34.36960675542405,0.640625,43.939393939393945,1024.2424242424252,32.007575757575786,0
308,4,0,0,33,0.0,0.0,1.0,33,700,400,300,0.5714285714285714,10,4,6,374.0112929818365,0.7806976010101011,0.04138003152052927,0.21832572886723897,131198.73769258245,3213.9619043975167,134412.69959697998,307,1,205.15151515151516,32,1,21,34.29694560841343,0.6412760416666666,43.87626262626263,1024.49494949495,32.01546717171719,0
309,4,0,1,32,0.0,0.030303030303030304,0.9696969696969697,33,650,500,150,0.7692307692307693,8,5,3,375.57225309405925,0.7809343434343435,0.04187762295204389,0.21960694568525843,131263.42337516593,3259.779933170103,134523.20330833603,308,2,206.15151515151516,32,1,21,34.19146336454741,0.6419270833333333,43.81313131313132,1024.7474747474757,32.02335858585862,0
310,4,0,0,32,0.0,0.0,1.0,32,650,400,250,0.6153846153846154,9,4,5,387.114087225973,0.7712953629032259,0.045695080091533224,0.22555847482366675,131128.00598144528,3752.2996690538193,134880.3056504991,309,3,213.4375,31,1,21,34.033074836850595,0.6431451612903225,43.9453125,1024.2187499999998,33.039314516129025,0
311,4,0,0,32,0.0,0.0,1.0,32,550,300,250,0.5454545454545454,8,3,5,388.7612830773637,0.7710853494623656,0.04838210064811288,0.22710931971312345,131228.0464172362,3803.2767401801075,135031.3231574163,310,4,214.4375,31,1,21,33.88944486804762,0.6441532258064517,43.84765624999999,1024.609374999999,33.05191532258062,0
312,4,0,0,32,0.0,0.0,1.0,32,750,400,350,0.5333333333333333,11,4,7,391.96245620992795,0.7711273521505377,0.053607723577235644,0.229578010065815,131328.125,3895.1770358615454,135223.30203586153,311,5,215.4375,30,2,21,33.70596205962059,0.6479166666666667,43.75,1025.0,34.166666666666664,0
313,4,0,1,31,0.0,0.03125,0.96875,32,700,500,200,0.7142857142857143,9,5,4,392.4382034119873,0.7711273521505377,0.05352812008390151,0.23027066274051058,131397.0184414383,3913.041970169958,135310.06041160825,312,6,216.4375,30,2,21,33.623929382975014,0.6486111111111111,43.68279569892473,1025.2688172043008,34.17562724014336,0
314,4,1,1,31,0.03125,0.03125,0.96875,32,850,500,350,0.5882352941176471,12,5,7,393.6303434770288,0.7656670026881721,0.06380076142132007,0.23217119061369637,131595.1877170137,3959.9717881944216,135555.1595052081,313,0,216.84375,31,1,19,33.392554991539775,0.6478494623655915,43.48958333333332,1026.0416666666652,33.098118279569846,0
315,4,0,0,31,0.0,0.0,1.0,31,750,400,350,0.5333333333333333,11,4,7,409.5586363830443,0.7573476702508961,0.09353295261614458,0.2335733282614695,130299.25724996686,4477.920036703973,134777.17728667083,314,8,224.83870967741936,28,3,21,34.301998311286226,0.6436011904761905,44.75574712643677,1020.977011494252,36.463464696223284,6
316,4,0,0,31,0.0,0.0,1.0,31,1000,800,200,0.8,12,8,4,405.0554850824425,0.7581541218637993,0.08810568824073628,0.23226759187463197,130510.82417052463,4372.8250385802385,134883.6492091049,315,9,225.83870967741936,29,2,19,34.20141248697385,0.6426005747126438,44.54861111111111,1021.8055555555551,35.2346743295019,0
317,4,0,0,31,0.0,0.0,1.0,31,650,300,350,0.46153846153846156,10,3,7,403.6497938213531,0.7600358422939069,0.08379822166518425,0.2323116600718513,130652.78018904317,4347.593557098763,135000.37374614194,316,10,226.83870967741936,29,2,20,34.09282592944799,0.644037356321839,44.40972222222222,1022.3611111111109,35.25383141762451,0
318,4,2,1,32,0.06060606060606061,0.030303030303030304,0.9696969696969697,33,950,900,50,0.9473684210526315,10,9,1,379.50047480537415,0.777304292929293,0.06877004894542083,0.22169927514799453,131228.04641723618,3360.2211846245514,134588.26760186075,317,0,214.03030303030303,31,2,21,34.126662642436585,0.6441532258064517,43.84765624999999,1024.6093749999989,33.051915322580605,0
319,4,0,1,31,0.0,0.03125,0.96875,32,650,400,250,0.6153846153846154,9,4,5,388.35381005607513,0.7681031586021506,0.07814754689754722,0.22685219111551405,131224.81871097808,3792.331664065211,135017.1503750433,318,1,221.71875,30,2,21,33.90315492588222,0.646875,43.850806451612904,1024.596774193548,34.1532258064516,0
320,4,0,0,31,0.0,0.0,1.0,31,850,600,250,0.7058823529411765,11,6,5,400.04301242564173,0.7613799283154122,0.055145658275570275,0.2315095736480521,130865.85889274688,4270.394483024685,135136.25337577157,319,2,228.3548387096774,29,2,21,33.96834419257046,0.6461925287356323,44.201388888888886,1023.1944444444442,35.28256704980842,2
321,4,0,0,31,0.0,0.0,1.0,31,550,300,250,0.5454545454545454,8,3,5,400.04301242564173,0.7613799283154122,0.055145658275570275,0.2315095736480521,130865.85889274688,4270.394483024685,135136.25337577157,320,3,229.3548387096774,29,2,21,33.96834419257046,0.6461925287356323,44.201388888888886,1023.1944444444442,35.28256704980842,0
322,4,1,1,31,0.03125,0.03125,0.96875,32,700,500,200,0.7142857142857143,9,5,4,397.55852453353856,0.7752436155913979,0.06335260972716483,0.22492740683340468,129988.3137682102,3935.5924456584607,133923.90621386864,321,0,223.15625,30,2,21,34.92514608321251,0.634375,45.060483870967744,1019.758064516129,33.99193548387097,3
323,4,0,0,31,0.0,0.0,1.0,31,700,500,200,0.7142857142857143,9,5,4,408.29560706134606,0.7648745519713261,0.08077257669089022,0.23094810069679544,129979.17631172853,4413.985339506196,134393.16165123472,322,1,231.2258064516129,29,2,21,34.66074185054028,0.6372126436781608,45.06944444444446,1019.7222222222233,35.16283524904218,0
324,4,1,0,32,0.03125,0.0,1.0,32,950,700,250,0.7368421052631579,12,7,5,396.0024238227148,0.7713373655913979,0.08779605263157908,0.22662789315155366,130434.1542374841,3930.4482454619047,134364.602482946,323,0,224.96875,30,2,22,34.51069078947368,0.6388888888888888,44.623655913978496,1021.505376344086,34.05017921146953,0
325,4,0,0,32,0.0,0.0,1.0,32,650,400,250,0.6153846153846154,9,4,5,393.7300732488391,0.7712953629032259,0.0873536569323865,0.2257266981023888,130502.81282518215,3876.5764105677063,134379.38923574984,324,1,225.96875,30,2,21,34.498870911163735,0.6395833333333333,44.55645161290323,1021.7741935483875,34.059139784946254,0
326,4,0,0,32,0.0,0.0,1.0,32,700,600,100,0.8571428571428571,8,6,2,393.7418944933182,0.7717153897849462,0.08331004208864945,0.2259335565156753,130537.1488936582,3879.5888614290666,134416.73775508726,325,2,226.96875,30,2,21,34.463643737121316,0.6399305555555554,44.52284946236559,1021.9086021505375,34.06362007168458,0
327,4,0,0,32,0.0,0.0,1.0,32,1000,700,300,0.7,13,7,6,394.06459901073777,0.7712113575268817,0.0846523668639052,0.22652012664222673,130605.83457986469,3893.427166435421,134499.26174630012,326,3,227.96875,30,2,21,34.38554678939295,0.640625,44.45564516129032,1022.1774193548384,34.07258064516128,0
328,4,0,0,32,0.0,0.0,1.0,32,1100,900,200,0.8181818181818182,13,9,4,397.1653592254471,0.7712533602150539,0.08533180026281229,0.22931930073639226,130777.62783269741,3988.068707365015,134765.69654006243,327,4,228.96875,30,2,22,34.13162505475253,0.642361111111111,44.28763440860215,1022.8494623655913,34.09498207885304,0
329,4,0,1,31,0.0,0.03125,0.96875,32,600,300,300,0.5,9,3,6,395.09698713669155,0.770455309139785,0.08587488503481788,0.2283282588532542,130812.00003251818,3936.6854188345396,134748.6854513527,328,5,229.96875,30,2,22,34.14958612534489,0.6427083333333334,44.25403225806451,1022.9838709677416,34.099462365591386,0
330,4,0,0,31,0.0,0.0,1.0,31,600,300,300,0.5,9,3,6,404.515622083666,0.7622759856630824,0.103951415726792,0.23302378793270354,130688.28125000001,4373.0902777777765,135061.37152777778,329,6,237.67741935483872,29,2,22,34.03456941048627,0.6443965517241379,44.375,1022.5000000000001,35.258620689655174,0
331,4,0,0,31,0.0,0.0,1.0,31,800,600,200,0.75,10,6,4,404.7054909611616,0.7624551971326164,0.10412130399162334,0.23334741816343235,130723.78713348757,4380.926890432085,135104.71402391966,330,7,238.67741935483872,29,2,22,33.99358843768391,0.6447557471264368,44.34027777777777,1022.6388888888882,35.2634099616858,0
332,4,1,1,31,0.03125,0.03125,0.96875,32,550,400,150,0.7272727272727273,7,4,3,393.6842350321984,0.7746135752688172,0.0949154629021669,0.22832486289186515,130949.53399598214,3910.553423806216,134860.08741978835,331,0,232.1875,30,2,22,34.04601663383673,0.6440972222222222,44.119623655913976,1023.5215053763437,34.11738351254479,0
333,4,1,0,32,0.03125,0.0,1.0,32,650,500,150,0.7692307692307693,8,5,3,394.2494048825649,0.7726394489247312,0.1016260829614073,0.22926656232025797,131052.73189097001,3933.49231124985,134986.22420221986,332,0,233.15625,30,2,23,33.92677430646713,0.6451388888888889,44.01881720430107,1023.9247311827953,34.13082437275985,0
334,4,1,1,32,0.030303030303030304,0.030303030303030304,0.9696969696969697,33,600,200,400,0.3333333333333333,10,2,8,382.52866856273454,0.7762784090909092,0.08556196469148758,0.22445605259973378,131397.01844143827,3452.914354260602,134849.93279569887,333,0,227.06060606060606,30,3,23,33.87792780982346,0.6486111111111111,43.68279569892473,1025.2688172043006,34.175627240143356,0
335,4,0,0,32,0.0,0.0,1.0,32,750,600,150,0.8,9,6,3,404.7463200364364,0.7697412634408602,0.08263870585134425,0.22919515495794618,130022.58209041513,4125.2323245461985,134147.81441496132,334,2,235.15625,30,2,21,34.70693858724302,0.6347222222222222,45.02688172043011,1019.89247311828,33.99641577060933,2
336,4,0,1,31,0.0,0.03125,0.96875,32,450,200,250,0.4444444444444444,7,2,5,403.3963973816181,0.7699932795698925,0.08680006587615274,0.22883248551020044,130091.13228407913,4095.658818938609,134186.79110301772,335,3,236.15625,30,2,21,34.671442687747025,0.6354166666666666,44.95967741935484,1020.161290322581,34.00537634408603,0
337,4,1,0,32,0.03125,0.0,1.0,32,950,700,250,0.7368421052631579,12,7,5,405.7945173763672,0.7641549059139786,0.12051386623164806,0.23247854126328318,130475.34722222212,4189.349021563177,134664.6962437853,336,0,237.03125,29,3,23,34.21866503534531,0.642241379310345,44.58333333333333,1021.6666666666657,35.22988505747123,0
338,4,1,0,33,0.030303030303030304,0.0,1.0,33,950,700,250,0.7368421052631579,12,7,5,405.251154154404,0.7771464646464648,0.10446215498221445,0.22918825776967547,129972.73875114789,3934.320477502301,133907.05922865018,337,0,230.8181818181818,32,1,20,34.744923229321444,0.62890625,45.07575757575758,1019.69696969697,31.86553030303031,3
339,4,0,0,33,0.0,0.0,1.0,33,1100,900,200,0.8181818181818182,13,9,4,397.37385753866266,0.7764362373737375,0.09433347929087121,0.22868060586286804,130649.55305899908,3783.343376951334,134432.89643595042,338,1,231.8181818181818,32,1,19,34.256514758552555,0.6357421875,44.41287878787879,1022.3484848484849,31.948390151515152,1
340,4,0,0,33,0.0,0.0,1.0,33,1050,800,250,0.7619047619047619,13,8,5,397.0672153635116,0.7759627525252526,0.09077441077441062,0.22907723963279522,130746.3842975207,3783.020546372823,134529.4048438935,339,2,232.8181818181818,32,1,19,34.165895061728406,0.63671875,44.31818181818182,1022.727272727273,31.96022727272728,0
341,4,0,1,32,0.0,0.030303030303030304,0.9696969696969697,33,1250,1200,50,0.96,13,12,1,392.92473414527956,0.7776988636363638,0.0886143128373027,0.22821158627864802,131004.77629833682,3695.0033797571577,134699.77967809397,340,3,233.8181818181818,32,1,19,34.00936318039796,0.6393229166666667,44.06565656565656,1023.737373737373,31.991792929292906,0
342,4,1,0,33,0.030303030303030304,0.0,1.0,33,950,700,250,0.7368421052631579,12,7,5,392.0388538397163,0.7828282828282829,0.09225680483534404,0.22942893847274526,131295.7721948015,3694.608809050093,134990.3810038516,341,0,225.15151515151516,32,1,20,33.736807523304996,0.6422526041666667,43.781565656565654,1024.873737373737,32.02730429292928,0
343,4,0,0,33,0.0,0.0,1.0,33,700,400,300,0.5714285714285714,10,4,6,387.6543236957441,0.7819602272727273,0.09344139900401016,0.22745083046052833,131394.8652479384,3587.1615105193,134982.0267584577,342,1,226.15151515151516,31,2,21,33.74872999745998,0.6458333333333333,43.684895833333336,1025.260416666667,33.07291666666668,0
344,4,1,1,33,0.029411764705882353,0.029411764705882353,0.9705882352941176,34,950,800,150,0.8421052631578947,11,8,3,378.7121635053987,0.7902926322043969,0.08528326459735203,0.22408514478157893,131716.66953627198,3176.5409779614547,134893.21051423342,343,0,220.47058823529412,32,2,21,33.652367773677746,0.646484375,43.37121212121213,1026.5151515151529,32.07859848484853,0
345,4,1,1,33,0.029411764705882353,0.029411764705882353,0.9705882352941176,34,950,800,150,0.8421052631578947,11,8,3,377.8240776315619,0.7870246583481878,0.09138113076555898,0.22432270419380507,131846.3119197023,3162.9422380369638,135009.25415773925,344,0,221.44117647058823,32,2,22,33.54412548151791,0.6477864583333333,43.24494949494951,1027.020202020204,32.09438131313137,0
346,4,0,0,33,0.0,0.0,1.0,33,700,600,100,0.8571428571428571,8,6,2,387.1820079488876,0.7788825757575758,0.10257356616148794,0.22876825986905067,131661.9957817927,3595.431179470511,135257.4269612632,345,4,229.15151515151516,31,2,22,33.49033663198851,0.648521505376344,43.42447916666668,1026.3020833333348,33.10651881720435,0
347,4,1,1,33,0.029411764705882353,0.029411764705882353,0.9705882352941176,34,550,400,150,0.7272727272727273,7,4,3,378.23483479649065,0.7862448009506834,0.08795328826060222,0.22475824551274326,131878.73247946656,3176.2261185083353,135054.9585979749,346,0,223.38235294117646,32,2,22,33.50081950419997,0.6481119791666665,43.21338383838385,1027.146464646466,32.09832702020206,0
348,4,0,1,32,0.0,0.030303030303030304,0.9696969696969697,33,1200,800,400,0.6666666666666666,16,8,8,389.6681167898725,0.7775410353535355,0.1010843637285519,0.23165725496272094,131895.95752292222,3679.1298760308346,135575.08739895307,347,6,231.15151515151516,31,2,22,33.1898054252757,0.6508736559139784,43.19661458333334,1027.2135416666679,33.13592069892477,0
349,4,1,0,33,0.030303030303030304,0.0,1.0,33,750,700,50,0.9333333333333333,8,7,1,382.26048062482107,0.7866950757575758,0.16805039172031555,0.21081551057213202,128983.44574502605,3261.0547926278477,132244.5005376539,348,0,223.0,33,0,17,36.340204890014874,0.6164772727272727,46.047794117647065,1015.8088235294126,30.782085561497354,7
350,4,1,1,33,0.029411764705882353,0.029411764705882353,0.9705882352941176,34,750,600,150,0.8,9,6,3,370.2146849569141,0.7987225193107547,0.1581458324472229,0.20562526477727402,129263.69214965405,2771.247386822378,132034.93953647642,349,0,217.41176470588235,33,1,17,36.360167108540196,0.6193181818181819,45.77205882352941,1016.9117647058829,30.81550802139039,0
351,4,0,1,32,0.0,0.030303030303030304,0.9696969696969697,33,700,500,200,0.7142857142857143,9,5,4,379.11572513996504,0.7875631313131314,0.1684866026400038,0.20957517285737254,129076.82742214529,3187.0110053825397,132263.83842752784,350,2,225.0,33,0,17,36.324670365010455,0.6174242424242424,45.955882352941174,1016.1764705882349,30.793226381461665,0
352,4,2,2,32,0.058823529411764705,0.058823529411764705,0.9411764705882353,34,850,700,150,0.8235294117647058,10,7,3,366.0027806549574,0.7988710635769459,0.16464071177604,0.20425316468808907,129450.69204152247,2675.922722029983,132126.61476355247,351,0,218.94117647058823,33,1,16,36.27669396274887,0.6212121212121213,45.588235294117645,1017.6470588235293,30.837789661319068,0
353,4,0,0,32,0.0,0.0,1.0,32,750,600,150,0.8,9,6,3,388.0005374899217,0.7747815860215055,0.19134221311475375,0.2151639344262295,129201.38888888896,3626.041666666672,132827.43055555565,352,4,233.625,31,1,17,35.97165300546446,0.6236559139784945,45.833333333333336,1016.6666666666673,32.795698924731205,0
354,4,1,1,32,0.030303030303030304,0.030303030303030304,0.9696969696969697,33,800,500,300,0.625,11,5,6,378.17111316976565,0.7820391414141414,0.17835268539493931,0.21154662876102617,129544.24267409151,3197.978091359071,132742.2207654506,353,0,227.5151515151515,33,0,16,35.87172966574374,0.622159090909091,45.496323529411754,1018.0147058823514,30.84893048128338,0
355,4,0,0,32,0.0,0.0,1.0,32,1050,900,150,0.8571428571428571,12,9,3,390.1975875721174,0.7710853494623656,0.1955024813895787,0.21779726840936742,129458.25043362913,3702.8594021018184,133161.10983573095,354,6,235.625,32,0,16,35.65343258891645,0.6236979166666667,45.580808080808076,1017.676767676767,31.80239898989897,0
356,4,1,1,32,0.030303030303030304,0.030303030303030304,0.9696969696969697,33,1050,800,250,0.7619047619047619,13,8,5,373.51708629812975,0.7803030303030304,0.18034638279889537,0.21078121599917524,129887.55076172623,3103.0439013840787,132990.5946631103,355,0,229.45454545454547,33,0,16,35.64057866474312,0.6256313131313131,45.15931372549019,1019.362745098039,30.88978015448603,0
357,4,0,0,32,0.0,0.0,1.0,32,800,400,400,0.5,12,4,8,381.4471296727639,0.770455309139785,0.18799959722394344,0.2144875881065876,129747.52456700847,3498.3641656463597,133245.88873265483,356,8,237.625,32,0,16,35.58113355640929,0.6266276041666667,45.29671717171717,1018.8131313131313,31.837910353535353,0
358,4,0,0,32,0.0,0.0,1.0,32,600,400,200,0.6666666666666666,8,4,4,378.947121830614,0.771463373655914,0.1828421199355721,0.21343211586147115,129811.85154894892,3438.3655047954076,133250.21705374433,357,9,238.625,32,0,17,35.57928592078635,0.6272786458333335,45.23358585858585,1019.0656565656552,31.845801767676726,0
359,4,0,0,32,0.0,0.0,1.0,32,900,700,200,0.7777777777777778,11,7,4,380.509656950608,0.7707913306451614,0.1847948916408666,0.21501857801792595,129940.55333958282,3488.7270750433768,133429.2804146262,358,10,239.625,32,0,17,35.40841073271413,0.6285807291666666,45.10732323232324,1019.5707070707081,31.861584595959627,0
360,4,0,0,32,0.0,0.0,1.0,32,750,500,250,0.6666666666666666,10,5,5,382.6507671708604,0.7722614247311829,0.1680907578084998,0.21291081147711974,129333.80126953125,3505.3049608099623,132839.10623034122,359,11,240.625,31,1,19,35.97243556920976,0.625,45.703125,1017.1875,32.8125,4
361,4,0,0,32,0.0,0.0,1.0,32,1050,800,250,0.7619047619047619,13,8,5,382.1267278136487,0.7716313844086022,0.16759327403046198,0.21279801314383734,129366.9149610732,3486.9111802842986,132853.8261413575,360,12,241.625,31,1,20,35.95196574085926,0.6253360215053763,45.67057291666667,1017.3177083333339,32.81670026881722,0
362,4,1,0,33,0.030303030303030304,0.0,1.0,33,900,500,400,0.5555555555555556,13,5,8,370.70821609440725,0.7857481060606061,0.17243980019019123,0.2090291683564193,129856.32216274986,3027.761107506724,132884.08327025658,361,0,235.27272727272728,33,0,18,35.74393310889343,0.6253156565656566,45.189950980392155,1019.240196078431,30.886066547831245,0
363,4,0,0,33,0.0,0.0,1.0,33,1000,600,400,0.6,14,6,8,375.44789231695376,0.782907196969697,0.17798843795960573,0.2128902081502945,130075.001201461,3167.277008842755,133242.27821030375,362,1,236.27272727272728,33,0,18,35.400648726573756,0.6275252525252526,44.97549019607843,1020.0980392156864,30.91206179441474,0
364,4,0,0,33,0.0,0.0,1.0,33,850,600,250,0.7058823529411765,11,6,5,378.6634195657597,0.7818813131313131,0.18505622923920462,0.21557673421484708,130231.31315179256,3262.766874519412,133494.08002631197,363,2,237.27272727272728,33,0,19,35.15965802217152,0.6291035353535354,44.822303921568626,1020.7107843137253,30.930629827688644,0
365,4,0,0,33,0.0,0.0,1.0,33,750,500,250,0.6666666666666666,10,5,5,380.0883163539347,0.781171085858586,0.18370650121391963,0.21710129256148483,130359.2745638201,3309.6111925820915,133668.8857564022,364,3,238.27272727272728,32,1,19,34.993199802176065,0.6328125,44.6969696969697,1021.2121212121218,31.912878787878807,0
366,4,2,2,33,0.05714285714285714,0.05714285714285714,0.9428571428571428,35,950,800,150,0.8421052631578947,11,8,3,362.5948831929311,0.7909663865546218,0.16516696014604015,0.21025747882459594,130942.84664619763,2495.841236925578,133438.6878831232,365,0,225.6,35,0,17,34.848302800708666,0.6318452380952382,44.126157407407405,1023.4953703703698,29.24272486772485,0
367,4,0,0,33,0.0,0.0,1.0,33,900,500,400,0.5555555555555556,13,5,8,381.4836961836699,0.7796717171717172,0.18616067214198062,0.22018415825372817,130763.47588667825,3376.8268214148466,134140.3027080931,366,5,240.27272727272728,33,0,17,34.546988577362406,0.6344696969696969,44.3014705882353,1022.7941176470592,30.993761140819977,0
368,4,0,0,33,0.0,0.0,1.0,33,1000,700,300,0.7,13,7,6,381.3067150609172,0.7793560606060607,0.18831505859892506,0.22061883326705475,130857.49959450703,3379.3686622933656,134236.8682568004,367,6,241.27272727272728,33,0,17,34.456097536631155,0.6354166666666665,44.20955882352942,1023.1617647058832,31.00490196078434,0
369,4,0,0,33,0.0,0.0,1.0,33,450,300,150,0.6666666666666666,6,3,3,378.7194844467932,0.7795928030303031,0.1894810170672241,0.21965730097914024,130951.55709342568,3318.781237985404,134270.3383314111,368,7,242.27272727272728,33,0,18,34.42688378033206,0.6363636363636362,44.117647058823536,1023.5294117647065,31.016042780748684,0
370,4,0,0,33,0.0,0.0,1.0,33,1150,700,450,0.6086956521739131,16,7,9,370.58833616122325,0.7797506313131314,0.10459445151552749,0.2087242471149497,129811.8515489489,3021.892273345965,132833.74382229487,369,8,243.27272727272728,32,1,14,35.79223970594308,0.6272786458333335,45.23358585858585,1019.065656565655,31.84580176767672,4
371,4,1,1,33,0.029411764705882353,0.029411764705882353,0.9705882352941176,34,1000,800,200,0.8,12,8,4,363.55817284475773,0.7880273321449792,0.09583727798109387,0.20647921876571973,130137.51471789686,2662.5114138792633,132800.02613177613,370,0,237.08823529411765,33,1,16,35.640363519897505,0.6281565656565657,44.9142156862745,1020.3431372549012,30.91948900772428,0
372,4,2,1,34,0.05714285714285714,0.02857142857142857,0.9714285714285714,35,750,300,450,0.4,12,3,9,354.65614874640124,0.7990196078431372,0.089684253831122,0.20272320601183164,130387.71896626281,2248.6213235293894,132636.3402897922,371,0,231.25714285714287,33,2,17,35.613650907927365,0.6306818181818183,44.66911764705881,1021.3235294117634,30.949197860962528,0
373,4,1,1,34,0.02857142857142857,0.02857142857142857,0.9714285714285714,35,700,600,100,0.8571428571428571,8,6,2,355.246397928095,0.8007703081232492,0.09347408829174686,0.20338832233026075,130450.3075740098,2268.4003748557993,132718.7079488656,372,0,232.22857142857143,33,2,17,35.53512875879718,0.6313131313131315,44.60784313725489,1021.5686274509789,30.956625074272086,0
374,4,0,1,33,0.0,0.029411764705882353,0.9705882352941176,34,850,500,350,0.5882352941176471,12,5,7,365.52977895007257,0.7907754010695187,0.10390314157071323,0.20861251392866864,130327.0413255024,2727.682921385565,133054.72424688796,373,2,240.05882352941177,32,2,17,35.39760314908701,0.6324869791666667,44.72853535353535,1021.0858585858577,31.908933080808055,0
375,4,0,0,33,0.0,0.0,1.0,33,500,300,200,0.6,7,3,4,377.1668901554172,0.784011994949495,0.10940136329891392,0.21436447301238265,130165.9349173554,3218.856175390274,133384.79109274567,374,3,246.75757575757575,32,1,17,35.26432195001237,0.630859375,44.88636363636364,1020.4545454545456,31.88920454545455,0
376,4,0,0,33,0.0,0.0,1.0,33,650,400,250,0.6153846153846154,9,4,5,374.4061916918375,0.7836963383838385,0.10770995456794563,0.2131478629321699,130230.36552392604,3151.8110396898173,133382.17656361585,375,4,247.75757575757575,32,1,18,35.26925614382318,0.6315104166666667,44.82323232323232,1020.70707070707,31.897095959595937,0
377,4,0,0,33,0.0,0.0,1.0,33,950,700,250,0.7368421052631579,12,7,5,374.60458615517615,0.7842487373737375,0.10799811121354552,0.2136144346721267,130294.81207274777,3161.806830935634,133456.6189036834,376,5,248.75757575757575,32,1,19,35.19869733696101,0.6321614583333333,44.76010101010102,1020.9595959595966,31.904987373737395,0
378,4,1,1,33,0.029411764705882353,0.029411764705882353,0.9705882352941176,34,1150,900,250,0.782608695652174,14,9,5,368.35337657297777,0.7877302436125966,0.10125471398865149,0.21243323617840343,130732.1421598663,2831.1251982410536,133563.26735810735,377,0,242.41176470588235,33,1,15,34.91449470740964,0.6341540404040404,44.33210784313725,1022.6715686274501,30.990047534165157,0
379,4,2,2,33,0.05714285714285714,0.05714285714285714,0.9428571428571428,35,900,600,300,0.6666666666666666,12,6,6,359.92424322804465,0.7957282913165266,0.09148441135411844,0.20848442013398075,130901.38888888899,2422.9166666666756,133324.30555555568,378,0,236.42857142857142,34,1,15,34.95860477741584,0.633578431372549,44.16666666666667,1023.3333333333342,30.0980392156863,0
380,4,1,1,33,0.029411764705882353,0.029411764705882353,0.9705882352941176,34,950,700,250,0.7368421052631579,12,7,5,368.54771443179965,0.7923722519310755,0.10059471800219844,0.2130634570690211,130826.15460399851,2843.136053440987,133669.2906574395,379,0,244.35294117647058,33,1,16,34.81422696054941,0.6351010101010102,44.240196078431374,1023.0392156862749,31.001188354129543,0
381,4,0,1,32,0.0,0.030303030303030304,0.9696969696969697,33,800,600,200,0.75,10,6,4,378.1200332031372,0.7786458333333334,0.1096487405212232,0.2178890578071117,130700.81218762013,3284.119088811988,133984.93127643212,380,9,252.75757575757575,33,0,16,34.69658836689037,0.6338383838383839,44.36274509803921,1022.5490196078431,30.986333927510398,0
382,4,0,0,32,0.0,0.0,1.0,32,600,300,300,0.5,9,3,6,388.27871838733984,0.7666330645161291,0.11950982209043715,0.22288850685298808,130552.75769054191,3738.171487603319,134290.92917814522,381,20,261.375,32,0,17,34.58734865332343,0.634765625,44.507575757575765,1021.9696969696979,31.93655303030306,0
383,4,0,0,32,0.0,0.0,1.0,32,500,200,300,0.4,8,2,6,384.5504937935829,0.7657930107526882,0.1393168066189192,0.22148576804697231,130681.82615294334,3650.752155392286,134332.57830833562,382,21,262.375,32,0,20,34.55148390549108,0.6360677083333335,44.38131313131312,1022.4747474747455,31.952335858585798,3
384,4,1,2,31,0.030303030303030304,0.06060606060606061,0.9393939393939394,33,1100,800,300,0.7272727272727273,14,8,6,376.1810024905339,0.777304292929293,0.1280323890164674,0.21836274592101632,130982.91710219606,3254.6570129277034,134237.57411512377,383,0,255.3939393939394,33,0,20,34.46004928369052,0.636679292929293,44.08700980392156,1023.651960784312,31.019756387403394,0
385,4,0,0,31,0.0,0.0,1.0,31,850,600,250,0.7058823529411765,11,6,5,409.22225801292973,0.7685483870967742,0.07054455972446338,0.22950977416461668,129645.8789491561,4491.928272135855,134137.80722129197,384,23,261.80645161290323,30,1,18,34.97756367955655,0.6309027777777776,45.396505376344095,1018.4139784946248,33.947132616487494,8
386,4,2,0,33,0.06060606060606061,0.0,1.0,33,750,400,350,0.5333333333333333,11,4,7,391.33694294044136,0.7839330808080809,0.07297464440321533,0.22297104888467023,130262.58680555563,3595.3125000000095,133857.89930555565,385,0,246.87878787878788,32,1,20,34.804421768707485,0.6318359375,44.79166666666667,1020.833333333334,31.90104166666669,0
387,4,0,1,32,0.0,0.030303030303030304,0.9696969696969697,33,800,600,200,0.75,10,6,4,388.5002388574941,0.782907196969697,0.06759728684862387,0.2240294328918327,130728.2257080079,3561.9296603732787,134290.15536838118,386,1,247.87878787878788,31,2,18,34.40338256514728,0.6391129032258064,44.33593750000001,1022.6562500000007,32.988911290322605,3
388,4,0,0,32,0.0,0.0,1.0,32,700,600,100,0.8571428571428571,8,6,2,388.93269570082737,0.7788558467741936,0.04661831383887516,0.22436610171247864,130743.2601492947,3770.065722915943,134513.32587221064,387,2,244.75,30,2,18,34.377053489289004,0.6420138888888889,44.321236559139784,1022.7150537634407,34.09050179211469,0
389,4,0,0,32,0.0,0.0,1.0,32,700,400,300,0.5714285714285714,10,4,6,388.93269570082737,0.7788558467741936,0.04661831383887516,0.22436610171247864,130743.2601492947,3770.065722915943,134513.32587221064,388,3,245.75,30,2,18,34.377053489289004,0.6420138888888889,44.321236559139784,1022.7150537634407,34.09050179211469,0
390,4,2,3,31,0.058823529411764705,0.08823529411764706,0.9117647058823529,34,850,700,150,0.8235294117647058,10,7,3,368.4975874148985,0.7959744503862152,0.035389765662362294,0.2158343012001548,131328.12500000003,2878.8194444444443,134206.94444444447,389,0,232.23529411764707,32,2,18,34.30724932249322,0.642578125,43.75,1025.0000000000002,32.03125000000001,0
391,4,0,0,31,0.0,0.0,1.0,31,1050,700,350,0.6666666666666666,14,7,7,399.0774884789761,0.7687275985663082,0.05269036199986887,0.23052593746256136,130794.81336805547,4239.453124999989,135034.26649305547,390,5,255.58064516129033,29,2,20,34.06525797691784,0.6454741379310346,44.27083333333333,1022.916666666666,35.2729885057471,0
392,4,1,1,31,0.03125,0.03125,0.96875,32,900,600,300,0.6666666666666666,12,6,6,388.1246449022755,0.7755796370967742,0.05040441659010386,0.2259069266241737,131087.14022213535,3775.6299499942033,134862.77017212956,391,0,248.5625,30,2,20,34.04865030406442,0.6454861111111112,43.98521505376343,1024.059139784945,34.13530465949817,0
393,4,0,0,31,0.0,0.0,1.0,31,850,800,50,0.9411764705882353,9,8,1,401.40361471291624,0.7671146953405018,0.05243576837221475,0.23294052286883393,130972.46334876533,4314.564043209862,135287.0273919752,392,7,257.5806451612903,29,2,21,33.8251922207146,0.6472701149425288,44.097222222222214,1023.6111111111104,35.29693486590036,0
394,4,0,0,31,0.0,0.0,1.0,31,900,600,300,0.6666666666666666,12,6,6,402.72344302094587,0.7665770609318996,0.04913514790414486,0.23457209074537536,131114.6701388888,4360.590277777768,135475.26041666657,393,8,258.5806451612903,29,2,21,33.646935177651216,0.6487068965517242,43.95833333333333,1024.1666666666658,35.31609195402296,0
395,4,0,0,31,0.0,0.0,1.0,31,400,300,100,0.75,5,3,2,401.1215168055161,0.7657706093189964,0.048507381082559364,0.23385542975815635,131150.2338927467,4321.436149691336,135471.67004243805,394,9,259.5806451612903,29,2,21,33.65183615819209,0.649066091954023,43.9236111111111,1024.3055555555538,35.32088122605358,0
396,4,0,0,31,0.0,0.0,1.0,31,950,800,150,0.8421052631578947,11,8,3,403.1965972408429,0.7648745519713261,0.0405914707194015,0.23571984900498702,131256.95408950603,4384.471450617265,135641.4255401233,395,10,260.5806451612903,29,2,23,33.49033161651757,0.6501436781609196,43.819444444444436,1024.7222222222213,35.33524904214556,0
397,4,1,1,31,0.03125,0.03125,0.96875,32,950,600,350,0.631578947368421,13,6,7,388.6089887276374,0.7777637768817205,0.033729311703665,0.22497948526110287,130880.757981414,3772.2878006127885,134653.0457820268,396,0,253.40625,30,2,18,34.24569814790491,0.6434027777777778,44.18682795698925,1023.2526881720428,34.10842293906809,3
398,4,1,1,31,0.03125,0.03125,0.96875,32,1100,900,200,0.8181818181818182,13,9,4,393.1420070130584,0.7748655913978495,0.03400807722616239,0.22780694378975844,130915.14373048898,3893.6484709214847,134808.79220141046,397,0,254.375,30,2,18,34.09481437702477,0.64375,44.15322580645161,1023.3870967741929,34.11290322580643,0
399,4,0,0,31,0.0,0.0,1.0,31,1200,800,400,0.6666666666666666,16,8,8,406.7278804852233,0.764068100358423,-0.022414595857420228,0.22957985409652593,129897.3104688857,4366.571553548182,134263.88202243389,398,13,263.5806451612903,31,0,18,34.784268957295524,0.6307123655913978,45.149739583333336,1019.4010416666672,32.88390456989249,4
400,4,0,0,31,0.0,0.0,1.0,31,550,500,50,0.9090909090909091,6,5,1,403.8954927846366,0.7653225806451613,-0.022142409964084786,0.2285628251076065,129996.88042534729,4301.030815972227,134297.91124131953,399,14,264.5806451612903,31,0,18,34.75485188968335,0.6317204301075269,45.052083333333336,1019.7916666666672,32.8965053763441,0
401,4,1,0,32,0.03125,0.0,1.0,32,1000,800,200,0.8,12,8,4,392.759582729859,0.7742775537634409,-0.02194411532385465,0.22397911339459517,130296.89125910509,3835.613063107007,134132.5043222121,400,0,257.28125,30,2,19,34.73319290854836,0.6375,44.75806451612903,1020.9677419354838,34.03225806451613,0
402,4,1,0,33,0.030303030303030304,0.0,1.0,33,1300,1100,200,0.8461538461538461,15,11,4,382.43677156275436,0.781802398989899,-0.022167677796816943,0.22015348462688783,130661.65500217021,3393.9643012152883,134055.6193033855,401,0,250.45454545454547,31,2,17,34.62599762268638,0.6384408602150538,44.40104166666667,1022.3958333333339,32.98051075268819,0
403,4,0,2,31,0.0,0.06060606060606061,0.9393939393939394,33,450,200,250,0.4444444444444444,7,2,5,384.184138734087,0.7805397727272728,-0.024909137208602328,0.2215405451995242,130728.22570800793,3444.7421603732782,134172.9678683812,402,1,251.45454545454547,31,2,18,34.51372973431796,0.6391129032258064,44.33593750000001,1022.6562500000009,32.98891129032261,0
404,4,0,0,31,0.0,0.0,1.0,31,850,800,50,0.9411764705882353,9,8,1,406.90651832510883,0.7627240143369176,-0.016844026073148832,0.23268977727549373,130404.4077932098,4412.48070987653,134816.88850308635,403,2,268.06451612903226,29,2,19,34.26253286193455,0.6415229885057472,44.65277777777777,1021.3888888888882,35.22030651340994,0
405,4,2,1,32,0.06060606060606061,0.030303030303030304,0.9696969696969697,33,750,400,350,0.5333333333333333,11,4,7,383.4389207210284,0.7813289141414143,-0.02130693863077493,0.22264378099769022,130994.67807345923,3445.6915961371587,134440.3696695964,404,0,252.75757575757575,31,2,19,34.26238022555754,0.6418010752688172,44.075520833333336,1023.697916666667,33.02251344086022,0
406,4,0,0,32,0.0,0.0,1.0,32,600,500,100,0.8333333333333334,7,5,2,392.7744215894259,0.7712113575268817,-0.015023485744317666,0.2269860381713834,130812.00003251818,3875.921529945652,134687.92156246383,405,1,261.65625,30,2,19,34.20898480269784,0.6427083333333334,44.25403225806451,1022.9838709677416,34.099462365591386,0
407,4,1,0,33,0.030303030303030304,0.0,1.0,33,850,500,350,0.5882352941176471,12,5,7,379.500474805374,0.7765940656565657,-0.009812189758815704,0.22169927514799456,131228.04641723633,3360.2211846245673,134588.2676018609,406,0,254.6969696969697,31,2,20,34.12666264243657,0.6441532258064516,43.84765625,1024.609375,33.05191532258065,0
408,4,0,0,33,0.0,0.0,1.0,33,500,200,300,0.4,8,2,6,378.0797445870889,0.7780145202020202,-0.010595009040542669,0.22126528369361975,131296.72369100834,3328.1263516436147,134624.85004265196,407,1,255.6969696969697,33,0,21,34.09350213240863,0.6398358585858585,43.78063725490197,1024.877450980393,31.056892453951303,0
409,4,0,0,33,0.0,0.0,1.0,33,600,300,300,0.5,9,3,6,374.93205367759447,0.776199494949495,-0.008665472458575962,0.21997458640621886,131392.84256708508,3252.681415008376,134645.52398209347,408,2,256.6969696969697,32,1,21,34.07686781609194,0.6432291666666666,43.68686868686869,1025.252525252526,32.03914141414144,0
410,4,0,0,33,0.0,0.0,1.0,33,1000,600,400,0.6,14,6,8,374.48943598088914,0.7765940656565657,-0.0026402344886218287,0.22083462676202498,131587.09092184465,3255.5950923375162,134842.68601418217,409,3,257.6969696969697,32,1,18,33.891726146525556,0.6451822916666667,43.49747474747475,1026.0101010101007,32.06281565656565,0
411,4,0,0,33,0.0,0.0,1.0,33,500,300,200,0.6,7,3,4,374.8092164153079,0.7768308080808082,0.0005144953471729607,0.22139893248718187,131651.87225793282,3268.8670161207997,134920.73927405363,410,4,258.6969696969697,32,1,18,33.81802616469817,0.6458333333333334,43.43434343434343,1026.2626262626259,32.07070707070706,0
412,4,2,2,33,0.05714285714285714,0.05714285714285714,0.9428571428571428,35,650,400,250,0.6153846153846154,9,4,5,357.19043756426595,0.7922268907563025,-0.0011513266724012539,0.21362164950173151,132122.47732426316,2438.57709750568,134561.05442176884,411,0,244.85714285714286,34,1,18,33.795545777366065,0.6458333333333333,42.97619047619048,1028.095238095239,30.238095238095266,0
413,4,0,0,33,0.0,0.0,1.0,33,1100,600,500,0.5454545454545454,16,6,10,372.0307619797203,0.7763573232323233,0.00509770603228521,0.22050686271276118,131781.48275686146,3205.3530889705016,134986.83584583196,412,6,260.6969696969697,32,1,18,33.758351778980156,0.6471354166666667,43.3080808080808,1026.7676767676762,32.08648989898988,0
414,4,0,0,33,0.0,0.0,1.0,33,650,300,350,0.46153846153846156,10,3,7,390.957189138535,0.7754892676767677,0.055029369818889284,0.2169798927727514,129233.48263251205,3515.7287840526587,132749.2114165647,413,7,261.6969696969697,32,1,20,35.86370503746017,0.6214192708333333,45.80176767676768,1016.7929292929298,31.774779040404056,5
415,4,1,1,33,0.029411764705882353,0.029411764705882353,0.9705882352941176,34,850,700,150,0.8235294117647058,10,7,3,383.95738165657207,0.7865790255496138,0.05050211753374567,0.2146130559918903,129513.05537533651,3145.498726451373,132658.5541017879,414,0,254.97058823529412,33,1,14,35.756280600369195,0.6218434343434343,45.52696078431373,1017.8921568627459,30.84521687462866,0
416,4,1,1,33,0.029411764705882353,0.029411764705882353,0.9705882352941176,34,1050,900,150,0.8571428571428571,12,9,3,384.4360906264334,0.7844994058229353,0.04715511625931068,0.21522203779814086,129575.4337274126,3162.6946366782063,132738.1283640908,415,0,255.94117647058823,33,1,14,35.68046862461885,0.6224747474747474,45.46568627450981,1018.1372549019613,30.852644087938224,0
417,4,0,0,33,0.0,0.0,1.0,33,950,700,250,0.7368421052631579,12,7,5,394.24305344815593,0.7780145202020202,0.048811107853529156,0.22041522169896208,129522.50567544128,3612.6696255484158,133135.1753009897,416,10,264.6969696969697,32,1,15,35.484887951707606,0.6243489583333334,45.51767676767677,1017.9292929292928,31.8102904040404,0
418,4,2,2,33,0.05714285714285714,0.05714285714285714,0.9428571428571428,35,900,600,300,0.6666666666666666,12,6,6,378.2395517160869,0.797689075630252,0.030319202161368963,0.214002642007926,129989.29280045342,2833.4183673469265,132822.71116780036,417,0,250.5142857142857,34,1,15,35.416666666666664,0.6243872549019608,45.0595238095238,1019.7619047619039,29.992997198879525,0
419,4,0,0,33,0.0,0.0,1.0,33,850,400,450,0.47058823529411764,13,4,9,397.0701811007033,0.7776199494949496,0.04417752137137332,0.22308929116437867,129715.36705438235,3701.2208575655727,133416.58791194792,418,12,266.6969696969697,32,1,17,35.21602834242274,0.6263020833333333,45.32828282828284,1018.68686868687,31.833964646464686,0
420,4,0,0,33,0.0,0.0,1.0,33,700,500,200,0.7142857142857143,9,5,4,396.17192198323545,0.7757260101010102,0.03657831723226823,0.22368476210438068,129908.3719135803,3693.2098765432183,133601.5817901235,419,13,267.6969696969697,32,1,17,35.04200726612171,0.6282552083333333,45.13888888888889,1019.4444444444448,31.8576388888889,0
421,4,0,0,33,0.0,0.0,1.0,33,850,700,150,0.8235294117647058,10,7,3,392.91397744341094,0.775094696969697,0.041971891210658585,0.22276154552739072,130069.31889921952,3621.2106864095585,133690.5295856291,420,14,268.6969696969697,32,1,17,34.96101002599331,0.6298828125,44.98106060606061,1020.0757575757581,31.87736742424244,0
422,4,0,0,33,0.0,0.0,1.0,33,750,400,350,0.5333333333333333,11,4,7,389.4036540128748,0.7730429292929294,0.044884770515646544,0.22168585486197734,130230.36552392606,3542.436039689819,133772.80156361588,421,15,269.6969696969697,32,1,18,34.88655574797954,0.6315104166666667,44.82323232323232,1020.7070707070701,31.89709595959594,0
423,4,0,0,33,0.0,0.0,1.0,33,800,400,400,0.5,12,4,8,383.0688982897407,0.7720959595959597,0.04707812271772238,0.2193496430334247,130455.99819214875,3394.7271005509633,133850.7252926997,422,16,270.6969696969697,32,1,20,34.818780126066,0.6337890625,44.60227272727273,1021.590909090909,31.924715909090907,0
424,4,1,1,33,0.029411764705882353,0.029411764705882353,0.9705882352941176,34,1050,700,350,0.6666666666666666,14,7,7,376.1431388719566,0.7792632204396911,0.041909122930609,0.2178082669612231,130888.84833958096,3046.5884515570956,133935.43679113805,423,0,263.70588235294116,33,1,17,34.5563872255489,0.6357323232323232,44.17892156862745,1023.2843137254905,31.008615567439108,0
425,4,0,0,33,0.0,0.0,1.0,33,850,700,150,0.8235294117647058,10,7,3,385.3893706459728,0.77114898989899,0.04871371994659701,0.2228986488468464,130843.25140610654,3485.11966253444,134328.371068641,424,18,272.6969696969697,32,1,17,34.3661298284586,0.6376953125,44.22348484848485,1023.1060606060607,31.972064393939398,0
426,4,0,0,33,0.0,0.0,1.0,33,1000,700,300,0.7,13,7,6,384.86029968316143,0.7721748737373738,0.06592844846379942,0.21516946851911548,129522.50567544118,3369.6140699928446,132892.11974543403,425,19,273.6969696969697,32,1,14,35.72366244935086,0.6243489583333335,45.51767676767676,1017.929292929292,31.810290404040376,3
427,4,0,0,33,0.0,0.0,1.0,33,550,300,250,0.5454545454545454,8,3,5,383.1147188927156,0.772253787878788,0.06597089165896475,0.21489591951242298,129651.06398581775,3334.246186613605,132985.31017243135,426,20,274.6969696969697,32,1,16,35.636984461525735,0.6256510416666667,45.39141414141414,1018.4343434343432,31.826073232323225,0
428,4,1,1,33,0.029411764705882353,0.029411764705882353,0.9705882352941176,34,850,500,350,0.5882352941176471,12,5,7,372.97371818510885,0.7824569221628046,0.06339492161812443,0.21064279440474665,129918.78311526803,2891.2583201172406,132810.04143538527,427,0,267.5882352941176,33,1,17,35.62264595103577,0.6259469696969697,45.128676470588225,1019.4852941176459,30.893493761140785,0
429,4,0,0,33,0.0,0.0,1.0,33,950,700,250,0.7368421052631579,12,7,5,381.287581818043,0.7784090909090909,0.07977682912635187,0.21475031911049716,129811.85154894895,3299.129393684296,133110.98094263324,428,1,276.06060606060606,32,1,17,35.51965886094246,0.6272786458333335,45.23358585858585,1019.0656565656554,31.845801767676733,0
430,4,1,1,33,0.029411764705882353,0.029411764705882353,0.9705882352941176,34,950,700,250,0.7368421052631579,12,7,5,375.1777723669617,0.7883986928104576,0.07306482953541837,0.21290763155793818,130106.25608239608,2962.5950655997563,133068.85114799583,429,0,268.9117647058824,33,1,17,35.375750750750754,0.6278409090909092,44.944852941176464,1020.2205882352932,30.915775401069492,0
431,4,0,1,32,0.0,0.030303030303030304,0.9696969696969697,33,1250,900,350,0.72,16,9,7,398.9124537866173,0.7758049242424243,0.04469549867608125,0.2066799936620804,126469.13528442384,3530.0387765663677,129999.1740609902,430,3,278.06060606060606,31,2,16,38.503910463861914,0.595766129032258,48.53515625,1005.8593750000001,32.44707661290323,8
432,4,5,3,34,0.13513513513513514,0.08108108108108109,0.9189189189189189,37,1000,700,300,0.7,13,7,6,362.56953948117354,0.8160035035035035,0.05383104855944665,0.1926785506402388,127500.8104531036,1845.582025891636,129346.39247899523,431,0,248.78378378378378,35,2,14,38.35711284284514,0.5970238095238095,47.511574074074076,1009.9537037037039,28.85582010582011,0
433,4,3,0,37,0.08108108108108109,0.0,1.0,37,1100,700,400,0.6363636363636364,15,7,8,361.71673067655775,0.8152527527527528,0.08544027898866591,0.19447279579178772,127968.81028163586,1857.6919367284017,129826.50221836426,432,0,249.7027027027027,35,2,19,37.89893617021277,0.6017857142857143,47.048611111111114,1011.805555555556,28.908730158730172,0
434,4,1,1,37,0.02631578947368421,0.02631578947368421,0.9736842105263158,38,700,400,300,0.5714285714285714,10,4,6,355.9418861851416,0.8206495969653864,0.08479331685401403,0.19263125825641125,128232.43694540876,1528.7796585647966,129761.21660397356,433,0,244.10526315789474,35,3,19,37.775325677065496,0.6044642857142858,46.788194444444436,1012.8472222222206,28.938492063492017,0
435,4,4,3,38,0.0975609756097561,0.07317073170731707,0.926829268292683,41,450,300,150,0.6666666666666666,6,3,3,334.4274298549065,0.8389735772357724,0.08111084584164407,0.18355834841429614,128794.39153928336,414.4754684418117,129208.86700772517,434,0,227.14634146341464,38,3,15,37.74734238501209,0.6044407894736842,46.23397435897436,1015.0641025641025,26.71221322537112,0
436,4,2,2,38,0.05,0.05,0.95,40,950,800,150,0.8421052631578947,11,8,3,352.17952888637,0.8332799145299146,0.12080679978413356,0.19433849524313376,129006.37846500838,1086.6811182286765,130093.05958323706,435,0,233.775,37,3,16,37.08074743658933,0.6083896396396395,46.02521929824561,1015.899122807017,27.456733048838295,0
437,4,2,4,36,0.05,0.1,0.9,40,1000,700,300,0.7,13,7,6,350.14646736416995,0.8303418803418804,0.11951397130219044,0.19376164811931268,129117.7949585448,1042.027955717128,130159.82291426192,436,0,234.65,37,3,17,37.01889362390765,0.6095157657657657,45.91557017543859,1016.3377192982445,27.46858700806066,0
438,4,5,2,39,0.12195121951219512,0.04878048780487805,0.9512195121951219,41,1050,800,250,0.7619047619047619,13,8,5,343.7861131027493,0.8322154471544716,0.14859729762366602,0.187668865536768,128577.58881446761,645.6905345179782,129223.2793489856,437,0,229.5609756097561,38,3,16,37.730871870501055,0.6022478070175439,46.44764957264956,1014.2094017094,26.68972109761579,2
439,4,2,2,39,0.04878048780487805,0.04878048780487805,0.9512195121951219,41,700,400,300,0.5714285714285714,10,4,6,344.40671554087214,0.8378048780487805,0.1580512457051293,0.18864907636719713,128713.06911571306,665.9290762655808,129378.99819197865,438,0,230.5121951219512,38,3,17,37.576989892608964,0.6036184210526316,46.31410256410255,1014.7435897435874,26.70377867746283,0
440,4,0,0,39,0.0,0.0,1.0,39,500,300,200,0.6,7,3,4,357.4973909128099,0.8247863247863249,0.16706828681945374,0.19457022448591965,128458.27880245095,1384.6999026052963,129842.97870505624,439,1,243.23076923076923,36,3,17,37.505091461156795,0.6047453703703705,46.56531531531531,1013.7387387387375,28.159409409409378,0
441,4,3,1,41,0.07142857142857142,0.023809523809523808,0.9761904761904762,42,650,400,250,0.6153846153846154,9,4,5,338.13532411599925,0.8431329849012776,0.17287402765984483,0.18726018687422918,129148.44292534704,333.93012152775805,129482.3730468748,440,0,226.78571428571428,39,3,19,37.292904966864796,0.6063034188034189,45.88541666666666,1016.4583333333319,26.063034188034152,0
442,4,0,0,41,0.0,0.0,1.0,41,1050,700,350,0.6666666666666666,14,7,7,342.2444076676036,0.8386178861788618,0.1721546638361371,0.18939913031657415,129119.93805473363,638.1153435239867,129758.05339825762,441,1,233.3170731707317,38,3,20,37.21749185325345,0.6077302631578948,45.91346153846153,1016.3461538461531,26.74595141700403,0
443,4,0,0,41,0.0,0.0,1.0,41,1000,700,300,0.7,13,7,6,340.9701693093256,0.8388211382113822,0.17273090763694543,0.1890834575260804,129201.3888888888,610.7895710059086,129812.17845989471,442,2,234.3170731707317,37,4,20,37.16700819672131,0.6103603603603605,45.83333333333333,1016.666666666666,27.477477477477457,0
444,4,0,0,41,0.0,0.0,1.0,41,1200,800,400,0.6666666666666666,16,8,8,339.5148557311726,0.838770325203252,0.17179947085215952,0.18854256120065233,129257.13320444748,576.9433864265869,129834.07659087407,443,3,235.3170731707317,37,4,20,37.14731148012364,0.6109234234234234,45.77850877192982,1016.8859649122803,27.483404457088657,0
445,4,3,1,43,0.06818181818181818,0.022727272727272728,0.9772727272727273,44,800,400,400,0.5,12,4,8,321.55535301389637,0.8536601479915433,0.18554262722922998,0.18163532102676838,129925.63950029736,-444.34302498513574,129481.29647531222,444,0,220.20454545454547,40,4,19,36.92621112440191,0.6125,45.12195121951219,1019.5121951219505,25.487804878048763,0
446,4,2,2,43,0.044444444444444446,0.044444444444444446,0.9555555555555556,45,1100,700,400,0.6363636363636364,15,7,8,323.5649428819152,0.8558501683501684,0.20589661658395086,0.18511539264294416,130422.14084201399,-559.1207864965365,129863.02005551745,445,0,216.26666666666668,39,6,21,36.37271398463526,0.6191239316239316,44.63541666666667,1021.4583333333342,26.191239316239336,0
447,4,1,0,44,0.022727272727272728,0.0,1.0,44,1250,1100,150,0.88,14,11,3,325.8775385892569,0.8454897815362932,0.21003206702564436,0.18682248837066187,130501.95448133699,-294.4688585069209,130207.48562283006,446,0,221.9318181818182,39,5,17,36.232987562442666,0.6199252136752136,44.55729166666668,1021.7708333333348,26.199252136752175,0
448,4,0,1,43,0.0,0.022727272727272728,0.9772727272727273,44,1450,900,550,0.6206896551724138,20,9,11,325.45786528492266,0.8463266384778013,0.2082125626232787,0.18761126620681687,130714.91021050366,-291.56087239581353,130423.34933810784,447,1,222.9318181818182,39,5,18,36.02859410546332,0.6220619658119657,44.34895833333334,1022.6041666666681,26.220619658119695,0
449,4,0,0,43,0.0,0.0,1.0,43,1200,1000,200,0.8333333333333334,14,10,4,337.1949259505416,0.8408545588778147,0.21169133855205868,0.19402394746967747,130644.58832137137,210.53845697277347,130855.12677834414,448,2,229.06976744186048,38,5,18,35.79963075208138,0.623081140350877,44.41773504273505,1022.3290598290614,26.90339631129109,0
450,4,0,0,43,0.0,0.0,1.0,43,950,600,350,0.631578947368421,13,6,7,336.2726105063419,0.8409468438538206,0.20730744278379665,0.19376671614426258,130699.20562358477,190.11261322961371,130889.31823681439,449,3,230.06976744186048,38,5,18,35.767988367638345,0.6236293859649122,44.364316239316246,1022.5427350427362,26.9090193432299,0
451,4,1,2,42,0.022727272727272728,0.045454545454545456,0.9545454545454546,44,1500,1000,500,0.6666666666666666,20,10,10,326.7926512330222,0.8417679704016914,0.20539636881584178,0.18994943636720155,131034.66932508699,-235.76660156248025,130798.9027235245,450,0,225.8181818181818,39,5,19,35.671757893308936,0.6252670940170939,44.03645833333334,1023.8541666666681,26.252670940170976,0
452,4,0,0,42,0.0,0.0,1.0,42,850,600,250,0.7058823529411765,11,6,5,352.1804137741688,0.8338414634146342,0.23744537574324776,0.2000849163969733,130150.67737188395,767.3038819637131,130917.98125384767,451,1,237.11904761904762,37,5,21,35.91723977362274,0.6199324324324322,44.9013157894737,1020.3947368421077,27.578236130867776,1
453,4,0,0,42,0.0,0.0,1.0,42,1050,600,450,0.5714285714285714,15,6,9,352.4872111600597,0.8333817266744096,0.23481301836303392,0.20040308333944307,130178.65022170315,777.2618738458319,130955.91209554898,452,2,238.11904761904762,37,5,21,35.88103488413741,0.6202139639639639,44.873903508771946,1020.5043859649148,27.581199620673374,0
454,4,0,0,42,0.0,0.0,1.0,42,1300,800,500,0.6153846153846154,18,8,10,370.53085557590146,0.8342044134727061,0.23733074659487996,0.20309709158196682,128740.17373666793,1140.4413443275407,129880.61508099547,453,3,239.11904761904762,38,4,18,36.88655823420008,0.6038925438596492,46.28739316239315,1014.8504273504258,26.70659019343226,4
455,4,0,1,41,0.0,0.023809523809523808,0.9761904761904762,42,1150,800,350,0.6956521739130435,15,8,7,372.1706192361658,0.8344947735191638,0.23535116604267325,0.20427458424972864,128794.39153928302,1186.6976906640066,129981.08922994703,454,4,240.11904761904762,38,4,19,36.78954846858227,0.6044407894736843,46.23397435897434,1015.0641025640998,26.71221322537105,0
456,4,3,3,41,0.06818181818181818,0.06818181818181818,0.9318181818181819,44,950,500,450,0.5263157894736842,14,5,9,356.51970600038635,0.8517441860465117,0.22687838618973455,0.19868746858724218,129396.54659366336,428.40990858474345,129824.9565022481,455,0,229.0,37,7,20,36.573063728131615,0.612331081081081,45.64144736842105,1017.4342105263152,27.498221906116626,0
457,4,0,0,41,0.0,0.0,1.0,41,1100,700,400,0.6363636363636364,15,7,8,376.06669833402685,0.8302845528455285,0.240237979282113,0.2075198308555544,129006.37846500843,1503.000562673123,130509.37902768156,456,6,246.7560975609756,37,4,20,36.474073574383866,0.6083896396396395,46.02521929824561,1015.8991228070173,27.456733048838306,0
458,4,2,2,41,0.046511627906976744,0.046511627906976744,0.9534883720930233,43,1300,800,500,0.6153846153846154,18,8,10,366.71684454941004,0.8423772609819121,0.2435359459276647,0.2049507807316176,129508.13140822163,898.8572204909051,130406.98862871253,457,0,236.2325581395349,37,6,16,36.20002064706094,0.6134572072072073,45.53179824561403,1017.8728070175428,27.510075865338994,0
459,4,4,2,43,0.08888888888888889,0.044444444444444446,0.9555555555555556,45,1300,1000,300,0.7692307692307693,16,10,6,353.001956609962,0.8463804713804715,0.2516984221823899,0.20072738665216502,130184.79100568428,191.09718917309635,130375.88819485738,458,0,226.64444444444445,40,5,18,35.86167264157206,0.6151041666666668,44.86788617886178,1020.5284552845516,25.513211382113788,0
460,4,0,0,43,0.0,0.0,1.0,43,1500,1200,300,0.8,18,12,6,369.1034900419133,0.8379475821336286,0.2610558329616983,0.20854674987980926,129935.60209155164,991.9368425378085,130927.53893408945,459,1,238.1860465116279,38,5,19,35.70418107513362,0.615953947368421,45.11217948717949,1019.5512820512823,26.830296896086377,0
461,4,0,0,43,0.0,0.0,1.0,43,1050,500,550,0.47619047619047616,16,5,11,372.01502053746407,0.8380860095976375,0.25954934329437274,0.20513971132494435,128978.5318559556,997.212063201958,129975.74391915757,460,2,239.1860465116279,37,6,20,36.60540803108806,0.6081081081081081,46.05263157894736,1015.78947368421,27.4537695590327,2
462,4,2,1,44,0.044444444444444446,0.022222222222222223,0.9777777777777777,45,1050,700,350,0.6666666666666666,14,7,7,363.3575351054945,0.8462962962962963,0.2589519489619059,0.20311618799125306,129516.42679419268,412.7310197681568,129929.15781396083,461,0,229.51111111111112,36,9,15,36.277058671681964,0.6154513888888891,45.52364864864864,1017.9054054054042,28.275150150150115,0
463,4,1,2,43,0.022222222222222223,0.044444444444444446,0.9555555555555556,45,1400,1000,400,0.7142857142857143,18,10,8,364.8483183398829,0.8487373737373738,0.27227873605582587,0.2046952972125247,129659.75265806334,461.2285427319031,130120.98120079524,462,0,230.48888888888888,36,9,17,36.09322018280996,0.6168981481481483,45.382882882882875,1018.4684684684674,28.290790790790762,0
464,4,1,0,44,0.022727272727272728,0.0,1.0,44,1550,1100,450,0.7096774193548387,20,11,9,367.09964048771275,0.8519203664552503,0.2770267556849564,0.20762568673430568,129975.3485537901,742.7807452722861,130718.12929906239,463,0,226.1590909090909,36,8,19,35.71484446898584,0.6200810185185186,45.07319819819819,1019.7072072072058,28.32520020020016,0
465,4,1,1,44,0.022222222222222223,0.022222222222222223,0.9777777777777777,45,1250,1000,250,0.8,15,10,5,359.4516197719308,0.8568181818181818,0.27099269445638163,0.20450951569909073,130206.62607725423,360.59652970140814,130567.22260695563,464,0,222.11111111111111,37,8,19,35.674957026213995,0.6204954954954957,44.84649122807016,1020.6140350877168,27.584163110478833,0
466,4,0,0,44,0.0,0.0,1.0,44,1150,800,350,0.6956521739130435,15,8,7,371.1298550505612,0.8515680056377731,0.2745576907646632,0.21130157073984213,130233.84871357847,866.7338791494183,131100.58259272788,465,2,228.1590909090909,36,8,20,35.34932149161517,0.6226851851851851,44.81981981981982,1020.7207207207209,28.35335335335336,0
467,4,1,1,44,0.022222222222222223,0.022222222222222223,0.9777777777777777,45,1400,1100,300,0.7857142857142857,17,11,6,363.35508790276265,0.8571548821548822,0.27621932277104677,0.20849198359340362,130536.16780045367,486.20565632512205,131022.37345677879,466,0,224.06666666666666,34,11,16,35.24095215905562,0.6299019607843136,44.52380952380953,1021.9047619047631,30.05602240896362,0
468,4,1,1,44,0.022222222222222223,0.022222222222222223,0.9777777777777777,45,1300,1000,300,0.7692307692307693,16,10,6,365.4512962145763,0.85496632996633,0.2672046863018698,0.21126383304386123,130824.41332572438,561.9902852794862,131386.40361100386,467,0,224.42222222222222,35,10,16,34.89518516423426,0.6306547619047619,44.241898148148145,1023.0324074074068,29.229497354497337,0
469,4,0,0,44,0.0,0.0,1.0,44,950,700,250,0.7368421052631579,12,7,5,375.7584217509326,0.8512596899224807,0.2790506931950467,0.21662851294231616,130718.71456916102,1023.7315759637185,131742.44614512473,468,2,230.52272727272728,34,10,16,34.73879511059371,0.6317401960784315,44.345238095238095,1022.6190476190478,30.077030812324935,0
470,4,0,0,44,0.0,0.0,1.0,44,800,500,300,0.625,11,5,6,376.0727036831094,0.8511715997181114,0.27667294306810253,0.21749453670609956,130840.48327664385,1041.106859410412,131881.59013605426,469,3,231.52272727272728,34,10,16,34.6072356682957,0.6329656862745099,44.22619047619047,1023.095238095237,30.091036414565796,0
471,4,0,1,43,0.0,0.022727272727272728,0.9772727272727273,44,800,500,300,0.625,11,5,6,370.60753689428947,0.8512596899224807,0.22548227179652902,0.20653857866919617,129396.54659366366,791.0670831409861,130187.61367680464,470,4,232.52272727272728,37,7,16,36.21472770054243,0.6123310810810809,45.64144736842106,1017.4342105263177,27.498221906116694,6
472,4,1,3,41,0.022727272727272728,0.06818181818181818,0.9318181818181819,44,950,500,450,0.5263157894736842,14,5,9,369.6853201031779,0.8517441860465117,0.21643680637862217,0.2063168644544558,129452.33298947779,771.3254318636757,130223.65842134146,471,0,232.75,37,7,14,36.18133372840569,0.612894144144144,45.586622807017555,1017.6535087719319,27.50414888572789,0
473,4,3,4,40,0.06818181818181818,0.09090909090909091,0.9090909090909091,44,750,300,450,0.4,12,3,9,368.8993999243602,0.8518983439041579,0.2171842264993249,0.20661036355232884,129591.85157933226,761.2712565404927,130353.12283587275,472,0,232.5909090909091,37,7,14,36.05921099863595,0.6143018018018017,45.44956140350878,1018.2017543859661,27.518966334755838,0
474,4,0,0,40,0.0,0.0,1.0,40,1100,900,200,0.8181818181818182,13,9,4,398.92702432971,0.8310096153846154,0.24378589007383145,0.2200416482615007,128989.67013888895,2291.493055555567,131281.16319444453,473,7,256.575,34,6,17,35.91058244462675,0.6142769607843137,46.04166666666667,1015.8333333333338,29.877450980392172,0
475,4,1,0,41,0.024390243902439025,0.0,1.0,41,1100,600,500,0.5454545454545454,16,6,10,395.252847170874,0.8354674796747967,0.25105187783784966,0.2198406342365596,129319.0854338135,2022.7473422496632,131341.83277606315,474,0,251.29268292682926,35,6,19,35.6670080412684,0.6154761904761905,45.717592592592595,1017.1296296296301,29.060846560846574,0
476,4,3,4,40,0.06818181818181818,0.09090909090909091,0.9090909090909091,44,1200,800,400,0.6666666666666666,16,8,8,377.01668287684964,0.8529994714587739,0.22739658162001497,0.21286941940892887,129908.37191358021,995.5246913580179,130903.89660493823,475,0,235.0909090909091,38,6,14,35.53019981834695,0.6156798245614035,45.138888888888886,1019.4444444444441,26.82748538011695,0
477,4,1,1,40,0.024390243902439025,0.024390243902439025,0.975609756097561,41,800,400,400,0.5,12,4,8,404.23310359973874,0.8348069105691057,0.2527534688716604,0.22618539308290714,129554.6392746913,2274.0547839506094,131828.6940586419,476,0,253.2439024390244,35,6,14,35.19781718963164,0.6178571428571429,45.48611111111111,1018.0555555555552,29.087301587301578,0
478,4,0,1,39,0.0,0.025,0.975,40,950,700,250,0.7368421052631579,12,7,5,412.4802322157092,0.8272168803418803,0.2650070167231906,0.2306813908225328,129534.44054705204,2686.0792233559914,132220.51977040805,477,11,260.575,34,6,15,35.008575995010325,0.6197916666666667,45.50595238095237,1017.9761904761896,29.940476190476165,0
479,4,1,1,39,0.025,0.025,0.975,40,1300,1000,300,0.7692307692307693,16,10,6,410.96348710485506,0.8372863247863248,0.2530163599182007,0.2309898220623839,129731.44531249988,2662.9774305555406,132394.42274305542,478,0,256.875,35,5,15,34.845773687798214,0.6196428571428572,45.31249999999999,1018.7499999999991,29.107142857142833,0
480,4,0,0,39,0.0,0.0,1.0,39,1200,800,400,0.6666666666666666,16,8,8,425.7462076872184,0.8279352226720648,0.26572663561206955,0.23865223201549568,129625.34722222218,3237.4999999999945,132862.84722222216,479,13,264.46153846153845,34,5,15,34.5778777959629,0.6207107843137255,45.416666666666664,1018.3333333333329,29.95098039215685,0
481,4,0,0,39,0.0,0.0,1.0,39,950,600,350,0.631578947368421,13,6,7,430.10968800876043,0.8283850652271705,0.26577621179163624,0.24184485610899903,129746.60572562339,3361.0544217686847,133107.66014739207,480,14,265.46153846153845,34,5,15,34.342622886967355,0.621936274509804,45.29761904761904,1018.8095238095223,29.964985994397715,0
482,4,0,0,39,0.0,0.0,1.0,39,1100,900,200,0.8181818181818182,13,9,4,425.8338921870476,0.8275416104363473,0.26426038190744094,0.2400699906913659,129849.38298396755,3258.8536308298753,133108.2366147974,481,15,266.46153846153845,35,4,15,34.34637368460896,0.6208333333333333,45.196759259259245,1019.2129629629611,29.120370370370317,0
483,4,1,2,38,0.025,0.05,0.95,40,1000,700,300,0.7,13,7,6,420.4535230106355,0.8316239316239317,0.2596811562224186,0.23938383998545243,130233.84871357857,2951.456101371656,133185.3048149502,482,0,260.775,36,4,16,34.090679243895266,0.6226851851851851,44.81981981981983,1020.7207207207217,28.35335335335338,0
484,4,0,0,38,0.0,0.0,1.0,38,1400,1100,300,0.7857142857142857,17,11,6,436.6242684437607,0.8163229018492176,0.2752837977296181,0.24742041878479792,130050.00000000012,3756.5972222222354,133806.59722222236,483,20,275.07894736842104,34,4,18,33.8660811546841,0.625,45.00000000000001,1020.0000000000009,30.00000000000003,0
485,4,0,0,38,0.0,0.0,1.0,38,600,300,300,0.5,9,3,6,434.53663903143695,0.8166192508297772,0.2710495608917274,0.2466211255959879,130110.72137188219,3707.5751133786976,133818.2964852609,484,21,276.07894736842104,34,4,18,33.857205367561264,0.6256127450980391,44.9404761904762,1020.2380952380961,30.007002801120475,0
486,4,0,0,38,0.0,0.0,1.0,38,950,600,350,0.631578947368421,13,6,7,432.1686597435367,0.81733048838312,0.2698588592091453,0.24585148772271637,130201.83000283432,3653.8300736961287,133855.66007653045,485,22,277.07894736842104,34,4,18,33.82445857148411,0.6265318627450981,44.85119047619047,1020.5952380952369,30.017507002801086,0
487,4,3,2,39,0.07317073170731707,0.04878048780487805,0.9512195121951219,41,1400,1200,200,0.8571428571428571,16,12,4,409.1441424767769,0.8355182926829269,0.25168683731391295,0.2377211486188965,131019.23338190601,2521.1503780009307,133540.38375990695,486,0,257.7317073170732,37,4,17,33.57955356824105,0.6286599099099099,44.0515350877193,1023.7938596491231,27.670104314841165,0
488,4,0,0,39,0.0,0.0,1.0,39,1000,700,300,0.7,13,7,6,430.8838911420627,0.8218623481781376,0.267563826916549,0.24870809575587244,130765.21675936639,3468.925084662211,134234.1418440286,487,1,271.94871794871796,35,4,17,33.28205744785185,0.6300595238095238,44.29976851851852,1022.8009259259258,29.222883597883595,0
489,4,0,0,39,0.0,0.0,1.0,39,950,700,250,0.7368421052631579,12,7,5,432.28272294007536,0.8228744939271255,0.2644372139961375,0.25047469437982617,130913.23329260974,3518.3057913237376,134431.5390839335,488,2,272.94871794871796,35,4,17,33.09535927015004,0.631547619047619,44.155092592592595,1023.3796296296298,29.239417989417994,0
490,4,0,0,39,0.0,0.0,1.0,39,850,400,450,0.47058823529411764,13,4,9,412.9040468480374,0.8231556455240666,0.2504598074218327,0.22757734675112753,128959.43877551016,2866.3197287659887,131825.75850427616,489,3,273.94871794871796,34,5,17,35.586615096108765,0.6139705882352942,46.07142857142857,1015.7142857142853,29.873949579831923,6
491,4,3,3,39,0.07142857142857142,0.07142857142857142,0.9285714285714286,42,1300,1000,300,0.7692307692307693,16,10,6,388.0642183129743,0.8419715447154471,0.23209942831875208,0.21803906328317793,129717.10519641264,1667.940163343158,131385.0453597558,490,0,255.3095238095238,36,6,13,35.44361227798661,0.6174768518518519,45.32657657657658,1018.6936936936937,28.297047047047048,0
492,4,1,0,40,0.025,0.0,1.0,40,1050,700,350,0.6666666666666666,14,7,7,403.121459632516,0.8311698717948718,0.2494062244062245,0.2247540192745672,129413.28125000001,2433.854166666667,131847.1354166667,491,0,269.05,34,6,20,35.37059787059786,0.6185661764705883,45.625,1017.5000000000001,29.926470588235297,0
493,4,0,1,39,0.0,0.025,0.975,40,1050,600,450,0.5714285714285714,15,6,9,407.6042494656743,0.8300213675213676,0.25150496785505605,0.2286593019133667,129655.65653344667,2569.6393140589516,132225.29584750562,492,1,270.05,34,6,16,35.00876680303915,0.6210171568627452,45.38690476190476,1018.4523809523806,29.954481792717075,0
494,4,0,0,39,0.0,0.0,1.0,39,800,500,300,0.625,11,5,6,415.79404767405936,0.8205690508322088,0.2593614748683377,0.23240816688968616,129513.05537533636,2970.151504229136,132483.2068795655,493,7,277.94871794871796,33,6,16,34.94612328437274,0.6218434343434345,45.52696078431372,1017.8921568627447,30.84521687462863,0
495,4,2,1,40,0.04878048780487805,0.024390243902439025,0.975609756097561,41,1050,800,250,0.7619047619047619,13,8,5,406.32337655777826,0.8366869918699187,0.25452854936990477,0.23045908886616848,130085.41907793212,2371.3493441358037,132456.76842206792,494,0,265.3414634146341,35,6,19,34.60262083049693,0.6232142857142857,44.96527777777778,1020.138888888889,29.146825396825403,0
496,4,2,0,42,0.047619047619047616,0.0,1.0,42,1650,1300,350,0.7878787878787878,20,13,7,395.60721783260885,0.8391647309330236,0.2722451515554962,0.22699815226437944,130536.16780045356,1928.451160556818,132464.6189610104,495,0,259.9761904761905,34,8,15,34.416987030133576,0.6299019607843137,44.523809523809526,1021.9047619047623,30.056022408963596,0
497,4,2,2,42,0.045454545454545456,0.045454545454545456,0.9545454545454546,44,1250,900,350,0.72,16,9,7,382.09335760425137,0.8451374207188161,0.2781773202059077,0.22262261930881913,131126.20380092933,1220.4902960392878,132346.69409696863,496,0,249.11363636363637,36,8,17,34.163459776433946,0.6316550925925926,43.947072072072075,1024.2117117117118,28.450325325325327,0
498,4,1,0,43,0.023255813953488372,0.0,1.0,43,550,300,250,0.5454545454545454,8,3,5,388.55429981622075,0.8421465485418973,0.28925968438355554,0.2267272909190612,131183.87972009182,1594.41210636313,132778.29182645495,497,0,254.67441860465115,36,7,19,33.939531347330615,0.6322337962962963,43.89076576576577,1024.4369369369379,28.456581581581606,0
499,4,0,0,43,0.0,0.0,1.0,43,800,600,200,0.75,10,6,4,388.6893341044723,0.8419158361018826,0.2909698740214228,0.2271473507396658,131241.56832085477,1602.4395594919397,132844.0078803467,498,1,255.67441860465115,36,7,20,33.87757812213797,0.6328125,43.83445945945947,1024.6621621621632,28.462837837837867,0
500,4,0,0,43,0.0,0.0,1.0,43,1000,700,300,0.7,13,7,6,389.4665000363996,0.8406699889258028,0.29002749455836874,0.22850202169765668,131392.84256708517,1634.7362392919563,133027.57880637713,499,2,256.6744186046512,32,11,20,33.70433087027914,0.6432291666666665,43.6868686868687,1025.2525252525268,32.03914141414146,0
501,4,1,0,44,0.022727272727272728,0.0,1.0,44,1550,1200,350,0.7741935483870968,19,12,7,378.5374478014225,0.8446749471458774,0.29242955816248206,0.22492769129620696,131876.97991488117,1184.0750801477209,133061.05499502888,500,0,251.8181818181818,36,8,18,33.49481964696854,0.6391782407407407,43.215090090090094,1027.13963963964,28.53165665665667,0
502,4,1,0,45,0.022222222222222223,0.0,1.0,45,1050,800,250,0.7619047619047619,13,8,5,372.5957821756906,0.8493686868686869,0.29243657649331123,0.22296302804476367,132144.21895438968,847.2757242612965,132991.49467865098,501,0,247.2,37,8,19,33.37765721090612,0.6399211711711712,42.955043859649116,1028.1798245614025,27.78864390706493,0
503,4,0,2,43,0.0,0.044444444444444446,0.9555555555555556,45,950,500,450,0.5263157894736842,14,5,9,373.20538478517676,0.8481060606060606,0.2886742148817567,0.22385347285525808,132233.1242809006,870.0228057199081,133103.1470866205,502,1,248.2,38,7,19,33.27230705307988,0.6389802631578948,42.86858974358974,1028.52564102564,27.06646423751684,0
504,4,0,0,43,0.0,0.0,1.0,43,1200,1000,200,0.8333333333333334,14,10,4,389.41003565396863,0.8368863049095607,0.29320930232558107,0.2320944856526758,131992.6741564201,1679.8543898628523,133672.52854628296,503,2,260.4418604651163,36,7,19,33.0986301369863,0.6403356481481481,43.102477477477485,1027.5900900900913,28.5441691691692,0
505,4,2,1,44,0.044444444444444446,0.022222222222222223,0.9777777777777777,45,1250,700,550,0.56,18,7,11,370.9814417371543,0.8433080808080808,0.2809088639200996,0.22491381685699413,132636.34366426617,842.9885951391898,133479.33225940535,504,0,249.82222222222222,35,10,14,32.92322097378277,0.6488095238095237,42.476851851851855,1030.092592592593,29.431216931216944,0
506,4,0,0,44,0.0,0.0,1.0,44,1600,1200,400,0.75,20,12,8,379.2901205475436,0.8367908738548274,0.286701971167991,0.2298051906846882,132612.49999999997,1259.7222222222217,133872.2222222222,505,1,256.5,34,10,20,32.733279395900766,0.650735294117647,42.5,1029.9999999999998,30.294117647058815,0
507,4,0,0,44,0.0,0.0,1.0,44,1150,700,450,0.6086956521739131,16,7,9,378.23546628727314,0.8361301973220578,0.2867365159392887,0.22972827794500694,132704.4802295918,1238.7081916099753,133943.18842120178,506,2,257.5,34,10,17,32.66777392643944,0.6516544117647058,42.410714285714285,1030.3571428571427,30.30462184873949,0
508,4,0,1,43,0.0,0.022727272727272728,0.9772727272727273,44,900,600,300,0.6666666666666666,12,6,6,378.40308457079107,0.8361962649753347,0.29154854154854215,0.23039478946651934,132796.4923469386,1250.1204648525895,134046.61281179122,507,3,258.5,34,10,17,32.570791945791946,0.6525735294117647,42.32142857142856,1030.7142857142844,30.31512605042013,0
509,4,1,0,44,0.022727272727272728,0.0,1.0,44,450,200,250,0.4444444444444444,7,2,5,375.87260023090744,0.8384866102889359,0.2953321227083996,0.22988337272873127,132964.41139671204,1195.5358099708394,134159.94720668287,508,0,258.47727272727275,35,9,18,32.46701174578238,0.6520833333333333,42.15856481481481,1031.36574074074,29.46759259259257,0
510,4,0,0,44,0.0,0.0,1.0,44,1150,600,550,0.5217391304347826,17,6,11,375.9128479888424,0.8369230091613813,0.29429205119053714,0.23064439365592054,133083.809223358,1205.5827492712374,134289.39197262924,509,1,259.47727272727275,35,9,18,32.3458824079267,0.6532738095238096,42.04282407407406,1031.828703703702,29.48082010582006,0
511,4,0,1,43,0.0,0.022727272727272728,0.9772727272727273,44,1050,700,350,0.6666666666666666,14,7,7,379.0859834952139,0.8351391825229035,0.29601975249881063,0.2335658801535026,133239.59094229355,1301.852274571861,134541.44321686542,510,2,260.47727272727275,36,8,18,32.10737529086679,0.6527777777777779,41.89189189189189,1032.4324324324316,28.678678678678654,0
512,4,0,0,43,0.0,0.0,1.0,43,1400,800,600,0.5714285714285714,20,8,12,388.95809459879894,0.8289959394610557,0.3039716182550971,0.2386484111044933,133083.809223358,1752.80497149346,134836.61419485146,511,3,267.3255813953488,35,8,18,32.00937091045054,0.6532738095238096,42.04282407407406,1031.828703703702,29.48082010582006,0
513,4,0,0,43,0.0,0.0,1.0,43,1150,800,350,0.6956521739130435,15,8,7,388.6372265390169,0.828672942045035,0.30382242342375254,0.23902529560516877,133173.3927576301,1751.2276020232916,134924.62035965337,512,4,268.3255813953488,35,8,18,31.927468789713675,0.6541666666666668,41.956018518518505,1032.175925925924,29.490740740740687,0
514,4,0,0,43,0.0,0.0,1.0,43,1550,1200,350,0.7741935483870968,19,12,7,388.24287321331366,0.8276578073089701,0.30326123501064717,0.23974333271158427,133322.76562767892,1752.322718407041,135075.08834608595,513,5,269.3255813953488,35,8,20,31.78735197429864,0.6556547619047619,41.81134259259258,1032.7546296296277,29.50727513227508,0
515,4,1,0,44,0.022727272727272728,0.0,1.0,44,1550,1300,250,0.8387096774193549,18,13,5,383.62632066635575,0.8319018675123326,0.31253243119499396,0.23919756979440948,133681.60211173265,1456.8399562757122,135138.44206800836,514,0,264.1818181818182,35,9,21,31.546003544114892,0.6592261904761905,41.46412037037037,1034.1435185185182,29.546957671957664,0
516,4,1,1,44,0.022222222222222223,0.022222222222222223,0.9777777777777777,45,1100,700,400,0.6363636363636364,15,7,8,372.9823609666047,0.8349747474747475,0.30422535211267654,0.23464839670937016,134010.9592013888,996.7447916666554,135007.70399305545,515,0,259.2888888888889,37,8,18,31.491029510395705,0.6585022522522523,41.14583333333333,1035.4166666666658,27.98423423423421,0
517,4,0,0,44,0.0,0.0,1.0,44,1350,1000,350,0.7407407407407407,17,10,7,379.16930202862125,0.8316816420014095,0.3120814828735623,0.2378802085286727,133908.95276611063,1354.832831141947,135263.78559725257,516,2,266.1818181818182,36,8,18,31.43315018315018,0.6594328703703705,41.244369369369366,1035.0225225225217,28.750625625625602,0
518,4,0,0,44,0.0,0.0,1.0,44,1450,1300,150,0.896551724137931,16,13,3,377.90521930832494,0.830272198731501,0.3138596896538448,0.23792912607652109,134039.34383656492,1330.8335257001936,135370.17736226512,517,3,267.1818181818182,37,7,19,31.335151065932504,0.6587837837837839,41.11842105263157,1035.5263157894722,27.98719772403979,0
519,4,0,0,44,0.0,0.0,1.0,44,1300,1000,300,0.7692307692307693,16,10,6,376.10516814296585,0.828884778012685,0.31602865748626296,0.23734572634913798,134124.51577648878,1288.9847116420278,135413.5004881308,518,4,268.1818181818182,37,7,19,31.296421262481914,0.6596283783783785,41.03618421052631,1035.8552631578937,27.996088193456586,0
520,4,0,0,44,0.0,0.0,1.0,44,1650,1300,350,0.7878787878787878,20,13,7,377.46266901822463,0.8284883720930233,0.31892736892736884,0.23875650751152758,134209.71476800548,1331.8314289011912,135541.54619690668,519,5,269.1818181818182,37,7,19,31.175925925925917,0.660472972972973,40.95394736842105,1036.1842105263152,28.004978662873384,0
521,4,0,0,44,0.0,0.0,1.0,44,1500,1100,400,0.7333333333333333,19,11,8,379.9258974365103,0.8264843199436223,0.31820289447801087,0.2414656735180962,134384.56658859286,1411.2354125575112,135795.80200115038,520,6,270.1818181818182,38,6,20,30.93701700154559,0.6603618421052633,40.7852564102564,1036.858974358973,27.285762483130867,0
522,4,0,0,44,0.0,0.0,1.0,44,1250,1100,150,0.88,14,11,3,382.80201680203004,0.8248106060606061,0.32226659425650084,0.24403314386939656,134495.36494859005,1497.019390569065,135992.38433915912,521,7,271.1818181818182,38,6,20,30.751536375184532,0.6614583333333334,40.6784188034188,1037.2863247863245,27.297008547008538,0
523,4,0,0,44,0.0,0.0,1.0,44,1150,900,250,0.782608695652174,14,9,5,384.67121498040353,0.8256915081042988,0.3246622855056589,0.24559777571825767,134550.78125,1551.619571371174,136102.40082137118,522,8,272.1818181818182,33,11,21,30.647590361445786,0.6723484848484849,40.625,1037.5,31.439393939393938,0
524,4,0,0,44,0.0,0.0,1.0,44,1300,1100,200,0.8461538461538461,15,11,4,378.3537096900485,0.8250748766737139,0.3179537853450898,0.24276343175391493,134730.9630594134,1395.1919367283747,136126.15499614176,523,9,273.1818181818182,35,9,21,30.63127090301004,0.6696428571428572,40.45138888888888,1038.194444444443,29.662698412698372,0
525,4,1,1,44,0.022222222222222223,0.022222222222222223,0.9777777777777777,45,1500,1100,400,0.7333333333333333,19,11,8,367.8674959786172,0.8285353535353536,0.3060508672468374,0.23830069160551692,135077.05498995614,938.0915966642311,136015.14658662037,524,0,268.0888888888889,36,9,20,30.55803813238003,0.6710069444444444,40.11824324324324,1039.5270270270269,28.875750750750747,0
526,4,0,0,44,0.0,0.0,1.0,44,1250,800,450,0.64,17,8,9,377.45160804545725,0.8222559901338972,0.31383075661391735,0.24399841530886685,135001.4618296682,1391.303771219135,136392.76560088733,525,11,275.1818181818182,35,9,20,30.38443869027731,0.6723214285714285,40.19097222222222,1039.236111111111,29.692460317460316,0
527,4,0,0,44,0.0,0.0,1.0,44,900,300,600,0.3333333333333333,15,3,12,376.07942467365564,0.8210227272727273,0.3123285521960506,0.2435161725302162,135061.60950627993,1358.7784797239299,136420.38798600386,526,12,276.1818181818182,35,9,21,30.360042497123562,0.6729166666666667,40.13310185185185,1039.467592592592,29.699074074074055,0
528,4,0,0,44,0.0,0.0,1.0,44,650,400,250,0.6153846153846154,9,4,5,378.84750431347163,0.8198995771670191,0.31738485826763707,0.24571748240057123,135121.77057881074,1438.109112439972,136559.8796912507,527,13,277.1818181818182,35,9,21,30.228046495231727,0.6735119047619048,40.075231481481474,1039.699074074073,29.7056878306878,0
529,4,0,0,44,0.0,0.0,1.0,44,1150,900,250,0.782608695652174,14,9,5,379.66819163380706,0.8182919309372798,0.31679396826646733,0.24694474774153802,135223.42443795135,1468.006604577539,136691.4310425289,528,14,278.1818181818182,36,8,22,30.10524938645878,0.6724537037037038,39.97747747747747,1040.0900900900892,28.891391391391366,0
530,4,0,0,44,0.0,0.0,1.0,44,1550,1300,250,0.8387096774193549,18,13,5,378.3957017887037,0.8175872093023256,0.31995504225241267,0.24712047210101853,135369.87314595009,1444.675630021921,136814.548775972,529,15,279.1818181818182,36,8,22,29.992244706561333,0.673900462962963,39.836711711711715,1040.6531531531537,28.907032032032046,0
531,4,0,0,44,0.0,0.0,1.0,44,1250,800,450,0.64,17,8,9,379.8717359998693,0.8157373150105709,0.32131232289193523,0.24912030421648898,135519.4867651585,1496.004539858417,137015.4913050169,530,16,280.1818181818182,37,7,22,29.804654591406898,0.6734234234234234,39.69298245614035,1041.2280701754385,28.14129919393077,0
532,4,0,0,44,0.0,0.0,1.0,44,900,600,300,0.6666666666666666,12,6,6,381.86132945593715,0.8147022551092319,0.3231464556077672,0.2510242746368131,135605.12759935754,1556.470861226535,137161.59846058406,531,17,281.1818181818182,37,7,23,29.6674869284486,0.6742680180180181,39.61074561403509,1041.55701754386,28.150189663347568,0
533,4,0,0,44,0.0,0.0,1.0,44,1450,1100,350,0.7586206896551724,18,11,7,378.136772832894,0.8147242776603242,0.3218333654113472,0.24921851493219113,135697.5156790659,1462.4561549947418,137159.97183406065,532,18,282.1818181818182,33,11,23,29.67243001646671,0.6837121212121211,39.52205882352942,1041.9117647058833,31.57308377896616,0
534,4,0,0,44,0.0,0.0,1.0,44,1000,600,400,0.6,14,6,8,369.0346625113954,0.8127422480620156,0.2775095645837127,0.23915363193920328,135091.68836805574,1174.5478001249764,136266.2361681807,533,19,283.1818181818182,37,7,18,30.513109552438223,0.6692004504504503,40.10416666666668,1039.5833333333348,28.096846846846887,4
535,4,0,0,44,0.0,0.0,1.0,44,1300,900,400,0.6923076923076923,17,9,8,375.31090485240236,0.8131386539816773,0.28233814156323356,0.2439906739222098,135205.70181450076,1348.8348578408925,136554.53667234167,534,20,284.1818181818182,37,7,18,30.236228255139693,0.6703265765765765,39.99451754385966,1040.0219298245627,28.108700806069262,0
536,4,0,0,44,0.0,0.0,1.0,44,750,300,450,0.4,12,3,9,373.7268779403971,0.8119274136715997,0.2809512405402812,0.24392490176439996,135348.2862515392,1316.6584910742035,136664.94474261338,535,21,285.1818181818182,37,7,19,30.135230066736906,0.6717342342342341,39.85745614035089,1040.5701754385987,28.12351825509726,0
537,4,0,0,44,0.0,0.0,1.0,44,1300,900,400,0.6923076923076923,17,9,8,375.81222831680253,0.8095269556025371,0.29005206535228045,0.24590587914644804,135438.99441385438,1379.926058331528,136818.9204721859,536,22,286.1818181818182,38,6,20,29.990548770057135,0.6707785087719296,39.770299145299155,1040.9188034188048,27.39260008996855,0
538,4,0,0,44,0.0,0.0,1.0,44,1150,900,250,0.782608695652174,14,9,5,378.0007944139795,0.8102316772374912,0.28804043719923844,0.24829863503689212,135578.04167579836,1449.7214917086994,137027.76316750707,537,23,287.1818181818182,38,6,20,29.79500068390097,0.6721491228070173,39.63675213675215,1041.4529914529935,27.40665766981562,0
539,4,0,0,44,0.0,0.0,1.0,44,1000,600,400,0.6,14,6,8,377.0044045642027,0.810143587033122,0.28629276662408154,0.24783654349942158,135605.85968889296,1424.8012774856109,137030.66096637858,538,24,288.1818181818182,38,6,20,29.79322665572537,0.6724232456140349,39.610042735042754,1041.5598290598323,27.40946918578506,0
540,4,0,0,44,0.0,0.0,1.0,44,1000,700,300,0.7,13,7,6,376.357733054204,0.807522903453136,0.28296674766859886,0.24846422286248124,135757.71683673465,1418.7047249318334,137176.42156166647,539,25,289.1818181818182,34,10,21,29.65882263346282,0.6819852941176471,39.464285714285715,1042.1428571428569,30.651260504201673,0
541,4,1,1,44,0.022222222222222223,0.022222222222222223,0.9777777777777777,45,1500,1100,400,0.7333333333333333,19,11,8,367.1975766749085,0.8109006734006734,0.2688610278979744,0.24424736225615867,136025.79417706194,989.6683974194058,137015.46257448135,540,0,283.73333333333335,35,10,17,29.63092662450533,0.6824404761904762,39.207175925925924,1043.1712962962965,29.804894179894188,0
542,4,0,0,44,0.0,0.0,1.0,44,1350,900,450,0.6666666666666666,18,9,9,377.1695046015593,0.8053206483439042,0.2737465376116526,0.25095948130777973,136037.00573979566,1461.8020124716209,137498.80775226728,541,27,291.1818181818182,34,10,17,29.35971318802539,0.6847426470588236,39.196428571428555,1043.2142857142837,30.68277310924364,0
543,4,0,0,44,0.0,0.0,1.0,44,1200,700,500,0.5833333333333334,17,7,10,378.87620895350506,0.8052766032417196,0.2701472799875546,0.25253611950398985,136099.10891439885,1512.942885487507,137612.05179988637,542,28,292.1818181818182,34,10,17,29.253422703936124,0.6853553921568629,39.13690476190475,1043.4523809523791,30.68977591036409,0
544,4,0,0,44,0.0,0.0,1.0,44,550,200,350,0.36363636363636365,9,2,7,378.4948439747722,0.8034046863988725,0.26828964830789626,0.2529453347538721,136192.29024943305,1509.6159297052075,137701.90617913826,543,29,293.1818181818182,34,10,17,29.170705976277368,0.6862745098039216,39.047619047619044,1043.8095238095234,30.700280112044805,0
545,4,0,0,44,0.0,0.0,1.0,44,1150,900,250,0.782608695652174,14,9,5,377.99142522622026,0.8011143410852714,0.2726314207848455,0.25371987555544223,136347.66333616775,1507.6495181405771,137855.31285430834,544,30,294.1818181818182,34,10,19,29.02940841217371,0.6878063725490196,38.89880952380952,1044.4047619047615,30.717787114845926,0
546,4,0,0,44,0.0,0.0,1.0,44,900,400,500,0.4444444444444444,14,4,10,373.2513738055808,0.7994846723044398,0.2671490428441208,0.2512004644568846,136440.92970521533,1385.352891156448,137826.28259637178,545,31,295.1818181818182,34,10,19,29.0605534032209,0.6887254901960784,38.8095238095238,1044.761904761904,30.728291316526587,0
547,4,0,0,44,0.0,0.0,1.0,44,1150,700,450,0.6086956521739131,16,7,9,371.29463787737836,0.7986918604651163,0.2629389348548703,0.2505453978420833,136534.22796201814,1338.885345804988,137873.11330782314,546,32,296.1818181818182,34,10,19,29.019060637126472,0.6896446078431373,38.720238095238095,1045.1190476190475,30.73879551820728,0
548,4,0,1,43,0.0,0.022727272727272728,0.9772727272727273,44,750,400,350,0.5333333333333333,11,4,7,371.10995867102935,0.7982954545454546,0.2671392779865618,0.2508634755265828,136596.4445153062,1338.4601757369737,137934.9046910432,547,33,297.1818181818182,34,10,20,28.962153133659797,0.6902573529411764,38.66071428571429,1045.3571428571436,30.74579831932775,0
549,4,0,0,43,0.0,0.0,1.0,43,1200,700,500,0.5833333333333334,17,7,10,376.76142048940517,0.7925895164267257,0.2693358535071704,0.2544900814091114,136569.65509527182,1690.8354498885515,138260.49054516037,548,40,304.3255813953488,35,8,21,28.84105211678293,0.6877976190476189,38.686342592592595,1045.25462962963,29.864417989418,0
550,4,0,0,43,0.0,0.0,1.0,43,1100,700,400,0.6363636363636364,15,7,8,377.10929840772224,0.7918973791066815,0.2699877980342993,0.25538271377926264,136660.40407450276,1707.1818201303167,138367.58589463308,549,41,305.3255813953488,35,8,22,28.74188251789535,0.6886904761904762,38.59953703703704,1045.6018518518522,29.874338624338634,0
551,4,0,0,43,0.0,0.0,1.0,43,950,600,350,0.631578947368421,13,6,7,379.2474566122619,0.7915282392026578,0.26713449635794584,0.25775760279184484,136786.95294166406,1775.2609879306438,138562.2139295947,550,42,306.3255813953488,32,11,22,28.56040032186683,0.6969401041666667,38.47853535353535,1046.085858585858,32.69018308080806,0
552,4,0,0,43,0.0,0.0,1.0,43,1300,900,400,0.6923076923076923,17,9,8,378.90568050039263,0.789313399778516,0.2688348525785089,0.2584978753636009,136919.0663739667,1775.8824035812356,138694.94877754792,551,43,307.3255813953488,32,11,22,28.438291711907347,0.6982421875000001,38.35227272727271,1046.590909090907,32.70596590909084,0
553,4,0,0,43,0.0,0.0,1.0,43,1500,1300,200,0.8666666666666667,17,13,4,379.8920794754137,0.7889442598744923,0.26835055362972415,0.25990636328466415,137018.1932966023,1810.4252754820782,138828.61857208438,552,44,308.3255813953488,32,11,19,28.314188374336698,0.69921875,38.25757575757575,1046.969696969696,32.717803030303,0
554,4,0,0,43,0.0,0.0,1.0,43,750,400,350,0.5333333333333333,11,4,7,391.3311003518097,0.790328534514581,0.25129992571853044,0.2686511578077843,137137.77641111583,2133.255388552476,139271.0317996683,553,45,309.3255813953488,33,10,18,27.896118521118524,0.6979166666666667,38.143382352941174,1047.4264705882347,31.740196078431353,2
555,4,0,0,43,0.0,0.0,1.0,43,900,700,200,0.7777777777777778,11,7,4,389.18262607619477,0.7906515319306017,0.2496583049872061,0.2676961345928353,137205.53090706433,2079.601766117952,139285.1326731823,554,46,310.3255813953488,35,8,18,27.885181911916327,0.6940476190476191,38.078703703703695,1047.685185185184,29.9338624338624,0
556,4,0,0,43,0.0,0.0,1.0,43,1100,800,300,0.7272727272727273,14,8,6,387.3708769739868,0.7901439645625692,0.25142475569196043,0.26714724226956954,137296.49087202066,2036.9324149091153,139333.42328692978,555,47,311.3255813953488,35,8,18,27.842467329284005,0.6949404761904763,37.991898148148145,1048.0324074074067,29.94378306878305,0
557,4,0,1,42,0.0,0.023255813953488372,0.9767441860465116,43,1250,900,350,0.72,16,9,7,388.070698653568,0.7897286821705426,0.2448791005698443,0.2688012637462786,137448.1577932097,2067.9205246913416,139516.07831790106,556,48,312.3255813953488,35,8,19,27.67384105960264,0.6964285714285715,37.847222222222214,1048.61111111111,29.960317460317427,0
558,4,0,0,42,0.0,0.0,1.0,42,1200,800,400,0.6666666666666666,16,8,8,389.5835280590093,0.7901664730933023,0.2385628334657739,0.27001111712602777,137468.964356576,2311.1288265306202,139780.09318310663,557,49,308.04761904761904,34,8,19,27.613567563476757,0.6988357843137255,37.827380952380956,1048.6904761904766,30.843837535014018,0
559,4,0,1,41,0.0,0.023809523809523808,0.9761904761904762,42,1200,900,300,0.75,15,9,6,378.0837395834089,0.7901664730933023,0.19586445899114358,0.25392662452108034,136367.82633562628,1911.6915479668974,138279.5178835932,558,50,309.04761904761904,36,6,19,29.00696316262354,0.6837384259259259,38.87950450450451,1044.4819819819827,29.013388388388407,3
560,4,0,0,41,0.0,0.0,1.0,41,1300,1000,300,0.7692307692307693,16,10,6,377.60335638703134,0.7880081300813008,0.18048996617569224,0.25440321652702375,136478.93625685864,2106.9808813443015,138585.91713820293,559,51,304.1707317073171,35,6,19,28.909134544380443,0.6869047619047619,38.773148148148145,1044.907407407407,29.85449735449734,0
561,4,0,0,41,0.0,0.0,1.0,41,1350,1000,350,0.7407407407407407,17,10,7,381.2040467695833,0.7885670731707317,0.13467149025557235,0.24010632973240284,134054.68813407977,2048.5693510702577,136103.25748515004,560,52,305.1707317073171,36,5,18,31.234368203566767,0.6608796296296298,41.10360360360359,1035.5855855855834,28.766266266266207,7
562,4,0,0,41,0.0,0.0,1.0,41,900,600,300,0.6666666666666666,12,6,6,380.7457927300092,0.7860772357723578,0.1380390784670804,0.2407726487222552,134200.5027620525,2019.2553617806861,136219.7581238332,561,53,306.1707317073171,36,5,19,31.100106872441387,0.662326388888889,40.96283783783783,1036.1486486486478,28.781906906906883,0
563,4,0,0,41,0.0,0.0,1.0,41,900,400,500,0.4444444444444444,14,4,10,380.305927339999,0.785010162601626,0.13765924685216713,0.24087786987680715,134258.8508060424,2011.8873518788967,136270.7381579213,562,54,307.1707317073171,36,5,19,31.053053352167783,0.6629050925925927,40.90653153153153,1036.373873873873,28.788163163163137,0
564,4,1,0,42,0.023809523809523808,0.0,1.0,42,1250,900,350,0.72,16,9,7,375.5068656274982,0.7859320557491289,0.1365529035616031,0.24014226513667264,134610.82845721886,1710.092134724195,136320.92059194305,563,0,300.8333333333333,35,7,20,30.825247230277334,0.6684523809523808,40.56712962962963,1037.731481481482,29.649470899470913,0
565,4,1,1,42,0.023255813953488372,0.023255813953488372,0.9767441860465116,43,1300,1000,300,0.7692307692307693,16,10,6,346.3245877629357,0.7910206718346253,0.12308051887343718,0.21948596485612773,134280.7345920137,700.9440104166476,134981.67860243036,564,0,294.8139534883721,39,4,17,31.911641541038524,0.6575854700854702,40.88541666666666,1036.4583333333317,26.57585470085466,6
566,4,0,0,42,0.0,0.0,1.0,42,850,700,150,0.8235294117647058,10,7,3,352.31112452210584,0.7858352690669764,0.12383604431871764,0.2223963973545791,134135.43721236012,1051.4813445101693,135186.91855687028,565,2,302.8333333333333,38,4,17,31.901686262376224,0.6578947368421053,41.025641025641015,1035.8974358974344,27.26045883940617,0
567,4,0,0,42,0.0,0.0,1.0,42,1050,700,350,0.6666666666666666,14,7,7,364.61157291400457,0.7869967092528068,0.10815068034050501,0.23039559747158164,134172.79188368077,1393.15359703733,135565.9454807181,566,3,303.8333333333333,39,3,18,31.545763791138825,0.6565170940170939,40.98958333333334,1036.0416666666683,26.565170940170983,3
568,4,0,1,41,0.0,0.023809523809523808,0.9761904761904762,42,950,500,450,0.5263157894736842,14,5,9,364.61157291400457,0.788109756097561,0.10815068034050501,0.23039559747158164,134172.79188368077,1384.1905381944637,135556.98242187523,567,4,304.8333333333333,39,3,18,31.545763791138825,0.6565170940170939,40.98958333333334,1036.0416666666683,26.565170940170983,0
569,4,0,0,41,0.0,0.0,1.0,41,850,600,250,0.7058823529411765,11,6,5,365.99538499983555,0.7871443089430894,0.09076398297735389,0.2322598574658867,134329.184530006,1632.7723217547136,135961.9568517607,568,5,299.5609756097561,38,3,18,31.353490329451382,0.659813596491228,40.838675213675224,1036.6452991453004,27.280139451192117,0
570,4,0,0,41,0.0,0.0,1.0,41,1300,1000,300,0.7692307692307693,16,10,6,366.9893074798606,0.7867886178861788,0.08469385960725417,0.23395267145909188,134495.3649485902,1671.6721683468566,136167.03711693705,569,6,300.5609756097561,38,3,18,31.161594053627212,0.6614583333333333,40.67841880341881,1037.2863247863256,27.29700854700857,0
571,4,0,0,41,0.0,0.0,1.0,41,1200,700,500,0.5833333333333334,17,7,10,367.99874581978827,0.7865345528455284,0.08155836382680626,0.23514673957764787,134580.80317911942,1705.1475990898398,136285.95077820926,570,7,301.5609756097561,35,6,18,31.050032533928245,0.6681547619047619,40.59606481481481,1037.61574074074,29.646164021163997,0
572,4,0,0,41,0.0,0.0,1.0,41,1350,1000,350,0.7407407407407407,17,10,7,366.8843745777218,0.7865345528455284,0.08040595842200027,0.2296881168574813,133831.25964506168,1620.1195987654294,135451.3792438271,571,8,302.5609756097561,35,6,15,31.828859060402696,0.6607142857142857,41.31944444444444,1034.722222222222,29.563492063492056,1
573,4,0,0,41,0.0,0.0,1.0,41,1400,1200,200,0.8571428571428571,16,12,4,362.40828009717194,0.7861280487804878,0.07598805159250177,0.2279057268955814,133996.384475692,1512.27984741499,135508.664323107,572,9,303.5609756097561,36,5,17,31.779330722935246,0.6603009259259258,41.15990990990991,1035.360360360361,28.760010010010028,0
574,4,0,0,41,0.0,0.0,1.0,41,1000,600,400,0.6,14,6,8,361.05789224952724,0.7857723577235772,0.0802598091198301,0.22814097587195412,134171.3334956579,1488.7237744501326,135660.05727010802,573,10,304.5609756097561,36,5,17,31.639266304347814,0.662037037037037,40.990990990990994,1036.0360360360366,28.778778778778797,0
575,4,0,0,41,0.0,0.0,1.0,41,700,300,400,0.42857142857142855,11,3,8,359.9977627875516,0.7864329268292682,0.0770405161126162,0.22783352222634465,134229.67519884757,1464.4765542569712,135694.15175310455,574,11,305.5609756097561,36,5,18,31.60839129174819,0.6626157407407407,40.93468468468469,1036.2612612612618,28.78503503503505,0
576,4,0,0,41,0.0,0.0,1.0,41,900,600,300,0.6666666666666666,12,6,6,359.3295701153511,0.7858231707317073,0.07332036510549145,0.22799340643426388,134323.35550361662,1453.2707179132171,135776.62622152985,575,12,306.5609756097561,37,4,18,31.53206755517947,0.661599099099099,40.84429824561404,1036.6228070175448,28.016832622095805,0
577,4,0,0,41,0.0,0.0,1.0,41,850,500,350,0.5882352941176471,12,5,7,359.91168285706914,0.7851117886178862,0.07492468325698476,0.2287180694285246,134380.1939058172,1473.00034626039,135853.19425207758,576,13,307.5609756097561,37,4,18,31.460184010152282,0.6621621621621621,40.78947368421053,1036.8421052631581,28.022759601706976,0
578,4,0,0,41,0.0,0.0,1.0,41,700,300,400,0.42857142857142855,11,3,8,359.54362711564454,0.7849593495934959,0.0749425512654196,0.2286620095247246,134408.6176155165,1465.1523786165167,135873.769994133,577,14,308.5609756097561,37,4,18,31.441326530612255,0.6624436936936936,40.76206140350878,1036.9517543859663,28.025723091512603,0
579,4,0,0,41,0.0,0.0,1.0,41,1200,800,400,0.6666666666666666,16,8,8,358.7322991754314,0.7843495934959349,0.07504238160099552,0.22835925643162405,134442.73003472245,1445.78993055558,135888.51996527804,578,15,309.5609756097561,39,2,18,31.42828445158699,0.6591880341880341,40.72916666666668,1037.083333333335,26.591880341880387,0
580,4,0,0,41,0.0,0.0,1.0,41,1100,800,300,0.7272727272727273,14,8,6,357.4506989475051,0.7845528455284553,0.0767234484747259,0.2285950760886824,134610.8284572187,1423.5205546982088,136034.34901191693,579,16,310.5609756097561,35,6,18,31.293683545245006,0.668452380952381,40.567129629629626,1037.7314814814808,29.64947089947088,0
581,4,0,0,41,0.0,0.0,1.0,41,1050,700,350,0.6666666666666666,14,7,7,357.73649064328146,0.7842987804878049,0.07932131495228001,0.22953478691489515,134730.9630594135,1439.636381172832,136170.59944058635,580,17,311.5609756097561,35,6,18,31.166387959866224,0.6696428571428572,40.451388888888886,1038.194444444444,29.662698412698397,0
582,4,0,0,41,0.0,0.0,1.0,41,800,500,300,0.625,11,5,6,355.84971413582457,0.7853658536585366,0.07154154170038796,0.22884561114090468,134813.78971877278,1394.6897065984876,136208.47942537128,581,18,312.5609756097561,36,5,14,31.13275319887228,0.6684027777777778,40.37162162162162,1038.513513513513,28.847597597597584,0
583,4,0,0,41,0.0,0.0,1.0,41,850,500,350,0.5882352941176471,12,5,7,359.29029833605955,0.7857215447154472,0.07371639778027128,0.23192335606488423,134949.23918898127,1497.1904816866713,136446.42967066795,582,19,313.5609756097561,37,4,14,30.90834740396791,0.6677927927927928,40.24122807017544,1039.0350877192986,28.082029397818882,0
584,4,0,1,40,0.0,0.024390243902439025,0.975609756097561,41,1100,1000,100,0.9090909090909091,12,10,2,357.96565577618253,0.7855691056910569,0.07670357323891785,0.23161477481927897,135034.6996792283,1467.5569646429726,136502.25664387128,583,20,314.5609756097561,37,4,14,30.857575517811306,0.6686373873873874,40.15899122807018,1039.36403508772,28.090919867235673,0
585,4,0,0,40,0.0,0.0,1.0,40,1250,1000,250,0.8,15,10,5,362.0878062589921,0.7805021367521368,0.08838821490467974,0.23474681372071757,135106.322538755,1784.07038795553,136890.3929267105,584,21,321.0,36,4,15,30.679069179664943,0.6712962962962963,40.090090090090094,1039.6396396396399,28.878878878878886,0
586,4,0,0,40,0.0,0.0,1.0,40,1450,1300,150,0.896551724137931,16,13,3,361.86781378775675,0.7775641025641026,0.08704806577421742,0.23562388122199363,135262.72657211832,1789.445430324709,137052.17200244303,585,22,322.0,37,3,16,30.52894750711499,0.6708896396396395,39.93969298245614,1040.241228070175,28.11462778568041,0
587,4,0,0,40,0.0,0.0,1.0,40,1400,1100,300,0.7857142857142857,17,11,6,359.2503386088296,0.775667735042735,0.08476611883691532,0.23484877507403645,135405.3410664819,1728.8829255155315,137134.22399199742,586,23,323.0,37,3,16,30.455032307908404,0.6722972972972974,39.80263157894736,1040.7894736842097,28.12944523470837,0
588,4,0,0,40,0.0,0.0,1.0,40,1050,800,250,0.7619047619047619,13,8,5,361.99923409704576,0.7740384615384616,0.08788046340179068,0.23721067824371622,135490.9458318905,1809.523723645732,137300.46955553623,587,24,324.0,37,3,16,30.29829296120765,0.6731418918918919,39.7203947368421,1041.118421052631,28.13833570412516,0
589,4,0,0,40,0.0,0.0,1.0,40,1250,900,350,0.72,16,9,7,360.0150180734994,0.7734241452991453,0.08858466722830705,0.23609824665925047,135519.48676515848,1757.8100954139702,137277.29686057245,588,25,325.0,37,3,16,30.321538893569222,0.6734234234234234,39.69298245614035,1041.2280701754382,28.141299193930763,0
590,4,0,0,40,0.0,0.0,1.0,40,1100,800,300,0.7272727272727273,14,8,6,358.38291773279406,0.7722222222222223,0.08769455252918235,0.23616515348032857,135692.33929875834,1726.0113860959955,137418.35068485432,589,26,326.0,36,4,17,30.192120622568094,0.6770833333333334,39.52702702702703,1041.8918918918928,28.941441441441466,0
591,4,0,0,40,0.0,0.0,1.0,40,1150,700,450,0.6086956521739131,16,7,9,347.9879348504871,0.7724626068376068,0.05421253175275198,0.21977205938953212,134152.9124345951,1369.5896990049732,135522.5021336001,590,27,327.0,37,3,18,31.996189669771375,0.6599099099099099,41.008771929824555,1035.9649122807007,27.99905168326218,4
592,4,0,0,40,0.0,0.0,1.0,40,1100,800,300,0.7272727272727273,14,8,6,348.69100064848675,0.7711271367521367,0.049619128226830345,0.22089995563870615,134266.5291243459,1363.506078793469,135630.03520313936,591,28,328.0,37,3,18,31.864508393285387,0.661036036036036,40.89912280701754,1036.4035087719294,28.01090564248458,0
593,4,0,0,40,0.0,0.0,1.0,40,1100,900,200,0.8181818181818182,13,9,4,349.95904366567777,0.7699519230769231,0.048429236302094614,0.22204783884666549,134323.35550361648,1401.534606802092,135724.89011041858,592,29,329.0,37,3,18,31.774910090966785,0.6615990990990991,40.844298245614034,1036.6228070175437,28.016832622095773,0
594,4,0,0,40,0.0,0.0,1.0,40,1150,900,250,0.782608695652174,14,9,5,352.11654463686745,0.7686431623931624,0.043330337316274115,0.22393854489783838,134408.61761551636,1465.4996008387247,135874.11721635508,593,30,330.0,37,3,18,31.633864685770686,0.6624436936936937,40.762061403508774,1036.9517543859652,28.02572309151257,0
595,4,0,0,40,0.0,0.0,1.0,40,600,400,200,0.6666666666666666,8,4,4,352.0034232572062,0.7692307692307693,0.04455280685061869,0.2242155138444387,134465.4740521123,1466.4614352493163,135931.9354873616,594,31,331.0,37,3,18,31.580042816365363,0.6630067567567567,40.70723684210527,1037.1710526315796,28.031650071123774,0
596,4,0,0,40,0.0,0.0,1.0,40,1300,900,400,0.6923076923076923,17,9,8,352.0910953049142,0.7684294871794872,0.04447791164658632,0.2247966223869839,134550.78125000015,1474.853440481702,136025.63469048185,595,32,332.0,37,3,19,31.49263721552878,0.6638513513513513,40.62500000000001,1037.5000000000011,28.040540540540572,0
597,4,0,1,39,0.0,0.025,0.975,40,1050,700,350,0.6666666666666666,14,7,7,350.4509412247505,0.7667735042735043,0.04474612129760236,0.22446882038002264,134667.6421987867,1438.8803922165503,136106.52259100325,596,33,333.0,36,4,19,31.418619579762048,0.6669560185185185,40.51238738738739,1037.950450450451,28.831956956956972,0
598,4,1,1,39,0.025,0.025,0.975,40,1150,600,550,0.5217391304347826,17,6,11,341.80553217252674,0.7656517094017093,0.05899451361046637,0.22098450436092837,135006.20984341338,1229.1738804247502,136235.38372383814,597,0,329.95,37,3,17,31.3058310473377,0.6683558558558558,40.18640350877193,1039.2543859649124,28.087956377430068,0
599,4,0,0,39,0.0,0.0,1.0,39,750,300,450,0.4,12,3,9,350.9326752888127,0.7635515069725596,0.06156625668820803,0.22623018375536658,134901.51627556607,1668.2700014203378,136569.78627698642,598,1,336.84615384615387,36,3,17,31.17299006323396,0.6692708333333334,40.28716216216216,1038.8513513513512,28.856981981981978,0
600,4,0,0,39,0.0,0.0,1.0,39,1000,700,300,0.7,13,7,6,347.5492691153683,0.7622582096266307,0.06053482711480118,0.22459276298295658,134989.27136596065,1583.084520331155,136572.3558862918,599,2,337.84615384615387,36,3,17,31.173466623320337,0.6701388888888888,40.20270270270271,1039.18918918919,28.866366366366393,0
601,4,0,0,39,0.0,0.0,1.0,39,1100,800,300,0.7272727272727273,14,8,6,348.85535181369846,0.7607962213225371,0.06360229098048142,0.2262548868602935,135120.18722106813,1627.4800900277132,136747.66731109584,600,3,338.84615384615387,37,2,17,31.009192856640652,0.6694819819819819,40.07675438596492,1039.6929824561412,28.099810336652464,0
602,4,0,0,39,0.0,0.0,1.0,39,750,500,250,0.6666666666666666,10,5,5,348.6312982276884,0.760515069725596,0.06604375520444683,0.2264670707117395,135177.19394429057,1625.4001231148054,136802.59406740539,601,4,339.84615384615387,37,2,17,30.95828061296218,0.670045045045045,40.021929824561404,1039.9122807017545,28.105737316263635,0
603,4,0,0,39,0.0,0.0,1.0,39,1050,700,350,0.6666666666666666,14,7,7,350.9579757130551,0.7589406207827261,0.06929320284437779,0.2285201314749317,135262.7265721184,1694.3065414358337,136957.03311355424,602,5,340.84615384615387,37,2,17,30.812669091036863,0.6708896396396395,39.939692982456144,1040.241228070176,28.114627785680433,0
604,4,0,1,38,0.0,0.02564102564102564,0.9743589743589743,39,850,700,150,0.8235294117647058,10,7,3,354.80706772477504,0.7585470085470086,0.0717192186106832,0.23157627735268996,135348.2862515388,1804.5057132963832,137152.7919648352,603,6,341.84615384615387,37,2,18,30.62741482262031,0.6717342342342343,39.85745614035087,1040.5701754385955,28.123518255097174,0
605,4,0,1,37,0.0,0.02631578947368421,0.9736842105263158,38,850,500,350,0.5882352941176471,12,5,7,351.12336897791937,0.7573494547178757,0.051469034030859895,0.22417876634744108,134550.78125000017,1848.7847222222372,136399.56597222242,604,7,337.2368421052632,36,2,20,31.5177376171352,0.665798611111111,40.62500000000001,1037.5000000000014,28.819444444444482,2
606,4,0,0,37,0.0,0.0,1.0,37,950,500,450,0.5263157894736842,14,5,9,352.48967873617096,0.7515015015015015,0.02024530408809877,0.2190734391644221,133561.93636670534,2015.84080825618,135577.77717496152,605,8,340.7837837837838,35,2,18,32.47081793752099,0.6580357142857143,41.579861111111114,1033.680555555556,29.533730158730176,2
607,4,0,0,37,0.0,0.0,1.0,37,950,800,150,0.8421052631578947,11,8,3,352.9042541190621,0.751438938938939,0.01822767049887175,0.2205774981339985,133771.38658479083,2041.6982810356687,135813.0848658265,606,9,341.7837837837838,35,2,16,32.250410233460116,0.6601190476190476,41.37731481481482,1034.490740740741,29.556878306878318,0
608,4,0,0,37,0.0,0.0,1.0,37,1100,700,400,0.6363636363636364,15,7,8,351.9531473847787,0.75,0.017784201026174618,0.22016159443474703,133801.32144043632,2018.3592410408016,135819.68068147713,607,10,342.7837837837838,35,2,16,32.24505444307714,0.6604166666666667,41.348379629629626,1034.606481481481,29.560185185185173,0
609,4,0,0,37,0.0,0.0,1.0,37,450,300,150,0.6666666666666666,6,3,3,352.29043736768637,0.7494994994994995,0.014511155450753321,0.22055157633523215,133831.25964506165,2029.494598765429,135860.75424382708,608,11,343.7837837837838,35,2,16,32.20637583892618,0.6607142857142857,41.31944444444444,1034.7222222222217,29.56349206349205,0
610,4,0,0,37,0.0,0.0,1.0,37,600,300,300,0.5,9,3,6,350.66762161840086,0.7489364364364365,0.021459616628482392,0.21989269793209962,133891.1461012518,1990.2579518175623,135881.40405306936,609,12,344.7837837837838,35,2,16,32.18845523000073,0.6613095238095238,41.261574074074076,1034.9537037037044,29.57010582010584,0
611,4,1,0,38,0.02631578947368421,0.0,1.0,38,650,400,250,0.6153846153846154,9,4,5,346.4171840968395,0.755452821242295,0.032715999954243236,0.21923871582249788,134229.6751988476,1699.8932209236375,135929.56841977124,610,0,336.6842105263158,36,2,17,31.960216981815563,0.6626157407407407,40.93468468468469,1036.261261261262,28.785035035035055,0
612,4,0,0,38,0.0,0.0,1.0,38,1150,800,350,0.6956521739130435,15,8,7,343.79008732323337,0.7546526789947843,0.03232380397066281,0.21844550269047708,134375.58493882412,1639.3988160457916,136014.9837548699,611,1,337.6842105263158,36,2,17,31.88267079396112,0.6640625,40.793918918918926,1036.8243243243255,28.80067567567571,0
613,4,0,0,38,0.0,0.0,1.0,38,800,500,300,0.625,11,5,6,345.4013658854026,0.7546230440967283,0.03724784273387027,0.21999630565730013,134463.16882761155,1688.7524348673146,136151.92126247886,612,2,338.6842105263158,36,2,17,31.753528773072738,0.6649305555555556,40.70945945945947,1037.1621621621634,28.810060060060096,0
614,4,0,0,38,0.0,0.0,1.0,38,650,500,150,0.7692307692307693,8,5,3,345.40263708218157,0.7544155998103367,0.03622906224444922,0.22035430542377074,134522.34251163818,1692.8743699984595,136215.21688163665,613,3,339.6842105263158,37,1,17,31.694478208786958,0.6635698198198199,40.65241228070175,1037.390350877193,28.037577050734946,0
615,4,0,0,38,0.0,0.0,1.0,38,1050,800,250,0.7619047619047619,13,8,5,347.5805713219115,0.7540303461356093,0.03769883199588753,0.22227307180648284,134609.20538359322,1757.5119082161173,136366.71729180933,614,4,340.6842105263158,36,2,17,31.551365527220124,0.6663773148148147,40.5686936936937,1037.7252252252265,28.825700700700736,0
616,4,0,0,38,0.0,0.0,1.0,38,750,400,350,0.5333333333333333,11,4,7,343.18644893345555,0.7540007112375533,0.044635958890784755,0.22031406677633183,134749.9365790437,1648.8704457140802,136398.80702475776,615,5,341.6842105263158,37,1,17,31.52513024958636,0.665822072072072,40.433114035087726,1038.2675438596502,28.061284969179734,0
617,4,0,0,38,0.0,0.0,1.0,38,1350,900,450,0.6666666666666666,18,9,9,343.159675903989,0.7519262683736369,0.04598387661331116,0.22098923248392172,134863.80575032707,1655.9639744921587,136519.76972481923,616,6,342.6842105263158,37,1,14,31.41241335022345,0.6669481981981982,40.323464912280706,1038.7061403508776,28.0731389284021,0
618,4,0,0,38,0.0,0.0,1.0,38,1200,800,400,0.6666666666666666,16,8,8,352.99108608368505,0.7508594120436226,0.10026448029621804,0.22371091124411865,134280.73459201373,1894.8708677188954,136175.60545973261,617,7,343.6842105263158,35,3,15,31.738902847571186,0.6651785714285714,40.88541666666666,1036.458333333332,29.613095238095198,3
619,4,0,0,38,0.0,0.0,1.0,38,1200,800,400,0.6666666666666666,16,8,8,356.271100997723,0.7510372214319583,0.10544821144277172,0.22653178096796292,134400.72183909875,1976.6186289008733,136377.34046799963,618,8,344.6842105263158,35,3,15,31.53404862893925,0.6663690476190478,40.76967592592592,1036.921296296295,29.626322751322714,0
620,4,0,0,38,0.0,0.0,1.0,38,1000,700,300,0.7,13,7,6,353.0588216319093,0.7496443812233285,0.10008454872120076,0.22541447842652654,134550.78124999985,1900.868055555542,136451.6493055554,619,9,345.6842105263158,35,3,16,31.467536813922372,0.6678571428571429,40.62499999999999,1037.4999999999989,29.64285714285711,0
621,4,0,0,38,0.0,0.0,1.0,38,1100,800,300,0.7272727272727273,14,8,6,353.9039519210774,0.7490516832622096,0.10584430069150086,0.22632687823997,134610.82845721877,1927.8608324759875,136538.68928969477,620,10,346.6842105263158,35,3,17,31.385697821399354,0.668452380952381,40.567129629629626,1037.7314814814813,29.649470899470895,0
622,4,0,1,37,0.0,0.02631578947368421,0.9736842105263158,38,650,400,250,0.6153846153846154,9,4,5,352.4554745547855,0.7489331436699858,0.10103760739940815,0.22577290684337933,134670.88906035645,1893.0984224965423,136563.987482853,621,11,347.6842105263158,35,3,17,31.36336604222419,0.6690476190476191,40.509259259259245,1037.9629629629612,29.656084656084605,0
623,4,0,0,37,0.0,0.0,1.0,37,950,700,250,0.7368421052631579,12,7,5,361.12320769019874,0.7491866866866866,0.09464886573320319,0.23056327875604973,134550.78124999985,2317.8819444444307,136868.6631944443,622,12,342.4594594594595,34,3,17,31.258366800535484,0.6700367647058825,40.62499999999999,1037.4999999999989,30.514705882352906,0
624,4,0,0,37,0.0,0.0,1.0,37,800,500,300,0.625,11,5,6,364.41157012305246,0.7478728728728729,0.0979632839217559,0.23305764172873408,134612.5442885486,2410.8737244897798,137023.4180130384,623,13,343.4594594594595,34,3,17,31.111381973920693,0.6706495098039216,40.56547619047618,1037.7380952380943,30.52170868347336,0
625,4,0,1,36,0.0,0.02702702702702703,0.972972972972973,37,1050,800,250,0.7619047619047619,13,8,5,363.7786347007852,0.748998998998999,0.09417467002606306,0.23344470001659645,134736.11288265293,2402.8238378684623,137138.9367205214,624,14,344.4594594594595,34,3,17,31.00442418682873,0.671875,40.44642857142856,1038.2142857142846,30.535714285714253,0
626,4,0,0,36,0.0,0.0,1.0,36,800,500,300,0.625,11,5,6,371.49180672813156,0.7431878306878308,0.10850417765185782,0.23822158174065128,134709.75894187333,2808.7143466455154,137518.47328851884,625,15,351.5833333333333,33,3,17,30.830554243890912,0.6739267676767677,40.47181372549019,1038.112745098039,31.457961972667853,0
627,4,0,0,36,0.0,0.0,1.0,36,1100,900,200,0.8181818181818182,13,9,4,357.00763089520035,0.7427910052910054,0.08848866437269698,0.20973622496333508,131443.5782911289,2185.27209642074,133628.85038754967,626,16,352.5833333333333,36,0,18,34.48504648949412,0.634837962962963,43.637387387387385,1025.45045045045,28.484734734734722,8
628,4,0,1,35,0.0,0.027777777777777776,0.9722222222222222,36,850,700,150,0.8235294117647058,10,7,3,355.1703785504031,0.7427910052910054,0.0745433079038873,0.2006384645056499,129928.59977324265,2069.1084700254605,131997.7082432681,627,17,353.5833333333333,34,2,19,36.06643118480461,0.6237745098039216,45.11904761904762,1019.5238095238096,29.985994397759107,8
629,4,1,1,35,0.027777777777777776,0.027777777777777776,0.9722222222222222,36,850,600,250,0.7058823529411765,11,6,5,350.19728315204986,0.7566798941798942,0.09170540877650524,0.19937958942013742,130233.05047850226,1921.452090835054,132154.50256933732,628,0,350.9166666666667,35,1,19,35.884288657066186,0.624702380952381,44.820601851851855,1020.7175925925928,29.163359788359795,0
630,4,1,0,36,0.027777777777777776,0.0,1.0,36,700,500,200,0.7142857142857143,9,5,4,349.97263955586806,0.754728835978836,0.09425300385400148,0.19970625007515308,130321.6695066014,1921.8037337105507,132243.47324031196,629,0,351.8888888888889,35,1,20,35.800177586337185,0.6255952380952381,44.73379629629629,1021.0648148148141,29.173280423280403,0
631,4,0,0,36,0.0,0.0,1.0,36,750,400,350,0.5333333333333333,11,4,7,348.60247156091305,0.7550595238095239,0.08892161304938906,0.19983523499608682,130498.99798525359,1898.4546467763882,132397.45263202998,630,1,352.8888888888889,35,1,16,35.65549010723457,0.6273809523809524,44.560185185185176,1021.7592592592578,29.19312169312165,0
632,4,1,2,35,0.02702702702702703,0.05405405405405406,0.9459459459459459,37,750,500,250,0.6666666666666666,10,5,5,342.5731141687204,0.7673298298298298,0.08068817716394805,0.1973708043560902,130694.03863322778,1554.452763574379,132248.49139680216,631,0,344.3243243243243,36,1,16,35.61215124816448,0.6273148148148149,44.369369369369366,1022.5225225225222,28.403403403403395,0
633,4,1,0,36,0.027777777777777776,0.0,1.0,36,900,600,300,0.6666666666666666,12,6,6,348.2372067415931,0.7521164021164022,0.09900962082626008,0.20069639410058496,130706.03358892712,1903.340808256139,132609.37439718327,632,0,354.80555555555554,35,1,17,35.45522071307301,0.6294642857142858,44.35763888888887,1022.5694444444416,29.21626984126976,0
634,4,0,0,36,0.0,0.0,1.0,36,900,500,400,0.5555555555555556,13,5,8,350.214243345598,0.751686507936508,0.10879158180583914,0.20230022762669223,130794.81336805543,1961.241319444436,132756.05468749985,633,1,355.80555555555554,35,1,18,35.31483367277666,0.6303571428571428,44.27083333333333,1022.9166666666656,29.226190476190446,0
635,4,0,0,36,0.0,0.0,1.0,36,950,500,450,0.5263157894736842,14,5,9,348.4981879977887,0.7517526455026455,0.1042986425339365,0.20161806164269955,130854.01663237302,1920.477537722893,132774.49417009592,634,2,356.80555555555554,35,1,18,35.29883107088988,0.630952380952381,44.212962962962955,1023.1481481481475,29.232804232804213,0
636,4,0,0,36,0.0,0.0,1.0,36,1300,900,400,0.6923076923076923,17,9,8,348.1239483792908,0.751388888888889,0.10363646646307023,0.2015562428042771,130883.62328800153,1912.7447434413612,132796.3680314429,635,3,357.80555555555554,35,1,18,35.27846114692908,0.63125,44.18402777777778,1023.2638888888888,29.236111111111107,0
637,4,1,0,37,0.02702702702702703,0.0,1.0,37,1100,700,400,0.6363636363636364,15,7,8,339.0838786436645,0.7591341341341341,0.10766864425401024,0.19860627177700343,131328.12500000003,1507.0035204475316,132835.12852044756,636,0,349.1081081081081,35,2,20,35.06097560975609,0.6357142857142857,43.75,1025.0000000000002,29.285714285714292,0
638,4,0,0,37,0.0,0.0,1.0,37,900,500,400,0.5555555555555556,13,5,8,349.6395961108136,0.7597597597597597,0.1278621627748815,0.1995162041972569,130321.66950660128,1717.4634559327587,132039.13296253403,637,1,350.1081081081081,35,2,18,35.80867905992594,0.6255952380952381,44.73379629629628,1021.064814814813,29.17328042328037,4
639,4,1,1,37,0.02631578947368421,0.02631578947368421,0.9736842105263158,38,850,600,250,0.7058823529411765,11,6,5,343.62674042987885,0.769825746799431,0.12580379559673682,0.19753641056884153,130607.69120049085,1376.0590404593584,131983.7502409502,638,0,341.86842105263156,36,2,16,35.672579045940296,0.6264467592592593,44.45382882882882,1022.1846846846832,28.39401901901898,0
640,4,2,1,38,0.05128205128205128,0.02564102564102564,0.9743589743589743,39,850,600,250,0.7058823529411765,11,6,5,326.45233599326366,0.7808142150247414,0.09293931874577055,0.18509304655960063,130071.79578493652,692.4483161662322,130764.24410110275,639,0,334.05128205128204,38,1,16,36.653400363077786,0.6173245614035089,44.97863247863246,1020.0854700854677,26.84435447593336,2
641,4,0,0,38,0.0,0.0,1.0,38,950,700,250,0.7368421052631579,12,7,5,329.84855453832574,0.768610715979137,0.09946706495358049,0.18699458274649838,130066.77685682102,980.4676679362543,131047.24452475728,640,1,343.8421052631579,37,1,17,36.571871976781686,0.6190878378378379,44.98355263157893,1020.0657894736817,27.569345661450857,0
642,4,1,0,39,0.02564102564102564,0.0,1.0,39,750,400,350,0.5333333333333333,11,4,7,320.23005614979144,0.7767094017094017,0.08699673019123422,0.18324712549701785,130430.54112803908,553.7031827100275,130984.24431074911,641,0,336.0,37,2,19,36.44938814942034,0.6227477477477479,44.62719298245612,1021.4912280701728,27.60787102892359,0
643,4,0,0,39,0.0,0.0,1.0,39,700,500,200,0.7142857142857143,9,5,4,320.99971432232,0.7772154745838956,0.08627360333735101,0.1839529728201336,130486.54994806054,577.22905124649,131063.77899930703,642,1,337.0,37,2,19,36.373148744365736,0.623310810810811,44.57236842105261,1021.7105263157862,27.61379800853476,0
644,4,0,2,37,0.0,0.05128205128205128,0.9487179487179487,39,900,500,400,0.5555555555555556,13,5,8,320.91460443185866,0.7786774628879892,0.054906166219840014,0.18483809056992445,130682.67549871093,587.5958227531382,131270.27132146407,643,2,338.0,37,2,15,36.177278820375335,0.6252815315315317,44.38048245614034,1022.4780701754369,27.63454243717397,7
645,4,1,2,36,0.02631578947368421,0.05263157894736842,0.9473684210526316,38,1200,800,400,0.6666666666666666,16,8,8,325.88908918201895,0.7652323376007587,0.06949176110686239,0.18831911489373143,130809.21292914523,925.8590516191754,131735.0719807644,644,0,347.7105263157895,36,2,16,35.92236349625718,0.6284722222222223,44.25675675675675,1022.9729729729719,28.415915915915885,0
646,4,0,1,35,0.0,0.027777777777777776,0.9722222222222222,36,1250,700,550,0.56,18,7,11,343.7347037323137,0.746362433862434,0.07776030137092649,0.19707915578720445,130505.75573979602,1771.8714569161045,132277.62719671213,645,13,367.80555555555554,34,2,17,35.77299118412363,0.6295955882352942,44.55357142857143,1021.7857142857151,30.052521008403385,0
647,4,1,1,35,0.027777777777777776,0.027777777777777776,0.9722222222222222,36,700,400,300,0.5714285714285714,10,4,6,339.99846841673565,0.7475198412698413,0.09225404957822292,0.19570421224952572,130657.8514739228,1684.6938775510068,132342.54535147382,646,0,368.4166666666667,34,2,17,35.71456295606272,0.6311274509803921,44.4047619047619,1022.3809523809515,30.070028011204457,0
648,4,1,1,35,0.027777777777777776,0.027777777777777776,0.9722222222222222,36,900,800,100,0.8888888888888888,10,8,2,341.8911721537756,0.7495039682539683,0.09125598240848576,0.19710370260408924,130718.71456916087,1738.3149092970368,132457.0294784579,647,0,369.3888888888889,34,2,17,35.60462747380675,0.6317401960784315,44.34523809523809,1022.6190476190466,30.0770308123249,0
649,4,0,1,34,0.0,0.02857142857142857,0.9714285714285714,35,700,600,100,0.8571428571428571,8,6,2,351.22623045807563,0.7357142857142857,0.09803552160583706,0.20190061945215762,130606.84479827457,2174.5099541041736,132781.35475237874,648,38,380.9428571428571,33,2,17,35.47923410462376,0.6328914141414143,44.45465686274509,1022.1813725490185,30.975193107546016,0
650,4,1,1,34,0.02857142857142857,0.02857142857142857,0.9714285714285714,35,850,700,150,0.8235294117647058,10,7,3,350.3475702094239,0.7500700280112045,0.0907244738959958,0.2017218618535005,130669.48596993937,2155.9473820165267,132825.4333519559,649,0,374.85714285714283,33,2,18,35.43826661073156,0.6335227272727273,44.393382352941174,1022.4264705882347,30.982620320855595,0
651,4,0,0,34,0.0,0.0,1.0,34,950,500,450,0.5263157894736842,14,5,9,360.5199342923511,0.7362967914438503,0.09476340871919242,0.20774712235741566,130700.81218762022,2624.049644367559,133324.86183198777,650,40,386.88235294117646,33,1,20,35.146512464046026,0.6338383838383839,44.36274509803922,1022.5490196078438,30.98633392751042,0
652,4,0,0,34,0.0,0.0,1.0,34,800,500,300,0.625,11,5,6,363.5601132863236,0.7364453357100417,0.09096996095346865,0.20983905293828897,130763.47588667826,2708.0768214148466,133471.5527080931,651,41,387.88235294117646,33,1,20,35.00529195622653,0.6344696969696969,44.3014705882353,1022.7941176470594,30.99376114081998,0
653,4,0,0,34,0.0,0.0,1.0,34,800,600,200,0.75,10,6,4,371.7026128504123,0.7363339275103982,0.025062337073557206,0.20743403878426236,129450.69204152252,2823.432093425602,132274.12413494813,652,42,388.88235294117646,33,1,16,36.131683526011535,0.6212121212121213,45.588235294117645,1017.6470588235296,30.83778966131908,5
654,4,1,1,34,0.02857142857142857,0.02857142857142857,0.9714285714285714,35,650,400,250,0.6153846153846154,9,4,5,362.3521715744097,0.74593837535014,0.0222199959927869,0.2034307860886253,129685.96938775519,2398.398526077106,132084.3679138323,653,0,378.74285714285713,34,1,16,36.13010363098021,0.6213235294117647,45.35714285714286,1018.5714285714292,29.95798319327733,0
655,4,2,2,34,0.05555555555555555,0.05555555555555555,0.9444444444444444,36,750,500,250,0.6666666666666666,10,5,5,351.7753137461544,0.7593584656084656,0.017964581677829772,0.19876771897305148,129937.87140185611,1941.7870959790787,131879.6584978352,654,0,369.1666666666667,35,1,16,36.14355110303856,0.6217261904761904,45.1099537037037,1019.560185185185,29.130291005291,0
656,4,0,0,34,0.0,0.0,1.0,34,1150,1000,150,0.8695652173913043,13,10,3,368.9022327807246,0.7375965537730244,0.026312810426070365,0.2075137458280747,129762.65889321407,2773.9469194540416,132536.6058126681,655,45,391.88235294117646,33,1,17,35.88525378878998,0.6243686868686871,45.28186274509803,1018.8725490196073,30.874925727866888,0
657,4,1,0,35,0.02857142857142857,0.0,1.0,35,750,400,350,0.5333333333333333,11,4,7,357.8124553236512,0.7511904761904762,0.026804467411235322,0.20307634053799253,130110.72137188193,2311.0473356008924,132421.7687074828,656,0,381.65714285714284,34,1,18,35.81412874367951,0.6256127450980392,44.94047619047618,1020.2380952380939,30.00700280112041,0
658,4,0,0,35,0.0,0.0,1.0,35,950,700,250,0.7368421052631579,12,7,5,357.4982636207586,0.75,0.027468297478795645,0.2033730998023066,130201.83000283432,2309.3856292516834,132511.215632086,657,1,382.65714285714284,34,1,18,35.729664839223915,0.6265318627450981,44.85119047619047,1020.5952380952369,30.017507002801086,0
659,4,0,1,34,0.0,0.02857142857142857,0.9714285714285714,35,950,700,250,0.7368421052631579,12,7,5,346.4683892071718,0.751890756302521,0.03601378710303571,0.19183833379058576,129140.88010204083,1948.6465419501196,131089.52664399095,658,2,383.65714285714284,34,1,20,37.08884789568206,0.6158088235294117,45.892857142857146,1016.4285714285716,29.89495798319328,6
660,4,0,0,34,0.0,0.0,1.0,34,850,600,250,0.7058823529411765,11,6,5,355.91410385381215,0.7418300653594772,0.040875684571947124,0.19674931661038753,129076.82742214545,2388.0526720492226,131464.88009419467,659,49,395.88235294117646,33,1,22,36.91409390577261,0.6174242424242424,45.95588235294118,1016.1764705882363,30.793226381461704,0
661,4,2,1,35,0.05555555555555555,0.027777777777777776,0.9722222222222222,36,950,700,250,0.7368421052631579,12,7,5,341.04374082021974,0.7661044973544974,0.04820474946028841,0.19154600912308592,129701.9692670826,1646.8089581190106,131348.77822520162,660,0,374.8333333333333,35,1,16,36.65646422754991,0.619345238095238,45.34143518518519,1018.6342592592603,29.103835978836006,0
662,4,2,3,34,0.05405405405405406,0.08108108108108109,0.9189189189189189,37,1050,700,350,0.6666666666666666,14,7,7,335.710141197986,0.7723348348348348,0.03286223827361345,0.18987228785432633,129975.34855379042,1326.8085230500938,131302.15707684052,661,0,365.64864864864865,36,1,18,36.51504693539482,0.6200810185185185,45.073198198198206,1019.7072072072084,28.325200200200232,0
663,4,2,1,35,0.05555555555555555,0.027777777777777776,0.9722222222222222,36,900,700,200,0.7777777777777778,11,7,4,342.95435190846354,0.7646825396825397,0.04650181723779845,0.19313745081160838,129807.2562358276,1750.0105153760944,131557.2667512037,661,0,358.3888888888889,34,2,17,36.50092484423675,0.6225490196078431,45.238095238095234,1019.0476190476186,29.971988795518193,4
664,4,2,2,35,0.05405405405405406,0.05405405405405406,0.9459459459459459,37,850,500,350,0.5882352941176471,12,5,7,333.7963926671944,0.7738988988988988,0.05311584982600315,0.18946652938578978,130114.93866008648,1286.3794313700173,131401.3180914565,662,0,349.64864864864865,35,2,17,36.42240971828324,0.6235119047619049,44.93634259259259,1020.2546296296288,29.15013227513225,0
665,4,1,1,35,0.027777777777777776,0.027777777777777776,0.9722222222222222,36,1050,700,350,0.6666666666666666,14,7,7,343.80357052657075,0.7691798941798942,0.06353122833553915,0.19514671437164943,130114.9386600864,1746.7960980366704,131861.73475812306,663,0,360.3333333333333,35,1,17,36.16716297976932,0.6235119047619049,44.93634259259258,1020.2546296296281,29.150132275132233,0
666,4,0,0,35,0.0,0.0,1.0,35,800,600,200,0.75,10,6,4,352.36381799480876,0.7548319327731092,0.06961596825026262,0.19951756964715947,130019.64462868462,2162.8436791382946,132182.4883078229,664,3,371.62857142857143,34,1,17,36.04553324773354,0.6246936274509804,45.02976190476189,1019.8809523809508,29.99649859943973,0
667,4,0,0,35,0.0,0.0,1.0,35,950,800,150,0.8421052631578947,11,8,3,355.16481374192176,0.7560924369747899,0.0806718768225827,0.20204565017979392,130201.83000283432,2248.6217403627948,132450.4517431971,665,4,372.62857142857143,34,1,18,35.78920253509078,0.6265318627450982,44.85119047619047,1020.5952380952369,30.017507002801086,0
668,4,0,0,35,0.0,0.0,1.0,35,600,300,300,0.5,9,3,6,351.353602665556,0.7556022408963585,0.07673469387755105,0.2001898433792122,130262.5868055555,2153.6600056689304,132416.24681122444,666,5,373.62857142857143,33,2,18,35.82482993197279,0.629419191919192,44.791666666666664,1020.8333333333329,30.934343434343422,0
669,4,1,1,35,0.027777777777777776,0.027777777777777776,0.9722222222222222,36,750,500,250,0.6666666666666666,10,5,5,342.7176750064527,0.7644179894179894,0.06706654243341847,0.1969594349133469,130597.00255102034,1751.5802154194894,132348.58276643982,667,0,364.22222222222223,34,2,17,35.70662512617438,0.630514705882353,44.46428571428571,1022.1428571428567,30.06302521008402,0
670,4,0,0,35,0.0,0.0,1.0,35,950,500,450,0.5263157894736842,14,5,9,349.59024244679364,0.7572128851540616,0.07173018919660024,0.20015001792832887,130450.30757400986,2120.830930411369,132571.13850442122,668,7,375.62857142857143,33,2,19,35.67958253358926,0.6313131313131313,44.607843137254896,1021.5686274509793,30.9566250742721,0
671,4,1,1,35,0.027777777777777776,0.027777777777777776,0.9722222222222222,36,850,400,450,0.47058823529411764,13,4,9,339.5026705473828,0.770271164021164,0.07244338390305138,0.19588095652602847,130749.15143140574,1677.9372165532723,132427.08864795903,669,0,366.1666666666667,34,2,18,35.634918325379296,0.632046568627451,44.31547619047618,1022.7380952380939,30.080532212885117,0
672,4,1,1,35,0.027777777777777776,0.027777777777777776,0.9722222222222222,36,650,400,250,0.6153846153846154,9,4,5,340.67212318411765,0.7665013227513228,0.06689876773084058,0.1968658745474863,130810.03578514738,1712.666524943309,132522.70231009068,670,0,367.1388888888889,34,2,18,35.54346561154428,0.6326593137254901,44.25595238095238,1022.9761904761904,30.0875350140056,0
673,4,0,0,35,0.0,0.0,1.0,35,550,300,250,0.5454545454545454,8,3,5,347.6280395997939,0.757563025210084,0.07000102701037259,0.20064340376900958,130763.47588667816,2091.410154748166,132854.88604142633,671,10,378.62857142857143,33,2,18,35.412672737439074,0.634469696969697,44.30147058823529,1022.7941176470586,30.993761140819956,0
674,4,1,0,36,0.027777777777777776,0.0,1.0,36,1000,700,300,0.7,13,7,6,338.4457749533644,0.7663359788359789,0.07758019525801974,0.19728912247281472,131145.15306122435,1677.104591836724,132822.25765306107,672,0,369.0833333333333,34,2,19,35.261942119944216,0.636029411764706,43.92857142857142,1024.2857142857133,30.12605042016804,0
675,4,0,0,36,0.0,0.0,1.0,36,650,300,350,0.46153846153846156,10,3,7,349.38226084762033,0.7658399470899472,0.09249013136607775,0.20063188691483747,130566.58340419493,1923.5296201813949,132490.11302437633,673,1,370.0833333333333,34,2,18,35.567122888759464,0.6302083333333334,44.49404761904761,1022.0238095238088,30.05952380952379,1
676,4,0,0,36,0.0,0.0,1.0,36,1000,700,300,0.7,13,7,6,348.30313156712424,0.7650793650793651,0.08868964446514527,0.2004844030763044,130657.8514739228,1901.7077664398962,132559.5592403627,674,2,371.0833333333333,34,2,18,35.502299720540286,0.6311274509803921,44.4047619047619,1022.3809523809515,30.070028011204457,0
677,4,1,1,36,0.02702702702702703,0.02702702702702703,0.972972972972973,37,950,600,350,0.631578947368421,13,6,7,337.91985009080156,0.7759009009009009,0.08776985012146143,0.1962508912707245,131002.0834003127,1453.6408768432523,132455.72427715594,675,0,362.02702702702703,35,2,18,35.41984642924438,0.6324404761904763,44.068287037037024,1023.7268518518499,29.24933862433857,0
678,4,0,0,36,0.0,0.0,1.0,36,1350,1100,250,0.8148148148148148,16,11,5,347.19663215589384,0.7621031746031747,0.08432573330820903,0.20163849057248054,131002.08340031284,1896.6964323988223,132898.77983271168,676,4,373.0833333333333,35,1,18,35.18242415677406,0.6324404761904763,44.06828703703703,1023.7268518518512,29.249338624338606,0
679,4,0,0,36,0.0,0.0,1.0,36,750,600,150,0.8,9,6,3,345.9062682916461,0.762665343915344,0.0787120755475188,0.20135385933187402,131090.963648834,1869.0372085048004,132960.0008573388,677,5,374.0833333333333,35,1,18,35.12564044605184,0.6333333333333333,43.98148148148148,1024.074074074074,29.259259259259256,0
680,4,0,0,36,0.0,0.0,1.0,36,700,500,200,0.7142857142857143,9,5,4,347.64722780810104,0.7629298941798942,0.07625235404896435,0.20267970791183768,131150.233892747,1918.8030478395135,133069.03694058652,678,6,375.0833333333333,35,1,18,35.02118644067795,0.6339285714285714,43.923611111111114,1024.305555555556,29.26587301587303,0
681,4,0,0,36,0.0,0.0,1.0,36,700,500,200,0.7142857142857143,9,5,4,347.69485411452536,0.7614087301587302,0.07808655922076646,0.2030207683787456,131209.5175325791,1924.1748113854883,133133.6923439646,679,7,376.0833333333333,35,1,18,34.960084350052725,0.6345238095238093,43.865740740740755,1024.537037037039,29.27248677248683,0
682,4,0,0,36,0.0,0.0,1.0,36,750,500,250,0.6666666666666666,10,5,5,346.21625715214515,0.7605158730158731,0.07697014194811547,0.20231369799128346,131239.1643759647,1887.4264564043388,133126.59083236902,680,8,377.0833333333333,35,1,18,34.96801931548627,0.6348214285714284,43.836805555555564,1024.6527777777792,29.27579365079369,0
683,4,1,1,36,0.02702702702702703,0.02702702702702703,0.972972972972973,37,950,700,250,0.7368421052631579,12,7,5,336.464878924722,0.7687687687687688,0.07111701754760302,0.19876309669723602,131654.57182623906,1459.4580546982443,133114.0298809373,681,0,367.86486486486484,35,2,17,34.79909119957898,0.6389880952380951,43.431712962962976,1026.2731481481499,29.322089947089996,0
684,4,0,0,36,0.0,0.0,1.0,36,1100,700,400,0.6363636363636364,15,7,8,344.9812445416916,0.7629960317460318,0.07192690601464968,0.2030299455581435,131511.22448979624,1873.7811791383624,133385.0056689346,682,10,379.0833333333333,34,2,19,34.725123800680905,0.6397058823529409,43.57142857142859,1025.7142857142883,30.16806722689083,0
685,4,0,0,36,0.0,0.0,1.0,36,1050,400,650,0.38095238095238093,17,4,13,346.63849921522785,0.7634920634920636,0.07288484098438897,0.20449536103600627,131602.82206632668,1923.7209467120417,133526.54301303872,683,11,380.0833333333333,34,2,17,34.59024635495226,0.6406249999999998,43.48214285714287,1026.0714285714298,30.178571428571466,0
686,4,0,0,36,0.0,0.0,1.0,36,800,500,300,0.625,11,5,6,347.1153440715125,0.7623346560846561,0.07598304473304451,0.20559908841158847,131755.55555555574,1946.8750000000214,133702.43055555577,684,12,381.0833333333333,34,2,17,34.42403950216448,0.642156862745098,43.33333333333334,1026.6666666666683,30.196078431372598,0
687,4,0,0,36,0.0,0.0,1.0,36,650,400,250,0.6153846153846154,9,4,5,345.9867608638634,0.7620701058201059,0.0731638199757838,0.20526009623189037,131816.6737528345,1921.3647959183718,133738.03854875287,685,13,382.0833333333333,34,2,17,34.39142321663189,0.6427696078431373,43.273809523809526,1026.9047619047622,30.203081232493005,0
688,4,0,0,36,0.0,0.0,1.0,36,750,500,250,0.6666666666666666,10,5,5,347.82189714889546,0.7609126984126985,0.07479375008044098,0.20751530325407133,132030.69905045335,1984.6336451247016,134015.33269557805,686,14,383.0833333333333,34,2,18,34.12873083902853,0.6449142156862746,43.06547619047618,1027.738095238094,30.22759103641453,0
689,4,0,0,36,0.0,0.0,1.0,36,1000,900,100,0.9,11,9,2,350.62035521994943,0.7596560846560847,0.07664942617466974,0.20969233986699995,132122.47732426287,2064.965986394541,134187.4433106574,687,15,384.0833333333333,34,2,19,33.9644125366682,0.6458333333333335,42.97619047619047,1028.095238095237,30.238095238095205,0
690,4,0,0,36,0.0,0.0,1.0,36,1350,1100,250,0.8148148148148148,16,11,5,355.94507022934613,0.7587962962962963,0.08238190748026475,0.21391358114895748,132306.1295351473,2218.7429138321927,134524.8724489795,688,16,385.0833333333333,34,2,19,33.64262709249403,0.647671568627451,42.797619047619044,1028.8095238095232,30.259103641456562,0
691,4,0,0,36,0.0,0.0,1.0,36,800,400,400,0.5,12,4,8,357.35449114717835,0.7588293650793652,0.08804471438033445,0.2151143385774924,132368.2260186257,2260.476010588136,134628.70202921383,689,17,386.0833333333333,35,1,19,33.54386926854871,0.6461309523809524,42.73726851851852,1029.050925925926,29.401455026455032,0
692,4,0,0,36,0.0,0.0,1.0,36,1200,1000,200,0.8333333333333334,14,10,4,361.3506086794725,0.7590277777777779,0.09071340713407139,0.21823914187751606,132492.61289227701,2375.2639607911387,134867.87685306816,690,18,387.0833333333333,33,3,20,33.31585029559973,0.6518308080808082,42.61642156862745,1029.5343137254902,31.198009506833035,0
693,4,0,0,36,0.0,0.0,1.0,36,950,600,350,0.631578947368421,13,6,7,359.99691983426726,0.7583333333333334,0.08957523341003504,0.21760389355737497,132524.1568747596,2341.6576557093285,134865.81453046892,691,19,388.0833333333333,33,3,20,33.31895183686424,0.6521464646464648,42.58578431372548,1029.656862745097,31.201723113487787,0
694,4,0,0,36,0.0,0.0,1.0,36,950,700,250,0.7368421052631579,12,7,5,360.86258872217195,0.757936507936508,0.09044634829975151,0.21849345789777608,132587.25610342177,2369.156093810071,134956.41219723184,692,20,389.0833333333333,33,3,20,33.23318261145485,0.6527777777777778,42.52450980392157,1029.9019607843136,31.20915032679738,0
695,4,0,0,36,0.0,0.0,1.0,36,1000,700,300,0.7,13,7,6,360.90110637536696,0.7573082010582011,0.09421336414404036,0.21919993513535413,132704.48022959154,2378.638747165502,135083.11897675705,693,21,390.0833333333333,34,2,16,33.114288465241664,0.6516544117647061,42.41071428571427,1030.3571428571406,30.30462184873943,0
696,4,0,0,36,0.0,0.0,1.0,36,1200,800,400,0.6666666666666666,16,8,8,363.602501743766,0.7562500000000001,0.09226613768495673,0.2214941094753748,132815.2394654491,2458.390667866926,135273.630133316,694,22,391.0833333333333,35,1,16,32.93332210494797,0.6505952380952382,42.30324074074073,1030.787037037036,29.451058201058174,0
697,4,0,0,36,0.0,0.0,1.0,36,1000,600,400,0.6,14,6,8,362.570342922183,0.7558862433862434,0.08781070328382046,0.22139404969799328,132904.7325772674,2437.4628933041513,135342.19547057155,695,23,392.0833333333333,35,1,16,32.869967635724166,0.6514880952380953,42.21643518518517,1031.134259259257,29.460978835978775,0
698,4,0,0,36,0.0,0.0,1.0,36,1000,800,200,0.8,12,8,4,358.05708867960726,0.754728835978836,0.08113953082541836,0.2195131285068785,133053.9547432268,2328.1823345335797,135382.13707776036,696,24,393.0833333333333,35,1,16,32.836455762471026,0.6529761904761906,42.071759259259245,1031.712962962961,29.47751322751317,0
699,4,1,1,36,0.02702702702702703,0.02702702702702703,0.972972972972973,37,500,200,300,0.4,8,2,6,354.40099622338147,0.7606356356356356,0.082439652606483,0.2188694637282575,133326.80389426558,2050.230424681401,135377.03431894697,697,0,383.43243243243245,36,1,16,32.65706211609057,0.6536458333333335,41.807432432432414,1032.7702702702677,28.68806306306299,0
700,4,0,0,36,0.0,0.0,1.0,36,600,200,400,0.3333333333333333,10,2,8,363.1546853603847,0.7519510582010582,0.08997185168578548,0.22389101230822295,133263.00643272008,2479.0170342506544,135742.02346697074,698,26,395.0833333333333,35,1,18,32.4950724881366,0.6550595238095239,41.86921296296295,1032.523148148146,29.500661375661313,0
701,4,0,0,36,0.0,0.0,1.0,36,900,900,0,1.0,9,9,0,364.79545257857063,0.7495370370370371,0.09047374384106677,0.2265600034644819,133535.5467248173,2555.0165677389564,136090.56329255627,699,27,396.0833333333333,33,3,19,32.1792743656628,0.6622474747474747,41.60539215686274,1033.5784313725485,31.320558526440863,1
702,4,0,0,36,0.0,0.0,1.0,36,1200,1000,200,0.8333333333333334,14,10,4,361.05822387052365,0.748478835978836,0.08782228360957678,0.2253501328295338,133718.3673469388,2456.023242630392,136174.39058956917,700,28,397.0833333333333,34,2,18,32.092637354205046,0.661764705882353,41.42857142857143,1034.2857142857144,30.420168067226896,0
703,4,0,0,36,0.0,0.0,1.0,36,950,700,250,0.7368421052631579,12,7,5,355.6537942299103,0.7482142857142857,0.08188216514294,0.22259857366378846,133821.54959013063,2318.8283722912056,136140.37796242183,701,29,398.0833333333333,36,0,18,32.129090480336664,0.6585648148148149,41.328828828828826,1034.6846846846843,28.74124124124123,0
704,4,0,0,36,0.0,0.0,1.0,36,1550,1200,350,0.7741935483870968,19,12,7,359.47037062486197,0.7479828042328043,0.07457062740974418,0.2258790920816374,133967.23740209805,2431.4504961042117,136398.68789820228,702,30,399.0833333333333,36,0,18,31.884540773777154,0.6600115740740742,41.18806306306306,1035.2477477477478,28.75688188188188,0
705,4,0,0,36,0.0,0.0,1.0,36,550,300,250,0.5454545454545454,8,3,5,358.85982789179087,0.7479166666666667,0.07319717782368684,0.22621205189313223,134083.8447188742,2423.4610877769596,136507.30580665116,703,31,400.0833333333333,36,0,18,31.783688521619368,0.6611689814814815,41.07545045045045,1035.6981981981976,28.76939439439438,0
706,4,0,0,36,0.0,0.0,1.0,36,1100,800,300,0.7272727272727273,14,8,6,357.37879797279,0.7482142857142857,0.01569574307078625,0.21848782828781055,132949.91673752814,2312.4135632460707,135262.33030077422,704,32,401.0833333333333,34,2,17,32.9584150986956,0.6541053921568629,42.17261904761904,1031.3095238095223,30.332633053221244,8
707,4,0,0,36,0.0,0.0,1.0,36,650,400,250,0.6153846153846154,9,4,5,359.9672500776744,0.7492394179894181,0.012498077218889625,0.22097706258309346,133103.4297052152,2382.5751133786594,135486.00481859388,705,33,402.0833333333333,34,2,17,32.737511536686654,0.6556372549019609,42.02380952380951,1031.9047619047603,30.35014005602236,0
708,4,0,0,36,0.0,0.0,1.0,36,950,500,450,0.5263157894736842,14,5,9,361.8612112954618,0.7473214285714286,0.01617594300943015,0.22287360968425013,133226.30385487515,2441.8863378684673,135668.1901927436,706,34,403.0833333333333,34,2,18,32.565296356088574,0.6568627450980392,41.9047619047619,1032.3809523809514,30.364145658263276,0
709,4,0,0,36,0.0,0.0,1.0,36,1000,800,200,0.8,12,8,4,361.87660390834594,0.748015873015873,0.01282420749279578,0.22343626611422762,133318.496669501,2448.9689625850187,135767.46563208604,707,35,404.0833333333333,34,2,18,32.4723823246878,0.6577818627450981,41.81547619047618,1032.7380952380943,30.37464985994395,0
710,4,0,0,36,0.0,0.0,1.0,36,1250,1000,250,0.8,15,10,5,360.1791817153745,0.748181216931217,0.015300504468515719,0.22294115113594998,133410.72137188204,2410.35289115646,135821.0742630385,708,36,405.0833333333333,34,2,19,32.42370553891066,0.6587009803921569,41.726190476190474,1033.0952380952378,30.385154061624643,0
711,4,0,0,36,0.0,0.0,1.0,36,800,500,300,0.625,11,5,6,358.6758584807493,0.7483465608465609,0.015681003584229636,0.2223790322580645,133472.22222222216,2374.6527777777733,135846.87499999994,709,37,406.0833333333333,34,2,20,32.400873655913976,0.6593137254901962,41.666666666666664,1033.333333333333,30.39215686274509,0
712,4,0,0,36,0.0,0.0,1.0,36,1500,1100,400,0.7333333333333333,19,11,8,356.54279220231484,0.7471891534391535,0.01950776472996152,0.22216145574385274,133656.8098072563,2330.874433106583,135987.6842403629,710,38,407.0833333333333,34,2,20,32.2710396039604,0.6611519607843137,41.48809523809524,1034.0476190476195,30.413165266106457,0
713,4,0,0,36,0.0,0.0,1.0,36,800,600,200,0.75,10,6,4,357.09603647434125,0.748181216931217,0.020937220304309223,0.2232492487023041,133779.93905895695,2354.4571995464876,136134.39625850343,711,39,408.0833333333333,34,2,15,32.1334388185654,0.6623774509803921,41.36904761904762,1034.5238095238096,30.427170868347343,0
714,4,0,0,36,0.0,0.0,1.0,36,650,500,150,0.7692307692307693,8,5,3,355.6270041403236,0.7486111111111111,0.02027493385482604,0.2228886479446167,133872.32320011334,2321.7226473922906,136194.04584750562,712,40,409.0833333333333,34,2,15,32.078971586333836,0.663296568627451,41.279761904761905,1034.8809523809523,30.437675070028007,0
715,4,0,0,36,0.0,0.0,1.0,36,650,500,150,0.7692307692307693,8,5,3,355.55088800205374,0.7483134920634921,0.016326713186616715,0.22302737520128832,133903.12500000012,2321.8750000000155,136225.00000000015,713,41,410.0833333333333,34,2,16,32.05012077294687,0.6636029411764706,41.25000000000001,1035.000000000001,30.44117647058826,0
716,4,0,0,36,0.0,0.0,1.0,36,1200,700,500,0.5833333333333334,17,7,10,350.24238567592187,0.7483465608465609,0.040809945470008824,0.20967340662701417,132159.87761488341,2057.598165294929,134217.47578017836,714,42,411.0833333333333,35,1,17,33.93647756265947,0.644047619047619,42.93981481481482,1028.2407407407409,29.378306878306883,3
717,4,0,0,36,0.0,0.0,1.0,36,850,700,150,0.8235294117647058,10,7,3,352.085311944122,0.7472222222222222,0.040389545426124274,0.21094254865971165,132189.6316256216,2108.405537337113,134298.03716295873,715,43,412.0833333333333,35,1,17,33.85914931532546,0.644345238095238,42.91087962962963,1028.3564814814818,29.381613756613763,0
718,4,0,0,36,0.0,0.0,1.0,36,900,600,300,0.6666666666666666,12,6,6,355.58416327681357,0.7456018518518519,0.04475447544754507,0.21354270562191366,132278.91375171483,2207.257373113873,134486.17112482872,716,44,413.0833333333333,35,1,17,33.67930543054307,0.6452380952380952,42.82407407407408,1028.7037037037048,29.391534391534424,0
719,4,0,0,36,0.0,0.0,1.0,36,900,700,200,0.7777777777777778,11,7,4,355.84913701257176,0.7433531746031746,0.05049482681061623,0.21437740693196405,132398.0034722223,2222.7966392318285,134620.80011145413,717,45,414.0833333333333,34,2,17,33.552631578947356,0.6485906862745099,42.708333333333336,1029.1666666666672,30.26960784313727,0
720,4,0,1,35,0.0,0.027777777777777776,0.9722222222222222,36,900,800,100,0.8888888888888888,10,8,2,353.7010476988364,0.7422619047619048,0.051212868742933626,0.21360381707399012,132489.9092970522,2172.363945578234,134662.2732426304,718,46,415.0833333333333,34,2,18,33.51545636756091,0.6495098039215685,42.61904761904762,1029.5238095238096,30.28011204481793,0
721,4,1,0,36,0.027777777777777776,0.0,1.0,36,500,300,200,0.6,7,3,4,350.1353874706253,0.748478835978836,0.06096089155945905,0.21248749250847035,132673.81660997713,2090.7596371881928,134764.57624716533,719,0,410.19444444444446,34,2,17,33.42240582389647,0.6513480392156863,42.44047619047618,1030.2380952380938,30.30112044817923,0
722,4,0,0,36,0.0,0.0,1.0,36,1150,1000,150,0.8695652173913043,13,10,3,350.3513686663428,0.7479166666666667,0.0540378370746859,0.21314067452877927,132765.81809807254,2102.937216553285,134868.75531462583,720,1,411.19444444444446,34,2,17,33.32442917099842,0.6522671568627452,42.351190476190474,1030.595238095238,30.311624649859944,0
723,4,0,0,36,0.0,0.0,1.0,36,1050,700,350,0.6666666666666666,14,7,7,352.35516291919873,0.7464616402116403,0.056264352332935585,0.21506328865702476,132888.5363520408,2164.7923752834404,135053.32872732423,721,2,412.19444444444446,34,2,17,33.149559327252426,0.6534926470588236,42.232142857142854,1031.0714285714284,30.325630252100837,0
724,4,0,0,36,0.0,0.0,1.0,36,1150,700,450,0.6086956521739131,16,7,9,350.73571540017826,0.7447089947089948,0.057652354570636666,0.21460270043977,132980.61224489784,2128.210034013582,135108.82227891142,722,3,413.19444444444446,34,2,17,33.09888619575252,0.6544117647058825,42.14285714285713,1031.4285714285704,30.336134453781483,0
725,4,0,0,36,0.0,0.0,1.0,36,1050,700,350,0.6666666666666666,14,7,7,350.3492096458252,0.7433531746031746,0.06183271170582283,0.2152499857136537,133134.1429280043,2128.68835034011,135262.8312783444,723,4,414.19444444444446,34,2,17,32.95482946898912,0.6559436274509804,41.994047619047606,1032.0238095238076,30.353641456582576,0
726,4,0,0,36,0.0,0.0,1.0,36,650,400,250,0.6153846153846154,9,4,5,350.25903495555065,0.7408399470899472,0.06024123397004755,0.21590594244274988,133257.03124999988,2134.8958333333185,135391.9270833332,724,5,415.19444444444446,34,2,17,32.83393866020984,0.6571691176470589,41.87499999999999,1032.499999999999,30.367647058823504,0
727,4,0,0,36,0.0,0.0,1.0,36,750,500,250,0.6666666666666666,10,5,5,351.35228244730104,0.7407407407407408,0.05748981630927652,0.21675886898633642,133287.76218820864,2166.1918934240357,135453.95408163266,725,6,416.19444444444446,34,2,17,32.77491161325031,0.6574754901960784,41.845238095238095,1032.6190476190477,30.371148459383758,0
728,4,0,0,36,0.0,0.0,1.0,36,650,400,250,0.6153846153846154,9,4,5,350.5792038832104,0.7412037037037038,0.05109241329849934,0.2166399695791119,133349.2346938774,2149.8937074829773,135499.1284013604,726,7,417.19444444444446,34,2,17,32.73325841401568,0.6580882352941178,41.78571428571428,1032.8571428571418,30.37815126050417,0
729,4,0,0,36,0.0,0.0,1.0,36,1000,600,400,0.6,14,6,8,351.5218522372526,0.7386574074074075,0.05174731182795678,0.2179435483870968,133472.2222222223,2183.737244897969,135655.95946712026,727,8,418.19444444444446,33,3,18,32.585685483870954,0.6616161616161615,41.66666666666667,1033.3333333333342,31.31313131313134,0
730,4,1,1,36,0.02702702702702703,0.02702702702702703,0.972972972972973,37,1350,1000,350,0.7407407407407407,17,10,7,340.5498959824461,0.7471846846846847,0.03800578484122785,0.2129049349703207,133779.93905895695,1711.748866213155,135491.68792517012,728,0,407.86486486486484,34,3,16,32.56137322593018,0.6623774509803921,41.36904761904762,1034.5238095238096,30.427170868347343,0
731,4,0,0,36,0.0,0.0,1.0,36,1300,900,400,0.6923076923076923,17,9,8,351.40046270299376,0.734755291005291,0.0384676145339653,0.21936537760453184,133725.61034217625,2198.2482698962094,135923.85861207245,729,10,420.19444444444446,33,3,16,32.33511058451817,0.6641414141414141,41.42156862745099,1034.3137254901974,31.34284016636962,0
732,4,0,0,36,0.0,0.0,1.0,36,750,500,250,0.6666666666666666,10,5,5,350.61769562829954,0.7338955026455027,0.03418600978998865,0.21963025384906254,133852.39451172636,2186.203623606316,136038.5981353327,730,11,421.19444444444446,33,3,16,32.228505447655124,0.6654040404040404,41.29901960784314,1034.8039215686283,31.357694592988736,0
733,4,0,0,36,0.0,0.0,1.0,36,1150,800,350,0.6956521739130435,15,8,7,351.2566086621618,0.7346230158730159,0.04129520052597013,0.2211712625331795,134042.6834030182,2216.675677624009,136259.3590806422,731,12,422.19444444444446,33,3,17,32.0216962524655,0.6672979797979797,41.11519607843138,1035.5392156862754,31.379976232917436,0
734,4,0,0,36,0.0,0.0,1.0,36,650,400,250,0.6153846153846154,9,4,5,352.3536972817794,0.7339947089947091,0.038604898828541234,0.22205377298496015,134074.41135921283,2248.3229106593644,136322.7342698722,732,13,423.19444444444446,33,3,17,31.961577525342165,0.6676136363636364,41.08455882352941,1035.6617647058824,31.383689839572195,0
735,4,0,0,36,0.0,0.0,1.0,36,500,300,200,0.6,7,3,4,353.22262433307924,0.732936507936508,0.037918819091183886,0.22298662012602835,134137.87853529895,2276.106695742023,136413.98523104098,733,14,424.19444444444446,33,3,17,31.87564079813873,0.6682449494949495,41.02328431372549,1035.9068627450981,31.39111705288176,0
736,4,0,0,36,0.0,0.0,1.0,36,1000,800,200,0.8,12,8,4,354.6983526031474,0.7326058201058202,0.03611603916157491,0.2243062506551692,134201.36072964733,2320.2003135813284,136521.56104322866,734,15,425.19444444444446,33,3,17,31.773974965503662,0.6688762626262625,40.962009803921575,1036.1519607843143,31.39854426619134,0
737,4,0,0,36,0.0,0.0,1.0,36,750,400,350,0.5333333333333333,11,4,7,354.3338419149497,0.7299272486772487,0.03496191226687695,0.22504987256760303,134360.13192041512,2321.668348712026,136681.80026912715,735,16,426.19444444444446,33,3,18,31.62480299448385,0.6704545454545454,40.80882352941176,1036.7647058823522,31.41711229946522,0
738,4,0,1,35,0.0,0.027777777777777776,0.9722222222222222,36,550,500,50,0.9090909090909091,6,5,1,351.80133540117436,0.7295965608465609,0.03292375551354776,0.2242203691894232,134487.21645520953,2262.5564686659,136749.77292387543,736,17,427.19444444444446,33,3,19,31.563583018273473,0.6717171717171717,40.68627450980392,1037.2549019607843,31.431966726084372,0
739,4,0,0,35,0.0,0.0,1.0,35,900,700,200,0.7777777777777778,11,7,4,358.80321914712783,0.7254901960784313,0.04601899196493808,0.22846586372670596,134452.55107897148,2648.401629935718,137100.9527089072,737,18,438.25714285714287,32,3,21,31.41663623082542,0.673828125,40.71969696969697,1037.1212121212118,32.41003787878787,0
740,4,0,0,35,0.0,0.0,1.0,35,700,500,200,0.7142857142857143,9,5,4,359.284825770411,0.7246498599439776,0.044867158158297116,0.22918355035168458,134518.03387409457,2666.0576726864697,137184.09154678104,738,19,439.25714285714287,32,3,22,31.338749594287567,0.6744791666666666,40.65656565656566,1037.373737373738,32.417929292929315,0
741,4,0,0,35,0.0,0.0,1.0,35,700,600,100,0.8571428571428571,8,6,2,360.3706399020463,0.7263305322128851,0.04142127038208798,0.23028972929354707,134583.53261146814,2699.990753494533,137283.52336496266,739,20,440.25714285714287,32,3,22,31.24518333738947,0.6751302083333334,40.59343434343434,1037.6262626262621,32.42582070707069,0
742,4,0,0,35,0.0,0.0,1.0,35,1200,800,400,0.6666666666666666,16,8,8,363.28035677697596,0.7271708683473389,0.05802488580878906,0.22113777422598455,132788.12629132226,2647.8635789715313,135435.9898702938,740,21,441.25714285714287,32,3,19,32.96888398872963,0.6572265625,42.32954545454545,1030.6818181818178,32.208806818181806,7
743,4,0,0,35,0.0,0.0,1.0,35,900,600,300,0.6666666666666666,12,6,6,364.8072947389064,0.7278011204481792,0.056631965707287124,0.22245343999575592,132853.20255905017,2693.1634845934177,135546.3660436436,741,22,442.25714285714287,32,3,19,32.8641049193713,0.6578776041666666,42.266414141414145,1030.934343434344,32.21669823232325,0
744,4,0,0,35,0.0,0.0,1.0,35,750,600,150,0.8,9,6,3,361.1468217528824,0.7294117647058823,0.05391053391053435,0.22070083551565037,132934.5703125,2601.7795138888882,135536.34982638888,742,23,443.25714285714287,33,2,19,32.876683501683495,0.65625,42.1875,1031.25,31.25,0
745,4,0,0,35,0.0,0.0,1.0,35,850,600,250,0.7058823529411765,11,6,5,363.181635523918,0.7292016806722689,0.05753657129280776,0.22250822473364915,133029.37121539784,2662.7649221453116,135692.13613754316,743,24,444.25714285714287,33,2,19,32.72897362794011,0.6571969696969697,42.09558823529411,1031.6176470588227,31.261140819964325,0
746,4,0,0,35,0.0,0.0,1.0,35,700,600,100,0.8571428571428571,8,6,2,364.60059339250125,0.7292016806722689,0.05851390562163772,0.22356681688066046,133060.979025495,2702.8223820165276,135763.80140751152,744,25,445.25714285714287,33,2,19,32.66062378746485,0.6575126262626263,42.064950980392155,1031.7401960784314,31.264854426619134,0
747,4,1,1,35,0.027777777777777776,0.027777777777777776,0.9722222222222222,36,1150,700,450,0.6086956521739131,16,7,9,355.2223818812106,0.7346891534391535,0.05797894817717286,0.21969099127464464,133379.97626133787,2275.9105725623567,135655.88683390024,745,0,433.8611111111111,34,2,19,32.582545810764074,0.6583946078431373,41.75595238095238,1032.9761904761906,30.38165266106443,0
748,4,0,0,35,0.0,0.0,1.0,35,1100,800,300,0.7272727272727273,14,8,6,385.53428198618536,0.7272408963585434,0.09628276298222227,0.22851055255915878,131781.48275686151,3161.2877545033966,134942.7705113649,746,27,447.25714285714287,32,3,18,33.41172733234958,0.6471354166666666,43.30808080808081,1026.7676767676767,32.086489898989896,7
749,4,1,0,36,0.027777777777777776,0.0,1.0,36,800,400,400,0.5,12,4,8,375.9351795768323,0.7396164021164021,0.09475448498820827,0.22422421165941064,132019.90370290264,2726.185241253354,134746.08894415598,747,0,435.80555555555554,33,3,19,33.41730264726927,0.6470959595959596,43.07598039215686,1027.6960784313717,31.142305407011264,0
750,4,0,0,36,0.0,0.0,1.0,36,700,500,200,0.7142857142857143,9,5,4,379.0868668345384,0.7397486772486773,0.0981031102633394,0.22648010249345485,132082.88278546702,2814.177239523248,134897.06002499026,748,1,436.80555555555554,33,3,19,33.27273088539184,0.6477272727272728,43.014705882352935,1027.9411764705874,31.14973262032083,0
751,4,0,0,36,0.0,0.0,1.0,36,850,700,150,0.8235294117647058,10,7,3,380.2862596268222,0.7397486772486773,0.09985897588686354,0.22776459703987587,132177.3795685552,2853.0482566801065,135030.4278252353,749,2,437.80555555555554,33,3,19,33.14650121161563,0.6486742424242424,42.92279411764705,1028.3088235294103,31.16087344028516,0
752,4,0,0,36,0.0,0.0,1.0,36,1100,700,400,0.6363636363636364,15,7,8,380.7707156995971,0.7387566137566138,0.10945688423058608,0.22900794620442808,132334.9492983467,2877.8546712802695,135212.80396962698,750,3,438.80555555555554,33,3,20,32.975027791011605,0.6502525252525253,42.76960784313725,1028.9215686274504,31.179441473559102,0
753,4,0,0,36,0.0,0.0,1.0,36,850,500,350,0.5882352941176471,12,5,7,380.08950004976396,0.7387896825396826,0.10648423754150671,0.22917241284407508,132429.53619100817,2867.015240532477,135296.55143154063,751,4,439.80555555555554,33,3,20,32.897145493511125,0.651199494949495,42.67769607843137,1029.2892156862738,31.19058229352345,0
754,4,1,1,36,0.02702702702702703,0.02702702702702703,0.972972972972973,37,800,600,200,0.75,10,6,4,373.2871710155424,0.7467467467467468,0.10294999250636927,0.22690826912293077,132735.14739229015,2509.6655328798015,135244.81292516994,752,0,428.8918918918919,34,3,16,32.7643638324091,0.6519607843137256,42.38095238095237,1030.4761904761897,30.308123249299697,0
755,4,1,1,36,0.02702702702702703,0.02702702702702703,0.972972972972973,37,550,400,150,0.7272727272727273,7,4,3,375.19670279198743,0.7430555555555556,0.10609754955371242,0.2282556469480134,132765.8180980724,2562.659438775493,135328.4775368479,753,0,429.86486486486484,34,3,16,32.684292095029065,0.6522671568627452,42.35119047619047,1030.595238095237,30.31162464985991,0
756,4,0,0,36,0.0,0.0,1.0,36,1000,900,100,0.9,11,9,2,384.8199591358791,0.7370701058201059,0.10950200229967089,0.23358710443720815,132681.93310565632,3011.731215157613,135693.66432081393,754,7,442.80555555555554,33,3,16,32.52089032948732,0.6537247474747476,42.43259803921568,1030.269607843136,31.2202911467617,0
757,4,0,0,36,0.0,0.0,1.0,36,900,700,200,0.7777777777777778,11,7,4,386.0988772496368,0.7369708994708996,0.10226582111243254,0.23495597378215904,132776.64389898087,3052.9826268742427,135829.6265258551,755,8,443.80555555555554,33,3,16,32.392489100277444,0.6546717171717173,42.340686274509785,1030.6372549019584,31.23143196672601,0
758,4,1,1,36,0.02702702702702703,0.02702702702702703,0.972972972972973,37,700,500,200,0.7142857142857143,9,5,4,378.674846143678,0.7487487487487487,0.09850127103445039,0.23188816550070437,133011.3112953513,2673.6075680271897,135684.9188633785,756,0,432.7837837837838,34,3,16,32.347566839776874,0.654718137254902,42.11309523809523,1031.5476190476177,30.339635854341697,0
759,4,1,2,35,0.02702702702702703,0.05405405405405406,0.9459459459459459,37,700,400,300,0.5714285714285714,10,4,6,380.3433605989729,0.7463713713713713,0.09562210185263176,0.23329341162854164,133072.72002550997,2722.6651077097263,135795.3851332197,757,0,433.7567567567568,34,3,16,32.242750278835416,0.6553308823529413,42.053571428571416,1031.7857142857126,30.346638655462137,0
760,4,0,0,35,0.0,0.0,1.0,35,1250,1100,150,0.88,14,11,3,397.707181610882,0.7241596638655462,0.1010989010989014,0.24230458437845073,132820.66243240488,3564.746263136419,136385.4086955413,758,39,459.25714285714287,32,3,16,32.04898538298221,0.6575520833333334,42.2979797979798,1030.8080808080808,32.212752525252526,0
761,4,0,1,34,0.0,0.02857142857142857,0.9714285714285714,35,700,400,300,0.5714285714285714,10,4,6,374.99681278568806,0.7241596638655462,0.08301307200454167,0.21069256250867552,129716.28578514718,2728.6387471655116,132444.9245323127,759,40,460.25714285714287,34,1,17,35.777238907716885,0.6216299019607844,45.32738095238094,1018.6904761904744,29.961484593837483,8
762,4,0,0,34,0.0,0.0,1.0,34,900,800,100,0.8888888888888888,10,8,2,377.58306397075046,0.7228535353535354,0.09697818521347945,0.21273582384693493,129825.09731833907,3003.951605151861,132829.04892349095,760,41,465.9117647058824,33,1,17,35.600549142215804,0.625,45.220588235294116,1019.1176470588233,30.882352941176464,0
763,4,1,0,35,0.02857142857142857,0.0,1.0,35,800,400,400,0.5,12,4,8,374.78984358774886,0.7350840336134453,0.1217435004020373,0.20594122333223727,128838.54875283444,2657.4759070294776,131496.0246598639,761,0,453.57142857142856,34,1,18,36.67795301751094,0.6127450980392157,46.19047619047619,1015.2380952380951,29.85994397759103,2
764,4,1,1,35,0.027777777777777776,0.027777777777777776,0.9722222222222222,36,850,700,150,0.8235294117647058,10,7,3,366.25667546562806,0.7459656084656086,0.11168381617749468,0.2023516270555535,129054.34355977783,2253.4029653206303,131307.74652509845,762,0,441.94444444444446,35,1,19,36.674284276872825,0.612797619047619,45.97800925925925,1016.0879629629619,29.031084656084627,0
765,4,2,1,36,0.05405405405405406,0.02702702702702703,0.972972972972973,37,750,600,150,0.8,9,6,3,364.29462906820396,0.7515015015015015,0.12266250314059102,0.2031954486580429,129430.4693206722,2030.1649622595808,131460.63428293177,763,0,430.94594594594594,36,1,16,36.340748118636576,0.6145833333333333,45.60810810810812,1017.5675675675691,28.265765765765806,0
766,4,1,1,36,0.02702702702702703,0.02702702702702703,0.972972972972973,37,900,600,300,0.6666666666666666,12,6,6,362.5617802848688,0.7549424424424425,0.11561993504901191,0.20252369408001555,129487.77113261938,1989.463365392448,131477.23449801182,764,0,431.9189189189189,36,1,16,36.326482628900195,0.615162037037037,45.551801801801815,1017.792792792795,28.272022022022085,0
767,4,2,2,36,0.05263157894736842,0.05263157894736842,0.9473684210526316,38,1250,1000,250,0.8,15,10,5,351.60476687021844,0.7663880986249407,0.10695108412443033,0.19776703957373315,129759.37307633122,1524.8028239458322,131284.17590027704,765,0,421.5,37,1,17,36.32918998421582,0.6159909909909909,45.28508771929825,1018.8596491228074,27.536747273589388,0
768,4,0,0,36,0.0,0.0,1.0,36,1100,800,300,0.7272727272727273,14,8,6,367.0853409379319,0.7414351851851853,0.12367536912836452,0.2055537711159128,129584.09857521014,2313.684601123125,131897.78317633327,766,3,445.9166666666667,35,1,17,36.113281990072366,0.6181547619047618,45.45717592592593,1018.171296296297,29.090608465608486,0
769,4,1,1,36,0.02702702702702703,0.02702702702702703,0.972972972972973,37,1000,700,300,0.7,13,7,6,360.1277364601712,0.7516891891891891,0.1240759097586317,0.2032341814487203,129889.23890106338,1955.3435191948868,131844.58242025826,767,0,434.8378378378378,36,1,18,35.980078067462074,0.6192129629629629,45.157657657657666,1019.3693693693706,28.31581581581585,0
770,4,0,0,36,0.0,0.0,1.0,36,750,400,350,0.5333333333333333,11,4,7,366.42094657316784,0.7415674603174603,0.13222525114846828,0.2062640673676577,129790.40745027429,2311.58479080932,132101.99224108362,768,1,447.75,35,1,18,35.9202256550053,0.6202380952380953,45.254629629629626,1018.981481481481,29.1137566137566,0
771,4,0,0,36,0.0,0.0,1.0,36,600,300,300,0.5,9,3,6,369.6790880662841,0.7431547619047619,0.13249173543291204,0.20841191098026218,129849.38298396766,2400.520297496557,132249.9032814642,769,2,448.75,35,1,18,35.77721629192217,0.6208333333333333,45.19675925925925,1019.212962962962,29.120370370370342,0
772,4,0,0,36,0.0,0.0,1.0,36,1050,700,350,0.6666666666666666,14,7,7,370.2992672475407,0.7425925925925927,0.1319089774145954,0.20955085701464846,129996.88042534703,2427.549913194419,132424.43033854145,770,3,449.75,35,1,19,35.61138066053796,0.6223214285714287,45.05208333333332,1019.791666666665,29.136904761904717,0
773,4,0,0,36,0.0,0.0,1.0,36,550,200,350,0.36363636363636365,9,2,7,370.2992672475407,0.7425925925925927,0.1319089774145954,0.20955085701464846,129996.88042534703,2427.549913194419,132424.43033854145,771,4,450.75,35,1,19,35.61138066053796,0.6223214285714287,45.05208333333332,1019.791666666665,29.136904761904717,0
774,4,2,1,37,0.05263157894736842,0.02631578947368421,0.9736842105263158,38,750,500,250,0.6666666666666666,10,5,5,352.7244374553614,0.7646989094357516,0.1267603644724129,0.20198731307754136,130458.54403518373,1603.1833112111215,132061.72734639485,772,0,427.9736842105263,37,1,21,35.59119083395943,0.6230292792792793,44.599780701754376,1021.6008771929811,27.61083451872922,0
775,4,1,2,36,0.02631578947368421,0.05263157894736842,0.9473684210526316,38,800,600,200,0.75,10,6,4,376.82732272995236,0.7640469416785206,0.11273248382537582,0.22055134536987236,131300.02891514683,2295.4876740920113,133595.51658923883,773,0,428.94736842105266,37,1,17,34.1222451053814,0.6314752252252254,43.777412280701746,1024.8903508771918,27.69973921289708,6
776,4,0,0,36,0.0,0.0,1.0,36,850,600,250,0.7058823529411765,11,6,5,390.1445327726458,0.741931216931217,0.13468879094938524,0.22728037988842267,131120.59709630048,3031.196818201291,134151.79391450176,774,7,453.75,35,1,19,33.96299487701058,0.6336309523809525,43.95254629629629,1024.189814814814,29.262566137566118,0
777,4,0,0,36,0.0,0.0,1.0,36,1100,800,300,0.7272727272727273,14,8,6,389.87065478496015,0.7425925925925927,0.13499190481569356,0.2278234261921617,131239.1643759644,3033.259789737643,134272.42416570205,775,8,454.75,35,1,19,33.84975432056929,0.6348214285714286,43.83680555555555,1024.652777777777,29.275793650793627,0
778,4,1,1,36,0.02702702702702703,0.02702702702702703,0.972972972972973,37,1000,600,400,0.6,14,6,8,380.443749856864,0.7556931931931932,0.1312227267321482,0.2240447146167031,131535.81700370784,2608.426033093261,134144.2430368011,776,0,443.43243243243245,35,2,20,33.790876866373324,0.6377976190476191,43.547453703703695,1025.8101851851839,29.308862433862394,0
779,4,0,0,36,0.0,0.0,1.0,36,700,400,300,0.5714285714285714,10,4,6,384.8192857033667,0.7432870370370371,0.13828693253072477,0.22609408961086383,131446.7860510973,2916.651663237297,134363.4377143346,777,10,456.75,35,1,21,33.76881113619262,0.6369047619047619,43.63425925925925,1025.4629629629621,29.298941798941776,0
780,4,1,0,37,0.02702702702702703,0.0,1.0,37,950,700,250,0.7368421052631579,12,7,5,375.8378167553937,0.752002002002002,0.14212677421362585,0.22298406317452385,131819.15181651237,2508.5244450531495,134327.67626156553,778,0,445.3783783783784,36,1,17,33.622564608692464,0.6385995370370372,43.27139639639639,1026.9144144144136,28.52540040040038,0
781,4,0,0,37,0.0,0.0,1.0,37,1200,800,400,0.6666666666666666,16,8,8,375.84992407140123,0.7509384384384384,0.14326574602648234,0.22452605411804663,132079.47812677556,2528.412365067787,134607.89049184334,779,1,446.3783783783784,36,1,19,33.35935217645341,0.6412037037037037,43.018018018018026,1027.927927927929,28.553553553553584,0
782,4,0,0,37,0.0,0.0,1.0,37,750,400,350,0.5333333333333333,11,4,7,375.7758184602181,0.7488738738738738,0.14643239692506138,0.22551487029012057,132253.17166829004,2539.508765522295,134792.68043381235,780,2,447.3783783783784,36,1,19,33.18599007371725,0.6429398148148147,42.84909909909911,1028.6036036036048,28.572322322322357,0
783,4,0,0,37,0.0,0.0,1.0,37,900,500,400,0.5555555555555556,13,5,8,380.4172424781237,0.7479354354354354,0.15202582031966516,0.2293700229414039,132429.53619100805,2675.9335760977583,135105.46976710582,781,3,448.3783783783784,33,4,21,32.88871194983529,0.651199494949495,42.67769607843136,1029.2892156862729,31.19058229352342,0
784,4,0,0,37,0.0,0.0,1.0,37,950,600,350,0.631578947368421,13,6,7,377.31186632330565,0.7471221221221221,0.1555186820535417,0.22804824121804815,132520.55165816317,2600.3153344671086,135120.86699263027,782,4,449.3783783783784,34,3,21,32.87687401240991,0.6498161764705883,42.58928571428571,1029.6428571428564,30.28361344537813,0
785,4,0,0,37,0.0,0.0,1.0,37,750,500,250,0.6666666666666666,10,5,5,377.31186632330565,0.7471221221221221,0.1555186820535417,0.22804824121804815,132520.55165816317,2600.3153344671086,135120.86699263027,783,5,450.3783783783784,34,3,21,32.87687401240991,0.6498161764705883,42.58928571428571,1029.6428571428564,30.28361344537813,0
786,4,0,0,37,0.0,0.0,1.0,37,950,800,150,0.8421052631578947,11,8,3,378.59647921540517,0.7476226226226226,0.153617449203306,0.2297597427159967,132673.81660997716,2645.967970521526,135319.7845804987,784,6,451.3783783783784,34,3,16,32.689363300207994,0.6513480392156863,42.44047619047618,1030.238095238094,30.301120448179237,0
787,4,0,0,37,0.0,0.0,1.0,37,600,400,200,0.6666666666666666,8,4,4,375.90307365356813,0.7466216216216216,0.14887970225308456,0.2284983852208767,132735.14739229015,2579.1099773242463,135314.2573696144,785,7,452.3783783783784,34,3,16,32.696973197781865,0.6519607843137256,42.38095238095237,1030.4761904761897,30.308123249299697,0
788,4,0,0,37,0.0,0.0,1.0,37,1050,900,150,0.8571428571428571,12,9,3,375.5236150831144,0.7471846846846847,0.14640238020161833,0.22845452816405598,132765.81809807237,2571.339994331048,135337.1580924034,786,8,453.3783783783784,34,3,16,32.675869238766325,0.6522671568627452,42.35119047619047,1030.5952380952367,30.311624649859905,0
789,4,0,0,37,0.0,0.0,1.0,37,1000,800,200,0.8,12,8,4,372.6083600239332,0.7450575575575575,0.1441340341576005,0.2278869661066072,132964.41139671206,2508.7302544152844,135473.14165112734,787,9,454.3783783783784,35,2,16,32.55117738375791,0.6520833333333333,42.15856481481481,1031.3657407407402,29.467592592592577,0
790,4,0,0,37,0.0,0.0,1.0,37,1450,1100,350,0.7586206896551724,18,11,7,375.8180886116991,0.7436186186186187,0.14397439161907544,0.23077094201528323,133113.6670524692,2605.3047839506257,135718.9718364198,788,10,455.3783783783784,35,2,16,32.318304172274566,0.6535714285714285,42.01388888888889,1031.944444444445,29.484126984127002,0
791,4,0,1,36,0.0,0.02702702702702703,0.972972972972973,37,1000,600,400,0.6,14,6,8,381.7075065320247,0.7393643643643644,0.14704519645696168,0.23608728314610672,133382.53821855705,2782.62321566358,136165.16143422062,789,11,456.3783783783784,35,2,18,31.896008403361346,0.65625,41.75347222222222,1032.9861111111109,29.513888888888882,0
792,4,0,0,36,0.0,0.0,1.0,36,750,600,150,0.8,9,6,3,380.1238573088394,0.7299603174603175,0.16134318635234735,0.236300229292898,133570.0936926079,2954.6961287432378,136524.78982135112,790,23,469.75,32,4,21,31.74850372541835,0.6650390625,41.571969696969695,1033.712121212121,32.30350378787878,2
793,4,0,0,36,0.0,0.0,1.0,36,650,500,150,0.7692307692307693,8,5,3,379.3408634270985,0.7297949735449736,0.15770368561037795,0.2360215037797176,133602.72548719525,2936.1946485052576,136538.9201357005,791,24,470.75,32,4,21,31.735975411170813,0.6653645833333334,41.54040404040404,1033.8383838383843,32.30744949494951,0
794,4,0,0,36,0.0,0.0,1.0,36,1100,800,300,0.7272727272727273,14,8,6,377.25792253829445,0.7281746031746033,0.15395284797677666,0.23534803073200083,133700.6447843333,2887.9254986736087,136588.5702830069,792,25,471.75,32,4,18,31.691541529320798,0.6663411458333334,41.44570707070707,1034.217171717172,32.31928661616163,0
795,4,0,0,36,0.0,0.0,1.0,36,1000,700,300,0.7,13,7,6,377.55077824739243,0.7278439153439153,0.15093168965376957,0.23594763738984637,133765.9442435721,2900.687270431589,136666.63151400367,793,26,472.75,32,4,19,31.618454778469435,0.6669921875,41.38257575757576,1034.469696969697,32.32717803030303,0
796,4,0,0,36,0.0,0.0,1.0,36,950,700,250,0.7368421052631579,12,7,5,376.8298725282645,0.7281746031746033,0.14903057419835974,0.23591450002819933,133831.2596450618,2886.323302469147,136717.58294753096,794,27,473.75,32,4,20,31.571588366890374,0.6676432291666666,41.31944444444445,1034.7222222222229,32.335069444444464,0
797,4,1,1,36,0.02702702702702703,0.02702702702702703,0.972972972972973,37,850,700,150,0.8235294117647058,10,7,3,369.299061160835,0.7371746746746747,0.14500965707780678,0.23293400484562518,134106.14306997307,2505.0545463283356,136611.19761630142,795,0,461.9189189189189,33,4,20,31.491067203028877,0.6679292929292928,41.05392156862745,1035.7843137254902,31.387403446226976,0
798,4,0,0,36,0.0,0.0,1.0,36,850,400,450,0.47058823529411764,13,4,9,377.4562619804864,0.7267526455026455,0.14729879916510802,0.23693617425084454,133929.26263901652,2910.4877691052056,136839.75040812173,796,29,475.75,32,4,20,31.45711352362365,0.6686197916666666,41.22474747474748,1035.1010101010108,32.34690656565659,0
799,4,0,0,36,0.0,0.0,1.0,36,1450,1100,350,0.7586206896551724,18,11,7,374.4284503121122,0.724702380952381,0.14467409123548647,0.23566291028469938,134027.3015030354,2836.726960259157,136864.02846329458,797,30,476.75,32,4,20,31.437223102873638,0.6695963541666666,41.130050505050505,1035.4797979797981,32.35874368686869,0
800,4,0,0,36,0.0,0.0,1.0,36,300,200,100,0.6666666666666666,4,2,2,376.0978953694274,0.7249338624338625,0.14283101682516453,0.23692434238249188,134059.9890955005,2883.935950413229,136943.92504591373,798,31,477.75,32,4,20,31.361253352840777,0.669921875,41.09848484848485,1035.606060606061,32.362689393939405,0
801,4,0,0,36,0.0,0.0,1.0,36,950,600,350,0.631578947368421,13,6,7,378.05471296013707,0.7233465608465609,0.14976873751708197,0.23928373149632617,134233.10745866972,2949.4917820069177,137182.59924067665,799,32,478.75,33,3,20,31.137160990223897,0.6691919191919191,40.931372549019606,1036.2745098039213,31.4022578728461,0
802,4,1,1,36,0.02702702702702703,0.02702702702702703,0.972972972972973,37,800,700,100,0.875,9,7,2,366.5073865690283,0.7316691691691691,0.1345860953344027,0.23360489094191247,134489.03238378678,2458.244756235815,136947.2771400226,800,0,466.7837837837838,34,3,20,31.180420061976342,0.6694240196078431,40.6845238095238,1037.2619047619041,30.507703081232474,0
803,4,0,0,36,0.0,0.0,1.0,36,750,500,250,0.6666666666666666,10,5,5,373.6835889185223,0.7208664021164022,0.14007106172255712,0.2371334942732019,134328.37017313062,2839.26149197425,137167.63166510488,801,34,480.75,33,3,20,31.155056744296015,0.6701388888888888,40.83946078431373,1036.6421568627457,31.413398692810475,0
804,4,0,0,36,0.0,0.0,1.0,36,900,800,100,0.8888888888888888,10,8,2,374.38418374364807,0.7205026455026455,0.13740495607296266,0.23799132822351649,134391.8974222654,2862.840163638977,137254.7375859044,802,35,481.75,33,3,20,31.07333156049324,0.6707702020202021,40.7781862745098,1036.8872549019602,31.420825906120005,0
805,4,0,0,36,0.0,0.0,1.0,36,950,700,250,0.7368421052631579,12,7,5,374.06956092924213,0.7182208994708995,0.14423177903801765,0.23841300931514334,134487.21645520942,2861.51480199922,137348.73125720865,803,36,482.75,33,3,20,30.986137366099566,0.6717171717171717,40.686274509803916,1037.2549019607834,31.431966726084344,0
806,4,0,0,36,0.0,0.0,1.0,36,800,600,200,0.75,10,6,4,376.52322595342974,0.7184193121693122,0.1447016217918442,0.2408156100735378,134614.36106305252,2937.086697424051,137551.44776047659,804,37,483.75,33,3,20,30.795347189418987,0.672979797979798,40.56372549019607,1037.7450980392146,31.44682115270347,0
807,4,0,0,36,0.0,0.0,1.0,36,950,700,250,0.7368421052631579,12,7,5,377.93570182804126,0.7179232804232805,0.14326984876506765,0.24235377215634651,134709.75894187333,2982.3254577566267,137692.08439962997,805,38,484.75,33,3,21,30.66331700310864,0.6739267676767677,40.47181372549019,1038.112745098039,31.457961972667853,0
808,4,0,0,36,0.0,0.0,1.0,36,600,300,300,0.5,9,3,6,378.1718103115433,0.7176256613756614,0.14650876088553133,0.242717543709045,134741.5657439446,2991.0923683198707,137732.65811226447,806,39,485.75,33,3,21,30.625393452943023,0.6742424242424242,40.44117647058823,1038.2352941176468,31.46167557932263,0
809,4,0,0,36,0.0,0.0,1.0,36,550,400,150,0.7272727272727273,7,4,3,382.15605033575645,0.7159722222222222,0.15320719586709708,0.24570488395638806,134805.19061178374,3103.3238417915964,137908.51445357534,807,40,486.75,33,3,18,30.45836283533947,0.6748737373737375,40.3799019607843,1038.4803921568612,31.469102792632157,0
810,4,0,0,36,0.0,0.0,1.0,36,1300,900,400,0.6923076923076923,17,9,8,381.4565775959931,0.7156084656084657,0.15155060097256645,0.24590170405180448,134900.6560727843,3091.748516195667,137992.40458897996,808,41,487.75,33,3,19,30.381104754040347,0.6758207070707072,40.28799019607842,1038.8480392156846,31.480243612596503,0
811,4,0,0,36,0.0,0.0,1.0,36,850,500,350,0.5882352941176471,12,5,7,410.89269723686385,0.7145171957671959,0.18471085938046294,0.25684834614845675,133775.12825859923,3817.8418216316763,137592.9700802309,809,42,488.75,31,5,18,30.746932032724978,0.6696908602150538,41.37369791666667,1034.505208333334,33.37113575268819,3
812,4,0,0,36,0.0,0.0,1.0,36,1100,800,300,0.7272727272727273,14,8,6,414.87915826114437,0.7147486772486773,0.1752131376659678,0.26052838137252,133943.55773925805,3914.0780978732937,137857.63583713133,810,43,489.75,31,5,19,30.474318658280932,0.6713709677419354,41.210937500000014,1035.1562500000018,33.39213709677425,0
813,4,0,0,36,0.0,0.0,1.0,36,1400,900,500,0.6428571428571429,19,9,10,416.38402458592503,0.7146164021164022,0.1671765428994494,0.2624341150203209,134078.37761773012,3965.618896484385,138043.9965142145,811,44,490.75,31,5,19,30.299744363423006,0.6727150537634408,41.08072916666667,1035.6770833333342,33.40893817204304,0
814,4,1,0,37,0.02702702702702703,0.0,1.0,37,800,400,400,0.5,12,4,8,408.51613068460995,0.7219094094094094,0.16607111128659668,0.26012027111964253,134452.55107897165,3585.2071854912892,138037.75826446293,812,0,478.4594594594595,32,5,20,30.127678354029694,0.673828125,40.719696969696976,1037.1212121212131,32.41003787878791,0
815,4,0,0,37,0.0,0.0,1.0,37,1250,1000,250,0.8,15,10,5,403.58523019677773,0.7224099099099099,0.1656350923812595,0.2579053982703825,134583.53261146822,3463.1851979389908,138046.71780940722,813,1,479.4594594594595,32,5,20,30.124168491928287,0.6751302083333333,40.593434343434346,1037.6262626262628,32.42582070707071,0
816,4,0,0,37,0.0,0.0,1.0,37,700,500,200,0.7142857142857143,9,5,4,402.4900180173895,0.7219719719719719,0.16606873329102334,0.2574370006291772,134616.2879584992,3436.342433170096,138052.63039166929,814,2,480.4594594594595,32,5,20,30.119742872206675,0.6754557291666666,40.56186868686869,1037.7525252525259,32.42976641414143,0
817,4,0,0,37,0.0,0.0,1.0,37,1150,800,350,0.6956521739130435,15,8,7,405.88769795909076,0.7223473473473473,0.16780155642023376,0.2607828459387159,134780.12447709424,3541.1188909295056,138321.24336802374,815,3,481.4594594594595,32,5,13,29.867359760051883,0.6770833333333333,40.40404040404041,1038.383838383839,32.44949494949497,0
818,4,0,0,37,0.0,0.0,1.0,37,1250,700,550,0.56,18,7,11,409.57705396208064,0.7205955955955956,0.1743026448908802,0.26410658307210033,134911.2654320988,3651.3117283950633,138562.57716049385,816,4,482.4594594594595,32,5,13,29.6401515151515,0.6783854166666666,40.27777777777778,1038.8888888888891,32.465277777777786,0
819,4,0,0,37,0.0,0.0,1.0,37,1200,800,400,0.6666666666666666,16,8,8,405.10524207903154,0.7212837837837838,0.17491075981642035,0.26183631500230087,134996.15532487506,3537.5300365244116,138533.68536139946,817,5,483.4594594594595,33,4,13,29.67128537735849,0.6767676767676767,40.19607843137255,1039.2156862745098,31.491384432560903,0
820,4,0,0,37,0.0,0.0,1.0,37,1150,700,450,0.6086956521739131,16,7,9,408.0706503186731,0.721096096096096,0.17180306559064062,0.2644509798818416,135091.68836805565,3625.3906250000095,138717.07899305565,818,6,484.4594594594595,33,4,13,29.498580494321974,0.6777146464646464,40.10416666666667,1039.5833333333342,31.502525252525277,0
821,4,0,0,37,0.0,0.0,1.0,37,850,600,250,0.7058823529411765,11,6,5,408.0706503186731,0.720970970970971,0.17180306559064062,0.2644509798818416,135091.68836805565,3625.3906250000095,138717.07899305565,819,7,485.4594594594595,33,4,13,29.498580494321974,0.6777146464646464,40.10416666666667,1039.5833333333342,31.502525252525277,0
822,4,0,0,37,0.0,0.0,1.0,37,850,300,550,0.35294117647058826,14,3,11,411.81633920860736,0.7207207207207207,0.17832422876618548,0.2673497810394057,135155.39583633692,3731.840067522099,138887.23590385902,820,8,486.4594594594595,33,4,13,29.337433706540956,0.6783459595959596,40.04289215686274,1039.8284313725485,31.509952465834804,0
823,4,0,0,37,0.0,0.0,1.0,37,850,500,350,0.5882352941176471,12,5,7,409.5555339602901,0.719532032032032,0.17880054633500286,0.2668240159469611,135282.8558276865,3681.1684508362187,138964.0242785227,821,9,487.4594594594595,33,4,13,29.26863686339184,0.6796085858585859,39.9203431372549,1040.3186274509806,31.524806892453956,0
824,4,0,0,37,0.0,0.0,1.0,37,1000,800,200,0.8,12,8,4,406.4782703135413,0.7184059059059059,0.17699329098292882,0.2655241131925069,135378.49024413674,3605.682910419054,138984.17315455579,822,10,488.4594594594595,33,4,14,29.25302245250432,0.6805555555555556,39.82843137254901,1040.6862745098028,31.535947712418267,0
825,4,0,0,37,0.0,0.0,1.0,37,1250,1000,250,0.8,15,10,5,404.27466032536444,0.7183433433433434,0.1733598004784449,0.26502449954662755,135506.05536332165,3556.3329008073615,139062.388264129,823,11,489.4594594594595,33,4,16,29.182850753295657,0.6818181818181819,39.70588235294117,1041.176470588234,31.550802139037394,0
826,4,0,0,37,0.0,0.0,1.0,37,600,400,200,0.6666666666666666,8,4,4,403.9403089313874,0.7184684684684685,0.1756422775606017,0.26504098880231625,135537.95602953172,3549.848766099556,139087.80479563127,824,12,490.4594594594595,33,4,17,29.15967890628065,0.6821338383838385,39.675245098039206,1041.2990196078417,31.554515745692175,0
827,4,0,0,37,0.0,0.0,1.0,37,900,700,200,0.7777777777777778,11,7,4,404.1333803104923,0.7182182182182182,0.1782257740652986,0.265647103255935,135602.68034297042,3560.3139172335514,139162.99426020397,825,13,491.4594594594595,34,3,17,29.089991237093763,0.680453431372549,39.613095238095234,1041.5476190476184,30.63375350140054,0
828,4,0,0,37,0.0,0.0,1.0,37,600,300,300,0.5,9,3,6,406.9232246736087,0.7165915915915916,0.1794808216826569,0.268190795052327,135697.5156790656,3643.6976751484785,139341.2133542141,826,14,492.4594594594595,33,4,18,28.92260644554223,0.6837121212121213,39.522058823529406,1041.9117647058813,31.5730837789661,0
829,4,0,0,37,0.0,0.0,1.0,37,800,400,400,0.5,12,4,8,404.01737969060116,0.7152777777777778,0.18211628039984573,0.2672295358979976,135825.23098087255,3575.15078335254,139400.3817642251,827,15,493.4594594594595,33,4,19,28.87079708441102,0.6849747474747476,39.39950980392156,1042.4019607843122,31.587938205585218,0
830,4,0,0,37,0.0,0.0,1.0,37,1100,700,400,0.6363636363636364,15,7,8,406.6605969900509,0.7132757757757757,0.18278504174131838,0.2694601525849959,135889.1111591693,3652.1494136870106,139541.2605728563,828,16,494.4594594594595,33,4,12,28.738148409340226,0.6856060606060608,39.33823529411763,1042.6470588235272,31.595365418894765,0
831,4,0,0,37,0.0,0.0,1.0,37,950,700,250,0.7368421052631579,12,7,5,406.52979947082656,0.7127752752752753,0.18290331699663032,0.2696151257753125,135921.05688016614,3651.191999471338,139572.24887963748,829,17,495.4594594594595,33,4,13,28.709675049947105,0.6859217171717173,39.30759803921568,1042.769607843136,31.599079025549578,0
832,4,0,0,37,0.0,0.0,1.0,37,1100,600,500,0.5454545454545454,16,6,10,405.4598903734857,0.7121496496496497,0.18193592953976379,0.270019033376385,136068.05555555547,3634.0277777777733,139702.08333333326,830,18,496.4594594594595,34,3,14,28.590921192758252,0.6850490196078431,39.166666666666664,1043.3333333333328,30.686274509803905,0
833,4,0,0,37,0.0,0.0,1.0,37,900,600,300,0.6666666666666666,12,6,6,382.71928795075587,0.7121496496496497,0.15512053977236362,0.23973899610209085,133852.3945117263,2856.6897347174267,136709.08424644373,831,19,497.4594594594595,33,4,15,31.398034107058272,0.6654040404040404,41.29901960784314,1034.8039215686279,31.35769459298872,4
834,4,1,1,37,0.02631578947368421,0.02631578947368421,0.9736842105263158,38,1300,1000,300,0.7692307692307693,16,10,6,373.365905311554,0.720513276434329,0.14471567334792956,0.23577867257047497,134149.66695011346,2417.382369614521,136567.049319728,832,0,485.3421052631579,34,4,15,31.342172297556125,0.6660539215686274,41.011904761904766,1035.9523809523816,30.46918767507005,0
835,4,0,0,37,0.0,0.0,1.0,37,1050,600,450,0.5714285714285714,15,6,9,379.1032526872307,0.7111486486486487,0.14399488245642078,0.23870510321960525,134042.68340301822,2763.2034554017864,136805.88685842,833,21,499.4594594594595,33,4,16,31.300788954635117,0.6672979797979797,41.11519607843138,1035.5392156862756,31.379976232917443,0
836,4,0,0,37,0.0,0.0,1.0,37,900,700,200,0.7777777777777778,11,7,4,377.57192478173977,0.7105855855855856,0.13876275724126774,0.23843475250005092,134149.66695011346,2730.229591836743,136879.8965419502,834,22,500.4594594594595,34,3,17,31.233241400444353,0.6660539215686274,41.011904761904766,1035.9523809523816,30.46918767507005,0
837,4,0,0,37,0.0,0.0,1.0,37,900,600,300,0.6666666666666666,12,6,6,365.1837808069458,0.7105855855855856,0.10570334605462928,0.22161994664118548,132673.81660997713,2290.065192743748,134963.8818027209,835,23,501.4594594594595,34,3,13,33.03482012171636,0.6513480392156863,42.44047619047618,1030.2380952380938,30.30112044817923,4
838,4,0,0,37,0.0,0.0,1.0,37,1150,900,250,0.782608695652174,14,9,5,376.9197084279127,0.7110235235235235,0.08519429784196975,0.22505703752189468,132061.2882653061,2568.4842687074815,134629.77253401358,836,24,502.4594594594595,34,3,18,33.35022392093275,0.6452205882352942,43.035714285714285,1027.8571428571427,30.231092436974784,3
839,4,0,0,37,0.0,0.0,1.0,37,750,600,150,0.8,9,6,3,376.7507373775746,0.7103353353353353,0.08216091018638783,0.22513789738791393,132091.8810232426,2553.1427154195003,134645.0237386621,837,25,503.4594594594595,34,3,19,33.323682686740014,0.6455269607843137,43.00595238095238,1027.9761904761904,30.234593837535012,0
840,4,0,0,37,0.0,0.0,1.0,37,950,700,250,0.7368421052631579,12,7,5,375.4340277777782,0.7116491491491491,0.07620120120120144,0.2252604166666666,132244.8979591835,2529.846938775491,134774.744897959,838,26,504.4594594594595,34,3,19,33.20312500000001,0.6470588235294118,42.85714285714285,1028.571428571427,30.25210084033609,0
841,4,0,0,37,0.0,0.0,1.0,37,1200,800,400,0.6666666666666666,16,8,8,376.0444623566227,0.7124624624624625,0.07984387491754541,0.22636501792909502,132368.22601862566,2555.267677254803,134923.49369588046,839,27,505.4594594594595,35,2,21,33.06304596408354,0.6461309523809524,42.73726851851852,1029.0509259259259,29.401455026455025,0
842,4,0,0,37,0.0,0.0,1.0,37,300,100,200,0.3333333333333333,5,1,4,377.9448995883331,0.7126501501501501,0.07766996728115383,0.22808177397066445,132462.98408644513,2612.751890883783,135075.7359773289,840,28,506.4594594594595,32,5,21,32.91860869209699,0.6539713541666667,42.645202020202014,1029.4191919191908,32.16934974747471,0
843,4,0,0,37,0.0,0.0,1.0,37,950,700,250,0.7368421052631579,12,7,5,377.3806171882078,0.7122747747747747,0.07655724393921814,0.22813483566863108,132527.98064291902,2602.6982259463166,135130.67886886533,841,29,507.4594594594595,32,5,21,32.86761700388309,0.6546223958333335,42.5820707070707,1029.6717171717164,32.17724116161614,0
844,4,0,0,37,0.0,0.0,1.0,37,1100,1000,100,0.9090909090909091,12,10,2,375.7572299314434,0.7142142142142142,0.08111323314749486,0.22789431997140772,132650.37035034588,2568.8671424451954,135219.2374927911,842,30,508.4594594594595,33,4,16,32.78610516297882,0.653409090909091,42.46323529411764,1030.1470588235281,31.216577540106915,0
845,4,1,1,37,0.02631578947368421,0.02631578947368421,0.9736842105263158,38,850,600,250,0.7058823529411765,11,6,5,368.68568283056226,0.7239509246088194,0.07976774287641519,0.2250307751230089,132888.53635204062,2198.820153061204,135087.35650510184,843,0,496.05263157894734,34,4,16,32.72861101489436,0.6534926470588236,42.23214285714285,1031.071428571427,30.325630252100797,0
846,4,0,0,37,0.0,0.0,1.0,37,1000,800,200,0.8,12,8,4,375.6385368757253,0.712525025025025,0.07845229295883227,0.22859045550831042,132776.64389898116,2575.204849096493,135351.84874807764,844,32,510.4594594594595,33,4,17,32.66200951248511,0.6546717171717171,42.3406862745098,1030.6372549019607,31.23143196672608,0
847,4,0,0,37,0.0,0.0,1.0,37,1300,1000,300,0.7692307692307693,16,10,6,379.43067033976126,0.7127752752752753,0.07119847119847145,0.23187429854096522,132934.5703125,2687.8906250000005,135622.4609375,845,33,511.4594594594595,33,4,19,32.405303030303024,0.65625,42.1875,1031.25,31.25,0
848,4,0,0,37,0.0,0.0,1.0,37,1150,600,550,0.5217391304347826,17,6,11,376.57799201902117,0.7125875875875876,0.06641051390647545,0.23079383867304334,133042.01388888867,2620.138888888866,135662.15277777755,846,34,512.4594594594595,34,3,19,32.37075928917609,0.6550245098039217,42.08333333333332,1031.666666666665,30.343137254901908,0
849,4,0,0,37,0.0,0.0,1.0,37,500,200,300,0.4,8,2,6,368.53462174140924,0.7127127127127127,0.0739516140936134,0.22477911139524318,132861.99787202736,2392.849225915102,135254.84709794246,847,35,513.4594594594595,36,1,17,32.759193519024215,0.6490162037037037,42.25788288288288,1030.968468468468,28.638013013013,3
850,4,0,0,37,0.0,0.0,1.0,37,1500,900,600,0.6,21,9,12,366.82842432531044,0.7120870870870871,0.0681046615159262,0.22502317294010227,133075.95245652503,2363.208391043393,135439.16084756842,848,36,514.4594594594595,37,0,18,32.588115479985845,0.6492117117117117,42.050438596491226,1031.7982456140346,27.886439070649583,0
851,4,1,1,37,0.02631578947368421,0.02631578947368421,0.9736842105263158,38,950,700,250,0.7368421052631579,12,7,5,361.32426514779723,0.7228544333807492,0.0694259956884351,0.22335569024609353,133361.8461903718,2037.3742146979303,135399.22040506973,849,0,501.89473684210526,38,0,19,32.44315439249759,0.6502192982456141,41.77350427350427,1032.9059829059827,27.181736392262703,0
852,4,0,0,37,0.0,0.0,1.0,37,650,300,350,0.46153846153846156,10,3,7,366.5440988542508,0.710085085085085,0.06630906153046978,0.2260475297256373,133274.01369892666,2370.160650392437,135644.1743493191,850,38,516.4594594594595,37,0,19,32.396530211319956,0.6511824324324323,41.85855263157895,1032.5657894736848,27.90718349928878,0
853,4,0,0,37,0.0,0.0,1.0,37,1050,700,350,0.6666666666666666,14,7,7,363.70749823788634,0.7107107107107107,0.06801792240128002,0.2251545366883947,133415.57618690372,2304.8490881809844,135720.4252750847,851,39,517.4594594594595,37,0,21,32.327708200665114,0.6525900900900901,41.72149122807018,1033.11403508772,27.922000948316754,0
854,4,0,1,36,0.0,0.02702702702702703,0.972972972972973,37,650,200,450,0.3076923076923077,11,2,9,363.9601752522432,0.7117117117117117,0.07019053437391531,0.22548301981603483,133443.89770169675,2313.6528787703983,135757.55058046716,852,40,518.4594594594595,37,0,21,32.29277211786763,0.6528716216216215,41.694078947368425,1033.223684210527,27.92496443812235,0
855,4,0,0,36,0.0,0.0,1.0,36,450,300,150,0.6666666666666666,6,3,3,367.8533955789014,0.7070436507936508,0.09153978463364698,0.22753332418376698,133384.96171424814,2613.2222171495914,135998.18393139774,853,86,532.75,36,0,21,32.25135361023294,0.654224537037037,41.75112612612613,1032.9954954954962,28.69431931931934,0
856,4,1,0,37,0.02702702702702703,0.0,1.0,37,450,400,50,0.8888888888888888,5,4,1,359.7244363493571,0.7169669669669669,0.08905726147105453,0.22375060344515735,133591.84777949256,2211.307495871757,135803.15527536432,854,0,519.3243243243244,35,2,22,32.253881176294975,0.6583333333333332,41.55092592592593,1033.796296296297,29.537037037037056,0
857,4,0,0,37,0.0,0.0,1.0,37,1050,900,150,0.8571428571428571,12,9,3,358.95118916730263,0.7168418418418419,0.08850103601082937,0.22381220343404393,133681.6021117327,2197.034009559335,135878.63612129205,855,1,520.3243243243244,35,2,22,32.18394422682336,0.6592261904761905,41.464120370370374,1034.1435185185187,29.546957671957678,0
858,4,0,0,37,0.0,0.0,1.0,37,1050,800,250,0.7619047619047619,13,8,5,361.36023351819836,0.7154029029029029,0.08035846563646065,0.2260461250818177,133801.32144043632,2270.0953521519127,136071.41679258825,856,2,521.3243243243244,35,2,17,32.00173863593988,0.6604166666666667,41.348379629629626,1034.606481481481,29.560185185185173,0
859,4,0,1,36,0.0,0.02702702702702703,0.972972972972973,37,1050,800,250,0.7619047619047619,13,8,5,366.1587273604003,0.7164664664664665,0.0573439340577897,0.2351331383786793,134761.00508241166,2468.783623756856,137229.78870616853,857,3,522.3243243243244,35,2,22,30.917795303384967,0.6699404761904761,40.4224537037037,1038.310185185185,29.666005291005284,1
860,4,0,0,36,0.0,0.0,1.0,36,450,400,50,0.8888888888888888,5,4,1,371.8427582384206,0.7056878306878307,0.06749126965919805,0.23801212674908595,134643.43112244896,2813.236961451245,137456.6680839002,858,91,537.75,34,2,22,30.887722719278123,0.6709558823529411,40.535714285714285,1037.8571428571427,30.525210084033606,0
861,4,0,0,36,0.0,0.0,1.0,36,850,600,250,0.7058823529411765,11,6,5,370.4894192826041,0.7055224867724869,0.08004700217814964,0.2381561683420895,134797.91843820858,2788.2405045351425,137586.15894274373,859,92,538.75,34,2,19,30.76851427261263,0.6724877450980392,40.38690476190476,1038.4523809523807,30.542717086834728,0
862,4,0,0,36,0.0,0.0,1.0,36,1150,800,350,0.6956521739130435,15,8,7,368.406971107918,0.7051587301587302,0.07268826240863824,0.23742387222213385,134890.65334467115,2738.9314058956857,137629.58475056684,860,93,539.75,34,2,21,30.730002292000908,0.6734068627450981,40.297619047619044,1038.8095238095234,30.553221288515395,0
863,4,0,0,36,0.0,0.0,1.0,36,1150,900,250,0.782608695652174,14,9,5,365.19858532447785,0.7053240740740742,0.07195001237317511,0.2362740126955192,135031.53399348402,2662.6650377228816,137694.1990312069,861,94,540.75,35,1,21,30.672791388270223,0.6726190476190477,40.162037037037024,1039.3518518518501,29.695767195767147,0
864,4,0,0,36,0.0,0.0,1.0,36,550,300,250,0.5454545454545454,8,3,5,363.75052514559025,0.7046957671957672,0.07466263435872733,0.235925701616089,135121.77057881074,2630.12300132886,137751.89358013961,862,95,541.75,35,1,21,30.62045437678578,0.6735119047619048,40.075231481481474,1039.699074074073,29.7056878306878,0
865,4,0,0,36,0.0,0.0,1.0,36,850,700,150,0.8235294117647058,10,7,3,363.184832017795,0.7044642857142858,0.07937656107030677,0.23614897977654895,135212.03730495542,2621.3922110768144,137833.42951603222,863,96,542.75,35,1,21,30.545199940648402,0.674404761904762,39.988425925925924,1040.0462962962963,29.715608465608465,0
866,4,0,0,36,0.0,0.0,1.0,36,1250,1000,250,0.8,15,10,5,365.7156919411109,0.7037367724867726,0.08220887301415525,0.2384507606100158,135311.28415155018,2697.0919821848893,138008.37613373506,864,97,543.75,36,0,21,30.38049752859256,0.6733217592592593,39.89301801801802,1040.4279279279278,28.900775775775774,0
867,4,0,0,36,0.0,0.0,1.0,36,950,700,250,0.7368421052631579,12,7,5,364.53376490763907,0.7035383597883599,0.08171083468541629,0.23884582966485615,135487.08917955103,2677.9237429997434,138165.01292255076,865,98,544.75,36,0,21,30.236163692085814,0.6750578703703705,39.72409909909909,1041.1036036036023,28.919544544544507,0
868,4,0,0,36,0.0,0.0,1.0,36,1050,600,450,0.5714285714285714,15,6,9,363.77213519532836,0.7030423280423281,0.07781142596197754,0.2385416426961707,135516.40111395178,2659.4181174417618,138175.81923139354,866,99,545.75,36,0,21,30.226809791621605,0.6753472222222223,39.695945945945944,1041.216216216216,28.922672672672668,0
869,4,0,0,36,0.0,0.0,1.0,36,1000,700,300,0.7,13,7,6,360.0000000000001,0.7042328042328043,0.07711111111111135,0.23684210526315777,135633.68055555536,2565.675726402054,138199.3562819574,867,100,546.75,35,1,21,30.208333333333332,0.6785714285714286,39.58333333333332,1041.6666666666652,29.76190476190472,0
870,4,0,1,35,0.0,0.027777777777777776,0.9722222222222222,36,1000,700,300,0.7,13,7,6,361.45661871481275,0.705489417989418,0.08248167073983637,0.23820149939024438,135693.96888931727,2609.4966349450997,138303.46552426237,868,101,547.75,35,1,21,30.110438421091615,0.6791666666666668,39.52546296296295,1041.8981481481458,29.76851851851845,0
871,4,0,0,35,0.0,0.0,1.0,35,900,500,400,0.5555555555555556,13,5,8,363.25096705790895,0.6995098039215686,0.09114936146585251,0.23999082599827348,135784.42650730864,2864.764848036674,138649.1913553453,869,102,560.1428571428571,35,0,22,29.973741439940774,0.680059523809524,39.4386574074074,1042.245370370369,29.778439153439116,0
872,4,1,0,36,0.027777777777777776,0.0,1.0,36,650,500,150,0.7692307692307693,8,5,3,353.1021732526915,0.7047949735449736,0.08663728488337252,0.2351899090716164,136073.93024358808,2409.6000984092084,138483.53034199728,870,0,545.5555555555555,36,0,17,29.950755531570433,0.6808449074074074,39.16103603603603,1043.355855855855,28.982107107107083,0
873,4,0,1,35,0.0,0.027777777777777776,0.9722222222222222,36,1100,900,200,0.8181818181818182,13,9,4,352.8068820377505,0.7043650793650794,0.08895723912991338,0.23518766683178377,136103.3055859914,2403.6365757649523,138506.94216175633,871,1,546.5555555555555,36,0,17,29.929311461256198,0.6811342592592593,39.13288288288288,1043.4684684684685,28.985235235235237,0
874,4,0,0,35,0.0,0.0,1.0,35,1250,1100,150,0.88,14,11,3,354.1518791174503,0.7046918767507002,0.08598989435002302,0.2367750776694057,136206.96058652687,2647.590208118988,138854.55079464585,872,2,547.4857142857143,35,0,17,29.791389474073252,0.6842261904761905,39.03356481481481,1043.8657407407402,29.824735449735435,0
875,4,0,0,35,0.0,0.0,1.0,35,750,600,150,0.8,9,6,3,357.41156643051113,0.7058123249299719,0.08044692737430204,0.2255876953140388,134130.8258852021,2587.981717249634,136718.80760245174,873,3,548.4857142857143,35,0,19,31.774208566108015,0.6636904761904763,41.03009259259258,1035.879629629628,29.5965608465608,4
876,4,0,0,35,0.0,0.0,1.0,35,950,800,150,0.8421052631578947,11,8,3,357.64511463191536,0.7052521008403361,0.0843449255470261,0.22591964862881217,134160.80092860485,2596.3910054440676,136757.19193404893,874,4,549.4857142857143,35,0,19,31.738190332551284,0.6639880952380954,41.00115740740739,1035.9953703703682,29.59986772486766,0
877,4,0,0,35,0.0,0.0,1.0,35,850,600,250,0.7058823529411765,11,6,5,356.67321857343586,0.7054621848739495,0.08638437729346804,0.22585940587740747,134250.74615269186,2576.7291452331738,136827.47529792503,875,5,550.4857142857143,35,0,19,31.67346065073336,0.6648809523809525,40.91435185185184,1036.3425925925912,29.609788359788322,0
878,4,0,0,35,0.0,0.0,1.0,35,700,500,200,0.7142857142857143,9,5,4,354.00413140828465,0.7060224089635854,0.08291041324423087,0.22472112012927015,134340.72151759663,2511.434086719796,136852.15560431642,876,6,551.4857142857143,35,0,19,31.65273436046294,0.6657738095238097,40.82754629629628,1036.689814814813,29.61970899470894,0
879,4,0,0,35,0.0,0.0,1.0,35,850,600,250,0.7058823529411765,11,6,5,355.2712350550636,0.707422969187675,0.08608733081448183,0.22626762880799023,134460.73555651997,2554.0063175154223,137014.7418740354,877,7,552.4857142857143,35,0,19,31.500041848008024,0.6669642857142858,40.71180555555555,1037.152777777777,29.632936507936485,0
880,4,0,0,35,0.0,0.0,1.0,35,850,500,350,0.5882352941176471,12,5,7,354.5472063373634,0.7068627450980391,0.09098729821365326,0.2269584497710605,134646.15660142727,2547.744015055639,137193.90061648292,878,8,553.4857142857143,33,2,19,31.333761364978148,0.6732954545454546,40.533088235294116,1037.8676470588232,31.450534759358277,0
881,4,0,0,35,0.0,0.0,1.0,35,600,400,200,0.6666666666666666,8,4,4,351.9905475462222,0.7069327731092436,0.09388477685420926,0.22611189608484755,134773.3763005814,2487.7909037389395,137261.16720432034,879,9,554.4857142857143,33,2,19,31.273235571816347,0.6745580808080809,40.41053921568627,1038.3578431372543,31.465389185977404,0
882,4,0,0,35,0.0,0.0,1.0,35,850,500,350,0.5882352941176471,12,5,7,350.81643911904695,0.7063725490196078,0.09097682258744233,0.2257531755151043,134837.00867755193,2460.607849144565,137297.61652669648,880,10,555.4857142857143,33,2,17,31.240290068829893,0.6751893939393939,40.349264705882355,1038.602941176471,31.472816399286998,0
883,4,0,0,35,0.0,0.0,1.0,35,800,500,300,0.625,11,5,6,354.68615819634635,0.707422969187675,0.0842640885383541,0.2302384714765877,135151.85613854585,2587.2985253772176,137739.15466392305,881,11,556.4857142857143,35,0,19,30.826098248738496,0.6738095238095239,40.04629629629629,1039.814814814814,29.708994708994688,3
884,4,0,0,35,0.0,0.0,1.0,35,950,900,50,0.9473684210526315,10,9,1,359.2789958757684,0.707422969187675,0.07205111402359154,0.23036123853211005,134705.21541950095,2680.2082458497634,137385.4236653507,882,12,557.4857142857143,34,1,22,31.152045107033658,0.6715686274509804,40.47619047619047,1038.0952380952367,30.53221288515402,1
885,4,0,0,35,0.0,0.0,1.0,35,750,400,350,0.5333333333333333,11,4,7,359.5032943635388,0.7065826330532212,0.06938494792690153,0.23129105752415258,134828.82653061207,2694.2814625850133,137523.10799319707,883,13,558.4857142857143,34,1,20,31.022896607060982,0.6727941176470589,40.35714285714285,1038.571428571427,30.546218487394913,0
886,4,0,0,35,0.0,0.0,1.0,35,800,600,200,0.75,10,6,4,361.26075227234844,0.7057422969187674,0.06406390675899098,0.23301719032378285,134921.5720663264,2748.3737244897734,137669.94579081616,884,14,559.4857142857143,34,1,20,30.88475421106908,0.6737132352941178,40.26785714285713,1038.9285714285702,30.556722689075595,0
887,4,0,0,35,0.0,0.0,1.0,35,800,400,400,0.5,12,4,8,359.6111790681407,0.7039915966386554,0.062090743982852636,0.23274760596322716,135045.28238378678,2712.7586451247066,137758.04102891148,885,15,560.4857142857143,34,1,22,30.804270224869242,0.6749387254901962,40.14880952380952,1039.4047619047612,30.570728291316506,0
888,4,0,0,35,0.0,0.0,1.0,35,950,600,350,0.631578947368421,13,6,7,361.48851255452814,0.7031512605042016,0.06341718734665847,0.23456468563530816,135138.10232426293,2770.1743197278806,137908.2766439908,886,16,561.4857142857143,34,1,22,30.66297420044271,0.6758578431372548,40.0595238095238,1039.761904761904,30.581232492997174,0
889,4,0,0,35,0.0,0.0,1.0,35,650,300,350,0.46153846153846156,10,3,7,358.14304675214623,0.7021008403361344,0.05993557775633995,0.23299298581336578,135230.95415249438,2686.40518707483,137917.3593395692,887,17,562.4857142857143,34,1,22,30.65745297775742,0.6767769607843137,39.970238095238095,1040.119047619048,30.59173669467788,0
890,4,0,0,35,0.0,0.0,1.0,35,1200,1000,200,0.8333333333333334,14,10,4,356.7641005445698,0.7023109243697478,0.058424175069867745,0.23289581798805706,135354.80619331065,2657.9471371882064,138012.75333049885,888,18,563.4857142857143,34,1,22,30.570014872440222,0.6780024509803921,39.851190476190474,1040.595238095238,30.605742296918766,0
891,4,0,0,35,0.0,0.0,1.0,35,700,500,200,0.7142857142857143,9,5,4,361.46264209693123,0.7005602240896358,0.04461284685361533,0.2371878267383241,135540.69054705233,2798.579223356032,138339.26977040837,889,19,564.4857142857143,34,1,22,30.26275675469686,0.6798406862745097,39.67261904761906,1041.3095238095252,30.626750700280155,0
892,4,0,0,35,0.0,0.0,1.0,35,400,300,100,0.75,5,3,2,361.46264209693123,0.7005602240896358,0.04461284685361533,0.2371878267383241,135540.69054705233,2798.579223356032,138339.26977040837,890,20,565.4857142857143,34,1,22,30.26275675469686,0.6798406862745097,39.67261904761906,1041.3095238095252,30.626750700280155,0
893,4,0,0,35,0.0,0.0,1.0,35,1050,600,450,0.5714285714285714,15,6,9,361.81805386606834,0.7003501400560224,0.04206181639229767,0.23783788654059532,135603.54141214423,2812.761890217765,138416.303302362,891,21,566.4857142857143,35,0,22,30.190970292995527,0.6782738095238094,39.61226851851852,1041.550925925926,29.75859788359789,0
894,4,0,0,35,0.0,0.0,1.0,35,800,500,300,0.625,11,5,6,363.25140939420874,0.7002100840336134,0.04430154559253152,0.2396035860156376,135726.7024518142,2860.5865405897625,138587.28899240395,892,22,567.4857142857143,34,1,22,30.031132183251454,0.6816789215686274,39.49404761904763,1042.0238095238108,30.647759103641494,0
895,4,0,0,35,0.0,0.0,1.0,35,600,300,300,0.5,9,3,6,363.1882663333762,0.6993697478991596,0.04462715541852247,0.24039604295399675,135850.78125000012,2867.8819444444603,138718.66319444458,893,23,568.4857142857143,34,1,22,29.909405808686394,0.6829044117647058,39.37500000000001,1042.500000000001,30.66176470588238,0
896,4,0,0,35,0.0,0.0,1.0,35,750,500,250,0.6666666666666666,10,5,5,365.59652634432155,0.6975490196078431,0.04504240052185282,0.24262314930123147,135943.87755102038,2940.1218820861664,138883.99943310654,894,24,569.4857142857143,34,1,18,29.754090563165903,0.6838235294117647,39.285714285714285,1042.8571428571427,30.67226890756302,0
897,4,0,0,35,0.0,0.0,1.0,35,1300,1100,200,0.8461538461538461,15,11,4,364.2517871869421,0.6964285714285714,0.047920165669281145,0.2419416154317515,135974.91673752843,2905.821286848085,138880.7380243765,895,25,570.4857142857143,34,1,18,29.758303846592867,0.6841299019607843,39.25595238095239,1042.9761904761913,30.675770308123273,0
898,4,0,0,35,0.0,0.0,1.0,35,850,500,350,0.5882352941176471,12,5,7,365.80107640426684,0.6944677871148459,0.05440469399396952,0.24382102164892788,136099.10891439917,2957.0401077097604,139056.14902210893,896,26,571.4857142857143,34,1,18,29.594504658680357,0.6853553921568627,39.136904761904766,1043.4523809523816,30.689775910364165,0
899,4,0,0,35,0.0,0.0,1.0,35,800,500,300,0.625,11,5,6,362.904012200814,0.6939775910364145,0.05258185372210478,0.24295177000008703,136254.42885487535,2889.45578231293,139143.88463718828,897,27,572.4857142857143,34,1,19,29.515868491068037,0.6868872549019607,38.98809523809524,1044.0476190476195,30.70728291316528,0
900,4,0,0,35,0.0,0.0,1.0,35,1050,800,250,0.7619047619047619,13,8,5,363.84656939160345,0.6943977591036414,0.05559246954595776,0.244010864426846,136316.5816326531,2919.6641156462633,139236.24574829938,898,28,573.4857142857143,34,1,19,29.429577063383487,0.6875,38.92857142857143,1044.2857142857147,30.714285714285726,0
901,4,0,0,35,0.0,0.0,1.0,35,650,400,250,0.6153846153846154,9,4,5,363.1595599011917,0.694047619047619,0.05518251978247424,0.24397871198874865,136378.7485827665,2905.4492630385516,139284.19784580506,899,29,574.4857142857143,34,1,19,29.38582744472304,0.6881127450980392,38.86904761904762,1044.5238095238099,30.721288515406172,0
902,4,0,0,35,0.0,0.0,1.0,35,950,700,250,0.7368421052631579,12,7,5,366.0800000000001,0.694047619047619,0.046628571428571686,0.240842105263158,135633.6805555556,2930.5555555555616,138564.23611111115,900,30,575.4857142857143,34,1,20,30.050000000000004,0.6807598039215685,39.583333333333336,1041.666666666667,30.637254901960794,1
903,4,0,0,35,0.0,0.0,1.0,35,400,200,200,0.5,6,2,4,367.08193520248375,0.6937675070028011,0.0489618699399319,0.2419202633201911,135695.69160997728,2962.2874149659765,138657.97902494326,901,31,576.4857142857143,34,1,20,29.962199116392437,0.6813725490196079,39.52380952380952,1041.9047619047615,30.64425770308122,0
904,4,0,0,35,0.0,0.0,1.0,35,1050,700,350,0.6666666666666666,14,7,7,366.73331982392136,0.6929271708683473,0.04768648436990164,0.24253149156935463,135819.75623582763,2961.926020408165,138781.6822562358,902,32,577.4857142857143,34,1,20,29.84786622506473,0.6825980392156863,39.404761904761905,1042.3809523809523,30.658263305322127,0
905,4,0,0,35,0.0,0.0,1.0,35,800,600,200,0.75,10,6,4,366.3431642259051,0.692156862745098,0.04933285485923067,0.2426954184788561,135881.80980725627,2955.8744331065764,138837.68424036284,903,33,578.4857142857143,34,1,18,29.79632907056405,0.6832107843137255,39.345238095238095,1042.6190476190477,30.66526610644258,0
906,4,0,0,35,0.0,0.0,1.0,35,850,600,250,0.7058823529411765,11,6,5,359.638879601974,0.692156862745098,-0.034550602236191774,0.2235166898904123,133561.93636670496,2606.813030478357,136168.74939718333,904,34,579.4857142857143,35,0,19,32.28606818945246,0.6580357142857145,41.57986111111109,1033.6805555555532,29.53373015873009,8
907,4,0,0,35,0.0,0.0,1.0,35,750,600,150,0.8,9,6,3,352.2603306180139,0.692156862745098,-0.0015470933899939254,0.20566841284251206,131206.12953514737,2280.6654157611997,133486.79495090857,905,35,580.4857142857143,34,1,20,34.8465702223255,0.6366421568627452,43.86904761904761,1024.5238095238092,30.133053221288506,8
908,4,0,0,35,0.0,0.0,1.0,35,750,500,250,0.6666666666666666,10,5,5,353.12800144414837,0.6914565826330532,-0.004374668082846256,0.206503113887991,131267.1201814059,2270.8191609977353,133537.9393424036,906,36,581.4857142857143,34,1,21,34.76272072490707,0.6372549019607843,43.80952380952381,1024.7619047619046,30.14005602240896,0
909,4,0,0,35,0.0,0.0,1.0,35,400,300,100,0.75,5,3,2,353.12800144414837,0.6914565826330532,-0.004374668082846256,0.206503113887991,131267.1201814059,2270.8191609977353,133537.9393424036,907,37,582.4857142857143,34,1,21,34.76272072490707,0.6372549019607843,43.80952380952381,1024.7619047619046,30.14005602240896,0
910,4,0,0,35,0.0,0.0,1.0,35,650,400,250,0.6153846153846154,9,4,5,353.5469482842456,0.6918067226890756,-0.0018386074373990535,0.20691269053562675,131297.62081916095,2283.974631519275,133581.59545068024,908,38,583.4857142857143,34,1,21,34.721173578038496,0.6375612745098038,43.779761904761905,1024.880952380952,30.143557422969177,0
911,4,1,1,35,0.027777777777777776,0.027777777777777776,0.9722222222222222,36,550,300,250,0.5454545454545454,8,3,5,346.7063697067516,0.7037367724867726,-0.008481907771007213,0.204018051018674,131506.13667052463,1918.8030478394999,133424.93971836413,909,0,568.25,35,1,21,34.686018957345965,0.6375,43.576388888888886,1025.6944444444441,29.305555555555546,0
912,4,1,1,35,0.027777777777777776,0.027777777777777776,0.9722222222222222,36,950,600,350,0.631578947368421,13,6,7,346.64192621739744,0.7047288359788361,-0.007437902599192858,0.20461566696694056,131624.87809713645,1925.3402563443017,133550.21835348074,910,0,569.2222222222222,35,1,19,34.567918640499286,0.6386904761904761,43.460648148148145,1026.1574074074072,29.318783068783063,0
913,4,1,1,35,0.027777777777777776,0.027777777777777776,0.9722222222222222,36,950,600,350,0.631578947368421,13,6,7,364.0812931199837,0.7108796296296297,0.012353818695223673,0.20945973429013143,130638.1635068244,2327.719688622858,132965.88319544727,911,0,570.1944444444445,33,3,15,35.11897626468471,0.6332070707070707,44.42401960784314,1022.3039215686283,30.978906714200857,7
914,4,2,2,35,0.05405405405405406,0.05405405405405406,0.9459459459459459,37,600,400,200,0.6666666666666666,8,4,4,358.3837485503193,0.71996996996997,0.005943115890760131,0.20742816961548777,130870.93431122445,1980.4032029478424,132851.3375141723,912,0,555.7297297297297,34,3,15,35.028844289315494,0.6332720588235294,44.19642857142857,1023.2142857142853,30.09453781512604,0
915,4,1,0,36,0.027777777777777776,0.0,1.0,36,1050,600,450,0.5714285714285714,15,6,9,365.71776859719307,0.7099537037037037,0.022155015238019216,0.211599282745528,130857.49959450706,2371.382551182255,133228.8821456893,913,0,572.1388888888889,33,3,17,34.854847885974365,0.6354166666666665,44.20955882352942,1023.1617647058835,31.00490196078435,0
916,4,0,0,36,0.0,0.0,1.0,36,1550,1300,250,0.8387096774193549,18,13,5,342.66968752998855,0.7112433862433863,0.01940466267586083,0.19202598158527645,129613.56122470848,1682.9277049039777,131296.48892961245,914,1,573.1388888888889,35,1,15,36.70483822080777,0.618452380952381,45.42824074074074,1018.2870370370368,29.093915343915338,6
917,4,4,2,38,0.1,0.05,0.95,40,1250,1000,250,0.8,15,10,5,322.51815217423564,0.7571314102564103,0.06404617634768073,0.1859725152175774,130726.51855504428,433.95594711589973,131160.47450216018,915,0,516.725,38,2,14,36.092030575289044,0.6239035087719298,44.33760683760684,1022.6495726495733,26.9118308591993,0
918,4,2,1,39,0.05,0.025,0.975,40,850,700,150,0.8235294117647058,10,7,3,324.7031747438459,0.7546474358974359,0.06281201044386453,0.18763022921981432,130808.47447083419,494.78538881583233,131303.25985965002,916,0,517.675,38,2,15,35.953437771975636,0.6247258771929824,44.25747863247863,1022.970085470085,26.9202654071075,0
919,4,0,0,39,0.0,0.0,1.0,39,1100,800,300,0.7272727272727273,14,8,6,331.72628410723644,0.7464012595591544,0.0673310673310672,0.19092690574172058,130654.64854570644,868.3162126808331,131522.96475838727,917,1,531.9487179487179,37,2,15,35.92923280423282,0.625,44.40789473684211,1022.3684210526321,27.631578947368435,0
920,4,0,0,39,0.0,0.0,1.0,39,1150,800,350,0.6956521739130435,15,8,7,332.907108768098,0.7470760233918129,0.06499976642512273,0.19258253142685186,130850.9003371229,912.2389821868198,131763.13931930973,918,2,532.9487179487179,37,2,17,35.700777873039684,0.6269707207207207,44.21600877192982,1023.1359649122802,27.652323376007573,0
921,4,0,0,39,0.0,0.0,1.0,39,950,800,150,0.8421052631578947,11,8,3,332.9922767118712,0.7463450292397661,0.06705353512040202,0.19277195572426686,130878.94833025543,916.3357956294193,131795.28412588485,919,3,533.9487179487179,37,2,18,35.67027432490355,0.6272522522522522,44.18859649122807,1023.2456140350874,27.655286865813174,0
922,4,0,0,39,0.0,0.0,1.0,39,1000,700,300,0.7,13,7,6,336.6265036254631,0.7458951866846604,0.06872387981833294,0.19572965696479283,131047.29940943359,1022.7988419513628,132070.09825138494,920,4,534.9487179487179,37,2,18,35.407296351824094,0.6289414414414414,44.02412280701754,1023.9035087719292,27.673067804646735,0
923,4,0,0,39,0.0,0.0,1.0,39,1100,800,300,0.7272727272727273,14,8,6,338.316008601993,0.7464012595591544,0.07637401855817316,0.19699947134305565,131103.44048168662,1070.8785395506293,132174.31902123726,921,5,535.9487179487179,37,2,18,35.30736973590294,0.6295045045045045,43.969298245614034,1024.1228070175434,27.67899478425793,0
924,4,0,0,39,0.0,0.0,1.0,39,1100,900,200,0.8181818181818182,13,9,4,340.18565522652034,0.7456702654071076,0.07449230988713174,0.198959645415961,131271.93583602642,1131.3659010464723,132403.30173707288,922,6,536.9487179487179,37,2,18,35.08943219915828,0.6311936936936937,43.80482456140351,1024.7807017543855,27.696775723091502,0
925,4,0,1,38,0.0,0.02564102564102564,0.9743589743589743,39,1000,700,300,0.7,13,7,6,340.1397462171171,0.7464574898785425,0.08033662295525246,0.1995252738118964,131385.8453047641,1137.9216386269009,132523.766943391,923,7,537.9487179487179,36,3,19,34.975697495606326,0.6342592592592593,43.69369369369369,1025.2252252252244,28.478478478478458,0
926,4,0,1,37,0.0,0.02631578947368421,0.9736842105263158,38,700,500,200,0.7142857142857143,9,5,4,343.4588866650502,0.7444286391654813,0.10300372142477365,0.20208162401455299,131501.32395909436,1433.0596643941378,132934.38362348848,924,8,546.1578947368421,36,2,19,34.7741454399063,0.6354166666666665,43.58108108108109,1025.6756756756768,28.490990990991023,0
927,4,0,0,37,0.0,0.0,1.0,37,1100,600,500,0.5454545454545454,16,6,10,350.4867781412502,0.7452452452452453,0.10000975704946802,0.20656348413856668,131565.50068587108,1822.393689986284,133387.89437585737,925,9,538.5675675675676,35,2,15,34.529181708784606,0.638095238095238,43.51851851851852,1025.925925925926,29.312169312169317,0
928,4,0,0,37,0.0,0.0,1.0,37,1200,1100,100,0.9166666666666666,13,11,2,352.57735431650997,0.7456831831831832,0.1012797141829398,0.20811922925234203,131624.87809713645,1881.590256344301,133506.46835348074,926,10,539.5675675675676,35,2,15,34.41565155274832,0.6386904761904761,43.460648148148145,1026.1574074074072,29.318783068783063,0
929,4,1,0,38,0.02631578947368421,0.0,1.0,38,600,300,300,0.5,9,3,6,344.3533573443983,0.7527560455192034,0.09767389535990634,0.20492731109282086,131934.82069485018,1486.4396913805676,133421.26038623074,927,0,526.3421052631579,36,2,17,34.31437027293654,0.6397569444444444,43.15878378378378,1027.3648648648643,28.537912912912898,0
930,4,0,0,38,0.0,0.0,1.0,38,800,600,200,0.75,10,6,4,345.6045481491713,0.7510668563300142,0.09630781669342992,0.20635012957645413,132059.6782182978,1528.0850838719414,133587.76330216974,928,1,527.3421052631579,37,1,18,34.15653225232913,0.6390765765765767,43.037280701754376,1027.8508771929812,27.77975343764814,0
931,4,1,0,39,0.02564102564102564,0.0,1.0,39,850,600,250,0.7058823529411765,11,6,5,337.5023109568329,0.7571412505623032,0.09767654825794381,0.2031763911960132,132370.5164730804,1135.0710424428182,133505.58751552322,929,0,514.7948717948718,38,1,20,34.05229097452934,0.6403508771929826,42.735042735042725,1029.0598290598277,27.080521817363888,0
932,4,0,0,39,0.0,0.0,1.0,39,800,500,300,0.625,11,5,6,335.73856499564863,0.7564102564102564,0.08656369876842351,0.20304189406879686,132542.91453615762,1099.9592924791968,133642.87382863683,930,1,515.7948717948718,36,3,20,33.92456802274715,0.6458333333333335,42.56756756756756,1029.7297297297284,28.603603603603567,0
933,4,0,0,39,0.0,0.0,1.0,39,500,200,300,0.4,8,2,6,335.73856499564863,0.7564102564102564,0.08656369876842351,0.20304189406879686,132542.91453615762,1099.9535853420794,133642.8681214997,931,2,516.7948717948718,36,3,20,33.92456802274715,0.6458333333333335,42.56756756756756,1029.7297297297284,28.603603603603567,0
934,4,0,0,39,0.0,0.0,1.0,39,800,700,100,0.875,9,7,2,333.4038021303128,0.7563540260908682,0.08444212686504415,0.20194113736979052,132600.9011545328,1041.9289221653935,133642.83007669818,932,3,517.7948717948718,36,3,20,33.92648881113783,0.6464120370370372,42.511261261261254,1029.954954954954,28.609859859859835,0
935,4,1,0,40,0.025,0.0,1.0,40,750,300,450,0.4,12,3,9,327.43926056580824,0.7630876068376068,0.09386030193493555,0.2002531654669693,132962.84072983972,707.4508502615924,133670.2915801013,933,0,505.825,37,3,16,33.71739669714367,0.6480855855855857,42.16008771929823,1031.3596491228052,27.874585111427166,0
936,4,0,0,40,0.0,0.0,1.0,40,900,600,300,0.6666666666666666,12,6,6,327.8416701218893,0.762900641025641,0.09544753906665271,0.2006510468989335,132991.1141529122,720.0057950522987,133711.1199479645,934,1,506.825,37,3,16,33.67871000318911,0.6483671171171173,42.13267543859648,1031.4692982456122,27.877548601232764,0
937,4,0,1,39,0.0,0.025,0.975,40,950,700,250,0.7368421052631579,12,7,5,324.3327398947705,0.7634081196581196,0.04182808716707065,0.1999245098157318,133257.03125000012,643.9236111111263,133900.95486111124,935,2,507.825,39,1,17,33.50316115146622,0.6474358974358974,41.87500000000001,1032.500000000001,26.474358974359,5
938,4,0,0,39,0.0,0.0,1.0,39,1050,700,350,0.6666666666666666,14,7,7,330.71584797871736,0.7572537112010796,0.04836438000811638,0.2042830736364384,133334.2593163307,1019.1505268829013,134353.4098432136,936,3,521.6410256410256,38,1,17,33.26113754698114,0.6499451754385964,41.800213675213676,1032.7991452991457,27.17892487629331,0
939,4,0,0,39,0.0,0.0,1.0,39,950,600,350,0.631578947368421,13,6,7,331.0353798126952,0.7568038686459739,0.04549214226633591,0.20524193548387093,133472.22222222216,1036.8055555555516,134509.02777777772,937,4,522.6410256410256,38,1,17,33.11491935483872,0.6513157894736842,41.666666666666664,1033.333333333333,27.192982456140342,0
940,4,0,1,38,0.0,0.02564102564102564,0.9743589743589743,39,950,800,150,0.8421052631578947,11,8,3,335.4254531397693,0.75787224471435,0.039765319426336765,0.20858461983164556,133582.64391116946,1161.4037731024844,134744.04768427194,938,5,523.6410256410256,38,1,17,32.89108791511646,0.6524122807017544,41.559829059829056,1033.760683760683,27.20422852001797,0
941,4,0,0,38,0.0,0.0,1.0,38,1100,900,200,0.8181818181818182,13,9,4,347.2312973616521,0.7509186818397344,0.051364043794576375,0.20008132131537482,130699.20562358478,1476.5709465629477,132175.77657014772,939,10,538.2894736842105,38,0,13,35.4878452269007,0.6236293859649122,44.364316239316246,1022.5427350427364,26.909019343229904,4
942,4,0,0,38,0.0,0.0,1.0,38,700,500,200,0.7142857142857143,9,5,4,334.90395061728395,0.7509186818397344,0.053578947368420726,0.18201301663982836,128401.20525931347,1012.8928363801599,129414.09809569363,940,11,539.2894736842105,36,2,14,38.135879629629635,0.6041666666666665,46.62162162162163,1013.5135135135143,28.153153153153177,6
943,4,0,0,38,0.0,0.0,1.0,38,800,600,200,0.75,10,6,4,334.44043133206384,0.7519855381697487,0.05162033248380804,0.18228218182287578,128515.36502718956,996.1468224981974,129511.51184968775,941,12,540.2894736842105,36,2,14,38.03124537242707,0.605324074074074,46.50900900900902,1013.9639639639656,28.165665665665713,0
944,4,0,0,38,0.0,0.0,1.0,38,1150,900,250,0.782608695652174,14,9,5,331.7167584483249,0.752430061640588,0.04880122477838866,0.18118695229497095,128601.01814229802,931.8225742634901,129532.84071656152,942,13,541.2894736842105,36,2,14,38.013026904999805,0.6061921296296295,46.42454954954957,1014.3018018018045,28.175050050050125,0
945,4,2,3,37,0.05,0.075,0.925,40,750,600,150,0.8,9,6,3,319.48711163937503,0.768349358974359,0.04267273109685554,0.17632054234351846,129011.37689248701,243.49443439991876,129254.87132688693,943,0,515.175,38,2,15,37.90597504118904,0.6066337719298244,46.02029914529916,1015.9188034188062,26.73470535312648,0
946,4,0,0,37,0.0,0.0,1.0,37,750,400,350,0.5333333333333333,11,4,7,341.4636991584802,0.7456831831831832,0.05538628541823476,0.18657031542549385,128613.70991941028,1383.3826303155179,129997.0925497258,944,28,557.5675675675676,35,2,15,37.75292864749735,0.6083333333333332,46.412037037037045,1014.3518518518529,28.98148148148151,0
947,4,0,0,37,0.0,0.0,1.0,37,800,500,300,0.625,11,5,6,341.391547928618,0.7453078078078078,0.058103608603053525,0.1868735022379617,128686.69979100727,1386.51032789547,130073.21011890273,945,29,558.5675675675676,36,1,15,37.680355160932294,0.6070601851851851,46.340090090090094,1014.63963963964,28.184434434434444,0
948,4,2,2,37,0.05128205128205128,0.05128205128205128,0.9487179487179487,39,750,600,150,0.8,9,6,3,328.49183871955734,0.7584907782276203,0.0656717738568271,0.182292329170943,129229.25954380204,691.1786264241687,129920.4381702262,946,0,530.8717948717949,37,2,16,37.45585301412701,0.6106418918918919,45.80592105263158,1016.7763157894744,27.480440967283094,0
949,4,1,1,37,0.02631578947368421,0.02631578947368421,0.9736842105263158,38,1200,900,300,0.75,15,9,6,333.57968288094577,0.7580310573731627,0.07571182053494363,0.18498509687034284,129201.38888888908,1019.7916666666866,130221.18055555577,947,0,543.8157894736842,36,2,18,37.35484972677595,0.6122685185185185,45.83333333333334,1016.6666666666682,28.240740740740783,0
950,4,3,2,38,0.075,0.05,0.95,40,750,600,150,0.8,9,6,3,324.499966321408,0.7791132478632479,0.09499685501624944,0.18283550967158357,129826.69850107755,425.75185824385244,130252.4503593214,948,0,517.55,38,2,13,36.95137505678446,0.6148574561403508,45.2190170940171,1019.123931623932,26.819050832208735,0
951,4,1,0,39,0.02564102564102564,0.0,1.0,39,650,400,250,0.6153846153846154,9,4,5,329.2247549331824,0.7708614484930275,0.10774968003883667,0.1857083326370669,129871.1141889812,751.3571483533356,130622.47133733453,949,0,531.7948717948718,37,2,15,36.78598321858864,0.617117117117117,45.175438596491226,1019.298245614035,27.548601232811755,0
952,4,1,1,39,0.025,0.025,0.975,40,500,400,100,0.8,6,4,2,325.27613717281724,0.780448717948718,0.1138336299863889,0.18481334837225327,130153.54624379064,467.1685523047689,130620.7147960954,950,0,519.475,38,2,15,36.60066136181204,0.6181469298245614,44.89850427350427,1020.4059829059829,26.852789023841655,0
953,4,1,0,40,0.025,0.0,1.0,40,1250,900,350,0.72,16,9,7,323.0320699708453,0.7786057692307692,0.11438775510204047,0.18405315614617945,130262.58680555566,415.7986111111212,130678.38541666679,951,0,520.45,39,1,17,36.547619047619044,0.6175213675213675,44.79166666666667,1020.8333333333343,26.1752136752137,0
954,4,0,0,40,0.0,0.0,1.0,40,1400,900,500,0.6428571428571429,19,9,10,322.67464885805725,0.7784722222222222,0.11291588198367886,0.18423681563831007,130344.39718934908,411.7665187376703,130756.16370808675,952,1,521.45,38,2,17,36.474026993094796,0.6200657894736842,44.71153846153846,1021.1538461538458,26.87246963562752,0
955,4,0,0,40,0.0,0.0,1.0,40,700,300,400,0.42857142857142855,11,3,8,323.90273121833906,0.7773771367521367,0.11368842171321036,0.18532818750320398,130426.23325525968,449.0826347797496,130875.31589003943,953,2,522.45,38,2,17,36.359951887877834,0.6208881578947368,44.631410256410255,1021.4743589743588,26.88090418353576,0
956,4,1,0,41,0.024390243902439025,0.0,1.0,41,800,700,100,0.875,9,7,2,319.14907636061633,0.7839939024390243,0.12225184287087854,0.18397454390089063,130714.91021050338,143.50857204860193,130858.41878255198,954,0,510.6829268292683,39,2,14,36.189878951478725,0.6220619658119659,44.34895833333333,1022.6041666666658,26.220619658119638,0
957,4,1,2,40,0.023809523809523808,0.047619047619047616,0.9523809523809523,42,800,500,300,0.625,11,5,6,313.904752137224,0.7935056136275649,0.12225847637962795,0.18187691910367346,130911.78882444304,-181.23347544452474,130730.55534899852,955,0,499.5,40,2,14,36.1254551473022,0.6223958333333335,44.15650406504064,1023.3739837398367,25.58434959349592,0
958,4,0,1,39,0.0,0.025,0.975,40,750,600,150,0.8,9,6,3,330.759328229872,0.7751602564102564,0.13230407523510923,0.19045528105655068,130671.89554569352,644.1896778435121,131316.08522353703,956,2,525.375,38,2,14,35.93652037617555,0.6233552631578948,44.391025641025635,1022.4358974358967,26.906207827260438,0
959,4,0,0,39,0.0,0.0,1.0,39,1150,900,250,0.782608695652174,14,9,5,336.24856203054554,0.7730544309491678,0.125665215287857,0.19409199174634426,130766.77439212042,994.0279701446343,131760.80236226507,957,3,522.3846153846154,37,2,14,35.70031089193824,0.6261261261261262,44.298245614035075,1022.8070175438578,27.64343290659075,0
960,4,0,0,39,0.0,0.0,1.0,39,850,500,350,0.5882352941176471,12,5,7,337.3554946262877,0.7730544309491678,0.12387069820878382,0.19487240924883184,130794.81336805536,1024.869791666643,131819.68315972202,958,4,523.3846153846154,37,2,14,35.64366938221316,0.6264076576576578,44.27083333333332,1022.916666666665,27.64639639639635,0
961,4,0,1,38,0.0,0.02564102564102564,0.9743589743589743,39,600,200,400,0.3333333333333333,10,2,8,336.46237919146625,0.7733918128654971,0.1256272844697286,0.19449776938391405,130822.85534972268,1003.3938327177232,131826.2491824404,959,5,524.3846153846154,37,2,14,35.638174347981405,0.6266891891891893,44.24342105263156,1023.0263157894711,27.64935988620192,0
962,4,0,0,38,0.0,0.0,1.0,38,1450,1200,250,0.8275862068965517,17,12,5,345.5115734779803,0.762624466571835,0.12855563514938906,0.19987405406838368,130850.90033712266,1442.1000932979043,132293.00043042056,960,6,538.921052631579,37,1,14,35.37837584396099,0.6269707207207209,44.21600877192981,1023.1359649122783,27.65232337600752,0
963,4,0,0,38,0.0,0.0,1.0,38,1050,700,350,0.6666666666666666,14,7,7,343.27065960056086,0.7634542437174017,0.13446441352336835,0.19973860996944767,131075.36844269378,1398.8656365419956,132474.2340792358,961,7,539.921052631579,37,1,16,35.2088687225613,0.629222972972973,43.99671052631578,1024.0131578947357,27.67603129445232,0
964,4,0,0,38,0.0,0.0,1.0,38,1150,800,350,0.6956521739130435,15,8,7,342.6001266169233,0.7642543859649122,0.12863838392942673,0.19993210387144966,131187.67463305994,1388.9827879731984,132576.65742103313,962,8,540.921052631579,37,1,16,35.112628884369755,0.6303490990990992,43.88706140350876,1024.451754385963,27.68788525367468,0
965,4,0,0,38,0.0,0.0,1.0,38,1350,1200,150,0.8888888888888888,15,12,3,346.0850725820725,0.765024893314367,0.13223212626623826,0.2025583702833203,131300.0289151467,1488.1960074253311,132788.22492257203,963,9,541.921052631579,37,1,17,34.90993099390178,0.6314752252252254,43.77741228070174,1024.8903508771907,27.699739212897047,0
966,4,0,0,38,0.0,0.0,1.0,38,700,400,300,0.5714285714285714,10,4,6,346.3546830590259,0.7651730678046468,0.1302952503209247,0.20286488579171505,131328.12499999985,1497.2252279547415,132825.3502279546,964,10,542.921052631579,36,2,17,34.874661246612476,0.6336805555555556,43.74999999999999,1024.9999999999989,28.47222222222219,0
967,4,0,0,38,0.0,0.0,1.0,38,1050,600,450,0.5714285714285714,15,6,9,346.5553068620645,0.7651434329065908,0.13156160201668632,0.203135412644261,131356.983567182,1504.4919497199867,132861.475516902,965,11,543.921052631579,36,2,17,34.84039144604343,0.6339699074074074,43.721846846846844,1025.1126126126123,28.475350350350343,0
968,4,0,0,38,0.0,0.0,1.0,38,550,300,250,0.5454545454545454,8,3,5,348.58012913591824,0.7652027027027027,0.1334518338680304,0.20463069476354204,131414.71021274658,1561.7113312636975,132976.42154401029,966,12,544.921052631579,36,2,17,34.7302306425041,0.6345486111111112,43.66554054054054,1025.3378378378382,28.481606606606615,0
969,4,0,0,38,0.0,0.0,1.0,38,650,300,350,0.46153846153846156,10,3,7,366.5551268923951,0.7642840208629682,0.18045961404640232,0.20780392111395196,130066.7768568213,1935.3287790473937,132002.1056358687,967,13,545.921052631579,37,1,16,35.635794009101,0.6190878378378378,44.983552631578945,1020.065789473684,27.56934566145092,3
970,4,0,0,38,0.0,0.0,1.0,38,950,400,550,0.42105263157894735,15,4,11,368.85446367318036,0.763839497392129,0.18384856402773497,0.20955797551542224,130150.67737188366,2001.3316597414594,132152.00903162512,968,14,546.921052631579,37,1,16,35.49188695465291,0.6199324324324323,44.901315789473685,1020.3947368421054,27.578236130867715,0
971,4,0,0,38,0.0,0.0,1.0,38,950,800,150,0.8421052631578947,11,8,3,368.4036234563521,0.763809862494073,0.17627819145026558,0.20975347588716722,130234.60493853885,1995.7800717528535,132230.3850102917,969,15,547.921052631579,37,1,16,35.41812135209653,0.620777027027027,44.819078947368425,1020.7236842105269,27.587126600284513,0
972,4,2,1,39,0.05,0.025,0.975,40,500,200,300,0.4,8,2,6,353.1661313921486,0.7803952991452991,0.16863938646358467,0.20311954614244296,130626.62459843406,1226.5859447137495,131853.2105431478,970,0,521.475,37,3,16,35.40962762344024,0.6247184684684685,44.435307017543856,1022.258771929824,27.62861545756281,0
973,4,0,1,38,0.0,0.02564102564102564,0.9743589743589743,39,850,700,150,0.8235294117647058,10,7,3,361.35005957395146,0.7711426000899685,0.1734830825739917,0.20741630554292267,130550.14209733372,1634.860324851867,132185.0024221856,971,1,535.8461538461538,36,3,16,35.278007346189156,0.6258680555555556,44.51013513513513,1021.9594594594587,28.38776276276274,0
974,4,0,0,38,0.0,0.0,1.0,38,400,300,100,0.75,5,3,2,369.28969482346037,0.7648767188240873,0.17466065776060913,0.21185566703030076,130528.56445312488,2040.570746527763,132569.13519965264,972,2,549.5,35,3,16,35.097052327556916,0.6276785714285715,44.53124999999999,1021.8749999999991,29.196428571428545,0
975,4,0,0,38,0.0,0.0,1.0,38,1150,800,350,0.6956521739130435,15,8,7,364.82344893166953,0.7648174490279753,0.1697310456758636,0.21019015966367757,130694.03863322777,1936.0499857966006,132630.08861902438,973,3,550.5,36,2,16,35.043364537444944,0.6273148148148149,44.369369369369366,1022.5225225225221,28.40340340340339,0
976,4,0,0,38,0.0,0.0,1.0,38,1300,1200,100,0.9230769230769231,14,12,2,366.0684012577357,0.7650841631104789,0.1665585261999245,0.21169518939697804,130838.01442912493,1979.132553161252,132817.14698228618,974,4,551.5,36,2,16,34.86562098697486,0.6287615740740742,44.228603603603595,1023.0855855855845,28.419044044044014,0
977,4,0,0,38,0.0,0.0,1.0,38,700,500,200,0.7142857142857143,9,5,4,367.417049274405,0.7659435751541015,0.1672961293835511,0.21263384138262673,130866.81909950473,2016.540104293461,132883.3592037982,975,5,552.5,36,2,16,34.801938880328706,0.629050925925926,44.20045045045044,1023.1981981981968,28.422172172172132,0
978,4,1,1,38,0.02564102564102564,0.02564102564102564,0.9743589743589743,39,900,600,300,0.6666666666666666,12,6,6,359.4923165437585,0.7784525416104364,0.1555808068332154,0.20963653065866333,131159.59357686955,1630.1732263773192,132789.76680324686,976,0,539.3076923076923,37,2,18,34.708395775351455,0.6300675675675678,43.91447368421051,1024.3421052631559,27.684921763869077,0
979,4,2,1,39,0.05,0.025,0.975,40,650,500,150,0.7692307692307693,8,5,3,353.0542770106739,0.7805288461538461,0.16039193669126317,0.20724485526219757,131412.43128895407,1279.2523901584868,132691.68367911255,977,0,526.775,37,3,19,34.617843902612904,0.6326013513513514,43.667763157894726,1025.3289473684194,27.711593172119443,0
980,4,3,3,39,0.07142857142857142,0.07142857142857142,0.9285714285714286,42,1200,800,400,0.6666666666666666,16,8,8,343.31734632592133,0.8028455284552846,0.16365621278284936,0.19972665020669705,131067.83743142351,599.5724271267466,131667.40985855027,978,0,502.6190476190476,40,2,17,35.21528053460367,0.6239583333333332,44.004065040650424,1023.9837398374017,25.599593495935043,1
981,4,1,0,40,0.025,0.0,1.0,40,500,200,300,0.4,8,2,6,358.5073480306341,0.7805288461538461,0.17320403048971533,0.20745769619875415,130863.1260158704,1383.0784525896722,132246.20446846006,979,0,528.725,38,2,18,35.033587414291176,0.6252741228070176,44.20405982905983,1023.1837606837605,26.92588843904633,0
982,4,0,0,40,0.0,0.0,1.0,40,850,500,350,0.5882352941176471,12,5,7,358.1433573530125,0.7801549145299145,0.1758243435782616,0.20774006076450435,130954.69292534741,1380.1106770833526,132334.80360243077,980,1,529.725,39,1,18,34.950217111065896,0.624465811965812,44.11458333333334,1023.5416666666681,26.24465811965816,0
983,4,0,0,40,0.0,0.0,1.0,40,650,500,150,0.7692307692307693,8,5,3,357.3069832121339,0.7802884615384615,0.17438434924188417,0.20739844796371204,130981.34901258704,1360.1101345486359,132341.45914713567,981,2,530.725,39,1,18,34.94464655201656,0.6247329059829059,44.08854166666668,1023.6458333333353,26.24732905982911,0
984,4,0,0,40,0.0,0.0,1.0,40,1200,1000,200,0.8333333333333334,14,10,4,358.29933112249955,0.7796207264957264,0.17491863303498745,0.20869662462064098,131114.67013888908,1395.659722222242,132510.32986111133,982,3,531.725,39,1,18,34.78437754271766,0.6260683760683761,43.95833333333334,1024.1666666666683,26.260683760683804,0
985,4,0,0,40,0.0,0.0,1.0,40,1300,700,600,0.5384615384615384,19,7,12,359.73901275759823,0.7786324786324786,0.17890871200569292,0.21026456734976195,131248.05908203125,1443.0094401041667,132691.0685221354,983,4,532.725,39,1,19,34.612623259123716,0.6274038461538461,43.828125,1024.6875,26.27403846153846,0
986,4,0,0,40,0.0,0.0,1.0,40,1350,1000,350,0.7407407407407407,17,10,7,365.89375323458455,0.77946047008547,0.1769979681679652,0.21480800264447844,131417.1157648532,1617.0380015431915,133034.1537663964,984,5,533.725,35,5,19,34.28399085675584,0.6366071428571429,43.663194444444436,1025.3472222222208,29.295634920634882,0
987,4,0,1,39,0.0,0.025,0.975,40,1100,900,200,0.8181818181818182,13,9,4,365.7523876819505,0.779193376068376,0.17685571538377043,0.2150359583356694,131472.44953991135,1617.2724667234547,133089.7220066348,985,6,534.725,36,4,19,34.23168075839095,0.6351273148148149,43.60923423423422,1025.5630630630617,28.487862862862826,0
988,4,0,0,39,0.0,0.0,1.0,39,750,500,250,0.6666666666666666,10,5,5,371.32347708310806,0.7781713900134953,0.17024582619049644,0.21864160004848246,131530.20154867676,1968.0503560993077,133498.25190477606,986,7,532.8974358974359,36,3,19,34.030446078969504,0.6357060185185188,43.55292792792791,1025.788288288286,28.494119119119052,0
989,4,1,1,39,0.025,0.025,0.975,40,550,400,150,0.7272727272727273,7,4,3,364.70597289894476,0.7840010683760684,0.16276294714362005,0.2163059807598864,131806.21831957865,1614.1030172744927,133420.32133685314,987,0,520.55,37,3,16,33.9214050542801,0.636542792792793,43.28399122807015,1026.8640350877156,27.753082029397717,0
990,4,0,0,39,0.0,0.0,1.0,39,550,300,250,0.5454545454545454,8,3,5,376.56434579697924,0.7769905533063428,0.1437473774935074,0.2112684828404394,129659.75265806359,1966.3735152234701,131626.12617328705,988,9,534.8974358974359,36,3,15,35.794910069290864,0.6168981481481481,45.38288288288289,1018.4684684684694,28.290790790790815,8
991,4,1,0,40,0.025,0.0,1.0,40,750,600,150,0.8,9,6,3,369.38858317081383,0.7806623931623932,0.14764709045928814,0.20851279039095663,129899.05698147505,1596.6457227223746,131495.70270419744,989,0,522.5,37,3,16,35.73408536803985,0.6173986486486487,45.14802631578947,1019.407894736842,27.55156472261735,0
992,4,1,1,40,0.024390243902439025,0.024390243902439025,0.975609756097561,41,600,600,0,1.0,6,6,0,365.2823336267502,0.7865345528455284,0.15161715358964356,0.20827579965699136,130290.57167830481,1319.0767832409947,131609.64846154582,990,0,510.7317073170732,37,4,17,35.4409435076791,0.6213400900900901,44.76425438596491,1020.9429824561399,27.593053579895674,0
993,4,0,0,40,0.0,0.0,1.0,40,550,200,350,0.36363636363636365,9,2,7,372.4517902266122,0.7821848290598291,0.165395358831113,0.2119059451973905,130206.6260772546,1699.1381963681197,131905.7642736227,991,1,524.225,37,3,17,35.34325311559949,0.6204954954954955,44.84649122807018,1020.6140350877198,27.584163110478915,0
994,4,0,1,39,0.0,0.025,0.975,40,600,400,200,0.6666666666666666,8,4,4,375.0785377277101,0.7822382478632479,0.16194165655674442,0.2140237320061138,130320.07250071019,1776.0644689572405,132096.13696966742,992,2,525.225,36,4,17,35.160931583397655,0.6235532407407407,44.73536036036036,1021.0585585585586,28.36273773773774,0
995,4,0,0,39,0.0,0.0,1.0,39,850,700,150,0.8235294117647058,10,7,3,381.76761757219845,0.7749662618083671,0.16393405543256723,0.21816323401148507,130377.57087746532,2154.786923748078,132532.3578012134,993,3,539.1282051282051,36,3,17,34.93172712904767,0.6241319444444444,44.679054054054056,1021.283783783784,28.368993993994,0
996,4,1,1,39,0.025,0.025,0.975,40,1000,700,300,0.7,13,7,6,390.0536681404292,0.7885416666666667,0.11357042583060384,0.21763568898592614,129443.56575963719,2120.427620463817,131563.99338010102,994,0,526.625,34,6,14,35.67208703790361,0.6188725490196079,45.595238095238095,1017.6190476190477,29.929971988795522,5
997,4,1,1,39,0.025,0.025,0.975,40,1250,1000,250,0.8,15,10,5,392.04111630751373,0.7842681623931624,0.10483861536662409,0.2192507250193297,129534.44054705225,2156.5653344671323,131691.00588151938,995,0,527.6,34,6,14,35.52873932873349,0.6197916666666666,45.50595238095239,1017.9761904761912,29.94047619047621,0
998,4,0,0,39,0.0,0.0,1.0,39,650,200,450,0.3076923076923077,11,2,9,403.674211082816,0.7756972559604138,0.1063691788818264,0.22491968459124434,129388.34372597089,2646.1475153787137,132034.4912413496,996,6,542.1282051282051,33,6,19,35.38203645707862,0.620580808080808,45.649509803921575,1017.4019607843146,30.830362448009534,0
999,4,1,1,39,0.025,0.025,0.975,40,1200,900,300,0.75,15,9,6,391.23894374162177,0.7856303418803419,0.10212759913646163,0.2197379670625409,129701.96926708258,2148.8922914523428,131850.8615585349,997,0,529.55,35,5,16,35.378200393894645,0.619345238095238,45.34143518518519,1018.63425925926,29.103835978836003,0
1000,4,1,0,40,0.025,0.0,1.0,40,850,600,250,0.7058823529411765,11,6,5,392.8746542049283,0.7831997863247864,0.12397260273972588,0.22171454924333006,129889.23890106338,2206.037963639332,132095.2768647027,998,0,530.525,36,4,17,35.14554794520548,0.6192129629629629,45.157657657657666,1019.3693693693706,28.31581581581585,0
1001,4,2,0,42,0.047619047619047616,0.0,1.0,42,900,700,200,0.7777777777777778,11,7,4,379.2834225457229,0.796433410762679,0.1257871307163092,0.2169265200237204,130410.3186755188,1494.1017933716846,131904.4204688905,999,0,506.2142857142857,35,7,19,34.96187440982059,0.6264880952380951,44.64699074074075,1021.4120370370381,29.18320105820109,0
1002,4,0,0,42,0.0,0.0,1.0,42,1050,700,350,0.6666666666666666,14,7,7,377.3081680820219,0.7942315137437088,0.12516069788797024,0.21657632038863717,130550.142097334,1451.5269915185645,132001.66908885256,1000,1,507.2142857142857,36,6,14,34.87029384756658,0.6258680555555556,44.510135135135144,1021.959459459461,28.387762762762804,0
1003,4,0,2,40,0.0,0.047619047619047616,0.9523809523809523,42,1100,900,200,0.8181818181818182,13,9,4,378.94513006442253,0.7945460704607046,0.1305825701066945,0.21800151398763182,130636.47050766999,1500.8108615372316,132137.28136920722,1001,2,508.2142857142857,36,6,14,34.74081111845487,0.626736111111111,44.425675675675684,1022.2972972972985,28.39714714714718,0
1004,4,1,1,40,0.024390243902439025,0.024390243902439025,0.975609756097561,41,1100,800,300,0.7272727272727273,14,8,6,383.15307347601095,0.7909044715447154,0.13217089554443606,0.22091511493559723,130722.82745160707,1817.3706223115037,132540.19807391858,1002,0,519.439024390244,36,5,15,34.54557133942664,0.6276041666666666,44.34121621621622,1022.6351351351356,28.40653153153154,0
1005,4,0,0,40,0.0,0.0,1.0,40,1350,1000,350,0.7407407407407407,17,10,7,391.0547461879577,0.7840811965811966,0.136236273066908,0.22502844124288132,130646.86381440748,2218.0152338391495,132864.87904824663,1003,4,533.425,35,5,15,34.42075644363938,0.6288690476190477,44.41550925925925,1022.3379629629621,29.20965608465606,0
1006,4,1,1,40,0.024390243902439025,0.024390243902439025,0.975609756097561,41,1250,800,450,0.64,17,8,9,385.99741882191057,0.7914126016260162,0.13008309000343532,0.22372095294984187,130924.43795146483,1907.299021994951,132831.73697345977,1004,0,521.390243902439,36,5,15,34.268174149061025,0.6296296296296298,44.144144144144136,1023.4234234234223,28.428428428428397,0
1007,4,0,0,40,0.0,0.0,1.0,40,550,200,350,0.36363636363636365,9,2,7,393.37763366447876,0.784107905982906,0.13457904266153697,0.22705931735421256,130765.21675936619,2288.0223068844043,133053.2390662506,1005,6,535.425,35,5,15,34.241093319754064,0.6300595238095239,44.299768518518505,1022.800925925924,29.222883597883545,0
1008,4,1,0,41,0.024390243902439025,0.0,1.0,41,900,500,400,0.5555555555555556,13,5,8,382.4243576371941,0.7917682926829268,0.13514260046393733,0.22281547294748752,131126.20380092927,1829.1708515948303,132955.3746525241,1006,0,523.3414634146342,36,5,16,34.15498442367601,0.6316550925925927,43.94707207207207,1024.2117117117114,28.450325325325316,0
1009,4,1,0,42,0.023809523809523808,0.0,1.0,42,1200,900,300,0.75,15,9,6,373.1639107849225,0.7975464576074333,0.1423290879812622,0.21955923122926835,131501.32395909418,1414.4650140004871,132915.78897309466,1007,0,511.85714285714283,36,6,18,34.012452422778516,0.6354166666666667,43.58108108108108,1025.6756756756754,28.490990990990984,0
1010,4,1,1,42,0.023255813953488372,0.023255813953488372,0.9767441860465116,43,900,600,300,0.6666666666666666,12,6,6,367.22751990272053,0.7999723145071982,0.1464192404359097,0.21764041116259936,131778.07113727278,1078.5068482609795,132856.57798553378,1008,0,500.93023255813955,37,6,17,33.88509184109354,0.6362612612612613,43.31140350877192,1026.7543859649106,27.75011853959218,0
1011,4,0,1,41,0.0,0.023809523809523808,0.9761904761904762,42,600,400,200,0.6666666666666666,8,4,4,376.3279430386876,0.7946912504839334,0.15856996594162043,0.22276659277536862,131732.4334469605,1514.9191421150924,133247.3525890756,1009,2,513.8571428571429,36,6,17,33.69761956998683,0.6377314814814815,43.35585585585586,1026.5765765765768,28.516016016016025,0
1012,4,1,0,42,0.023809523809523808,0.0,1.0,42,700,300,400,0.42857142857142855,11,3,8,380.87814134944404,0.8001355013550135,0.14887993413926082,0.212479734691898,129436.83556241432,1619.9233423864366,131056.75890480075,1010,0,514.3571428571429,35,7,17,35.91238246891113,0.6166666666666667,45.601851851851855,1017.592592592593,29.074074074074083,8
1013,4,0,0,42,0.0,0.0,1.0,42,1000,500,500,0.5,15,5,10,382.8274773418951,0.7990708478513356,0.1470604156178783,0.21436876627477103,129584.09857521013,1521.670712234235,131105.76928744436,1011,1,515.3571428571429,35,7,17,35.712577204349984,0.6181547619047618,45.45717592592593,1018.1712962962969,29.090608465608483,0
1014,4,1,0,43,0.023255813953488372,0.0,1.0,43,1450,1200,250,0.8275862068965517,17,12,5,375.7818424189129,0.8060631229235881,0.14696749836271872,0.2125362013181298,129975.3485537904,1168.475189716758,131143.82374350715,1012,0,504.3488372093023,36,7,18,35.49351187189399,0.6200810185185185,45.073198198198206,1019.7072072072083,28.32520020020023,0
1015,4,2,1,44,0.044444444444444446,0.022222222222222223,0.9777777777777777,45,900,700,200,0.7777777777777778,11,7,4,365.3472396626622,0.8132996632996633,0.12445746982066885,0.20801713514523681,130235.32238476147,530.5469757566084,130765.86936051807,1013,0,482.8888888888889,38,7,16,35.49538587677064,0.6189692982456141,44.81837606837607,1020.7264957264956,26.861223571749886,2
1016,4,0,1,43,0.0,0.022727272727272728,0.9772727272727273,44,1200,600,600,0.5,18,6,12,370.87697039922045,0.8068402043692742,0.12693322260759077,0.21055583950974677,130122.70752779716,851.9031096106623,130974.61063740782,1014,1,494.8636363636364,37,7,17,35.46872201325452,0.6196509009009008,44.928728070175445,1020.2850877192994,27.575272641062146,0
1017,4,0,1,42,0.0,0.023255813953488372,0.9767441860465116,43,1050,700,350,0.6666666666666666,14,7,7,372.70347998288344,0.8026024363233665,0.16389113051133397,0.20583101594873537,129038.51290269564,1018.62056213018,130057.13346482582,1015,2,505.9767441860465,38,5,16,36.52668243953732,0.6069078947368421,45.993589743589745,1016.0256410256414,26.737516869095828,5
1018,4,2,2,42,0.045454545454545456,0.045454545454545456,0.9545454545454546,44,1200,1000,200,0.8333333333333334,14,10,4,366.4145044203859,0.8117952783650458,0.1664526262520174,0.2038943598238745,129337.19735051863,678.3077425304964,130015.50509304913,1016,0,495.3636363636364,38,6,16,36.38185764800617,0.6099232456140351,45.699786324786324,1017.2008547008544,26.768443544759325,0
1019,4,0,0,42,0.0,0.0,1.0,42,1000,500,500,0.5,15,5,10,379.05525480192995,0.7951751838946961,0.1614470148831999,0.20975899443337842,129117.79495854494,1388.5557334949212,130506.35069203986,1017,4,519.952380952381,37,5,16,36.28436634660338,0.6095157657657657,45.915570175438596,1016.3377192982457,27.468587008060695,0
1020,4,1,1,42,0.023255813953488372,0.023255813953488372,0.9767441860465116,43,800,500,300,0.625,11,5,6,367.87008573007995,0.8025562938353635,0.16232467942454187,0.20544946665142044,129480.23069598363,926.4077648892221,130406.63846087285,1018,0,508.83720930232556,37,6,15,36.19909502262443,0.6131756756756757,45.5592105263158,1017.7631578947389,27.507112375533485,0
1021,4,1,1,42,0.023255813953488372,0.023255813953488372,0.9767441860465116,43,1250,900,350,0.72,16,9,7,372.2563091686138,0.8016334440753045,0.1580814203981844,0.20819443218803707,129536.03512619282,1044.1212680825024,130580.15639427531,1019,0,509.8139534883721,37,6,15,36.03062616688209,0.6137387387387387,45.50438596491229,1017.9824561403519,27.513039355144645,0
1022,4,1,0,43,0.023255813953488372,0.0,1.0,43,1300,900,400,0.6923076923076923,17,9,8,373.68088565393225,0.8051864156515319,0.1725114877514038,0.21018418822617083,129759.37307633134,1097.7194906125133,130857.09256694384,1020,0,510.7906976744186,37,6,16,35.76687831826663,0.6159909909909909,45.285087719298254,1018.8596491228083,27.536747273589413,0
1023,4,2,1,44,0.044444444444444446,0.022222222222222223,0.9777777777777777,45,1150,800,350,0.6956521739130435,15,8,7,356.9961582284813,0.8160353535353536,0.17255996186622946,0.2036902856232598,130317.12420784964,305.5163960579695,130622.64060390761,1021,0,489.0444444444444,38,7,17,35.62550137769873,0.6197916666666665,44.73824786324788,1021.0470085470107,26.869658119658176,0
1024,4,0,1,43,0.0,0.022727272727272728,0.9772727272727273,44,900,600,300,0.6666666666666666,12,6,6,362.2965632674022,0.8095489781536294,0.15430719785986935,0.2046045276802117,129917.22140842033,613.7125651041861,130530.93397352452,1022,1,501.15909090909093,39,5,14,35.896363373182126,0.6140491452991452,45.13020833333334,1019.4791666666682,26.140491452991494,1
1025,4,0,0,43,0.0,0.0,1.0,43,1250,900,350,0.72,16,9,7,369.55243694156246,0.8045404208194905,0.15715772565403152,0.2085097457634209,129881.14458917743,999.578699137991,130880.72328831542,1023,3,513.7906976744187,38,5,14,35.748130873772844,0.6154057017543859,45.16559829059829,1019.3376068376068,26.82467386414755,0
1026,4,2,1,44,0.044444444444444446,0.022222222222222223,0.9777777777777777,45,1150,800,350,0.6956521739130435,15,8,7,357.4907018858903,0.818392255892256,0.1535337050636929,0.20424468772082,130368.94531250012,321.6964522152963,130690.64176471542,1024,0,491.9111111111111,39,6,18,35.560315517475864,0.6185897435897435,44.68750000000001,1021.2500000000009,26.18589743589746,0
1027,4,1,1,44,0.022222222222222223,0.022222222222222223,0.9777777777777777,45,600,200,400,0.3333333333333333,10,2,8,357.4907018858903,0.8195707070707071,0.1535337050636929,0.20424468772082,130368.94531250012,321.1371527777916,130690.08246527791,1025,0,492.8888888888889,39,6,18,35.560315517475864,0.6185897435897435,44.68750000000001,1021.2500000000009,26.18589743589746,0
1028,4,0,1,43,0.0,0.022727272727272728,0.9772727272727273,44,800,400,400,0.5,12,4,8,388.4486477969683,0.812632135306554,0.15616763310490267,0.2109007111822692,128360.96871803999,1187.9973484640907,129548.96606650409,1026,2,505.09090909090907,38,6,18,36.82041820418204,0.6000548245614036,46.66132478632478,1013.3547008547005,26.66722896986054,6
1029,4,0,0,43,0.0,0.0,1.0,43,1200,700,500,0.5833333333333334,17,7,10,397.3194261157646,0.8042635658914729,0.1730133929133042,0.21589791038142334,128394.44739006227,1602.7216306940502,129997.16902075632,1027,3,517.3720930232558,37,6,13,36.56133921165566,0.6021959459459459,46.628289473684205,1013.4868421052628,27.39153627311521,0
1030,4,2,3,42,0.044444444444444446,0.06666666666666667,0.9333333333333333,45,950,800,150,0.8421052631578947,11,8,3,380.3192511924782,0.8221801346801347,0.1568917162596617,0.20893976449390628,128830.99500868066,799.3815104166766,129630.37651909734,1028,0,495.3333333333333,39,6,14,36.54533483822423,0.6030982905982906,46.19791666666667,1015.2083333333343,26.03098290598293,0
1031,4,2,1,43,0.045454545454545456,0.022727272727272728,0.9772727272727273,44,1200,700,500,0.5833333333333334,17,7,10,384.18824055180556,0.8129184284707541,0.17383279459862688,0.2115928977222168,128929.98598327115,1106.6768938563716,130036.66287712753,1029,0,507.20454545454544,38,6,15,36.345904341117894,0.605811403508772,46.100427350427346,1015.5982905982899,26.726270805218153,0
1032,4,0,0,43,0.0,0.0,1.0,43,850,600,250,0.7058823529411765,11,6,5,393.6387584615594,0.8067091177556294,0.18042974774801945,0.2161511047352974,128811.51532202197,1541.0409933825567,130352.55631540452,1030,1,520.0,37,6,16,36.22722690285878,0.606418918918919,46.21710526315788,1015.1315789473668,27.435988620199105,0
1033,4,2,1,44,0.044444444444444446,0.022222222222222223,0.9777777777777777,45,1650,1200,450,0.7272727272727273,21,12,9,380.45740176029005,0.820496632996633,0.1860796916705567,0.2126301059928219,129508.13140822177,855.6436836334245,130363.77509185519,1031,0,497.84444444444443,37,8,14,35.85036715860533,0.6134572072072071,45.531798245614034,1017.8728070175439,27.510075865339026,0
1034,4,0,0,44,0.0,0.0,1.0,44,1550,1200,350,0.7741935483870968,19,12,7,393.29210392356447,0.8131826990838619,0.1969831053901847,0.2200099393235785,129545.08562616698,1389.8118557747262,130934.8974819417,1032,1,510.15909090909093,36,8,15,35.4860342920354,0.6157407407407407,45.49549549549551,1018.0180180180203,28.27827827827834,0
1035,4,0,0,44,0.0,0.0,1.0,44,1000,800,200,0.8,12,8,4,390.7409834296207,0.8132707892882312,0.1999025184410983,0.21954303950958734,129717.10519641294,1337.1578504180184,131054.26304683097,1033,2,511.15909090909093,36,8,16,35.37544218439089,0.6174768518518517,45.32657657657659,1018.6936936936962,28.297047047047116,0
1036,4,0,0,44,0.0,0.0,1.0,44,1000,700,300,0.7,13,7,6,390.8472139889003,0.8136892177589853,0.20266177076321812,0.2200856527309004,129803.15778193779,1346.6405172064433,131149.79829914423,1034,3,512.1590909090909,36,8,16,35.28497624046856,0.6183449074074072,45.24211711711714,1019.0315315315352,28.306431431431534,0
1037,4,1,0,45,0.022222222222222223,0.0,1.0,45,1100,900,200,0.8181818181818182,13,9,4,381.084036767367,0.8215909090909091,0.2103897282337459,0.21653707796827917,130156.27170138911,920.0954861111329,131076.36718750023,1035,0,501.75555555555553,39,6,17,35.17422077038247,0.6164529914529913,44.89583333333334,1020.4166666666684,26.16452991452996,0
1038,4,0,0,45,0.0,0.0,1.0,45,800,500,300,0.625,11,5,6,381.5630544094188,0.8215488215488216,0.2058742146923409,0.2171053894949763,130209.42382812529,936.6210937500309,131146.04492187532,1036,1,502.75555555555553,39,6,17,35.107930189834676,0.6169871794871793,44.843750000000014,1020.6250000000023,26.169871794871852,0
1039,4,0,0,45,0.0,0.0,1.0,45,850,500,350,0.5882352941176471,12,5,7,379.6135061657494,0.8199074074074074,0.20389430464243463,0.216620333207907,130321.66950660154,894.4165809327886,131216.08608753432,1037,2,503.75555555555553,35,10,19,35.043546436937966,0.6255952380952381,44.7337962962963,1021.0648148148151,29.17328042328043,0
1040,4,0,0,45,0.0,0.0,1.0,45,1050,800,250,0.7619047619047619,13,8,5,381.7129024460341,0.8195286195286196,0.201011548305718,0.21877960605766716,130492.60567577725,962.1422520493616,131454.7479278266,1038,3,504.75555555555553,36,9,13,34.81621293949082,0.6252893518518519,44.56644144144145,1021.7342342342351,28.381506506506533,0
1041,4,0,0,45,0.0,0.0,1.0,45,1200,700,500,0.5833333333333334,17,7,10,369.359138577762,0.8188973063973064,0.1979988789906144,0.21151315882784355,130458.54403518411,637.2110889889441,131095.75512417304,1039,4,505.75555555555553,37,8,20,35.16634020249723,0.6230292792792791,44.5997807017544,1021.6008771929842,27.610834518729302,2
1042,4,1,1,45,0.021739130434782608,0.021739130434782608,0.9782608695652174,46,1050,600,450,0.5714285714285714,15,6,9,361.5395894183348,0.8226247987117553,0.2017154224517319,0.20862076488859108,130753.83434007263,254.5375164365887,131008.37185650921,1040,0,495.7391304347826,38,8,15,35.06672411992062,0.6241776315789471,44.31089743589745,1022.7564102564128,26.914642375168757,0
1043,4,1,1,45,0.021739130434782608,0.021739130434782608,0.9782608695652174,46,1100,600,500,0.5454545454545454,16,6,10,362.61930214282603,0.8235507246376812,0.203228412939072,0.20998595380435278,130890.45606874168,292.6811673606951,131183.13723610237,1041,0,496.7173913043478,38,8,16,34.90072736131413,0.6255482456140349,44.17735042735045,1023.2905982906012,26.928699955015823,0
1044,4,0,0,45,0.0,0.0,1.0,45,850,600,250,0.7058823529411765,11,6,5,368.54833022925885,0.8164141414141415,0.2030323602625026,0.21289085899125446,130794.81336805574,640.8420138889094,131435.65538194464,1042,7,508.75555555555553,37,8,16,34.84597759674134,0.6264076576576575,44.27083333333334,1022.9166666666681,27.646396396396437,0
1045,4,0,1,44,0.0,0.022222222222222223,0.9777777777777777,45,1150,700,450,0.6086956521739131,16,7,9,356.28621545313746,0.8155723905723906,0.13742379547689287,0.21033368773370503,131629.44614517112,379.5514418511034,132008.99758702223,1043,8,509.75555555555553,38,7,16,34.31589449939267,0.6329495614035088,43.45619658119657,1026.1752136752123,27.004610886189795,2
1046,4,1,0,45,0.022222222222222223,0.0,1.0,45,1300,900,400,0.6923076923076923,17,9,8,352.49038042644986,0.8139309764309764,0.14793551742069733,0.2095977122943916,131903.67408366187,298.95525147927157,132202.62933514113,1044,0,510.4222222222222,38,7,17,34.13676547061883,0.6356907894736843,43.189102564102555,1027.2435897435882,27.0327260458839,0
1047,4,0,0,45,0.0,0.0,1.0,45,1350,900,450,0.6666666666666666,18,9,9,350.1995994301909,0.8142676767676769,0.14144059869036463,0.2091415484865218,132068.34781804736,250.0565006574612,132318.40431870482,1045,1,511.4222222222222,38,7,17,34.029726639642426,0.6373355263157894,43.02884615384615,1027.8846153846155,27.049595141700408,0
1048,4,0,0,45,0.0,0.0,1.0,45,1800,1400,400,0.7777777777777778,22,14,8,350.9770870052879,0.8138468013468014,0.14780309423347426,0.21069293216882753,132264.0313042533,284.32888454859193,132548.3601888019,1046,2,512.4222222222222,39,6,18,33.812763713080166,0.6375534188034189,42.83854166666666,1028.645833333332,26.375534188034152,0
1049,4,0,0,45,0.0,0.0,1.0,45,1500,1100,400,0.7333333333333333,19,11,8,354.78564568845786,0.8120370370370371,0.15932672845424545,0.21389677945263671,132426.216780644,396.71979900064605,132822.93657964465,1047,3,513.4222222222222,37,8,18,33.55160949540143,0.6427364864864864,42.680921052631575,1029.2763157894733,27.8182788051209,0
1050,4,1,1,45,0.021739130434782608,0.021739130434782608,0.9782608695652174,46,1100,600,500,0.5454545454545454,16,6,10,349.4399551093359,0.8174919484702093,0.1547704374873209,0.21237229785945486,132728.07004026973,76.09816732413913,132804.16820759387,1048,0,503.2391304347826,38,8,18,33.385821669258675,0.6439144736842104,42.38782051282052,1030.4487179487191,27.117071524966292,0
1051,4,0,0,45,0.0,0.0,1.0,45,1200,1000,200,0.8333333333333334,14,10,4,353.5010214859002,0.811952861952862,0.15423333924664417,0.2144055582220808,132652.03145438977,378.5257242613055,133030.55717865107,1049,5,515.4222222222222,37,8,18,33.35761486606352,0.6449887387387387,42.46162280701754,1030.1535087719294,27.84198672356566,0
1052,4,0,0,45,0.0,0.0,1.0,45,1850,1500,350,0.8108108108108109,22,15,7,352.07965116521,0.80993265993266,0.16485656221938694,0.21499721036088532,132906.30290089257,358.7209526007979,133265.02385349336,1050,6,516.4222222222222,37,8,19,33.1388239047214,0.6475225225225225,42.21491228070175,1031.1403508771928,27.86865813181602,0
1053,4,1,1,45,0.021739130434782608,0.021739130434782608,0.9782608695652174,46,1350,1000,350,0.7407407407407407,17,10,7,348.2052853356211,0.8190217391304349,0.16179275842211305,0.21460815545175016,133251.5158156184,79.77641719628849,133331.29223281468,1051,0,506.17391304347825,38,8,19,32.892478959713024,0.6491228070175439,41.88034188034188,1032.4786324786326,27.170490328385068,0
1054,4,0,1,44,0.0,0.022222222222222223,0.9777777777777777,45,1050,600,450,0.5714285714285714,15,6,9,352.5575526472004,0.8106060606060607,0.1639765336355159,0.21676187087316126,133160.81781173064,389.3704072407044,133550.18821897134,1052,8,518.4222222222222,37,8,19,32.871095824922996,0.6500563063063062,41.96820175438597,1032.127192982457,27.895329540066406,0
1055,4,0,0,44,0.0,0.0,1.0,44,1450,1200,250,0.8275862068965517,17,12,5,350.43694104776847,0.8106060606060607,0.17566913274199103,0.21143329065272848,132454.43309479856,483.3852723915157,132937.81836719008,1053,9,517.5,37,7,18,33.635137054395656,0.6430180180180181,42.65350877192983,1029.385964912282,27.821242294926538,3
1056,4,0,0,44,0.0,0.0,1.0,44,1300,900,400,0.6923076923076923,17,9,8,349.6849540132472,0.8105179704016914,0.17383737255395593,0.21113775133314316,132482.65241468523,465.4380434364399,132948.09045812167,1054,10,518.5,37,7,18,33.6261183299606,0.6432995495495495,42.62609649122807,1029.4956140350873,27.82420578473209,0
1057,4,0,0,44,0.0,0.0,1.0,44,1400,700,700,0.5,21,7,14,350.7082982025716,0.808557963354475,0.17574822496082354,0.2131925347029602,132736.76155163115,510.37675053861386,133247.13830216977,1055,11,519.5,37,7,16,33.344417251897575,0.6458333333333334,42.379385964912274,1030.48245614035,27.85087719298243,0
1058,4,0,1,43,0.0,0.022727272727272728,0.9772727272727273,44,1100,700,400,0.6363636363636364,15,7,8,352.85617017402416,0.8071264975334743,0.1667778615768405,0.21514615512167168,132849.7770948754,575.372710834111,133425.14980570952,1056,12,520.5,37,7,17,33.17556548252146,0.6469594594594594,42.26973684210527,1030.9210526315794,27.862731152204848,0
1059,4,0,0,43,0.0,0.0,1.0,43,800,700,100,0.875,9,7,2,357.3172094639498,0.8036175710594315,0.17144207389113797,0.21759976169151937,132803.9541864501,890.6276631361309,133694.58184958625,1057,13,532.4651162790698,36,7,17,33.10663170545176,0.6484375,42.3141891891892,1030.7432432432445,28.63175675675679,0
1060,4,0,0,43,0.0,0.0,1.0,43,1600,1300,300,0.8125,19,13,6,355.0870092074251,0.8032484311554079,0.17302721004374377,0.21782064906400708,133075.95245652506,850.7083910433931,133926.66084756845,1058,14,533.4651162790698,37,6,17,32.89098476797733,0.6492117117117117,42.050438596491226,1031.7982456140348,27.88643907064959,0
1061,4,0,0,43,0.0,0.0,1.0,43,1050,500,550,0.47619047619047616,16,5,11,359.6412568055198,0.8014950166112956,0.17266328998183345,0.22182085175656352,133279.09412895396,986.5321836876428,134265.6263126416,1059,15,534.4651162790698,38,5,17,32.569624073116046,0.6493969298245613,41.853632478632484,1032.5854700854707,27.17330184435449,0
1062,4,0,0,43,0.0,0.0,1.0,43,1300,700,600,0.5384615384615384,19,7,12,362.9444897758395,0.8000645994832041,0.16930809744835362,0.224690986948295,133417.02849915996,1084.5950672072506,134501.62356636723,1060,16,535.4651162790698,38,5,17,32.34595829024474,0.6507675438596492,41.72008547008547,1033.1196581196584,27.18735942420154,0
1063,4,0,0,43,0.0,0.0,1.0,43,1300,1000,300,0.7692307692307693,16,10,6,361.67378184457425,0.7969730527870063,0.17042460346389787,0.22496310720304583,133591.84777949253,1063.368004825457,134655.215784318,1061,17,536.4651162790698,35,8,17,32.20350052246604,0.6583333333333332,41.55092592592593,1033.7962962962968,29.53703703703705,0
1064,4,0,0,43,0.0,0.0,1.0,43,950,700,250,0.7368421052631579,12,7,5,361.3439740865522,0.7960040605389442,0.16355297579703665,0.22526963435416214,133675.94103816652,1060.5991548981447,134736.54019306466,1062,18,537.4651162790698,36,7,18,32.12775418345495,0.6571180555555556,41.4695945945946,1034.1216216216214,28.725600600600597,0
1065,4,0,0,43,0.0,0.0,1.0,43,1100,900,200,0.8181818181818182,13,9,4,361.00548506471654,0.7968346253229974,0.16181854085337166,0.22559159087105346,133763.2966581446,1057.856758785816,134821.1534169304,1063,19,538.4651162790698,36,7,17,32.048996661586486,0.6579861111111112,41.38513513513514,1034.4594594594594,28.734984984984983,0
1066,4,1,0,44,0.022727272727272728,0.0,1.0,44,1150,900,250,0.782608695652174,14,9,5,355.0227640441626,0.8038451374207188,0.17176510306281312,0.2237705250093699,134080.10651800703,720.2980038717081,134800.40452187875,1064,0,527.2045454545455,38,6,18,31.8867770442198,0.6573464912280702,41.07905982905982,1035.6837606837596,27.25483580746736,0
1067,4,0,0,44,0.0,0.0,1.0,44,1650,1000,650,0.6060606060606061,23,10,13,355.38960245527517,0.8041534531360113,0.1802949061662198,0.22467851138274184,134190.77932098764,738.001543209874,134928.78086419753,1065,1,528.2045454545455,38,6,18,31.766644325290436,0.6584429824561404,40.97222222222222,1036.111111111111,27.26608187134503,0
1068,4,0,0,44,0.0,0.0,1.0,44,650,400,250,0.6153846153846154,9,4,5,357.59458791191685,0.8027660324171952,0.18185800080574888,0.2269287303145407,134329.18453000573,807.0778773102393,135136.26240731598,1066,2,529.2045454545455,38,6,18,31.571206499708,0.6598135964912281,40.83867521367521,1036.6452991452984,27.280139451192063,0
1069,4,0,0,44,0.0,0.0,1.0,44,1200,800,400,0.6666666666666666,16,8,8,359.9125968076978,0.8019732205778718,0.1823402980042521,0.22909321817785702,134439.96006145436,877.3270280882332,135317.2870895426,1067,3,530.2045454545455,38,6,19,31.400449847189318,0.6609100877192983,40.7318376068376,1037.0726495726487,27.291385515069702,0
1070,4,0,0,44,0.0,0.0,1.0,44,750,500,250,0.6666666666666666,10,5,5,358.1324169170983,0.8010482734319944,0.17948770622768806,0.22814615964450083,134469.73876953125,831.5945095486111,135301.33327907987,1068,4,531.2045454545455,39,5,19,31.416863345719918,0.6594551282051282,40.703125,1037.1875,26.59455128205128,0
1071,4,0,0,44,0.0,0.0,1.0,44,1000,800,200,0.8,12,8,4,354.0508213684804,0.8008500704721635,0.1879768574565721,0.22198642761142207,133886.53897518083,680.5522329316684,134567.09120811248,1069,5,532.2045454545455,38,6,16,32.10552802725301,0.6554276315789473,41.26602564102564,1034.9358974358977,27.235155195681518,1
1072,4,0,0,44,0.0,0.0,1.0,44,1300,1100,200,0.8461538461538461,15,11,4,353.95471420069714,0.7982293868921776,0.19366197183098577,0.22267783918702092,134010.95920138893,686.7621527777832,134697.72135416672,1070,6,533.2045454545455,39,5,16,31.983568075117372,0.65491452991453,41.145833333333336,1035.416666666667,26.549145299145305,0
1073,4,0,1,43,0.0,0.022727272727272728,0.9772727272727273,44,800,500,300,0.625,11,5,6,355.4295967372369,0.7986918604651163,0.18990910005395478,0.22376983034609718,134037.9245334202,728.2090928819551,134766.13362630218,1071,7,534.2045454545455,39,5,16,31.918422861549807,0.6551816239316239,41.11979166666667,1035.520833333334,26.551816239316256,0
1074,4,0,0,43,0.0,0.0,1.0,43,1600,1500,100,0.9375,17,15,2,362.96637586505767,0.7909283868586194,0.18986806982505344,0.22774729594434445,133914.18292059313,1121.2691303236163,135035.45205091673,1072,28,547.4651162790698,38,5,16,31.8471734792183,0.6557017543859649,41.23931623931624,1035.0427350427346,27.237966711650913,0
1075,4,0,0,43,0.0,0.0,1.0,43,1150,900,250,0.782608695652174,14,9,5,361.258171021115,0.7912052417866371,0.19253596217684255,0.22743935896902567,134037.92453342056,1084.4590928819835,135122.38362630256,1073,29,548.4651162790698,39,4,16,31.767532609060112,0.6551816239316237,41.119791666666686,1035.5208333333367,26.551816239316324,0
1076,4,0,0,43,0.0,0.0,1.0,43,1200,700,500,0.5833333333333334,17,7,10,359.48553916072706,0.7898671096345514,0.18938681562364024,0.22648955832293732,134064.89257812512,1038.8780381944584,135103.77061631958,1074,30,549.4651162790698,39,4,16,31.786444712666807,0.6554487179487178,41.09375000000001,1035.625000000001,26.554487179487204,0
1077,4,0,0,43,0.0,0.0,1.0,43,1300,800,500,0.6153846153846154,18,8,10,362.70606790783324,0.7871447028423773,0.1909225421743912,0.22969845128039698,134253.74484592033,1138.9295789930748,135392.6744249134,1075,31,550.4651162790698,39,4,16,31.51415971454417,0.657318376068376,40.91145833333334,1036.3541666666683,26.573183760683804,0
1078,4,0,0,43,0.0,0.0,1.0,43,1350,1000,350,0.7407407407407407,17,10,7,366.4279312153308,0.7866832779623477,0.18382722250125538,0.23308562653345818,134415.72401258684,1250.7351345486159,135666.45914713547,1076,32,551.4651162790698,39,4,16,31.255755064456714,0.6589209401709402,40.755208333333336,1036.979166666667,26.58920940170941,0
1079,4,0,0,43,0.0,0.0,1.0,43,1000,400,600,0.4,16,4,12,363.6839952329502,0.7868217054263565,0.18638744433572985,0.23202619529307836,134523.76437717024,1184.828016493066,135708.5923936633,1077,33,552.4651162790698,39,4,17,31.218935134049595,0.6599893162393162,40.65104166666667,1037.3958333333342,26.599893162393183,0
1080,4,0,0,43,0.0,0.0,1.0,43,1400,1100,300,0.7857142857142857,17,11,6,364.698524976352,0.7875599852344038,0.18420347161718387,0.23373422616558276,134689.37194097444,1224.205768046531,135913.57770902096,1078,34,553.4651162790698,38,5,18,31.027214560175658,0.6633771929824561,40.49145299145299,1038.0341880341875,27.316689158794407,0
1081,4,0,0,43,0.0,0.0,1.0,43,1100,700,400,0.6363636363636364,15,7,8,365.2758725803995,0.7881136950904393,0.1831036462819411,0.23482020380168528,134800.29585798807,1247.8591387245128,136048.15499671258,1079,35,554.4651162790698,38,5,15,30.90149176954733,0.6644736842105263,40.38461538461538,1038.4615384615377,27.327935222672043,0
1082,4,0,0,43,0.0,0.0,1.0,43,1300,900,400,0.6923076923076923,17,9,8,371.3434963038287,0.7858527131782945,0.19339598958545023,0.2400038663486605,134994.52257515152,1425.867598984575,136420.3901741361,1080,36,555.4651162790698,38,5,17,30.55005825708508,0.6663925438596492,40.19764957264957,1039.2094017094012,27.347615834457926,0
1083,4,0,0,43,0.0,0.0,1.0,43,1250,1000,250,0.8,15,10,5,371.4247688620503,0.7854374307862679,0.19042520136714525,0.24061005333074217,135077.80540032138,1434.248529841468,136512.05393016283,1081,37,556.4651162790698,38,5,17,30.464842411784844,0.6672149122807018,40.11752136752136,1039.529914529914,27.35605038236616,0
1084,4,0,0,43,0.0,0.0,1.0,43,800,400,400,0.5,12,4,8,372.3216920117561,0.784422296050203,0.1947363895205516,0.2423077535712872,135244.44809701218,1470.8883501351384,136715.33644714733,1082,38,557.4651162790698,38,5,17,30.275309846617358,0.668859649122807,39.957264957264954,1040.17094017094,27.37291947818263,0
1085,4,0,0,43,0.0,0.0,1.0,43,1250,900,350,0.72,16,9,7,371.3330977456384,0.7831303063861204,0.1966290525833434,0.2431632865882727,135466.79815910573,1460.6611604207635,136927.4593195265,1083,39,558.4651162790698,38,5,18,30.0794078407225,0.6710526315789473,39.74358974358974,1041.02564102564,27.395411605937895,0
1086,4,0,0,43,0.0,0.0,1.0,43,1400,900,500,0.6428571428571429,19,9,10,370.3616282047488,0.7825304540420819,0.19868377724433195,0.2429033935722396,135522.41421031478,1438.4603970341088,136960.87460734887,1084,40,559.4651162790698,38,5,19,30.04929372734113,0.6716008771929824,39.69017094017094,1041.2393162393157,27.40103463787673,0
1087,4,0,0,43,0.0,0.0,1.0,43,1350,900,450,0.6666666666666666,18,9,9,366.4739364031047,0.7829457364341085,0.15501354193460481,0.2356780084734612,134813.78971877298,1310.8879314505755,136124.67765022354,1085,41,560.4651162790698,36,7,13,30.856918238993714,0.6684027777777777,40.37162162162163,1038.5135135135147,28.84759759759763,5
1088,4,0,0,43,0.0,0.0,1.0,43,1350,1000,350,0.7407407407407407,17,10,7,364.70129771951287,0.7831764488741233,0.1498668791222093,0.23491653422938472,134872.27091956834,1237.6184461488697,136109.88936571722,1086,42,561.4651162790698,36,7,13,30.844581165076633,0.6689814814814814,40.315315315315324,1038.7387387387398,28.853853853853884,0
1089,4,0,1,42,0.0,0.023255813953488372,0.9767441860465116,43,1500,1200,300,0.8,18,12,6,368.7182807391968,0.7820690291620523,0.15298728132492112,0.23819653350820516,134977.72301333104,1353.7507935133904,136331.4738068444,1087,43,562.4651162790698,37,6,14,30.635024269283512,0.6680743243243243,40.213815789473685,1039.1447368421054,28.08499288762447,0
1090,4,1,0,43,0.023255813953488372,0.0,1.0,43,750,400,350,0.5333333333333333,11,4,7,358.9120161996144,0.7880675526024363,0.14021796503865613,0.23376095663783605,135272.2318672841,1110.1658950617464,136382.39776234585,1088,0,538.6279069767442,38,5,15,30.596350689808645,0.6691337719298245,39.930555555555564,1040.277777777779,27.37573099415208,0
1091,4,0,0,43,0.0,0.0,1.0,43,1000,700,300,0.7,13,7,6,361.7119890874209,0.7871447028423773,0.14260924360721705,0.2366796447064301,135438.99441385426,1197.9816138870685,136636.97602774133,1089,1,539.6279069767442,38,5,16,30.3574788737213,0.6707785087719298,39.77029914529915,1040.918803418804,27.392600089968525,0
1092,4,0,0,43,0.0,0.0,1.0,43,1250,1000,250,0.8,15,10,5,370.87999999999994,0.7867294204503507,0.14604651162790705,0.2440000000000001,135633.6805555557,1472.8401910293142,137106.520746585,1090,2,540.6279069767442,36,7,19,29.925000000000004,0.6765046296296295,39.58333333333334,1041.6666666666679,28.93518518518522,1
1093,4,0,0,43,0.0,0.0,1.0,43,950,800,150,0.8421052631578947,11,8,3,369.640765317888,0.7858527131782945,0.1462629139917515,0.24360662485407808,135695.6916099774,1431.7318594104354,137127.42346938784,1091,3,541.6279069767442,34,9,20,29.895547684338812,0.6813725490196079,39.523809523809526,1041.9047619047624,30.644257703081248,0
1094,4,0,0,43,0.0,0.0,1.0,43,1200,800,400,0.6666666666666666,16,8,8,367.13254898688456,0.7844684385382059,0.15041135367119574,0.24276033305256117,135814.58574459888,1372.3910108024825,137186.97675540135,1092,4,542.6279069767442,35,8,20,29.842604930046626,0.6803571428571428,39.40972222222223,1042.361111111112,29.781746031746057,0
1095,4,0,0,43,0.0,0.0,1.0,43,1800,1500,300,0.8333333333333334,21,15,6,370.08799629787904,0.7835917312661499,0.159229554392593,0.24596113736257255,135995.6114969135,1466.0686728394985,137461.680169753,1093,5,543.6279069767442,35,8,15,29.585552596537962,0.6821428571428572,39.23611111111111,1043.055555555555,29.801587301587286,0
1096,4,0,0,43,0.0,0.0,1.0,43,1300,1000,300,0.7692307692307693,16,10,6,368.09089675831467,0.7837301587301587,0.15685485431257984,0.24525790349417625,136086.16958429775,1418.4160397376431,137504.5856240354,1094,6,544.6279069767442,35,8,15,29.547628951747082,0.6830357142857142,39.14930555555555,1043.4027777777771,29.81150793650792,0
1097,4,0,0,43,0.0,0.0,1.0,43,1150,700,450,0.6086956521739131,16,7,9,368.3685691973606,0.7822535991140642,0.16533398880349925,0.24678564838135322,136279.62421881352,1440.2260368476705,137719.85025566118,1095,7,545.6279069767442,36,7,18,29.34821685360943,0.6828703703703703,38.96396396396397,1044.144144144145,29.004004004004027,0
1098,4,0,1,42,0.0,0.023255813953488372,0.9767441860465116,43,800,500,300,0.625,11,5,6,368.3685691973606,0.7822535991140642,0.16533398880349925,0.24678564838135322,136279.62421881352,1440.2260368476705,137719.85025566118,1096,8,546.6279069767442,36,7,18,29.34821685360943,0.6828703703703703,38.96396396396397,1044.144144144145,29.004004004004027,0
1099,4,0,0,42,0.0,0.0,1.0,42,1400,900,500,0.6428571428571429,19,9,10,365.5269867168631,0.7771002710027101,0.16624062581807575,0.2459023825795752,136426.64359883545,1573.5239885155588,138000.167587351,1097,9,557.0714285714286,36,6,19,29.276481261902198,0.6843171296296295,38.823198198198206,1044.7072072072083,29.019644644644675,0
1100,4,0,0,42,0.0,0.0,1.0,42,1650,900,750,0.5454545454545454,24,9,15,366.6288581398318,0.7750677506775068,0.17008836472803757,0.24770183590694647,136577.61432604262,1614.6589575638654,138192.27328360648,1098,10,558.0714285714286,37,5,20,29.09793611664744,0.6838400900900901,38.67872807017544,1045.2850877192982,28.250948316737787,0
1101,4,0,0,42,0.0,0.0,1.0,42,1250,1000,250,0.8,15,10,5,370.31158235583575,0.7746080139372822,0.1727376209447924,0.25121137073328303,136720.92013888885,1726.0183421822057,138446.93848107106,1099,11,559.0714285714286,35,7,21,28.859561752988043,0.6892857142857143,38.541666666666664,1045.833333333333,29.880952380952372,0
1102,4,0,0,42,0.0,0.0,1.0,42,850,600,250,0.7058823529411765,11,6,5,370.3926105419167,0.7750193573364305,0.16938564736506545,0.2514829467668894,136751.1831945515,1730.325547625156,138481.50874217667,1100,12,560.0714285714286,35,7,21,28.82743628047655,0.6895833333333334,38.512731481481474,1045.9490740740732,29.884259259259235,0
1103,4,0,0,42,0.0,0.0,1.0,42,1450,1100,350,0.7586206896551724,18,11,7,369.35732597243674,0.7739305071622145,0.16413850132465324,0.2516472934526601,136872.26890700017,1710.9550486539783,138583.22395565413,1101,13,561.0714285714286,35,7,21,28.734491944106473,0.6907738095238095,38.39699074074074,1046.4120370370372,29.897486772486776,0
1104,4,0,0,42,0.0,0.0,1.0,42,1050,1000,50,0.9523809523809523,11,10,1,365.9593853632651,0.7710753000387147,0.16553983107710124,0.2503549967418894,137015.51371895548,1628.4226371641962,138643.93635611967,1102,14,562.0714285714286,36,6,17,28.68151912803413,0.6901041666666667,38.26013513513514,1046.9594594594598,29.08220720720722,0
1105,4,0,0,42,0.0,0.0,1.0,42,950,400,550,0.42105263157894735,15,4,11,369.3146030698045,0.768970189701897,0.17141730912962916,0.25371967782535615,137162.92939899364,1731.2545653761965,138894.18396436985,1103,15,563.0714285714286,36,6,19,28.447735254067222,0.6915509259259259,38.11936936936937,1047.522522522523,29.097847847847863,0
1106,4,0,0,42,0.0,0.0,1.0,42,1450,1000,450,0.6896551724137931,19,10,9,366.3023334415566,0.7683168795973674,0.16617831728756793,0.252189128124461,137237.44325176996,1654.0791397353232,138891.52239150528,1104,16,564.0714285714286,37,5,19,28.452891725966236,0.6903153153153152,38.048245614035096,1047.807017543861,28.319108582266516,0
1107,4,0,0,42,0.0,0.0,1.0,42,750,200,550,0.26666666666666666,13,2,11,366.3555424408807,0.7667682926829268,0.15194768808973502,0.24452819445668306,136148.14774738366,1578.1302900892424,137726.2780374729,1105,17,565.0714285714286,37,5,14,29.531326609231627,0.6796171171171171,39.089912280701746,1043.6403508771918,28.206495969653833,2
1108,4,0,0,42,0.0,0.0,1.0,42,1000,800,200,0.8,12,8,4,365.8242708848247,0.7670586527293844,0.1511604641856743,0.24456791143423653,136205.3708833486,1565.446098799618,137770.81698214822,1106,18,566.0714285714286,37,5,15,29.488357843137262,0.6801801801801801,39.03508771929824,1043.859649122806,28.21242294926503,0
1109,4,0,0,42,0.0,0.0,1.0,42,850,600,250,0.7058823529411765,11,6,5,365.8242708848247,0.7670586527293844,0.1511604641856743,0.24456791143423653,136205.3708833486,1565.446098799618,137770.81698214822,1107,19,567.0714285714286,37,5,15,29.488357843137262,0.6801801801801801,39.03508771929824,1043.859649122806,28.21242294926503,0
1110,4,0,0,42,0.0,0.0,1.0,42,700,200,500,0.2857142857142857,12,2,10,365.1059054333274,0.7653164924506388,0.15377532228360957,0.24475618104974894,136302.2374260354,1552.9503616041961,137855.1877876396,1108,20,568.0714285714286,38,4,15,29.410937180274196,0.6792763157894738,38.942307692307686,1044.2307692307684,27.47975708502022,0
1111,4,0,0,42,0.0,0.0,1.0,42,1000,600,400,0.6,14,6,8,363.48065532679306,0.7649051490514905,0.1558219259385878,0.2444901067922474,136421.49658203128,1517.3149956597226,137938.811577691,1109,21,569.0714285714286,39,3,15,29.335032572207254,0.6786858974358976,38.828125,1044.6875000000002,26.78685897435898,0
1112,4,0,0,42,0.0,0.0,1.0,42,1300,900,400,0.6923076923076923,17,9,8,364.4060516770287,0.7632839721254355,0.15988903285823453,0.2458699338584822,136530.33989800356,1550.4964192708387,138080.8363172744,1110,22,570.0714285714286,39,3,16,29.202901259178052,0.6797542735042735,38.723958333333336,1045.1041666666672,26.79754273504275,0
1113,4,0,0,42,0.0,0.0,1.0,42,1500,1200,300,0.8,18,12,6,367.134665490909,0.7624370886566009,0.15810956317978953,0.24886326177334453,136693.68625216992,1636.9981553819202,138330.68440755183,1111,23,571.0714285714286,39,3,16,28.969622638376993,0.6813568376068377,38.56770833333332,1045.729166666665,26.813568376068332,0
1114,4,0,0,42,0.0,0.0,1.0,42,850,500,350,0.5882352941176471,12,5,7,366.7955658471098,0.7619047619047619,0.147230829877796,0.24984511669371642,136864.3010950484,1640.249178232716,138504.55027328111,1112,24,572.0714285714286,37,5,19,28.809402179608085,0.6866554054054055,38.40460526315789,1046.3815789473679,28.280583214793726,0
1115,4,0,0,42,0.0,0.0,1.0,42,950,500,450,0.5263157894736842,14,5,9,369.2080974255393,0.7599690282617112,0.14705354337776622,0.2527288976570948,137036.4574316135,1718.9939452523734,138755.45137686588,1113,25,573.0714285714286,37,5,13,28.575745278737728,0.6883445945945947,38.24013157894736,1047.0394736842097,28.29836415362729,0
1116,4,0,0,42,0.0,0.0,1.0,42,1000,600,400,0.6,14,6,8,370.04141108200304,0.7580816879597367,0.14801275821684,0.2545533249019826,137208.72197454987,1754.5818184441366,138963.303792994,1114,26,574.0714285714286,37,5,13,28.38337257980115,0.6900337837837838,38.07565789473684,1047.6973684210527,28.316145092460886,0
1117,4,0,1,41,0.0,0.023809523809523808,0.9761904761904762,42,1200,700,500,0.5833333333333334,17,7,10,368.3178238790765,0.7572348044909021,0.1410164442385391,0.25420578183827364,137323.62511782465,1715.747754116645,139039.3728719413,1115,27,575.0714285714286,37,5,14,28.314829828782656,0.6911599099099099,37.96600877192982,1048.13596491228,28.327999051683246,0
1118,4,0,0,41,0.0,0.0,1.0,41,1150,600,550,0.5217391304347826,17,6,11,366.3378290036125,0.7572154471544715,0.13885589029112255,0.2535429798195663,137420.15144459042,1868.4399883117703,139288.59143290218,1116,28,576.609756097561,38,3,14,28.271262142517493,0.6902412280701755,37.87393162393162,1048.5042735042725,27.592217723796647,0
1119,4,0,0,41,0.0,0.0,1.0,41,1000,600,400,0.6,14,6,8,372.812993085013,0.75625,0.1481746439829199,0.25906941111831133,137560.21172337263,2056.846852399717,139617.05857577236,1117,29,577.609756097561,38,3,15,27.96300539769833,0.6916118421052633,37.740384615384606,1049.0384615384603,27.60627530364369,0
1120,4,0,0,41,0.0,0.0,1.0,41,500,300,200,0.6,7,3,4,374.3663847763979,0.7542174796747968,0.15465445706070624,0.26099368329727163,137672.31131063256,2107.977093834459,139780.28840446702,1118,30,578.609756097561,38,3,15,27.8114289592453,0.6927083333333334,37.633547008547005,1049.4658119658116,27.617521367521356,0
1121,4,0,0,41,0.0,0.0,1.0,41,500,200,300,0.4,8,2,6,377.14072606491476,0.7539126016260163,0.15973189350214123,0.2633551978385066,137728.37822567386,2188.596112754765,139916.97433842864,1119,31,579.609756097561,38,3,15,27.683206106870223,0.6932565789473684,37.580128205128204,1049.6794871794868,27.62314439946018,0
1122,4,0,0,41,0.0,0.0,1.0,41,1150,700,450,0.6086956521739131,16,7,9,374.83141218064515,0.7538617886178862,0.12810399772820458,0.25195189705707727,136397.23338203077,2025.2448854579902,138422.47826748877,1120,32,580.609756097561,36,5,14,29.062679675147322,0.6840277777777778,38.851351351351354,1044.5945945945953,29.016516516516536,3
1123,4,0,0,41,0.0,0.0,1.0,41,850,500,350,0.5882352941176471,12,5,7,375.3893279400892,0.7532520325203252,0.13018821791106783,0.2525371135098045,136426.6435988352,2042.621210737751,138469.26480957295,1121,33,581.609756097561,36,5,14,29.01889978800618,0.6843171296296298,38.82319819819819,1044.7072072072062,29.019644644644618,0
1124,4,0,0,41,0.0,0.0,1.0,41,1050,500,550,0.47619047619047616,16,5,11,376.0548268430441,0.7532012195121951,0.13118692178301083,0.2536183715918203,136514.89327164993,2067.416910153383,138582.3101818033,1122,34,582.609756097561,36,5,14,28.913882902298848,0.6851851851851853,38.73873873873873,1045.0450450450442,29.029029029029005,0
1125,4,0,0,41,0.0,0.0,1.0,41,900,700,200,0.7777777777777778,11,7,4,375.94093898901315,0.7535569105691057,0.13151967959718358,0.25375329852778405,136544.31617005516,2066.519686916642,138610.8358569718,1123,35,583.609756097561,36,5,15,28.887646805301156,0.6854745370370371,38.710585585585584,1045.1576576576574,29.03215715715715,0
1126,4,0,0,41,0.0,0.0,1.0,41,1350,1000,350,0.7407407407407407,17,10,7,374.41591056448556,0.7528963414634147,0.1298518403690987,0.2531466058099139,136603.17147806578,2029.2801669913015,138632.45164505707,1124,36,584.609756097561,36,5,15,28.869079679701244,0.6860532407407408,38.65427927927927,1045.3828828828819,29.038413413413384,0
1127,4,0,0,41,0.0,0.0,1.0,41,1150,900,250,0.782608695652174,14,9,5,371.26394819129854,0.7515243902439024,0.1304052084345546,0.25185743512436737,136720.92013888885,1951.9604486242952,138672.88058751315,1125,37,585.609756097561,35,6,16,28.834661354581673,0.6892857142857143,38.541666666666664,1045.833333333333,29.880952380952372,0
1128,4,0,0,41,0.0,0.0,1.0,41,1200,800,400,0.6666666666666666,16,8,8,369.19527547649744,0.7511686991869919,0.13317213499641056,0.2508862330644047,136781.449599194,1899.81299296981,138681.2625921638,1126,38,586.609756097561,35,6,16,28.828741609500618,0.6898809523809524,38.48379629629629,1046.064814814814,29.887566137566118,0
1129,4,0,0,41,0.0,0.0,1.0,41,950,900,50,0.9473684210526315,10,9,1,368.0436995849322,0.7502540650406504,0.13749190589251037,0.2505357714042008,136841.99245541837,1872.7666323731096,138714.75908779146,1127,39,587.609756097561,35,6,17,28.79885693215339,0.6904761904761905,38.425925925925924,1046.296296296296,29.89417989417989,0
1130,4,0,0,41,0.0,0.0,1.0,41,1000,800,200,0.8,12,8,4,368.0436995849322,0.7502540650406504,0.13749190589251037,0.2505357714042008,136841.99245541837,1872.7666323731096,138714.75908779146,1128,40,588.609756097561,35,6,17,28.79885693215339,0.6904761904761905,38.425925925925924,1046.296296296296,29.89417989417989,0
1131,4,0,0,41,0.0,0.0,1.0,41,750,500,250,0.6666666666666666,10,5,5,358.5110505764925,0.7505081300813008,0.09910818463360993,0.24621538937147563,137151.28843730732,1634.0505011156947,138785.33893842302,1129,41,589.609756097561,37,4,14,28.74217087127952,0.6894707207207209,38.130482456140335,1047.4780701754362,28.310218112849626,4
1132,4,0,0,41,0.0,0.0,1.0,41,900,500,400,0.5555555555555556,13,5,8,359.4310542194863,0.751270325203252,0.10648441755142546,0.24736423499863125,137224.18690417465,1664.5268326758448,138888.7137368505,1130,42,590.609756097561,38,3,14,28.645992658305286,0.6883223684210528,38.060897435897424,1047.7564102564083,27.572537112010746,0
1133,4,0,0,41,0.0,0.0,1.0,41,1050,700,350,0.6666666666666666,14,7,7,359.6414007284264,0.7507621951219512,0.1095857711559074,0.2479074138963549,137280.1625050221,1674.325987106416,138954.48849212853,1131,43,591.609756097561,38,3,14,28.58514289597988,0.6888706140350878,38.00747863247862,1047.970085470084,27.57816014394958,0
1134,4,0,1,40,0.0,0.024390243902439025,0.975609756097561,41,850,600,250,0.7058823529411765,11,6,5,362.9786327194001,0.750609756097561,0.11501276566124163,0.25061107428641993,137336.14952014363,1770.017555153745,139106.1670752974,1132,44,592.609756097561,38,3,14,28.44235212176809,0.689418859649123,37.954059829059815,1048.1837606837585,27.58378317588838,0
1135,4,0,0,40,0.0,0.0,1.0,40,900,700,200,0.7777777777777778,11,7,4,365.7580522584314,0.7457799145299145,0.12778300899769857,0.2522305529210739,137294.89482340703,2043.3426631270936,139338.2374865341,1133,45,605.375,37,3,14,28.410319453163133,0.6908783783783785,37.99342105263157,1048.0263157894722,28.325035561877627,0
1136,4,0,0,40,0.0,0.0,1.0,40,1050,600,450,0.5714285714285714,15,6,9,366.4580775360579,0.7455929487179487,0.1272853258027402,0.2533409746436908,137381.0947238571,2068.8823724607264,139449.97709631783,1134,46,606.375,37,3,15,28.306727852735065,0.691722972972973,37.9111842105263,1048.3552631578928,28.3339260312944,0
1137,4,0,0,40,0.0,0.0,1.0,40,1150,700,450,0.6086956521739131,16,7,9,365.1860166408924,0.7448183760683761,0.1269866164784612,0.2530897871850356,137467.32167590005,2040.228724222813,139507.55040012285,1135,47,607.375,37,3,15,28.25482712951346,0.6925675675675678,37.82894736842104,1048.684210526314,28.34281650071119,0
1138,4,0,1,39,0.0,0.025,0.975,40,1300,1000,300,0.7692307692307693,16,10,6,370.96420165540445,0.7448183760683761,0.13631131669535268,0.2535649425432823,136986.04009414816,2163.8162257769427,139149.8563199251,1136,48,608.375,36,4,15,28.57972066838783,0.6898148148148149,38.288288288288285,1046.8468468468466,29.079079079079072,1
1139,4,0,0,39,0.0,0.0,1.0,39,500,300,200,0.6,7,3,4,371.6631661624435,0.7434772829509672,0.13535377585786645,0.25431656589300006,137023.70139960552,2385.3325402949135,139409.03393990043,1137,49,607.5641025641025,35,4,15,28.524117473653185,0.6922619047619047,38.25231481481481,1046.9907407407397,29.914021164021136,0
1140,4,0,0,39,0.0,0.0,1.0,39,1200,900,300,0.75,15,9,6,372.1558390422456,0.7431399010346379,0.1304063299422933,0.2557617691094429,137175.21761670514,2410.111641589501,139585.32925829463,1138,50,608.5641025641025,35,4,16,28.361161750082864,0.69375,38.107638888888886,1047.5694444444437,29.930555555555532,0
1141,4,0,0,39,0.0,0.0,1.0,39,800,300,500,0.375,13,3,10,368.24776984217976,0.7422402159244265,0.12825610439924562,0.25373784689125506,137266.16753472204,2309.592013888864,139575.75954861092,1139,51,609.5641025641025,37,2,16,28.37350894632205,0.6905968468468469,38.02083333333332,1047.9166666666652,28.322072072072032,0
1142,4,0,0,39,0.0,0.0,1.0,39,1100,600,500,0.5454545454545454,16,6,10,365.47326599863277,0.7417341430499326,0.12462412922712107,0.25224252344266623,137323.62511782456,2237.622754116631,139561.2478719412,1140,52,610.5641025641025,37,2,16,28.389366914251827,0.6911599099099099,37.966008771929815,1048.1359649122794,28.32799905168323,0
1143,4,0,0,39,0.0,0.0,1.0,39,900,500,400,0.5555555555555556,13,5,8,363.93414267704486,0.741846603688709,0.12001383537512367,0.2520131938030831,137438.57635282003,2203.718091143417,139642.29444396344,1141,53,611.5641025641025,37,2,17,28.3160575481892,0.6922860360360361,37.8563596491228,1048.5745614035081,28.339853010905625,0
1144,4,0,0,39,0.0,0.0,1.0,39,700,400,300,0.5714285714285714,10,4,6,363.6073586278953,0.741340530814215,0.12003345880384786,0.25199570854472375,137467.3216759002,2196.8259464450502,139664.14762234525,1142,54,612.5641025641025,37,2,17,28.296214972814706,0.6925675675675675,37.82894736842105,1048.6842105263152,28.34281650071122,0
1145,4,0,0,39,0.0,0.0,1.0,39,650,400,250,0.6153846153846154,9,4,5,364.1543143393783,0.7393162393162394,0.12681412869559594,0.25300394519134584,137553.575679536,2218.145607302243,139771.72128683826,1143,55,613.5641025641025,37,2,17,28.196643845162182,0.6934121621621622,37.74671052631579,1049.0131578947369,28.351706970128024,0
1146,4,0,0,39,0.0,0.0,1.0,39,1250,1000,250,0.8,15,10,5,365.885205967359,0.7398223121907332,0.1268708303191055,0.2548414425842523,137639.85673476462,2272.077466143432,139911.93420090806,1144,56,614.5641025641025,37,2,18,28.066004876349698,0.6942567567567568,37.66447368421053,1049.3421052631584,28.360597439544822,0
1147,4,0,0,39,0.0,0.0,1.0,39,700,500,200,0.7142857142857143,9,5,4,367.9409351240186,0.7392037786774629,0.1328125837110381,0.25670048330955564,137697.3924669128,2332.9014696829713,140030.2939365958,1145,57,615.5641025641025,37,2,18,27.955234015879658,0.6948198198198199,37.609649122807014,1049.5614035087713,28.36652441915598,0
1148,4,0,0,39,0.0,0.0,1.0,39,1250,1100,150,0.88,14,11,3,368.8551514342046,0.7375168690958165,0.12660789051911592,0.2588647101148854,137901.196699233,2378.415470479088,140279.61216971208,1146,58,616.5641025641025,36,3,20,27.72997748472178,0.6987847222222222,37.41554054054054,1050.3378378378377,29.176051051051047,1
1149,4,0,0,39,0.0,0.0,1.0,39,600,400,200,0.6666666666666666,8,4,4,368.8551514342046,0.7375168690958165,0.12660789051911592,0.2588647101148854,137901.196699233,2373.1133582907228,140274.31005752372,1147,59,617.5641025641025,36,3,20,27.72997748472178,0.6987847222222222,37.41554054054054,1050.3378378378377,29.176051051051047,0
1150,4,0,1,38,0.0,0.02564102564102564,0.9743589743589743,39,1250,1100,150,0.88,14,11,3,368.6023776409679,0.7357737291947819,0.12190410239922644,0.2595795310013487,138019.50335047877,2374.863419162399,140394.36676964117,1148,60,618.5641025641025,36,3,20,27.61985139141928,0.6999421296296298,37.302927927927925,1050.7882882882877,29.188563563563548,0
1151,4,0,0,38,0.0,0.0,1.0,38,1250,900,350,0.72,16,9,7,374.7680361151949,0.7338786154575628,0.12292972214653797,0.2639657874235728,138025.2556611154,2745.4907996827815,140770.74646079817,1149,61,606.3947368421053,35,3,20,27.452201967911293,0.7020833333333334,37.2974537037037,1050.8101851851852,30.02314814814815,0
1152,4,0,0,38,0.0,0.0,1.0,38,1150,700,450,0.6086956521739131,16,7,9,370.5948437205152,0.7319819819819819,0.11695681140109504,0.26242043298525947,138207.748266568,2643.8157739626113,140851.56404053062,1150,62,607.3947368421053,35,3,17,27.381787745367813,0.7038690476190477,37.12384259259259,1051.504629629629,30.042989417989403,0
1153,4,0,0,38,0.0,0.0,1.0,38,850,700,150,0.8235294117647058,10,7,3,372.5551317256434,0.7321597913703177,0.12444481762222681,0.264750085399091,138329.47698313193,2707.071303798018,141036.54828692996,1151,63,608.3947368421053,35,3,17,27.210203726115815,0.7050595238095239,37.008101851851855,1051.967592592593,30.056216931216944,0
1154,4,0,0,38,0.0,0.0,1.0,38,850,500,350,0.5882352941176471,12,5,7,370.71503905233084,0.731359649122807,0.12375251811887833,0.2641489917761593,138420.80868484228,2662.935099451306,141083.7437842936,1152,64,609.3947368421053,35,3,17,27.16857310456078,0.7059523809523809,36.9212962962963,1052.314814814815,30.06613756613757,0
1155,4,0,0,38,0.0,0.0,1.0,38,1150,900,250,0.782608695652174,14,9,5,370.5221887702965,0.7298779042200095,0.1185111366349123,0.2648043899560194,138522.87253469694,2665.1595852609485,141188.0321199579,1153,65,610.3947368421053,36,2,17,27.073081586079027,0.704861111111111,36.82432432432433,1052.7027027027034,29.241741741741762,0
1156,4,0,0,38,0.0,0.0,1.0,38,700,500,200,0.7142857142857143,9,5,4,368.56623661023616,0.7299668089141773,0.11572022901407952,0.26363624683007636,138552.5110203109,2613.155511930857,141165.66653224174,1154,66,611.3947368421053,36,2,17,27.095366705886548,0.7051504629629629,36.796171171171174,1052.8153153153157,29.24486986986988,0
1157,4,0,0,38,0.0,0.0,1.0,38,800,700,100,0.875,9,7,2,379.71586631886686,0.7292259364627786,0.10426117595243345,0.26228928338210755,137352.35841797487,2830.9739535241724,140183.33237149904,1155,67,612.3947368421053,37,1,16,27.987709205020927,0.6914414414414414,37.938596491228076,1048.2456140350885,28.330962541488876,4
1158,4,0,0,38,0.0,0.0,1.0,38,550,200,350,0.36363636363636365,9,2,7,377.5134411096286,0.7288406827880513,0.1073903256520472,0.2614164400674426,137438.57635282027,2776.9819800323357,140215.5583328526,1156,68,613.3947368421053,37,1,16,27.96008487573635,0.6922860360360359,37.856359649122815,1048.57456140351,28.339853010905674,0
1159,4,0,0,38,0.0,0.0,1.0,38,1700,1400,300,0.8235294117647058,20,14,6,375.9208911292714,0.7288110478899953,0.10675999911950518,0.26052952193915596,137467.3216759003,2735.3676131117313,140202.68928901205,1157,69,614.3947368421053,37,1,16,27.97338979506482,0.6925675675675675,37.828947368421055,1048.684210526316,28.342816500711244,0
1160,4,0,0,38,0.0,0.0,1.0,38,1250,1100,150,0.88,14,11,3,376.0406687386131,0.7267662399241347,0.1048643921434893,0.2616969570298026,137611.09337728904,2749.4735158894896,140360.56689317853,1158,70,615.3947368421053,37,1,17,27.828034103180407,0.6939752252252253,37.691885964912274,1049.23245614035,28.35763394973919,0
1161,4,0,0,38,0.0,0.0,1.0,38,1000,800,200,0.8,12,8,4,375.7308481324169,0.7251363205310574,0.10756953493102861,0.2623538591664206,137726.16484158585,2749.5937451908217,140475.75858677668,1159,71,616.3947368421053,37,1,17,27.722391970472493,0.6951013513513513,37.58223684210526,1049.6710526315787,28.369487908961588,0
1162,4,0,0,38,0.0,0.0,1.0,38,1650,1400,250,0.8484848484848485,19,14,5,373.71097082915117,0.7254030346135609,0.10442507542742185,0.2618163838793549,137841.28439760313,2702.5600425130824,140543.8444401162,1160,72,617.3947368421053,37,1,17,27.661650308029653,0.6962274774774775,37.47258771929825,1050.1096491228072,28.38134186818398,0
1163,4,0,0,38,0.0,0.0,1.0,38,900,500,400,0.5555555555555556,13,5,8,369.0414833893767,0.7246917970602181,0.10858936821230625,0.2594120654698179,137956.45204534082,2582.330741189593,140538.7827865304,1161,73,618.3947368421053,37,1,17,27.670541523153467,0.6973536036036035,37.362938596491226,1050.5482456140346,28.39319582740634,0
1164,4,0,0,38,0.0,0.0,1.0,38,700,400,300,0.5714285714285714,10,4,6,369.0686480018503,0.7246917970602181,0.10233156924201148,0.23677410340494506,134726.0916955808,2363.0604429601,137089.1521385409,1162,74,619.3947368421053,36,2,19,30.87712875583036,0.6675347222222221,40.45608108108109,1038.1756756756765,28.838213213213237,7
1165,4,0,0,38,0.0,0.0,1.0,38,800,300,500,0.375,13,3,10,369.52839570064583,0.7231211474632527,0.10673529008992588,0.23802583253790222,134872.27091956834,2367.826779482203,137240.09769905056,1163,75,620.3947368421053,36,2,16,30.719228823359366,0.6689814814814814,40.315315315315324,1038.7387387387398,28.853853853853884,0
1166,4,0,0,38,0.0,0.0,1.0,38,1150,700,450,0.6086956521739131,16,7,9,369.12094321816573,0.7209874348032242,0.1088131804209842,0.23872580132869317,135018.529403559,2367.6333850742712,137386.16278863326,1164,76,621.3947368421053,36,2,16,30.583848015314054,0.6704282407407407,40.17454954954955,1039.3018018018022,28.869494494494504,0
1167,4,1,0,39,0.02564102564102564,0.0,1.0,39,1050,600,450,0.5714285714285714,15,6,9,362.41899132760113,0.7261583445793972,0.11203937044029777,0.23710844139716872,135433.87298255236,2016.7615275854164,137450.63451013778,1165,0,606.4358974358975,37,2,18,30.34417904420802,0.6725788288288288,39.77521929824562,1040.8991228070176,28.13240872451399,0
1168,4,0,0,39,0.0,0.0,1.0,39,850,700,150,0.8235294117647058,10,7,3,360.01501807349916,0.7264394961763383,0.11384010541550604,0.2360982466592507,135519.48676515857,1957.8100954139854,137477.29686057256,1166,1,607.4358974358975,37,2,18,30.321538893569226,0.6734234234234233,39.692982456140356,1041.2280701754391,28.141299193930788,0
1169,4,0,0,39,0.0,0.0,1.0,39,700,300,400,0.42857142857142855,11,3,8,361.46542094331494,0.7275078722447144,0.11763880115111958,0.23742728686857567,135576.57764889195,2001.2489419821497,137577.8265908741,1167,2,608.4358974358975,37,2,18,30.226977609321256,0.6739864864864864,39.63815789473684,1041.4473684210525,28.14722617354196,0
1170,4,0,0,39,0.0,0.0,1.0,39,650,500,150,0.7692307692307693,8,5,3,364.57769098671537,0.7272267206477733,0.1209735977606281,0.23966252502995228,135605.1275993575,2087.720861226535,137692.84846058403,1168,3,609.4358974358975,37,2,18,30.11753430185633,0.6742680180180181,39.61074561403509,1041.5570175438597,28.15018966334756,0
1171,4,0,0,39,0.0,0.0,1.0,39,950,700,250,0.7368421052631579,12,7,5,364.2522604328389,0.7267768780926676,0.12247072262626091,0.23984159445179096,135663.82304794661,2083.1768523001083,137746.99990024674,1169,4,610.4358974358975,35,4,18,30.067608228715322,0.6788690476190476,39.554398148148145,1041.782407407407,29.76521164021163,0
1172,4,0,0,39,0.0,0.0,1.0,39,700,500,200,0.7142857142857143,9,5,4,365.11340731924065,0.7257647323436798,0.1292644864390755,0.24101767738287722,135754.27061899868,2113.1408607681815,137867.41147976686,1170,5,611.4358974358975,35,4,18,29.955205094032284,0.6797619047619048,39.467592592592595,1042.12962962963,29.775132275132286,0
1173,4,0,1,38,0.0,0.02564102564102564,0.9743589743589743,39,850,400,450,0.47058823529411764,13,4,9,361.41819257092135,0.7251461988304094,0.12908478590725747,0.23918395742000653,135844.7483308685,2019.3526823988361,137864.10101326733,1171,6,612.4358974358975,35,4,18,29.961534547204025,0.6806547619047618,39.38078703703704,1042.476851851852,29.78505291005291,0
1174,4,0,0,38,0.0,0.0,1.0,38,850,600,250,0.7058823529411765,11,6,5,366.06366385708407,0.724780701754386,0.12817114729269252,0.24229928226730774,135850.78124999985,2346.00694444443,138196.7881944443,1172,7,610.2105263157895,34,4,19,29.834465760724765,0.682904411764706,39.37499999999999,1042.4999999999989,30.66176470588232,0
1175,4,0,0,38,0.0,0.0,1.0,38,600,400,200,0.6666666666666666,8,4,4,366.87360563791435,0.7238027501185396,0.1285147801009372,0.24347066555970653,135943.87755102027,2374.8441043083735,138318.72165532864,1173,8,611.2105263157895,34,4,16,29.72079528158295,0.6838235294117647,39.28571428571428,1042.8571428571418,30.672268907562994,0
1176,4,0,0,38,0.0,0.0,1.0,38,1000,700,300,0.7,13,7,6,367.68513534586634,0.7245139876718825,0.12832326193250765,0.2444352925569406,136005.95946712003,2401.4739229024767,138407.43339002252,1174,9,612.2105263157895,34,4,16,29.63792513124857,0.684436274509804,39.22619047619047,1043.095238095237,30.67927170868344,0
1177,4,0,0,38,0.0,0.0,1.0,38,800,500,300,0.625,11,5,6,366.32176183907075,0.723565670934092,0.12717646564202312,0.24374165520089408,136037.00573979583,2366.6631235827485,138403.66886337858,1175,10,613.2105263157895,34,4,16,29.642626193464938,0.6847426470588236,39.19642857142856,1043.2142857142849,30.682773109243673,0
1178,4,0,0,38,0.0,0.0,1.0,38,1200,1000,200,0.8333333333333334,14,10,4,367.68214434769743,0.7242472735893789,0.11789593710616364,0.24615056533811475,136254.42885487506,2419.6641156462347,138674.0929705213,1176,11,614.2105263157895,34,4,17,29.39115355378183,0.6868872549019609,38.98809523809523,1044.0476190476174,30.70728291316522,0
1179,4,0,0,38,0.0,0.0,1.0,38,1000,700,300,0.7,13,7,6,366.30748105579,0.7236249407302039,0.11644488579940404,0.24601751533616611,136367.82633562628,2390.5109924113426,138758.33732803763,1177,12,615.2105263157895,36,2,18,29.314465408805038,0.6837384259259259,38.87950450450451,1044.4819819819827,29.013388388388407,0
1180,4,0,0,38,0.0,0.0,1.0,38,1050,700,350,0.6666666666666666,14,7,7,363.4398116948905,0.7238620199146515,0.11267945161967363,0.24490617376302748,136485.47354364503,2320.8509607580622,138806.32450440308,1178,13,616.2105263157895,36,2,18,29.272640729963737,0.6848958333333333,38.766891891891895,1044.9324324324325,29.025900900900904,0
1181,4,0,0,38,0.0,0.0,1.0,38,650,300,350,0.46153846153846156,10,3,7,363.5441700804842,0.7231507823613087,0.11467967948100033,0.24538570491032524,136544.3161700551,2327.9780202499765,138872.29419030508,1179,14,617.2105263157895,36,2,18,29.211561254175205,0.6854745370370371,38.710585585585584,1045.157657657657,29.032157157157137,0
1182,4,0,0,38,0.0,0.0,1.0,38,1000,700,300,0.7,13,7,6,362.2214298176006,0.7212245139876718,0.1125463346067086,0.24551738666322911,136691.47821808292,2302.5165368070775,138993.99475489,1180,15,618.2105263157895,36,2,18,29.10025845358605,0.6869212962962963,38.56981981981982,1045.7207207207205,29.04779779779779,0
1183,4,0,0,38,0.0,0.0,1.0,38,850,500,350,0.5882352941176471,12,5,7,364.99706510687275,0.7224988146040777,0.11355946023074703,0.24781957005039876,136751.1831945515,2382.759273580842,139133.94246813233,1181,16,619.2105263157895,35,3,18,28.96852292427428,0.6895833333333334,38.512731481481474,1045.9490740740732,29.884259259259235,0
1184,4,0,0,38,0.0,0.0,1.0,38,500,300,200,0.6,7,3,4,365.0701831283428,0.7233582266477003,0.11231525372404194,0.24808303121157607,136781.44959919402,2386.965770747588,139168.41536994162,1182,17,620.2105263157895,35,3,18,28.936619458582264,0.6898809523809524,38.48379629629629,1046.0648148148143,29.887566137566125,0
1185,4,0,0,38,0.0,0.0,1.0,38,1000,600,400,0.6,14,6,8,362.1297774603355,0.7225580844001896,0.10505072257110748,0.24715015679802357,136932.831857103,2317.4911854852467,139250.32304258825,1183,18,621.2105263157895,35,3,19,28.863600759335018,0.6913690476190476,38.33912037037037,1046.6435185185182,29.90410052910052,0
1186,4,0,0,38,0.0,0.0,1.0,38,1500,1200,300,0.8,18,12,6,365.636223023524,0.7195945945945946,0.10992594230131547,0.2504096070926435,137053.99794506596,2422.3812317815436,139476.3791768475,1184,19,622.2105263157895,35,3,18,28.65187815482113,0.6925595238095239,38.223379629629626,1047.106481481481,29.91732804232803,0
1187,4,0,0,38,0.0,0.0,1.0,38,800,400,400,0.5,12,4,8,364.985330228173,0.7191500711237553,0.10700823677230176,0.25018085362912945,137084.29783950615,2406.7515432098735,139491.049382716,1185,20,623.2105263157895,35,3,18,28.63892572944297,0.6928571428571428,38.19444444444444,1047.2222222222222,29.92063492063492,0
1188,4,0,0,38,0.0,0.0,1.0,38,600,500,100,0.8333333333333334,7,5,2,368.08790940447494,0.7190315315315315,0.11185228264030278,0.2527462503877463,137144.9076753257,2496.276470336067,139641.18414566177,1186,21,624.2105263157895,35,3,18,28.497697974217314,0.6934523809523809,38.13657407407407,1047.453703703703,29.927248677248656,0
1189,4,0,0,38,0.0,0.0,1.0,38,1250,800,450,0.64,17,8,9,364.6905841294185,0.7177275960170697,0.10562938160510638,0.2512867997494483,137266.16753472204,2411.9357638888646,139678.10329861092,1187,22,625.2105263157895,35,3,18,28.46669980119284,0.6946428571428572,38.02083333333332,1047.9166666666652,29.940476190476147,0
1190,4,0,0,38,0.0,0.0,1.0,38,1150,800,350,0.6956521739130435,15,8,7,366.40825879031905,0.715742057847321,0.11155814804701358,0.2535746689367072,137417.81771101235,2470.204662851489,139888.02237386385,1188,23,626.2105263157895,35,3,18,28.271723332229453,0.6961309523809525,37.8761574074074,1048.495370370369,29.957010582010543,0
1191,4,0,0,38,0.0,0.0,1.0,38,700,600,100,0.8571428571428571,8,6,2,367.0942537245962,0.7156827880512091,0.11430421877450514,0.25449434070379223,137478.5012243869,2493.5135620284514,139972.01478641536,1189,24,627.2105263157895,35,3,18,28.193747010999527,0.6967261904761906,37.81828703703703,1048.726851851851,29.963624338624317,0
1192,4,0,1,37,0.0,0.02631578947368421,0.9736842105263158,38,1100,800,300,0.7272727272727273,14,8,6,352.14527920913554,0.7156827880512091,0.073885874968046,0.234552552974309,136073.93024358808,1983.558431742542,138057.48867533062,1190,25,628.2105263157895,36,2,17,29.975715056664864,0.6808449074074074,39.16103603603603,1043.355855855855,28.982107107107083,3
1193,4,0,0,37,0.0,0.0,1.0,37,950,600,350,0.631578947368421,13,6,7,357.60018104618365,0.7121496496496497,0.08361767580760238,0.23806558581612236,136055.98020618988,2330.72863082989,138386.70883701977,1191,26,641.7027027027027,35,2,17,29.85124990755121,0.6827380952380953,39.17824074074073,1043.2870370370363,29.808201058201035,0
1194,4,0,0,37,0.0,0.0,1.0,37,1000,800,200,0.8,12,8,4,355.8764070513663,0.7122747747747747,0.08844554879821631,0.2375231356315445,136146.55838745268,2290.269606267129,138436.8279937198,1192,27,642.7027027027027,35,2,17,29.806314923662715,0.6836309523809524,39.091435185185176,1043.634259259258,29.818121693121658,0
1195,4,0,0,37,0.0,0.0,1.0,37,850,400,450,0.47058823529411764,13,4,9,355.23434903596694,0.7122747747747747,0.09744176247516978,0.2298274102552583,135031.53399348425,2193.5678155006885,137225.10180898494,1193,28,643.7027027027027,35,2,17,30.931700074239043,0.6726190476190477,40.16203703703704,1039.3518518518522,29.695767195767207,2
1196,4,0,0,37,0.0,0.0,1.0,37,600,400,200,0.6666666666666666,8,4,4,357.32627869117226,0.7120870870870871,0.09600115533545317,0.2317589863886497,135121.77057881077,2256.5118902177487,137378.28246902852,1194,29,644.7027027027027,35,2,17,30.787436454042812,0.6735119047619048,40.075231481481474,1039.6990740740732,29.705687830687808,0
1197,4,0,0,37,0.0,0.0,1.0,37,1050,700,350,0.6666666666666666,14,7,7,382.5070913437374,0.7112737737737738,0.09522185547422124,0.22755582726320445,131921.96609224955,2692.217506858698,134614.18359910825,1195,30,645.7027027027027,35,2,17,33.34741625356766,0.6416666666666667,43.17129629629629,1027.314814814814,29.35185185185183,8
1198,4,0,0,37,0.0,0.0,1.0,37,1150,900,250,0.782608695652174,14,9,5,382.59492184615704,0.7112737737737738,0.10061637374412657,0.22357180482534872,131239.16437596473,2651.3432088048876,133890.50758476963,1196,31,646.7027027027027,35,2,15,34.03613181972213,0.6348214285714284,43.836805555555564,1024.6527777777794,29.275793650793698,3
1199,4,0,0,37,0.0,0.0,1.0,37,1050,700,350,0.6666666666666666,14,7,7,380.7557823442073,0.7128378378378378,0.09560593441392617,0.22353316605615228,131417.1157648536,2607.5653452932356,134024.68111014683,1197,32,647.7027027027027,35,2,15,33.9030223501524,0.6366071428571427,43.66319444444446,1025.347222222224,29.29563492063497,0
1200,4,0,0,37,0.0,0.0,1.0,37,1100,900,200,0.8181818181818182,13,9,4,384.4659450794352,0.7120870870870871,0.10040003902819805,0.22658950380213544,131565.5006858712,2716.490912208521,134281.9915980797,1198,33,648.7027027027027,35,2,14,33.65767900120337,0.638095238095238,43.518518518518526,1025.925925925927,29.312169312169342,0
1201,4,1,1,37,0.02631578947368421,0.02631578947368421,0.9736842105263158,38,1000,800,200,0.8,12,8,4,374.58806001843345,0.7231507823613087,0.09078240497637036,0.22258095735688177,131876.9799148813,2279.908413481072,134156.88832836237,1199,0,632.6052631578947,36,2,15,33.59623396557397,0.6391782407407407,43.2150900900901,1027.139639639641,28.531656656656693,0
1202,4,1,0,38,0.02631578947368421,0.0,1.0,38,1150,800,350,0.6956521739130435,15,8,7,378.1053977110089,0.7243065433854907,0.11528616150959059,0.22604611497732824,132108.41912436092,2390.181270797836,134498.60039515875,1200,0,633.578947368421,36,2,16,33.272172928761826,0.6414930555555556,42.98986486486487,1028.0405405405413,28.556681681681702,0
1203,4,0,0,38,0.0,0.0,1.0,38,700,600,100,0.8571428571428571,8,6,2,377.33168515260786,0.7242769084874348,0.10839592135524456,0.22592889292645674,132166.3106307322,2374.107342139453,134540.41797287163,1201,1,634.578947368421,36,2,16,33.233627204030235,0.6420717592592593,42.933558558558566,1028.2657657657667,28.562937937937964,0
1204,4,0,0,38,0.0,0.0,1.0,38,1200,900,300,0.75,15,9,6,371.51627023128003,0.7226173541963016,0.10521995587633826,0.22347229500350285,132340.06123944902,2233.2971907718684,134573.3584302209,1202,2,635.578947368421,36,2,16,33.207927474371616,0.6438078703703702,42.76463963963965,1028.9414414414423,28.58170670670673,0
1205,4,0,0,38,0.0,0.0,1.0,38,1300,1000,300,0.7692307692307693,16,10,6,368.21300205721036,0.7233878615457563,0.11303303232220463,0.22217682769992075,132457.56842635464,2154.5324646938107,134612.10089104847,1203,3,636.578947368421,35,3,16,33.17451840191892,0.6470238095238094,42.65046296296297,1029.3981481481487,29.41137566137568,0
1206,4,1,1,38,0.02564102564102564,0.02564102564102564,0.9743589743589743,39,1350,800,550,0.5925925925925926,19,8,11,358.80514207166425,0.7376855600539811,0.10581441288467786,0.2181678309035086,132745.9231824732,1725.983965384321,134471.9071478575,1204,0,621.2307692307693,36,3,15,33.126616398936356,0.6478587962962963,42.370495495495504,1030.5180180180196,28.625500500500543,0
1207,4,1,1,38,0.02564102564102564,0.02564102564102564,0.9743589743589743,39,1150,1000,150,0.8695652173913043,13,10,3,353.54997145731437,0.7341430499325237,0.10578463330756893,0.21580690257754476,132891.02447041645,1596.7235816898053,134487.74805210627,1205,0,622.2051282051282,36,3,15,33.11626256006989,0.6493055555555556,42.22972972972973,1031.0810810810817,28.64114114114116,0
1208,4,0,0,38,0.0,0.0,1.0,38,1050,800,250,0.7619047619047619,13,8,5,361.31496722839523,0.7238027501185396,0.10745564787783479,0.2201006223075298,132815.23946544912,1997.6267789780375,134812.86624442716,1206,6,639.578947368421,35,3,15,32.992271128078436,0.6505952380952382,42.30324074074073,1030.7870370370363,29.451058201058178,0
1209,4,0,0,38,0.0,0.0,1.0,38,1200,800,400,0.6666666666666666,16,8,8,359.3046369585113,0.7228544333807492,0.10585097270058119,0.21939993219077264,132904.73257726748,1950.6573377486102,134855.3899150161,1207,7,640.578947368421,35,3,15,32.9541521682194,0.6514880952380953,42.216435185185176,1031.1342592592578,29.460978835978793,0
1210,4,0,0,38,0.0,0.0,1.0,38,800,600,200,0.75,10,6,4,357.8657787776915,0.7227062588904695,0.11062553151280352,0.2190453173397516,132994.25582990385,1918.8185871056035,134913.07441700945,1208,8,641.578947368421,35,3,15,32.90133153800119,0.6523809523809525,42.12962962962962,1031.4814814814804,29.47089947089944,0
1211,4,0,0,38,0.0,0.0,1.0,38,700,300,400,0.42857142857142855,11,3,8,356.99724040440555,0.7218468468468469,0.11050860465802792,0.21903856835549002,133083.80922335785,1902.1105270490016,134985.91975040684,1209,9,642.578947368421,35,3,15,32.83382407926714,0.6532738095238098,42.042824074074055,1031.828703703701,29.480820105820026,0
1212,4,0,0,38,0.0,0.0,1.0,38,900,600,300,0.6666666666666666,12,6,6,361.37072066391653,0.7219061166429588,0.1119889271232355,0.2220773753383971,133143.52823055972,2022.8345496827683,135166.3627802425,1210,10,643.578947368421,35,3,15,32.66104538148105,0.6538690476190477,41.984953703703695,1032.0601851851843,29.487433862433836,0
1213,4,0,0,38,0.0,0.0,1.0,38,750,500,250,0.6666666666666666,10,5,5,362.4446456045888,0.7213726884779517,0.10730787614849424,0.22309480981002922,133203.26063368036,2055.7617187499764,135259.02235243033,1211,11,644.578947368421,35,3,16,32.57336865119409,0.6544642857142857,41.92708333333332,1032.2916666666652,29.494047619047574,0
1214,4,1,1,38,0.02564102564102564,0.02564102564102564,0.9743589743589743,39,900,500,400,0.5555555555555556,13,5,8,351.52185223725286,0.7341992802519118,0.09884201819685678,0.21794354838709656,133472.2222222221,1583.9518229166483,135056.17404513876,1212,0,629.025641025641,35,4,16,32.58568548387096,0.6571428571428573,41.66666666666666,1033.3333333333323,29.523809523809497,0
1215,4,0,0,38,0.0,0.0,1.0,38,850,700,150,0.8235294117647058,10,7,3,357.7697551441088,0.7224691797060219,0.10250952274254987,0.22145997464745557,133412.42953746548,1946.186449759919,135358.6159872254,1213,13,646.578947368421,35,3,16,32.484222122638,0.6565476190476192,41.724537037037024,1033.10185185185,29.517195767195712,0
1216,4,0,0,38,0.0,0.0,1.0,38,1300,1000,300,0.7692307692307693,16,10,6,360.12549059669595,0.7214912280701754,0.10174869054422708,0.2241812548780681,133621.76254125906,2024.1205579131952,135645.88309917226,1214,14,647.578947368421,35,3,17,32.21353875144595,0.6586309523809526,41.52199074074072,1033.912037037034,29.54034391534383,0
1217,4,0,0,38,0.0,0.0,1.0,38,650,600,50,0.9230769230769231,7,6,1,358.53458115980294,0.7217875770507349,0.09010037707791207,0.22068805585674794,133203.26063368033,1954.8134216392089,135158.07405531954,1215,15,648.578947368421,35,3,18,32.67427682475615,0.6544642857142857,41.92708333333332,1032.291666666665,29.49404761904757,2
1218,4,0,0,38,0.0,0.0,1.0,38,1250,1000,250,0.8,15,10,5,354.5164767255797,0.7203058321479374,0.09302805523780355,0.2194461907942107,133412.42953746548,1859.3808942043645,135271.81043166984,1216,16,649.578947368421,35,3,19,32.568246321607305,0.6565476190476192,41.724537037037024,1033.10185185185,29.517195767195712,0
1219,4,0,0,38,0.0,0.0,1.0,38,900,500,400,0.5555555555555556,13,5,8,353.47294484911555,0.718764817449028,0.0935908319185057,0.2191532258064515,133472.2222222221,1835.7772848079385,135307.99950703004,1217,17,650.578947368421,34,4,20,32.53528225806451,0.6593137254901962,41.66666666666666,1033.3333333333323,30.39215686274507,0
1220,4,0,0,38,0.0,0.0,1.0,38,1150,600,550,0.5217391304347826,17,6,11,354.56450935027925,0.7198020388809863,0.09430102377907268,0.22037821293403514,133564.50007086145,1871.4462868480523,135435.9463577095,1218,18,651.578947368421,34,4,21,32.414632039617636,0.660232843137255,41.57738095238094,1033.6904761904746,30.402661064425722,0
1221,4,0,1,37,0.0,0.02631578947368421,0.9736842105263158,38,1150,700,450,0.6086956521739131,16,7,9,354.2192932226104,0.7190018966334756,0.1090972061879476,0.21637852735502466,132919.22477324257,1816.5107709750496,134735.73554421763,1219,19,652.578947368421,34,4,17,33.070691911029016,0.6537990196078431,42.20238095238095,1031.1904761904757,30.32913165266105,1
1222,4,0,0,37,0.0,0.0,1.0,37,650,300,350,0.46153846153846156,10,3,7,360.00017184426656,0.7150900900900901,0.12287465782472928,0.21944358301115746,132839.80320069217,2164.470396001555,135004.27359669373,1220,20,669.7567567567568,33,4,17,33.00146615945475,0.6553030303030303,42.27941176470589,1030.8823529411775,31.238859180035682,0
1223,4,0,0,37,0.0,0.0,1.0,37,600,500,100,0.8333333333333334,7,5,2,358.8613406795222,0.7150275275275275,0.12590772590772592,0.219304152637486,132934.57031250015,2141.015625000014,135075.58593750015,1221,21,670.7567567567568,33,4,17,32.935606060606055,0.65625,42.18750000000001,1031.2500000000011,31.250000000000036,0
1224,4,0,0,37,0.0,0.0,1.0,37,1350,900,450,0.6666666666666666,18,9,9,356.8404224384618,0.7139014014014013,0.1157259208233723,0.21959995052973053,133195.58000283447,2105.9134070294795,135301.49340986394,1222,22,671.7567567567568,34,3,20,32.72570445546458,0.6565563725490196,41.93452380952381,1032.2619047619048,30.360644257703083,0
1225,4,0,0,37,0.0,0.0,1.0,37,600,500,100,0.8333333333333334,7,5,2,355.34556438161223,0.7150275275275275,0.11165478208836133,0.21886056351685687,133226.3038548754,2068.275226757385,135294.5790816328,1223,23,672.7567567567568,34,3,20,32.733462100246015,0.6568627450980391,41.90476190476191,1032.3809523809534,30.364145658263336,0
1226,4,0,0,37,0.0,0.0,1.0,37,750,500,250,0.6666666666666666,10,5,5,356.66769095333393,0.7137137137137137,0.10904276033959026,0.22022008676300173,133318.49666950124,2110.0800736961583,135428.5767431974,1224,24,673.7567567567568,34,3,20,32.60686839577329,0.657781862745098,41.8154761904762,1032.738095238096,30.374649859944004,0
1227,4,0,0,37,0.0,0.0,1.0,37,1050,600,450,0.5714285714285714,15,6,9,356.9258616424851,0.7130255255255256,0.11428090916452294,0.22092743418926442,133410.72137188216,2123.547335600918,135534.26870748308,1225,25,674.7567567567568,34,3,21,32.50773027579321,0.6587009803921567,41.72619047619048,1033.0952380952388,30.385154061624668,0
1228,4,0,0,37,0.0,0.0,1.0,37,500,300,200,0.6,7,3,4,358.67585848074896,0.7139014014014013,0.11987794245858763,0.22237903225806468,133472.22222222245,2174.6527777778015,135646.87500000026,1226,26,675.7567567567568,34,3,21,32.400873655913976,0.659313725490196,41.66666666666668,1033.333333333335,30.39215686274515,0
1229,4,0,0,37,0.0,0.0,1.0,37,800,600,200,0.75,10,6,4,359.82414997163806,0.7131506506506506,0.1172324529365778,0.22385520126554137,133598.8862456749,2214.4211361015196,135813.30738177642,1227,27,676.7567567567568,33,4,21,32.24425082977715,0.6628787878787877,41.54411764705883,1033.823529411766,31.327985739750485,0
1230,4,0,0,37,0.0,0.0,1.0,37,450,200,250,0.4444444444444444,7,2,5,359.82414997163806,0.7131506506506506,0.1172324529365778,0.22385520126554137,133598.8862456749,2214.4211361015196,135813.30738177642,1228,28,677.7567567567568,33,4,21,32.24425082977715,0.6628787878787877,41.54411764705883,1033.823529411766,31.327985739750485,0
1231,4,0,0,37,0.0,0.0,1.0,37,1300,1000,300,0.7692307692307693,16,10,6,357.98348536715093,0.7113363363363363,0.11590331888945449,0.22328326925450045,133693.92368620262,2172.043354719355,135865.96704092197,1229,29,678.7567567567568,33,4,22,32.196621835130536,0.6638257575757576,41.45220588235295,1034.1911764705897,31.33912655971484,0
1232,4,1,0,38,0.02631578947368421,0.0,1.0,38,1300,1100,200,0.8461538461538461,15,11,4,350.4052927956365,0.7150900900900901,0.13110288283522875,0.22207214416029186,134280.73459201385,1810.536024305551,136091.2706163194,1230,0,661.8684210526316,35,3,19,31.805904522613066,0.6651785714285714,40.885416666666664,1036.458333333333,29.61309523809523,0
1233,4,0,0,38,0.0,0.0,1.0,38,1100,700,400,0.6363636363636364,15,7,8,348.67267219387764,0.7152975343764818,0.12328477443609032,0.221882609577922,134430.7270233195,1774.4641632372973,136205.1911865568,1231,1,662.8684210526316,35,3,19,31.701078869047624,0.6666666666666667,40.74074074074073,1037.037037037036,29.6296296296296,0
1234,4,1,0,39,0.02564102564102564,0.0,1.0,39,1100,900,200,0.8181818181818182,13,9,4,338.82595856251845,0.7228969860548808,0.11888839352058267,0.21776121061768725,134791.05045438948,1334.1949588477237,136125.2454132372,1232,0,646.8461538461538,35,4,17,31.597377024817945,0.6702380952380953,40.39351851851851,1038.4259259259252,29.66931216931215,0
1235,4,0,0,39,0.0,0.0,1.0,39,950,600,350,0.631578947368421,13,6,7,336.9700731682716,0.724246513720198,0.1229455038925793,0.21710742330834418,134881.2066642017,1290.186015732152,136171.39267993384,1233,1,647.8461538461538,35,4,18,31.55582636954504,0.6711309523809523,40.306712962962955,1038.7731481481471,29.679232804232775,0
1236,4,0,0,39,0.0,0.0,1.0,39,600,300,300,0.5,9,3,6,337.2849579931557,0.7235155195681512,0.12514922517150184,0.21785211171673025,134971.39301483182,1304.7641246570458,136276.15713948887,1234,2,648.8461538461538,35,4,19,31.45791564565232,0.6720238095238096,40.2199074074074,1039.1203703703693,29.689153439153408,0
1237,4,0,0,39,0.0,0.0,1.0,39,1250,700,550,0.56,18,7,11,335.4177090527615,0.7216599190283401,0.12359294015571853,0.21773068628106984,135151.85613854573,1266.46519204387,136418.3213305896,1235,3,649.8461538461538,35,4,20,31.326988720688632,0.6738095238095239,40.04629629629628,1039.8148148148132,29.708994708994663,0
1238,4,0,0,39,0.0,0.0,1.0,39,1450,1200,250,0.8275862068965517,17,12,5,334.099226204588,0.7210413855150698,0.12207729964739311,0.21760027863237916,135272.23186728376,1238.8695987654069,136511.10146604918,1236,4,650.8461538461538,35,4,20,31.24165554072095,0.6750000000000002,39.93055555555554,1040.2777777777762,29.72222222222218,0
1239,4,0,0,39,0.0,0.0,1.0,39,800,500,300,0.625,11,5,6,334.3084273740786,0.7207040035987404,0.12370104771929236,0.21791866959141315,135302.33417191758,1246.5421114111434,136548.87628332872,1237,5,651.8461538461538,35,4,20,31.206312344717613,0.6752976190476192,39.90162037037035,1040.3935185185162,29.725529100529034,0
1240,4,0,1,38,0.0,0.02564102564102564,0.9743589743589743,39,600,400,200,0.6666666666666666,8,4,4,334.5083710611595,0.7194107062528116,0.12450300904138523,0.2182315134861988,135332.43982553127,1253.966799554151,136586.40662508542,1238,6,652.8461538461538,35,4,20,31.171208750463467,0.6755952380952381,39.87268518518517,1040.509259259257,29.728835978835917,0
1241,4,0,0,38,0.0,0.0,1.0,38,1300,1000,300,0.7692307692307693,16,10,6,338.68062355670315,0.7184684684684685,0.12251595808743843,0.22090064551384941,135323.83786848056,1566.3123582766277,136890.1502267572,1239,7,649.7894736842105,34,4,20,31.07122425629291,0.6776960784313726,39.88095238095237,1040.4761904761892,30.602240896358506,0
1242,4,0,0,38,0.0,0.0,1.0,38,1050,800,250,0.7619047619047619,13,8,5,340.66295475613936,0.7174905168326221,0.11985183104525787,0.22299291230543788,135452.89592978393,1628.7567515432072,137081.65268132713,1240,8,650.7894736842105,35,3,20,30.891427618412276,0.6767857142857143,39.75694444444444,1040.9722222222222,29.74206349206349,0
1243,4,0,1,37,0.0,0.02631578947368421,0.9736842105263158,38,950,700,250,0.7368421052631579,12,7,5,344.224800994003,0.7167496443812233,0.099489767622428,0.22466941963088638,135348.2862515389,1718.0473799630643,137066.33363150197,1241,9,651.7894736842105,37,1,17,30.902704601334747,0.6717342342342343,39.85745614035088,1040.5701754385964,28.1235182550972,1
1244,4,0,0,37,0.0,0.0,1.0,37,650,300,350,0.46153846153846156,10,3,7,355.0647945128464,0.7073323323323323,0.10131040131040137,0.23169482353804396,135340.57706355012,2210.934836863902,137551.511900414,1242,12,670.1621621621622,36,1,17,30.62838203463203,0.673611111111111,39.86486486486487,1040.5405405405413,28.903903903903924,0
1245,4,0,0,37,0.0,0.0,1.0,37,800,500,300,0.625,11,5,6,355.3108016748448,0.7081456456456456,0.10315953871846095,0.2320443193128795,135369.8731459502,2219.675630021935,137589.54877597213,1243,13,671.1621621621622,36,1,17,30.59282905890417,0.6739004629629628,39.83671171171172,1040.6531531531546,28.90703203203207,0
1246,4,0,0,37,0.0,0.0,1.0,37,1000,700,300,0.7,13,7,6,355.7652117858733,0.70508008008008,0.11023612840614838,0.23329114526043862,135516.40111395184,2242.404228552888,137758.80534250473,1244,14,672.1621621621622,36,1,18,30.43523325401976,0.6753472222222221,39.69594594594595,1041.2162162162165,28.92267267267268,0
1247,4,0,0,37,0.0,0.0,1.0,37,800,500,300,0.625,11,5,6,354.8799999999999,0.7063313313313313,0.11762162162162171,0.2334736842105264,135633.6805555557,2226.7361111111313,137860.41666666683,1245,15,673.1621621621622,36,1,18,30.341666666666676,0.6765046296296295,39.58333333333334,1041.6666666666679,28.93518518518522,0
1248,4,0,0,37,0.0,0.0,1.0,37,1000,600,400,0.6,14,6,8,348.1934263545956,0.7063313313313313,0.08739989989989971,0.2089160558127569,132244.8979591834,1809.3608276643645,134054.25878684776,1246,16,674.1621621621622,34,3,21,33.903597608024675,0.6470588235294119,42.85714285714284,1028.5714285714264,30.25210084033607,6
1249,4,0,0,37,0.0,0.0,1.0,37,750,500,250,0.6666666666666666,10,5,5,351.02434834779723,0.7053928928928929,0.0947666018251534,0.21095635733113072,132306.1295351472,1888.5345804988444,134194.66411564604,1247,17,675.1621621621622,34,3,21,33.76918923088792,0.6476715686274511,42.79761904761904,1028.8095238095223,30.259103641456537,0
1250,4,0,0,37,0.0,0.0,1.0,37,500,200,300,0.4,8,2,6,352.5709321575506,0.7066441441441441,0.09694714957872863,0.2124024883973536,132398.00347222216,1935.9374999999905,134333.94097222216,1248,18,676.1621621621622,34,3,21,33.63697705802969,0.6485906862745099,42.70833333333333,1029.166666666666,30.269607843137237,0
1251,4,0,0,37,0.0,0.0,1.0,37,1050,900,150,0.8571428571428571,12,9,3,353.04586153397236,0.7065815815815816,0.09190689301697685,0.21320814319453857,132489.90929705216,1955.0028344671225,134444.9121315193,1249,19,677.1621621621622,34,3,21,33.53231961147087,0.6495098039215685,42.61904761904762,1029.5238095238094,30.280112044817923,0
1252,4,0,0,37,0.0,0.0,1.0,37,850,600,250,0.7058823529411765,11,6,5,351.4692670013917,0.7062062062062062,0.09999156479332227,0.21277541139461428,132581.84700963713,1919.6889172335605,134501.53592687068,1250,20,678.1621621621622,34,3,21,33.48047431896121,0.6504289215686274,42.529761904761905,1029.880952380952,30.29061624649859,0
1253,4,0,0,37,0.0,0.0,1.0,37,800,400,400,0.5,12,4,8,350.4625264561974,0.7064564564564565,0.10938231968969214,0.21268602412005108,132673.81660997716,1899.4401927437484,134573.25680272092,1251,21,679.1621621621622,34,3,18,33.41398004776211,0.6513480392156863,42.44047619047618,1030.238095238094,30.301120448179237,0
1254,4,1,1,37,0.02631578947368421,0.02631578947368421,0.9736842105263158,38,950,600,350,0.631578947368421,13,6,7,341.8745910542821,0.7176386913229018,0.10448360578285909,0.2092573046343243,132994.25582990394,1493.471364883395,134487.72719478732,1252,0,662.2631578947369,35,3,18,33.313696888090966,0.6523809523809524,42.129629629629626,1031.481481481481,29.470899470899457,0
1255,4,0,0,37,0.0,0.0,1.0,37,900,500,400,0.5555555555555556,13,5,8,349.9743383481465,0.7062687687687688,0.10403314882649872,0.21378545266372662,132919.22477324263,1903.6635487528274,134822.88832199547,1253,23,681.1621621621622,34,3,18,33.18012583698913,0.6537990196078431,42.20238095238095,1031.1904761904761,30.32913165266106,0
1256,4,0,0,37,0.0,0.0,1.0,37,650,400,250,0.6153846153846154,9,4,5,348.8908481499246,0.7061436436436437,0.10475741815924211,0.21329861803266037,132949.9167375284,1877.0018424036348,134826.91857993204,1254,24,682.1621621621622,34,3,18,33.177257685944056,0.6541053921568627,42.17261904761905,1031.3095238095243,30.332633053221304,0
1257,4,0,0,37,0.0,0.0,1.0,37,1050,900,150,0.8571428571428571,12,9,3,340.4629279563116,0.7061436436436437,0.10519388954171549,0.20182080780915382,131786.1128826531,1573.657171201819,133359.7700538549,1255,25,683.1621621621622,34,3,19,34.56400966183574,0.6424632352941178,43.30357142857143,1026.7857142857147,30.199579831932784,3
1258,4,0,0,37,0.0,0.0,1.0,37,1050,700,350,0.6666666666666666,14,7,7,338.35323435857293,0.7078328328328328,0.10247095299238973,0.2013785112078954,131938.952664399,1528.394274376404,133467.3469387754,1256,26,684.1621621621622,34,3,19,34.46432020084975,0.6439950980392157,43.1547619047619,1027.3809523809516,30.21708683473387,0
1259,4,0,1,36,0.0,0.02702702702702703,0.972972972972973,37,1300,1000,300,0.7692307692307693,16,10,6,338.1382619870085,0.7084584584584585,0.09836660844305012,0.20190081286278205,132061.288265306,1530.9948979591672,133592.28316326518,1257,27,685.1621621621622,34,3,21,34.34676858929811,0.6452205882352942,43.03571428571428,1027.857142857142,30.231092436974762,0
1260,4,0,0,36,0.0,0.0,1.0,36,750,500,250,0.6666666666666666,10,5,5,344.15526285669637,0.7058201058201059,0.10351668587629037,0.2054398711444207,132051.391366902,1889.2362612937218,133940.62762819574,1258,28,691.4722222222222,33,3,23,34.2021133897699,0.6474116161616161,43.045343137254896,1027.8186274509794,31.14601901366604,0
1261,4,1,0,37,0.02702702702702703,0.0,1.0,37,1050,600,450,0.5714285714285714,15,6,9,339.57206367009786,0.7161536536536537,0.10824563432404322,0.20490437086917912,132459.27047902485,1595.893565759627,134055.16404478447,1259,0,673.7567567567568,34,3,24,33.90988204001387,0.649203431372549,42.64880952380952,1029.4047619047612,30.276610644257683,0
1262,4,0,0,37,0.0,0.0,1.0,37,500,300,200,0.6,7,3,4,340.65287847906706,0.7161536536536537,0.1053897828464303,0.20605925866041466,132551.19756235817,1630.7893990929583,134181.98696145113,1260,1,674.7567567567568,34,3,25,33.78973988439306,0.6501225490196079,42.5595238095238,1029.761904761904,30.28711484593835,0
1263,4,0,0,37,0.0,0.0,1.0,37,1050,900,150,0.8571428571428571,12,9,3,342.25849288520317,0.7152152152152152,0.10835792464908578,0.2078770004155392,132704.4802295918,1683.8470804988651,134388.32731009068,1261,2,675.7567567567568,34,3,20,33.594502214519544,0.6516544117647058,42.410714285714285,1030.3571428571427,30.30462184873949,0
1264,4,0,0,37,0.0,0.0,1.0,37,1300,1100,200,0.8461538461538461,15,11,4,341.8109635895631,0.7139014014014013,0.10534362577770628,0.2087987705650768,132919.2247732424,1686.6496598639246,134605.87443310634,1262,3,676.7567567567568,34,3,23,33.390575694604784,0.6537990196078433,42.20238095238094,1031.1904761904746,30.329131652661015,0
1265,4,0,1,36,0.0,0.02702702702702703,0.972972972972973,37,1000,800,200,0.8,12,8,4,343.8136262538774,0.713526026026026,0.09870306443515164,0.2108869567404356,133072.72002551012,1750.4428854875177,134823.16291099763,1263,4,677.7567567567568,34,3,23,33.18502172993346,0.6553308823529412,42.05357142857142,1031.7857142857138,30.34663865546217,0
1266,4,0,0,36,0.0,0.0,1.0,36,550,300,250,0.5454545454545454,8,3,5,349.8665858260205,0.7117063492063492,0.10406104773975522,0.21398816760986833,132966.1668589004,2104.083765859284,135070.25062475968,1264,5,690.25,33,3,23,33.135792934093786,0.6565656565656566,42.15686274509804,1031.3725490196075,31.253713606654774,0
1267,4,0,0,36,0.0,0.0,1.0,36,450,200,250,0.4444444444444444,7,2,5,350.65647916423217,0.7113425925925927,0.10761620001848127,0.21465276982729742,132997.76715986626,2127.3057537965997,135125.07291366285,1265,6,691.25,33,3,23,33.083714506356195,0.6568813131313131,42.12622549019607,1031.4950980392146,31.257427213309533,0
1268,4,0,0,36,0.0,0.0,1.0,36,650,300,350,0.46153846153846156,10,3,7,351.87929564067156,0.7117394179894181,0.10215979728392166,0.21576633576102056,133060.97902549495,2164.280715349861,135225.2597408448,1266,7,692.25,33,3,23,32.98875064338599,0.6575126262626263,42.064950980392155,1031.740196078431,31.26485442661912,0
1269,4,0,0,36,0.0,0.0,1.0,36,1150,800,350,0.6956521739130435,15,8,7,351.10523294232183,0.7123015873015873,0.1032108881236069,0.2156569778706995,133124.20590938572,2148.1210652152954,135272.32697460102,1267,8,693.25,33,3,23,32.945290543482585,0.6581439393939394,42.00367647058823,1031.9852941176464,31.27228163992868,0
1270,4,1,0,37,0.02702702702702703,0.0,1.0,37,1250,800,450,0.64,17,8,9,345.4107487292756,0.7198448448448448,0.14118936660256565,0.19023234973592298,128929.21095521525,1506.7070578231119,130435.91801303836,1268,0,675.4864864864865,34,3,20,37.33125268628142,0.6136642156862746,46.10119047619047,1015.5952380952368,29.870448179271673,8
1271,4,0,0,37,0.0,0.0,1.0,37,950,600,350,0.631578947368421,13,6,7,347.35567817994996,0.7192192192192192,0.14025434594721253,0.19218246433066963,129110.63102324257,1569.4621598639383,130680.09318310651,1269,1,676.4864864864865,34,3,22,37.097096950529064,0.6155024509803921,45.922619047619044,1016.3095238095233,29.891456582633037,0
1272,4,0,0,37,0.0,0.0,1.0,37,800,500,300,0.625,11,5,6,346.5796614092822,0.7197822822822822,0.14348790762890773,0.19204696487825176,129171.13272392284,1553.617488662123,130724.75021258497,1270,2,677.4864864864865,34,3,22,37.05522699769684,0.6161151960784315,45.863095238095234,1016.5476190476186,29.898459383753487,0
1273,4,0,0,37,0.0,0.0,1.0,37,1300,1100,200,0.8461538461538461,15,11,4,345.3677276660114,0.7218468468468469,0.13289129592298665,0.19197634105158934,129294.84941188488,1530.8572111442627,130825.70662302914,1271,3,678.4864864864865,33,4,22,36.9601508213841,0.6196338383838383,45.74142156862745,1017.0343137254904,30.819221628045163,0
1274,4,1,0,38,0.02631578947368421,0.0,1.0,38,1050,900,150,0.8571428571428571,12,9,3,339.59420552131746,0.7348269321953532,0.14166728180901034,0.1906540697139365,129685.96938775519,1208.1207482993284,130894.09013605452,1272,0,661.6052631578947,34,4,19,36.709618980832175,0.6213235294117647,45.35714285714286,1018.5714285714292,29.95798319327733,0
1275,4,0,0,38,0.0,0.0,1.0,38,1100,700,400,0.6363636363636364,15,7,8,339.94508253995957,0.7344713134186819,0.14181628135759916,0.1914427570093458,129807.25623582774,1225.467687074836,131032.72392290257,1273,1,662.6052631578947,34,4,20,36.57758956386293,0.6225490196078431,45.23809523809524,1019.0476190476196,29.971988795518225,0
1276,4,0,0,38,0.0,0.0,1.0,38,800,700,100,0.875,9,7,2,340.6058037337869,0.7326635846372689,0.13843217760622517,0.19226153575296095,129898.25857426306,1248.820153061229,131147.0787273243,1274,2,663.6052631578947,34,4,20,36.46843006734401,0.6234681372549019,45.148809523809526,1019.404761904762,29.982492997198882,0
1277,4,0,0,38,0.0,0.0,1.0,38,900,700,200,0.7777777777777778,11,7,4,362.24786067325147,0.7335229966808914,0.1617141547628138,0.19652659527863814,128330.72015570942,1787.1918497791353,130117.91200548856,1275,3,664.6052631578947,33,5,18,37.51511852926947,0.6098484848484848,46.69117647058824,1013.2352941176476,30.704099821746897,7
1278,4,1,0,39,0.02564102564102564,0.0,1.0,39,750,500,250,0.6666666666666666,10,5,5,350.1669581475619,0.7497750787224472,0.13215140096860511,0.18560663118391496,127396.24361582415,1121.9910212757804,128518.23463709993,1276,0,648.5384615384615,37,2,15,38.7774474132001,0.5920608108108107,47.61513157894737,1009.5394736842109,27.284850640113806,4
1279,4,0,0,39,0.0,0.0,1.0,39,1400,900,500,0.6428571428571429,19,9,10,349.9043834399968,0.7497188484030589,0.12983361588290454,0.1859762998191468,127506.962779413,1123.0490391274357,128630.01181854044,1277,1,649.5384615384615,37,2,16,38.67058860782397,0.5931869369369368,47.505482456140356,1009.9780701754395,27.296704599336202,0
1280,4,2,1,40,0.04878048780487805,0.024390243902439025,0.975609756097561,41,1100,800,300,0.7272727272727273,14,8,6,337.9594866919024,0.770579268292683,0.1383868984788854,0.18203020702891595,128041.65556423092,454.5784379337699,128496.2340021647,1278,0,618.8048780487804,40,1,19,38.425461057000376,0.5934895833333333,46.97662601626016,1012.0934959349592,25.30233739837398,0
1281,4,0,0,40,0.0,0.0,1.0,40,1450,1100,350,0.7586206896551724,18,11,7,342.1204800001269,0.7607638888888889,0.13959083890890334,0.18413852981724307,128012.72922092032,759.1552734375193,128771.88449435783,1279,1,635.275,39,1,19,38.34973837708013,0.5948183760683761,47.00520833333334,1011.9791666666681,25.948183760683797,0
1282,4,2,1,41,0.047619047619047616,0.023809523809523808,0.9761904761904762,42,750,500,250,0.6666666666666666,10,5,5,330.6151984687063,0.7824719318621758,0.14849765671627124,0.1801908366122279,128513.937717014,97.86783854167513,128611.80555555568,1280,0,605.9761904761905,39,3,15,38.12966577631667,0.5998931623931624,46.51041666666667,1013.9583333333344,25.99893162393165,0
1283,4,1,0,42,0.023809523809523808,0.0,1.0,42,900,600,300,0.6666666666666666,12,6,6,331.51957782415485,0.7848915989159891,0.15191532652502215,0.1809234646690568,128566.7534722223,124.47916666667089,128691.23263888898,1281,0,606.952380952381,39,3,16,38.05293070391673,0.6004273504273505,46.458333333333336,1014.1666666666673,26.00427350427352,0
1284,4,0,0,42,0.0,0.0,1.0,42,900,600,300,0.6666666666666666,12,6,6,327.84386107515604,0.784335075493612,0.1466393849206351,0.17945137658850654,128685.30636525882,37.737540485164345,128723.04390574398,1282,1,607.952380952381,40,2,17,38.02542401175214,0.6,46.34146341463415,1014.6341463414637,25.365853658536594,0
1285,4,1,1,42,0.023255813953488372,0.023255813953488372,0.9767441860465116,43,850,600,250,0.7058823529411765,11,6,5,323.4192462792455,0.7919896640826873,0.14455948427427234,0.17821131557626016,128949.36244173588,-259.0588781809106,128690.30356355497,1283,0,594.7906976744187,41,2,18,37.86913134075665,0.6011178861788617,46.0813492063492,1015.6746031746027,24.77255129694153,0
1286,4,0,1,41,0.0,0.023809523809523808,0.9761904761904762,42,1100,900,200,0.8181818181818182,13,9,4,332.56829643057927,0.7830768486256291,0.1547380761752264,0.18298581596554792,128891.61544054466,173.0529942494597,129064.66843479412,1284,3,609.952380952381,40,2,18,37.6955731251668,0.6020833333333333,46.13821138211382,1015.4471544715448,25.38617886178862,0
1287,4,1,1,41,0.023809523809523808,0.023809523809523808,0.9761904761904762,42,1700,1300,400,0.7647058823529411,21,13,8,337.3602424086268,0.7838511420828495,0.1648432218318241,0.18683705119441227,129149.73416121356,313.99712472734143,129463.7312859409,1285,0,610.3333333333334,40,2,18,37.3112877424515,0.6046875,45.88414634146341,1016.4634146341463,25.411585365853657,0
1288,4,1,0,42,0.023809523809523808,0.0,1.0,42,1150,800,350,0.6956521739130435,15,8,7,336.9123384647978,0.7856658923732095,0.17163365346138448,0.1873484498939762,129310.02995105549,313.2495712469822,129623.27952230247,1286,0,611.3095238095239,38,4,20,37.159707633053216,0.6096491228070176,45.72649572649572,1017.0940170940163,26.765632028789902,0
1289,4,2,3,41,0.045454545454545456,0.06818181818181818,0.9318181818181819,44,1000,600,400,0.6,14,6,8,322.5395523210376,0.8011363636363636,0.16712616991946594,0.1812296228960808,129718.50419723714,-432.1303456936961,129286.37385154344,1287,0,584.4772727272727,40,4,19,37.11093375897846,0.6104166666666667,45.32520325203252,1018.6991869918702,25.467479674796756,0
1290,4,2,2,41,0.046511627906976744,0.046511627906976744,0.9534883720930233,43,1200,900,300,0.75,15,9,6,343.790861928897,0.8009413067552602,0.18034342499916578,0.18988312951610753,129042.58355034713,273.87085001279775,129316.45440035993,1288,0,593.0697674418604,39,4,19,37.25693732485818,0.6052350427350428,45.98958333333333,1016.0416666666658,26.052350427350405,3
1291,4,0,1,40,0.0,0.024390243902439025,0.975609756097561,41,1350,1000,350,0.7407407407407407,17,10,7,352.4696156618647,0.7837398373983739,0.18628532609411197,0.19422522604853332,128950.68825263508,890.2399055478188,129840.9281581829,1289,1,622.609756097561,37,4,20,37.13013692468241,0.6078265765765767,46.0800438596491,1015.6798245614007,27.450806069227045,0
1292,4,4,1,43,0.09090909090909091,0.022727272727272728,0.9772727272727273,44,950,700,250,0.7368421052631579,12,7,5,342.99641889407843,0.8031844608879493,0.22372246449737232,0.18969801942917366,129095.50781249972,56.102839335150634,129151.61065183487,1290,0,581.0,39,5,18,37.22324723247231,0.605769230769231,45.937499999999986,1016.2499999999978,26.057692307692253,2
1293,4,2,3,42,0.044444444444444446,0.06666666666666667,0.9333333333333333,45,1100,1000,100,0.9090909090909091,12,10,2,332.7744214973595,0.8071548821548822,0.2167897604629727,0.18543070894788474,129391.54071015028,-388.27417315000093,129003.26653700028,1291,0,569.0444444444445,38,7,18,37.18212923098462,0.6104714912280704,45.64636752136751,1017.4145299145282,26.77406657669811,0
1294,4,1,0,43,0.023255813953488372,0.0,1.0,43,1300,1100,200,0.8461538461538461,15,11,4,342.8736030470925,0.803063861203396,0.23625781418409164,0.19094725624675368,129368.65790435481,271.4195714065457,129640.07747576135,1292,0,590.5348837209302,37,6,20,36.94851620320471,0.6120495495495497,45.66885964912279,1017.3245614035058,27.495258416310968,0
1295,4,1,1,43,0.022727272727272728,0.022727272727272728,0.9772727272727273,44,1250,900,350,0.72,16,9,7,335.3973796929196,0.8079193093727978,0.23268284777303294,0.18858192292167886,129745.05077069145,-96.76998867707749,129648.28078201438,1293,0,578.0909090909091,38,6,17,36.756545371923934,0.6140350877192984,45.29914529914528,1018.803418803416,26.81061628430042,0
1296,4,0,0,43,0.0,0.0,1.0,43,1000,800,200,0.8,12,8,4,344.2714377590144,0.7994186046511628,0.24008554092868017,0.1929540641199737,129619.76431450043,324.87652450751733,129944.64083900795,1294,1,592.5116279069767,37,6,17,36.657760848497894,0.6145833333333335,45.42214912280701,1018.3114035087705,27.521929824561365,0
1297,4,0,0,43,0.0,0.0,1.0,43,1000,600,400,0.6,14,6,8,329.54564246771446,0.7994647471391657,0.20217624047298122,0.18078184815480874,128773.09032698713,-101.49351237239304,128671.59681461474,1295,2,593.5116279069767,41,2,15,37.892903104942484,0.599339430894309,46.25496031746031,1014.9801587301575,24.755613627564816,4
1298,4,0,1,42,0.0,0.023255813953488372,0.9767441860465116,43,1250,600,650,0.48,19,6,13,331.87268176655476,0.7974806201550387,0.20391358947050464,0.1832187673299889,129024.94454089533,-36.02912808639263,128988.91541280894,1296,3,594.5116279069767,41,2,17,37.57760879471405,0.6018800813008129,46.00694444444446,1015.9722222222244,24.779810298103037,0
1299,4,0,0,42,0.0,0.0,1.0,42,1050,900,150,0.8571428571428571,12,9,3,338.6022170573891,0.7955381339527681,0.19856985698569818,0.18715774286107445,129072.27143441419,340.8314536651628,129413.10288807935,1297,4,579.0238095238095,40,2,17,37.3585275194186,0.6039062499999999,45.960365853658544,1016.1585365853671,25.403963414634177,0
1300,4,1,3,40,0.023255813953488372,0.06976744186046512,0.9302325581395349,43,750,600,150,0.8,9,6,3,332.21325294823805,0.8025101513473606,0.19147938245065488,0.1847354070132726,129310.0299510556,-8.105215090501304,129301.9247359651,1298,0,566.5348837209302,38,5,17,37.279192927170875,0.6096491228070176,45.72649572649573,1017.0940170940172,26.765632028789927,0
1301,4,1,0,41,0.024390243902439025,0.0,1.0,41,1500,1100,400,0.7333333333333333,19,11,8,344.318081702801,0.7848069105691057,0.20865073447456806,0.19133472386041803,129282.865405161,702.8856426692878,129985.7510478303,1299,0,594.609756097561,38,3,19,36.99902825927094,0.609375,45.753205128205124,1016.987179487179,26.7628205128205,0
1302,4,1,1,41,0.023809523809523808,0.023809523809523808,0.9761904761904762,42,1100,700,400,0.6363636363636364,15,7,8,333.1704263206265,0.7965785907859079,0.17896023105976444,0.18133011957305206,128458.27880245114,186.84590030419534,128645.12470275533,1300,0,581.4285714285714,36,6,19,38.12162112123232,0.6047453703703705,46.56531531531532,1013.7387387387391,28.15940940940942,6
1303,4,1,1,41,0.023809523809523808,0.023809523809523808,0.9761904761904762,42,1450,1100,350,0.7586206896551724,18,11,7,336.8645671974231,0.7923683701122726,0.1794119512814012,0.18413082653606735,128629.57552146754,266.1492573654925,128895.72477883304,1301,0,582.4047619047619,36,6,19,37.853389579632925,0.6064814814814814,46.396396396396405,1014.4144144144154,28.178178178178207,0
1304,4,0,0,41,0.0,0.0,1.0,41,1150,800,350,0.6956521739130435,15,8,7,347.47950064087894,0.7858739837398374,0.17945563157982614,0.18957754574192928,128555.01570001728,734.0465320644814,129289.06223208176,1302,3,597.609756097561,35,6,19,37.660256410256395,0.6077380952380952,46.46990740740741,1014.1203703703715,28.974867724867757,0
1305,4,1,0,42,0.023809523809523808,0.0,1.0,42,1300,1100,200,0.8461538461538461,15,11,4,340.54937254648854,0.795150987224158,0.18482938135892968,0.18762460543657816,128943.91593874303,382.3539333252376,129326.26987206827,1303,0,584.3571428571429,36,6,20,37.439710610932465,0.6096643518518519,46.08671171171172,1015.653153153155,28.212587587587638,0
1306,4,1,0,43,0.023255813953488372,0.0,1.0,43,1200,1000,200,0.8333333333333334,14,10,4,331.7917702492292,0.804078995939461,0.19132257724771917,0.18425370522702703,129257.13320444748,-22.70939135119113,129234.42381309629,1304,0,571.7441860465116,37,6,21,37.343648910933794,0.6109234234234234,45.77850877192982,1016.8859649122803,27.483404457088657,0
1307,4,2,0,45,0.044444444444444446,0.0,1.0,45,750,500,250,0.6666666666666666,10,5,5,320.79992974268254,0.8187710437710438,0.19859122926607586,0.18031168464847325,129731.4453125,-676.4322916666661,129055.01302083333,1305,0,547.2888888888889,39,6,21,37.142126789366046,0.6121794871794872,45.3125,1018.75,26.121794871794872,0
1308,4,0,1,44,0.0,0.022222222222222223,0.9777777777777777,45,1350,900,450,0.6666666666666666,18,9,9,319.5731138366588,0.8188973063973064,0.20304868352302474,0.1798656041168121,129784.51063368046,-704.8719618055604,129079.6386718749,1306,1,548.2888888888889,39,6,21,37.11962448033804,0.6127136752136753,45.260416666666664,1018.9583333333326,26.12713675213673,0
1309,4,0,0,44,0.0,0.0,1.0,44,850,700,150,0.8235294117647058,10,7,3,326.1979641681643,0.81553911205074,0.20616117132317147,0.18353687222842394,129772.26382725194,-333.71034681129265,129438.55348044065,1307,2,561.3409090909091,38,6,22,36.963274614658715,0.6143092105263157,45.272435897435905,1018.9102564102575,26.813427800269935,0
1310,4,0,1,43,0.0,0.022727272727272728,0.9772727272727273,44,1500,1000,500,0.6666666666666666,20,10,10,337.5384041019004,0.8169705778717407,0.2144505604770499,0.18679481316005705,129119.9380547338,-81.56332182774237,129038.37473290606,1308,3,562.3409090909091,38,6,20,37.33706506885315,0.6077302631578947,45.91346153846154,1016.3461538461544,26.74595141700406,6
1311,4,1,0,44,0.022727272727272728,0.0,1.0,44,1200,800,400,0.6666666666666666,16,8,8,341.19611877536613,0.8137332628611699,0.23003096278586743,0.19001306062412043,129368.65790435518,28.042475745838857,129396.70038010101,1309,0,563.25,37,7,21,36.991179851979616,0.6120495495495495,45.66885964912281,1017.3245614035086,27.495258416311042,0
1312,4,1,2,43,0.022222222222222223,0.044444444444444446,0.9555555555555556,45,1150,700,450,0.6086956521739131,16,7,9,336.0441772237622,0.8187710437710438,0.23178798685406532,0.18868346205249428,129690.63321827764,-283.64357330702165,129406.98964497061,1310,0,551.7111111111111,38,7,20,36.795285294734626,0.613486842105263,45.35256410256411,1018.5897435897451,26.804993252361715,0
1313,4,1,1,43,0.022727272727272728,0.022727272727272728,0.9772727272727273,44,1300,1000,300,0.7692307692307693,16,10,6,342.80959235550523,0.8161777660324172,0.23300283286118972,0.19208220016110053,129609.02829142011,86.24363083497332,129695.27192225508,1311,0,565.2045454545455,38,6,20,36.70588080998844,0.6126644736842106,45.43269230769231,1018.2692307692307,26.79655870445344,0
1314,4,0,0,43,0.0,0.0,1.0,43,900,600,300,0.6666666666666666,12,6,6,354.49795165843386,0.8067552602436323,0.24611484624710678,0.19826258934921068,129536.03512619254,584.051823638028,130120.08694983057,1312,7,579.3488372093024,37,6,20,36.48256857676288,0.6137387387387387,45.504385964912274,1017.9824561403498,27.51303935514459,0
1315,4,1,0,44,0.022727272727272728,0.0,1.0,44,1550,1200,350,0.7741935483870968,19,12,7,347.7423591184037,0.8137993305144469,0.2579606159002823,0.1970264867954542,130044.5513391227,244.39981463218726,130288.95115375488,1313,0,567.1590909090909,38,6,21,36.13809748262978,0.6170504385964912,45.00534188034188,1019.9786324786329,26.841542959964023,0
1316,4,0,0,44,0.0,0.0,1.0,44,1500,1200,300,0.8,18,12,6,357.43079817253454,0.8144600070472164,0.2643442622950827,0.1982116244411325,129201.38888888867,448.90080539116525,129650.28969427984,1314,1,568.1590909090909,35,9,20,36.74863387978143,0.6142857142857143,45.83333333333332,1016.6666666666649,29.047619047618998,2
1317,4,0,0,44,0.0,0.0,1.0,44,750,600,150,0.8,9,6,3,358.20670398940877,0.8128964059196617,0.27250225022502295,0.19908679999714943,129289.65627411254,462.48432677467764,129752.14060088721,1315,2,569.1590909090909,35,9,20,36.638997951519286,0.6151785714285715,45.74652777777777,1017.013888888888,29.05753968253966,0
1318,4,0,0,44,0.0,0.0,1.0,44,1500,1200,300,0.8,18,12,6,357.9232330429404,0.8136231501057083,0.2705792989657536,0.19964162554172876,129430.46932067184,465.234406703981,129895.70372737582,1316,3,570.1590909090909,36,8,16,36.5028312675225,0.6145833333333335,45.6081081081081,1017.567567567566,28.26576576576572,0
1319,4,0,0,44,0.0,0.0,1.0,44,1000,600,400,0.6,14,6,8,357.19876848560693,0.8133588794926004,0.2696242129191895,0.19952796474492662,129487.77113261897,450.57447650351537,129938.3456091225,1317,4,571.1590909090909,36,8,17,36.462943497824,0.6151620370370372,45.551801801801794,1017.7927927927917,28.272022022021993,0
1320,4,1,1,44,0.022222222222222223,0.022222222222222223,0.9777777777777777,45,1000,600,400,0.6,14,6,8,349.7631682494072,0.8223063973063973,0.2625987278954365,0.19693276852200953,129799.4797373802,79.81545401415448,129879.29519139435,1318,0,559.4444444444445,38,7,17,36.335360313133435,0.6145833333333335,45.24572649572649,1019.0170940170926,26.81623931623928,0
1321,4,1,1,44,0.022222222222222223,0.022222222222222223,0.9777777777777777,45,850,500,350,0.5882352941176471,12,5,7,353.1779576602307,0.8170033670033671,0.2683296649547562,0.1992708985237293,129881.14458917748,174.23147691576963,130055.37606609325,1319,0,560.4222222222222,38,7,17,36.16540893686894,0.6154057017543859,45.16559829059829,1019.3376068376072,26.824673864147556,0
1322,4,2,1,45,0.043478260869565216,0.021739130434782608,0.9782608695652174,46,1600,1000,600,0.625,22,10,12,349.141502829251,0.823389694041868,0.25966274352354635,0.19935958404959006,130346.55044100106,-97.00329920901618,130249.54714179205,1320,0,549.195652173913,37,9,19,35.796176491642505,0.6219031531531531,44.709429824561404,1021.1622807017542,27.59898055950687,0
1323,4,0,0,45,0.0,0.0,1.0,45,1600,1200,400,0.75,20,12,8,356.22777378470573,0.821422558922559,0.2650587052969584,0.20311704384478899,130291.32806793295,282.67794821850896,130574.00601615146,1321,1,562.4,36,9,20,35.67128097654241,0.6232638888888888,44.76351351351352,1020.9459459459471,28.35960960960964,0
1324,4,0,1,44,0.0,0.022222222222222223,0.9777777777777777,45,1150,700,450,0.6086956521739131,16,7,9,353.83936665055995,0.8221801346801347,0.2583273698773916,0.20247957860667182,130430.54112803945,230.29201292706037,130660.83314096651,1322,2,563.4,37,8,20,35.59109775296981,0.6227477477477477,44.627192982456144,1021.4912280701758,27.60787102892367,0
1325,4,0,0,44,0.0,0.0,1.0,44,1350,900,450,0.6666666666666666,18,9,9,350.3291855930205,0.8231589147286822,0.24630474630474608,0.20163390904131634,130654.64854570638,354.4273237919307,131009.07586949831,1323,3,554.7727272727273,37,7,15,35.45375732875731,0.625,44.4078947368421,1022.3684210526317,27.631578947368425,0
1326,4,0,0,44,0.0,0.0,1.0,44,1000,500,500,0.5,15,5,10,347.9525371386826,0.8220798097251586,0.24307897763827468,0.20055657363135662,130710.70545744829,296.2243190212216,131006.92977646951,1324,4,555.7727272727273,37,7,15,35.457770391021526,0.6255630630630631,44.35307017543859,1022.5877192982443,27.63750592697958,0
1327,4,0,1,43,0.0,0.022727272727272728,0.9772727272727273,44,1200,700,500,0.5833333333333334,17,7,10,346.41540559386766,0.8208245243128964,0.23459514761765599,0.20025128464626893,130822.8553497228,263.8104993844048,131086.6658491072,1325,5,556.7727272727273,37,7,15,35.38361914969632,0.6266891891891893,44.24342105263157,1023.026315789472,27.649359886201946,0
1328,4,0,0,43,0.0,0.0,1.0,43,1300,1000,300,0.7692307692307693,16,10,6,345.3310794020894,0.8131690660760428,0.13992954555420778,0.19552375349776668,130017.30974687707,380.7774405096931,130398.08718738676,1326,13,570.6046511627907,38,5,17,36.227215587680725,0.6167763157894737,45.032051282051285,1019.8717948717949,26.838731443994604,4
1329,4,1,0,44,0.022727272727272728,0.0,1.0,44,1550,1100,450,0.7096774193548387,20,11,9,336.0787434459569,0.8192829457364341,0.13718219847696433,0.19161767100138608,130289.17236328138,-42.515733506929536,130246.65662977446,1327,0,558.6136363636364,39,5,18,36.187740196578595,0.6177884615384615,44.76562500000001,1020.937500000001,26.17788461538464,0
1330,4,1,1,44,0.022222222222222223,0.022222222222222223,0.9777777777777777,45,1100,800,300,0.7272727272727273,14,8,6,330.7357666550731,0.823063973063973,0.14559676510556452,0.1899605714020604,130574.00238160182,-362.90144341989753,130211.10093818193,1328,0,547.1777777777778,40,5,13,36.03605283218985,0.6190104166666666,44.48678861788619,1022.0528455284574,25.551321138211435,0
1331,4,0,1,43,0.0,0.022727272727272728,0.9772727272727273,44,1300,1000,300,0.7692307692307693,16,10,6,340.6299913255097,0.8154510218463707,0.14104618633862587,0.19595209465818034,130635.03146701408,99.64192708335261,130734.67339409744,1329,1,560.0454545454545,39,5,14,35.72150329461315,0.6212606837606837,44.42708333333334,1022.2916666666682,26.212606837606877,0
1332,4,2,2,43,0.044444444444444446,0.044444444444444446,0.9555555555555556,45,1250,1000,250,0.8,15,10,5,336.301548358725,0.8206649831649833,0.1412925440339028,0.19459103384342805,130859.79327781104,-198.32978055388145,130661.46349725717,1330,0,548.5111111111111,40,5,15,35.604969540458214,0.621875,44.20731707317074,1023.1707317073187,25.57926829268297,0
1333,4,1,0,44,0.022727272727272728,0.0,1.0,44,1450,1100,350,0.7586206896551724,18,11,7,344.6849612777121,0.814922480620155,0.14867009708198786,0.19951917351979787,130874.7409396703,222.1110026041856,131096.8519422745,1331,0,561.9545454545455,39,5,16,35.3754156910652,0.6236645299145298,44.19270833333334,1023.229166666668,26.236645299145334,0
1334,4,2,1,45,0.043478260869565216,0.021739130434782608,0.9782608695652174,46,1250,900,350,0.72,16,9,7,331.813074228303,0.8275764895330113,0.15447154471544722,0.19434765776229196,131328.12500000015,-483.938259548597,130844.18674045155,1332,0,538.4782608695652,40,6,19,35.24728997289973,0.6265624999999999,43.75000000000001,1025.0000000000011,25.62500000000003,0
1335,4,0,0,45,0.0,0.0,1.0,45,1150,800,350,0.6956521739130435,15,8,7,335.16129712092004,0.8236111111111112,0.15203062019442504,0.19644564174907542,131354.81906467027,-194.98969184025916,131159.82937283002,1333,1,550.2444444444444,39,6,20,35.134577278731854,0.6284722222222221,43.72395833333334,1025.1041666666679,26.284722222222253,0
1336,4,0,0,45,0.0,0.0,1.0,45,1450,1200,250,0.8275862068965517,17,12,5,336.99105648395664,0.8244107744107745,0.1507544989268612,0.19859455430271739,131562.60456945302,-132.91577847177626,131429.68879098125,1334,2,551.2444444444444,40,5,14,34.87824005283143,0.6289062499999998,43.52134146341465,1025.914634146344,25.6478658536586,0
1337,4,0,1,44,0.0,0.022222222222222223,0.9777777777777777,45,850,700,150,0.8235294117647058,10,7,3,337.68033335019425,0.8240319865319866,0.15427710114312743,0.19954556386797057,131666.88484243868,-107.73648704471543,131559.14835539396,1335,3,552.2444444444444,40,5,14,34.75550384526522,0.6299479166666665,43.41971544715449,1026.3211382113846,25.658028455284615,0
1338,4,1,2,43,0.022222222222222223,0.044444444444444446,0.9555555555555556,45,1250,900,350,0.72,16,9,7,335.04027926221573,0.8236952861952862,0.16167452700548557,0.19907419767802567,131875.56932257602,-163.2744852600772,131712.29483731595,1336,0,552.5555555555555,40,5,16,34.613180633884106,0.6320312499999999,43.216463414634156,1027.1341463414649,25.678353658536622,0
1339,4,0,0,43,0.0,0.0,1.0,43,1100,800,300,0.7272727272727273,14,8,6,350.5435713476371,0.8108157991878922,0.16993236125338695,0.20664640366183906,131574.6348002958,624.528476331351,132199.16327662717,1337,5,579.1627906976744,38,5,16,34.51850984067478,0.6324013157894737,43.50961538461538,1025.9615384615379,26.998987854251,0
1340,4,0,0,43,0.0,0.0,1.0,43,1100,800,300,0.7272727272727273,14,8,6,357.1647326916617,0.8104005167958656,0.1750795287828828,0.21100396200714025,131656.8560979618,804.637163050616,132461.49326101242,1338,6,580.1627906976744,38,5,16,34.265693316677066,0.6332236842105263,43.429487179487175,1026.2820512820508,27.007422402159232,0
1341,4,0,0,43,0.0,0.0,1.0,43,1550,1300,250,0.8387096774193549,18,13,5,358.0987579061898,0.8099852344038391,0.1762591756275007,0.2120129984424259,131739.1030777447,835.12183596316,132574.22491370785,1339,7,581.1627906976744,38,5,17,34.15873139764804,0.634046052631579,43.349358974358964,1026.6025641025624,27.01585695006743,0
1342,4,1,3,41,0.022727272727272728,0.06818181818181818,0.9318181818181819,44,1000,500,500,0.5,15,5,10,348.16024572111576,0.8141296687808316,0.1660005754308984,0.2074394958447969,131979.97352972775,390.0360028752766,132370.00953260303,1340,0,568.9318181818181,40,4,17,34.17111726502487,0.6330729166666667,43.114837398373986,1027.5406504065047,25.68851626016262,0
1343,4,0,0,41,0.0,0.0,1.0,41,1150,900,250,0.782608695652174,14,9,5,366.66221281572166,0.7972052845528456,0.17691529630131675,0.2160259233692626,131553.00188519532,1447.1029547552957,133000.10483995063,1341,9,610.3414634146342,37,4,21,34.126941712982756,0.6340090090090091,43.53070175438596,1025.8771929824552,27.726410621147437,0
1344,4,0,0,41,0.0,0.0,1.0,41,1050,700,350,0.6666666666666666,14,7,7,365.51710262712936,0.7969512195121952,0.17253211950985015,0.21614691078285236,131693.64762474975,1427.2561028393181,133120.90372758906,1342,10,611.3414634146342,37,4,18,34.014239041412964,0.6354166666666667,43.393640350877185,1026.4254385964898,27.7412280701754,0
1345,4,0,0,41,0.0,0.0,1.0,41,800,600,200,0.75,10,6,4,370.3039426429306,0.7965447154471544,0.17195838162332544,0.2196261192432579,131806.21831957897,1561.6724617189818,133367.89078129796,1343,11,612.3414634146342,37,4,18,33.77769620928992,0.6365427927927929,43.28399122807017,1026.8640350877183,27.753082029397792,0
1346,4,0,0,41,0.0,0.0,1.0,41,800,500,300,0.625,11,5,6,373.62425489866456,0.7943089430894309,0.1828604453191509,0.2222530567711484,131918.83710612875,1657.6154441751305,133576.4525503039,1344,12,613.3414634146342,37,4,19,33.578712598285136,0.637668918918919,43.17434210526316,1027.302631578947,27.76493598862019,0
1347,4,0,0,41,0.0,0.0,1.0,41,1200,1100,100,0.9166666666666666,13,11,2,372.52321428414905,0.7950711382113821,0.17971183445964378,0.22225716661268802,132031.50398439902,1636.9600502077492,133668.46403460676,1345,13,614.3414634146342,37,4,19,33.49325633913011,0.638795045045045,43.06469298245614,1027.741228070175,27.77678994784257,0
1348,4,0,0,41,0.0,0.0,1.0,41,1050,700,350,0.6666666666666666,14,7,7,370.9535318327995,0.7924288617886179,0.17419373297924068,0.22198029789381998,132144.2189543897,1603.8729464835194,133748.09190087323,1346,14,615.3414634146342,37,4,19,33.4198704276421,0.6399211711711712,42.955043859649116,1028.1798245614027,27.788643907064937,0
1349,4,0,0,41,0.0,0.0,1.0,41,1250,900,350,0.72,16,9,7,373.7504825751644,0.7895833333333333,0.1764945945313654,0.22465732082016468,132313.3815813521,1690.4380434364548,134003.81962478854,1347,15,616.3414634146342,37,4,19,33.17735532345732,0.6416103603603602,42.7905701754386,1028.8377192982466,27.806424845898558,0
1350,4,1,0,42,0.023809523809523808,0.0,1.0,42,1000,500,500,0.5,15,5,10,363.28565630797823,0.7940863337204801,0.17776915940441929,0.22000916632500583,132595.55975155823,1234.0400411665164,133829.59979272474,1348,0,602.6428571428571,37,5,20,33.16243922779375,0.6444256756756757,42.516447368421055,1029.9342105263163,27.836059743954493,0
1351,4,0,2,40,0.0,0.047619047619047616,0.9523809523809523,42,850,700,150,0.8235294117647058,10,7,3,361.1928012626765,0.7947880371660859,0.1752316081817995,0.21923563053385756,132680.2718144047,1184.6318097876522,133864.90362419235,1349,1,603.6428571428571,37,5,18,33.1311196253725,0.6452702702702702,42.4342105263158,1030.263157894739,27.844950213371323,0
1352,4,0,0,40,0.0,0.0,1.0,40,800,500,300,0.625,11,5,6,371.59212737701495,0.787767094017094,0.18997470489038792,0.2243932093020061,132487.3559268906,1846.2516878858194,134333.6076147764,1350,18,631.075,35,5,19,33.057546374367625,0.6473214285714285,42.621527777777786,1029.51388888889,29.414682539682573,0
1353,4,2,2,40,0.047619047619047616,0.047619047619047616,0.9523809523809523,42,1400,1300,100,0.9285714285714286,15,13,2,356.08611366187097,0.7975464576074333,0.17609427609427608,0.21760818057114364,132934.57031250026,1067.2309027778067,134001.80121527807,1351,0,601.9761904761905,37,5,19,33.007154882154886,0.647804054054054,42.187500000000014,1031.250000000002,27.871621621621678,0
1354,4,0,0,40,0.0,0.0,1.0,40,850,500,350,0.5882352941176471,12,5,7,378.9669259084924,0.7857371794871795,0.1549167200512498,0.22493055944606702,131834.36850761762,1993.2581419282792,133827.62664954588,1352,20,633.075,37,3,17,33.52685244501389,0.6368243243243243,43.25657894736842,1026.9736842105256,27.756045519203393,4
1355,4,0,0,40,0.0,0.0,1.0,40,900,600,300,0.6666666666666666,12,6,6,378.0737571868317,0.7839476495726496,0.15399552875116984,0.22513531410933496,131958.5539141829,1978.0132542552437,133936.56716843814,1353,21,634.075,38,2,17,33.424318047901295,0.6362390350877192,43.13568376068376,1027.457264957265,27.03834907782276,0
1356,4,0,0,40,0.0,0.0,1.0,40,1200,700,500,0.5833333333333334,17,7,10,379.4993713051286,0.783306623931624,0.15378976918278253,0.22614776661788885,131985.99810979614,2017.7206607495045,134003.71877054565,1354,22,635.075,38,2,17,33.359976086504474,0.6365131578947368,43.10897435897436,1027.5641025641023,27.041160593792167,0
1357,4,0,0,40,0.0,0.0,1.0,40,1450,1100,350,0.7586206896551724,18,11,7,382.87532244534026,0.7831730769230769,0.15255897329315182,0.2289875219323499,132123.26189139095,2117.3472998392917,134240.60919123024,1355,23,636.075,38,2,19,33.13459073746926,0.6378837719298245,42.97542735042735,1028.098290598291,27.055218173639236,0
1358,4,0,0,40,0.0,0.0,1.0,40,650,300,350,0.46153846153846156,10,3,7,382.3243852251643,0.7827991452991453,0.1468805194805194,0.22899018094537701,132178.18737900877,2106.9888459712292,134285.17622498,1356,24,637.075,38,2,19,33.09329004329004,0.6384320175438596,42.92200854700855,1028.3119658119665,27.060841205578065,0
1359,4,0,0,40,0.0,0.0,1.0,40,900,600,300,0.6666666666666666,12,6,6,375.5477762819443,0.7825320512820513,0.13897051188869236,0.2259150926528048,132343.03232750748,1940.2262994009784,134283.25862690844,1357,25,638.075,38,2,19,33.1012269407815,0.6400767543859649,42.761752136752136,1028.9529914529915,27.07771030139451,0
1360,4,1,1,40,0.024390243902439025,0.024390243902439025,0.975609756097561,41,1300,900,400,0.6923076923076923,17,9,8,365.27487794977895,0.7883130081300813,0.13788001879167466,0.22188028623749664,132708.51518015156,1495.0401656137192,134203.5553457653,1358,0,623.4878048780488,37,4,16,32.99756571246143,0.6455518018018018,42.406798245614034,1030.3728070175437,27.847913703176857,0
1361,4,3,1,42,0.06976744186046512,0.023255813953488372,0.9767441860465116,43,950,700,250,0.7368421052631579,12,7,5,332.73572129040616,0.7996493170911775,0.1586479895545727,0.19662364244071473,131666.88484243842,174.75439957421608,131841.63924201264,1359,0,595.4186046511628,40,3,16,34.882372842195586,0.6299479166666666,43.41971544715447,1026.3211382113825,25.658028455284562,7
1362,4,0,0,42,0.0,0.0,1.0,42,800,600,200,0.75,10,6,4,338.5432746078469,0.7924893534649632,0.15848917001552332,0.19926094590935273,131515.0404188369,504.7064887152831,132019.74690755218,1360,1,610.5952380952381,39,3,22,34.886365559730535,0.6300747863247864,43.567708333333336,1025.7291666666674,26.30074786324788,0
1363,4,0,0,42,0.0,0.0,1.0,42,950,400,550,0.42105263157894735,15,4,11,336.1591383441982,0.791013356562137,0.15520908871162642,0.19827350375391348,131595.187717014,447.3849826388945,132042.5726996529,1361,2,611.5952380952381,39,3,16,34.86675126903551,0.6308760683760684,43.489583333333336,1026.0416666666674,26.308760683760703,0
1364,4,0,0,42,0.0,0.0,1.0,42,850,500,350,0.5882352941176471,12,5,7,338.4258566023248,0.79045683313976,0.15804776889945882,0.19975033633250477,131621.90890842024,508.8514539930659,132130.7603624133,1362,3,612.5952380952381,39,3,16,34.78168460054817,0.6311431623931624,43.46354166666667,1026.1458333333342,26.311431623931647,0
1365,4,0,0,42,0.0,0.0,1.0,42,1750,1400,350,0.8,21,14,7,340.9600533225811,0.7897067363530779,0.17313822080556363,0.20252205576871388,131862.52170138896,591.9704861111214,132454.4921875001,1363,4,613.5952380952381,39,3,18,34.47430696416498,0.6335470085470085,43.22916666666667,1027.083333333334,26.3354700854701,0
1366,4,0,0,42,0.0,0.0,1.0,42,1150,800,350,0.6956521739130435,15,8,7,343.3623475536558,0.789561556329849,0.1752017919901132,0.2045245287602211,131969.53125000003,662.6736111111119,132632.20486111115,1364,5,614.5952380952381,39,3,20,34.30487969721546,0.6346153846153846,43.125,1027.5000000000002,26.34615384615385,0
1367,4,0,0,42,0.0,0.0,1.0,42,1250,1000,250,0.8,15,10,5,344.36945956888775,0.7886662795199381,0.16967492879504786,0.20574702206375065,132084.41904826812,697.1680010245137,132781.58704929263,1365,6,615.5952380952381,40,2,20,34.16337123084529,0.6341145833333334,43.013211382113816,1027.9471544715439,25.698678861788597,0
1368,4,0,0,42,0.0,0.0,1.0,42,1100,700,400,0.6363636363636364,15,7,8,345.7117212453377,0.7883517228029423,0.17486597287921768,0.2068341504340084,132136.6572993093,736.2382469099065,132872.8955462192,1366,7,616.5952380952381,40,2,20,34.07630720569338,0.6346354166666668,42.96239837398374,1028.1504065040651,25.70376016260163,0
1369,4,0,1,41,0.0,0.023809523809523808,0.9761904761904762,42,850,600,250,0.7058823529411765,11,6,5,348.11619443344864,0.7883517228029423,0.16441556669736368,0.19474181844293645,129545.80213758702,663.3639744422183,130209.16611202924,1367,8,617.5952380952381,39,3,18,36.63505320781747,0.610309829059829,45.49479166666668,1018.0208333333351,26.103098290598336,5
1370,4,1,0,42,0.023809523809523808,0.0,1.0,42,400,200,200,0.5,6,2,4,346.09149462932857,0.7981997677119629,0.17011464025168221,0.19426421552730086,129678.39084201411,576.117621527799,130254.5084635419,1368,0,615.3095238095239,39,3,19,36.551868139360465,0.6116452991452991,45.36458333333334,1018.5416666666684,26.116452991453038,0
1371,4,2,0,44,0.045454545454545456,0.0,1.0,44,800,500,300,0.625,11,5,6,338.001445646537,0.813953488372093,0.18034663178548072,0.19208192651493258,130161.3333412068,-1.0562326782626315,130160.27710852853,1369,0,588.2954545454545,41,3,21,36.26814764404691,0.6133130081300813,44.89087301587301,1020.4365079365075,24.888695315524572,0
1372,4,1,0,45,0.022222222222222223,0.0,1.0,45,1200,900,300,0.75,15,9,6,336.187222071829,0.8183501683501684,0.19836457825167852,0.19303523207317652,130562.68376981537,-221.14133704104108,130341.54243277432,1370,0,576.2,38,7,18,35.9082078890515,0.6222587719298245,44.49786324786326,1022.0085470085485,26.894961763382856,0
1373,4,0,0,45,0.0,0.0,1.0,45,800,600,200,0.75,10,6,4,338.30783317580335,0.8172558922558923,0.19842995169082167,0.19452700407608708,130617.28395061738,-162.2299382715927,130455.05401234579,1371,1,577.2,38,7,18,35.79879981884059,0.6228070175438596,44.44444444444445,1022.222222222223,26.900584795321656,0
1374,4,0,1,44,0.0,0.022222222222222223,0.9777777777777777,45,1350,900,450,0.6666666666666666,18,9,9,337.3077740091046,0.8166666666666668,0.20321041819004892,0.19463817483961168,130753.83434007232,-179.14303911899674,130574.69130095333,1372,2,578.2,38,7,18,35.68630523346915,0.6241776315789473,44.31089743589744,1022.7564102564103,26.914642375168693,0
1375,4,0,0,44,0.0,0.0,1.0,44,1200,700,500,0.5833333333333334,17,7,10,343.6146848690414,0.8089103241719521,0.20592718156177936,0.19827747909893503,130753.83434007232,185.7875164365597,130939.62185650888,1373,3,592.2727272727273,38,6,18,35.52504439569625,0.6241776315789473,44.31089743589744,1022.7564102564103,26.914642375168693,0
1376,4,0,0,44,0.0,0.0,1.0,44,1450,1100,350,0.7586206896551724,18,11,7,341.64906080737984,0.8073687455954898,0.2118571776748721,0.19808564717277632,130937.79047070211,146.95462770178312,131084.7450984039,1374,4,593.2727272727273,40,4,18,35.389360540164844,0.6226562499999999,44.13109756097562,1023.4756097560987,25.586890243902467,0
1377,4,0,1,43,0.0,0.022727272727272728,0.9772727272727273,44,1100,700,400,0.6363636363636364,15,7,8,342.93810669562055,0.8072145877378436,0.20999330579313114,0.1994064337580566,131048.6359619081,188.31422036409066,131236.9501822722,1375,5,594.2727272727273,41,3,18,35.244384426573646,0.6222052845528454,44.02281746031747,1023.9087301587317,24.97338366240809,0
1378,4,0,0,43,0.0,0.0,1.0,43,1300,1000,300,0.7692307692307693,16,10,6,354.06303837841494,0.7974806201550387,0.21039875353453752,0.2058387254277284,131041.82287535543,679.4131923788932,131721.2360677343,1376,6,608.9302325581396,40,3,19,34.96650124069481,0.6236979166666666,44.029471544715456,1023.8821138211393,25.597052845528484,0
1379,4,1,0,44,0.022727272727272728,0.0,1.0,44,1250,1000,250,0.8,15,10,5,349.99008526670633,0.8021494009866104,0.2208056171470809,0.20499419279907094,131328.12500000012,392.70833333334826,131720.83333333346,1377,0,596.0681818181819,42,2,20,34.781504065040664,0.6235119047619047,43.75000000000001,1025.000000000001,24.404761904761926,0
1380,4,0,0,44,0.0,0.0,1.0,44,1200,1000,200,0.8333333333333334,14,10,4,350.3925320201433,0.8017089499647639,0.21926899558478574,0.2055162872551996,131381.5158420138,407.0203993055507,131788.53624131935,1378,1,597.0681818181819,39,5,20,34.717283072546245,0.6287393162393162,43.697916666666664,1025.2083333333326,26.287393162393144,0
1381,4,0,0,44,0.0,0.0,1.0,44,1450,900,550,0.6206896551724138,20,9,11,350.86407414337395,0.8016649048625794,0.2184798660135423,0.20691143063969075,131588.6707647565,433.94742712671723,132022.61819188323,1379,2,598.0681818181819,40,4,18,34.49612882989963,0.6291666666666667,43.4959349593496,1026.0162601626023,25.650406504065057,0
1382,4,0,1,43,0.0,0.022727272727272728,0.9772727272727273,44,550,500,50,0.9090909090909091,6,5,1,352.5218081450575,0.8009161381254405,0.21811834298216404,0.20803113365521025,131614.739542022,479.4131923788858,132094.15273440088,1380,3,599.0681818181819,40,4,18,34.42730514014065,0.6294270833333333,43.47052845528456,1026.1178861788624,25.65294715447156,0
1383,4,0,0,43,0.0,0.0,1.0,43,1200,800,400,0.6666666666666666,16,8,8,333.73882761307567,0.8002953119232189,0.15224234317410223,0.1958955063365559,131410.26925131495,180.6369017133157,131590.90615302828,1381,4,596.0697674418604,38,5,21,35.11514014796289,0.6307565789473684,43.669871794871796,1025.3205128205132,26.982118758434556,1
1384,4,0,0,43,0.0,0.0,1.0,43,1250,900,350,0.72,16,9,7,333.7584528095926,0.8007567368032484,0.14839562482750623,0.19717611916906172,131656.85609796178,188.31771860617232,131845.17381656796,1382,5,597.0697674418604,38,5,17,34.86622943993338,0.6332236842105263,43.429487179487175,1026.2820512820506,27.007422402159225,0
1385,4,0,0,43,0.0,0.0,1.0,43,950,600,350,0.631578947368421,13,6,7,308.0177143234846,0.8003414544112218,0.11703535640007545,0.1804103755323268,131328.12500000015,-509.7222222222075,130818.40277777794,1383,6,598.0697674418604,40,3,19,35.85704607046071,0.6265624999999999,43.75000000000001,1025.0000000000011,25.62500000000003,5
1386,4,0,0,43,0.0,0.0,1.0,43,1200,700,500,0.5833333333333334,17,7,10,307.1141896228217,0.8005260243632336,0.12504349950335647,0.18049442559603382,131458.3656078561,-525.454115440511,130932.91149241559,1384,7,599.0697674418604,40,3,19,35.749265021636454,0.6278645833333332,43.62296747967481,1025.5081300813033,25.637703252032583,0
1387,4,0,0,43,0.0,0.0,1.0,43,1050,600,450,0.5714285714285714,15,6,9,307.88363552362364,0.7999723145071982,0.13088970251083443,0.18119355879533178,131510.479924731,-502.0150662634416,131008.46485846755,1385,8,600.0697674418604,40,3,20,35.67716073846558,0.6283854166666666,43.57215447154473,1025.7113821138237,25.64278455284559,0
1388,4,1,0,44,0.022727272727272728,0.0,1.0,44,1100,800,300,0.7272727272727273,14,8,6,305.8349086326399,0.8048581747709656,0.14077733860342523,0.18129388913790542,131786.1128826534,-739.0412414965655,131047.07164115683,1386,0,587.4090909090909,41,3,14,35.45289855072464,0.6295731707317072,43.303571428571445,1026.785714285717,25.043554006968705,0
1389,4,1,0,45,0.022222222222222223,0.0,1.0,45,1250,800,450,0.64,17,8,9,304.3178863291404,0.8132154882154883,0.14724211584369895,0.1822472578851492,132173.71627306085,-955.4348071029046,131218.28146595796,1387,0,575.3333333333334,42,3,15,35.103145809775114,0.6319444444444443,42.926356589147304,1028.2945736434135,24.48320413436699,0
1390,4,0,0,45,0.0,0.0,1.0,45,900,600,300,0.6666666666666666,12,6,6,304.3178863291404,0.8132154882154883,0.14724211584369895,0.1822472578851492,132173.71627306085,-955.4348071029046,131218.28146595796,1388,1,576.3333333333334,42,3,15,35.103145809775114,0.6319444444444443,42.926356589147304,1028.2945736434135,24.48320413436699,0
1391,4,0,0,45,0.0,0.0,1.0,45,1150,900,250,0.782608695652174,14,9,5,306.72653768087184,0.8127525252525253,0.1484062702747957,0.18441802814810307,132323.2199462173,-882.5913782224491,131440.62856799483,1389,2,577.3333333333334,42,3,16,34.89141866013688,0.6334325396825395,42.78100775193799,1028.875968992249,24.497046880767833,0
1392,4,0,0,45,0.0,0.0,1.0,45,1050,700,350,0.6666666666666666,14,7,7,304.51194809393235,0.8125841750841751,0.15661879866763773,0.17691195877152663,131015.8109012491,-1005.9018393345209,130009.90906191459,1390,3,578.3333333333334,40,5,15,36.26104327972999,0.6234375000000001,44.05487804878048,1023.7804878048769,25.594512195121922,6
1393,4,0,2,43,0.0,0.044444444444444446,0.9555555555555556,45,1200,600,600,0.5,18,6,12,303.42313757916105,0.8119949494949495,0.15860419491011735,0.17711688766274034,131197.9489411892,-1038.3013376627541,130159.64760352646,1391,4,579.3333333333334,40,5,15,36.10566908044837,0.6252604166666667,43.87703252032521,1024.4918699187,25.612296747967502,0
1394,4,2,1,44,0.044444444444444446,0.022222222222222223,0.9777777777777777,45,1200,900,300,0.75,15,9,6,299.1215826638548,0.80753367003367,0.16669970267591694,0.17567734395100704,131432.31232236128,-1137.1517449930286,130295.16057736825,1392,0,579.7111111111111,40,5,16,35.980343574496196,0.6276041666666665,43.64837398373985,1025.4065040650428,25.63516260162607,0
1395,4,0,0,44,0.0,0.0,1.0,44,750,400,350,0.5333333333333333,11,4,7,305.58020207912995,0.803646934460888,0.17038293075089128,0.17873353317803123,131274.74500868074,-777.0073784722009,130497.73763020853,1393,1,593.8863636363636,39,5,16,35.97318221860814,0.6276709401709402,43.80208333333334,1024.7916666666683,26.276709401709443,0
1396,4,0,0,44,0.0,0.0,1.0,44,1400,1000,400,0.7142857142857143,18,10,8,305.53570180355166,0.8024356941508105,0.16255367283808098,0.17958202891080421,131461.62245008704,-766.7561848958069,130694.86626519123,1394,2,594.8863636363636,39,5,17,35.78646097850008,0.6295405982905982,43.61979166666668,1025.5208333333353,26.295405982906033,0
1397,4,0,1,43,0.0,0.022727272727272728,0.9772727272727273,44,1000,700,300,0.7,13,7,6,306.19106602321153,0.8011363636363636,0.16215567535632536,0.18034507285864768,131541.7534722223,-744.6180555555443,130797.13541666676,1395,3,595.8863636363636,39,5,18,35.689141619279724,0.6303418803418803,43.54166666666667,1025.8333333333342,26.303418803418825,0
1398,4,0,0,43,0.0,0.0,1.0,43,900,500,400,0.5555555555555556,13,5,8,312.27842829887277,0.800249169435216,0.169075071017051,0.18408899612977764,131574.63480029596,-382.41596811307755,131192.21883218287,1396,4,608.3023255813954,38,5,14,35.499973966468794,0.6324013157894737,43.50961538461539,1025.961538461539,26.998987854251027,0
1399,4,1,0,44,0.022727272727272728,0.0,1.0,44,1350,1100,250,0.8148148148148148,16,11,5,305.16401127693564,0.8069943622269204,0.1651564314817202,0.18151552950622102,131916.02105034742,-748.7955729166464,131167.22547743077,1397,0,595.4545454545455,39,5,15,35.33977218954911,0.6340811965811964,43.17708333333334,1027.2916666666683,26.34081196581201,0
1400,4,1,1,44,0.022222222222222223,0.022222222222222223,0.9777777777777777,45,1250,900,350,0.72,16,9,7,319.79242238396705,0.8110269360269361,0.20059740561307948,0.18128458968422298,130064.82600392099,-681.2508450513881,129383.5751588696,1398,0,583.2,42,3,16,36.83029353092048,0.6108630952380953,44.985465116279066,1020.0581395348834,24.287098560354366,4
1401,4,1,1,44,0.022222222222222223,0.022222222222222223,0.9777777777777777,45,1350,1100,250,0.8148148148148148,16,11,5,320.2707807173035,0.808459595959596,0.1974957013407601,0.182248089319036,130213.13252095715,-659.307677573476,129553.82484338367,1399,0,584.0444444444445,42,3,16,36.66809076236591,0.6123511904761905,44.84011627906976,1020.63953488372,24.300941306755238,0
1402,4,0,0,44,0.0,0.0,1.0,44,950,400,550,0.42105263157894735,15,4,11,324.3961969124456,0.802677942212826,0.1978058510638303,0.18401094617964567,130089.53788834793,-359.88973018449457,129729.64815816343,1400,2,598.3181818181819,42,2,16,36.687879939209736,0.6111111111111112,44.961240310077514,1020.155038759689,24.2894056847545,0
1403,4,2,2,44,0.043478260869565216,0.043478260869565216,0.9565217391304348,46,1150,700,450,0.6086956521739131,16,7,9,310.8452631370996,0.8134661835748792,0.18844743522585294,0.17821574863173772,130504.37345758722,-1086.5517175246353,129417.82174006259,1401,0,573.2608695652174,43,3,13,36.61453506333024,0.6138565891472869,44.55492424242424,1021.780303030303,23.7623326286117,0
1404,4,1,2,43,0.022222222222222223,0.044444444444444446,0.9555555555555556,45,900,700,200,0.7777777777777778,11,7,4,316.57912014340917,0.8058080808080809,0.19036840330466998,0.18141360015174507,130485.24728081259,-738.2190448290265,129747.02823598357,1402,0,586.9777777777778,42,3,17,36.487378287809804,0.6150793650793651,44.57364341085272,1021.7054263565902,24.32631967515691,0
1405,4,0,0,43,0.0,0.0,1.0,43,850,600,250,0.7058823529411765,11,6,5,322.60516905560564,0.7980343300110742,0.19500182992124593,0.1842895455193343,130363.87963750311,-188.78771415973972,130175.09192334337,1403,5,612.1627906976744,41,2,18,36.45610711741468,0.6153455284552845,44.692460317460316,1021.2301587301583,24.90805265195508,0
1406,4,0,0,43,0.0,0.0,1.0,43,1000,700,300,0.7,13,7,6,324.21679705910105,0.7977113325950534,0.19106796116504876,0.18593724998378278,130515.89269967239,-136.91106072058983,130378.9816389518,1404,6,613.1627906976744,41,2,13,36.26132686084143,0.6168699186991871,44.54365079365079,1021.8253968253962,24.922570654277955,0
1407,4,2,2,43,0.044444444444444446,0.044444444444444446,0.9555555555555556,45,800,400,400,0.5,12,4,8,316.05012269881524,0.8101430976430977,0.19013076733284007,0.18325481363351895,130940.15438475658,-723.2696280991806,130216.8847566574,1405,0,586.8666666666667,43,2,13,36.04197508018751,0.6182170542635659,44.128787878787875,1023.4848484848478,23.801973220577857,0
1408,4,0,0,43,0.0,0.0,1.0,43,850,400,450,0.47058823529411764,13,4,9,327.23441498915327,0.7954964931709118,0.19419315113910884,0.18902599736432246,130794.81336805546,-39.88715277778698,130754.92621527768,1406,8,615.1627906976744,41,2,13,35.902494908350306,0.6196646341463414,44.27083333333333,1022.9166666666658,24.949186991869897,0
1409,4,1,1,43,0.022727272727272728,0.022727272727272728,0.9772727272727273,44,1450,1100,350,0.7586206896551724,18,11,7,319.6652846072643,0.8015988372093024,0.200709918215358,0.18638619545413065,131154.36952594487,-414.9002276005099,130739.46929834437,1407,0,602.1590909090909,42,2,14,35.733571406047986,0.6217757936507937,43.91957364341085,1024.321705426356,24.388612033960857,0
1410,4,0,0,43,0.0,0.0,1.0,43,900,600,300,0.6666666666666666,12,6,6,323.8593094317706,0.7960040605389442,0.200536620641647,0.18856174006002074,131099.43000637754,-108.44582624716838,130990.98418013037,1408,10,617.1627906976744,41,2,15,35.68154848396784,0.6227134146341464,43.973214285714285,1024.1071428571427,24.978222996515676,0
1411,4,0,0,43,0.0,0.0,1.0,43,1600,1300,300,0.8125,19,13,6,325.6643973270783,0.793373938722776,0.2035262999355778,0.19062270783223587,131303.29574732567,-47.83826467762958,131255.45748264805,1409,11,618.1627906976744,42,1,17,35.42986354038636,0.6232638888888891,43.77422480620154,1024.903100775192,24.402454780361712,0
1412,4,3,2,44,0.06521739130434782,0.043478260869565216,0.9565217391304348,46,600,500,100,0.8333333333333334,7,5,2,307.5669808821031,0.811755233494364,0.19982244565729967,0.1831068331439043,131949.619210459,-1083.3237560843788,130866.29545437462,1410,0,578.7826086956521,42,4,15,35.2443490835927,0.6297123015873016,43.144379844961236,1027.4224806201541,24.462440014765576,0
1413,4,0,0,44,0.0,0.0,1.0,44,1450,900,550,0.6206896551724138,20,9,11,319.4964323708115,0.8015327695560254,0.20888302946311277,0.1891883329314149,131745.12215777647,-381.5806976667325,131363.54146010973,1411,1,606.0909090909091,40,4,15,35.14341219560484,0.6307291666666668,43.34349593495935,1026.6260162601627,25.665650406504067,0
1414,4,0,2,42,0.0,0.045454545454545456,0.9545454545454546,44,1400,1000,400,0.7142857142857143,18,10,8,319.57167832244846,0.7997048978153629,0.21424620200221245,0.18988306600852362,131875.56932257587,-371.2605963712038,131504.30872620468,1412,2,607.0909090909091,40,4,16,35.01038883941822,0.63203125,43.21646341463415,1027.1341463414637,25.678353658536594,0
1415,4,0,1,41,0.0,0.023809523809523808,0.9761904761904762,42,1350,1000,350,0.7407407407407407,17,10,7,322.9307828997585,0.7945702671312428,0.18761132000791636,0.19174726744917514,131849.47472569236,115.65081961795443,131965.12554531032,1412,3,601.0238095238095,40,2,16,34.95035952239594,0.6317708333333333,43.24186991869919,1027.0325203252032,25.67581300813008,0
1416,4,0,0,41,0.0,0.0,1.0,41,700,500,200,0.7142857142857143,9,5,4,332.5188227339494,0.7889227642276423,0.1950873165289111,0.1973692398154131,131835.77609592033,567.5754123264095,132403.35150824673,1413,4,613.6829268292682,39,2,16,34.71796074652602,0.6332799145299145,43.25520833333334,1026.9791666666683,26.332799145299187,0
1417,4,0,0,41,0.0,0.0,1.0,41,950,600,350,0.631578947368421,13,6,7,347.0156652786043,0.7889227642276423,0.21435653380924102,0.203252032520325,131328.12499999974,915.7796223958046,132243.90462239555,1414,5,614.6829268292682,38,3,18,34.857723577235774,0.6299342105263159,43.749999999999986,1024.999999999998,26.97368421052626,1
1418,4,0,0,41,0.0,0.0,1.0,41,1250,1000,250,0.8,15,10,5,345.5425789059512,0.7903455284552846,0.21294392962681608,0.2031147100378578,131465.0463533673,885.3542305865662,132350.40058395386,1415,6,615.6829268292682,38,3,18,34.75730978921415,0.6313048245614037,43.616452991452974,1025.5341880341853,26.987741790373295,0
1419,4,0,1,40,0.0,0.024390243902439025,0.975609756097561,41,1250,1100,150,0.88,14,11,3,348.6482133685327,0.7886178861788617,0.2201633609067799,0.205783915511888,131621.90890841995,977.9486762152584,132599.8575846352,1416,7,616.6829268292682,39,2,15,34.51944388048591,0.6311431623931625,43.46354166666666,1026.1458333333317,26.311431623931583,0
1420,4,1,1,40,0.024390243902439025,0.024390243902439025,0.975609756097561,41,800,500,300,0.625,11,5,6,350.9550592968322,0.7953760162601626,0.21933654776247558,0.20831221731531985,131835.77609591992,1053.6865234374766,132889.4626193574,1417,0,585.7317073170732,39,2,15,34.244619974980544,0.6332799145299146,43.25520833333332,1026.979166666665,26.332799145299102,0
1421,4,0,0,40,0.0,0.0,1.0,40,1300,700,600,0.5384615384615384,19,7,12,355.33181837310144,0.7898771367521368,0.21927278401997574,0.21083021223470647,131821.37573964463,1368.065828402332,133189.44156804695,1418,9,601.375,38,2,16,34.146769662921336,0.6348684210526319,43.26923076923075,1026.9230769230744,27.024291497975643,0
1422,4,0,0,40,0.0,0.0,1.0,40,950,600,350,0.631578947368421,13,6,7,351.73872317401583,0.7882478632478632,0.21234157964108302,0.20936626594238458,131942.77479383664,1281.8766276041483,133224.6514214408,1419,10,602.375,39,1,18,34.1166692013924,0.6343482905982908,43.15104166666666,1027.395833333332,26.34348290598287,0
1423,4,0,0,40,0.0,0.0,1.0,40,1450,1200,250,0.8275862068965517,17,12,5,352.12576051999196,0.7894497863247864,0.20691489361702153,0.21063522765650425,132130.126953125,1305.284288194445,133435.41124131944,1420,11,603.375,39,1,18,33.918017561634585,0.6362179487179487,42.96875,1028.125,26.362179487179485,0
1424,4,0,0,40,0.0,0.0,1.0,40,950,700,250,0.7368421052631579,12,7,5,356.2882037568727,0.788301282051282,0.21300648298217228,0.21342701137668948,132183.6805555554,1419.0972222222026,133602.77777777758,1421,12,604.375,39,1,18,33.75709076175039,0.6367521367521368,42.91666666666666,1028.333333333332,26.36752136752133,0
1425,4,0,0,40,0.0,0.0,1.0,40,1700,1300,400,0.7647058823529411,21,13,8,354.06759597437497,0.7877938034188035,0.21526526273159874,0.21285000885203262,132317.61203341992,1369.8757595485872,133687.48779296852,1422,13,605.375,39,1,18,33.679360298336206,0.6380876068376069,42.78645833333332,1028.854166666665,26.380876068376022,0
1426,4,0,0,40,0.0,0.0,1.0,40,1150,600,550,0.5217391304347826,17,6,11,351.16600419659153,0.7868055555555555,0.21491282689912827,0.21201977546606238,132480.48159105846,1304.5526849369162,133785.03427599536,1423,14,606.375,38,2,18,33.59018264840182,0.6414473684210527,42.628205128205124,1029.487179487179,27.09176788124155,0
1427,4,0,0,40,0.0,0.0,1.0,40,750,300,450,0.4,12,3,9,347.39178567696837,0.7861912393162394,0.2084412300222538,0.2101784083967263,132558.85959201382,1209.9717881944352,133768.83138020826,1424,15,607.375,39,1,18,33.608554184368465,0.6404914529914532,42.55208333333333,1029.791666666666,26.404914529914514,0
1428,4,0,0,40,0.0,0.0,1.0,40,1200,900,300,0.75,15,9,6,353.6961824175009,0.784375,0.21333400727860918,0.21491170985712033,132719.8133680556,1388.4982638888941,134108.3116319445,1425,16,608.375,39,1,14,33.28447230084918,0.642094017094017,42.395833333333336,1030.416666666667,26.420940170940177,0
1429,4,0,0,40,0.0,0.0,1.0,40,700,300,400,0.42857142857142855,11,3,8,353.13438910480147,0.7829059829059829,0.21213996968165683,0.21503167878104718,132800.32687717036,1379.2724609375211,134179.5993381079,1426,17,609.375,39,1,14,33.21806046824995,0.6428952991452991,42.31770833333334,1030.7291666666686,26.42895299145304,0
1430,4,0,0,40,0.0,0.0,1.0,40,850,600,250,0.7058823529411765,11,6,5,361.61474241117054,0.7829059829059829,0.21892998880635006,0.2098988820835541,130981.34901258674,1474.6527777777735,132456.0017903645,1427,18,610.375,39,1,17,34.83440605813914,0.6247329059829061,44.088541666666664,1023.6458333333328,26.247329059829045,5
1431,4,0,0,40,0.0,0.0,1.0,40,1050,800,250,0.7619047619047619,13,8,5,363.1506732935219,0.781784188034188,0.2266834503102435,0.21137562280335187,131088.00048828122,1520.9391276041663,132608.93961588538,1428,19,611.375,39,1,17,34.68715034075883,0.6258012820512822,43.984375,1024.0624999999998,26.258012820512814,0
1432,4,1,1,40,0.024390243902439025,0.024390243902439025,0.975609756097561,41,800,500,300,0.625,11,5,6,356.58477890793995,0.7851626016260163,0.21563060028724368,0.20900616698971755,131355.50356353607,1168.3140924339,132523.81765596996,1429,0,597.439024390244,38,3,17,34.58485322216433,0.6302083333333335,43.72329059829058,1025.106837606835,26.976495726495656,0
1433,4,1,1,40,0.024390243902439025,0.024390243902439025,0.975609756097561,41,1250,900,350,0.72,16,9,7,354.8770369296207,0.7874491869918699,0.20985216416715602,0.2083030534197899,131410.2692513147,1126.8973948060213,132537.16664612072,1430,0,598.4146341463414,38,3,17,34.573304157549224,0.6307565789473686,43.66987179487178,1025.3205128205109,26.982118758434495,0
1434,4,2,1,41,0.047619047619047616,0.023809523809523808,0.9761904761904762,42,1050,800,250,0.7619047619047619,13,8,5,348.71697451710395,0.7960220673635308,0.2103235002778383,0.20640274978174528,131728.82080078125,787.2151692708351,132516.0359700521,1431,0,585.1190476190476,39,3,14,34.409880771182145,0.6322115384615385,43.359375,1026.5625,26.322115384615383,0
1435,4,1,2,40,0.023809523809523808,0.047619047619047616,0.9523809523809523,42,750,500,250,0.6666666666666666,10,5,5,350.1827168377948,0.7957317073170732,0.21415044662483051,0.20756169812809036,131782.2930230034,829.5762803819409,132611.86930338535,1432,0,586.0952380952381,39,3,14,34.31835666700482,0.6327457264957266,43.307291666666664,1026.770833333333,26.327457264957257,0
1436,4,0,0,40,0.0,0.0,1.0,40,1050,700,350,0.6666666666666666,14,7,7,356.63574515360256,0.7887820512820513,0.22076482830385058,0.21129898341098124,131766.5244448095,1398.5305263349887,133165.0549711445,1433,2,607.775,38,2,14,34.16861775927851,0.6343201754385965,43.32264957264956,1026.7094017094,27.018668466036843,0
1437,4,0,0,40,0.0,0.0,1.0,40,800,500,300,0.625,11,5,6,359.06339873852636,0.7871260683760684,0.21820486815415863,0.21327500672059435,131862.5217013887,1469.401041666647,133331.92274305536,1434,3,608.775,39,1,14,34.009465855307646,0.6335470085470087,43.22916666666666,1027.0833333333317,26.335470085470043,0
1438,4,2,0,42,0.047619047619047616,0.0,1.0,42,1150,600,550,0.5217391304347826,17,6,11,348.6370863315251,0.7982481610530391,0.2156352419510319,0.2100325861558211,132398.00347222213,833.9409722222133,133231.94444444435,1435,0,580.7380952380952,39,3,17,33.73819163292849,0.6388888888888891,42.70833333333333,1029.1666666666658,26.388888888888868,0
1439,4,0,0,42,0.0,0.0,1.0,42,900,500,400,0.5555555555555556,13,5,8,339.2603457380404,0.7979094076655052,0.19915634535989968,0.189875365291001,129563.94184989615,399.8620969913849,129963.80394688754,1436,1,581.7380952380952,37,5,15,36.842016693591816,0.6140202702702702,45.47697368421053,1018.092105263158,27.51600284495022,7
1440,4,1,1,42,0.023255813953488372,0.023255813953488372,0.9767441860465116,43,1600,1200,400,0.75,20,12,8,336.46930533234166,0.804171280915467,0.1901804452265985,0.189843503381187,129881.14458917743,140.2036991379921,130021.34828831542,1437,0,569.1860465116279,38,5,15,36.591202878803756,0.6154057017543859,45.16559829059829,1019.3376068376068,26.82467386414755,0
1441,4,0,0,42,0.0,0.0,1.0,42,1050,600,450,0.5714285714285714,15,6,9,344.9973146627626,0.7949574138598529,0.19533438846120355,0.19474438581783274,129899.05698147506,562.9651671668184,130462.02214864189,1438,3,583.7380952380952,37,5,16,36.35570166003368,0.6173986486486487,45.14802631578947,1019.4078947368421,27.551564722617353,0
1442,4,0,0,42,0.0,0.0,1.0,42,950,700,250,0.7368421052631579,12,7,5,343.5323817121344,0.7947396438250097,0.18323915980837735,0.19489178533229867,130094.74068944289,538.3512234533681,130633.09191289626,1439,4,584.7380952380952,37,5,17,36.194557896245335,0.6193693693693694,44.95614035087719,1020.1754385964912,27.57230915125652,0
1443,4,2,0,44,0.045454545454545456,0.0,1.0,44,1150,900,250,0.782608695652174,14,9,5,367.39756878898186,0.8045058139534884,0.30212628617673065,0.19302691865773036,127038.15563591223,540.5210029981608,127578.6766389104,1440,0,559.1136363636364,38,6,16,38.71056768404691,0.5866228070175438,47.97008547008548,1008.1196581196597,26.529464687359464,8
1444,4,4,1,47,0.08333333333333333,0.020833333333333332,0.9791666666666666,48,1450,1300,150,0.896551724137931,16,13,3,353.0986275574288,0.8346077127659575,0.28243017309205376,0.18621923469937413,127192.06664147125,-608.137469046367,126583.92917242488,1441,0,513.4375,41,7,18,38.91292945187515,0.5833333333333335,47.81746031746031,1008.7301587301574,24.603174603174573,5
1445,4,2,1,48,0.04081632653061224,0.02040816326530612,0.9795918367346939,49,1300,600,700,0.46153846153846156,20,6,14,349.27511011902044,0.8413052721088435,0.2865442359564203,0.18598275271199685,127581.01695360815,-887.8252508864066,126693.19170272174,1442,0,503.9183673469388,42,7,17,38.61060489801136,0.5858134920634923,47.43217054263564,1010.2713178294541,24.054078995939385,0
1446,4,2,3,47,0.04,0.06,0.94,50,1100,700,400,0.6363636363636364,15,7,8,358.8545106606375,0.8473979591836734,0.22576131687242795,0.19378143575674445,128144.53125000015,-782.501145514076,127362.03010448607,1443,0,494.58,42,8,16,37.791495198902616,0.5915178571428571,46.87500000000001,1012.5000000000011,24.107142857142883,4
1447,4,2,0,49,0.04081632653061224,0.0,1.0,49,1250,700,550,0.56,18,7,11,358.4556236600825,0.8450963718820862,0.25317284310660604,0.19446167603690073,128329.16802300379,-599.9376085069082,127729.23041449688,1444,0,505.59183673469386,39,10,19,37.612766012131196,0.598023504273504,46.69270833333335,1013.2291666666692,25.98023504273511,0
1448,4,2,1,50,0.0392156862745098,0.0196078431372549,0.9803921568627451,51,1100,600,500,0.5454545454545454,16,6,10,345.386922275286,0.8553594771241831,0.25075654345405396,0.1894720429918744,128773.09032698757,-1304.6917320168536,127468.39859497071,1445,0,486.72549019607845,41,10,16,37.490938487603046,0.5993394308943087,46.25496031746033,1014.9801587301611,24.755613627564905,0
1449,4,2,3,49,0.038461538461538464,0.057692307692307696,0.9423076923076923,52,1300,1000,300,0.7692307692307693,16,10,6,341.488604784871,0.8595713926596279,0.26357358194394465,0.188781813304109,129078.27546609301,-1584.2479606093175,127494.0275054837,1446,0,478.3269230769231,42,10,16,37.279091573694416,0.6009424603174602,45.954457364341096,1016.1821705426374,24.19481358434851,0
1450,4,2,0,51,0.0392156862745098,0.0,1.0,51,1550,1000,550,0.6451612903225806,21,10,11,354.7017336346305,0.8527450980392157,0.30056434338441274,0.19724068365664024,129310.02995105549,-1026.5255876322833,128283.50436342321,1447,0,488.5686274509804,38,13,20,36.70737044817927,0.6096491228070176,45.72649572649572,1017.0940170940163,26.765632028789902,0
1451,4,0,0,51,0.0,0.0,1.0,51,1550,1200,350,0.7741935483870968,19,12,7,354.56504144478697,0.8520261437908497,0.301966001834159,0.19808204802498658,129492.78564453131,-1017.2770182291631,128475.50862630215,1448,1,489.5686274509804,39,12,13,36.52485671886192,0.609775641025641,45.546875,1017.8125000000005,26.097756410256423,0
1452,4,0,1,50,0.0,0.0196078431372549,0.9803921568627451,51,1300,800,500,0.6153846153846154,18,8,10,355.8866664430022,0.8522222222222223,0.3120007540706775,0.19962730566914708,129651.86767578131,-971.7258029513864,128680.14187282992,1449,2,490.5686274509804,39,12,14,36.32941682861136,0.6113782051282051,45.390625,1018.4375000000005,26.11378205128206,0
1453,4,1,2,49,0.0196078431372549,0.0392156862745098,0.9607843137254902,51,1250,1200,50,0.96,13,12,1,354.93566456536547,0.8545098039215687,0.3156892803110001,0.20017553186006345,129864.12896050344,-981.3178168402792,128882.81114366316,1450,0,491.27450980392155,39,12,14,36.137902401635145,0.6135149572649572,45.182291666666664,1019.270833333333,26.135149572649564,0
1454,4,2,4,47,0.0392156862745098,0.0784313725490196,0.9215686274509804,51,1700,1300,400,0.7647058823529411,21,13,8,349.3903119753848,0.855326797385621,0.3045124076188186,0.19771856382884503,129996.88042534732,-1116.0698784722144,128880.8105468751,1451,0,492.11764705882354,39,12,14,36.14445011916921,0.6148504273504274,45.052083333333336,1019.7916666666674,26.148504273504294,0
1455,4,0,0,47,0.0,0.0,1.0,47,1550,800,750,0.5161290322580645,23,8,15,376.0314112200061,0.8359158186864014,0.3116658660864817,0.2097419649249368,129430.4693206721,333.9844067040128,129764.45372737611,1452,5,532.2340425531914,36,11,14,36.042173897004574,0.6145833333333334,45.60810810810811,1017.5675675675682,28.26576576576578,0
1456,4,2,1,48,0.04081632653061224,0.02040816326530612,0.9795918367346939,49,1100,800,300,0.7272727272727273,14,8,6,362.54387102035037,0.8469387755102041,0.32674738775093326,0.20530173748757952,130023.43885633677,-372.15983072917015,129651.2790256076,1453,0,511.46938775510205,39,10,16,35.782117080311856,0.6151175213675215,45.026041666666664,1019.895833333333,26.151175213675206,0
1457,4,0,0,48,0.0,0.0,1.0,48,1550,1100,450,0.7096774193548387,20,11,9,351.3824145291963,0.8468713061465721,0.28970439296113426,0.19982503184781283,130188.40889970551,-450.81650742143705,129737.59239228407,1454,1,520.5833333333334,42,6,18,35.89932269907582,0.6121031746031746,44.86434108527131,1020.5426356589144,24.298634182355105,1
1458,4,0,1,47,0.0,0.020833333333333332,0.9791666666666666,48,1050,700,350,0.6666666666666666,14,7,7,352.49686178765165,0.8443410165484634,0.29801611587107346,0.2013915636926654,130368.94531250009,-409.00780170210635,129959.93751079799,1455,2,521.5833333333334,39,9,18,35.687814497484034,0.6185897435897435,44.68750000000001,1021.2500000000007,26.185897435897452,0
1459,4,2,1,48,0.04081632653061224,0.02040816326530612,0.9795918367346939,49,1150,700,450,0.6086956521739131,16,7,9,347.1075617730544,0.8472222222222222,0.30798804881754216,0.20179507702616992,131041.82287535531,-702.8784742877895,130338.94440106752,1456,0,492.44897959183675,40,9,16,35.14454094292804,0.6236979166666667,44.02947154471545,1023.8821138211384,25.59705284552846,0
1460,4,1,0,49,0.02040816326530612,0.0,1.0,49,1200,700,500,0.5833333333333334,17,7,10,346.09879202741104,0.8456986961451247,0.3048571873943511,0.20202790517824726,131197.94894118904,-718.509670996106,130479.43927019293,1457,0,493.3673469387755,40,9,18,35.01264755480608,0.6252604166666667,43.8770325203252,1024.4918699186987,25.61229674796747,0
1461,4,0,0,49,0.0,0.0,1.0,49,700,300,400,0.42857142857142855,11,3,8,346.35829173448934,0.8451672335600907,0.30403568746748877,0.2024539510468905,131250.01161882828,-708.0940371141328,130541.91758171415,1458,1,494.3673469387755,40,9,18,34.953428212502885,0.62578125,43.82621951219513,1024.6951219512212,25.61737804878053,0
1462,4,0,1,48,0.0,0.02040816326530612,0.9795918367346939,49,1750,1000,750,0.5714285714285714,25,10,15,344.82617187500006,0.844812925170068,0.2939030612244895,0.20283892463235276,131492.43918474668,-731.546637771211,130760.89254697546,1459,2,495.3673469387755,38,11,20,34.74804687499997,0.6315789473684212,43.58974358974358,1025.641025641024,26.990553306342736,0
1463,4,0,0,48,0.0,0.0,1.0,48,1500,900,600,0.6,21,9,12,342.661318492166,0.8439531619385343,0.2867861009608883,0.20239204495112784,131648.6328124997,-577.8211805555853,131070.81163194412,1460,3,502.8541666666667,39,9,16,34.64609554743537,0.6314102564102566,43.437499999999986,1026.2499999999977,26.314102564102505,0
1464,4,0,1,47,0.0,0.020833333333333332,0.9791666666666666,48,1300,1000,300,0.7692307692307693,16,10,6,308.96318952702376,0.844636524822695,0.15148386194304586,0.18129364138187565,131397.7673824433,-1480.5853385580763,129917.18204388523,1461,4,503.8541666666667,45,3,16,35.76278455104985,0.6201388888888888,43.682065217391305,1025.271739130435,22.783816425120776,8
1465,4,0,0,47,0.0,0.0,1.0,47,1250,900,350,0.72,16,9,7,311.7422847901662,0.8400400863398088,0.15271730985747767,0.18304528429301695,131423.04955418373,-1205.975651577508,130217.07390260622,1462,6,515.4893617021277,44,3,16,35.66612485702245,0.6216856060606061,43.657407407407405,1025.3703703703698,23.30387205387204,0
1466,4,0,0,47,0.0,0.0,1.0,47,1200,900,300,0.75,15,9,6,311.1559840477522,0.8403484427998766,0.14715031876488172,0.1833834203855903,131565.50068587126,-1212.5214334704897,130352.97925240076,1463,7,516.4893617021277,44,3,15,35.53794374247893,0.6231060606060606,43.518518518518526,1025.9259259259275,23.31649831649835,0
1467,4,0,0,47,0.0,0.0,1.0,47,1250,900,350,0.72,16,9,7,309.9115350871146,0.8392306506321306,0.15284129525740386,0.18287750968239677,131613.00154321018,-1242.3225308641695,130370.67901234601,1464,8,517.4893617021277,44,3,15,35.52213048186248,0.6235795454545453,43.472222222222236,1026.1111111111136,23.320707070707126,0
1468,4,0,0,47,0.0,0.0,1.0,47,1750,1400,350,0.8,21,14,7,309.939185109772,0.8380743139068763,0.1670598435925299,0.18387129992618975,131816.00934841688,-1229.010695625915,130586.99865279096,1465,9,518.4893617021277,45,2,15,35.317525947487574,0.6243055555555554,43.27445652173913,1026.902173913044,22.820048309178755,0
1469,4,0,1,46,0.0,0.02127659574468085,0.9787234042553191,47,1150,900,250,0.782608695652174,14,9,5,309.9065676363685,0.8388837496145544,0.16369902462727004,0.18430258959433982,131909.04225904506,-1224.1042946597195,130684.93796438535,1466,10,519.4893617021277,45,2,15,35.22497648649441,0.6252314814814814,43.18387681159421,1027.2644927536248,22.82809983896944,0
1470,4,0,0,46,0.0,0.0,1.0,46,1250,800,450,0.64,17,8,9,336.5013797661793,0.8344202898550724,0.25085255767301917,0.18253094430189373,128324.66310562493,-467.252292891409,127857.41081273352,1467,11,531.304347826087,40,6,18,38.17347876964227,0.5963541666666667,46.697154471544714,1013.2113821138208,25.33028455284552,7
1471,4,2,1,47,0.041666666666666664,0.020833333333333332,0.9791666666666666,48,1250,800,450,0.64,17,8,9,327.4262507048833,0.8426972517730497,0.2567840095465397,0.17966422085561284,128783.0426826061,-1166.6102360134737,127616.43244659263,1468,0,510.125,42,6,15,37.9365552903739,0.5979662698412699,46.245155038759684,1015.0193798449603,24.167128091546676,0
1472,4,0,0,47,0.0,0.0,1.0,47,1400,1000,400,0.7142857142857143,18,10,8,333.5902245462435,0.8429694727104532,0.2531937769440815,0.18300062130469796,128773.09032698724,-808.5111764613272,127964.57915052591,1469,1,520.0212765957447,41,6,15,37.79027384094093,0.599339430894309,46.254960317460316,1014.9801587301583,24.755613627564838,0
1473,4,3,1,49,0.06,0.02,0.98,50,1300,1000,300,0.7692307692307693,16,10,6,316.47975111062755,0.8557993197278911,0.2573408714299643,0.17674282888644097,129478.90216561129,-1802.3766219451031,127676.52554366618,1470,0,489.76,41,9,15,37.508021412093456,0.6064532520325204,45.56051587301586,1017.7579365079339,24.823364305071557,0
1474,4,1,2,48,0.02,0.04,0.96,50,1400,1000,400,0.7142857142857143,18,10,8,312.1239420339093,0.85578231292517,0.243454456892352,0.17498373921234728,129630.3985280455,-1907.8498007999533,127722.54872724554,1471,0,490.74,41,9,15,37.46539616820912,0.6079776422764227,45.41170634920635,1018.3531746031748,24.83788230739451,0
1475,4,1,1,48,0.02040816326530612,0.02040816326530612,0.9795918367346939,49,1100,800,300,0.7272727272727273,14,8,6,319.32551029578417,0.8504109977324263,0.2455823730829798,0.17883299539706327,129589.12854658268,-1523.7770796153063,128065.35146696738,1472,0,501.3673469387755,40,9,15,37.323876301693474,0.6091145833333333,45.452235772357724,1018.1910569105687,25.45477642276422,0
1476,4,1,2,47,0.02040816326530612,0.04081632653061224,0.9591836734693877,49,1500,1200,300,0.8,18,12,6,319.5453347886635,0.8543083900226758,0.23963941404782751,0.1796065157605246,129731.44531250001,-1508.9843749999993,128222.46093750001,1473,0,502.3469387755102,41,8,15,37.174079754601216,0.6089939024390244,45.3125,1018.7500000000001,24.84756097560976,0
1477,4,3,5,45,0.06,0.1,0.9,50,1250,900,350,0.72,16,9,7,310.7170500896148,0.8609013605442176,0.23886778115501506,0.1762515680680747,130089.53788834809,-1915.7925079622576,128173.74538038584,1474,0,492.72,42,8,16,37.03675120314086,0.611111111111111,44.96124031007752,1020.1550387596902,24.28940568475453,0
1478,4,1,2,44,0.021739130434782608,0.043478260869565216,0.9565217391304348,46,1300,800,500,0.6153846153846154,18,8,10,333.88000414637776,0.8503019323671498,0.25050543200551,0.18830062481684756,129864.1289605034,-528.1928168402817,129335.93614366312,1475,0,510.2608695652174,39,7,17,36.6744379151763,0.6135149572649572,45.182291666666664,1019.2708333333327,26.135149572649556,0
1479,4,0,0,44,0.0,0.0,1.0,44,1250,900,350,0.72,16,9,7,342.46260261541227,0.8424726920366455,0.2613403978434652,0.19248760078038685,129731.4453125,85.63368055555515,129817.07899305556,1476,1,532.25,37,7,18,36.59040558963871,0.6157094594594594,45.3125,1018.75,27.533783783783782,0
1480,4,1,0,45,0.022222222222222223,0.0,1.0,45,1350,1100,250,0.8148148148148148,16,11,5,330.96245033961304,0.8483585858585859,0.2590413943355121,0.1875453885257807,130050.0,-391.6666666666663,129658.33333333333,1477,0,521.4,39,6,19,36.56045751633987,0.6153846153846154,45.0,1020.0,26.153846153846153,0
1481,4,1,1,45,0.021739130434782608,0.021739130434782608,0.9782608695652174,46,800,400,400,0.5,12,4,8,324.798277887481,0.8537640901771337,0.2564827053928649,0.18531273107410307,130315.76063368065,-734.5594618055504,129581.2011718751,1478,0,511.04347826086956,39,7,20,36.44876895871588,0.6180555555555556,44.739583333333336,1021.0416666666674,26.180555555555575,0
1482,4,1,1,45,0.021739130434782608,0.021739130434782608,0.9782608695652174,46,1400,1100,300,0.7857142857142857,17,11,6,322.74355099114007,0.8501006441223833,0.25355401058420646,0.18524595597984606,130548.03688280779,-773.2926003040623,129774.74428250373,1479,0,511.2608695652174,40,6,15,36.26649098382391,0.6187500000000001,44.512195121951216,1021.9512195121946,25.548780487804866,0
1483,4,0,0,45,0.0,0.0,1.0,45,950,600,350,0.631578947368421,13,6,7,331.55356730987404,0.8465488215488216,0.2554275290891994,0.18981586892048646,130448.74267578122,-349.8508029513893,130098.89187282983,1480,2,523.6222222222223,39,6,20,36.141807722375184,0.6193910256410258,44.609375,1021.5624999999998,26.193910256410252,0
1484,4,1,1,45,0.021739130434782608,0.021739130434782608,0.9782608695652174,46,1250,800,450,0.64,17,8,9,324.3314510020832,0.8508454106280193,0.2529088481695745,0.1870342344661298,130729.84959556157,-720.0396382774782,130009.80995728409,1481,0,513.2173913043479,40,6,16,36.04230845672264,0.6205729166666667,44.334349593495936,1022.6626016260168,25.56656504065042,0
1485,4,0,1,44,0.0,0.022222222222222223,0.9777777777777777,45,1050,600,450,0.5714285714285714,15,6,9,343.3491244911186,0.84503367003367,0.24076434650054646,0.18840443659835665,128783.68975309674,-153.7148593283531,128629.97489376839,1482,1,525.5555555555555,37,8,19,37.53184527024593,0.6061373873873875,46.24451754385963,1015.0219298245584,27.433025130393467,7
1486,4,0,0,44,0.0,0.0,1.0,44,1350,1000,350,0.7407407407407407,17,10,7,346.7096045767822,0.8460183227625089,0.2282689778371063,0.19091702482700063,128922.84765504742,139.75790627882537,129062.60556132624,1483,2,527.4772727272727,37,7,19,37.30475779169365,0.6075450450450453,46.10745614035086,1015.5701754385941,27.44784257942146,0
1487,4,0,0,44,0.0,0.0,1.0,44,1300,900,400,0.6923076923076923,17,9,8,350.8361477503265,0.8466349541930938,0.23020559500922078,0.19400652848150488,129089.93632656183,257.88319482916154,129347.819521391,1484,3,528.4772727272727,37,7,19,37.02974392173788,0.6092342342342343,45.94298245614034,1016.228070175437,27.465623518255054,0
1488,4,0,0,44,0.0,0.0,1.0,44,1350,900,450,0.6666666666666666,18,9,9,348.91877725409495,0.8460183227625089,0.2335479616186229,0.19363169267530586,129230.01284646144,218.20370510419795,129448.21655156564,1485,4,529.4772727272727,36,8,19,36.93584560859454,0.6125578703703705,45.80518018018019,1016.7792792792801,28.24386886886889,0
1489,4,1,1,44,0.022222222222222223,0.022222222222222223,0.9777777777777777,45,1050,800,250,0.7619047619047619,13,8,5,345.7863045779677,0.8523148148148149,0.23821149887500614,0.19339036456035244,129536.03512619257,-41.64262080641589,129494.39250538615,1486,0,518.6888888888889,37,8,13,36.70427617406289,0.6137387387387387,45.504385964912274,1017.98245614035,27.513039355144596,0
1490,4,1,2,43,0.022222222222222223,0.044444444444444446,0.9555555555555556,45,1400,800,600,0.5714285714285714,20,8,12,342.9081140160283,0.8507154882154883,0.23170230066484954,0.1928754355591364,129759.37307633106,-100.89162049862676,129658.48145583243,1487,0,519.6666666666666,37,8,15,36.55070670110491,0.615990990990991,45.28508771929824,1018.8596491228061,27.536747273589356,0
1491,4,0,1,42,0.0,0.023255813953488372,0.9767441860465116,43,1000,500,500,0.5,15,5,10,363.6962602993924,0.8386397194536729,0.24639106570639968,0.2035033273278276,129554.63927469116,823.7075617283724,130378.34683641953,1488,11,544.6976744186046,35,8,15,36.22953615279673,0.6178571428571429,45.4861111111111,1018.0555555555538,29.08730158730154,0
1492,4,3,3,42,0.06666666666666667,0.06666666666666667,0.9333333333333333,45,1150,900,250,0.782608695652174,14,9,5,342.0241566014162,0.8513468013468014,0.23564625850340137,0.1948742287612719,130262.58680555539,-87.48070987656257,130175.10609567883,1489,0,520.3777777777777,36,9,17,36.06292517006802,0.6229745370370372,44.79166666666666,1020.833333333332,28.356481481481445,0
1493,4,1,1,42,0.023255813953488372,0.023255813953488372,0.9767441860465116,43,1050,800,250,0.7619047619047619,13,8,5,357.3841484161371,0.8384551495016611,0.255254129345057,0.20227942800353355,130004.05811216618,692.2779198117004,130696.33603197789,1490,0,545.2790697674419,36,7,18,35.93335909893993,0.6203703703703705,45.04504504504504,1019.8198198198195,28.32832832832832,0
1494,4,1,1,42,0.023255813953488372,0.023255813953488372,0.9767441860465116,43,1350,1000,350,0.7407407407407407,17,10,7,355.62483153023646,0.8397009966777408,0.2555264009201679,0.2015800828536222,130061.48674011853,650.6188621053491,130712.10560222388,1491,0,546.2558139534884,36,7,18,35.91990505630381,0.6209490740740742,44.98873873873874,1020.0450450450453,28.33458458458459,0
1495,4,0,0,42,0.0,0.0,1.0,42,1400,1000,400,0.7142857142857143,18,10,8,366.4087519946352,0.8335994967092528,0.2689560335651342,0.20766304381535158,130055.90284475725,1130.724210176597,131186.62705493384,1492,3,560.2619047619048,35,7,18,35.65057774499791,0.6229166666666668,44.994212962962955,1020.0231481481471,29.14351851851849,0
1496,4,1,1,42,0.023255813953488372,0.023255813953488372,0.9767441860465116,43,1000,700,300,0.7,13,7,6,359.9639429075138,0.8341177556293835,0.2620615480326667,0.20540762641203617,130321.66950660117,782.3845003857631,131104.05400698693,1493,0,548.2093023255813,35,8,18,35.54513337867452,0.6255952380952383,44.733796296296276,1021.0648148148122,29.173280423280346,0
1497,4,1,0,43,0.023255813953488372,0.0,1.0,43,1350,1200,150,0.8888888888888888,15,12,3,356.5869904563105,0.8391472868217054,0.2694825408456336,0.20498670755997,130607.69120049085,714.6007071260251,131322.2919076169,1494,0,549.1860465116279,36,7,17,35.34138481877272,0.6264467592592593,44.45382882882882,1022.1846846846832,28.39401901901898,0
1498,4,1,1,43,0.022727272727272728,0.022727272727272728,0.9772727272727273,44,1100,900,200,0.8181818181818182,13,9,4,351.8949219798533,0.8411953840732911,0.26185558975957623,0.20371485185583035,130878.94833025518,411.1274622960584,131290.07579255124,1495,0,537.6818181818181,37,7,17,35.18672310330047,0.6272522522522523,44.188596491228054,1023.2456140350855,27.65528686581312,0
1499,4,1,0,44,0.022727272727272728,0.0,1.0,44,1650,1200,450,0.7272727272727273,21,12,9,352.22076954596685,0.8413495419309374,0.27749851582953,0.2052460516736663,131131.5155264117,437.4486620883077,131568.96418850002,1496,0,538.6590909090909,37,7,19,34.92298736751953,0.6297860360360361,43.94188596491227,1024.2324561403489,27.681958274063483,0
1500,4,1,1,44,0.022222222222222223,0.022222222222222223,0.9777777777777777,45,1000,700,300,0.7,13,7,6,344.24237734591844,0.8448232323232324,0.2711877647173706,0.2017796755299354,131356.983567182,44.022622619339984,131401.00618980135,1497,0,527.6666666666666,36,9,19,34.899666776520554,0.6339699074074074,43.721846846846844,1025.1126126126123,28.475350350350343,0
1501,4,0,0,44,0.0,0.0,1.0,44,1200,900,300,0.75,15,9,6,353.02687100256156,0.8412394291754757,0.27990264255911046,0.206621300141574,131300.0289151467,470.487674091998,131770.5165892387,1498,2,540.6590909090909,37,7,20,34.732066438429435,0.6314752252252254,43.77741228070174,1024.8903508771907,27.699739212897047,0
1502,4,1,0,45,0.022222222222222223,0.0,1.0,45,1350,1000,350,0.7407407407407407,17,10,7,349.9752565907453,0.8435606060606061,0.287282091447423,0.20726238630355148,131749.92696069946,221.84590450908132,131971.77286520854,1499,0,529.6222222222223,37,8,19,34.35630940937733,0.6359797297297298,43.338815789473685,1026.6447368421054,27.747155049786635,0
1503,4,1,0,46,0.021739130434782608,0.0,1.0,46,950,600,350,0.631578947368421,13,6,7,343.20672023374743,0.8439412238325282,0.287367802585194,0.2048169136878815,132040.8950617284,-136.53549382715647,131904.35956790124,1500,0,519.0869565217391,38,8,20,34.23704954954956,0.6370614035087719,43.05555555555556,1027.7777777777778,27.046783625730995,0
1504,4,0,1,45,0.0,0.021739130434782608,0.9782608695652174,46,900,600,300,0.6666666666666666,12,6,6,345.0238167132491,0.8434983896940419,0.29194870450868926,0.2061999481003033,132095.80342793482,-84.76034589817004,132011.04308203666,1501,1,520.0869565217391,38,8,21,34.135098385644014,0.637609649122807,43.00213675213675,1027.9914529914527,27.052406657669806,0
1505,4,0,0,45,0.0,0.0,1.0,45,1400,800,600,0.5714285714285714,20,8,12,351.8778328885574,0.8423400673400674,0.2855626628760959,0.21103670540247255,132228.78674207453,305.6757848568871,132534.46252693143,1498,2,499.2888888888889,37,8,21,33.82507107320539,0.6407657657657657,42.87280701754386,1028.5087719298251,27.79753437648176,0
1506,4,0,0,45,0.0,0.0,1.0,45,1750,1400,350,0.8,21,14,7,349.33425370133546,0.8402356902356902,0.283499252452321,0.2107765289164298,132455.95838659626,254.38888062655252,132710.34726722282,1499,3,500.2888888888889,36,9,22,33.66198081902055,0.6449652777777777,42.65202702702704,1029.3918918918935,28.594219219219262,0
1507,4,0,0,45,0.0,0.0,1.0,45,1500,1200,300,0.8,18,12,6,348.4152183531273,0.8377946127946129,0.283159463487332,0.2111621007231796,132623.794100108,241.62963604188099,132865.42373614988,1500,4,501.2888888888889,37,8,22,33.5169611808956,0.6447072072072071,42.48903508771931,1030.043859649125,27.839023233760134,0
1508,4,0,0,45,0.0,0.0,1.0,45,1550,1200,350,0.7741935483870968,19,12,7,347.4384596687382,0.8366161616161617,0.27800714099926704,0.2112048281996638,132736.76155163138,223.5711949830873,132960.33274661447,1501,5,502.2888888888889,37,8,20,33.42865503298573,0.6458333333333333,42.37938596491229,1030.4824561403518,27.85087719298248,0
1509,4,0,0,45,0.0,0.0,1.0,45,1550,1200,350,0.7741935483870968,19,12,7,347.9555848595173,0.835479797979798,0.2818407431043042,0.21215813286959684,132849.7770948754,245.16437750077898,133094.94147237617,1502,6,503.2888888888889,37,8,20,33.30186839679503,0.6469594594594594,42.26973684210527,1030.9210526315794,27.862731152204848,0
1510,4,0,0,45,0.0,0.0,1.0,45,950,700,250,0.7368421052631579,12,7,5,344.7399380302448,0.8350168350168351,0.27669336357407825,0.21083380085256712,132962.84072983998,167.52029470606743,133130.36102454606,1503,7,504.2888888888889,37,8,20,33.27131618116095,0.6480855855855856,42.16008771929825,1031.3596491228072,27.874585111427223,0
1511,4,0,0,45,0.0,0.0,1.0,45,1550,1200,350,0.7741935483870968,19,12,7,345.38681633900853,0.8345959595959597,0.27801267750274494,0.21235310922267062,133160.81781173052,198.3981850184701,133359.215996749,1504,8,505.2888888888889,37,8,20,33.05612362335778,0.6500563063063063,41.968201754385966,1032.127192982456,27.89532954006638,0
1512,4,0,0,45,0.0,0.0,1.0,45,1550,1000,550,0.6451612903225806,21,10,11,346.04325037590365,0.8337542087542088,0.2796280562635709,0.21324235900127667,133245.71021852872,221.7557325330813,133467.4659510618,1505,9,506.2888888888889,37,8,20,32.95410294534127,0.6509009009009008,41.8859649122807,1032.4561403508767,27.904220009483154,0
1513,4,0,0,45,0.0,0.0,1.0,45,1350,1000,350,0.7407407407407407,17,10,7,345.60067796304565,0.8333333333333334,0.27807501769285214,0.21361931669369344,133358.94217451513,217.78816558939917,133576.73034010452,1506,10,507.2888888888889,37,8,20,32.85208775654635,0.6520270270270271,41.77631578947368,1032.8947368421045,27.91607396870553,0
1514,4,0,0,45,0.0,0.0,1.0,45,1300,1000,300,0.7692307692307693,16,10,6,344.48475267005074,0.8329545454545455,0.27445153743731376,0.21375290872764993,133502.12358807004,197.98538847362101,133700.10897654365,1507,11,508.2888888888889,35,10,20,32.73754526449396,0.6574404761904763,41.637731481481474,1033.4490740740732,29.527116402116377,0
1515,4,1,0,46,0.021739130434782608,0.0,1.0,46,1350,1000,350,0.7407407407407407,17,10,7,336.97495949283035,0.8371980676328503,0.26547349802162157,0.21134263406331025,133897.45071800912,-175.98239362114583,133721.46832438797,1508,0,498.2173913043478,37,9,19,32.53644012430696,0.6573761261261263,41.255482456140335,1034.9780701754364,27.972380275011794,0
1516,4,0,0,46,0.0,0.0,1.0,46,900,500,400,0.5555555555555556,13,5,8,336.5351178769503,0.8365338164251208,0.2661679169947919,0.21139241835504216,133954.1989482339,-183.94157336874136,133770.25737486518,1509,1,499.2173913043478,37,9,19,32.49115118454966,0.6579391891891893,41.200657894736835,1035.1973684210514,27.978307254623008,0
1517,4,0,0,46,0.0,0.0,1.0,46,1050,900,150,0.8571428571428571,12,9,3,337.2740320607995,0.836694847020934,0.2687022830461492,0.21202006729148254,133982.5775719451,-162.23116728225276,133820.34640466285,1510,2,500.2173913043478,37,9,19,32.443691308338636,0.6582207207207207,41.17324561403508,1035.3070175438586,27.98127074442861,0
1518,4,0,0,46,0.0,0.0,1.0,46,1250,1000,250,0.8,15,10,5,336.1342125794336,0.8353462157809984,0.26939579765390476,0.2116301002400111,134039.34383656492,-188.9581409664728,133850.38569559844,1511,3,501.2173913043478,37,9,19,32.41652548355215,0.6587837837837839,41.11842105263157,1035.5263157894722,27.98719772403979,0
1519,4,0,0,46,0.0,0.0,1.0,46,1250,700,550,0.56,18,7,11,334.83811329771623,0.8351650563607086,0.2670038743004737,0.21136655901918314,134135.4372123601,-217.2686554898305,133918.16855687025,1512,4,502.2173913043478,38,8,20,32.35419245049505,0.6578947368421053,41.025641025641015,1035.8974358974342,27.260458839406162,0
1520,4,0,0,46,0.0,0.0,1.0,46,1200,900,300,0.75,15,9,6,335.7341152736977,0.8348631239935588,0.26033835850401466,0.21241260169860338,134218.45465565397,-187.6571745562319,134030.79748109775,1513,5,503.2173913043478,38,8,20,32.24816991442417,0.658717105263158,40.94551282051281,1036.2179487179471,27.2688933873144,0
1521,4,0,0,46,0.0,0.0,1.0,46,1150,900,250,0.782608695652174,14,9,5,338.8543482542511,0.8339170692431562,0.2627000165793638,0.21503621589999966,134329.18453000564,-96.39434491199586,134232.79018509365,1514,6,504.2173913043478,38,8,20,32.05688103335738,0.6598135964912282,40.8386752136752,1036.6452991452975,27.28013945119204,0
1522,4,0,0,46,0.0,0.0,1.0,46,1400,1100,300,0.7857142857142857,17,11,6,343.3070964072678,0.8332125603864735,0.2699800667847889,0.21902992750783698,134524.42329301356,36.637831317349026,134561.0611243309,1515,7,505.2173913043478,40,6,20,31.746750914315562,0.6583333333333332,40.650406504065046,1037.3983739837408,25.93495934959352,0
1523,4,0,0,46,0.0,0.0,1.0,46,1000,500,500,0.5,15,5,10,341.030108543909,0.8334943639291466,0.26540668691333313,0.21790465342005455,134579.22299409422,-20.87884902844587,134558.34414506578,1516,8,506.2173913043478,37,9,20,31.751184437634294,0.664132882882883,40.59758771929824,1037.609649122806,28.04350403034611,0
1524,4,0,1,45,0.0,0.021739130434782608,0.9782608695652174,46,950,800,150,0.8421052631578947,11,8,3,342.4290955445438,0.8332528180354267,0.2694159259514457,0.21914072950162997,134636.11549948054,20.664651623567238,134656.78015110412,1517,9,507.2173913043478,37,9,21,31.658192463461877,0.6646959459459459,40.54276315789473,1037.8289473684206,28.049431009957313,0
1525,4,0,0,45,0.0,0.0,1.0,45,900,600,300,0.6666666666666666,12,6,6,351.9218350634163,0.8307659932659933,0.27060667438271624,0.22522997444058648,134638.4222059899,476.44012255500115,135114.8623285449,1518,10,518.4666666666667,36,9,21,31.409595630787045,0.6666666666666665,40.54054054054055,1037.8378378378386,28.82882882882885,0
1526,4,0,0,45,0.0,0.0,1.0,45,1000,600,400,0.6,14,6,8,351.54953793696785,0.8296296296296297,0.27329138641787787,0.22535352160660457,134696.86536198377,470.52415591268925,135167.38951789646,1519,11,519.4666666666667,36,9,21,31.360969480002893,0.6672453703703702,40.48423423423424,1038.0630630630644,28.835085085085122,0
1527,4,0,0,45,0.0,0.0,1.0,45,800,500,300,0.625,11,5,6,348.02645437574233,0.8290404040404041,0.2681319210979767,0.2236342812403291,134784.5538739755,381.71807787519185,135166.27195185068,1520,12,520.4666666666667,36,9,17,31.365000180746847,0.6681134259259258,40.399774774774784,1038.4009009009021,28.8444694694695,0
1528,4,0,0,45,0.0,0.0,1.0,45,1000,700,300,0.7,13,7,6,346.19133025647835,0.8283670033670034,0.267066676305453,0.2226343408385805,134813.78971877295,334.2730399318378,135148.0627587048,1521,13,521.4666666666667,36,9,17,31.38351225330731,0.6684027777777777,40.37162162162163,1038.5135135135145,28.847597597597623,0
1529,4,0,0,45,0.0,0.0,1.0,45,1100,800,300,0.7272727272727273,14,8,6,346.2631586759657,0.8271043771043771,0.2622838703462891,0.22376165464018283,134989.27136596054,348.3622981089188,135337.63366406946,1522,14,522.4666666666667,36,9,18,31.206879424938588,0.6701388888888888,40.2027027027027,1039.1891891891892,28.866366366366364,0
1530,4,0,0,45,0.0,0.0,1.0,45,1100,700,400,0.6363636363636364,15,7,8,345.8313304491801,0.8249579124579125,0.2663384903891233,0.2239399598810265,135063.1925207757,341.81671283472645,135405.0092336104,1523,15,523.4666666666667,37,8,19,31.144514767932485,0.6689189189189189,40.131578947368425,1039.473684210527,28.093883357041268,0
1531,4,0,0,45,0.0,0.0,1.0,45,700,300,400,0.42857142857142855,11,3,8,347.08894881941285,0.8243686868686869,0.2684845503314828,0.2258220691701612,135234.2126904432,387.66014542936966,135621.87283587258,1524,16,524.4666666666667,37,8,19,30.94165085388995,0.6706081081081081,39.9671052631579,1040.1315789473686,28.111664295874824,0
1532,4,0,0,45,0.0,0.0,1.0,45,800,300,500,0.375,13,3,10,351.2796454811844,0.8240740740740741,0.27353237325840074,0.2292739914454221,135348.2862515388,509.01960218527216,135857.30585372407,1525,17,525.4666666666667,37,8,19,30.71917808219179,0.6717342342342343,39.85745614035087,1040.5701754385955,28.123518255097174,0
1533,4,0,0,45,0.0,0.0,1.0,45,1200,900,300,0.75,15,9,6,351.54124278183644,0.8223063973063973,0.26458903628834163,0.23090862544549673,135576.57764889198,532.1517197599285,136108.7293686519,1526,18,526.4666666666667,37,8,19,30.48536534007159,0.6739864864864864,39.63815789473684,1041.4473684210527,28.147226173541966,0
1534,4,0,0,45,0.0,0.0,1.0,45,1450,1200,250,0.8275862068965517,17,12,5,353.2621703814819,0.8212542087542088,0.26347235375963174,0.23296671791361687,135719.35745854478,588.9029557171259,136308.2604142619,1527,19,527.4666666666667,37,8,19,30.298655687677577,0.6753941441441442,39.50109649122806,1041.9956140350864,28.162043622569904,0
1535,4,0,0,45,0.0,0.0,1.0,45,1100,700,400,0.6363636363636364,15,7,8,355.40378032694343,0.8198232323232324,0.2700516632769947,0.23494216521473738,135805.06141312714,653.1264427516189,136458.18785587876,1528,20,528.4666666666667,37,8,19,30.157707412862063,0.6762387387387387,39.41885964912281,1042.3245614035088,28.170934091986727,0
1536,4,0,0,45,0.0,0.0,1.0,45,1500,1100,400,0.7333333333333333,19,11,8,352.8468111082067,0.818476430976431,0.2721263964848317,0.23362586908195188,135862.21241151128,587.7096799015153,136449.9220914128,1529,21,529.4666666666667,37,8,19,30.16757817977844,0.6768018018018017,39.3640350877193,1042.543859649123,28.17686107159792,0
1537,4,0,0,45,0.0,0.0,1.0,45,900,500,400,0.5555555555555556,13,5,8,353.7004472593955,0.8190235690235691,0.26828333800579385,0.2349440401069395,135976.55047707,618.9933441058942,136595.5438211759,1530,22,530.4666666666667,37,8,16,30.031801934398654,0.6779279279279278,39.25438596491229,1042.9824561403518,28.18871503082032,0
1538,4,0,0,45,0.0,0.0,1.0,45,750,400,350,0.5333333333333333,11,4,7,352.2166533187354,0.818939393939394,0.26727869465176357,0.23414654248924732,136005.14250779088,580.6552256463544,136585.79773343724,1531,23,531.4666666666667,37,8,16,30.04211342373596,0.6782094594594594,39.22697368421053,1043.092105263158,28.19167852062589,0
1539,4,0,0,45,0.0,0.0,1.0,45,1450,1200,250,0.8275862068965517,17,12,5,348.75237886083596,0.815993265993266,0.2613101701049583,0.23259119759065017,136119.54068800024,494.40272487689515,136613.94341287712,1532,24,532.4666666666667,37,8,16,30.01897919512452,0.6793355855855856,39.117324561403514,1043.5307017543867,28.20353247984829,0
1540,4,0,0,45,0.0,0.0,1.0,45,1500,1200,300,0.8,18,12,6,348.2153263672838,0.8145622895622896,0.26562049781678754,0.23368185155009302,136339.89257812512,495.1280381944593,136835.02061631958,1533,25,533.4666666666667,39,6,17,29.814565463129206,0.6778846153846153,38.90625000000001,1044.375000000001,26.778846153846178,0
1541,4,0,0,45,0.0,0.0,1.0,45,1250,900,350,0.72,16,9,7,352.6634858819683,0.813425925925926,0.2713907446183845,0.23721409120793158,136421.49658203125,622.1761067708325,137043.6726888021,1534,26,534.4666666666667,39,6,17,29.617546614817044,0.6786858974358975,38.828125,1044.6875,26.786858974358974,0
1542,4,0,0,45,0.0,0.0,1.0,45,1650,1200,450,0.7272727272727273,21,12,9,354.9228219032364,0.8130892255892256,0.27763382278032434,0.23965650033493122,136557.55750868068,693.4787326388986,137251.03624131958,1535,27,535.4666666666667,39,6,17,29.423709388080518,0.6800213675213675,38.69791666666667,1045.2083333333344,26.8002136752137,0
1543,4,0,0,45,0.0,0.0,1.0,45,1300,1000,300,0.7692307692307693,16,10,6,354.6506013208874,0.8130471380471381,0.2747716326191658,0.23965783058956946,136584.77783203128,687.9747178819451,137272.75254991322,1536,28,536.4666666666667,39,6,17,29.40385733266899,0.6802884615384615,38.671875,1045.3125000000002,26.80288461538462,0
1544,4,0,1,44,0.0,0.022222222222222223,0.9777777777777777,45,1000,700,300,0.7,13,7,6,339.9417162571832,0.8134680134680136,0.22275470358537452,0.22638671742233712,136068.05555555565,251.04166666667743,136319.09722222234,1537,29,537.4666666666667,39,6,15,30.29985356762514,0.6752136752136751,39.16666666666667,1043.3333333333342,26.752136752136774,5
1545,4,0,0,44,0.0,0.0,1.0,44,1150,900,250,0.782608695652174,14,9,5,347.0423557361448,0.8136231501057083,0.22991175320685908,0.23118797040376465,136079.2025074877,645.0494009788822,136724.2519084666,1538,30,533.0681818181819,38,6,16,30.103590688784223,0.6770833333333334,39.1559829059829,1043.376068376068,27.457264957264943,0
1546,4,0,0,44,0.0,0.0,1.0,44,1400,1000,400,0.7142857142857143,18,10,8,347.7499865062911,0.8137773079633545,0.22701448924706158,0.23220571552836333,136162.81920017893,670.123707904153,136832.9429080831,1539,31,534.0681818181819,38,6,16,30.00221790016037,0.6779057017543859,39.0758547008547,1043.6965811965808,27.46569950517318,0
1547,4,0,0,44,0.0,0.0,1.0,44,850,600,250,0.7058823529411765,11,6,5,348.28553299480444,0.8133368569415081,0.22478158930415626,0.23292935954087818,136218.57792981577,688.5920036160287,136907.1699334318,1540,32,535.0681818181819,38,6,16,29.93296489612117,0.678453947368421,39.02243589743589,1043.9102564102554,27.471322537111984,0
1548,4,0,0,44,0.0,0.0,1.0,44,950,500,450,0.5263157894736842,14,5,9,347.9106631228564,0.8124779774489077,0.22206875383670965,0.23322900009347053,136302.2374260355,684.2003616042111,136986.43778763973,1541,33,536.0681818181819,38,6,17,29.85983220789851,0.6792763157894737,38.94230769230769,1044.2307692307693,27.479757085020243,0
1549,4,0,0,44,0.0,0.0,1.0,44,850,500,350,0.5882352941176471,12,5,7,346.1337143503849,0.8122357293868923,0.22056334622823992,0.23240406534954403,136358.02469135798,639.6219135802407,136997.64660493823,1542,34,537.0681818181819,38,6,17,29.850953014184388,0.6798245614035088,38.888888888888886,1044.4444444444441,27.485380116959057,0
1550,4,0,0,44,0.0,0.0,1.0,44,1450,1300,150,0.896551724137931,16,13,3,350.1365519852568,0.810628083157153,0.22813014099692364,0.23602244072831108,136497.542792114,758.5557975381554,137256.09858965216,1543,35,538.0681818181819,38,6,17,29.60821149848345,0.6811951754385965,38.755341880341874,1044.9786324786314,27.49943769680609,0
1551,4,0,0,44,0.0,0.0,1.0,44,1150,700,450,0.6086956521739131,16,7,9,346.6162386411951,0.8092406624383369,0.22083495903238393,0.23457721378580454,136637.1322320841,672.1297666009143,137309.26199868502,1544,36,539.0681818181819,38,6,18,29.562001839362345,0.6825657894736843,38.62179487179487,1045.51282051282,27.51349527665316,0
1552,4,0,0,44,0.0,0.0,1.0,44,1200,800,400,0.6666666666666666,16,8,8,344.00855137496893,0.8089323467230445,0.2209616599175246,0.2331825277602627,136692.98798305195,604.7113558331357,137297.69933888508,1545,37,540.0681818181819,38,6,18,29.574904645143715,0.6831140350877194,38.56837606837606,1045.7264957264945,27.51911830859196,0
1553,4,0,1,43,0.0,0.022727272727272728,0.9772727272727273,44,900,500,400,0.5555555555555556,13,5,8,344.00855137496893,0.8084478505990135,0.2209616599175246,0.2331825277602627,136692.98798305195,604.7113558331357,137297.69933888508,1546,38,541.0681818181819,38,6,18,29.574904645143715,0.6831140350877194,38.56837606837606,1045.7264957264945,27.51911830859196,0
1554,4,0,0,43,0.0,0.0,1.0,43,950,600,350,0.631578947368421,13,6,7,346.9217624938942,0.8071705426356589,0.21905381976195537,0.23515229914031732,136692.2529648544,884.3034635656909,137576.55642842007,1547,39,552.0930232558139,37,6,18,29.499471357170314,0.6849662162162162,38.56907894736841,1045.7236842105249,28.262802275960134,0
1555,4,0,0,43,0.0,0.0,1.0,43,800,500,300,0.625,11,5,6,355.57365139990344,0.8084163898117386,0.1863028155742339,0.23489180183483974,135780.35119156315,1091.6250286864079,136871.97622024955,1548,40,553.0930232558139,36,7,21,30.177831802629218,0.677951388888889,39.442567567567565,1042.2297297297293,28.950825825825817,4
1556,4,0,1,42,0.0,0.023255813953488372,0.9767441860465116,43,1300,800,500,0.6153846153846154,18,8,10,358.98371387991887,0.8086471022517534,0.1908298182896162,0.23753482769023673,135839.0416387673,1152.8007314747329,136991.84237024203,1549,41,554.0930232558139,36,7,21,30.030652479204917,0.6785300925925926,39.38626126126127,1042.454954954956,28.957082082082113,0
1557,4,0,1,41,0.0,0.023809523809523808,0.9761904761904762,42,1250,800,450,0.64,17,8,9,359.5615181553116,0.8078300425861401,0.17658157602663715,0.23856032979229427,135935.25618355622,1375.4174168381332,137310.67360039437,1550,42,538.4285714285714,35,7,19,29.919996300406957,0.6815476190476191,39.29398148148148,1042.824074074074,29.79497354497354,0
1558,4,0,1,40,0.0,0.024390243902439025,0.975609756097561,41,900,700,200,0.7777777777777778,11,7,4,357.9191878087822,0.8025914634146342,0.18671226872020164,0.2382779585604406,136055.9802061901,1539.4091863854742,137595.3893925756,1551,43,549.8048780487804,35,6,20,29.84292951704756,0.6827380952380951,39.17824074074075,1043.287037037038,29.80820105820109,0
1559,4,0,0,40,0.0,0.0,1.0,40,950,700,250,0.7368421052631579,12,7,5,365.36460806591026,0.8016025641025641,0.18883087983567304,0.24310478819146314,136037.0057397959,1940.6214569160957,137977.62719671198,1552,44,557.9,34,6,20,29.667589105709617,0.6847426470588236,39.19642857142857,1043.2142857142853,30.682773109243687,0
1560,4,0,0,40,0.0,0.0,1.0,40,1100,800,300,0.7272727272727273,14,8,6,362.61201968494066,0.8005341880341881,0.1846120935539075,0.2416953880257417,136099.10891439905,1870.234552154189,137969.34346655325,1553,45,558.9,34,6,20,29.67769537934968,0.6853553921568627,39.13690476190476,1043.4523809523807,30.68977591036414,0
1561,4,0,0,40,0.0,0.0,1.0,40,1200,900,300,0.75,15,9,6,360.8252778733947,0.7989049145299145,0.18116946059983996,0.2413483494791607,136223.35778061222,1830.5661848072473,138053.92396541947,1554,46,559.9,34,6,20,29.600961721214876,0.6865808823529411,39.01785714285714,1043.928571428571,30.703781512605033,0
1562,4,0,0,40,0.0,0.0,1.0,40,1200,1000,200,0.8333333333333334,14,10,4,363.2795188350746,0.7971955128205128,0.17970085470085495,0.24427415921668796,136409.83737244885,1910.9800170067897,138320.81738945562,1555,47,560.9,34,6,20,29.351851851851844,0.6884191176470589,38.83928571428571,1044.6428571428562,30.724789915966358,0
1563,4,0,0,40,0.0,0.0,1.0,40,950,900,50,0.9473684210526315,10,9,1,363.7382537450513,0.7946047008547008,0.17266514806378175,0.24566322060627285,136565.33446712003,1934.807256235811,138500.14172335583,1556,48,561.9,34,6,20,29.18564920273349,0.6899509803921569,38.69047619047618,1045.238095238094,30.742296918767472,0
1564,4,0,0,40,0.0,0.0,1.0,40,750,400,350,0.5333333333333333,11,4,7,363.7382537450513,0.7946047008547008,0.17266514806378175,0.24566322060627285,136565.33446712003,1934.807256235811,138500.14172335583,1557,49,562.9,34,6,20,29.18564920273349,0.6899509803921569,38.69047619047618,1045.238095238094,30.742296918767472,0
1565,4,0,0,40,0.0,0.0,1.0,40,1250,1200,50,0.96,13,12,1,360.443551531017,0.7927083333333333,0.17042918943533714,0.2443006293710224,136689.7959183672,1853.7910997732238,138543.58701814042,1558,50,563.9,34,6,21,29.148404295689126,0.6911764705882353,38.57142857142856,1045.7142857142844,30.756302521008365,0
1566,4,0,0,40,0.0,0.0,1.0,40,1100,500,600,0.45454545454545453,17,5,12,357.00552891154393,0.7904113247863248,0.16261948111060565,0.2428300764763658,136814.31405895684,1768.6933106575898,138583.00736961444,1559,51,564.9,34,6,21,29.114986345015936,0.6924019607843137,38.45238095238095,1046.1904761904757,30.770308123249286,0
1567,4,0,0,40,0.0,0.0,1.0,40,750,400,350,0.5333333333333333,11,4,7,357.3130497359229,0.7897702991452992,0.1612157242007055,0.24325518157467274,136845.452451814,1779.3331916099696,138624.78564342397,1560,52,565.9,34,6,21,29.076117874616003,0.6927083333333334,38.422619047619044,1046.3095238095232,30.773809523809504,0
1568,4,0,0,40,0.0,0.0,1.0,40,1400,1400,0,1.0,14,14,0,359.4848046848259,0.7899572649572649,0.15761289955636482,0.24516919456821581,136907.7398667799,1843.2504251700582,138750.99029194997,1561,53,566.9,34,6,21,28.95764607742767,0.6933210784313726,38.363095238095234,1046.5476190476181,30.780812324929943,0
1569,4,0,0,40,0.0,0.0,1.0,40,1100,800,300,0.7272727272727273,14,8,6,359.3079379223285,0.7899839743589744,0.14932835820895485,0.24564930449791844,136993.40820312503,1844.5638020833328,138837.97200520837,1562,54,567.9,35,5,20,28.877487562189053,0.6919642857142858,38.28125,1046.8750000000002,29.910714285714292,0
1570,4,0,0,40,0.0,0.0,1.0,40,1350,800,550,0.5925925925925926,19,8,11,362.4693852494684,0.7900106837606837,0.1488255775395162,0.24824076671854192,137053.99794506593,1935.5756762259875,138989.57362129193,1563,55,568.9,35,5,20,28.734778563796475,0.6925595238095239,38.223379629629626,1047.1064814814808,29.917328042328023,0
1571,4,0,0,40,0.0,0.0,1.0,40,800,500,300,0.625,11,5,6,361.47678481521785,0.7891025641025641,0.15349486131064194,0.2479911619251634,137114.6010829261,1912.7490301354605,139027.35011306155,1564,56,569.9,35,5,20,28.70080027258998,0.6931547619047619,38.16550925925926,1047.3379629629628,29.923941798941794,0
1572,4,0,0,40,0.0,0.0,1.0,40,1450,1300,150,0.896551724137931,16,13,3,355.05797264563375,0.7869925213675214,0.15806113677876876,0.24496104902986773,137310.42433903506,1750.6321777859066,139061.05651682097,1565,57,570.9,36,4,20,28.67532502417535,0.6929976851851851,37.97860360360361,1048.0855855855864,29.11348848848851,0
1573,4,0,0,40,0.0,0.0,1.0,40,1350,1000,350,0.7407407407407407,17,10,7,353.67881111402085,0.7870726495726496,0.1567883995703543,0.24463222373488375,137398.9593478615,1719.0201180910753,139117.97946595258,1566,58,571.9,36,4,20,28.624015395631936,0.6938657407407407,37.89414414414415,1048.4234234234243,29.122872872872897,0
1574,4,0,0,40,0.0,0.0,1.0,40,600,400,200,0.6666666666666666,8,4,4,353.87425492436296,0.7869123931623931,0.15448346219931253,0.24518430519759457,137457.99853907977,1728.5693632822176,139186.56790236197,1567,59,572.9,36,4,20,28.56059385738831,0.6944444444444444,37.837837837837846,1048.64864864865,29.129129129129165,0
1575,4,0,0,40,0.0,0.0,1.0,40,800,600,200,0.75,10,6,4,352.7951039932932,0.7860042735042735,0.15035800146336387,0.2451118925129875,137553.57567953612,1705.6456073022587,139259.22128683838,1568,60,573.9,37,3,20,28.49454287307063,0.6934121621621621,37.746710526315795,1049.0131578947376,28.351706970128042,0
1576,4,0,0,40,0.0,0.0,1.0,40,550,400,150,0.7272727272727273,7,4,3,352.01042966689903,0.7845886752136753,0.14818704284221518,0.24517757000816776,137639.8567347646,1690.1330216989868,139329.98975646356,1569,61,574.9,37,3,21,28.429989550679213,0.6942567567567568,37.66447368421053,1049.3421052631581,28.360597439544815,0
1577,4,0,1,39,0.0,0.025,0.975,40,1100,700,400,0.6363636363636364,15,7,8,356.82791635172566,0.7816506410256411,0.15317460317460285,0.24977954144620812,137812.50000000015,1835.0694444444594,139647.5694444446,1570,62,575.9,37,3,21,28.133267195767196,0.6959459459459458,37.50000000000001,1050.0000000000011,28.378378378378407,0
1578,4,0,0,39,0.0,0.0,1.0,39,550,400,150,0.7272727272727273,7,4,3,361.8732892013079,0.7758659469185786,0.16067058461073414,0.2537715546370378,137875.00708616766,2178.656462585018,140053.6635487527,1571,63,588.4102564102565,34,5,21,27.939148341268044,0.7028186274509804,37.44047619047618,1050.2380952380943,30.88935574229689,0
1579,4,0,0,39,0.0,0.0,1.0,39,1350,1000,350,0.7407407407407407,17,10,7,359.6399911557452,0.774685110211426,0.158948787688588,0.25266427404126535,137937.5283446711,2121.570294784562,140059.09863945565,1572,64,589.4102564102565,34,5,21,27.93612118464793,0.7034313725490197,37.38095238095237,1050.4761904761895,30.896358543417335,0
1580,4,0,0,39,0.0,0.0,1.0,39,1200,1100,100,0.9166666666666666,13,11,2,358.3152469253622,0.7727732793522267,0.16129500833783683,0.2521922144627787,138000.06377551012,2089.505385487523,140089.56916099763,1573,65,590.4102564102565,34,5,21,27.909254853085592,0.7040441176470589,37.32142857142857,1050.714285714285,30.903361344537796,0
1581,4,0,0,39,0.0,0.0,1.0,39,1300,900,400,0.6923076923076923,17,9,8,361.7632063411533,0.7696243814664867,0.1639644032670975,0.2564860485407505,138250.34722222236,2202.777777777798,140453.12500000017,1574,66,591.4102564102565,34,5,20,27.571975699947174,0.7064950980392156,37.08333333333334,1051.6666666666679,30.931372549019642,0
1582,4,0,0,39,0.0,0.0,1.0,39,1100,700,400,0.6363636363636364,15,7,8,363.6495564048684,0.7684997750787225,0.1333672600924798,0.24281155072364688,136161.22626133796,2104.5564058957,138265.78266723367,1575,67,592.4102564102565,34,5,17,29.588941485114624,0.6859681372549019,39.077380952380956,1043.6904761904768,30.696778711484612,8
1583,4,0,0,39,0.0,0.0,1.0,39,1300,800,500,0.6153846153846154,18,8,10,364.81526505956737,0.76731893837157,0.12767885857965688,0.24423128813529807,136254.4288548752,2141.53911564625,138395.96797052145,1576,68,593.4102564102565,34,5,17,29.465982516153552,0.6868872549019608,38.988095238095234,1044.0476190476186,30.70728291316525,0
1584,4,0,0,39,0.0,0.0,1.0,39,900,600,300,0.6666666666666666,12,6,6,365.12015701412014,0.7665879442195231,0.12770820910355818,0.2448649860342402,136316.58163265308,2154.3863378684855,138470.96797052157,1577,69,594.4102564102565,34,5,17,29.39632732938137,0.6875,38.92857142857143,1044.2857142857144,30.71428571428572,0
1585,4,0,0,39,0.0,0.0,1.0,39,650,300,350,0.46153846153846156,10,3,7,363.27951883507416,0.7657444894287,0.128570384980641,0.24427415921668807,136409.83737244914,2110.98001700682,138520.81738945597,1578,70,595.4102564102565,34,5,17,29.35185185185185,0.6884191176470588,38.83928571428572,1044.6428571428585,30.724789915966426,0
1586,4,0,0,39,0.0,0.0,1.0,39,800,600,200,0.75,10,6,4,365.49071678761914,0.7636077372919479,0.12902302375986574,0.24641148325358858,136503.12500000015,2178.1250000000164,138681.25000000017,1579,71,596.4102564102565,34,5,17,29.201555023923436,0.6893382352941175,38.75000000000001,1045.0000000000011,30.735294117647094,0
1587,4,0,0,39,0.0,0.0,1.0,39,550,300,250,0.5454545454545454,8,3,5,366.28078932757705,0.7623144399460189,0.13048303253314608,0.24738041002277902,136565.3344671202,2204.251700680272,138769.58616780047,1580,72,597.4102564102565,34,5,17,29.119210326499605,0.6899509803921569,38.69047619047619,1045.2380952380954,30.74229691876751,0
1588,4,0,0,39,0.0,0.0,1.0,39,1250,1000,250,0.8,15,10,5,366.15904766407573,0.7620895186684661,0.13054037644201566,0.24817446563898457,136689.7959183673,2210.0410997732392,138899.83701814053,1581,73,598.4102564102565,34,5,17,28.998984896782023,0.6911764705882353,38.57142857142857,1045.7142857142853,30.756302521008394,0
1589,4,0,0,39,0.0,0.0,1.0,39,1050,700,350,0.6666666666666666,14,7,7,368.10887897159387,0.7605713000449843,0.12998494450474452,0.2503824170590068,136814.31405895695,2272.5127551020496,139086.826814059,1582,74,599.4102564102565,34,5,18,28.82458086785011,0.6924019607843137,38.452380952380956,1046.1904761904766,30.77030812324931,0
1590,4,0,0,39,0.0,0.0,1.0,39,1050,700,350,0.6666666666666666,14,7,7,369.3435890665911,0.7605713000449843,0.13042209970537622,0.2516690037128168,136876.59438775515,2310.898526077104,139187.49291383225,1583,75,600.4102564102565,34,5,19,28.730565036025794,0.6930147058823528,38.392857142857146,1046.4285714285718,30.777310924369758,0
1591,4,0,0,39,0.0,0.0,1.0,39,900,700,200,0.7777777777777778,11,7,4,369.4801627569896,0.7593904633378318,0.1282342856143177,0.25266007397239254,137001.1975623583,2323.844954648531,139325.04251700683,1584,76,601.4102564102565,34,5,15,28.603545978318547,0.6942401960784312,38.273809523809526,1046.9047619047622,30.79131652661065,0
1592,4,0,0,39,0.0,0.0,1.0,39,1050,800,250,0.7619047619047619,13,8,5,369.36196282520336,0.7568038686459739,0.13463068355669794,0.2537092826619024,137157.03125000023,2332.1180555555866,139489.14930555582,1585,77,602.4102564102565,34,5,16,28.452333598514986,0.6957720588235292,38.125000000000014,1047.5000000000018,30.808823529411818,0
1593,4,0,1,38,0.0,0.02564102564102564,0.9743589743589743,39,1300,1100,200,0.8461538461538461,15,11,4,368.0633064851567,0.7549482681061629,0.14326238656088774,0.2539521434400723,137312.95351473932,2307.9719387755226,139620.92545351485,1586,78,603.4102564102565,34,5,17,28.33205550507345,0.6973039215686274,37.97619047619048,1048.0952380952388,30.826330532212904,0
1594,4,0,0,38,0.0,0.0,1.0,38,800,400,400,0.5,12,4,8,376.7188744028373,0.7522522522522522,0.14210033798966948,0.25909651305469494,137201.96446378814,2737.3139237312803,139939.2783875194,1587,79,615.2105263157895,33,5,17,28.21516649120756,0.6985479797979797,38.082107843137265,1047.6715686274522,31.747623291740975,0
1595,4,0,0,38,0.0,0.0,1.0,38,800,600,200,0.75,10,6,4,375.99452983885953,0.7517484589853011,0.13733389138851115,0.2590756828889676,137266.16753472228,2722.2656250000064,139988.43315972228,1588,80,616.2105263157895,33,5,17,28.17055997349238,0.6991792929292928,38.020833333333336,1047.916666666667,31.755050505050516,0
1596,4,0,0,38,0.0,0.0,1.0,38,800,600,200,0.75,10,6,4,388.42991554569716,0.7532894736842105,0.11717782337825611,0.2651942373042206,136945.302362673,3048.496071222608,139993.79843389563,1589,81,617.2105263157895,33,5,21,28.16305175038052,0.6960227272727273,38.32720588235294,1046.6911764705883,31.717914438502675,4
1597,4,0,0,38,0.0,0.0,1.0,38,1350,1100,250,0.8148148148148148,16,11,5,387.3910245619939,0.7523707918444761,0.11529174058742298,0.2652138552770574,137041.5224913495,3017.731161091886,140059.25365244137,1590,82,618.2105263157895,33,5,19,28.094764357053666,0.696969696969697,38.23529411764706,1047.058823529412,31.729055258467028,0
1598,4,0,0,38,0.0,0.0,1.0,38,850,700,150,0.8235294117647058,10,7,3,386.28703374315785,0.7520448079658606,0.11682732284192032,0.26470109890419274,137073.60337670607,2989.951130574776,140063.55450728085,1591,83,619.2105263157895,33,5,19,28.09184220791885,0.6972853535353536,38.2046568627451,1047.1813725490194,31.732768865121802,0
1599,4,0,0,38,0.0,0.0,1.0,38,950,700,250,0.7368421052631579,12,7,5,386.90023597008513,0.7508297771455666,0.11571003676266844,0.2656093427177765,137137.77641111586,3011.727610774696,140149.50402189055,1592,84,620.2105263157895,33,5,19,28.012143637143637,0.6979166666666667,38.143382352941174,1047.426470588235,31.74019607843136,0
1600,4,0,0,38,0.0,0.0,1.0,38,800,500,300,0.625,11,5,6,388.6423012620105,0.7497036510194405,0.11829025844930419,0.26779051717094704,137266.16753472225,3069.4878472222267,140335.65538194447,1593,85,621.2105263157895,33,5,19,27.839214711729632,0.6991792929292929,38.020833333333336,1047.9166666666667,31.75505050505051,0
1601,4,0,0,38,0.0,0.0,1.0,38,950,600,350,0.631578947368421,13,6,7,386.8405117080474,0.7495851114272167,0.11647629363399137,0.2667951658167115,137298.27470203768,3022.506968473668,140320.78167051135,1594,86,622.2105263157895,33,5,19,27.854595416276894,0.6994949494949495,37.990196078431374,1048.0392156862747,31.758764111705293,0
1602,4,0,0,38,0.0,0.0,1.0,38,800,600,200,0.75,10,6,4,387.1258431922043,0.7472143195827406,0.12114613321522572,0.2679812875689727,137426.74091695514,3040.2885909265806,140467.02950788173,1595,87,623.2105263157895,33,5,19,27.719826242792582,0.7007575757575757,37.867647058823536,1048.5294117647068,31.77361853832445,0
1603,4,0,0,38,0.0,0.0,1.0,38,1200,900,300,0.75,15,9,6,384.63669264495354,0.7472439544807966,0.1189139136149111,0.2668227765513422,137500.1771541952,2977.522675736984,140477.6998299322,1596,88,624.2105263157895,34,4,20,27.712353386303445,0.699142156862745,37.79761904761906,1048.8095238095252,30.84733893557427,0
1604,4,0,0,38,0.0,0.0,1.0,38,550,400,150,0.7272727272727273,7,4,3,386.3958877517948,0.7478959222380275,0.12617363881788024,0.26852685827041134,137562.61337868482,3030.7256235827726,140593.3390022676,1597,89,625.2105263157895,34,4,20,27.60440308669995,0.6997549019607843,37.73809523809524,1049.0476190476193,30.854341736694685,0
1605,4,0,0,38,0.0,0.0,1.0,38,950,600,350,0.631578947368421,13,6,7,385.8414806561935,0.7469179706021811,0.1259353705948747,0.268383659749253,137593.8368055557,3017.8819444444644,140611.71875000017,1598,90,626.2105263157895,34,4,20,27.588032830288597,0.7000612745098038,37.70833333333334,1049.1666666666679,30.85784313725494,0
1606,4,0,0,38,0.0,0.0,1.0,38,1000,800,200,0.8,12,8,4,385.90878663289595,0.7467697961119014,0.12486116584858986,0.2686729893666941,137625.06377551024,3022.144274376422,140647.20804988666,1599,91,627.2105263157895,34,4,20,27.55535700779063,0.7003676470588235,37.67857142857143,1049.2857142857147,30.86134453781514,0
1607,4,0,0,38,0.0,0.0,1.0,38,850,600,250,0.7058823529411765,11,6,5,385.90878663289595,0.7462660028449503,0.12486116584858986,0.2686729893666941,137625.06377551024,3022.144274376422,140647.20804988666,1600,92,628.2105263157895,34,4,20,27.55535700779063,0.7003676470588235,37.67857142857143,1049.2857142857147,30.86134453781514,0
1608,4,0,0,38,0.0,0.0,1.0,38,950,600,350,0.631578947368421,13,6,7,384.79427103000387,0.7446953532479849,0.12560961778382662,0.2686247892059813,137718.76594387754,2998.678429705218,140717.44437358275,1601,93,629.2105263157895,34,4,20,27.49187176288232,0.7012867647058822,37.589285714285715,1049.642857142857,30.871848739495796,0
1609,4,0,0,38,0.0,0.0,1.0,38,800,600,200,0.75,10,6,4,382.01068853172023,0.7440433854907539,0.11907603798019828,0.26716512784783847,137781.25177154207,2926.78217120183,140708.0339427439,1602,94,630.2105263157895,34,4,20,27.503118267377264,0.7018995098039216,37.52976190476191,1049.8809523809534,30.878851540616278,0
1610,4,0,0,38,0.0,0.0,1.0,38,1250,1000,250,0.8,15,10,5,401.7555827123557,0.7440433854907539,0.18049835317809282,0.24846993522417068,133379.976261338,3117.2300170068147,136497.2062783448,1603,95,631.2105263157895,34,4,18,31.380853597633582,0.6583946078431373,41.75595238095239,1032.9761904761915,30.381652661064457,8
1611,4,0,0,38,0.0,0.0,1.0,38,1900,1600,300,0.8421052631578947,22,16,6,400.0362783406799,0.7435395922238027,0.18197725557226008,0.24908531958378735,133630.5616379518,3091.4463977993196,136722.00803575112,1604,96,632.2105263157895,33,5,18,31.173081861641187,0.6631944444444444,41.513480392156865,1033.9460784313728,31.331699346405237,0
1612,4,1,1,38,0.02564102564102564,0.02564102564102564,0.9743589743589743,39,1000,700,300,0.7,13,7,6,391.8540819051915,0.7497750787224472,0.17837235228539572,0.24579937864962023,133903.12500000012,2694.0972222222367,136597.22222222236,1605,0,616.974358974359,34,5,15,31.110775630703174,0.6636029411764706,41.25000000000001,1035.000000000001,30.44117647058826,0
1613,4,0,0,38,0.0,0.0,1.0,38,900,800,100,0.8888888888888888,10,8,2,401.9207954539986,0.7433025130393551,0.1845596992124905,0.2511186850057143,133757.3007527153,3151.968143262206,136909.2688959775,1606,98,634.2105263157895,33,5,15,30.996895115112746,0.6644570707070707,41.39093137254902,1034.4362745098038,31.346553773024358,0
1614,4,0,0,38,0.0,0.0,1.0,38,1200,1000,200,0.8333333333333334,14,10,4,401.9918902421206,0.742739449976292,0.18532013439972062,0.251595072595569,133820.6928374905,3158.9666534506077,136979.6594909411,1607,99,635.2105263157895,33,5,15,30.9313188440128,0.6650883838383839,41.329656862745104,1034.6813725490204,31.35398098633395,0
1615,4,0,0,38,0.0,0.0,1.0,38,1150,900,250,0.782608695652174,14,9,5,407.5036634910199,0.742739449976292,0.1516628545567964,0.23792242388084942,131206.1295351475,3093.3956916099946,134299.5252267575,1608,100,636.2105263157895,34,4,17,33.431617476179426,0.636642156862745,43.86904761904763,1024.5238095238105,30.133053221288545,4
1616,4,0,0,38,0.0,0.0,1.0,38,1150,900,250,0.782608695652174,14,9,5,408.67631130719553,0.7441026552868658,0.15017853648992352,0.2389867994383384,131267.12018140606,3129.1524943310815,134396.27267573716,1609,101,637.2105263157895,34,4,17,33.33962592936802,0.6372549019607842,43.80952380952382,1024.761904761906,30.140056022409,0
1617,4,0,0,38,0.0,0.0,1.0,38,1250,900,350,0.72,16,9,7,371.3066655560522,0.7447842579421526,0.07946308024823678,0.2144042239825572,130780.41459956585,2111.9279330005756,132892.34253256643,1610,102,638.2105263157895,36,2,18,34.790038166538224,0.6281828703703705,44.28490990990991,1022.8603603603609,28.412787787787803,5
1618,4,0,0,38,0.0,0.0,1.0,38,500,500,0,1.0,5,5,0,372.72354674429744,0.742798719772404,0.08365675359430935,0.21570485004577625,130866.81909950498,2155.4289931823787,133022.24809268737,1611,103,639.2105263157895,36,2,18,34.666198914080276,0.6290509259259258,44.200450450450454,1023.1981981981988,28.42217217217219,0
1619,4,2,0,40,0.05,0.0,1.0,40,1300,1100,200,0.8461538461538461,15,11,4,352.565045285623,0.7566239316239316,0.09033291653641728,0.20694597795756134,131410.26925131507,1266.1335059171754,132676.40275723225,1612,0,608.2,38,2,20,34.63256746900072,0.6307565789473684,43.6698717948718,1025.320512820514,26.98211875843458,0
1620,4,0,0,40,0.0,0.0,1.0,40,1250,900,350,0.72,16,9,7,348.97719053791883,0.7553685897435898,0.07870235367631784,0.20557539776350275,131547.23340821092,1181.396787566653,132728.63019577757,1613,1,609.2,38,2,20,34.586327501215024,0.6321271929824561,43.53632478632478,1025.8547008547002,26.996176338281586,0
1621,4,0,0,40,0.0,0.0,1.0,40,750,700,50,0.9333333333333333,8,7,1,347.93408710436694,0.7567574786324787,0.08187070580886946,0.20555072821184175,131656.85609796178,1161.58160749506,132818.43770545683,1614,2,610.2,38,2,14,34.50252446387674,0.6332236842105263,43.429487179487175,1026.2820512820506,27.007422402159225,0
1622,4,0,2,38,0.0,0.05,0.95,40,800,600,200,0.75,10,6,4,348.0882199373133,0.7539262820512821,0.0881398252184773,0.2065323438294724,131821.37573964492,1177.0936061801394,132998.46934582505,1615,3,611.2,38,2,16,34.33273512276321,0.6348684210526316,43.26923076923077,1026.9230769230765,27.024291497975696,0
1623,4,0,0,38,0.0,0.0,1.0,38,1000,800,200,0.8,12,8,4,359.9072682821618,0.7386498340445709,0.0805534692934311,0.212079897415944,131559.08230866006,1869.8139862835853,133428.89629494364,1616,108,644.2105263157895,36,2,16,34.29404500548847,0.6359953703703705,43.52477477477478,1025.9009009009012,28.497247247247255,0
1624,4,0,0,38,0.0,0.0,1.0,38,1350,1200,150,0.8888888888888888,15,12,3,361.8994532089744,0.738027501185396,0.08510705853148814,0.21438838953256786,131761.3363997443,1936.871119430239,133698.20751917452,1617,109,645.2105263157895,36,2,16,34.03874629812438,0.6380208333333334,43.3277027027027,1026.689189189189,28.519144144144136,0
1625,4,0,0,38,0.0,0.0,1.0,38,650,500,150,0.7692307692307693,8,5,3,361.1171826993208,0.7371680891417733,0.08658650572935289,0.21473995701324686,131905.89871966574,1926.6973054135385,133832.59602507929,1618,110,646.2105263157895,36,2,16,33.91297595556531,0.6394675925925926,43.186936936936945,1027.2522522522534,28.534784784784815,0
1626,4,0,0,38,0.0,0.0,1.0,38,850,400,450,0.47058823529411764,13,4,9,360.47324451116515,0.7358641536273115,0.08307714491708684,0.21484770451759536,131992.6741564201,1915.9655009739627,133908.63965739406,1619,111,647.2105263157895,36,2,16,33.842009132420095,0.6403356481481481,43.102477477477485,1027.5900900900913,28.5441691691692,0
1627,4,1,0,39,0.02564102564102564,0.0,1.0,39,1050,800,250,0.7619047619047619,13,8,5,348.82019153666556,0.7417903733693207,0.08450088403195122,0.20967199597620315,132313.38158135195,1430.7158212142178,133744.09740256617,1620,0,631.5897435897435,37,2,17,33.818585917794586,0.6416103603603605,42.790570175438596,1028.8377192982455,27.806424845898526,0
1628,4,0,1,38,0.0,0.02564102564102564,0.9743589743589743,39,600,500,100,0.8333333333333334,7,5,2,347.1281948414488,0.7424089068825911,0.08297811878374528,0.2088109602815485,132341.5858725762,1387.8991612803939,133729.4850338566,1621,1,632.5897435897435,37,2,17,33.83374183006536,0.6418918918918919,42.76315789473684,1028.9473684210527,27.809388335704128,0
1629,4,0,0,38,0.0,0.0,1.0,38,1000,700,300,0.7,13,7,6,349.09433960275715,0.743361782835467,0.0825298637269467,0.2101465135237153,132369.0307706357,1641.8558761464396,134010.88664678214,1622,2,645.2368421052631,36,2,17,33.755562851097984,0.6440972222222221,42.7364864864865,1029.0540540540558,28.584834834834883,0
1630,4,1,0,39,0.02564102564102564,0.0,1.0,39,900,600,300,0.6666666666666666,12,6,6,344.89810970401334,0.7478632478632479,0.10333728327828595,0.2100367530353185,132803.95418645014,1360.7697224251501,134164.72390887528,1623,0,629.6666666666666,36,3,16,33.426654284569715,0.6484375,42.3141891891892,1030.7432432432447,28.631756756756797,0
1631,4,0,0,39,0.0,0.0,1.0,39,1100,700,400,0.6363636363636364,15,7,8,364.32653071922596,0.7476383265856951,0.056976290948531405,0.2095916505620491,130636.47050766986,1718.8664170927723,132355.33692476264,1624,1,630.6666666666666,36,3,17,35.11442498347655,0.6267361111111112,44.42567567567568,1022.2972972972975,28.39714714714715,4
1632,4,0,0,39,0.0,0.0,1.0,39,900,800,100,0.8888888888888888,10,8,2,366.5520028658129,0.7469073324336483,0.06253123597028454,0.2113434119380601,130722.82745160704,1783.3428445337258,132506.17029614077,1625,2,631.6666666666666,36,3,17,34.96999229159785,0.6276041666666666,44.34121621621622,1022.6351351351353,28.406531531531538,0
1633,4,0,0,39,0.0,0.0,1.0,39,850,700,150,0.8235294117647058,10,7,3,365.7053468958736,0.7463450292397661,0.06682925176980703,0.21132744091616493,130809.21292914523,1767.5257182858409,132576.73864743108,1626,3,632.6666666666666,36,3,17,34.90408960810217,0.6284722222222223,44.25675675675675,1022.9729729729719,28.415915915915885,0
1634,4,1,1,39,0.025,0.025,0.975,40,800,700,100,0.875,9,7,2,354.5378263002722,0.755582264957265,0.06411134903640292,0.2064453427459189,131103.4404816865,1296.2257617728367,132399.66624345933,1627,0,617.825,37,3,17,34.89204139900072,0.6295045045045045,43.96929824561403,1024.1228070175425,27.678994784257906,0
1635,4,0,0,39,0.0,0.0,1.0,39,1250,1000,250,0.8,15,10,5,366.2053560229946,0.7451641925326136,0.06274509803921569,0.21336564465273142,131126.20380092936,1803.823629372622,132930.02743030197,1628,5,634.6666666666666,36,3,17,34.57027670881437,0.6316550925925926,43.947072072072075,1024.211711711712,28.450325325325334,0
1636,4,1,0,40,0.025,0.0,1.0,40,800,200,600,0.25,14,2,12,362.6880179032719,0.7581997863247864,0.11443146333584608,0.20327601824186403,129619.76431450066,1402.3070800631046,131022.07139456377,1629,0,619.775,37,3,15,36.18891550913466,0.6145833333333333,45.42214912280702,1018.3114035087723,27.521929824561415,5
1637,4,0,1,39,0.0,0.025,0.975,40,1100,800,300,0.7272727272727273,14,8,6,364.984232799742,0.7590811965811965,0.11923159707275066,0.2052925842115741,129759.37307633123,1472.0250461680555,131231.3981224993,1630,1,620.775,37,3,15,35.98839503515568,0.6159909909909909,45.28508771929825,1018.8596491228075,27.53674727358939,0
1638,4,3,3,39,0.07142857142857142,0.07142857142857142,0.9285714285714286,42,1100,600,500,0.5454545454545454,16,6,10,343.1914687242635,0.7882791327913279,0.10634758747966266,0.19620946652136498,130395.54172092036,551.1013530004642,130946.64307392083,1631,0,585.5714285714286,39,3,15,35.89845741968384,0.6188568376068375,44.66145833333334,1021.3541666666684,26.18856837606842,0
1639,4,0,0,39,0.0,0.0,1.0,39,1200,900,300,0.75,15,9,6,355.5428595509731,0.75472334682861,0.11944132107502714,0.20170553446721054,130094.74068944287,1450.85122345337,131545.59191289626,1632,3,631.6153846153846,37,2,15,35.88823803382058,0.6193693693693694,44.95614035087719,1020.1754385964911,27.572309151256515,0
1640,4,0,0,39,0.0,0.0,1.0,39,850,400,450,0.47058823529411764,13,4,9,355.07297979270845,0.7541610436347279,0.11748211683757925,0.2021635699627108,130234.60493853872,1448.5578495306202,131683.16278806934,1633,4,632.6153846153846,37,2,16,35.758293944927836,0.620777027027027,44.81907894736842,1020.7236842105258,27.58712660028448,0
1641,4,1,2,38,0.025,0.05,0.95,40,700,500,200,0.7142857142857143,9,5,4,347.66509920356935,0.764102564102564,0.11395859473023862,0.19934466479514007,130508.09500328731,1074.621959237345,131582.71696252466,1634,0,617.775,38,2,14,35.67022166457549,0.6217105263157894,44.55128205128205,1021.7948717948717,26.889338731443992,0
1642,4,0,0,38,0.0,0.0,1.0,38,1000,900,100,0.9,11,9,2,358.4261614111067,0.7563715030820294,0.1129863646653857,0.20452171211545006,130320.07250071006,1742.024668249317,132062.0971689594,1635,6,621.1578947368421,36,2,16,35.58600786735782,0.6235532407407408,44.73536036036035,1021.0585585585576,28.36273773773771,0
1643,4,1,1,38,0.02564102564102564,0.02564102564102564,0.9743589743589743,39,900,700,200,0.7777777777777778,11,7,4,349.680903327566,0.7659131803868646,0.11166306339016097,0.20096950559923327,130598.60365689409,1333.567540012274,131932.17119690636,1636,0,606.2051282051282,37,2,14,35.52706858327969,0.6244369369369371,44.462719298245595,1022.1491228070148,27.625651967757157,0
1644,4,1,0,39,0.02564102564102564,0.0,1.0,39,800,500,300,0.625,11,5,6,381.04640200386734,0.7603463787674314,0.1496258073334924,0.20768412854980792,128515.36502718956,2052.97584681337,130568.34087400293,1637,0,607.1794871794872,36,3,15,36.849826003257796,0.605324074074074,46.50900900900902,1013.9639639639656,28.165665665665713,8
1645,4,0,0,39,0.0,0.0,1.0,39,1050,800,250,0.7619047619047619,13,8,5,382.5946420401548,0.7606837606837608,0.14602800412260764,0.2088271118917355,128572.46393352823,2038.2271629737975,130610.69109650202,1638,1,608.1794871794872,36,3,15,36.752118957731895,0.6059027777777777,46.45270270270271,1014.1891891891901,28.171921921921946,0
1646,4,1,0,40,0.025,0.0,1.0,40,1500,1300,200,0.8666666666666667,17,13,4,373.697578756775,0.7707532051282051,0.1511334196891192,0.20606752200016437,128978.5318559556,1639.7930132348308,130618.32486919043,1639,0,593.95,37,3,17,36.56267990788716,0.6081081081081081,46.05263157894736,1015.78947368421,27.4537695590327,0
1647,4,0,0,40,0.0,0.0,1.0,40,650,500,150,0.7692307692307693,8,5,3,372.70230827097663,0.7700320512820513,0.14947922288181315,0.2056633047129599,129006.37846500841,1616.1950071175663,130622.57347212598,1640,1,594.95,37,3,17,36.5595205972297,0.6083896396396395,46.02521929824561,1015.8991228070172,27.456733048838302,0
1648,4,0,0,40,0.0,0.0,1.0,40,1000,700,300,0.7,13,7,6,372.9015183427357,0.769417735042735,0.13969937875118532,0.20411790891648174,128685.96734832697,1597.4385227189573,130283.40587104594,1641,2,595.95,38,2,16,36.88182232985853,0.6033442982456141,46.34081196581196,1014.6367521367509,26.700967161493445,1
1649,4,0,0,40,0.0,0.0,1.0,40,1400,1100,300,0.7857142857142857,17,11,6,370.1486626621692,0.7688034188034188,0.1404562677612884,0.203164785901402,128794.39153928332,1534.6143573307013,130329.00589661402,1642,3,596.95,38,2,16,36.840858856962434,0.6044407894736842,46.23397435897436,1015.0641025641022,26.712213225371112,0
1650,4,1,1,40,0.024390243902439025,0.024390243902439025,0.975609756097561,41,900,500,400,0.5555555555555556,13,5,8,363.8555810525517,0.7766768292682927,0.1456312379180391,0.20083098370150182,129016.12548828125,1188.6474609375005,130204.77294921875,1643,0,583.3658536585366,39,2,17,36.774261765610596,0.6049679487179487,46.015625,1015.9375,26.049679487179485,0
1651,4,4,3,41,0.09090909090909091,0.06818181818181818,0.9318181818181819,44,800,600,200,0.75,10,6,4,342.88187992157265,0.7986257928118393,0.14863917683072203,0.19238922667995012,129663.42872242317,92.37972351203882,129755.80844593521,1644,0,544.4090909090909,38,6,17,36.64879016748838,0.6132127192982456,45.379273504273506,1018.4829059829063,26.80218173639227,0
1652,4,2,2,41,0.046511627906976744,0.046511627906976744,0.9534883720930233,43,1400,1000,400,0.7142857142857143,18,10,8,349.4883343579192,0.7947582133628645,0.1482855376420793,0.19643654655289966,129731.44531250023,467.92534722225287,130199.37065972248,1645,0,558.0232558139535,37,6,18,36.411468984321765,0.6157094594594593,45.312500000000014,1018.7500000000018,27.533783783783832,0
1653,4,0,0,41,0.0,0.0,1.0,41,1250,800,450,0.64,17,8,9,364.7013060010533,0.7787601626016261,0.15918543905766458,0.20406569259448262,129554.63927469144,1249.7492283950696,130804.3885030865,1646,2,586.2439024390244,35,6,18,36.20395634379262,0.6178571428571428,45.486111111111114,1018.0555555555562,29.087301587301607,0
1654,4,0,0,41,0.0,0.0,1.0,41,1200,1000,200,0.8333333333333334,14,10,4,364.13223140495876,0.7795223577235773,0.15474501108647454,0.20435992578849715,129672.49657064467,1243.5871056241367,130916.0836762688,1647,3,587.2439024390244,35,6,18,36.09848484848483,0.6190476190476191,45.37037037037037,1018.5185185185181,29.10052910052909,0
1655,4,1,0,42,0.023809523809523808,0.0,1.0,42,1600,1300,300,0.8125,19,13,6,357.18262874387295,0.7861498257839721,0.15621769877089076,0.2029268341325079,130150.67737188355,897.5122152970025,131048.18958718055,1648,0,574.2380952380952,37,5,20,35.78963392793182,0.6199324324324325,44.90131578947368,1020.3947368421043,27.578236130867683,0
1656,4,0,0,42,0.0,0.0,1.0,42,700,500,200,0.7142857142857143,9,5,4,357.48835125144944,0.7860772357723578,0.15800447180053956,0.20324643158810252,130178.65022170274,907.4702071791223,131086.12042888187,1649,1,575.2380952380952,37,5,20,35.7534427491852,0.620213963963964,44.873903508771924,1020.5043859649115,27.581199620673285,0
1657,4,0,0,42,0.0,0.0,1.0,42,950,700,250,0.7368421052631579,12,7,5,359.3484830604257,0.785230352303523,0.1606955949639648,0.20460163332296205,130235.32238476136,959.9731079698881,131195.29549273124,1650,2,576.2380952380952,38,4,20,35.64846312190358,0.6189692982456141,44.81837606837606,1020.7264957264947,26.86122357174986,0
1658,4,1,0,43,0.023255813953488372,0.0,1.0,43,1100,700,400,0.6363636363636364,15,7,8,352.24689180416476,0.7914820967146549,0.1609659082171917,0.2020409795341965,130521.37230135521,595.1581021389813,131116.5304034942,1651,0,563.8139534883721,36,7,17,35.53972889574609,0.6255787037037038,44.53828828828828,1021.8468468468452,28.38463463463459,0
1659,4,1,0,44,0.022727272727272728,0.0,1.0,44,750,300,450,0.4,12,3,9,342.9410373792304,0.7976788231148697,0.1632116276351172,0.19853137474087915,130878.94833025515,176.75246229605767,131055.70079255122,1652,0,551.9772727272727,37,7,18,35.41577368195456,0.6272522522522523,44.188596491228054,1023.2456140350853,27.655286865813117,0
1660,4,0,0,44,0.0,0.0,1.0,44,1200,700,500,0.5833333333333334,17,7,10,343.5145962703279,0.7976127554615927,0.1731420892731954,0.19944354917784668,130991.17036011055,199.47580024620444,131190.64616035676,1653,1,552.9772727272727,37,7,19,35.28768566123965,0.6283783783783785,44.07894736842104,1023.6842105263138,27.667140825035506,0
1661,4,0,0,44,0.0,0.0,1.0,44,900,500,400,0.5555555555555556,13,5,8,341.95764114650456,0.7969080338266386,0.17751605995717346,0.19911997308655546,131103.44048168653,166.36465066172593,131269.80513234827,1654,2,553.9772727272727,37,7,19,35.214132762312616,0.6295045045045047,43.96929824561403,1024.1228070175428,27.678994784257913,0
1662,4,1,1,44,0.022222222222222223,0.022222222222222223,0.9777777777777777,45,1200,700,500,0.5833333333333334,17,7,10,334.2283690728356,0.8000841750841752,0.1749117741418027,0.19619394094162473,131412.4312889541,-215.4551159972528,131196.97617295684,1655,0,542.6444444444444,37,8,20,35.10041261184186,0.6326013513513514,43.667763157894726,1025.3289473684197,27.71159317211945,0
1663,4,1,0,45,0.022222222222222223,0.0,1.0,45,700,500,200,0.7142857142857143,9,5,4,331.0301866906873,0.8017255892255892,0.1764571754310964,0.19503264651625096,131553.00188519518,-290.39704524471694,131262.60483995045,1656,0,543.3555555555556,37,8,22,35.040793786518456,0.6340090090090091,43.53070175438595,1025.877192982454,27.72641062114741,0
1664,4,0,1,44,0.0,0.022222222222222223,0.9777777777777777,45,1100,900,200,0.8181818181818182,13,9,4,354.34951922522845,0.8022306397306398,0.19885097574023702,0.20175538180439984,130235.32238476136,229.76477463655345,130465.08715939791,1657,1,544.3555555555556,38,7,19,35.77602749284768,0.6189692982456141,44.81837606837606,1020.7264957264947,26.86122357174986,3
1665,4,3,3,44,0.06382978723404255,0.06382978723404255,0.9361702127659575,47,1250,900,350,0.72,16,9,7,340.693513191428,0.8097055195806352,0.2061042081881188,0.19699951736347512,130833.79937743724,-485.154649183699,130348.64472825355,1658,0,522.0851063829788,40,7,17,35.51889838084833,0.6216145833333334,44.23272357723577,1023.0691056910558,25.576727642276396,0
1666,4,0,0,44,0.0,0.0,1.0,44,1050,900,150,0.8571428571428571,12,9,3,360.3763999716658,0.7981412966878083,0.21024861689775287,0.20636920212268028,130458.54403518375,602.8360889888996,131061.38012417265,1659,3,558.6818181818181,37,7,21,35.39575954348682,0.6230292792792793,44.599780701754376,1021.6008771929812,27.610834518729224,0
1667,4,2,1,45,0.043478260869565216,0.021739130434782608,0.9782608695652174,46,1650,1000,650,0.6060606060606061,23,10,13,348.5317846217238,0.8105273752012883,0.21249303091177785,0.20216489466901177,130954.69292534728,-71.62543402777408,130883.0674913195,1660,0,535.3478260869565,39,7,19,35.19616324038265,0.624465811965812,44.114583333333336,1023.5416666666671,26.24465811965813,0
1668,4,0,1,44,0.0,0.022222222222222223,0.9777777777777777,45,1300,1000,300,0.7692307692307693,16,10,6,354.4451105685404,0.8021464646464647,0.21284352605579926,0.205835942391985,130999.8048159105,286.44806048651606,131286.25287639702,1661,1,548.2444444444444,38,7,19,34.99921728240451,0.6266447368421053,44.07051282051282,1023.717948717948,26.93994601889337,0
1669,4,0,0,44,0.0,0.0,1.0,44,850,600,250,0.7058823529411765,11,6,5,361.31169852617137,0.7981412966878083,0.21277538617371472,0.20947101826355788,130935.05333371807,661.6733033241013,131596.72663704216,1662,2,561.4772727272727,37,7,19,34.88902578387258,0.6278153153153152,44.13377192982456,1023.4649122807017,27.66121384542437,0
1670,4,0,0,44,0.0,0.0,1.0,44,1700,1500,200,0.8823529411764706,19,15,4,367.0728172560705,0.7981412966878083,0.21521171877281975,0.2132768447243268,131019.23338190603,818.7198224453739,131837.9532043514,1663,3,562.4772727272727,37,7,19,34.65636267894756,0.6286599099099099,44.0515350877193,1023.7938596491232,27.67010431484117,0
1671,4,0,1,43,0.0,0.022727272727272728,0.9772727272727273,44,1050,800,250,0.7619047619047619,13,8,5,375.3497586398395,0.7999691684284708,0.21873143196672618,0.21269819656257566,130050.0,985.5976117651575,131035.59761176516,1664,4,563.4772727272727,39,5,19,35.4285811546841,0.6153846153846154,45.0,1020.0,26.153846153846153,4
1672,4,1,2,42,0.022727272727272728,0.045454545454545456,0.9545454545454546,44,1350,900,450,0.6666666666666666,18,9,9,377.3294341035639,0.7973044397463003,0.22176203072068268,0.21425749606054553,130129.6997070314,1020.35319010418,131150.05289713558,1665,0,564.3636363636364,39,5,20,35.29702654415517,0.6161858974358974,44.92187500000001,1020.3125000000011,26.161858974359003,0
1673,4,0,0,42,0.0,0.0,1.0,42,1350,1000,350,0.7407407407407407,17,10,7,384.5681809948327,0.7940863337204801,0.22731646398886296,0.2181720948765808,130094.74068944299,1606.0595567867153,131700.80024622972,1666,10,587.1666666666666,37,5,20,35.147965032960734,0.6193693693693693,44.9561403508772,1020.175438596492,27.57230915125654,0
1674,4,1,2,41,0.023255813953488372,0.046511627906976744,0.9534883720930233,43,1150,1000,150,0.8695652173913043,13,10,3,381.57409740302165,0.804171280915467,0.22913334153644271,0.21853789214900324,130463.84222059889,1356.5409805534268,131820.38320115232,1667,0,574.4883720930233,36,7,20,34.84898589065256,0.625,44.59459459459459,1021.6216216216209,28.378378378378358,0
1675,4,0,0,41,0.0,0.0,1.0,41,950,400,550,0.42105263157894735,15,4,11,393.2240279488751,0.7910569105691057,0.23433284338671578,0.22474809698690196,130384.14292800448,2054.0355725623504,132438.17850056684,1668,12,599.0731707317074,34,7,20,34.63253292924583,0.6283700980392157,44.672619047619044,1021.3095238095234,30.038515406162453,0
1676,4,0,0,41,0.0,0.0,1.0,41,800,500,300,0.625,11,5,6,387.8524707026578,0.7896341463414634,0.22111558447638302,0.22205619476492788,130450.30757400976,1929.309530184596,132379.61710419436,1669,13,600.0731707317074,33,8,18,34.70239523352527,0.6313131313131315,44.60784313725489,1021.5686274509785,30.956625074272075,1
1677,4,2,1,42,0.046511627906976744,0.023255813953488372,0.9767441860465116,43,750,500,250,0.6666666666666666,10,5,5,372.5387890013295,0.8062015503875969,0.22108144926087925,0.21602364007467229,130942.84664619753,1156.2579035922304,132099.10454978977,1670,0,573.1162790697674,35,8,18,34.593864261751285,0.6318452380952382,44.1261574074074,1023.495370370369,29.242724867724828,0
1678,4,1,1,42,0.023255813953488372,0.023255813953488372,0.9767441860465116,43,1200,1000,200,0.8333333333333334,14,10,4,362.42011017724013,0.8065245478036175,0.1831248989423091,0.2085040385585199,130638.16350682438,877.7864002998118,131515.9499071242,1671,0,574.0930232558139,33,10,17,35.161432110604984,0.6332070707070707,44.42401960784314,1022.3039215686281,30.97890671420085,3
1679,4,0,0,42,0.0,0.0,1.0,42,950,700,250,0.7368421052631579,12,7,5,372.2881377260857,0.799845141308556,0.19225925664383436,0.2133537967761677,130488.2473727172,1315.8453219059459,131804.09269462316,1672,2,588.7619047619048,32,10,17,35.06137749217335,0.6341145833333333,44.57070707070708,1021.7171717171727,31.928661616161648,0
1680,4,0,0,42,0.0,0.0,1.0,42,850,600,250,0.7058823529411765,11,6,5,371.8231730137905,0.8007888114595432,0.19766757845819005,0.2136201976967094,130585.0188277982,1310.9072097235032,131895.92603752168,1673,3,589.7619047619048,32,10,18,34.97503603047149,0.6350911458333333,44.476010101010104,1022.0959595959597,31.94049873737374,0
1681,4,0,0,42,0.0,0.0,1.0,42,300,100,200,0.3333333333333333,5,1,4,371.3904980680557,0.7996031746031746,0.20028884246098344,0.21366479550922218,130638.16350682438,1303.5545222991261,131941.7180291235,1674,4,590.7619047619048,33,9,18,34.93217054263567,0.6332070707070706,44.42401960784314,1022.3039215686281,30.97890671420085,0
1682,4,2,1,43,0.045454545454545456,0.022727272727272728,0.9772727272727273,44,1200,800,400,0.6666666666666666,16,8,8,355.8069960260214,0.812566067653277,0.1978605095345185,0.20791810797480972,131239.16437596452,539.1625675154351,131778.32694347994,1675,0,564.8636363636364,35,9,19,34.72233988478481,0.6348214285714285,43.83680555555556,1024.6527777777778,29.275793650793652,0
1683,4,0,0,43,0.0,0.0,1.0,43,1650,900,750,0.5454545454545454,24,9,15,365.4922666355004,0.8048634182355112,0.19774738014041038,0.21339392446846128,131206.1295351475,990.9651360544383,132197.09467120195,1676,1,579.0,34,9,19,34.50765938492526,0.636642156862745,43.86904761904763,1024.5238095238105,30.133053221288545,0
1684,4,1,1,43,0.022727272727272728,0.022727272727272728,0.9772727272727273,44,1400,900,500,0.6428571428571429,19,9,10,358.42292171079697,0.8105840380549684,0.2090845827797816,0.21195627098700212,131694.45153061225,640.5187074829996,132334.97023809524,1677,0,566.8181818181819,34,10,17,34.19546895538546,0.6415441176470588,43.392857142857146,1026.4285714285716,30.189075630252105,0
1685,4,0,0,43,0.0,0.0,1.0,43,1200,900,300,0.75,15,9,6,360.14520828413356,0.810031376891842,0.20785726225203383,0.2136597363589365,131816.67375283453,894.6286848072598,132711.30243764177,1678,1,576.0930232558139,34,9,17,34.02793878970553,0.6427696078431373,43.273809523809526,1026.9047619047624,30.203081232493012,0
1686,4,0,0,43,0.0,0.0,1.0,43,1350,900,450,0.6666666666666666,18,9,9,361.8267512194962,0.810077519379845,0.21423701040568988,0.21517595012219376,131908.37762188198,945.5959467120051,132853.973568594,1679,2,577.0930232558139,34,9,17,33.892252868235026,0.6436887254901962,43.1845238095238,1027.261904761904,30.213585434173645,0
1687,4,0,1,42,0.0,0.023255813953488372,0.9767441860465116,43,1050,600,450,0.5714285714285714,15,6,9,360.8921759520211,0.8111387966039129,0.12747415818609031,0.21092729186811904,131246.0064308021,873.1313691650217,132119.13779996714,1680,3,578.0930232558139,38,5,19,34.585157960588056,0.6291118421052632,43.830128205128204,1024.679487179487,26.96524966261808,4
1688,4,0,0,42,0.0,0.0,1.0,42,1250,700,550,0.56,18,7,11,365.9866108152329,0.801296941540844,0.13144566847852412,0.21452967650499757,131357.78523930453,1215.089489019698,132572.87472832424,1681,4,592.6190476190476,35,7,20,34.34159892363854,0.6360119047619048,43.7210648148148,1025.1157407407393,29.289021164021122,0
1689,4,1,1,42,0.023255813953488372,0.023255813953488372,0.9767441860465116,43,750,400,350,0.5333333333333333,11,4,7,357.9437268655206,0.8086009597637505,0.1333694007283226,0.21140253939893,131645.74361100973,824.3536188215285,132470.09722983127,1682,0,579.8139534883721,36,7,16,34.25692234536741,0.6368634259259259,43.44031531531532,1026.2387387387394,28.50663163163165,0
1690,4,0,0,42,0.0,0.0,1.0,42,1500,1000,500,0.6666666666666666,20,10,10,363.11391899152176,0.8007162214479288,0.1302886826372338,0.21429365478307932,131616.85333982628,1158.382284311333,132775.23562413763,1683,6,594.6190476190476,36,6,16,34.153451492537314,0.6365740740740742,43.468468468468465,1026.1261261261259,28.503503503503495,0
1691,4,0,0,42,0.0,0.0,1.0,42,1200,900,300,0.75,15,9,6,360.3121001674279,0.800038714672861,0.13551426273514489,0.21361025548287427,131790.24252292825,1097.1238130021854,132887.36633593045,1684,7,595.6190476190476,36,6,17,34.0503217079769,0.6383101851851853,43.299549549549546,1026.8018018018013,28.522272272272257,0
1692,4,0,0,42,0.0,0.0,1.0,42,1100,800,300,0.7272727272727273,14,8,6,358.13227758931225,0.8003048780487805,0.1271137772069686,0.21280289927635934,131876.97991488106,1045.8806357032638,132922.86055058433,1685,8,596.6190476190476,36,6,18,34.01879362642985,0.6391782407407408,43.21509009009009,1027.1396396396392,28.531656656656644,0
1693,4,0,0,42,0.0,0.0,1.0,42,1100,800,300,0.7272727272727273,14,8,6,356.19632640875056,0.8010549748354626,0.12151652286476367,0.21197515236966935,131934.8206948502,998.9396913805678,132933.76038623077,1686,9,597.6190476190476,36,6,18,34.01019401512661,0.6397569444444444,43.15878378378378,1027.3648648648646,28.537912912912905,0
1694,4,2,3,41,0.045454545454545456,0.06818181818181818,0.9318181818181819,44,950,700,250,0.7368421052631579,12,7,5,342.14990039910157,0.8148564129668782,0.12703695814250748,0.20658812957216466,132482.6524146851,266.5968880918904,132749.24930277697,1687,0,571.4090909090909,37,7,19,33.82005094614265,0.6432995495495495,42.62609649122806,1029.4956140350862,27.824205784732058,0
1695,4,1,0,42,0.023809523809523808,0.0,1.0,42,950,700,250,0.7368421052631579,12,7,5,355.3242921299972,0.8061604723190089,0.15172643800352303,0.21389679719920368,132369.03077063535,1006.7864317019532,133375.8172023373,1688,0,598.6190476190476,36,6,21,33.595288903479975,0.6440972222222223,42.73648648648648,1029.0540540540528,28.5848348348348,0
1696,4,1,1,42,0.023255813953488372,0.023255813953488372,0.9767441860465116,43,1300,900,400,0.6923076923076923,17,9,8,345.2112278092232,0.8138150609080841,0.1483501818727171,0.20957780512452429,132687.90486009646,561.0740808375785,133248.97894093403,1689,0,585.6744186046511,36,7,15,33.53508580172698,0.6472800925925927,42.426801801801794,1030.2927927927917,28.619244244244214,0
1697,4,0,0,42,0.0,0.0,1.0,42,1200,900,300,0.75,15,9,6,343.50027715801787,0.8054345722028649,0.17915613668827657,0.20104154484984696,131299.2696032181,620.267099870144,131919.53670308823,1690,2,600.6190476190476,36,6,17,34.97692561257006,0.6333912037037037,43.778153153153156,1024.8873873873874,28.469094094094096,3
1698,4,0,0,42,0.0,0.0,1.0,42,950,700,250,0.7368421052631579,12,7,5,344.1791227541735,0.8040553619821913,0.18409167889804645,0.2017468226494847,131357.7852393047,642.1246285191323,131999.90986782385,1691,3,601.6190476190476,35,7,17,34.900478905573756,0.6360119047619047,43.72106481481482,1025.1157407407409,29.289021164021168,0
1699,4,0,0,42,0.0,0.0,1.0,42,1150,800,350,0.6956521739130435,15,8,7,341.8086075472797,0.8039585753000387,0.18425455381977152,0.20111064583595753,131501.3239590942,589.6568866163447,132090.98084571055,1692,4,602.6190476190476,36,6,18,34.81646171863564,0.6354166666666666,43.58108108108108,1025.6756756756756,28.49099099099099,0
1700,4,0,0,42,0.0,0.0,1.0,42,1100,700,400,0.6363636363636364,15,7,8,344.5288447926857,0.804006968641115,0.1872383461122351,0.2031716702204634,131587.96623904316,667.1699993912972,132255.13623843447,1693,5,603.6190476190476,36,6,14,34.65934035780925,0.6362847222222221,43.49662162162163,1026.013513513514,28.500375375375388,0
1701,4,0,1,41,0.0,0.023809523809523808,0.9761904761904762,42,900,500,400,0.5555555555555556,13,5,8,348.5228777367551,0.8023615950445219,0.19159011607206455,0.20624975862019612,131721.7857898584,781.6111688211754,132503.39695867957,1694,6,604.6190476190476,37,5,14,34.42195399843339,0.6356981981981982,43.36622807017544,1026.5350877192982,27.744191559981033,0
1702,4,0,0,41,0.0,0.0,1.0,41,800,600,200,0.75,10,6,4,355.74335388969286,0.7955792682926829,0.1969423184518313,0.20978496422582482,131587.9662390432,1162.3088882801858,132750.27512732337,1695,7,620.1951219512196,36,5,14,34.371684410785505,0.6362847222222221,43.49662162162163,1026.0135135135142,28.500375375375395,0
1703,4,0,0,41,0.0,0.0,1.0,41,1150,900,250,0.782608695652174,14,9,5,356.2298595586581,0.7940548780487805,0.19856804974368325,0.21086957141147583,131732.43344696047,1185.4052532262017,132917.83870018666,1696,8,621.1951219512196,36,5,16,34.21342511335381,0.6377314814814814,43.35585585585586,1026.5765765765766,28.516016016016017,0
1704,4,0,0,41,0.0,0.0,1.0,41,1050,800,250,0.7619047619047619,13,8,5,356.74073506110983,0.79375,0.19514869784074484,0.2116537906976097,131819.1518165125,1205.0522228309424,133024.20403934343,1697,9,622.1951219512196,36,5,17,34.1128413203202,0.638599537037037,43.2713963963964,1026.9144144144148,28.52540040040041,0
1705,4,0,0,41,0.0,0.0,1.0,41,1150,900,250,0.782608695652174,14,9,5,356.52529777164904,0.7928861788617886,0.19890226524757804,0.21217092573847074,131934.82069485035,1207.6202469361376,133142.44094178648,1698,10,623.1951219512196,36,5,17,34.001744674631865,0.6397569444444444,43.15878378378379,1027.3648648648657,28.537912912912937,0
1706,4,1,1,41,0.023809523809523808,0.023809523809523808,0.9761904761904762,42,850,600,250,0.7058823529411765,11,6,5,349.2687559680261,0.7984659310878823,0.1932965744139643,0.2093157611644804,132200.59447378045,834.7074340181632,133035.30190779862,1699,0,609.3333333333334,37,5,17,33.92052724171022,0.6404842342342343,42.90021929824562,1028.3991228070179,27.79457088667616,0
1707,4,0,0,41,0.0,0.0,1.0,41,1050,800,250,0.7619047619047619,13,8,5,358.3930532296536,0.7933943089430894,0.19879291135993826,0.21426130864004633,132108.41912436084,1269.3479374644874,133377.76706182532,1700,12,625.1951219512196,36,5,17,33.77880016066016,0.6414930555555556,42.98986486486486,1028.0405405405404,28.556681681681678,0
1708,4,0,0,41,0.0,0.0,1.0,41,1000,700,300,0.7,13,7,6,359.42735303076455,0.79375,0.20262104113578472,0.21556448666423084,132228.78674207442,1305.328562634648,133534.11530470906,1701,13,626.1951219512196,37,4,17,33.630952380952365,0.6407657657657657,42.872807017543856,1028.508771929824,27.797534376481728,0
1709,4,0,0,41,0.0,0.0,1.0,41,900,500,400,0.5555555555555556,13,5,8,356.24843711371346,0.791819105691057,0.20275738399365895,0.2144574459469019,132369.79316953296,1231.306387542323,133601.09955707527,1702,14,627.1951219512196,37,4,17,33.570746759012614,0.6421734234234234,42.73574561403509,1029.0570175438597,27.812351825509722,0
1710,4,0,0,41,0.0,0.0,1.0,41,1250,1000,250,0.8,15,10,5,357.8329527454932,0.790599593495935,0.21073499773783544,0.216084461281138,132487.35592689048,1281.6743660175357,133769.03029290802,1703,15,628.1951219512196,35,6,17,33.4116779089376,0.6473214285714286,42.62152777777778,1029.5138888888891,29.41468253968255,0
1711,4,0,0,41,0.0,0.0,1.0,41,1000,800,200,0.8,12,8,4,358.9116117178199,0.7901930894308943,0.21448938410247398,0.21690745229903038,132517.14677640607,1312.3885459533658,133829.53532235944,1704,16,629.1951219512196,35,6,17,33.35394184652278,0.6476190476190475,42.592592592592595,1029.62962962963,29.41798941798943,0
1712,4,0,0,41,0.0,0.0,1.0,41,850,400,450,0.47058823529411764,13,4,9,360.83726802171446,0.7888211382113821,0.22180323376267497,0.21876373878700675,132636.34366426614,1372.0271776406084,134008.37084190676,1705,17,630.1951219512196,35,6,15,33.184456928838955,0.6488095238095237,42.476851851851855,1030.0925925925928,29.431216931216937,0
1713,4,0,0,41,0.0,0.0,1.0,41,1350,800,550,0.5925925925925926,19,8,11,362.6099781315166,0.7880081300813008,0.2231937413713767,0.2205381998144138,132755.59413580224,1427.7006172839285,134183.29475308617,1706,18,631.1951219512196,35,6,15,33.018867924528315,0.6500000000000001,42.3611111111111,1030.5555555555536,29.44444444444439,0
1714,4,0,0,41,0.0,0.0,1.0,41,700,400,300,0.5714285714285714,10,4,6,361.9436442452503,0.788109756097561,0.21788033776161786,0.22083520431073186,132874.89819101486,1418.6449759944903,134293.54316700934,1707,19,632.1951219512196,35,6,16,32.916105373447095,0.6511904761904763,42.24537037037036,1031.0185185185167,29.457671957671906,0
1715,4,0,1,40,0.0,0.024390243902439025,0.975609756097561,41,1250,800,450,0.64,17,8,9,360.41319878765273,0.7874491869918699,0.21493953748019545,0.22078095125734332,133024.10361207539,1388.7285397376356,134412.83215181303,1708,20,633.1951219512196,35,6,17,32.80566307640526,0.6526785714285714,42.100694444444436,1031.5972222222206,29.474206349206302,0
1716,4,0,0,40,0.0,0.0,1.0,40,950,600,350,0.631578947368421,13,6,7,369.21188736748286,0.7881143162393163,0.22491344489324927,0.22609335717591775,133011.3112953513,1821.8714569160757,134833.18275226737,1709,21,607.875,34,6,18,32.59160415464512,0.654718137254902,42.11309523809523,1031.5476190476177,30.339635854341697,0
1717,4,0,0,40,0.0,0.0,1.0,40,1150,900,250,0.782608695652174,14,9,5,369.90629364323166,0.7866185897435898,0.22448078920041592,0.2268915673747971,133072.72002550995,1844.8873299319475,134917.6073554419,1710,22,608.875,34,6,18,32.51197069343487,0.6553308823529413,42.053571428571416,1031.7857142857124,30.34663865546213,0
1718,4,1,0,41,0.024390243902439025,0.0,1.0,41,850,600,250,0.7058823529411765,11,6,5,402.9212276671565,0.7959857723577236,0.2508377568030411,0.2293922049148868,130232.20663265287,2303.426162131501,132535.63279478438,1711,0,595.0,34,7,16,34.53974224399347,0.6268382352941178,44.82142857142856,1020.7142857142842,30.0210084033613,7
1719,4,1,0,42,0.023809523809523808,0.0,1.0,42,900,700,200,0.7777777777777778,11,7,4,385.3401706617302,0.8006436314363143,0.24190763918860592,0.22498219190738458,131206.12953514734,1716.3903061224364,132922.51984126976,1712,0,581.8095238095239,34,8,17,33.99929312882484,0.6366421568627452,43.86904761904761,1024.523809523809,30.1330532212885,2
1720,4,1,0,43,0.023255813953488372,0.0,1.0,43,1200,1000,200,0.8333333333333334,14,10,4,377.32923046059676,0.8086471022517534,0.23743222564373867,0.22224511133827476,131541.75347222213,1326.9664115646212,132868.71988378675,1713,0,569.2558139534884,34,9,19,33.86474411047928,0.6400122549019608,43.541666666666664,1025.8333333333328,30.171568627450966,0
1721,4,0,1,42,0.0,0.023255813953488372,0.9767441860465116,43,1250,900,350,0.72,16,9,7,375.9656628270153,0.807954964931709,0.22659327392340756,0.21856008992475903,131039.713700187,1253.2865635906526,132293.00026377765,1714,1,570.2558139534884,36,7,18,34.40799604047515,0.6307870370370369,44.03153153153155,1023.8738738738765,28.440940940941015,1
1722,4,0,0,42,0.0,0.0,1.0,42,1300,900,400,0.6923076923076923,17,9,8,383.4770853905671,0.7997241579558653,0.23077979354129985,0.2223664174497565,130942.8466461978,1642.716236925592,132585.56288312338,1715,3,584.8095238095239,35,7,18,34.31398186889818,0.631845238095238,44.12615740740741,1023.4953703703711,29.24272486772489,0
1723,4,0,0,42,0.0,0.0,1.0,42,1200,900,300,0.75,15,9,6,383.7671752446727,0.7979578010065815,0.24020248994816584,0.22322078891450509,131061.33355034735,1659.4075520833433,132720.7411024307,1716,4,585.8095238095239,35,7,18,34.18637673787724,0.6330357142857143,44.01041666666667,1023.9583333333344,29.25595238095241,0
1724,4,1,1,42,0.023255813953488372,0.023255813953488372,0.9767441860465116,43,950,700,250,0.7368421052631579,12,7,5,376.1624465853166,0.8069398301956441,0.23460527772751427,0.22049930752526634,131358.63272392293,1282.9794678287974,132641.61219175172,1717,0,573.1627906976744,34,9,18,34.07995587039833,0.6381740196078431,43.720238095238095,1025.1190476190477,30.150560224089638,0
1725,4,0,0,42,0.0,0.0,1.0,42,1450,1000,450,0.6896551724137931,19,10,9,385.41404849816496,0.7978368176538908,0.23846851480111275,0.22592242148520755,131358.63272392293,1725.4924886621325,133084.12521258506,1718,6,587.8095238095239,34,8,18,33.8428560368521,0.6381740196078431,43.720238095238095,1025.1190476190477,30.150560224089638,0
1726,4,1,1,42,0.023255813953488372,0.023255813953488372,0.9767441860465116,43,1150,800,350,0.6956521739130435,15,8,7,381.30022110766174,0.8075858250276855,0.22990917459826266,0.22524910463435252,131654.5718262386,1439.9834694358408,133094.55529567442,1719,0,575.1162790697674,35,8,15,33.64875850531934,0.6389880952380953,43.43171296296295,1026.273148148146,29.322089947089886,0
1727,4,2,1,43,0.045454545454545456,0.022727272727272728,0.9772727272727273,44,1150,600,550,0.5217391304347826,17,6,11,374.56648258715995,0.812984496124031,0.24675220801380582,0.22414230422589607,132144.21895438954,1099.3590575946175,133243.57801198415,1720,0,563.0,37,7,16,33.327001350822925,0.6399211711711712,42.95504385964911,1028.1798245614013,27.788643907064902,0
1728,4,1,1,43,0.022727272727272728,0.022727272727272728,0.9772727272727273,44,1000,600,400,0.6,14,6,8,376.4643181396633,0.8092186398872445,0.25337238712678434,0.22595084891031222,132256.98201610107,1158.0069107802358,133414.9889268813,1721,0,563.9772727272727,37,7,16,33.1644414241552,0.6410472972972973,42.8453947368421,1028.6184210526312,27.80049786628733,0
1729,4,0,0,43,0.0,0.0,1.0,43,900,700,200,0.7777777777777778,11,7,4,380.54295504163474,0.8024640088593576,0.2572298790860654,0.22802613290290102,132195.261139518,1461.1950633065617,133656.45620282457,1722,2,578.0930232558139,36,7,16,33.121851730179586,0.6423611111111112,42.90540540540541,1028.3783783783792,28.56606606606609,0
1730,4,0,0,43,0.0,0.0,1.0,43,950,700,250,0.7368421052631579,12,7,5,381.58283174986633,0.8024640088593576,0.25625946716564174,0.22917548770776014,132282.13168827622,1495.3180799042393,133777.44976818046,1723,3,579.0930232558139,36,7,16,33.007434774676156,0.6432291666666666,42.82094594594595,1028.716216216217,28.57545045045047,0
1731,4,0,0,43,0.0,0.0,1.0,43,1300,900,400,0.6923076923076923,17,9,8,382.995010742618,0.8010335917312661,0.2559895747166512,0.23037691989172504,132340.06123944905,1537.1166352163145,133877.17787466536,1724,4,580.0930232558139,36,7,16,32.9126536791799,0.6438078703703705,42.76463963963965,1028.9414414414425,28.581706706706736,0
1732,4,0,0,43,0.0,0.0,1.0,43,1200,1000,200,0.8333333333333334,14,10,4,383.9803055871202,0.8015873015873015,0.2631771912761418,0.23043864068546369,132253.17166828993,1556.5226544111688,133809.6943227011,1725,5,581.0930232558139,36,7,16,32.97501094810597,0.6429398148148149,42.8490990990991,1028.6036036036037,28.572322322322325,1
1733,4,0,0,43,0.0,0.0,1.0,43,1500,1200,300,0.8,18,12,6,382.0747758527429,0.802048726467331,0.26174559834290556,0.2301767552088477,132398.0034722223,1517.1875000000045,133915.1909722223,1726,6,582.0930232558139,36,7,17,32.87786774628879,0.6443865740740742,42.708333333333336,1029.1666666666672,28.587962962962976,0
1734,4,0,0,43,0.0,0.0,1.0,43,1450,1100,350,0.7586206896551724,18,11,7,381.58325545046137,0.8023717238833518,0.25862174204968547,0.23076701639146957,132542.91453615788,1515.2313631198858,134058.14589927776,1727,7,583.0930232558139,36,7,17,32.74437700495771,0.6458333333333334,42.56756756756757,1029.7297297297305,28.603603603603624,0
1735,4,0,0,43,0.0,0.0,1.0,43,1200,800,400,0.6666666666666666,16,8,8,380.00165631600623,0.8018641565153193,0.2576521467198545,0.23034295230765472,132629.89921932074,1479.9162760733789,134109.8154953941,1728,8,584.0930232558139,36,7,14,32.69742356328123,0.6467013888888888,42.48310810810811,1030.0675675675682,28.612987987988006,0
1736,4,0,0,43,0.0,0.0,1.0,43,1100,800,300,0.7272727272727273,14,8,6,382.0193933898479,0.8016334440753045,0.261626000970792,0.2322830211900666,132745.92318247317,1542.3034098287642,134288.22659230194,1729,9,585.0930232558139,36,7,14,32.52854879248171,0.6478587962962963,42.370495495495504,1030.5180180180193,28.625500500500536,0
1737,4,0,0,43,0.0,0.0,1.0,43,1250,900,350,0.72,16,9,7,382.6177526533435,0.801079734219269,0.2707234803458396,0.233549876219601,132891.02447041645,1569.2930261342492,134460.3174965507,1730,10,586.0930232558139,36,7,14,32.366981578564136,0.6493055555555556,42.22972972972973,1031.0810810810817,28.64114114114116,0
1738,4,0,0,43,0.0,0.0,1.0,43,1050,600,450,0.5714285714285714,15,6,9,382.9978706783924,0.8005260243632336,0.2757638312296704,0.2343271541445158,132978.12328798414,1586.0676132213503,134564.1909012055,1731,11,587.0930232558139,36,7,14,32.26948902718637,0.650173611111111,42.14527027027028,1031.4189189189206,28.65052552552557,0
1739,4,1,1,43,0.022727272727272728,0.022727272727272728,0.9772727272727273,44,1200,1000,200,0.8333333333333334,14,10,4,376.314070487842,0.8060253699788584,0.27436599187156663,0.23207266547373978,133274.01369892654,1230.5773170590917,134504.59101598564,1732,0,574.7272727272727,37,7,14,32.14432674949558,0.6511824324324325,41.858552631578945,1032.565789473684,27.907183499288756,0
1740,4,0,0,43,0.0,0.0,1.0,43,800,400,400,0.5,12,4,8,387.1441701257895,0.7991878922111479,0.28353110756955924,0.2377874782193524,133123.35139193258,1707.5858797987285,134830.9372717313,1733,13,589.0930232558139,36,7,14,32.01635930452496,0.6516203703703705,42.00450450450451,1031.9819819819827,28.666166166166185,0
1741,4,0,0,43,0.0,0.0,1.0,43,1050,200,850,0.19047619047619047,19,2,17,387.4727325775782,0.800110741971207,0.2770254675131316,0.23891980396797696,133268.65875588442,1727.5942750182767,134996.2530309027,1734,14,590.0930232558139,36,7,14,31.861662485912678,0.6530671296296295,41.863738738738746,1032.5450450450462,28.68180680680684,0
1742,4,2,1,44,0.044444444444444446,0.022222222222222223,0.9777777777777777,45,1650,1300,350,0.7878787878787878,20,13,7,371.62699435980744,0.8091329966329966,0.26664782629174333,0.2325379521736833,133812.3509156664,945.8117054081531,134758.16262107456,1735,0,564.8222222222222,37,8,14,31.72513070510103,0.6565315315315314,41.33771929824562,1034.6491228070179,27.963489805595078,0
1743,4,0,0,44,0.0,0.0,1.0,44,1700,1500,200,0.8823529411764706,19,15,4,376.8719771575082,0.8025898520084567,0.26884301025522417,0.23509632860777904,133698.92659279788,1277.4757617728649,134976.40235457075,1736,1,578.6590909090909,37,7,16,31.70324427480916,0.6554054054054053,41.44736842105264,1034.2105263157903,27.95163584637271,0
1744,4,0,0,44,0.0,0.0,1.0,44,1250,800,450,0.64,17,8,9,377.7897496819788,0.8032725510923185,0.2710220047015295,0.2363941696285909,133812.35091566632,1310.5869113573312,135122.93782702365,1737,2,579.6590909090909,37,7,14,31.56572347039705,0.6565315315315315,41.33771929824561,1034.6491228070172,27.96348980559506,0
1745,4,0,0,44,0.0,0.0,1.0,44,1100,700,400,0.6363636363636364,15,7,8,379.76267976640315,0.8030082804792108,0.27215180729853916,0.23817806872525413,133897.45071800923,1369.8509397122007,135267.30165772143,1738,3,580.6590909090909,37,7,14,31.42933132040823,0.6573761261261262,41.25548245614034,1034.9780701754373,27.97238027501182,0
1746,4,1,1,44,0.022222222222222223,0.022222222222222223,0.9777777777777777,45,550,300,250,0.5454545454545454,8,3,5,373.9906014116266,0.8083333333333333,0.26850935093509376,0.236081567141089,134135.43721236012,1033.0785667323912,135168.5157790925,1739,0,568.7333333333333,38,7,14,31.340243399339922,0.6578947368421053,41.025641025641015,1035.8974358974344,27.26045883940617,0
1747,4,0,0,44,0.0,0.0,1.0,44,1250,900,350,0.72,16,9,7,384.518784517938,0.8022815362931642,0.27833030206799747,0.24265524097133956,134124.5157764886,1514.6791560864567,135639.19493257508,1740,5,582.6590909090909,37,7,15,31.078539042376768,0.6596283783783785,41.0361842105263,1035.8552631578923,27.996088193456547,0
1748,4,0,0,44,0.0,0.0,1.0,44,1150,800,350,0.6956521739130435,15,8,7,384.8959367767542,0.8012905214940099,0.2820951794713964,0.24383621946473732,134266.5291243459,1535.728301015689,135802.25742536157,1741,6,583.6590909090909,37,7,15,30.926435322330374,0.6610360360360361,40.89912280701754,1036.4035087719294,28.01090564248458,0
1749,4,0,0,44,0.0,0.0,1.0,44,1300,900,400,0.6923076923076923,17,9,8,382.51484219188615,0.7998370331219169,0.27666110934192556,0.24329548219622835,134412.26189823938,1482.9370297318937,135895.19892797127,1742,7,584.6590909090909,38,6,15,30.84217666048492,0.6606359649122808,40.758547008547005,1036.9658119658113,27.288573999100297,0
1750,4,0,0,44,0.0,0.0,1.0,44,1000,500,500,0.5,15,5,10,379.54671042095106,0.7989341085271319,0.2742439846456324,0.24214182379680907,134523.0716725107,1411.55786580465,135934.62953831535,1743,8,585.6590909090909,38,6,16,30.808230346721572,0.6617324561403508,40.6517094017094,1037.393162393162,27.299820062977943,0
1751,4,0,0,44,0.0,0.0,1.0,44,1000,800,200,0.8,12,8,4,380.46898575625534,0.7983835447498239,0.27575839786908696,0.24330476778236615,134609.20538359325,1442.9312762873678,136052.1366598806,1744,9,586.6590909090909,36,8,16,30.698137095315616,0.6663773148148147,40.5686936936937,1037.7252252252267,28.825700700700743,0
1752,4,1,1,44,0.022222222222222223,0.022222222222222223,0.9777777777777777,45,1350,900,450,0.6666666666666666,18,9,9,375.46800418500334,0.8017255892255892,0.2714798395609037,0.24198529739106964,134892.2805574793,1129.5470721760637,136021.82762965537,1745,0,574.6,37,8,12,30.54500035184012,0.6672297297297296,40.29605263157895,1038.8157894736848,28.0761024182077,0
1753,4,0,0,44,0.0,0.0,1.0,44,1700,1300,400,0.7647058823529411,21,13,8,368.14428559557655,0.7982293868921776,0.2542188350571588,0.2306497768614977,133858.89788333702,1057.9095415668344,134916.80742490385,1746,11,588.6590909090909,38,6,17,31.768574919127268,0.6551535087719298,41.292735042735046,1034.82905982906,27.232343679712105,4
1754,4,0,0,44,0.0,0.0,1.0,44,850,500,350,0.5882352941176471,12,5,7,366.8556825984763,0.7973264622973926,0.252650889572855,0.23018768478070198,133914.18292059316,1025.4357969902824,134939.61871758345,1747,12,589.6590909090909,38,6,17,31.746533512248835,0.6557017543859649,41.23931623931624,1035.0427350427349,27.237966711650916,0
1755,4,0,0,44,0.0,0.0,1.0,44,1300,800,500,0.6153846153846154,18,8,10,367.21308900037104,0.797216349541931,0.24544188402127154,0.23127982272128614,134052.44545118333,1045.1625164365448,135097.60796761987,1748,13,590.6590909090909,38,6,18,31.598834210254807,0.6570723684210527,41.105769230769226,1035.5769230769222,27.252024291497953,0
1756,4,0,0,44,0.0,0.0,1.0,44,1400,1200,200,0.8571428571428571,16,12,4,367.9275169533325,0.7965116279069768,0.24340939559563868,0.2324295199932549,134163.10683988954,1072.459753269036,135235.56659315858,1749,14,591.6590909090909,38,6,19,31.46956962634491,0.6581688596491229,40.99893162393162,1036.0042735042725,27.263270355375592,0
1757,4,0,0,44,0.0,0.0,1.0,44,1300,600,700,0.46153846153846156,20,6,14,369.4951398579633,0.7971282593375617,0.2430554921006225,0.23399790874900575,134253.74484592027,1121.2212456597417,135374.96609158002,1750,15,592.6590909090909,39,5,19,31.338262639461263,0.6573183760683761,40.91145833333334,1036.3541666666679,26.573183760683794,0
1758,4,0,0,44,0.0,0.0,1.0,44,1050,500,550,0.47619047619047616,16,5,11,367.9820483446278,0.7967758985200846,0.24598151496885712,0.2339012330282518,134388.72070312497,1090.5273437500014,135479.24804687497,1751,16,593.6590909090909,39,5,19,31.242465340566618,0.6586538461538461,40.78125,1036.8749999999998,26.586538461538456,0
1759,4,0,0,44,0.0,0.0,1.0,44,1400,1100,300,0.7857142857142857,17,11,6,368.8650183061565,0.7959390415785765,0.25438116100766717,0.23550612707239196,134550.78124999977,1126.4105902777485,135677.19184027752,1752,17,594.6590909090909,37,7,19,31.057563587684065,0.6638513513513514,40.624999999999986,1037.4999999999982,28.04054054054049,0
1760,4,0,0,44,0.0,0.0,1.0,44,1000,700,300,0.7,13,7,6,368.8650183061565,0.7959390415785765,0.25438116100766717,0.23550612707239196,134550.78124999977,1126.2152777777485,135676.99652777752,1753,18,595.6590909090909,37,7,19,31.057563587684065,0.6638513513513514,40.624999999999986,1037.4999999999982,28.04054054054049,0
1761,4,0,0,44,0.0,0.0,1.0,44,1350,1000,350,0.7407407407407407,17,10,7,367.4949653639529,0.7950581395348838,0.25646195798287064,0.23573457534321854,134721.47680055402,1101.8928901200345,135823.36969067407,1754,19,596.6590909090909,37,7,19,30.92258132657373,0.6655405405405406,40.46052631578947,1038.157894736842,28.05832147937411,0
1762,4,0,0,44,0.0,0.0,1.0,44,1250,800,450,0.64,17,8,9,371.3452023602996,0.7939790345313601,0.25444371928746934,0.23895256499706224,134835.3339489073,1214.0908741151043,136049.4248230224,1755,20,597.6590909090909,37,7,17,30.708931587837828,0.6666666666666667,40.35087719298245,1038.5964912280697,28.07017543859648,0
1763,4,0,1,43,0.0,0.022727272727272728,0.9772727272727273,44,1250,600,650,0.48,19,6,13,370.54248048271336,0.7934725158562368,0.25200534759358284,0.23893601327678396,134911.26543209868,1198.0709876543096,136109.33641975297,1756,21,598.6590909090909,38,6,18,30.653966131907293,0.6655701754385965,40.27777777777777,1038.8888888888882,27.33918128654969,0
1764,4,0,0,43,0.0,0.0,1.0,43,1150,800,350,0.6956521739130435,15,8,7,352.2403169983469,0.7907899593946105,0.18630036526718086,0.21433368366430783,132773.48632812503,757.4930073302478,133530.97933545528,1757,22,593.8604651162791,39,4,15,33.26805808233945,0.6426282051282051,42.34375,1030.6250000000002,26.426282051282058,8
1765,4,0,0,43,0.0,0.0,1.0,43,850,600,250,0.7058823529411765,11,6,5,354.3464806828524,0.7900516795865633,0.1908217555601508,0.2159244318249699,132827.170138889,813.3680555555663,133640.53819444455,1758,23,594.8604651162791,39,4,15,33.15986257073565,0.6431623931623931,42.29166666666667,1030.8333333333342,26.431623931623953,0
1766,4,0,1,42,0.0,0.023255813953488372,0.9767441860465116,43,950,700,250,0.7368421052631579,12,7,5,350.0101846408271,0.7898209671465485,0.18708928898554666,0.21420277183643216,132988.2866753473,709.4509548611223,133697.73763020843,1759,24,595.8604651162791,39,4,15,33.10989362418366,0.6447649572649572,42.13541666666667,1031.4583333333342,26.447649572649595,0
1767,4,0,0,42,0.0,0.0,1.0,42,1000,600,400,0.6,14,6,8,358.7746984121715,0.7826413085559427,0.20299505756311298,0.21949372233657158,132975.8896285337,1141.6769395134652,134117.5665680472,1760,40,610.4761904761905,38,4,16,32.89633830536565,0.6463815789473685,42.14743589743589,1031.4102564102552,27.142375168690926,0
1768,4,0,0,42,0.0,0.0,1.0,42,1150,900,250,0.782608695652174,14,9,5,359.1144571958921,0.7831494386372435,0.19561679906507545,0.22018846432639544,133058.5475221892,1156.6496137409483,134215.19713593015,1761,41,611.4761904761905,38,4,17,32.80457181319251,0.647203947368421,42.067307692307686,1031.7307692307681,27.150809716599163,0
1769,4,0,0,42,0.0,0.0,1.0,42,1000,900,100,0.9,11,9,2,357.0154098639797,0.7827864885791715,0.1975581618919442,0.2192251648999477,133113.66705246904,1104.7260802469082,134218.39313271595,1762,42,612.4761904761905,38,4,17,32.80338716913413,0.6477521929824561,42.013888888888886,1031.944444444444,27.156432748538,0
1770,4,0,0,42,0.0,0.0,1.0,42,1150,700,450,0.6086956521739131,16,7,9,358.85652932929327,0.7823993418505614,0.19614395126711437,0.2208453367120784,133196.36774965297,1159.6772499817325,134356.0449996347,1763,43,613.4761904761905,38,4,17,32.672885185951834,0.6485745614035088,41.93376068376068,1032.264957264957,27.16486729644624,0
1771,4,0,0,42,0.0,0.0,1.0,42,950,400,550,0.42105263157894735,15,4,11,360.2569514494982,0.7826655052264808,0.2003902554399246,0.2220359170158129,133251.51581561824,1200.9569727518306,134452.47278837007,1764,44,614.4761904761905,38,4,18,32.58140176600441,0.6491228070175439,41.880341880341874,1032.4786324786314,27.17049032838504,0
1772,4,0,0,42,0.0,0.0,1.0,42,1050,700,350,0.6666666666666666,14,7,7,360.66355666236615,0.7823509485094851,0.20012856699522663,0.22278176372237027,133334.25931633066,1217.7616379940127,134552.02095432466,1765,45,615.4761904761905,38,4,18,32.48788834867762,0.6499451754385964,41.800213675213676,1032.7991452991455,27.1789248762933,0
1773,4,0,0,42,0.0,0.0,1.0,42,1100,700,400,0.6363636363636364,15,7,8,359.69844804384104,0.7811411149825784,0.19822555146787302,0.22251594972078698,133389.43591798164,1195.9946170282801,134585.43053500992,1766,46,616.4761904761905,38,4,18,32.457467163098585,0.6504934210526315,41.746794871794876,1033.0128205128208,27.184547908232126,0
1774,4,0,0,42,0.0,0.0,1.0,42,1150,800,350,0.6956521739130435,15,8,7,359.65140478668013,0.7817460317460317,0.19201228878648213,0.2229838709677419,133472.22222222234,1200.6944444444546,134672.9166666668,1767,47,617.4761904761905,38,4,18,32.375672043010745,0.6513157894736842,41.66666666666667,1033.3333333333344,27.192982456140378,0
1775,4,0,0,42,0.0,0.0,1.0,42,1050,800,250,0.7619047619047619,13,8,5,356.31773417414155,0.7820605884630275,0.18937511364325132,0.22159390486766525,133585.55036164966,1119.7801246537283,134705.3304863034,1768,48,618.4761904761905,37,5,18,32.34823575166172,0.6542792792792793,41.557017543859644,1033.7719298245606,27.939781887150286,0
1776,4,0,0,42,0.0,0.0,1.0,42,450,300,150,0.6666666666666666,6,3,3,353.7884214657538,0.7832220286488579,0.18633035398676978,0.22035831006750708,133642.23246575863,1056.2148930440067,134698.44735880263,1769,49,619.4761904761905,37,5,18,32.356839872746555,0.6548423423423424,41.50219298245614,1033.9912280701749,27.945708866761482,0
1777,4,0,0,42,0.0,0.0,1.0,42,1200,800,400,0.6666666666666666,16,8,8,355.28794084351665,0.7817460317460317,0.18416349896260886,0.22180219364506215,133727.27816491597,1102.3378587642192,134829.6160236802,1770,50,620.4761904761905,37,5,15,32.23291900773879,0.6556869369369369,41.41995614035087,1034.3201754385952,27.95459933617825,0
1778,4,0,0,42,0.0,0.0,1.0,42,1050,700,350,0.6666666666666666,14,7,7,353.1907696090257,0.7817460317460317,0.14867101044575404,0.21849018242800228,133389.43591798184,1022.3835059171822,134411.81942389903,1771,51,621.4761904761905,38,4,21,32.625530044472015,0.6504934210526314,41.74679487179488,1033.0128205128224,27.18454790823217,1
1779,4,0,0,42,0.0,0.0,1.0,42,750,400,350,0.5333333333333333,11,4,7,353.1477627471383,0.7806329849012776,0.15149769585253448,0.21895161290322593,133472.22222222228,1027.0833333333421,134499.30555555562,1772,52,622.4761904761905,38,4,21,32.543682795698935,0.6513157894736842,41.66666666666667,1033.333333333334,27.192982456140367,0
1780,4,0,0,42,0.0,0.0,1.0,42,1250,1100,150,0.88,14,11,3,348.68219302420334,0.7811169183120402,0.14936004369713207,0.2169901981926185,133610.2564673279,917.5034471108363,134527.75991443873,1773,53,623.4761904761905,38,4,22,32.52083979194656,0.6526864035087718,41.533119658119666,1033.8675213675224,27.207040035987433,0
1781,4,0,0,42,0.0,0.0,1.0,42,1000,800,200,0.8,12,8,4,348.6627828087863,0.7801490514905149,0.1488408812548878,0.21762762091372423,133720.73522764645,924.6887327416312,134645.42396038809,1774,54,624.4761904761905,38,4,15,32.410778845160635,0.653782894736842,41.42628205128206,1034.294871794873,27.21828609986508,0
1782,4,1,1,42,0.023255813953488372,0.023255813953488372,0.9767441860465116,43,800,400,400,0.5,12,4,8,342.75272947047597,0.7858988556662975,0.155623723316884,0.21547244643940958,133983.9965820315,584.6761067708617,134568.67268880238,1775,0,610.9302325581396,39,4,15,32.300470369252444,0.6546474358974358,41.171875000000014,1035.312500000002,26.54647435897441,0
1783,4,0,0,42,0.0,0.0,1.0,42,1300,800,500,0.6153846153846154,18,8,10,345.58828485369725,0.778164924506388,0.15645591638781187,0.21733264558839588,133997.13187824166,861.5677962232446,134858.6996744649,1776,56,626.4761904761905,38,4,16,32.213952808447694,0.6565241228070176,41.159188034188034,1035.363247863248,27.24640125955916,0
1784,4,0,1,41,0.0,0.023809523809523808,0.9761904761904762,42,950,500,450,0.5263157894736842,14,5,9,335.82503704757335,0.7772454510259388,0.17008209518045092,0.20715828203189804,133283.92062717042,605.5741447712683,133889.49477194168,1777,57,627.4761904761905,39,3,21,33.17960002017553,0.6477029914529913,41.84895833333335,1032.604166666669,26.477029914529975,5
1785,4,0,0,41,0.0,0.0,1.0,41,950,800,150,0.8421052631578947,11,8,3,341.12109872304273,0.7785060975609757,0.16577791243750917,0.20962021715423657,133141.23109796218,883.4566074951013,134024.6877054573,1778,58,636.9268292682926,38,3,21,33.185817805383024,0.6480263157894735,41.9871794871795,1032.0512820512845,27.159244264507485,0
1786,4,2,0,43,0.046511627906976744,0.0,1.0,43,1000,700,300,0.7,13,7,6,331.09935299539745,0.7938815060908084,0.159655598817672,0.19822859488801367,132162.78029777252,174.9161146585147,132337.69641243105,1779,0,608.2558139534884,40,3,20,34.42565230282664,0.6348958333333332,42.9369918699187,1028.2520325203254,25.706300813008134,5
1787,4,1,0,44,0.022727272727272728,0.0,1.0,44,750,500,250,0.6666666666666666,10,5,5,325.0653030817045,0.7997709654686399,0.16027416470918165,0.19556713013709034,132346.95845930965,-195.71916729655143,132151.2392920131,1780,0,595.4090909090909,41,3,21,34.395889574495435,0.6351626016260162,42.757936507936506,1028.968253968254,25.096786682152537,0
1788,4,0,0,44,0.0,0.0,1.0,44,750,300,450,0.4,12,3,9,325.01685414637416,0.7984716349541932,0.1625587408232203,0.19594570543467885,132425.49332493238,-191.86702445059984,132233.6263004818,1781,1,596.4090909090909,38,6,22,34.31834302124417,0.6408991228070176,42.681623931623925,1029.2735042735037,27.08614484930273,0
1789,4,0,1,43,0.0,0.022727272727272728,0.9772727272727273,44,700,600,100,0.8571428571428571,8,6,2,318.8975373572209,0.7996828752642706,0.14376382597703596,0.1897990170615735,131938.95266439908,-384.99858276643835,131553.95408163263,1782,2,597.4090909090909,41,3,18,34.964030513711876,0.6310975609756098,43.154761904761905,1027.3809523809523,25.058072009291518,4
1790,4,1,1,43,0.022727272727272728,0.022727272727272728,0.9772727272727273,44,900,600,300,0.6666666666666666,12,6,6,319.32067202337487,0.8006959126145173,0.1533783783783782,0.19056233653007848,132040.89506172828,-367.32253086420906,131673.57253086407,1783,0,598.3409090909091,41,3,19,34.85078828828828,0.6321138211382114,43.05555555555555,1027.777777777777,25.067750677506755,0
1791,4,0,0,43,0.0,0.0,1.0,43,1200,800,400,0.6666666666666666,16,8,8,329.84627064701743,0.7936969361387965,0.16317254387780955,0.19639256750537964,131953.868604997,104.89829136096387,132058.76689635796,1784,5,613.2558139534884,40,3,19,34.66782063963072,0.6328125,43.140243902439025,1027.4390243902437,25.685975609756092,0
1792,4,0,0,43,0.0,0.0,1.0,43,1250,1100,150,0.88,14,11,3,333.38188050641025,0.7939737910668143,0.16576549238139893,0.19931980515383266,132110.53688280794,208.65184414040098,132319.18872694834,1785,6,614.2558139534884,40,3,19,34.419483985765126,0.634375,42.987804878048784,1028.0487804878055,25.701219512195138,0
1793,4,1,2,42,0.022727272727272728,0.045454545454545456,0.9545454545454546,44,1200,700,500,0.5833333333333334,17,7,10,327.638873619394,0.7998810782241015,0.1587040217411817,0.1975264648591516,132425.49332493247,-121.514853573642,132303.97847135883,1786,0,601.2727272727273,38,6,19,34.25087364196247,0.6408991228070176,42.68162393162393,1029.2735042735044,27.086144849302748,0
1794,4,1,1,42,0.023255813953488372,0.023255813953488372,0.9767441860465116,43,850,600,250,0.7058823529411765,11,6,5,337.78803045407744,0.7906976744186046,0.17036431631869564,0.20410743925120925,132510.8747403049,352.11747845492295,132862.9922187598,1787,0,616.0697674418604,37,6,20,33.90397586084486,0.6435810810810809,42.59868421052632,1029.6052631578962,27.827169274537734,0
1795,4,0,0,42,0.0,0.0,1.0,42,900,400,500,0.4444444444444444,14,4,10,339.9955719664522,0.7895373596593109,0.1702755905511808,0.20561636971304528,132542.914536158,612.8008075643448,133155.71534372235,1788,1,622.6428571428571,36,6,20,33.81497885680956,0.6458333333333333,42.56756756756758,1029.7297297297316,28.603603603603656,0
1796,4,0,0,42,0.0,0.0,1.0,42,1550,1100,450,0.7096774193548387,20,11,9,336.6195298383699,0.788472706155633,0.17158256337360767,0.20503189544700748,132810.65088757424,541.331771860645,133351.9826594349,1789,2,623.6428571428571,38,4,16,33.633265961857376,0.644736842105263,42.30769230769232,1030.769230769233,27.125506072874554,0
1797,4,0,0,42,0.0,0.0,1.0,42,650,400,250,0.6153846153846154,9,4,5,336.14429647805554,0.7886904761904762,0.1723716743407906,0.2048930080048491,132838.18354381275,530.5595505515606,133368.7430943643,1790,3,624.6428571428571,38,4,16,33.617905136974485,0.6450109649122806,42.28098290598292,1030.87606837607,27.128317588843945,0
1798,4,0,0,42,0.0,0.0,1.0,42,1400,900,500,0.6428571428571429,19,9,10,340.0352715191167,0.788835656213705,0.16878766454566896,0.2079486858128955,132961.42713758696,642.3149956597417,133603.7421332467,1791,4,625.6428571428571,39,3,16,33.39403848096153,0.6444978632478633,42.16145833333334,1031.354166666668,26.44497863247867,0
1799,4,0,0,42,0.0,0.0,1.0,42,1150,800,350,0.6956521739130435,15,8,7,339.58309953257225,0.7882549361207898,0.1765905069620739,0.20812073129768557,133042.01388888905,635.7638888889073,133677.77777777796,1792,5,626.6428571428571,39,3,17,33.324919224555735,0.6452991452991452,42.08333333333334,1031.666666666668,26.45299145299149,0
1800,4,1,1,42,0.023255813953488372,0.023255813953488372,0.9767441860465116,43,1050,800,250,0.7619047619047619,13,8,5,330.9150586200883,0.7946659283868586,0.16483911352801295,0.2041547000994971,133288.51176754906,221.43513698856358,133509.94690453762,1793,0,613.046511627907,40,3,17,33.30175835711708,0.6460937500000001,41.84451219512195,1032.621951219512,25.815548780487802,0
1801,4,0,0,42,0.0,0.0,1.0,42,1000,800,200,0.8,12,8,4,337.8030936348426,0.7879645760743321,0.16200567007832367,0.20792724583362054,133203.26063368062,599.2947048611154,133802.55533854174,1794,7,628.6428571428571,39,3,18,33.209300369996626,0.6469017094017094,41.927083333333336,1032.2916666666672,26.469017094017108,0
1802,4,0,0,42,0.0,0.0,1.0,42,1500,1200,300,0.8,18,12,6,342.2935930388202,0.7868273325590399,0.17327868931176416,0.21176079614260623,133391.50526258672,731.811523437495,134123.31678602422,1795,8,629.6428571428571,39,3,18,32.90488134852611,0.6487713675213675,41.744791666666664,1033.0208333333328,26.487713675213662,0
1803,4,0,0,42,0.0,0.0,1.0,42,1050,600,450,0.5714285714285714,15,6,9,344.51210494477226,0.7869967092528068,0.17079910682711463,0.21392431496768247,133528.88028047077,800.5119513936825,134329.39223186445,1796,9,630.6428571428571,37,5,18,32.710057288351365,0.6537162162162162,41.61184210526315,1033.5526315789461,27.933854907539086,0
1804,4,0,0,42,0.0,0.0,1.0,42,1050,800,250,0.7619047619047619,13,8,5,343.90686492333066,0.7868273325590399,0.17824449258019404,0.21436785479788042,133670.5780264119,794.0458843105507,134464.62391072247,1797,10,631.6428571428571,37,5,19,32.58392093450676,0.6551238738738738,41.47478070175438,1034.1008771929821,27.948672356567084,0
1805,4,0,0,42,0.0,0.0,1.0,42,1050,700,350,0.6666666666666666,14,7,7,344.963108067772,0.7876258226867983,0.1752338570520391,0.21618604342255193,133869.08111149582,835.9788588796494,134705.05997037547,1798,11,632.6428571428571,37,5,17,32.35810906265452,0.6570945945945945,41.2828947368421,1034.8684210526312,27.96941678520625,0
1806,4,0,1,41,0.0,0.023809523809523808,0.9761904761904762,42,1000,600,400,0.6,14,6,8,345.50955185291605,0.787045102593883,0.17571630347054135,0.21686237829065988,133925.8233302553,854.5302400738526,134780.35357032917,1799,12,633.6428571428571,37,5,17,32.287252824858754,0.6576576576576577,41.22807017543859,1035.0877192982443,27.975343764817413,0
1807,4,1,1,41,0.023809523809523808,0.023809523809523808,0.9761904761904762,42,900,600,300,0.6666666666666666,12,6,6,336.87079230816477,0.7933604336043361,0.15443411560767473,0.21281016762294924,134163.10683988954,639.1264199357024,134802.23325982524,1800,0,591.9285714285714,38,4,18,32.273942112680906,0.6581688596491229,40.99893162393162,1036.0042735042725,27.263270355375592,0
1808,4,0,0,41,0.0,0.0,1.0,41,1250,900,350,0.72,16,9,7,341.67848398335593,0.7846036585365853,0.1612542432745323,0.21558698253366052,134118.8368055555,965.104166666662,135083.94097222216,1801,14,607.3658536585366,39,2,18,32.19361759184768,0.6559829059829061,41.041666666666664,1035.833333333333,26.559829059829053,0
1809,4,0,0,41,0.0,0.0,1.0,41,800,500,300,0.625,11,5,6,343.19353278786735,0.7829268292682927,0.16575951042984483,0.21718125090163506,134226.7578125,1013.1510416666677,135239.90885416666,1802,15,608.3658536585366,39,2,18,32.04664254121432,0.6570512820512822,40.9375,1036.25,26.57051282051282,0
1810,4,0,0,41,0.0,0.0,1.0,41,950,700,250,0.7368421052631579,12,7,5,341.3426246626898,0.7825711382113821,0.16320288604815314,0.216648074020605,134334.72222222213,970.8333333333245,135305.55555555545,1803,16,609.3658536585366,39,2,18,31.986870310825296,0.6581196581196582,40.83333333333333,1036.6666666666658,26.58119658119656,0
1811,4,0,0,41,0.0,0.0,1.0,41,750,500,250,0.6666666666666666,10,5,5,340.20710659832906,0.7817581300813008,0.15986709595848225,0.21624658614813325,134388.720703125,943.9995659722226,135332.72026909722,1804,17,610.3658536585366,39,2,18,31.962443908646446,0.6586538461538463,40.78125,1036.875,26.58653846153846,0
1812,4,1,1,41,0.023809523809523808,0.023809523809523808,0.9761904761904762,42,850,500,350,0.5882352941176471,12,5,7,331.04479282261843,0.7869725125822686,0.15468959126943305,0.21168124244148065,134606.20896568403,512.3322244365831,135118.5411901206,1805,0,596.8095238095239,38,4,18,31.983338481073478,0.6625548245614036,40.57158119658119,1037.7136752136744,27.308254610886166,0
1813,4,0,0,41,0.0,0.0,1.0,41,950,600,350,0.631578947368421,13,6,7,338.84069780991115,0.7803353658536586,0.16426862330677738,0.21617645800697655,134523.7643771701,916.4252387152725,135440.18961588538,1806,19,612.3658536585366,39,2,18,31.86324346487263,0.6599893162393162,40.651041666666664,1037.395833333333,26.599893162393155,0
1814,4,1,0,42,0.023809523809523808,0.0,1.0,42,900,700,200,0.7777777777777778,11,7,4,332.15560910413166,0.7869967092528068,0.17141854234422738,0.21381043114120676,134848.14588758664,558.1163194444259,135406.26220703108,1807,0,598.7619047619048,39,3,16,31.71374068130914,0.6631944444444446,40.33854166666666,1038.645833333332,26.631944444444407,0
1815,4,0,0,42,0.0,0.0,1.0,42,1200,700,500,0.5833333333333334,17,7,10,332.91611409895654,0.7854965156794425,0.17003409344958653,0.21488221910023553,134946.4604402141,585.1702442329274,135531.63068444704,1808,1,599.7619047619048,40,2,16,31.59620337767344,0.6625000000000001,40.24390243902439,1039.0243902439022,25.975609756097555,0
1816,4,0,0,42,0.0,0.0,1.0,42,1200,1000,200,0.8333333333333334,14,10,4,332.3370676155039,0.7836575687185443,0.16886883811013642,0.21513566630198538,135052.07300548602,576.5619836076244,135628.63498909364,1809,2,600.7619047619048,40,2,16,31.506241037674354,0.6635416666666668,40.14227642276422,1039.430894308942,25.98577235772355,0
1817,4,0,0,42,0.0,0.0,1.0,42,1300,1100,200,0.8461538461538461,15,11,4,333.9579079174061,0.7837059620596206,0.16941195082684213,0.21713629159000852,135210.56931224806,630.9277711679608,135841.49708341603,1810,3,601.7619047619048,40,2,16,31.306592404403617,0.6651041666666667,39.989837398373986,1040.0406504065045,26.00101626016261,0
1818,4,0,0,42,0.0,0.0,1.0,42,1350,800,550,0.5925925925925926,19,8,11,332.3525000780752,0.780173248161053,0.17166011102742185,0.21736617533841945,135422.0423111244,601.570865556222,136023.6131766806,1811,4,602.7619047619048,40,2,16,31.138327475102518,0.6671875,39.78658536585366,1040.853658536586,26.02134146341465,0
1819,4,0,0,42,0.0,0.0,1.0,42,1100,500,600,0.45454545454545453,17,5,12,330.2386130393947,0.7789150212930701,0.1699246163427306,0.2166213078874289,135527.84077764564,551.3052333267287,136079.14601097238,1812,5,603.7619047619048,40,2,18,31.088351551825106,0.6682291666666667,39.6849593495935,1041.2601626016265,26.03150406504066,0
1820,4,0,0,42,0.0,0.0,1.0,42,800,500,300,0.625,11,5,6,331.6958782079525,0.7786972512582269,0.1718198208245041,0.21789867691507017,135580.75550267703,594.3155529116256,136175.07105558866,1813,6,604.7619047619048,40,2,18,30.997918293000257,0.6687500000000001,39.63414634146341,1041.4634146341466,26.036585365853664,0
1821,4,0,0,42,0.0,0.0,1.0,42,1450,1200,250,0.8275862068965517,17,12,5,335.0488868721366,0.7775116144018583,0.17660376819460932,0.2205940696252954,135660.80864800344,690.610913784677,136351.41956178812,1814,7,605.7619047619048,39,3,19,30.831187714561874,0.671207264957265,39.557291666666664,1041.7708333333333,26.712072649572647,0
1822,4,0,0,42,0.0,0.0,1.0,42,1000,600,400,0.6,14,6,8,335.60954772329467,0.7757452574525745,0.17086414817775974,0.22180377374632038,135796.4898003474,714.9197048611305,136511.40950520852,1815,8,606.7619047619048,39,3,19,30.682007462189354,0.672542735042735,39.42708333333334,1042.291666666668,26.72542735042739,0
1823,4,0,0,42,0.0,0.0,1.0,42,1000,800,200,0.8,12,8,4,337.3803421061318,0.7748499806426635,0.17667194762808736,0.22348377525746357,135877.93104383684,768.5085720486165,136646.43961588547,1816,9,607.7619047619048,39,3,17,30.555104572551375,0.673344017094017,39.348958333333336,1042.604166666667,26.733440170940177,0
1824,4,0,0,42,0.0,0.0,1.0,42,1200,900,300,0.75,15,9,6,335.8829971353593,0.7755516840882695,0.17239312824610464,0.2230013638805847,135959.39670138893,733.2899305555613,136692.6866319445,1817,10,608.7619047619048,39,3,18,30.513383939272863,0.6741452991452992,39.270833333333336,1042.916666666667,26.741452991453,0
1825,4,0,0,42,0.0,0.0,1.0,42,750,600,150,0.8,9,6,3,335.4742998687743,0.7748499806426635,0.17470859311466547,0.22290007727843658,135986.55734592024,723.9990234375102,136710.55636935774,1818,11,609.7619047619048,39,3,18,30.49712457139053,0.6744123931623931,39.24479166666667,1043.0208333333342,26.744123931623953,0
1826,4,0,0,42,0.0,0.0,1.0,42,1100,700,400,0.6363636363636364,15,7,8,336.33400556975374,0.7743176538908246,0.17721380543429688,0.2236420140621192,136013.720703125,749.2078993055559,136762.92860243056,1819,12,610.7619047619048,39,3,18,30.447789761001264,0.6746794871794872,39.21875,1043.125,26.746794871794872,0
1827,4,0,0,42,0.0,0.0,1.0,42,1150,800,350,0.6956521739130435,15,8,7,333.8811256621991,0.7737369337979094,0.1715731020842841,0.22235062198354963,136068.05555555553,686.111111111107,136754.16666666663,1820,13,611.7619047619048,39,3,18,30.457933972310954,0.6752136752136753,39.166666666666664,1043.3333333333333,26.75213675213675,0
1828,4,0,0,42,0.0,0.0,1.0,42,1100,700,400,0.6363636363636364,15,7,8,334.7160979374894,0.7734949670925281,0.16761267749587594,0.22307725569127293,136095.22705078125,710.6526692708338,136805.8797200521,1821,14,612.7619047619048,39,3,18,30.409241788958777,0.6754807692307693,39.140625,1043.4375,26.754807692307693,0
1829,4,0,0,42,0.0,0.0,1.0,42,650,400,250,0.6153846153846154,9,4,5,344.6787394551543,0.7743418505613627,0.101790189760115,0.22253530265793933,134956.35986328125,914.0842013888891,135870.44406467013,1822,15,613.7619047619048,39,3,19,31.280806182121975,0.6642628205128205,40.234375,1039.0625,26.642628205128204,5
1830,4,0,0,42,0.0,0.0,1.0,42,950,600,350,0.631578947368421,13,6,7,344.65039362404053,0.7734949670925281,0.09303801697066905,0.22301696676917498,135037.54882812515,908.1488715277933,135945.69769965293,1823,16,614.7619047619048,39,3,20,31.200724928175315,0.6650641025641024,40.15625000000001,1039.3750000000011,26.650641025641054,0
1831,4,0,0,42,0.0,0.0,1.0,42,1250,900,350,0.72,16,9,7,349.20761598486934,0.7726722802942315,0.09753270172023898,0.22664437079070027,135145.83875868077,1038.7912326389092,136184.62999131967,1824,17,615.7619047619048,39,3,20,30.974504107393315,0.6661324786324785,40.05208333333334,1039.7916666666683,26.66132478632483,0
1832,4,0,0,42,0.0,0.0,1.0,42,1150,700,450,0.6086956521739131,16,7,9,357.1572987005061,0.7723819202477739,0.11225757777481915,0.21898844657465374,133058.54752218974,1113.6917144354502,134172.23923662517,1825,18,616.7619047619048,38,4,18,32.85505332919127,0.6472039473684208,42.067307692307715,1031.7307692307725,27.150809716599277,4
1833,4,0,0,42,0.0,0.0,1.0,42,1200,800,400,0.6666666666666666,16,8,8,353.0033283707239,0.7711720867208672,0.11518869329950099,0.21712662823249623,133176.37939453172,1002.3410373264326,134178.72043185815,1826,19,617.7619047619048,39,3,19,32.84398442493355,0.6466346153846152,41.95312500000002,1032.1875000000036,26.466346153846246,0
1834,4,0,0,42,0.0,0.0,1.0,42,950,500,450,0.5263157894736842,14,5,9,351.96620313789066,0.7713656600851723,0.11637555199279914,0.2166831934227092,133209.81744497357,977.0707333598035,134186.88817833338,1827,20,618.7619047619048,40,2,19,32.83721369035899,0.6453124999999998,41.92073170731709,1032.3170731707344,25.80792682926836,0
1835,4,0,0,42,0.0,0.0,1.0,42,950,700,250,0.7368421052631579,12,7,5,353.18821124161263,0.7698170731707317,0.11110486312218204,0.21804973284552118,133314.74837233173,1017.0395019499432,134331.78787428167,1828,21,619.7619047619048,40,2,20,32.70046086728336,0.6463541666666665,41.81910569105693,1032.723577235776,25.8180894308944,0
1836,4,0,0,42,0.0,0.0,1.0,42,1100,800,300,0.7272727272727273,14,8,6,350.87148803329796,0.7696476964769647,0.10925499231950786,0.2175403225806453,133472.22222222263,966.319444444483,134438.54166666712,1829,22,620.7619047619048,40,2,20,32.6024865591398,0.6479166666666665,41.666666666666686,1033.3333333333364,25.83333333333341,0
1837,4,0,0,42,0.0,0.0,1.0,42,950,600,350,0.631578947368421,13,6,7,350.2302058562468,0.7690911730545877,0.10250544662309324,0.21782610364230012,133588.61395178983,957.3535528772202,134545.96750466706,1830,23,621.7619047619048,36,6,20,32.502496368917924,0.65625,41.55405405405406,1033.7837837837853,28.71621621621626,0
1838,4,0,0,42,0.0,0.0,1.0,42,1050,900,150,0.8571428571428571,12,9,3,344.4125549340497,0.7670586527293844,0.10557053009883166,0.21517801610912748,133755.63274276708,813.4238419513711,134569.05658471843,1831,24,622.7619047619048,37,5,18,32.48577839021977,0.6559684684684685,41.39254385964912,1034.4298245614038,27.95756282598389,0
1839,4,1,1,42,0.023255813953488372,0.023255813953488372,0.9767441860465116,43,1250,1100,150,0.88,14,11,3,337.450888005244,0.7688722775932078,0.10901390967836178,0.2128279362963771,134103.04712803263,450.638467512764,134553.6855955454,1832,0,609.2558139534884,40,3,19,32.31885302197802,0.6541666666666666,41.05691056910571,1035.7723577235802,25.894308943089506,0
1840,4,0,0,42,0.0,0.0,1.0,42,1100,800,300,0.7272727272727273,14,8,6,344.23846904363774,0.7628968253968254,0.10649611957459015,0.2165652140692256,134010.9592013892,826.3454861111454,134837.30468750035,1833,26,624.7619047619048,39,3,19,32.23507712944333,0.6549145299145298,41.14583333333335,1035.4166666666692,26.549145299145366,0
1841,4,0,0,42,0.0,0.0,1.0,42,1200,1000,200,0.8333333333333334,14,10,4,343.1572090999247,0.7599206349206349,0.10492494849406397,0.2165821320343987,134129.3637736304,805.4916261815345,134934.85539981193,1834,27,625.7619047619048,40,2,19,32.144813434056054,0.6544270833333332,41.031504065040664,1035.8739837398398,25.896849593495993,0
1842,4,0,0,42,0.0,0.0,1.0,42,900,700,200,0.7777777777777778,11,7,4,343.1572090999247,0.7599206349206349,0.10492494849406397,0.2165821320343987,134129.3637736304,805.4916261815345,134934.85539981193,1835,28,626.7619047619048,40,2,19,32.144813434056054,0.6544270833333332,41.031504065040664,1035.8739837398398,25.896849593495993,0
1843,4,1,1,42,0.023255813953488372,0.023255813953488372,0.9767441860465116,43,950,600,350,0.631578947368421,13,6,7,332.4208559245389,0.7670265780730897,0.052707414771908434,0.2079563028923278,133803.62426035505,297.80600714525974,134101.4302675003,1836,0,613.1627906976744,38,5,17,32.74796055349028,0.6546052631578947,41.34615384615385,1034.6153846153848,27.226720647773284,3
1844,4,0,0,42,0.0,0.0,1.0,42,700,500,200,0.7142857142857143,9,5,4,339.36107109300235,0.7604045683313976,0.05433701420341208,0.21153431999194333,133670.57802641182,672.5181065327603,134343.09613294457,1837,30,628.7619047619048,37,5,21,32.70144116919378,0.655123873873874,41.474780701754376,1034.1008771929812,27.94867235656706,0
1845,4,0,0,42,0.0,0.0,1.0,42,1250,800,450,0.64,17,8,9,335.8587451015722,0.7606465350367789,0.04765100671140954,0.21026450848795886,133831.25964506157,589.6797839506003,134420.93942901216,1838,31,629.7619047619048,38,4,17,32.6314317673378,0.6548793859649124,41.319444444444436,1034.722222222221,27.229532163742658,0
1846,4,0,0,42,0.0,0.0,1.0,42,1000,800,200,0.8,12,8,4,339.30642657009395,0.7607675183894697,0.05047481420313815,0.21290159718983567,133914.18292059287,687.5885747680318,134601.7714953609,1839,32,630.7619047619048,38,4,17,32.459399944949084,0.6557017543859651,41.239316239316224,1035.0427350427326,27.23796671165086,0
1847,4,0,0,42,0.0,0.0,1.0,42,1250,1100,150,0.88,14,11,3,339.5674262114224,0.761566008517228,0.04931902600082516,0.21370698018448725,134024.7872379281,702.09041018334,134726.87764811143,1840,33,631.7619047619048,38,4,17,32.34218083642866,0.6567982456140352,41.13247863247862,1035.4700854700843,27.249212775528534,0
1848,4,0,2,40,0.0,0.047619047619047616,0.9523809523809523,42,1100,1000,100,0.9090909090909091,12,10,2,338.9319118978178,0.7605739450251645,0.0462134164739012,0.21369689283449572,134091.86333550327,689.602322048587,134781.46565755186,1841,34,632.7619047619048,39,3,17,32.291666666666664,0.6557158119658122,41.06770833333332,1035.729166666665,26.557158119658077,0
1849,4,0,0,40,0.0,0.0,1.0,40,1000,600,400,0.6,14,6,8,347.22751630800025,0.7574786324786325,0.05531458531935174,0.21810878120185134,133954.19894823382,1302.5167599645765,135256.7157081984,1842,35,655.375,37,3,17,32.214432616601336,0.6579391891891893,41.20065789473683,1035.1973684210507,27.97830725462299,0
1850,4,0,0,40,0.0,0.0,1.0,40,500,200,300,0.4,8,2,6,348.28810919819483,0.7572382478632479,0.05424168608345692,0.21894383002991688,133982.577571945,1332.9077216066223,135315.48529355164,1843,36,656.375,37,3,17,32.15861752453576,0.6582207207207209,41.173245614035075,1035.307017543858,27.981270744428592,0
1851,4,0,1,39,0.0,0.025,0.975,40,900,800,100,0.8888888888888888,10,8,2,347.0723738811138,0.757051282051282,0.05216297786720325,0.2183480630619156,134010.9592013887,1302.300347222198,135313.2595486109,1844,37,657.375,37,3,17,32.161720321931575,0.6585022522522523,41.14583333333332,1035.4166666666652,27.984234234234194,0
1852,4,0,0,39,0.0,0.0,1.0,39,1100,900,200,0.8181818181818182,13,9,4,347.1257289598961,0.7577035537561854,-0.05942922047248267,0.21362603778410943,133196.36774965306,1447.177249981746,134643.54499963482,1845,38,666.2051282051282,38,1,18,32.97561753950184,0.6485745614035088,41.93376068376069,1032.2649572649577,27.164867296446257,7
1853,4,0,0,39,0.0,0.0,1.0,39,650,400,250,0.6153846153846154,9,4,5,350.52296420516694,0.7593342330184436,-0.06267393582447889,0.21619683784575233,133279.09412895388,1543.4766281320735,134822.57075708595,1846,39,667.2051282051282,38,1,18,32.80500948439386,0.6493969298245614,41.85363247863248,1032.5854700854698,27.173301844354466,0
1854,4,0,0,39,0.0,0.0,1.0,39,950,700,250,0.7368421052631579,12,7,5,348.2938509017288,0.7582658569500675,-0.06745655985337373,0.21514100042600698,133334.25931633054,1487.900526882886,134822.15984321342,1847,40,668.2051282051282,38,1,18,32.80727388710733,0.6499451754385965,41.80021367521367,1032.7991452991446,27.17892487629328,0
1855,4,0,0,39,0.0,0.0,1.0,39,900,600,300,0.6666666666666666,12,6,6,351.5438896418293,0.7565789473684211,-0.0495275770934952,0.2182997171267056,133530.41174620565,1593.9559140908332,135124.36766029647,1848,41,669.2051282051282,36,3,16,32.52683046415342,0.6556712962962963,41.61036036036036,1033.5585585585584,28.709959959959956,4
1856,4,0,0,39,0.0,0.0,1.0,39,900,600,300,0.6666666666666666,12,6,6,349.07301406378326,0.7561853351327036,-0.05268405486246697,0.21727724353353164,133617.71981018173,1528.4680372940372,135146.18784747578,1849,42,670.2051282051282,36,3,16,32.50326761790654,0.6565393518518519,41.52590090090089,1033.8963963963956,28.71934434434432,0
1857,4,0,0,39,0.0,0.0,1.0,39,800,500,300,0.625,11,5,6,349.22729391516384,0.753936122357175,-0.04855743059335871,0.21805932662207878,133734.17494775174,1540.7248041960818,135274.8997519478,1850,43,671.2051282051282,36,3,12,32.38273453093813,0.6576967592592593,41.413288288288285,1034.3468468468463,28.731856856856844,0
1858,4,0,0,39,0.0,0.0,1.0,39,1050,600,450,0.5714285714285714,15,6,9,353.95835480410926,0.753936122357175,-0.09051465302152473,0.20623006002199717,131126.2038009294,1515.627916768126,132641.83171769753,1851,44,672.2051282051282,36,3,17,34.883864760857605,0.6316550925925926,43.947072072072075,1024.2117117117123,28.45032532532534,6
1859,4,1,0,40,0.025,0.0,1.0,40,600,300,300,0.5,9,3,6,346.7789743647279,0.7605502136752137,-0.07521388086835623,0.2035612171553401,131412.4312889542,1114.2136282317556,132526.64491718594,1852,0,656.375,37,3,18,34.77870013902257,0.6326013513513513,43.66776315789473,1025.3289473684204,27.711593172119468,0
1860,4,0,1,39,0.0,0.025,0.975,40,1250,900,350,0.72,16,9,7,356.73931025066383,0.7616185897435898,-0.03326082285959775,0.20311230820326792,130234.60493853883,1358.6908952754777,131593.2958338143,1853,1,657.375,37,3,18,35.715772370823935,0.620777027027027,44.819078947368425,1020.7236842105268,27.58712660028451,6
1861,4,0,0,39,0.0,0.0,1.0,39,850,600,250,0.7058823529411765,11,6,5,366.4255710303562,0.7544984255510572,-0.024081793202199275,0.20816188709128902,130147.65346004804,1737.8856474718125,131885.53910751984,1854,47,675.2051282051282,36,3,18,35.55691976603024,0.6218171296296295,44.90427927927929,1020.382882882884,28.343968968969,0
1862,4,1,0,40,0.025,0.0,1.0,40,1200,900,300,0.75,15,9,6,357.9831312345015,0.7634882478632479,-0.016495750708215517,0.20474407862245475,130410.31867551869,1337.0402977544309,131747.35897327313,1855,0,659.3,35,5,19,35.50578375826251,0.6264880952380951,44.64699074074074,1021.4120370370371,29.18320105820106,0
1863,4,2,2,40,0.047619047619047616,0.047619047619047616,0.9523809523809523,42,1050,900,150,0.8571428571428571,12,9,3,349.1842222803373,0.7820605884630275,0.0033787746650550954,0.20288320369828938,131019.23338190603,749.9698224453753,131769.20320435142,1856,0,628.8571428571429,37,5,16,35.114218521295214,0.6286599099099099,44.0515350877193,1023.7938596491232,27.67010431484117,0
1864,4,1,0,41,0.024390243902439025,0.0,1.0,41,550,300,250,0.5454545454545454,8,3,5,362.0793183741003,0.7693089430894309,0.09731437598736159,0.19792418698687889,128631.77237426057,1129.414420128838,129761.18679438942,1857,0,645.1463414634146,38,3,16,37.211690363349135,0.6027960526315788,46.39423076923078,1014.4230769230786,26.6953441295547,4
1865,4,1,0,42,0.023809523809523808,0.0,1.0,42,1200,800,400,0.6666666666666666,16,8,8,352.70671854186133,0.7828106852497096,0.10299197217656375,0.19444587158444096,128969.02394614693,697.6482459184793,129666.67219206541,1858,0,630.7619047619048,40,2,17,37.105427713856926,0.6028645833333331,46.06199186991872,1015.752032520329,25.393800813008223,0
1866,4,2,1,43,0.045454545454545456,0.022727272727272728,0.9772727272727273,44,1150,700,450,0.6086956521739131,16,7,9,341.2413561145069,0.797084214235377,0.10481879023982743,0.19010390740469313,129382.26176754934,30.533970354978976,129412.79573790432,1859,0,603.0454545454545,40,4,19,36.97620117870344,0.6070312499999999,45.655487804878064,1017.37804878049,25.434451219512248,0
1867,4,0,0,43,0.0,0.0,1.0,43,1000,900,100,0.9,11,9,2,348.54352980230965,0.792220376522702,0.1066471042176762,0.19380290575112533,129307.31336805595,413.8454861111502,129721.15885416711,1860,1,618.0697674418604,39,4,19,36.86672128908917,0.6079059829059827,45.729166666666686,1017.0833333333366,26.07905982905991,0
1868,4,2,3,42,0.044444444444444446,0.06666666666666667,0.9333333333333333,45,1000,700,300,0.7,13,7,6,339.28429539856376,0.8095538720538721,0.09843217450579433,0.19070117293091712,129731.44531250026,-196.83159722219196,129534.61371527807,1861,0,591.5555555555555,41,4,12,36.671353101567846,0.6089939024390243,45.312500000000014,1018.750000000002,24.847560975609806,0
1869,4,0,0,42,0.0,0.0,1.0,42,900,700,200,0.7777777777777778,11,7,4,357.41114185449686,0.7813104916763454,0.08759173382558227,0.1986104296154673,129282.8654051611,841.4273093359704,130124.29271449706,1862,4,634.7619047619048,38,4,20,36.66614140140774,0.609375,45.75320512820513,1016.9871794871797,26.762820512820518,0
1870,4,0,0,42,0.0,0.0,1.0,42,950,700,250,0.7368421052631579,12,7,5,357.68946440607345,0.7806813782423538,0.09049419578775675,0.1990392396616149,129337.19735051895,852.5105696179696,130189.70792013692,1863,5,635.7619047619048,38,4,20,36.603735602002594,0.6099232456140349,45.69978632478634,1017.200854700857,26.768443544759396,0
1871,4,1,0,43,0.023255813953488372,0.0,1.0,43,1450,1000,450,0.6896551724137931,19,10,9,350.011457317568,0.7858527131782945,0.1031303433793822,0.19659747507802988,129704.91672092021,479.641384548622,130184.55810546884,1864,0,621.953488372093,39,4,14,36.42509885127997,0.6119123931623931,45.33854166666667,1018.6458333333339,26.119123931623946,0
1872,4,1,1,43,0.022727272727272728,0.022727272727272728,0.9772727272727273,44,1100,800,300,0.7272727272727273,14,8,6,348.85930814444436,0.7915125088090205,0.12641244186663325,0.1977382252668787,130060.1192444571,274.53664336105385,130334.65588781815,1865,0,608.7954545454545,41,3,16,36.09382091681255,0.6122967479674797,44.99007936507937,1020.0396825396831,24.879016647309342,0
1873,4,0,0,43,0.0,0.0,1.0,43,1300,900,400,0.6923076923076923,17,9,8,355.92041636837416,0.7811000369139903,0.1301509994416008,0.201715032133787,130055.18297846832,657.8589753122951,130713.04195378062,1866,1,623.7906976744187,40,3,16,35.91876722792334,0.6138020833333334,44.99491869918698,1020.0203252032506,25.500508130081265,0
1874,4,1,0,44,0.022727272727272728,0.0,1.0,44,1100,600,500,0.5454545454545454,16,6,10,345.480972610181,0.7889138477801269,0.12905372195895537,0.19724810567836942,130342.35161675341,206.49097288061867,130548.84258963403,1867,0,610.5909090909091,39,5,17,35.89388027474585,0.6183226495726496,44.713541666666664,1021.1458333333328,26.183226495726483,0
1875,4,1,2,43,0.022222222222222223,0.044444444444444446,0.9555555555555556,45,1150,700,450,0.6086956521739131,16,7,9,340.1181009769715,0.7932659932659933,0.1328934174349028,0.19569609327569426,130642.63791454058,-113.21481717689102,130529.42309736369,1868,0,598.0,41,4,16,35.726892285298405,0.618140243902439,44.41964285714285,1022.3214285714266,24.934668989546992,0
1876,4,1,0,44,0.022727272727272728,0.0,1.0,44,1200,800,400,0.6666666666666666,16,8,8,353.2570335831975,0.7858747357293869,0.14932419002186426,0.2035780224463994,130703.86860499703,434.4121802498521,131138.28078524687,1869,0,612.5454545454545,40,4,18,35.329084675014904,0.6203125,44.359756097560975,1022.5609756097562,25.564024390243905,0
1877,4,1,1,44,0.022222222222222223,0.022222222222222223,0.9777777777777777,45,1200,800,400,0.6666666666666666,16,8,8,346.09579757044025,0.7943602693602694,0.15013944072961438,0.20097707006918264,130997.85175933808,67.56119693248951,131065.41295627058,1870,0,599.9111111111112,41,4,18,35.21487466485771,0.6216971544715446,44.07242063492064,1023.7103174603182,24.968544328300442,0
1878,4,0,0,44,0.0,0.0,1.0,44,1050,600,450,0.5714285714285714,15,6,9,352.5381210903684,0.7865794573643411,0.14932327050675465,0.2044483302579725,130947.07739866778,432.7673256802748,131379.84472434805,1871,2,614.5454545454545,41,3,18,35.101349714064185,0.6211890243902438,44.12202380952381,1023.5119047619046,24.963704994192796,0
1879,4,0,0,44,0.0,0.0,1.0,44,950,700,250,0.7368421052631579,12,7,5,357.17953264214464,0.7849497885835095,0.16131497124133487,0.20768732148729985,131048.63596190781,561.5781092529509,131610.21407116076,1872,3,615.5454545454545,41,3,18,34.879836417659774,0.6222052845528455,44.022817460317455,1023.9087301587294,24.973383662408036,0
1880,4,0,0,44,0.0,0.0,1.0,44,850,700,150,0.8235294117647058,10,7,3,361.6845733984487,0.7855223749119098,0.1681201848998457,0.21086353587458964,131150.23389274688,687.00327932098,131837.23717206786,1873,4,616.5454545454545,41,3,19,34.66172316384179,0.6232215447154472,43.92361111111111,1024.3055555555552,24.983062330623298,0
1881,4,0,0,44,0.0,0.0,1.0,44,1000,800,200,0.8,12,8,4,362.24538468969155,0.7842670894996476,0.17169565523554642,0.21161031295673835,131226.45817586296,707.2357646762393,131933.6939405392,1874,5,617.5454545454545,41,3,19,34.57026207074618,0.6239837398373984,43.84920634920635,1024.6031746031747,24.99032133178475,0
1882,4,0,0,44,0.0,0.0,1.0,44,1250,1100,150,0.88,14,11,3,360.9976750679143,0.7835183227625089,0.17883528499131907,0.21203228600051008,131434.9175347223,689.6186657533439,132124.53620047565,1875,6,618.5454545454545,39,5,19,34.39150751726941,0.6292735042735043,43.645833333333336,1025.4166666666672,26.292735042735057,0
1883,4,0,0,44,0.0,0.0,1.0,44,1050,800,250,0.7619047619047619,13,8,5,357.6845158156515,0.7835403453136012,0.1816312305547605,0.21052716241701863,131515.04041883687,608.1787109375061,132123.21912977437,1876,7,619.5454545454545,39,5,19,34.395522324904356,0.6300747863247864,43.567708333333336,1025.7291666666672,26.300747863247878,0
1884,4,0,0,44,0.0,0.0,1.0,44,1050,800,250,0.7619047619047619,13,8,5,364.5236929578189,0.7841129316420015,0.18405629903091825,0.21500349554697706,131595.18771701396,793.9127604166727,132389.10047743065,1877,8,620.5454545454545,39,5,16,34.1391708967851,0.6308760683760684,43.489583333333336,1026.0416666666672,26.3087606837607,0
1885,4,0,0,44,0.0,0.0,1.0,44,850,600,250,0.7058823529411765,11,6,5,362.8276114635944,0.7836945031712473,0.18049621173669528,0.2141530737284521,131621.90890842007,751.2125651041631,132373.12147352422,1878,9,621.5454545454545,39,5,16,34.155690623625354,0.6311431623931625,43.463541666666664,1026.1458333333328,26.31143162393161,0
1886,4,0,0,44,0.0,0.0,1.0,44,1200,800,400,0.6666666666666666,16,8,8,362.3065211598164,0.7820207892882312,0.1799684484381059,0.2142958259008901,131702.08875868047,743.3051215277734,132445.39388020826,1879,10,622.5454545454545,39,5,16,34.0881029700291,0.6319444444444444,43.385416666666664,1026.4583333333328,26.319444444444432,0
1887,4,0,0,44,0.0,0.0,1.0,44,1150,600,550,0.5217391304347826,17,6,11,361.69661261720927,0.7811839323467231,0.17430389083533138,0.21483907231359506,131862.5217013887,738.8454861110911,132601.3671874998,1880,11,623.5454545454545,39,5,16,33.941852603110206,0.6335470085470087,43.22916666666666,1027.0833333333317,26.335470085470043,0
1888,4,0,0,44,0.0,0.0,1.0,44,850,500,350,0.5882352941176471,12,5,7,361.45101359017946,0.7810077519379846,0.16874953918749558,0.21529908200806316,131969.53124999985,740.1041666666521,132709.6354166665,1881,12,624.5454545454545,39,5,17,33.84022708840227,0.6346153846153848,43.12499999999999,1027.4999999999989,26.34615384615382,0
1889,4,1,1,44,0.022222222222222223,0.022222222222222223,0.9777777777777777,45,1300,900,400,0.6923076923076923,17,9,8,357.8518840020579,0.7882154882154883,0.17096193415637906,0.21471113040123443,132244.89795918346,464.8171768707256,132709.7151360542,1882,0,611.6444444444444,41,4,17,33.65523726851852,0.6341463414634148,42.85714285714285,1028.5714285714268,25.08710801393724,0
1890,4,0,0,44,0.0,0.0,1.0,44,1250,700,550,0.56,18,7,11,365.2489973112048,0.7771317829457365,0.171194294181082,0.21929744372437032,132270.40939350252,862.3268809838521,133132.73627448638,1883,14,626.5454545454545,41,3,18,33.43931832063522,0.6344004065040652,42.83234126984126,1028.670634920633,25.089527680991047,0
1891,4,1,1,44,0.022222222222222223,0.022222222222222223,0.9777777777777777,45,1100,700,400,0.6363636363636364,15,7,8,357.2980799986454,0.7845117845117846,0.17239837694681337,0.21641379070646471,132600.90115453317,475.978548960599,133076.87970349376,1884,0,613.6,36,9,19,33.311238063998836,0.6464120370370369,42.511261261261275,1029.954954954957,28.609859859859917,0
1892,4,0,0,44,0.0,0.0,1.0,44,1000,800,200,0.8,12,8,4,365.09127635399557,0.7758104298801973,0.17492339121552614,0.22134280378409818,132636.34366426617,884.874399862832,133521.218064129,1885,16,628.5454545454545,35,9,15,33.074906367041194,0.6488095238095237,42.476851851851855,1030.092592592593,29.431216931216944,0
1893,4,0,0,44,0.0,0.0,1.0,44,1100,700,400,0.6363636363636364,15,7,8,343.2261941728053,0.7744450317124736,0.09175542894888955,0.2111128713878543,133176.3793945315,341.92437065975037,133518.30376519126,1886,17,629.5454545454545,39,5,18,33.09628031755643,0.6466346153846152,41.953125000000014,1032.187500000002,26.466346153846207,3
1894,4,0,0,44,0.0,0.0,1.0,44,1350,1000,350,0.7407407407407407,17,10,7,340.4672558422441,0.7733879492600423,0.09428815082436204,0.21017387138356247,133310.81271701414,277.593315972246,133588.4060329864,1887,18,630.5454545454545,39,5,19,33.032832358281226,0.6479700854700854,41.82291666666668,1032.7083333333353,26.479700854700905,0
1895,4,0,0,44,0.0,0.0,1.0,44,1200,800,400,0.6666666666666666,16,8,8,344.9860393026644,0.7727933403805497,0.10580016313961282,0.2137361976166853,133445.31385633696,407.3540581597413,133852.6679144967,1888,19,631.5454545454545,39,5,19,32.7814673858252,0.6493055555555554,41.69270833333334,1033.229166666668,26.493055555555593,0
1896,4,0,0,44,0.0,0.0,1.0,44,1200,800,400,0.6666666666666666,16,8,8,342.31706353635144,0.773299859055673,0.11102005497302248,0.21257937255769255,133532.02830289782,342.0692140346382,133874.09751693247,1889,20,632.5454545454545,35,9,20,32.76362448674879,0.6577380952380951,41.6087962962963,1033.564814814815,29.530423280423285,0
1897,4,0,0,44,0.0,0.0,1.0,44,1400,1000,400,0.7142857142857143,18,10,8,338.6159168097607,0.7707672656800564,0.10794402700642514,0.21110047278099334,133675.94103816655,252.96026600925626,133928.90130417582,1890,21,633.5454545454545,36,8,21,32.71534356963956,0.6571180555555556,41.4695945945946,1034.1216216216217,28.7256006006006,0
1898,4,1,1,44,0.022222222222222223,0.022222222222222223,0.9777777777777777,45,1000,600,400,0.6,14,6,8,328.29787386566267,0.7765572390572391,0.10912099461103275,0.20623415110473825,133957.0366753473,-204.4379340277676,133752.59874131953,1891,0,620.4444444444445,39,6,16,32.70149929563293,0.6543803418803419,41.19791666666667,1035.2083333333342,26.54380341880344,0
1899,4,0,0,44,0.0,0.0,1.0,44,1350,1000,350,0.7407407407407407,17,10,7,337.3617732033842,0.7706351303735025,0.12274791682306163,0.2116814027716571,133914.18292059313,235.50524143472688,134149.68816202786,1892,23,635.5454545454545,38,6,17,32.509719928433825,0.6557017543859649,41.23931623931624,1035.0427350427346,27.237966711650913,0
1900,4,0,0,44,0.0,0.0,1.0,44,1200,800,400,0.6666666666666666,16,8,8,333.4144391798981,0.7705029950669486,0.11944246426293481,0.20983459380075142,134024.78723792822,137.15985462779844,134161.94709255602,1893,24,636.5454545454545,38,6,17,32.50146168661439,0.6567982456140351,41.13247863247863,1035.4700854700852,27.24921277552856,0
1901,4,0,0,44,0.0,0.0,1.0,44,1200,800,400,0.6666666666666666,16,8,8,333.98175633004143,0.7692697322057788,0.12236247350751195,0.21050839700022234,134080.10651800703,156.06189276059752,134236.16841076763,1894,25,637.5454545454545,38,6,18,32.43157279416822,0.6573464912280702,41.07905982905982,1035.6837606837596,27.25483580746736,0
1902,4,0,0,44,0.0,0.0,1.0,44,1150,700,450,0.6086956521739131,16,7,9,331.69467153397017,0.7685870331219169,0.12555195140015218,0.2095402755612317,134163.10683988951,100.23753104681379,134263.34437093633,1895,26,638.5454545454545,38,6,18,32.4080041937369,0.6581688596491229,40.99893162393162,1036.0042735042723,27.263270355375585,0
1903,4,0,0,44,0.0,0.0,1.0,44,1350,800,550,0.5925925925925926,19,8,11,331.05849299859375,0.7675960183227626,0.12233653792095378,0.20993003261910823,134301.49778106503,92.33029257067267,134393.8280736357,1896,27,639.5454545454545,38,6,20,32.28651309008451,0.6595394736842106,40.86538461538461,1036.5384615384612,27.27732793522266,0
1904,4,0,0,44,0.0,0.0,1.0,44,1000,600,400,0.6,14,6,8,334.07866103755356,0.7668472515856237,0.12743757375943665,0.21248803958260157,134412.26189823964,180.85369639858948,134593.11559463822,1897,28,640.5454545454545,38,6,21,32.09784325846555,0.6606359649122806,40.75854700854702,1036.9658119658134,27.28857399910035,0
1905,4,0,0,44,0.0,0.0,1.0,44,1700,1300,400,0.7647058823529411,21,13,8,336.1924994971153,0.7650854474982383,0.1289447897553151,0.214813613959568,134579.22299409437,248.97641096681656,134828.19940506117,1898,29,641.5454545454545,37,7,21,31.87667318327522,0.6641328828828829,40.59758771929825,1037.6096491228072,28.043504030346142,0
1906,4,0,0,44,0.0,0.0,1.0,44,1200,1000,200,0.8333333333333334,14,10,4,336.0188513944226,0.764931289640592,0.1339683371383662,0.21535350660608243,134689.37194097455,251.63361092849027,134941.00555190304,1899,30,642.5454545454545,38,6,21,31.77147660216825,0.6633771929824561,40.491452991452995,1038.0341880341884,27.316689158794432,0
1907,4,0,0,44,0.0,0.0,1.0,44,1100,500,600,0.45454545454545453,17,5,12,339.47472415721086,0.7649092670894997,0.14132142155900262,0.21873510556531223,134883.5187582182,357.90906476001817,135241.42782297824,1900,31,643.5454545454545,38,6,18,31.488480921526268,0.665296052631579,40.304487179487175,1038.7820512820508,27.336369770580284,0
1908,4,0,0,44,0.0,0.0,1.0,44,1200,1000,200,0.8333333333333334,14,10,4,337.232430884367,0.7644247709654687,0.1376461189134639,0.21829236993173692,135050.04160502952,308.6507642997971,135358.6923693293,1901,32,644.5454545454545,38,6,18,31.381051495528833,0.6669407894736842,40.14423076923077,1039.4230769230765,27.353238866396747,0
1909,4,0,0,44,0.0,0.0,1.0,44,1350,1000,350,0.7407407407407407,17,10,7,338.1319217502669,0.7625088090204369,0.13472174213619104,0.2192113078315687,135105.57204918182,336.701343231793,135442.27339241363,1902,33,645.5454545454545,38,6,19,31.302452642756837,0.6674890350877192,40.090811965811966,1039.636752136752,27.35886189833558,0
1910,4,0,0,44,0.0,0.0,1.0,44,600,200,400,0.3333333333333333,10,2,8,336.2964475392982,0.7616279069767442,0.13597842835130947,0.21869378201703876,135216.66718030913,294.57696416832295,135511.24414447744,1903,34,646.5454545454545,38,6,19,31.23972778633795,0.6685855263157894,39.983974358974365,1040.0641025641035,27.37010796221325,0
1911,4,0,0,44,0.0,0.0,1.0,44,1200,900,300,0.75,15,9,6,335.769340435342,0.7600643058491896,0.14912673533363185,0.2198747616399174,135466.79815910588,297.1194937541126,135763.91765286,1904,35,647.5454545454545,38,6,20,31.004977422003282,0.6710526315789473,39.743589743589745,1041.025641025641,27.395411605937923,0
1912,4,0,0,44,0.0,0.0,1.0,44,1050,800,250,0.7619047619047619,13,8,5,334.8145277695654,0.7594256518675123,0.1499393628434158,0.2194194736458923,135494.60475792622,273.11242146980754,135767.71717939604,1905,36,648.5454545454545,38,6,20,31.002223362408063,0.6713267543859649,39.71688034188035,1041.13247863248,27.398223121907364,0
1913,4,0,0,44,0.0,0.0,1.0,44,1450,1300,150,0.896551724137931,16,13,3,333.8226719149398,0.7595798097251586,0.14837542432946593,0.21927920524439604,135578.04167579827,251.8048250420195,135829.8465008403,1906,37,649.5454545454545,38,6,20,30.94523662973601,0.6721491228070174,39.63675213675214,1041.4529914529928,27.4066576698156,0
1914,4,0,1,43,0.0,0.022727272727272728,0.9772727272727273,44,1350,1200,150,0.8888888888888888,15,12,3,333.34023492738095,0.7598000352360817,0.14707303537426686,0.21947786362058555,135662.23651748622,244.34777257679684,135906.584290063,1907,38,650.5454545454545,37,7,20,30.87427200645546,0.674831081081081,39.55592105263158,1041.7763157894742,28.15611664295876,0
1915,4,0,0,43,0.0,0.0,1.0,43,1350,800,550,0.5925925925925926,19,8,11,336.1866419526351,0.7545681063122923,0.146601675671443,0.22188318368873927,135747.92243767326,527.3276392736366,136275.2500769469,1908,39,655.7209302325581,37,6,20,30.71513748597083,0.6756756756756757,39.47368421052632,1042.1052631578957,28.16500711237556,0
1916,4,0,0,43,0.0,0.0,1.0,43,1400,1000,400,0.7142857142857143,18,10,8,337.19318620866886,0.7534145441122185,0.14734226257447847,0.2232613380551549,135862.2124115113,562.3624576792942,136424.5748691906,1909,40,656.7209302325581,37,6,21,30.57556794278502,0.6768018018018017,39.3640350877193,1042.5438596491233,28.176861071597926,0
1917,4,0,0,43,0.0,0.0,1.0,43,1350,1200,150,0.8888888888888888,15,12,3,337.19318620866886,0.752906976744186,0.14734226257447847,0.2232613380551549,135862.2124115113,562.3624576792942,136424.5748691906,1910,41,657.7209302325581,37,6,21,30.57556794278502,0.6768018018018017,39.3640350877193,1042.5438596491233,28.176861071597926,0
1918,4,0,0,43,0.0,0.0,1.0,43,800,500,300,0.625,11,5,6,336.8457133506043,0.7526762643041712,0.14734062064411946,0.22338931199192802,135919.3754328255,556.771795167741,136476.14722799323,1911,42,658.7209302325581,37,6,15,30.527953031896235,0.6773648648648649,39.30921052631579,1042.7631578947369,28.182788051209105,0
1919,4,0,1,42,0.0,0.023255813953488372,0.9767441860465116,43,1250,900,350,0.72,16,9,7,335.41002982493876,0.7516611295681063,0.14157838387492605,0.22315321844436822,136033.7375442443,525.4159933825699,136559.15353762687,1912,43,659.7209302325581,37,6,15,30.452053114708146,0.678490990990991,39.19956140350877,1043.2017543859643,28.194642010431465,0
1920,4,0,0,42,0.0,0.0,1.0,42,800,600,200,0.75,10,6,4,337.21773108725654,0.7522260936895083,0.1513592927973253,0.22417556085486162,136005.14250779073,772.6691145352302,136777.81162232597,1913,44,673.452380952381,37,5,15,30.433244857913746,0.6782094594594594,39.22697368421052,1043.092105263157,28.191678520625864,0
1921,4,0,0,42,0.0,0.0,1.0,42,950,800,150,0.8421052631578947,11,8,3,335.8274086136088,0.7516937669376694,0.14758901984335537,0.22361076227841054,136062.3355864304,738.6923139812178,136801.0279004116,1914,45,674.452380952381,37,5,15,30.412834997372574,0.6787725225225225,39.172149122807014,1043.3114035087715,28.197605500237067,0
1922,4,0,0,42,0.0,0.0,1.0,42,900,600,300,0.6666666666666666,12,6,6,337.14515217851874,0.7511856368563685,0.14909963985594277,0.22539479274856003,136205.37088334857,784.1960987996187,136989.5669821482,1915,46,675.452380952381,37,5,16,30.236782212885167,0.6801801801801801,39.03508771929824,1043.8596491228059,28.212422949265022,0
1923,4,0,1,41,0.0,0.023809523809523808,0.9761904761904762,42,950,800,150,0.8421052631578947,11,8,3,337.82855870010303,0.7517421602787456,0.14674078853261774,0.22603413263413058,136233.98695992987,804.7462921283368,137038.7332520582,1916,47,676.452380952381,37,5,16,30.190609354759665,0.6804617117117118,39.007675438596486,1043.9692982456131,28.215386439070624,0
1924,4,0,0,41,0.0,0.0,1.0,41,850,600,250,0.7058823529411765,11,6,5,338.5633331266665,0.750609756097561,0.13885922796235883,0.22725974263787846,136348.48132358014,1032.5192607340557,137381.0005843142,1917,48,670.219512195122,37,4,16,30.058070866141748,0.6815878378378379,38.898026315789465,1044.4078947368407,28.22724039829299,0
1925,4,0,0,41,0.0,0.0,1.0,41,950,600,350,0.631578947368421,13,6,7,337.88709195885144,0.7501524390243902,0.13951762143290436,0.2275424805141973,136463.02377895103,1021.818852916259,137484.8426318673,1918,49,671.219512195122,37,4,17,29.962373631370898,0.6827139639639641,38.788377192982445,1044.8464912280688,28.239094357515373,0
1926,4,0,0,41,0.0,0.0,1.0,41,1150,900,250,0.782608695652174,14,9,5,337.88787424906826,0.7497967479674796,0.12553493547520667,0.2286558467682657,136634.92763398335,1033.4570492843695,137668.3846832677,1919,50,672.219512195122,37,4,19,29.792322146477865,0.6844031531531533,38.62390350877192,1045.5043859649109,28.25687529634894,0
1927,4,0,0,41,0.0,0.0,1.0,41,1350,1100,250,0.8148148148148148,16,11,5,338.44020258096486,0.7495426829268292,0.12599238827958747,0.22921631902074413,136663.58879655262,1050.490535549376,137714.079332102,1920,51,673.219512195122,37,4,19,29.749545581655468,0.6846846846846848,38.596491228070164,1045.6140350877179,28.259838786154535,0
1928,4,0,0,41,0.0,0.0,1.0,41,800,400,400,0.5,12,4,8,338.2485992285837,0.7495426829268292,0.12496356039257606,0.22946053623344456,136720.92013888885,1049.1439673745724,137770.06410626342,1921,52,674.219512195122,36,5,19,29.697875166002653,0.6872106481481481,38.541666666666664,1045.833333333333,29.050925925925917,0
1929,4,0,1,40,0.0,0.024390243902439025,0.975609756097561,41,1150,800,350,0.6956521739130435,15,8,7,337.9052436850905,0.7485264227642277,0.12683767057285178,0.2296124219890861,136779.81349170118,1043.7232418229037,137823.5367335241,1922,53,675.219512195122,36,5,21,29.648643556895255,0.6877893518518519,38.48536036036036,1046.0585585585586,29.057182182182185,0
1930,4,0,0,40,0.0,0.0,1.0,40,750,400,350,0.5333333333333333,11,4,7,338.3819024509876,0.7470886752136752,0.1356477994189178,0.23071041962413985,136897.6382421272,1264.7366538836077,138162.37489601082,1923,54,687.825,36,4,21,29.5197550127336,0.6889467592592593,38.372747747747745,1046.5090090090084,29.06969469469468,0
1931,4,0,0,40,0.0,0.0,1.0,40,1150,900,250,0.782608695652174,14,9,5,338.400158205879,0.7464476495726495,0.13749865548026263,0.23150156518322695,137015.51371895536,1273.2143038308463,138288.7280227862,1924,55,688.825,36,4,16,29.40285396722957,0.6901041666666667,38.26013513513513,1046.9594594594587,29.082207207207187,0
1932,4,0,0,40,0.0,0.0,1.0,40,1100,700,400,0.6363636363636364,15,7,8,337.67137558264324,0.7455128205128205,0.13578262739195868,0.2319807338013107,137162.92939899355,1263.1990098206243,138426.12840881417,1925,56,689.825,36,4,17,29.276410091019834,0.6915509259259259,38.119369369369366,1047.5225225225222,29.097847847847838,0
1933,4,0,0,40,0.0,0.0,1.0,40,1300,900,400,0.6923076923076923,17,9,8,334.7311755708295,0.7455662393162393,0.1376242544731614,0.2306435360440101,137266.16753472225,1189.4531250000043,138455.62065972225,1926,57,690.825,37,3,18,29.251573889993377,0.6905968468468469,38.020833333333336,1047.9166666666667,28.322072072072075,0
1934,4,0,0,40,0.0,0.0,1.0,40,950,700,250,0.7368421052631579,12,7,5,332.088971814009,0.7452457264957265,0.13482980024459845,0.22946880221401786,137364.14730805738,1123.4236887281577,138487.57099678554,1927,58,691.825,38,2,18,29.224206753635002,0.6896929824561404,37.92735042735042,1048.2905982905968,27.58659469185781,0
1935,4,0,0,40,0.0,0.0,1.0,40,1500,1000,500,0.6666666666666666,20,10,10,332.96332219439165,0.744150641025641,0.1343062347188262,0.2308169470805188,137476.1669953977,1154.9042570677125,138631.07125246542,1928,59,692.825,38,2,18,29.090897514262426,0.6907894736842105,37.82051282051282,1048.7179487179483,27.59784075573548,0
1936,4,0,0,40,0.0,0.0,1.0,40,800,500,300,0.625,11,5,6,334.61245638226245,0.7450587606837606,0.13404461193725847,0.2323355796860715,137532.19396047905,1203.9970505515223,138736.19101103058,1929,60,693.825,38,2,18,28.99245433557412,0.6913377192982457,37.76709401709401,1048.9316239316227,27.60346378767428,0
1937,4,0,0,40,0.0,0.0,1.0,40,1100,900,200,0.8181818181818182,13,9,4,333.05767480302745,0.7444978632478633,0.13302016498625102,0.2314432631911483,137560.21172337272,1163.0968523997324,138723.30857577245,1930,61,694.825,38,2,18,29.00562684591099,0.6916118421052632,37.74038461538461,1049.0384615384612,27.606275303643717,0
1938,4,0,0,40,0.0,0.0,1.0,40,850,500,350,0.5882352941176471,12,5,7,334.0188567327994,0.7440972222222222,0.13437881873727142,0.23229923322351909,137588.2323398348,1191.4128132076762,138779.64515304248,1931,62,695.825,38,2,18,28.952817379497613,0.6918859649122807,37.71367521367521,1049.1452991452984,27.609086819613115,0
1939,4,0,0,40,0.0,0.0,1.0,40,800,600,200,0.75,10,6,4,311.96518700915783,0.7434561965811965,0.13225646123260426,0.2149568343364472,137266.16753472228,564.6357533877622,137830.80328811004,1932,63,696.825,37,3,18,29.847995361166344,0.6905968468468467,38.020833333333336,1047.916666666667,28.322072072072082,3
1940,4,0,0,40,0.0,0.0,1.0,40,1050,600,450,0.5714285714285714,15,6,9,310.47848031005503,0.7442040598290598,0.1330918506119887,0.21428619446092545,137323.62511782482,527.2060874499948,137850.83120527482,1933,64,697.825,37,3,19,29.830417233322866,0.6911599099099099,37.96600877192983,1048.1359649122815,28.327999051683282,0
1941,4,0,0,40,0.0,0.0,1.0,40,1050,700,350,0.6666666666666666,14,7,7,311.8022271757996,0.7431891025641025,0.13670902625248438,0.21555611670483182,137381.09472385747,567.1462613496606,137948.24098520714,1934,65,698.825,37,3,20,29.73919656242374,0.6917229729729728,37.91118421052632,1048.3552631578957,28.333926031294478,0
1942,4,0,0,40,0.0,0.0,1.0,40,700,300,400,0.42857142857142855,11,3,8,313.090302211993,0.7427884615384616,0.13666875784190724,0.21698519205474642,137467.3216759003,607.9370575561769,138075.2587334565,1935,66,699.825,37,3,20,29.620625958455314,0.6925675675675675,37.828947368421055,1048.684210526316,28.342816500711244,0
1943,4,0,0,40,0.0,0.0,1.0,40,950,500,450,0.5263157894736842,14,5,9,312.05694706994325,0.7426282051282052,0.12940008361204036,0.2169884352881699,137582.33302554645,586.7045629424576,138169.03758848892,1936,67,700.825,37,3,21,29.534646739130437,0.6936936936936936,37.71929824561404,1049.1228070175448,28.354670459933644,0
1944,4,0,0,40,0.0,0.0,1.0,40,1200,1000,200,0.8333333333333334,14,10,4,312.24572840295355,0.7432692307692308,0.1179763843648205,0.21786236049933388,137700.34334136918,599.2688015925381,138299.61214296173,1937,68,701.825,38,2,21,29.413723194896836,0.6929824561403508,37.606837606837615,1049.5726495726512,27.62033288349082,0
1945,4,0,0,40,0.0,0.0,1.0,40,950,500,450,0.5263157894736842,14,5,9,310.10621591536443,0.7424412393162393,0.10785997702829708,0.2172558324668215,137841.28439760325,549.1334773878157,138390.41787499105,1938,69,702.825,37,3,21,29.331449479656133,0.6962274774774774,37.472587719298254,1050.1096491228082,28.381341868184006,0
1946,4,0,0,40,0.0,0.0,1.0,40,1000,800,200,0.8,12,8,4,310.77859205513386,0.7424412393162393,0.10415640394088732,0.2035098522167488,135466.7981591057,420.0361604207638,135886.83431952648,1939,70,703.825,38,2,23,31.655377668308716,0.6710526315789473,39.74358974358974,1041.0256410256397,27.395411605937888,6
1947,4,0,0,40,0.0,0.0,1.0,40,1200,900,300,0.75,15,9,6,312.351143036824,0.7428418803418804,0.11439378397784394,0.2053345444009439,135605.8596888926,471.32905526336054,136077.18874415598,1940,71,704.825,38,2,23,31.47673265634083,0.672423245614035,39.61004273504274,1041.5598290598296,27.40946918578499,0
1948,4,1,1,40,0.024390243902439025,0.024390243902439025,0.975609756097561,41,850,500,350,0.5882352941176471,12,5,7,303.9666005516144,0.7503556910569106,0.1107761077610776,0.20091450914509157,135800.66568047344,55.776193476522195,135856.44187394995,1941,0,688.609756097561,38,3,23,31.502408774087744,0.6743421052631577,39.42307692307693,1042.3076923076928,27.429149797570865,0
1949,4,0,0,40,0.0,0.0,1.0,40,950,600,350,0.631578947368421,13,6,7,311.8008899609741,0.7426549145299145,0.11345506209219125,0.20545992069411773,135690.79548514937,461.70215835642693,136152.4976435058,1942,73,706.825,37,3,23,31.40698449449238,0.6751126126126126,39.52850877192983,1041.8859649122815,28.159080132764363,0
1950,4,0,0,40,0.0,0.0,1.0,40,1150,700,450,0.6086956521739131,16,7,9,310.0389389339608,0.740357905982906,0.117017248632731,0.2052820495392827,135862.21241151125,424.51523545707096,136286.72764696833,1943,74,707.825,37,3,23,31.283305286776066,0.6768018018018017,39.3640350877193,1042.5438596491229,28.176861071597916,0
1951,4,0,0,40,0.0,0.0,1.0,40,1000,900,100,0.9,11,9,2,309.5220215549075,0.7410790598290599,0.11240405845862678,0.20543363203131382,135947.96145208142,415.7775709833788,136363.7390230648,1944,75,708.825,37,3,16,31.21199575929625,0.6776463963963963,39.281798245614034,1042.872807017544,28.1857515410147,0
1952,4,0,0,40,0.0,0.0,1.0,40,900,500,400,0.5555555555555556,13,5,8,311.26503523904637,0.7400641025641026,0.11031791907514399,0.20725589995098143,136062.33558643042,470.2895362034393,136532.62512263385,1945,76,709.825,37,3,16,31.0534901033456,0.6787725225225225,39.172149122807014,1043.3114035087717,28.197605500237074,0
1953,4,0,0,40,0.0,0.0,1.0,40,1450,1000,450,0.6896551724137931,19,10,9,311.9111079238729,0.7409188034188035,0.10464071856287438,0.20835662009314676,136176.75781249974,495.0086805555257,136671.76649305527,1946,77,710.825,37,3,17,30.923569527611438,0.6798986486486488,39.062499999999986,1043.749999999998,28.209459459459403,0
1954,4,0,0,40,0.0,0.0,1.0,40,850,400,450,0.47058823529411764,13,4,9,313.021225765725,0.7407852564102564,0.11101134215500985,0.20960535244312445,136262.60604224354,530.6175938750152,136793.22363611855,1947,78,711.825,37,3,17,30.80979136035848,0.6807432432432434,38.980263157894726,1044.0789473684192,28.218349928876194,0
1955,4,0,0,40,0.0,0.0,1.0,40,1050,800,250,0.7619047619047619,13,8,5,311.80716158881376,0.7397702991452991,0.11166526669466625,0.20913038077266619,136319.85322406876,501.10130040010347,136820.95452446886,1948,79,712.825,37,3,18,30.784946801063963,0.6813063063063064,38.92543859649122,1044.2982456140337,28.224276908487397,0
1956,4,1,0,41,0.024390243902439025,0.0,1.0,41,1200,600,600,0.5,18,6,12,304.9830084174967,0.7434451219512195,0.11111803362848227,0.2065653081925285,136665.05868078355,136.1041484038021,136801.16282918735,1949,0,696.4146341463414,38,3,21,30.62267974524028,0.6828399122807018,38.59508547008546,1045.619658119656,27.516306792622526,0
1957,4,0,0,41,0.0,0.0,1.0,41,1100,800,300,0.7272727272727273,14,8,6,300.4792330336565,0.7435975609756098,0.10681502363318507,0.20465185037076708,136860.6237216012,24.755049674909912,136885.37877127613,1950,1,697.4146341463414,38,3,21,30.547826900823647,0.6847587719298246,38.40811965811965,1046.3675213675206,27.535987404408434,0
1958,4,0,0,41,0.0,0.0,1.0,41,1300,900,400,0.6923076923076923,17,9,8,299.76498946821306,0.7415650406504065,0.10263916478723845,0.20481850535631463,136972.43795200516,11.908284023654062,136984.34623602882,1951,2,698.4146341463414,38,3,15,30.456470708307826,0.6858552631578948,38.301282051282044,1046.794871794871,27.547233468286077,0
1959,4,0,0,41,0.0,0.0,1.0,41,1250,1000,250,0.8,15,10,5,301.7681120672065,0.7416158536585366,0.1031247978262273,0.20684832408970333,137084.29783950618,73.53395061728156,137157.83179012345,1952,3,699.4146341463414,38,3,15,30.293987621573827,0.6869517543859649,38.19444444444444,1047.2222222222224,27.558479532163748,0
1960,4,0,0,41,0.0,0.0,1.0,41,1300,800,500,0.6153846153846154,18,8,10,312.56097004361555,0.7420731707317073,0.09282207723333968,0.20975477146300486,136339.89257812515,322.90581597223786,136662.7983940974,1953,4,700.4146341463414,39,2,17,30.745478422767473,0.6778846153846153,38.90625000000001,1044.3750000000011,26.77884615384618,4
1961,4,0,0,41,0.0,0.0,1.0,41,950,800,150,0.8421052631578947,11,8,3,312.35307039996655,0.7408028455284553,0.09264888262043147,0.21026183195380307,136448.70334201396,324.0342881944497,136772.7376302084,1954,5,701.4146341463414,39,2,18,30.643486208042532,0.6789529914529915,38.802083333333336,1044.7916666666672,26.78952991452993,0
1962,4,0,0,41,0.0,0.0,1.0,41,1300,700,600,0.5384615384615384,19,7,12,312.35307039996655,0.7408028455284553,0.09264888262043147,0.21026183195380307,136448.70334201396,324.0342881944497,136772.7376302084,1955,6,702.4146341463414,39,2,18,30.643486208042532,0.6789529914529915,38.802083333333336,1044.7916666666672,26.78952991452993,0
1963,4,0,1,40,0.0,0.024390243902439025,0.975609756097561,41,800,500,300,0.625,11,5,6,311.56439743697365,0.7397357723577236,0.0891585949352316,0.210054706659121,136503.125,305.9027777777783,136809.02777777778,1956,7,703.4146341463414,39,2,18,30.61038011695906,0.6794871794871795,38.75,1045.0,26.794871794871796,0
1964,4,0,1,39,0.0,0.025,0.975,40,850,700,150,0.8235294117647058,10,7,3,310.6386340936329,0.7372863247863248,0.06227628060069912,0.2000019073283642,134855.77493790633,378.28274526992084,135234.05768317624,1957,8,716.1,38,2,16,32.26488034012205,0.6650219298245614,40.33119658119658,1038.6752136752136,27.333558254610885,5
1965,4,0,0,39,0.0,0.0,1.0,39,900,500,400,0.5555555555555556,13,5,8,316.7895247439736,0.7316689158794423,0.0659340659340657,0.20368727690768318,134806.86515322016,741.0805488227041,135547.94570204287,1958,89,735.2564102564103,37,2,16,32.15374564459929,0.6663851351351353,40.378289473684205,1038.4868421052627,28.067211948790884,0
1966,4,0,0,39,0.0,0.0,1.0,39,1500,1100,400,0.7333333333333333,19,11,8,316.51444069405716,0.7310503823661718,0.07001764241105768,0.20431136512376583,134949.23918898107,742.6765927977683,135691.91578177884,1959,90,736.2564102564103,37,2,16,32.01948782890108,0.6677927927927929,40.24122807017543,1039.035087719297,28.08202939781884,0
1967,4,0,0,39,0.0,0.0,1.0,39,600,300,300,0.5,9,3,6,317.0510124155089,0.7300944669365722,0.06593406593406614,0.20498018387954917,135006.20984341326,760.7711026469573,135766.9809460602,1960,91,737.2564102564103,37,2,17,31.9489871280861,0.6683558558558559,40.186403508771924,1039.2543859649115,28.087956377430043,0
1968,4,0,0,39,0.0,0.0,1.0,39,750,300,450,0.4,12,3,9,315.62427673627815,0.7299820062977957,0.07089689494752816,0.20437965460791754,135063.1925207754,725.8444906124747,135789.03701138787,1961,92,738.2564102564103,37,2,18,31.92950070323489,0.668918918918919,40.13157894736841,1039.4736842105247,28.093883357041207,0
1969,4,0,0,39,0.0,0.0,1.0,39,1200,900,300,0.75,15,9,6,314.8664917497959,0.7286324786324787,0.07001462806587821,0.20437227524047302,135148.68907981287,710.7587190289169,135859.44779884178,1962,93,739.2564102564103,37,2,19,31.864366937326437,0.6697635135135136,40.04934210526315,1039.8026315789461,28.102773826458005,0
1970,4,0,0,39,0.0,0.0,1.0,39,750,400,350,0.5333333333333333,11,4,7,315.9235137799076,0.726889338731444,0.06922130759769152,0.20538276409886383,135205.70181450056,742.9320800630857,135948.63389456365,1963,94,740.2564102564103,37,2,20,31.780332981901243,0.6703265765765766,39.994517543859644,1040.0219298245609,28.108700806069212,0
1971,4,0,0,39,0.0,0.0,1.0,39,850,600,250,0.7058823529411765,11,6,5,316.8800055614875,0.7255398110661269,0.0682619561124238,0.20638532536135132,135272.23186728384,773.0131172839391,136045.24498456778,1964,95,741.2564102564103,38,1,20,31.689474855362697,0.6691337719298246,39.93055555555555,1040.277777777777,27.375730994152025,0
1972,4,0,0,39,0.0,0.0,1.0,39,1000,600,400,0.6,14,6,8,313.53486332530827,0.7239091318038686,0.06505028168272564,0.2046802660045912,135355.60029951046,687.7399280444056,136043.34022755487,1965,96,742.2564102564103,38,1,20,31.693831279945243,0.6699561403508772,39.850427350427346,1040.5982905982899,27.38416554206026,0
1973,4,0,0,39,0.0,0.0,1.0,39,1150,700,450,0.6086956521739131,16,7,9,314.25645121869564,0.724246513720198,0.06722149403323763,0.2054688824008409,135411.1935221709,710.76822631308,136121.961748484,1966,97,743.2564102564103,38,1,21,31.619961677957996,0.6705043859649124,39.79700854700854,1040.8119658119645,27.389788573999066,0
1974,4,0,1,38,0.0,0.02564102564102564,0.9743589743589743,39,800,600,200,0.75,10,6,4,313.02135152515245,0.7243589743589743,0.06200265251989423,0.2049784979342126,135466.79815910573,680.8000493096523,136147.59820841538,1967,98,744.2564102564103,38,1,21,31.597008415435127,0.6710526315789473,39.74358974358974,1041.02564102564,27.395411605937895,0
1975,4,0,0,38,0.0,0.0,1.0,38,1100,700,400,0.6363636363636364,15,7,8,316.71689764779927,0.7230322427690848,0.054125125385856565,0.20786871990056296,135548.0307041588,986.0703533779478,136534.10105753675,1968,99,748.7105263157895,37,1,23,31.420338878944236,0.673704954954955,39.66557017543859,1041.337719298244,28.144262683736326,0
1976,4,0,0,38,0.0,0.0,1.0,38,600,400,200,0.6666666666666666,8,4,4,316.9666866063638,0.7230618776671408,0.053556981525196834,0.20819845016509264,135576.5776488918,994.651719759913,136571.22936865172,1969,100,749.7105263157895,37,1,23,31.385554853653392,0.6739864864864865,39.638157894736835,1041.4473684210514,28.147226173541927,0
1977,4,0,1,37,0.0,0.02631578947368421,0.9736842105263158,38,750,500,250,0.6666666666666666,10,5,5,316.4886809315565,0.7230618776671408,0.07251387397064102,0.19384931707057831,133019.39058171748,838.1131694367559,133857.50375115423,1970,101,750.7105263157895,37,1,20,33.94318664965988,0.6486486486486486,42.10526315789474,1031.5789473684213,27.880512091038412,5
1978,4,0,0,37,0.0,0.0,1.0,37,1050,800,250,0.7619047619047619,13,8,5,324.9127591007034,0.718968968968969,0.06835241354892019,0.19894390864722258,133007.16256797366,1243.1448340232446,134250.3074019969,1971,102,745.3783783783783,36,1,20,33.738173216884995,0.6504629629629628,42.11711711711713,1031.5315315315338,28.653653653653716,0
1979,4,0,0,37,0.0,0.0,1.0,37,700,400,300,0.5714285714285714,10,4,6,322.747566423814,0.7175925925925926,0.06549221131004535,0.1978326939727472,133047.6700162552,1188.1623432210145,134235.83235947622,1972,103,746.3783783783783,37,0,20,33.75347628157439,0.6489301801801801,42.07785087719299,1031.6885964912296,27.883475580844046,0
1980,4,0,0,37,0.0,0.0,1.0,37,1000,800,200,0.8,12,8,4,322.22069501386125,0.7156531531531531,0.0663442873387623,0.19795960714559174,133132.52635426298,1179.611034164373,134312.13738842736,1973,104,747.3783783783783,37,0,22,33.68217877886385,0.6497747747747746,41.995614035087726,1032.0175438596502,27.89236605026082,0
1981,4,1,0,38,0.02631578947368421,0.0,1.0,38,1000,800,200,0.8,12,8,4,313.1649829702242,0.7247214319582741,0.07014732052963613,0.19401784435009856,133444.62393390684,758.0366763459851,134202.66061025282,1974,0,728.6842105263158,38,0,24,33.60411711991178,0.6510416666666665,41.693376068376075,1033.2264957264963,27.190170940170955,0
1982,4,0,0,38,0.0,0.0,1.0,38,1100,900,200,0.8181818181818182,13,9,4,314.93308975733277,0.7233878615457563,0.07303985616491904,0.19555726640662854,133528.88028047103,810.5354212817153,134339.41570175273,1975,1,729.6842105263158,37,1,24,33.474344013013656,0.653716216216216,41.611842105263165,1033.5526315789484,27.933854907539146,0
1983,4,0,0,38,0.0,0.0,1.0,38,800,500,300,0.625,11,5,6,314.07992405294306,0.7220839260312945,0.07455954268360743,0.1953262218978332,133585.55036164992,791.3079024315348,134376.85826408144,1976,2,730.6842105263158,37,1,24,33.43984231367556,0.6542792792792791,41.55701754385966,1033.771929824563,27.93978188715035,0
1984,4,0,0,38,0.0,0.0,1.0,38,750,600,150,0.8,9,6,3,316.1816566216881,0.7207207207207207,0.06936277518047818,0.197540248249603,133755.63274276705,858.2155086180373,134613.8482513851,1977,3,731.6842105263158,37,1,18,33.215850469931446,0.6559684684684685,41.39254385964912,1034.4298245614036,27.95756282598388,0
1985,4,0,0,38,0.0,0.0,1.0,38,800,500,300,0.625,11,5,6,317.3117941658105,0.7206318160265529,0.0668368058460933,0.19839872617325532,133783.99032635038,890.2476002231338,134674.23792657352,1978,4,732.6842105263158,37,1,18,33.15834216569511,0.65625,41.36513157894736,1034.5394736842102,27.960526315789465,0
1986,4,0,0,38,0.0,0.0,1.0,38,1050,700,350,0.6666666666666666,14,7,7,314.83832930210656,0.7172534376481745,0.06747478149393449,0.19769725033105057,133941.8297195741,834.0043785155897,134775.8340980897,1979,5,733.6842105263158,38,0,20,33.06498778683729,0.6559758771929824,41.212606837606835,1035.1495726495725,27.24077822762033,0
1987,4,0,2,36,0.0,0.05263157894736842,0.9473684210526316,38,900,600,300,0.6666666666666666,12,6,6,311.5238566804999,0.7161865813181603,0.06596458648943626,0.1962053764005254,134052.44545118348,752.1069608810045,134804.55241206448,1980,6,734.6842105263158,38,0,21,33.04059630661301,0.6570723684210527,41.10576923076923,1035.5769230769233,27.252024291497982,0
1988,4,0,0,36,0.0,0.0,1.0,36,650,600,50,0.9230769230769231,7,6,1,322.2126086433773,0.7037367724867726,0.049974618369049484,0.20246756741343583,133967.237402098,1433.1866072153207,135400.4240093133,1981,112,733.5,36,0,21,32.8488161282135,0.6600115740740742,41.18806306306306,1035.2477477477473,28.75688188188187,0
1989,4,0,0,36,0.0,0.0,1.0,36,950,900,50,0.9473684210526315,10,9,1,321.94140549113945,0.7038690476190477,0.04772823394356851,0.20261815355859203,134025.53471968602,1429.6738038714561,135455.2085235575,1982,113,734.5,36,0,21,32.79771615008156,0.6605902777777777,41.131756756756765,1035.472972972974,28.763138138138167,0
1990,4,1,1,36,0.02702702702702703,0.02702702702702703,0.972972972972973,37,900,600,300,0.6666666666666666,12,6,6,313.45543803996753,0.713963963963964,0.03585305394254945,0.1987320091074321,134294.9408111149,1019.0958996999038,135314.0367108148,1983,0,715.6216216216217,37,0,21,32.74919337776368,0.6613175675675675,40.87171052631579,1036.5131578947364,28.013869132290175,0
1991,4,0,0,36,0.0,0.0,1.0,36,900,800,100,0.8888888888888888,10,8,2,320.62192816635144,0.7053571428571429,0.0393236714975842,0.20259077878643098,134171.3334956579,1403.6543300056878,135574.9878256636,1984,115,736.5,36,0,21,32.686594202898526,0.662037037037037,40.990990990990994,1036.0360360360366,28.778778778778797,0
1992,4,0,0,36,0.0,0.0,1.0,36,850,600,250,0.7058823529411765,11,6,5,321.34284528193444,0.7053240740740742,0.04298690325306276,0.2038567119793387,134317.21153163296,1432.3749847820754,135749.58651641503,1985,116,737.5,36,0,21,32.52263262719536,0.6634837962962963,40.85022522522522,1036.599099099099,28.794419419419416,0
1993,4,0,0,36,0.0,0.0,1.0,36,450,300,150,0.6666666666666666,6,3,3,323.6691303071178,0.7069444444444445,0.05201394922289815,0.20582495523949876,134404.77639801972,1500.5354171739414,135905.31181519365,1986,117,738.5,36,0,21,32.37515385172313,0.6643518518518519,40.76576576576577,1036.9369369369376,28.803803803803824,0
1994,4,0,0,36,0.0,0.0,1.0,36,1050,800,250,0.7619047619047619,13,8,5,321.39367947352713,0.7065806878306878,0.04519053305829979,0.20486900910938818,134492.36979800757,1444.9995180991905,135937.36931610675,1987,118,739.5,36,0,22,32.34696739405784,0.6652199074074073,40.68130630630631,1037.2747747747756,28.81318818818821,0
1995,4,0,0,36,0.0,0.0,1.0,36,550,500,50,0.9090909090909091,6,5,1,320.9755881059621,0.7060185185185186,0.04015628391578052,0.20509494235841444,134579.99173159653,1439.3783986689486,136019.37013026548,1988,119,740.5,36,0,22,32.270638882859416,0.6660879629629629,40.59684684684685,1037.6126126126132,28.82257257257259,0
1996,4,0,0,36,0.0,0.0,1.0,36,700,300,400,0.42857142857142855,11,3,8,322.26421214916087,0.705489417989418,0.04215494791666652,0.20624909577546302,134638.42220598992,1477.829011443891,136116.2512174338,1989,120,741.5,36,0,22,32.17909071180556,0.6666666666666665,40.54054054054055,1037.8378378378388,28.828828828828858,0
1997,4,0,0,36,0.0,0.0,1.0,36,650,400,250,0.6153846153846154,9,4,5,321.1220488992458,0.7059193121693123,0.04070075826070174,0.2056832470260148,134667.64219878684,1448.9498366610092,136116.59203544786,1990,121,742.5,36,0,22,32.179668004773795,0.6669560185185184,40.5123873873874,1037.950450450452,28.831956956957,0
1998,4,0,0,36,0.0,0.0,1.0,36,1150,1000,150,0.8695652173913043,13,10,3,322.35607214833266,0.7048611111111112,0.04314459268901172,0.206805889292657,134726.09169558084,1485.9547469767203,136212.04644255756,1991,122,743.5,36,0,23,32.08952525581227,0.6675347222222221,40.45608108108109,1038.1756756756768,28.838213213213244,0
1999,4,0,0,36,0.0,0.0,1.0,36,550,400,150,0.7272727272727273,7,4,3,323.7644750401137,0.7041666666666667,0.040576042419860237,0.20787663369567197,134755.32119957803,1525.7971654086605,136281.1183649867,1992,123,744.5,36,0,23,32.023906362979034,0.6678240740740741,40.42792792792793,1038.2882882882889,28.84134134134136,0
2000,4,0,0,36,0.0,0.0,1.0,36,750,600,150,0.8,9,6,3,324.84130511211134,0.703670634920635,0.04202062924001959,0.20873600518737162,134784.55387397553,1556.7180778751913,136341.2719518507,1993,124,745.5,36,0,15,31.96688717781875,0.6681134259259258,40.399774774774784,1038.4009009009023,28.84446946946951,0
2001,4,0,0,36,0.0,0.0,1.0,36,1050,900,150,0.8571428571428571,12,9,3,324.4754812100715,0.7028439153439154,0.03454153416208916,0.20900571499173892,134872.27091956837,1552.5490017044249,136424.8199212728,1994,125,746.5,36,0,15,31.889184012720435,0.6689814814814814,40.315315315315324,1038.73873873874,28.85385385385389,0
2002,4,0,0,36,0.0,0.0,1.0,36,1200,900,300,0.75,15,9,6,323.79537424847916,0.7026785714285715,0.03819783051010717,0.20941187869230657,135018.529403559,1543.6750517409373,136562.2044552999,1995,126,747.5,36,0,16,31.76152165276123,0.6704282407407407,40.17454954954955,1039.3018018018022,28.869494494494504,0
2003,4,0,0,36,0.0,0.0,1.0,36,900,600,300,0.6666666666666666,12,6,6,323.2042027823025,0.7020171957671958,0.03663079719303308,0.20936828041287278,135077.05498995632,1531.4943744420216,136608.54936439835,1996,127,748.5,36,0,16,31.718755642220053,0.6710069444444444,40.11824324324325,1039.527027027028,28.87575075075078,0
2004,4,0,0,36,0.0,0.0,1.0,36,950,700,250,0.7368421052631579,12,7,5,322.53537994414705,0.7035714285714286,0.028710119820990698,0.20978427951860146,135223.42443795144,1522.8677156886638,136746.2921536401,1997,128,749.5,36,0,18,31.59083116789375,0.6724537037037037,39.97747747747748,1040.09009009009,28.891391391391387,0
2005,4,0,0,36,0.0,0.0,1.0,36,800,500,300,0.625,11,5,6,321.4504751050561,0.7031415343915345,0.022804897114887313,0.20958933941394617,135311.28415155035,1499.1753155182373,136810.45946706858,1998,129,750.5,36,0,18,31.531866724392973,0.6733217592592593,39.893018018018026,1040.4279279279292,28.900775775775813,0
2006,4,0,0,36,0.0,0.0,1.0,36,600,500,100,0.8333333333333334,7,5,2,321.4504751050561,0.7031415343915345,0.022804897114887313,0.20958933941394617,135311.28415155035,1499.1753155182373,136810.45946706858,1999,130,751.5,36,0,18,31.531866724392973,0.6733217592592593,39.893018018018026,1040.4279279279292,28.900775775775813,0
2007,4,0,0,36,0.0,0.0,1.0,36,1100,700,400,0.6363636363636364,15,7,8,330.52827720554654,0.70244708994709,0.027199325138587582,0.21221940918072016,134755.32119957806,1708.0888320753274,136463.4100316534,2000,131,752.5,36,0,21,31.848336948662325,0.6678240740740741,40.42792792792793,1038.288288288289,28.841341341341362,1
2008,4,0,0,36,0.0,0.0,1.0,36,1050,700,350,0.6666666666666666,14,7,7,329.8184752343471,0.6986441798941799,0.01793348024517427,0.2129625661992527,134960.0164987623,1702.4613718448225,136662.4778706071,2001,132,753.5,36,0,19,31.66318955240056,0.669849537037037,40.23085585585586,1039.0765765765768,28.863238238238246,0
2009,4,0,0,36,0.0,0.0,1.0,36,950,500,450,0.5263157894736842,14,5,9,329.95189456016317,0.6985119047619048,0.018593748119259956,0.21373936411823627,135077.05498995614,1713.7860411086745,136790.84103106483,2002,133,754.5,36,0,19,31.543395442891704,0.6710069444444444,40.11824324324324,1039.5270270270269,28.875750750750747,0
2010,4,0,0,36,0.0,0.0,1.0,36,600,500,100,0.8333333333333334,7,5,2,329.63702758904066,0.6972222222222223,0.020479869082858038,0.21405543690275683,135164.86714755304,1711.0690081973994,136875.93615575045,2003,134,755.5,36,0,19,31.464334705075448,0.671875,40.03378378378379,1039.8648648648657,28.885135135135158,0
2011,4,0,0,36,0.0,0.0,1.0,36,1150,700,450,0.6086956521739131,16,7,9,329.5632346149099,0.6950727513227514,0.022809834842962617,0.2145296404607417,135252.70783875103,1714.8639771528397,136967.57181590388,2004,135,756.5,36,0,19,31.37901014037747,0.6727430555555556,39.94932432432433,1040.2027027027036,28.894519519519545,0
2012,4,0,0,36,0.0,0.0,1.0,36,1150,700,450,0.6086956521739131,16,7,9,331.0128183504803,0.6944444444444445,0.022913660413659942,0.2159998899405679,135340.57706355018,1759.893170197236,137100.47023374742,2005,136,757.5,36,0,20,31.254058441558424,0.6736111111111112,39.86486486486487,1040.5405405405418,28.903903903903938,0
2013,4,0,0,36,0.0,0.0,1.0,36,1000,900,100,0.9,11,9,2,332.5465251736787,0.6948082010582011,0.021687768279046615,0.21717755753568668,135369.87314595006,1803.356185577476,137173.22933152755,2006,137,758.5,36,0,20,31.185071961908886,0.673900462962963,39.836711711711715,1040.6531531531534,28.90703203203204,0
2014,4,0,0,36,0.0,0.0,1.0,36,700,600,100,0.8571428571428571,8,6,2,335.38225828294776,0.6938161375661376,0.02390180878552961,0.2197454980741213,135487.0891795512,1887.9931874442022,137375.0823669954,2007,138,759.5,36,0,21,30.99490715702182,0.6750578703703705,39.7240990990991,1041.1036036036037,28.919544544544546,0
2015,4,0,0,36,0.0,0.0,1.0,36,850,500,350,0.5882352941176471,12,5,7,334.947210921289,0.6935846560846561,0.027567476626529253,0.21963985192753466,135516.40111395178,1878.168117441762,137394.56923139354,2008,139,760.5,36,0,21,30.97713425625496,0.6753472222222223,39.695945945945944,1041.216216216216,28.922672672672668,0
2016,4,0,0,36,0.0,0.0,1.0,36,800,500,300,0.625,11,5,6,336.0000000000002,0.6943121693121693,0.025333333333333874,0.22105263157894736,135633.68055555545,1914.583333333324,137548.26388888876,2009,140,761.5,36,0,22,30.833333333333343,0.6765046296296298,39.58333333333333,1041.6666666666658,28.935185185185162,0
2017,4,0,1,35,0.0,0.027777777777777776,0.9722222222222222,36,650,400,250,0.6153846153846154,9,4,5,337.7344362212395,0.692691798941799,0.02099319139738487,0.22274103623343744,135721.67342595963,1967.5765715039274,137689.24999746354,2010,141,762.5,36,0,22,30.70085377715336,0.6773726851851853,39.49887387387387,1042.0045045045038,28.94456956956955,0
2018,4,0,0,35,0.0,0.0,1.0,35,900,800,100,0.8888888888888888,10,8,2,340.9700132197983,0.686624649859944,0.03517264349950033,0.22565149956434402,135844.7483308684,2263.7971268432666,138108.54545771168,2011,142,779.4857142857143,35,0,22,30.494453388105544,0.6806547619047619,39.38078703703703,1042.476851851851,29.785052910052887,0
2019,4,0,0,35,0.0,0.0,1.0,35,850,700,150,0.8235294117647058,10,7,3,340.72634622988267,0.6850140056022408,0.03150085600152197,0.22644733275985998,135995.6114969135,2267.4575617283876,138263.0690586419,2012,143,780.4857142857143,35,0,18,30.351198402130503,0.6821428571428572,39.23611111111111,1043.055555555555,29.801587301587286,0
2020,4,0,0,35,0.0,0.0,1.0,35,650,300,350,0.46153846153846156,10,3,7,340.9813372609711,0.6848739495798318,0.03285951984787272,0.2271948821439508,136086.1695842979,2280.5688175154364,138366.73840181335,2013,144,781.4857142857143,35,0,19,30.254783693843592,0.6830357142857142,39.14930555555556,1043.402777777778,29.811507936507944,0
2021,4,0,0,35,0.0,0.0,1.0,35,1000,800,200,0.8,12,8,4,342.7476384556235,0.6837535014005601,0.02714570858283416,0.22895542248835665,136176.75781250015,2334.85243055557,138511.6102430557,2014,145,782.4857142857143,35,0,19,30.11892880904857,0.6839285714285713,39.06250000000001,1043.7500000000011,29.821428571428605,0
2022,4,0,0,35,0.0,0.0,1.0,35,650,500,150,0.7692307692307693,8,5,3,343.55976617617404,0.6846638655462184,0.02896420652518228,0.2298893984353924,136237.16670953357,2361.1218278463575,138598.28853737994,2015,146,783.4857142857143,35,0,19,30.037878787878782,0.6845238095238095,39.004629629629626,1043.981481481481,29.828042328042315,0
2023,4,0,0,35,0.0,0.0,1.0,35,1100,1000,100,0.9090909090909091,12,10,2,344.33477495170433,0.6853641456582633,0.029185799790987232,0.2308015111154739,136297.58900248643,2386.399927126217,138683.98892961265,2016,147,784.4857142857143,35,0,19,29.957788369171663,0.6851190476190475,38.94675925925927,1044.212962962964,29.834656084656114,0
2024,4,0,0,35,0.0,0.0,1.0,35,550,400,150,0.7272727272727273,7,4,3,343.59407766149434,0.6843837535014005,0.027130666075584786,0.23050181135610906,136327.80517243245,2368.285295567578,138696.09046800004,2017,148,785.4857142857143,35,0,19,29.947195130961603,0.6854166666666666,38.91782407407408,1044.328703703705,29.837962962963,0
2025,4,0,0,35,0.0,0.0,1.0,35,800,700,100,0.875,9,7,2,341.63756386565046,0.6832633053221288,0.03190782184799468,0.22977799191142803,136418.47377614898,2321.135009430743,138739.60878557974,2018,149,786.4857142857143,35,0,20,29.908505059457866,0.6863095238095237,38.831018518518526,1044.675925925927,29.84788359788363,0
2026,4,0,0,35,0.0,0.0,1.0,35,900,700,200,0.7777777777777778,11,7,4,341.34281078575293,0.6820728291316526,0.030754627432368453,0.23036813014912935,136539.41213348781,2321.3493441358182,138860.76147762363,2019,150,787.4857142857143,35,0,20,29.79651162790698,0.6874999999999998,38.715277777777786,1045.13888888889,29.861111111111143,0
2027,4,0,0,35,0.0,0.0,1.0,35,450,300,150,0.6666666666666666,6,3,3,341.34281078575293,0.6820728291316526,0.030754627432368453,0.23036813014912935,136539.41213348781,2321.3493441358182,138860.76147762363,2020,151,788.4857142857143,35,0,20,29.79651162790698,0.6874999999999998,38.715277777777786,1045.13888888889,29.861111111111143,0
2028,4,0,0,35,0.0,0.0,1.0,35,1050,800,250,0.7619047619047619,13,8,5,343.7617337087171,0.6820028011204481,0.025503652866947224,0.23279936299284504,136660.4040745029,2395.7234867969996,139056.12756129992,2021,152,789.4857142857143,35,0,20,29.61358940299609,0.6886904761904761,38.599537037037045,1045.601851851853,29.87433862433866,0
2029,4,0,0,35,0.0,0.0,1.0,35,600,400,200,0.6666666666666666,8,4,4,346.81989174775,0.6811624649859943,0.01957882754695528,0.23527511575320353,136720.92013888896,2483.506944444455,139204.42708333343,2022,153,790.4857142857143,35,0,20,29.473771580345286,0.6892857142857143,38.54166666666667,1045.833333333334,29.880952380952397,0
2030,4,0,0,35,0.0,0.0,1.0,35,450,300,150,0.6666666666666666,6,3,3,346.81989174775,0.6811624649859943,0.01957882754695528,0.23527511575320353,136720.92013888896,2483.506944444455,139204.42708333343,2023,154,791.4857142857143,35,0,20,29.473771580345286,0.6892857142857143,38.54166666666667,1045.833333333334,29.880952380952397,0
2031,4,0,0,35,0.0,0.0,1.0,35,750,600,150,0.8,9,6,3,350.9697219891624,0.6780812324929971,0.019459389171529784,0.2389367069374709,136845.45245181414,2605.722080498873,139451.17453231302,2024,155,792.4857142857143,34,1,20,29.24204498046801,0.6927083333333333,38.42261904761905,1046.3095238095243,30.77380952380954,0
2032,4,0,0,35,0.0,0.0,1.0,35,750,600,150,0.8,9,6,3,350.9521239488974,0.6781512605042016,0.019372663741264784,0.23913714492331853,136876.59438775515,2607.4263038548816,139484.02069161003,2025,156,793.4857142857143,34,1,20,29.211698900265457,0.6930147058823528,38.392857142857146,1046.4285714285718,30.777310924369758,0
2033,4,0,0,35,0.0,0.0,1.0,35,900,600,300,0.6666666666666666,12,6,6,351.8566062407676,0.6781512605042016,0.05131869428200697,0.22682041453254603,134900.65607278416,2496.326180594744,137396.9822533789,2026,157,794.4857142857143,33,2,18,31.149851559120762,0.6758207070707073,40.28799019607841,1038.8480392156835,31.480243612596468,3
2034,4,0,0,35,0.0,0.0,1.0,35,600,300,300,0.5,9,3,6,352.8527899139804,0.6756302521008403,0.05566055215860688,0.22826426477959283,135027.9959180361,2529.001015234495,137556.9969332706,2027,158,795.4857142857143,33,2,20,30.997106276775533,0.6770833333333335,40.16544117647057,1039.3382352941155,31.495098039215623,0
2035,4,0,0,35,0.0,0.0,1.0,35,1000,600,400,0.6,14,6,8,352.40684364831156,0.6754201680672268,0.05473187978786087,0.22878133652302374,135155.39583633683,2525.937289744307,137681.33312608112,2028,159,796.4857142857143,33,2,20,30.88182577096837,0.6783459595959597,40.042892156862735,1039.8284313725478,31.509952465834782,0
2036,4,0,0,35,0.0,0.0,1.0,35,1050,600,450,0.5714285714285714,15,6,9,372.26318463502145,0.6754201680672268,0.03211499109950244,0.21410743244882294,130627.42524092962,2725.5562641723236,133352.98150510195,2029,160,797.4857142857143,34,1,14,34.920762004580574,0.6308210784313726,44.4345238095238,1022.261904761904,30.066526610644235,6
2037,4,0,0,35,0.0,0.0,1.0,35,800,500,300,0.625,11,5,6,377.14982574231374,0.6774509803921568,0.027290720689253645,0.21725954750507942,130688.28125000001,2857.8125000000005,133546.09375000003,2030,161,798.4857142857143,34,1,14,34.734107579462105,0.6314338235294117,44.375,1022.5000000000001,30.07352941176471,0
2038,4,0,0,35,0.0,0.0,1.0,35,550,300,250,0.5454545454545454,8,3,5,377.4185810449108,0.678361344537815,0.03116580741726227,0.21758561148830774,130718.71456916105,2867.1343537414964,133585.84892290254,2031,162,799.4857142857143,34,1,14,34.696352347691075,0.6317401960784315,44.345238095238095,1022.619047619048,30.077030812324942,0
2039,4,0,0,35,0.0,0.0,1.0,35,1000,600,400,0.6,14,6,8,377.34549103606855,0.6785714285714285,0.027124731862248286,0.21771491695707604,130749.15143140576,2867.5205498866057,133616.67198129237,2032,163,800.4857142857143,34,1,15,34.6673359717534,0.632046568627451,44.31547619047618,1022.738095238094,30.080532212885117,0
2040,4,0,0,35,0.0,0.0,1.0,35,800,700,100,0.875,9,7,2,376.5989170992722,0.6794117647058823,0.02843841447193407,0.21745550374441833,130779.59183673457,2850.2905328798024,133629.88236961438,2033,164,801.4857142857143,34,1,15,34.655541977032904,0.6323529411764707,44.28571428571428,1022.8571428571419,30.08403361344535,0
2041,4,1,0,36,0.027777777777777776,0.0,1.0,36,1000,700,300,0.7,13,7,6,367.8345303073832,0.6915674603174604,0.035273069679849556,0.21444898506062823,131150.2338927467,2448.3169367283717,133598.55082947508,2034,0,780.1944444444445,35,1,17,34.5042372881356,0.6339285714285714,43.9236111111111,1024.3055555555538,29.265873015872966,0
2042,4,1,0,37,0.02702702702702703,0.0,1.0,37,1050,800,250,0.7619047619047619,13,8,5,358.49348323811313,0.7076451451451451,0.04523850606265012,0.21081374457995514,131480.69905045338,2027.2358827790204,133507.9349332324,2035,0,760.081081081081,34,3,18,34.40946024376088,0.6393995098039216,43.60119047619047,1025.595238095237,30.1645658263305,0
2043,4,1,1,37,0.02631578947368421,0.02631578947368421,0.9736842105263158,38,1000,800,200,0.8,12,8,4,352.0314680640072,0.7227358937885254,0.04379438620223186,0.20860862746798967,131773.38023244584,1677.675298996898,133451.05553144275,2036,0,741.0526315789474,35,3,16,34.27988670950287,0.6401785714285715,43.315972222222214,1026.73611111111,29.335317460317427,0
2044,4,0,0,37,0.0,0.0,1.0,37,700,500,200,0.7142857142857143,9,5,4,361.4289140897736,0.7062062062062062,0.0534583998219309,0.21356262291761052,131663.9048327664,2117.4284297052077,133781.3332624716,2037,2,762.081081081081,34,3,16,34.14917062985732,0.6412377450980392,43.422619047619044,1026.3095238095234,30.185574229691866,0
2045,4,0,0,37,0.0,0.0,1.0,37,700,600,100,0.8571428571428571,8,6,2,361.6097782088042,0.7061436436436437,0.04922779922779896,0.2141842532467533,131755.5555555556,2128.8194444444493,133884.37500000003,2038,3,763.081081081081,34,3,16,34.052015692640694,0.642156862745098,43.333333333333336,1026.666666666667,30.19607843137256,0
2046,4,0,0,37,0.0,0.0,1.0,37,650,500,150,0.7692307692307693,8,5,3,360.73544377806803,0.7061436436436437,0.06098484732321108,0.2044476827020008,130055.90284475735,1983.1547657321653,132039.05761048952,2039,4,764.081081081081,35,2,19,35.79525038768487,0.6229166666666666,44.99421296296296,1020.0231481481479,29.143518518518512,2
2047,4,1,1,37,0.02631578947368421,0.02631578947368421,0.9736842105263158,38,1000,800,200,0.8,12,8,4,354.42935824704404,0.7180239449976292,0.06242953524579886,0.202403250991176,130351.21588059417,1640.2236582647527,131991.43953885892,2040,0,744.9473684210526,35,3,19,35.656451887113235,0.625892857142857,44.704861111111114,1021.1805555555559,29.17658730158731,0
2048,4,0,0,37,0.0,0.0,1.0,37,1100,800,300,0.7272727272727273,14,8,6,359.350270720533,0.7081456456456456,0.05956977385548812,0.20474608448030385,130262.58680555563,1961.9791666666767,132224.5659722223,2041,6,766.081081081081,36,1,19,35.62074829931973,0.622974537037037,44.79166666666667,1020.833333333334,28.356481481481502,0
2049,4,2,2,37,0.05128205128205128,0.05128205128205128,0.9487179487179487,39,800,600,200,0.75,10,6,4,343.86268516505856,0.7317251461988304,0.05474192581346893,0.19776877321368544,130626.62459843412,1183.5243776931297,131810.14897612724,2042,0,727.7435897435897,37,2,14,35.64739086131071,0.6247184684684685,44.435307017543856,1022.2587719298244,27.628615457562823,0
2050,4,1,1,37,0.02631578947368421,0.02631578947368421,0.9736842105263158,38,900,700,200,0.7777777777777778,11,7,4,351.77825611285033,0.7207799905168326,0.05776247628881537,0.2016224963810419,130492.60567577725,1580.892252049361,132073.4979278266,2043,0,747.8684210526316,36,2,14,35.58084426319851,0.6252893518518519,44.56644144144145,1021.7342342342351,28.381506506506533,0
2051,4,2,0,39,0.05128205128205128,0.0,1.0,39,700,300,400,0.42857142857142855,11,3,8,336.95098840665884,0.7310503823661718,0.09161140583554439,0.18791497430371365,129424.43828870426,935.7487440367736,130360.18703274103,2044,0,729.6410256410256,37,2,16,37.042474856321846,0.6126126126126126,45.6140350877193,1017.5438596491231,27.501185395922246,5
2052,4,1,3,37,0.025,0.075,0.925,40,850,600,250,0.7058823529411765,11,6,5,330.87350470171856,0.7405181623931624,0.09053224960671225,0.18590918487512587,129717.84056770029,584.0393061947498,130301.87987389504,2045,0,712.375,38,2,12,36.89936199965041,0.6137609649122808,45.3258547008547,1018.6965811965808,26.807804768331074,0
2053,4,1,1,37,0.02631578947368421,0.02631578947368421,0.9736842105263158,38,1050,900,150,0.8571428571428571,12,9,3,346.86907586321007,0.7225284495021337,0.0924868624960673,0.19319452721012584,129373.1801903255,1375.1110908205535,130748.29128114606,2046,0,750.7894736842105,36,2,15,36.842299461294374,0.6140046296296295,45.664414414414416,1017.3423423423426,28.259509509509517,0
2054,4,1,0,38,0.02631578947368421,0.0,1.0,38,650,400,250,0.6153846153846154,9,4,5,346.47274488708143,0.7213430535798957,0.09798395080420619,0.19353650607474945,129487.77113261924,1372.7966987257653,130860.567831345,2047,0,751.7631578947369,36,2,13,36.7358652356716,0.615162037037037,45.55180180180181,1017.7927927927939,28.272022022022053,0
2055,4,2,0,40,0.05,0.0,1.0,40,800,600,200,0.75,10,6,4,342.68527027643495,0.7390758547008547,0.12396378480217729,0.19511412826108823,130235.32238476147,925.945330192125,131161.2677149536,2048,0,715.125,38,2,16,36.07367769171727,0.6189692982456141,44.81837606837607,1020.7264957264956,26.861223571749886,0
2056,4,0,0,40,0.0,0.0,1.0,40,750,400,350,0.5333333333333333,11,4,7,344.14680473817,0.7387553418803419,0.12087136261140374,0.19650761450193593,130346.55044100096,971.6726221511861,131318.22306315214,2049,1,716.125,37,3,17,35.92368642399513,0.6219031531531531,44.7094298245614,1021.1622807017534,27.59898055950685,0
2057,4,0,0,40,0.0,0.0,1.0,40,1150,800,350,0.6956521739130435,15,8,7,343.06023672736507,0.7381410256410257,0.12350762293321904,0.19602840766126864,130374.54433094799,945.2644082794737,131319.80873922748,2050,2,717.125,37,3,17,35.92307279364398,0.6221846846846846,44.68201754385965,1021.2719298245614,27.601944049312472,0
2058,4,0,0,40,0.0,0.0,1.0,40,1000,800,200,0.8,12,8,4,341.2896939830458,0.7385683760683761,0.12711418759390458,0.1955804039688819,130486.54994806091,906.7429401354227,131393.29288819633,2051,3,718.125,37,3,17,35.85488659941332,0.6233108108108107,44.57236842105263,1021.7105263157893,27.613798008534843,0
2059,4,0,0,40,0.0,0.0,1.0,40,900,700,200,0.7777777777777778,11,7,4,344.52315091390295,0.7383012820512821,0.1341996566891963,0.197862001828003,130570.58572108719,996.9179218605608,131567.50364294776,2052,4,719.125,37,3,12,35.68722508314556,0.6241554054054055,44.49013157894736,1022.0394736842101,27.622688477951623,0
2060,4,0,0,40,0.0,0.0,1.0,40,850,600,250,0.7058823529411765,11,6,5,343.1668739083875,0.7389957264957265,0.12353619302949093,0.19765479303247122,130682.67549871096,969.1930449753589,131651.86854368632,2053,5,720.125,37,3,12,35.60846738159071,0.6252815315315317,44.38048245614034,1022.4780701754371,27.634542437173977,0
2061,4,1,1,40,0.024390243902439025,0.024390243902439025,0.975609756097561,41,900,700,200,0.7777777777777778,11,7,4,337.8791401692829,0.7507113821138212,0.1156436611329168,0.1962156315819433,130999.80481591038,652.4202827087232,131652.2250986191,2054,0,703.5365853658536,38,3,14,35.42318931329576,0.6266447368421054,44.07051282051281,1023.7179487179471,26.939946018893345,0
2062,4,2,0,42,0.047619047619047616,0.0,1.0,42,900,700,200,0.7777777777777778,11,7,4,333.4133869766087,0.7576219512195121,0.12003978336939003,0.19514897765989603,131301.43364800338,355.53114149305,131656.96478949644,2055,0,687.5952380952381,39,3,16,35.23319188941966,0.6279380341880343,43.776041666666664,1024.8958333333328,26.27938034188033,0
2063,4,0,1,41,0.0,0.023809523809523808,0.9761904761904762,42,950,800,150,0.8421052631578947,11,8,3,333.1058724100167,0.7577913279132791,0.11245260922209632,0.1953841046238703,131382.88498064133,352.8848169178848,131735.76979755922,2056,1,688.5952380952381,38,4,16,35.15896380436291,0.6304824561403508,43.69658119658119,1025.2136752136746,26.979307242465122,0
2064,4,2,2,41,0.046511627906976744,0.046511627906976744,0.9534883720930233,43,1000,700,300,0.7,13,7,6,325.63585457702413,0.766703580657069,0.10767236432927896,0.1919322281106589,131568.46923828122,-31.317816840278397,131537.15142144094,2057,0,673.3255813953489,39,4,11,35.16357413612213,0.6306089743589745,43.515625,1025.9374999999998,26.306089743589737,0
2065,4,1,0,42,0.023809523809523808,0.0,1.0,42,900,600,300,0.6666666666666666,12,6,6,335.4067823787524,0.7557104142469996,0.1152850896760953,0.19814991091822218,131656.85609796178,431.7204963839488,132088.57659434574,2058,0,690.3333333333334,38,4,12,34.823938163647725,0.6332236842105263,43.429487179487175,1026.2820512820506,27.007422402159225,0
2066,4,0,0,42,0.0,0.0,1.0,42,1200,1000,200,0.8333333333333334,14,10,4,331.7827402295133,0.7549845141308555,0.11070895947599713,0.19671584925020688,131793.94866544305,345.39148677770265,132139.34015222074,2059,1,691.3333333333334,38,4,12,34.77894253112752,0.6345942982456141,43.29594017094017,1026.8162393162393,27.021479982006298,0
2067,4,0,1,41,0.0,0.023809523809523808,0.9761904761904762,42,1200,900,300,0.75,15,9,6,389.3398398247757,0.7549845141308555,0.1600805745314422,0.21575821642007798,129174.23575726851,1659.9163790269506,130834.15213629547,2060,2,692.3333333333334,38,4,15,35.965361709581366,0.6082785087719298,45.86004273504273,1016.5598290598283,26.75157444894285,6
2068,4,0,0,41,0.0,0.0,1.0,41,1300,900,400,0.6923076923076923,17,9,8,388.38918360891716,0.7503048780487804,0.16207897166880225,0.2152275027637938,129173.52123970828,1833.9196916358758,131007.44093134416,2061,3,710.0975609756098,37,4,15,35.990251860640704,0.6100788288288288,45.86074561403508,1016.5570175438588,27.47451398767186,0
2069,4,1,0,42,0.023809523809523808,0.0,1.0,42,1000,700,300,0.7,13,7,6,382.3425375454454,0.7603803716608595,0.16762624445244145,0.21378871465569219,129527.44904667948,1504.7707100591388,131032.21975673862,2062,0,694.1666666666666,38,4,16,35.78269311502938,0.611842105263158,45.5128205128205,1017.9487179487153,26.788124156545138,0
2070,4,0,0,42,0.0,0.0,1.0,42,1400,1000,400,0.7142857142857143,18,10,8,382.5624643305678,0.7618321718931474,0.17083220953579703,0.21480274057288715,129690.63321827704,1522.9536489151421,131213.58686719218,2063,1,695.1666666666666,38,4,16,35.61070904132576,0.6134868421052634,45.35256410256408,1018.5897435897404,26.804993252361587,0
2071,4,0,1,41,0.0,0.023809523809523808,0.9761904761904762,42,700,300,400,0.42857142857142855,11,3,8,378.4046777948392,0.7617595818815331,0.16977134001707817,0.2107588075954738,129373.18019032577,1402.6145835884988,130775.79477391427,2064,2,696.1666666666666,36,6,15,36.04023688288689,0.6140046296296295,45.66441441441443,1017.3423423423449,28.25950950950958,3
2072,4,0,0,41,0.0,0.0,1.0,41,750,300,450,0.4,12,3,9,384.26041388092904,0.7540142276422764,0.1691493673416138,0.2134078379492948,129260.23046339172,1733.9179312414385,130994.14839463316,2065,3,713.4146341463414,35,6,15,36.006620380909034,0.6148809523809522,45.77546296296297,1016.8981481481488,29.054232804232825,0
2073,4,1,2,40,0.023809523809523808,0.047619047619047616,0.9523809523809523,42,700,300,400,0.42857142857142855,11,3,8,378.18421700348813,0.7634775454897406,0.16440084941800048,0.21109640327736445,129459.11864144582,1391.8790834754004,130850.99772492122,2066,0,697.4047619047619,36,6,12,35.95819040241967,0.6148726851851851,45.57995495495497,1017.6801801801828,28.268893893893967,0
2074,4,0,0,40,0.0,0.0,1.0,40,900,500,400,0.5555555555555556,13,5,8,402.5951856418999,0.7440705128205128,0.1601721714687283,0.2229155444235111,129140.88010204086,2403.2705071315177,131544.1506091724,2067,9,733.175,34,6,16,35.662625907706726,0.6158088235294117,45.892857142857146,1016.4285714285718,29.894957983193287,6
2075,4,2,2,40,0.047619047619047616,0.047619047619047616,0.9523809523809523,42,1450,1000,450,0.6896551724137931,19,10,9,384.2148760330574,0.764082462253194,0.14874458874458862,0.21563079777365496,129672.49657064491,1564.434611293098,131236.931181938,2068,0,699.2142857142857,35,7,15,35.58712121212121,0.6190476190476188,45.37037037037038,1018.5185185185201,29.100529100529144,0
2076,4,0,0,40,0.0,0.0,1.0,40,1000,900,100,0.9,11,9,2,400.3635297582011,0.743482905982906,0.150262016624503,0.22289856878087383,129357.17520004336,2357.9790525278872,131715.15425257126,2069,11,735.175,33,7,16,35.49810765771193,0.6202651515151514,45.680147058823536,1017.2794117647068,30.82664884135475,0
2077,4,1,0,41,0.024390243902439025,0.0,1.0,41,950,600,350,0.631578947368421,13,6,7,372.18687360657566,0.7559451219512195,0.1597850664232945,0.20611093803800667,129147.08547921664,1413.3699959821447,130560.45547519877,2070,0,718.219512195122,38,3,16,36.42899061032863,0.6080043859649125,45.88675213675212,1016.4529914529894,26.748762932973406,3
2078,4,1,0,42,0.023809523809523808,0.0,1.0,42,1150,800,350,0.6956521739130435,15,8,7,363.5802053105636,0.7661391792489354,0.1698374073664417,0.20353737685528236,129573.74762854094,1022.124195951536,130595.87182449247,2071,0,702.0952380952381,36,6,16,36.21303874940088,0.6160300925925924,45.467342342342356,1018.1306306306326,28.28140640640646,0
2079,4,0,0,42,0.0,0.0,1.0,42,1600,1200,400,0.75,20,12,8,365.06863678614303,0.7669618660472319,0.17700833649109504,0.2054192180125018,129774.47041636262,1075.3178009090527,130849.78821727166,2072,1,703.0952380952381,36,6,17,35.97088675213677,0.6180555555555554,45.27027027027029,1018.9189189189213,28.30330330330337,0
2080,4,0,0,42,0.0,0.0,1.0,42,800,500,300,0.625,11,5,6,364.83503822643866,0.7669134727061556,0.17922981544672956,0.205501626986456,129815.2376211913,1072.2294359803213,130887.46705717163,2073,2,704.0952380952381,37,5,17,35.93537048992182,0.616554054054054,45.23026315789475,1019.0789473684224,27.542674253200605,0
2081,4,0,0,42,0.0,0.0,1.0,42,700,400,300,0.5714285714285714,10,4,6,365.20818733631125,0.7655826558265583,0.18273765852636026,0.20605862302636002,129881.14458917755,1086.7314769157842,130967.87606609333,2074,3,705.0952380952381,38,4,17,35.858837298675894,0.6154057017543859,45.1655982905983,1019.3376068376077,26.82467386414757,0
2082,4,1,0,43,0.023255813953488372,0.0,1.0,43,1450,1000,450,0.6896551724137931,19,10,9,331.8768720556421,0.7741786637135474,0.10778287131038633,0.18344040042478546,129072.27143441422,-32.2203580084437,129040.05107640577,2075,0,689.6744186046511,40,3,18,37.52937793779377,0.6039062499999999,45.960365853658544,1016.1585365853673,25.403963414634184,8
2083,4,1,1,43,0.022727272727272728,0.022727272727272728,0.9772727272727273,44,950,700,250,0.7368421052631579,12,7,5,324.9199201789643,0.7783210007047217,0.11029812513625448,0.18065547561950446,129304.7293277813,-397.1989845660453,128907.53034321526,2076,0,674.9772727272727,40,4,18,37.470023980815334,0.60625,45.73170731707318,1017.0731707317091,25.426829268292728,0
2084,4,1,1,43,0.022727272727272728,0.022727272727272728,0.9772727272727273,44,900,700,200,0.7777777777777778,11,7,4,323.8538843280194,0.7806333685694151,0.11105763992300144,0.18053591814544162,129408.11107806204,-418.1361127635615,128989.97496529848,2077,0,675.9545454545455,40,4,18,37.392212678119606,0.6072916666666668,45.63008130081301,1017.4796747967482,25.436991869918707,0
2085,4,1,0,44,0.022727272727272728,0.0,1.0,44,900,600,300,0.6666666666666666,12,6,6,331.88915173218726,0.7818886539816773,0.1490745021256541,0.1871004104959026,129847.94439693642,-180.97517598650734,129666.96922094992,2078,0,676.9318181818181,40,4,15,36.741574434140986,0.61171875,45.19817073170732,1019.2073170731712,25.48018292682928,0
2086,4,1,1,44,0.022222222222222223,0.022222222222222223,0.9777777777777777,45,1250,800,450,0.64,17,8,9,335.8813217820819,0.7904040404040404,0.16520175468737475,0.17913054989598579,127644.04432508702,-407.9113649308422,127236.13296015617,2079,0,662.8666666666667,39,6,19,38.8844148369584,0.5910790598290598,47.36979166666668,1010.5208333333351,25.910790598290642,7
2087,4,1,0,45,0.022222222222222223,0.0,1.0,45,1300,800,500,0.6153846153846154,18,8,10,338.8674108997475,0.7896885521885523,0.1867710156866782,0.181909421075039,127907.33642578153,-331.27441406247146,127576.06201171906,2080,0,663.7555555555556,39,6,20,38.539735866543104,0.5937499999999998,47.109375000000014,1011.5625000000022,25.937500000000057,0
2088,4,1,0,46,0.021739130434782608,0.0,1.0,46,1200,1000,200,0.8333333333333334,14,10,4,337.29344718795414,0.7957125603864734,0.2064111373626889,0.18264459936238686,128255.57503270233,-547.3878155418075,127708.18721716052,2081,0,650.304347826087,37,9,21,38.22391210218662,0.6007882882882883,46.76535087719298,1012.9385964912277,27.376718824087234,0
2089,4,1,0,47,0.02127659574468085,0.0,1.0,47,1600,1200,400,0.75,20,12,8,334.571550244762,0.8006475485661424,0.22141640089125758,0.18307454490921252,128672.41753472232,-789.9739583333237,127882.44357638899,2082,0,637.4468085106383,39,8,16,37.86789869952088,0.6014957264957265,46.35416666666667,1014.5833333333342,26.014957264957285,0
2090,4,3,1,49,0.06,0.02,0.98,50,1500,1400,100,0.9333333333333333,16,14,2,337.9307857470881,0.8186224489795918,0.2678731045490823,0.18987770158793768,129718.50419723702,-1230.6546512492657,128487.84954598776,2083,0,600.14,40,10,14,36.718957834530464,0.6104166666666667,45.325203252032516,1018.6991869918693,25.46747967479673,0
2091,4,1,0,50,0.02,0.0,1.0,50,900,400,500,0.4444444444444444,14,4,10,339.5770969940492,0.8191836734693877,0.27241200518496345,0.19143444102042223,129847.94439693603,-1181.322398208772,128666.62199872726,2084,0,601.12,40,10,15,36.54568418253729,0.6117187500000001,45.1981707317073,1019.2073170731682,25.480182926829205,0
2092,4,1,1,50,0.0196078431372549,0.0196078431372549,0.9803921568627451,51,1400,900,500,0.6428571428571429,19,9,10,332.4730648468715,0.8252614379084968,0.2697824641398314,0.18847301850527784,130064.8260039207,-1551.3897339403052,128513.43626998039,2085,0,590.3137254901961,42,9,15,36.506918716950054,0.6108630952380953,44.98546511627905,1020.0581395348809,24.287098560354305,0
2093,4,0,0,50,0.0,0.0,1.0,50,1250,900,350,0.72,16,9,7,339.48157240881017,0.8184523809523809,0.272063430294776,0.19204904143038798,129984.23450688105,-1174.5495362497297,128809.68497063132,2086,2,603.12,41,9,16,36.40989314784186,0.6115345528455286,45.064484126984105,1019.7420634920602,24.87175764614781,0
2094,4,0,1,49,0.0,0.02,0.98,50,850,600,250,0.7058823529411765,11,6,5,337.5130595555845,0.819047619047619,0.27388056798288307,0.19130701644710657,130060.11924445682,-1220.6022455278662,128839.51699892894,2087,3,604.12,41,9,16,36.383161512027485,0.6122967479674798,44.99007936507935,1020.0396825396806,24.87901664730928,0
2095,4,0,0,49,0.0,0.0,1.0,49,950,700,250,0.7368421052631579,12,7,5,348.5784474499251,0.8160076530612245,0.28531169367218845,0.1975540303249518,130055.18297846847,-733.1132469099114,129322.06973155856,2088,4,617.3061224489796,40,9,16,36.105991166019066,0.6138020833333333,44.99491869918699,1020.0203252032518,25.500508130081293,0
2096,4,2,1,50,0.0392156862745098,0.0196078431372549,0.9803921568627451,51,1500,1000,500,0.6666666666666666,20,10,10,345.168211947695,0.8258496732026145,0.30283247168655314,0.19861182321873094,130644.58832137127,-1180.4672274743268,129464.12109389695,2089,0,594.0588235294117,38,13,13,35.595847702650914,0.6230811403508771,44.417735042735046,1022.3290598290606,26.90339631129107,0
2097,4,1,1,50,0.0196078431372549,0.0196078431372549,0.9803921568627451,51,1250,900,350,0.72,16,9,7,340.3060160183211,0.8248039215686276,0.2915014039838797,0.1963057852683829,130741.5418836806,-1301.5733506944334,129439.96853298617,2090,0,595.0392156862745,39,12,13,35.622071705031594,0.6223290598290598,44.32291666666667,1022.7083333333338,26.22329059829061,0
2098,4,1,1,50,0.0196078431372549,0.0196078431372549,0.9803921568627451,51,1450,1100,350,0.7586206896551724,18,11,7,343.6486514321162,0.8233006535947713,0.2911829330413831,0.19916176899852317,130921.69390904513,-1201.7872889896653,129719.90662005547,2091,0,596.0196078431372,41,10,13,35.35446555512472,0.6209349593495934,44.1468253968254,1023.4126984126987,24.96128532713899,0
2099,4,0,0,50,0.0,0.0,1.0,50,1500,1100,400,0.7333333333333333,19,11,8,350.3139672449287,0.8203571428571428,0.28912486341511934,0.2025623611863695,130833.79937743724,-833.4185380725852,130000.38083936466,2092,3,608.94,40,10,13,35.27283864772691,0.6216145833333333,44.23272357723577,1023.0691056910558,25.576727642276396,0
2100,4,0,0,50,0.0,0.0,1.0,50,1250,800,450,0.64,17,8,9,352.0757593483119,0.8206292517006802,0.2864694789081885,0.20468339731299734,131041.82287535533,-772.6701409544538,130269.15273440088,2093,4,609.94,40,10,13,35.01736972704715,0.6236979166666667,44.02947154471545,1023.8821138211385,25.597052845528463,0
2101,4,1,0,51,0.0196078431372549,0.0,1.0,51,1600,1100,500,0.6875,21,11,10,344.9629624119694,0.8244444444444445,0.28591928450654125,0.20178806916310763,131278.46884201662,-1142.7580974701098,130135.71074454651,2094,0,598.9607843137255,42,9,14,34.96044503277862,0.623015873015873,43.7984496124031,1024.806201550387,24.400147655961593,0
2102,4,0,1,50,0.0,0.0196078431372549,0.9803921568627451,51,1150,600,550,0.5217391304347826,17,6,11,348.3376297177606,0.8249346405228759,0.2898134863701578,0.20402632597754564,131328.12500000012,-1050.6662760651247,130277.458723935,2095,1,599.9607843137255,39,12,14,34.82384823848239,0.6282051282051282,43.75000000000001,1025.000000000001,26.282051282051306,0
2103,4,0,0,50,0.0,0.0,1.0,50,1050,700,350,0.6666666666666666,14,7,7,355.63044157820264,0.8200680272108843,0.2921843532145627,0.20774610863233445,131226.4581758628,-666.3753464348881,130560.0828294279,2096,2,612.74,41,9,15,34.739704363542465,0.6239837398373984,43.84920634920634,1024.6031746031733,24.990321331784717,0
2104,4,0,0,50,0.0,0.0,1.0,50,1250,500,750,0.4,20,5,15,361.2106900605311,0.82078231292517,0.29577696717040136,0.21171756695973107,131355.5035635365,-510.47948011660264,130845.0240834199,2097,3,613.74,38,12,16,34.46630189334723,0.6302083333333333,43.7232905982906,1025.1068376068383,26.976495726495745,0
2105,4,0,0,50,0.0,0.0,1.0,50,1600,1200,400,0.75,20,12,8,359.61181742072154,0.8196598639455782,0.29336735756692,0.21168810907764252,131519.83486969478,-540.7826311271691,130979.05223856762,2098,4,614.74,38,12,17,34.341257855084535,0.6318530701754386,43.563034188034194,1025.7478632478642,26.993364822312216,0
2106,4,0,1,49,0.0,0.02,0.98,50,1050,700,350,0.6666666666666666,14,7,7,358.81306226082114,0.8189965986394557,0.2953404122423482,0.21197775375630093,131656.85609796207,-551.9600591715766,131104.8960387905,2099,5,615.74,38,12,12,34.22340204039142,0.6332236842105262,43.42948717948719,1026.2820512820529,27.007422402159285,0
2107,4,0,0,49,0.0,0.0,1.0,49,1500,1400,100,0.9333333333333333,16,14,2,361.2989917852752,0.8193735827664399,0.28778038340496415,0.21412682019476711,131778.07113727313,-277.74315173897924,131500.32798553415,2100,6,595.4285714285714,37,12,13,34.037270397266134,0.6362612612612611,43.31140350877194,1026.7543859649134,27.750118539592254,0
2108,4,0,2,47,0.0,0.04081632653061224,0.9591836734693877,49,1150,900,250,0.782608695652174,14,9,5,347.48592046988233,0.8193735827664399,0.2635794418422577,0.1974837684008814,130163.68762581884,-725.1231834698483,129438.56444234899,2101,7,596.4285714285714,42,7,15,36.023802741113535,0.6118551587301586,44.88856589147287,1020.4457364341091,24.29632705795498,7
2109,4,1,0,48,0.020833333333333332,0.0,1.0,48,1200,600,600,0.5,18,6,12,351.5289275141343,0.81427304964539,0.279932857096576,0.200159443010123,130237.26974875582,-443.56644857018574,129793.70330018563,2102,0,608.7291666666666,41,7,16,35.84602893057309,0.6140752032520326,44.816468253968246,1020.7341269841256,24.89595431668599,0
2110,4,0,0,48,0.0,0.0,1.0,48,1350,900,450,0.6666666666666666,18,9,9,352.7643534634611,0.8153627364066194,0.2827722326385056,0.20129102535262466,130320.0725007103,-405.53247382044856,129914.54002688985,2103,1,609.7291666666666,36,12,16,35.730533803904265,0.6235532407407407,44.73536036036037,1021.0585585585596,28.362737737737767,0
2111,4,0,0,48,0.0,0.0,1.0,48,1150,900,250,0.782608695652174,14,9,5,356.43475665356806,0.8153996749408984,0.2859330798339399,0.20429138010851688,130492.6056757771,-297.5799701728759,130195.02570560422,2104,2,610.7291666666666,36,12,14,35.461901612843974,0.6252893518518519,44.56644144144144,1021.734234234234,28.3815065065065,0
2112,4,1,1,48,0.02040816326530612,0.02040816326530612,0.9795918367346939,49,1050,400,650,0.38095238095238093,17,4,13,348.52922571780823,0.8186295351473923,0.28363146287674623,0.2011807312806752,130766.7743921204,-684.7914742998104,130081.98291782058,2105,0,599.2448979591836,37,12,14,35.38629216695254,0.6261261261261262,44.298245614035075,1022.8070175438576,27.643432906590746,0
2113,4,0,0,48,0.0,0.0,1.0,48,1100,900,200,0.8181818181818182,13,9,4,354.05509797238847,0.8154366134751773,0.2843693041706876,0.20422213350577986,130738.73842191802,-342.2566318482899,130396.48179006974,2106,4,612.7291666666666,37,11,14,35.27337747042637,0.6258445945945947,44.32565789473683,1022.6973684210506,27.64046941678515,0
2114,4,0,1,47,0.0,0.020833333333333332,0.9791666666666666,48,1250,700,550,0.56,18,7,11,353.8846741133252,0.8158244680851063,0.2823528361194463,0.2048667356591529,130878.94833025514,-336.78920437061026,130542.15912588453,2107,5,613.7291666666666,37,11,15,35.13582297471066,0.6272522522522523,44.188596491228054,1023.2456140350852,27.655286865813114,0
2115,4,1,0,48,0.020833333333333332,0.0,1.0,48,1450,1100,350,0.7586206896551724,18,11,7,356.10556366928637,0.8164339539007092,0.29176485289917253,0.20675382726470465,130991.17036011055,-270.66308864268285,130720.50727146787,2108,0,614.1875,37,11,16,34.96545629820052,0.6283783783783785,44.07894736842104,1023.6842105263138,27.667140825035506,0
2116,4,0,0,48,0.0,0.0,1.0,48,1650,1200,450,0.7272727272727273,21,12,9,352.03518551392006,0.8161015070921985,0.28309216861024944,0.20604088159039496,131300.02891514683,-355.55399257465496,130944.47492257218,2109,1,615.1875,37,11,16,34.75747566063978,0.6314752252252254,43.777412280701746,1024.8903508771918,27.69973921289708,0
2117,4,0,0,48,0.0,0.0,1.0,48,1600,1200,400,0.75,20,12,8,351.0726024909014,0.8164154846335697,0.28334536413217837,0.20608160112318988,131412.4312889541,-372.9391495460375,131039.49213940806,2110,2,616.1875,37,11,18,34.668640608847525,0.6326013513513514,43.667763157894726,1025.3289473684197,27.71159317211945,0
2118,4,0,0,48,0.0,0.0,1.0,48,1300,900,400,0.6923076923076923,17,9,8,349.381526967239,0.8161015070921985,0.288869648994897,0.20566597427421568,131519.83486969446,-409.8798533494213,131109.95501634505,2111,3,617.1875,38,10,18,34.603600319411186,0.6318530701754387,43.56303418803418,1025.7478632478617,26.99336482231215,0
2119,4,0,0,48,0.0,0.0,1.0,48,1250,800,450,0.64,17,8,9,347.1574980636161,0.81569518321513,0.28695872801082567,0.2052395128552097,131684.26890432084,-456.9637345679146,131227.30516975292,2112,4,618.1875,38,10,13,34.494812810103745,0.6334978070175439,43.40277777777777,1026.3888888888878,27.010233918128627,0
2120,4,0,0,48,0.0,0.0,1.0,48,1600,1100,500,0.6875,21,11,10,350.55243996984797,0.8153442671394799,0.28978336627483636,0.20814457105806958,131848.80566741532,-356.0158932354567,131492.78977417987,2113,5,619.1875,38,10,14,34.24182530600923,0.6351425438596492,43.24252136752136,1027.0299145299136,27.027103013945094,0
2121,4,0,0,48,0.0,0.0,1.0,48,1100,700,400,0.6363636363636364,15,7,8,347.13340173949,0.8157505910165485,0.2803934739261216,0.20662502965338464,131942.7747938366,-439.6511501736314,131503.12364366298,2114,6,620.1875,39,9,15,34.23495640271723,0.6343482905982907,43.15104166666666,1027.3958333333317,26.343482905982864,0
2122,4,1,2,47,0.02040816326530612,0.04081632653061224,0.9591836734693877,49,1050,800,250,0.7619047619047619,13,8,5,339.96625937675304,0.8217474489795918,0.27774707431895473,0.20353719599846076,132162.7802977725,-813.8227906669293,131348.95750710557,2115,0,608.5102040816327,40,9,16,34.19771694010674,0.6348958333333334,42.9369918699187,1028.2520325203252,25.70630081300813,0
2123,4,0,0,47,0.0,0.0,1.0,47,1350,800,550,0.5925925925925926,19,8,11,353.93922808906984,0.8101680542707369,0.2867251389528094,0.2106113624569611,131931.11257213802,-60.88077105707447,131870.23180108095,2116,8,635.1276595744681,38,9,17,34.07190273155852,0.6359649122807018,43.16239316239315,1027.3504273504257,27.035537561853307,0
2124,4,1,0,48,0.020833333333333332,0.0,1.0,48,900,500,400,0.5555555555555556,13,5,8,343.7577311328315,0.8166555851063829,0.28026371308016884,0.20635912431226186,132264.0313042533,-506.6433376736304,131757.38796657967,2117,0,622.875,39,9,18,33.99841772151898,0.6375534188034189,42.83854166666666,1028.645833333332,26.375534188034152,0
2125,4,0,1,47,0.0,0.020833333333333332,0.9791666666666666,48,1800,1200,600,0.6666666666666666,24,12,12,346.6701634185122,0.8158983451536643,0.29040148448043235,0.20884763503505482,132398.00347222213,-420.1768663194534,131977.82660590266,2118,1,623.875,37,11,18,33.78879892037787,0.642454954954955,42.70833333333333,1029.1666666666658,27.815315315315292,0
2126,4,0,0,47,0.0,0.0,1.0,47,950,600,350,0.631578947368421,13,6,7,354.555953455421,0.8100524205982115,0.2972360310200839,0.21313194954904485,132315.55103550272,-17.346729125600064,132298.20430637713,2119,2,637.4042553191489,38,9,19,33.66887331256489,0.6398026315789475,42.788461538461526,1028.846153846152,27.074898785425052,0
2127,4,0,0,47,0.0,0.0,1.0,47,900,600,300,0.6666666666666666,12,6,6,357.67564125277124,0.8087033610854146,0.30410633642162144,0.21564349347297695,132426.97934420916,73.23231545556322,132500.21165966472,2120,3,638.4042553191489,36,11,19,33.47647702407003,0.6446759259259258,42.68018018018019,1029.27927927928,28.591091091091112,0
2128,4,0,2,45,0.0,0.0425531914893617,0.9574468085106383,47,900,500,400,0.5555555555555556,13,5,8,331.3908863332429,0.8087033610854146,0.22885973584922414,0.19465665404078714,131437.6563755569,-671.6566489359892,130765.99972662091,2121,4,639.4042553191489,38,9,20,35.14773042995067,0.631030701754386,43.643162393162385,1025.4273504273492,26.984930274403926,5
2129,4,1,2,44,0.021739130434782608,0.043478260869565216,0.9565217391304348,46,900,600,300,0.6666666666666666,12,6,6,331.8191154134345,0.8086352657004832,0.23775474635744698,0.19535354466284943,131524.881754482,-471.5060162742524,131053.37573820773,2122,0,648.7173913043479,37,9,20,35.04888205950471,0.6337274774774776,43.55811403508771,1025.767543859648,27.723447131341835,0
2130,4,1,1,44,0.022222222222222223,0.022222222222222223,0.9777777777777777,45,1800,1400,400,0.7777777777777778,22,14,8,335.535956077437,0.813510101010101,0.23198584844059789,0.19812498504282217,131637.38031173046,-166.18514831487144,131471.1951634156,2123,0,647.8888888888889,37,8,17,34.8402384514015,0.6348536036036037,43.4484649122807,1026.2061403508767,27.735301090564235,0
2131,4,0,0,44,0.0,0.0,1.0,44,950,500,450,0.5263157894736842,14,5,9,339.12288037054105,0.8079853770260748,0.22861490869174705,0.1998324346814767,131559.0823086601,122.93898628358664,131682.02129494367,2124,16,663.6136363636364,36,8,17,34.8271130625686,0.6359953703703705,43.52477477477478,1025.9009009009014,28.497247247247262,0
2132,4,0,0,44,0.0,0.0,1.0,44,1050,500,550,0.47619047619047616,16,5,11,338.99663963766545,0.8069282945736435,0.22585470085470116,0.20031619614952936,131665.5124653738,126.83325638656328,131792.34572176036,2125,17,664.6136363636364,37,7,19,34.72311253561253,0.6351351351351353,43.42105263157894,1026.3157894736828,27.738264580369805,0
2133,4,0,0,44,0.0,0.0,1.0,44,1000,700,300,0.7,13,7,6,341.53723139379167,0.8052105355884426,0.23140848899071886,0.20241485030199158,131778.07113727301,201.4235149276742,131979.4946522007,2126,18,665.6136363636364,37,7,19,34.54453225117471,0.6362612612612613,43.31140350877193,1026.7543859649124,27.75011853959223,0
2134,4,0,0,44,0.0,0.0,1.0,44,1600,1200,400,0.75,20,12,8,343.21957560492496,0.8043736786469345,0.22960074496566163,0.20462174698278324,132003.33275623253,261.22556940594677,132264.55832563847,2127,19,666.6136363636364,37,7,20,34.27452340304452,0.6385135135135136,43.09210526315788,1027.631578947367,27.773826458036943,0
2135,4,0,0,44,0.0,0.0,1.0,44,1450,1100,350,0.7586206896551724,18,11,7,343.0241616093372,0.804197498238196,0.22685580204778133,0.20511444765619552,132116.03570329322,263.79847645427935,132379.8341797475,2128,20,667.6136363636364,37,7,21,34.16613339021614,0.6396396396396395,42.98245614035087,1028.0701754385957,27.785680417259343,0
2136,4,0,0,44,0.0,0.0,1.0,44,1150,700,450,0.6086956521739131,16,7,9,341.06722871500466,0.8042195207892883,0.22566839217510992,0.2042483059316292,132172.4052112188,215.93519159740444,132388.34040281622,2129,21,668.6136363636364,37,7,21,34.15973555129025,0.6402027027027027,42.92763157894736,1028.2894736842102,27.791607396870546,0
2137,4,0,0,44,0.0,0.0,1.0,44,1000,700,300,0.7,13,7,6,341.22491058768264,0.8027219873150107,0.22891963109354352,0.20525990775351385,132341.58587257625,231.6491612803955,132573.23503385665,2130,22,669.6136363636364,37,7,21,33.9855960500142,0.6418918918918919,42.76315789473684,1028.9473684210532,27.80938833570414,0
2138,4,0,0,44,0.0,0.0,1.0,44,1100,700,400,0.6363636363636364,15,7,8,341.0161374434795,0.8018410852713178,0.22804444262730716,0.20576645362430832,132457.5684263545,234.05771784241597,132691.62614419693,2131,23,670.6136363636364,35,9,21,33.874428453639155,0.6470238095238096,42.650462962962955,1029.3981481481474,29.41137566137564,0
2139,4,0,0,44,0.0,0.0,1.0,44,950,500,450,0.5263157894736842,14,5,9,340.6607526605898,0.8002774841437632,0.22345376889043322,0.20604070132027627,132546.94097490123,230.70813507371093,132777.64910997494,2132,24,671.6136363636364,35,9,21,33.793811584429214,0.6479166666666667,42.5636574074074,1029.7453703703688,29.42129629629625,0
2140,4,0,0,44,0.0,0.0,1.0,44,1100,800,300,0.7272727272727273,14,8,6,341.2033834111856,0.8008500704721635,0.21794688457609812,0.20686036187735363,132636.34366426614,251.19384430727632,132887.5375085734,2133,25,672.6136363636364,35,9,19,33.69007490636706,0.6488095238095237,42.476851851851855,1030.0925925925928,29.431216931216937,0
2141,4,0,0,44,0.0,0.0,1.0,44,1300,900,400,0.6923076923076923,17,9,8,344.3014799369378,0.7998810782241015,0.21581720166625873,0.20940303124033396,132755.59413580227,341.58950617281744,133097.18364197508,2134,26,673.6136363636364,35,9,19,33.49056603773585,0.6500000000000001,42.3611111111111,1030.5555555555538,29.444444444444397,0
2142,4,0,0,44,0.0,0.0,1.0,44,1100,800,300,0.7272727272727273,14,8,6,345.2621013147227,0.7999031007751939,0.21540781028377864,0.21082522690972313,132904.7325772674,377.39344885970706,133282.1260261271,2135,27,674.6136363636364,35,9,20,33.31614565794887,0.6514880952380953,42.21643518518517,1031.134259259257,29.460978835978775,0
2143,4,0,0,44,0.0,0.0,1.0,44,1200,900,300,0.75,15,9,6,343.44676651590333,0.799154334038055,0.215484532297054,0.21038769965334989,133024.1036120753,337.33965084873273,133361.44326292403,2136,28,675.6136363636364,35,9,20,33.243226186469194,0.6526785714285716,42.10069444444443,1031.59722222222,29.474206349206284,0
2144,4,2,0,46,0.043478260869565216,0.0,1.0,46,1200,500,700,0.4166666666666667,19,5,14,331.91088778856505,0.8054146537842191,0.23901062187507227,0.20752678769285,133783.99032635018,-319.1273997768804,133464.8629265733,2137,0,647.195652173913,37,9,16,32.780758699876344,0.6562500000000002,41.365131578947356,1034.5394736842086,27.960526315789423,0
2145,4,0,0,46,0.0,0.0,1.0,46,900,700,200,0.7777777777777778,11,7,4,334.13724197148474,0.8043679549114332,0.24486180667216462,0.2092404215318446,133840.71451071464,-255.7665579794002,133584.94795273524,2138,1,648.195652173913,37,9,16,32.66652096358307,0.6568130630630632,41.31030701754385,1034.7587719298228,27.96645329540062,0
2146,4,0,0,46,0.0,0.0,1.0,46,950,600,350,0.631578947368421,13,6,7,333.1944843435797,0.8037238325281804,0.24444546794399424,0.209132708258204,133925.8233302553,-275.33087103725927,133650.49245921805,2139,2,649.195652173913,37,9,18,32.60593220338984,0.6576576576576577,41.22807017543859,1035.0877192982443,27.975343764817413,0
2147,4,0,0,46,0.0,0.0,1.0,46,1300,700,600,0.5384615384615384,19,7,12,333.1457558226625,0.8027173913043478,0.242279765549821,0.20958663372640912,134010.9592013888,-270.96354166667663,133739.9956597221,2140,3,650.195652173913,37,9,18,32.52221663313212,0.6585022522522523,41.14583333333333,1035.4166666666658,27.98423423423421,0
2148,4,0,0,46,0.0,0.0,1.0,46,1350,1100,250,0.8148148148148148,16,11,5,333.06628437868716,0.8009259259259259,0.24277548428072437,0.2101855169355683,134124.5157764889,-265.5291772468461,133858.98659924205,2141,4,651.195652173913,37,9,18,32.41097261917364,0.6596283783783784,41.036184210526315,1035.8552631578946,27.99608819345661,0
2149,4,0,0,46,0.0,0.0,1.0,46,1450,1200,250,0.8275862068965517,17,12,5,336.07873588048443,0.8016304347826088,0.24107138750523172,0.21307527097774762,134294.9408111148,-173.2652114112219,134121.67559970357,2142,5,652.195652173913,37,9,19,32.16295973059699,0.6613175675675677,40.87171052631578,1036.5131578947355,28.01386913229015,0
2150,4,0,0,46,0.0,0.0,1.0,46,1500,900,600,0.6,21,9,12,339.7960984626649,0.7999194847020934,0.2400314433605779,0.2162712987388887,134437.04433094806,-63.76336949830056,134373.28096144975,2143,6,653.195652173913,37,9,21,31.924913653344603,0.6627252252252251,40.73464912280702,1037.0614035087724,28.028686581318173,0
2151,4,0,0,46,0.0,0.0,1.0,46,1150,800,350,0.6956521739130435,15,8,7,342.09125659263543,0.798731884057971,0.24436877946568858,0.21841210997837518,134550.78125000012,5.72916666668084,134556.5104166668,2144,7,654.195652173913,37,9,21,31.752008032128508,0.6638513513513513,40.62500000000001,1037.500000000001,28.040540540540565,0
2152,4,0,0,46,0.0,0.0,1.0,46,1200,800,400,0.6666666666666666,16,8,8,343.02982912364854,0.7979468599033817,0.2453270688175484,0.21955378142410836,134640.85708429792,37.16603973766564,134678.0231240356,2145,8,655.195652173913,35,11,21,31.63788056206089,0.66875,40.53819444444445,1037.8472222222229,29.652777777777796,0
2153,4,0,0,46,0.0,0.0,1.0,46,1400,800,600,0.5714285714285714,20,8,12,344.69816122851665,0.7952093397745572,0.25430132527319205,0.22227088327494005,134911.2654320988,100.7330246913599,135011.99845679014,2146,9,656.195652173913,35,11,18,31.32520053475935,0.6714285714285715,40.27777777777778,1038.8888888888891,29.68253968253969,0
2154,4,0,0,46,0.0,0.0,1.0,46,850,600,250,0.7058823529411765,11,6,5,343.7292850769141,0.7936191626409018,0.2531081846845318,0.22183017916142747,134941.32754897542,76.65720914779683,135017.9847581232,2147,10,657.195652173913,35,11,18,31.320434629237663,0.6717261904761905,40.24884259259259,1039.004629629629,29.685846560846546,0
2155,4,0,0,46,0.0,0.0,1.0,46,900,800,100,0.8888888888888888,10,8,2,343.6909377971606,0.7922504025764896,0.2528928968545634,0.22209943795463563,134989.27136596054,78.91785366447539,135068.189219625,2148,11,658.195652173913,36,10,18,31.273705028175115,0.6701388888888888,40.2027027027027,1039.1891891891892,28.866366366366364,0
2156,4,0,0,46,0.0,0.0,1.0,46,1400,1100,300,0.7857142857142857,17,11,6,345.90222529226793,0.7917471819645733,0.25716650692689735,0.22416261093615808,135091.6883680555,145.70312499999636,135237.3914930555,2149,12,659.195652173913,37,9,18,31.11431195724782,0.6692004504504505,40.104166666666664,1039.583333333333,28.096846846846837,0
2157,4,0,0,46,0.0,0.0,1.0,46,1550,1100,450,0.7096774193548387,20,11,9,345.3755844902652,0.7915861513687601,0.2504963114772889,0.224174994368322,135148.68907981302,135.41149680670878,135284.10057661973,2150,13,660.195652173913,37,9,18,31.07128106436077,0.6697635135135136,40.04934210526316,1039.8026315789475,28.10277382645804,0
2158,4,0,0,46,0.0,0.0,1.0,46,1400,900,500,0.6428571428571429,19,9,10,343.8794963506705,0.7915660225442834,0.2404962920184439,0.22373394392197918,135234.212690443,100.8545898737832,135335.06728031678,2151,14,661.195652173913,37,9,19,31.02510717548668,0.6706081081081081,39.96710526315788,1040.1315789473667,28.111664295874778,0
2159,4,0,1,45,0.0,0.021739130434782608,0.9782608695652174,46,900,500,400,0.5555555555555556,13,5,8,347.11840160230787,0.7896537842190017,0.2484364046241183,0.22637845448826793,135319.7633526662,194.39599203600824,135514.1593447022,2152,15,662.195652173913,37,9,19,30.855793550426803,0.6714527027027027,39.88486842105263,1040.4605263157894,28.120554765291605,0
2160,4,0,0,45,0.0,0.0,1.0,45,1100,900,200,0.8181818181818182,13,9,4,353.50785375689753,0.7854797979797981,0.25575936467777094,0.22999831966652456,135234.21269044312,561.2712565404645,135795.4839469836,2153,16,676.9333333333333,37,8,19,30.774738210696462,0.6706081081081081,39.96710526315789,1040.1315789473679,28.111664295874807,0
2161,4,0,0,45,0.0,0.0,1.0,45,1100,600,500,0.5454545454545454,16,6,10,356.3200520676234,0.7856481481481482,0.23840886411341677,0.22340921322841834,133886.53897518056,541.8808313345124,134428.41980651507,2154,17,677.9333333333333,38,7,17,32.046815319500354,0.6554276315789475,41.26602564102563,1034.9358974358956,27.235155195681465,4
2162,4,0,0,45,0.0,0.0,1.0,45,1350,600,750,0.4444444444444444,21,6,15,354.41456998770065,0.7859427609427609,0.24212138489228718,0.2228036945672206,133983.99658203128,497.1761067708335,134481.17268880212,2155,18,678.9333333333333,39,6,17,31.998629137740203,0.6546474358974359,41.171875,1035.3125000000002,26.546474358974365,0
2163,4,0,0,45,0.0,0.0,1.0,45,1300,1100,200,0.8461538461538461,15,11,4,354.468524496904,0.7852272727272728,0.2447953334003823,0.22349274185622792,134091.86333550338,506.26898871526873,134598.13232421866,2156,19,679.9333333333333,39,6,17,31.889373596164813,0.6557158119658121,41.06770833333333,1035.7291666666658,26.557158119658098,0
2164,4,0,0,45,0.0,0.0,1.0,45,1250,1000,250,0.8,15,10,5,353.4194182823335,0.7856060606060606,0.2397819554751297,0.22348779107783645,134199.7734917533,485.7611762152585,134685.53466796855,2157,20,680.9333333333333,39,6,18,31.80869022485841,0.6567841880341881,40.96354166666666,1036.145833333332,26.56784188034184,0
2165,4,0,0,45,0.0,0.0,1.0,45,850,600,250,0.7058823529411765,11,6,5,353.9772611148097,0.7859427609427609,0.2386169464267771,0.2241705773921858,134253.74484592004,504.55457899304656,134758.29942491307,2158,21,681.9333333333333,39,6,18,31.740313096793646,0.6573183760683762,40.91145833333333,1036.3541666666658,26.57318376068374,0
2166,4,0,0,45,0.0,0.0,1.0,45,1400,900,500,0.6428571428571429,19,9,10,356.87908900047375,0.7836279461279462,0.23445136238869901,0.22751613113103214,134496.75021701405,599.8155381944642,135096.56575520852,2159,22,682.9333333333333,39,6,19,31.42239070763875,0.6597222222222222,40.67708333333334,1037.291666666668,26.59722222222226,0
2167,4,0,1,44,0.0,0.022222222222222223,0.9777777777777777,45,750,500,250,0.6666666666666666,10,5,5,358.22002870921415,0.7832491582491583,0.23203926818384613,0.22870971063742154,134550.78125000015,639.7786458333478,135190.5598958335,2160,23,683.9333333333333,37,8,19,31.333668005354752,0.6638513513513513,40.62500000000001,1037.5000000000011,28.040540540540572,0
2168,4,0,0,44,0.0,0.0,1.0,44,1100,700,400,0.6363636363636364,15,7,8,354.1273427083641,0.7821529245947851,0.2233426694806604,0.2270059697556122,134696.86536198377,739.9686003571334,135436.8339623409,2161,24,688.2045454545455,36,8,20,31.294071382078542,0.6672453703703702,40.48423423423424,1038.0630630630644,28.835085085085122,0
2169,4,0,0,44,0.0,0.0,1.0,44,1350,1100,250,0.8148148148148148,16,11,5,347.1230338559051,0.780765503875969,0.21831900677283245,0.22377879874886503,134902.24745008684,565.5354817708379,135467.78293185768,2162,25,689.2045454545455,39,5,16,31.2712030816538,0.6637286324786325,40.286458333333336,1038.854166666667,26.637286324786334,0
2170,4,0,0,44,0.0,0.0,1.0,44,1250,1200,50,0.96,13,12,1,347.7857684424977,0.7800607822410148,0.21504337683166863,0.22470925038745843,134983.42013888893,589.062500000006,135572.48263888893,2163,26,690.2045454545455,39,5,16,31.17314889067095,0.6645299145299146,40.208333333333336,1039.166666666667,26.645299145299152,0
2171,4,0,0,44,0.0,0.0,1.0,44,1200,700,500,0.5833333333333334,17,7,10,349.5166686077565,0.7795983086680761,0.21055747859355067,0.22650495796788384,135091.6883680555,643.3593749999943,135735.0477430555,2164,27,691.2045454545455,39,5,17,31.020374081496314,0.6655982905982907,40.104166666666664,1039.583333333333,26.6559829059829,0
2172,4,0,0,44,0.0,0.0,1.0,44,950,800,150,0.8421052631578947,11,8,3,349.52877110275165,0.7802149400986611,0.2088623158048124,0.2268528083971175,135145.83875868056,647.4717881944499,135793.310546875,2165,28,692.2045454545455,39,5,17,30.966155747011285,0.6661324786324787,40.052083333333336,1039.7916666666667,26.661324786324787,0
2173,4,0,0,44,0.0,0.0,1.0,44,950,700,250,0.7368421052631579,12,7,5,346.756990769078,0.780281007751938,0.20668502754131213,0.22556146923969017,135227.08468967018,578.1873914930618,135805.27208116325,2166,29,693.2045454545455,39,5,17,30.957373560340514,0.6669337606837606,39.973958333333336,1040.104166666667,26.669337606837615,0
2174,4,0,1,43,0.0,0.022727272727272728,0.9772727272727273,44,1450,1100,350,0.7586206896551724,18,11,7,343.8866173630933,0.779796511627907,0.20451815725061628,0.22470707613307184,135389.649793837,511.7377387152969,135901.3875325523,2167,30,694.2045454545455,39,5,17,30.87038751543056,0.6685363247863247,39.81770833333334,1040.729166666668,26.685363247863286,0
2175,4,0,0,43,0.0,0.0,1.0,43,900,700,200,0.7777777777777778,11,7,4,343.20061481466075,0.7759320782576596,0.19453913003013112,0.22493705869328126,135498.08078342033,700.6049262153015,136198.68570963564,2168,31,692.6976744186046,39,4,17,30.780494413873612,0.6696047008547008,39.71354166666668,1041.1458333333348,26.696047008547048,0
2176,4,0,0,43,0.0,0.0,1.0,43,850,500,350,0.5882352941176471,12,5,7,344.8900029616761,0.7747785160575857,0.19512365337508153,0.22638643201627606,135552.31255425382,750.1274956597572,136302.44004991357,2169,32,693.6976744186046,39,4,17,30.682642292687806,0.6701388888888887,39.66145833333335,1041.3541666666695,26.70138888888896,0
2177,4,0,0,43,0.0,0.0,1.0,43,700,400,300,0.5714285714285714,10,4,6,342.3542800703151,0.7744093761535622,0.18842193883513403,0.225408277175263,135661.50427578727,688.8837399811355,136350.3880157684,2170,33,694.6976744186046,38,5,17,30.6402334803268,0.67297149122807,39.55662393162394,1041.7735042735055,27.415092217723828,0
2178,4,0,0,43,0.0,0.0,1.0,43,1150,900,250,0.782608695652174,14,9,5,340.40174350082987,0.7746862310815799,0.1818844932635375,0.2249972499724998,135800.6656804734,645.3566732412958,136446.0223537147,2171,34,695.6976744186046,38,5,19,30.552993029930295,0.6743421052631577,39.42307692307693,1042.3076923076926,27.429149797570858,0
2179,4,0,0,43,0.0,0.0,1.0,43,1100,700,400,0.6363636363636364,15,7,8,338.88167128811546,0.7739940937615356,0.18613228248154146,0.22486906821504393,135939.8984243737,613.507994557689,136553.4064189314,2172,35,696.6976744186046,38,5,17,30.454529932042494,0.6757127192982455,39.28952991452992,1042.8418803418813,27.443207377417927,0
2180,4,0,0,43,0.0,0.0,1.0,43,1050,700,350,0.6666666666666666,14,7,7,348.0758958396175,0.7739940937615356,0.1617548535108686,0.21303513026436446,132991.1141529125,703.0726050822807,133694.18675799476,2173,36,697.6976744186046,37,6,19,33.1569354381489,0.648367117117117,42.13267543859649,1031.4692982456145,27.877548601232824,7
2181,4,0,0,43,0.0,0.0,1.0,43,1400,1100,300,0.7857142857142857,17,11,6,349.2163016484823,0.774593946105574,0.15665669871240384,0.21421938712595967,133075.9524565252,694.4583910434085,133770.41084756862,2174,37,698.6976744186046,37,6,20,33.04241941197309,0.6492117117117115,42.05043859649123,1031.798245614036,27.886439070649622,0
2182,4,0,0,43,0.0,0.0,1.0,43,1200,900,300,0.75,15,9,6,351.58074363562724,0.7744093761535622,0.15529232775483592,0.21665473050216397,133245.71021852875,769.3251769775247,134015.03539550627,2175,38,699.6976744186046,37,6,20,32.81117247238742,0.6509009009009008,41.8859649122807,1032.456140350877,27.90422000948316,0
2183,4,1,0,44,0.022727272727272728,0.0,1.0,44,1150,800,350,0.6956521739130435,15,8,7,344.73349892738497,0.7823951726568006,0.15104342459280407,0.21422562257010283,133557.21381819405,408.52149218990564,133965.73531038396,2176,0,684.7727272727273,37,7,21,32.675979456171994,0.6539977477477477,41.584429824561404,1033.6622807017545,27.936818397344716,0
2184,4,0,0,44,0.0,0.0,1.0,44,700,400,300,0.5714285714285714,10,4,6,344.04536862003744,0.7815362931642001,0.14648124939747342,0.21428981678249376,133642.23246575892,395.79822637736845,134038.0306921363,2177,1,685.7727272727273,37,7,21,32.60869565217391,0.6548423423423422,41.50219298245615,1033.9912280701774,27.94570886676155,0
2185,4,0,0,44,0.0,0.0,1.0,44,850,400,450,0.47058823529411764,13,4,9,343.5821653640214,0.7810738195912614,0.1492346324018472,0.21416545945459936,133670.57802641203,385.36532875501075,134055.94335516702,2178,2,686.7727272727273,37,7,21,32.59231523698442,0.6551238738738738,41.47478070175439,1034.100877192983,27.94867235656711,0
2186,4,0,0,44,0.0,0.0,1.0,44,950,500,450,0.5263157894736842,14,5,9,336.56314620703984,0.779862579281184,0.16647202193561483,0.1980954752361458,131515.04041883672,52.62315538193445,131567.66357421866,2179,3,687.7727272727273,39,5,17,34.93714244609185,0.6300747863247864,43.56770833333333,1025.729166666666,26.300747863247846,8
2187,4,0,0,44,0.0,0.0,1.0,44,650,300,350,0.46153846153846156,10,3,7,335.5570058883662,0.7790477448907682,0.1641496196735841,0.19764147093233408,131541.75347222202,27.951388888868735,131569.7048611109,2180,4,688.7727272727273,39,5,17,34.93602761982129,0.6303418803418804,43.54166666666666,1025.8333333333317,26.30341880341876,0
2188,4,2,0,46,0.043478260869565216,0.0,1.0,46,1300,900,400,0.6923076923076923,17,9,8,329.75858544475176,0.7867954911433173,0.1742676340625171,0.19692384459902415,132066.3868122479,-489.9950199987555,131576.39179224914,2181,0,659.7826086956521,41,5,17,34.55697246083067,0.6323678861788619,43.03075396825396,1027.876984126983,25.07017034456056,0
2189,4,0,0,46,0.0,0.0,1.0,46,900,500,400,0.5555555555555556,13,5,8,330.9978826382622,0.7857487922705314,0.17891524570565664,0.1981971723596525,132168.3784190759,-450.50931831066845,131717.8691007652,2182,1,660.7826086956521,41,5,17,34.4226362759286,0.6333841463414633,42.93154761904761,1028.2738095238087,25.079849012775824,0
2190,4,0,1,45,0.0,0.021739130434782608,0.9782608695652174,46,750,300,450,0.4,12,3,9,329.2353424382069,0.7856481481481482,0.17739012993985348,0.19727477223782947,132193.88247197014,-495.4203672209769,131698.46210474917,2183,2,661.7826086956521,41,5,17,34.44232748086694,0.6336382113821138,42.906746031746025,1028.3730158730148,25.082268679829628,0
2191,4,0,0,45,0.0,0.0,1.0,45,850,500,350,0.5882352941176471,12,5,7,332.347845906497,0.784469696969697,0.16949219521833703,0.19952698079866904,132267.29811124314,-208.2496777711806,132059.04843347197,2184,3,662.0888888888888,40,5,18,34.28855463347165,0.6359375,42.83536585365853,1028.6585365853646,25.716463414634113,0
2192,4,0,0,45,0.0,0.0,1.0,45,1300,900,400,0.6923076923076923,17,9,8,331.7210425240053,0.7843013468013469,0.16614979423868337,0.19956479830989632,132345.71358194528,-219.62838340273794,132126.08519854254,2185,4,663.0888888888888,40,5,18,34.22592592592593,0.63671875,42.75914634146341,1028.9634146341464,25.72408536585366,0
2193,4,1,1,45,0.021739130434782608,0.021739130434782608,0.9782608695652174,46,1050,800,250,0.7619047619047619,13,8,5,323.2501743963084,0.7868357487922706,0.1697547941033919,0.19609736791474458,132659.60784131486,-623.541398142626,132036.06644317223,2186,0,649.6521739130435,40,6,13,34.1290980237414,0.6398437499999999,42.45426829268293,1030.1829268292695,25.75457317073174,0
2194,4,0,0,45,0.0,0.0,1.0,45,1200,1000,200,0.8333333333333334,14,10,4,328.6596500762056,0.7818181818181819,0.1728564847585976,0.19927132309034948,132639.32427300367,-281.3612196180361,132357.96305338564,2187,6,665.0888888888888,39,6,13,34.010116459365626,0.641292735042735,42.47395833333334,1030.1041666666683,26.412927350427392,0
2195,4,1,2,44,0.021739130434782608,0.043478260869565216,0.9565217391304348,46,1100,700,400,0.6363636363636364,15,7,8,323.99679681622916,0.7875805152979066,0.18101949025487274,0.19834544557808992,133000.07952442346,-581.6800515565958,132418.39947286688,2188,0,651.6086956521739,40,6,14,33.76888341543513,0.6432291666666666,42.123983739837406,1031.5040650406518,25.787601626016293,0
2196,4,0,1,43,0.0,0.022727272727272728,0.9772727272727273,44,1150,800,350,0.6956521739130435,15,8,7,326.0682105428373,0.7811398872445384,0.16957311781297424,0.1871542194759575,130548.03688280808,-286.48704474847494,130261.54983805961,2189,1,672.7727272727273,40,4,12,36.18154998674092,0.6187499999999999,44.51219512195123,1021.951219512197,25.548780487804926,8
2197,4,0,0,43,0.0,0.0,1.0,43,950,400,550,0.42105263157894735,15,4,11,328.4429708191957,0.7784237726098191,0.1872031399615095,0.18868164108184696,130581.79253472213,-22.26562500000506,130559.52690972213,2190,2,689.2325581395348,39,4,12,36.08676450604702,0.6207264957264957,44.479166666666664,1022.0833333333326,26.207264957264936,0
2198,4,0,0,43,0.0,0.0,1.0,43,800,600,200,0.75,10,6,4,329.59989038163775,0.77750092284976,0.18488549799192056,0.18973741490297774,130661.65500216995,13.21343315970313,130674.86843532966,2191,3,690.2325581395348,39,4,12,35.976502801833924,0.6215277777777779,44.40104166666666,1022.3958333333318,26.21527777777774,0
2199,4,0,0,43,0.0,0.0,1.0,43,1150,700,450,0.6086956521739131,16,7,9,331.6797619658462,0.7757475083056478,0.18726364719170863,0.19172612962134022,130821.45317925327,78.16569010414685,130899.61886935741,2192,4,691.2325581395348,39,4,14,35.76190900451414,0.623130341880342,44.24479166666666,1023.0208333333317,26.231303418803375,0
2200,4,0,0,43,0.0,0.0,1.0,43,1000,600,400,0.6,14,6,8,333.9292724591246,0.7761627906976744,0.18532686917657792,0.19342695593386994,130901.38888888869,142.36111111109074,131043.74999999978,2193,5,692.2325581395348,39,4,14,35.623642779587406,0.623931623931624,44.16666666666666,1023.3333333333317,26.239316239316196,0
2201,4,0,0,43,0.0,0.0,1.0,43,600,300,300,0.5,9,3,6,333.44862457132,0.7769933554817275,0.18755635281060035,0.19354988976150964,130981.3490125866,135.11013454858926,131116.45914713517,2194,6,693.2325581395348,39,4,15,35.55520928733761,0.6247329059829061,44.08854166666666,1023.6458333333317,26.247329059829017,0
2202,4,0,0,43,0.0,0.0,1.0,43,1250,800,450,0.64,17,8,9,357.1033057851238,0.7774086378737541,0.19198731501057043,0.20041512059369201,129672.4965706448,739.3010813185939,130411.7976519634,2195,7,694.2325581395348,35,8,17,36.27746212121211,0.619047619047619,45.370370370370374,1018.5185185185192,29.10052910052912,4
2203,4,0,0,43,0.0,0.0,1.0,43,900,600,300,0.6666666666666666,12,6,6,359.42470481357844,0.7772702104097453,0.19829392199805063,0.20217352565328628,129760.92470689729,727.8564118227072,130488.78111872,2196,8,695.2325581395348,35,8,17,36.12842686205461,0.6199404761904761,45.28356481481482,1018.8657407407408,29.110449735449738,0
2204,4,0,0,43,0.0,0.0,1.0,43,1250,700,550,0.56,18,7,11,357.29745882966336,0.7762550756736802,0.19821478605451648,0.2015435180388683,129871.11418898121,680.5238150200031,130551.63800400122,2197,9,696.2325581395348,37,6,19,36.0706217728055,0.617117117117117,45.175438596491226,1019.2982456140351,27.54860123281176,0
2205,4,1,1,43,0.022727272727272728,0.022727272727272728,0.9772727272727273,44,1250,800,450,0.64,17,8,9,353.9841165627133,0.783187984496124,0.19780721790772082,0.20126525484565674,130180.80210387883,416.38724523337794,130597.1893491122,2198,0,681.3863636363636,38,6,20,35.84066164154103,0.618421052631579,44.87179487179486,1020.512820512819,26.855600539811025,0
2206,4,0,0,43,0.0,0.0,1.0,43,850,600,250,0.7058823529411765,11,6,5,346.1427478138683,0.7759320782576596,0.1949873971560372,0.1945560961850363,129731.4453125,381.1454737836952,130112.59078628369,2199,11,698.2325581395348,37,6,17,36.49667689161553,0.6157094594594594,45.3125,1018.75,27.533783783783782,3
2207,4,1,1,43,0.022727272727272728,0.022727272727272728,0.9772727272727273,44,1400,900,500,0.6428571428571429,19,9,10,337.3193256694931,0.7829016913319239,0.18564653448374435,0.1909875612598446,130017.30974687697,-28.529750164375002,129988.77999671259,2200,0,683.3409090909091,38,6,17,36.431489629164055,0.6167763157894737,45.03205128205128,1019.8717948717941,26.838731443994583,0
2208,4,0,0,43,0.0,0.0,1.0,43,1100,600,500,0.5454545454545454,16,6,10,344.523552749646,0.775562938353636,0.18891877353415776,0.19419929792649857,129843.17440222,346.8063490689537,130189.98075128895,2201,13,700.2325581395348,37,6,17,36.4244889725659,0.6168355855855856,45.202850877192986,1019.1885964912287,27.545637743006182,0
2209,4,1,2,42,0.022727272727272728,0.045454545454545456,0.9545454545454546,44,1100,700,400,0.6363636363636364,15,7,8,334.90485458183736,0.782351127554616,0.18693479295573545,0.1901510916323749,130126.29323727077,-84.01453721966323,130042.27870005112,2202,0,685.2954545454545,38,6,17,36.38263525305411,0.6178728070175439,44.925213675213676,1020.2991452991452,26.84997750787224,0
2210,4,1,1,42,0.023255813953488372,0.023255813953488372,0.9767441860465116,43,700,500,200,0.7142857142857143,9,5,4,343.8525530074913,0.7855297157622738,0.18486647032646153,0.19479393715442658,130038.81602993232,342.83577639274404,130381.65180632507,2203,0,694.1860465116279,37,6,17,36.24310184189781,0.6188063063063062,45.010964912280706,1019.9561403508775,27.566382171645337,0
2211,4,1,0,43,0.023255813953488372,0.0,1.0,43,800,600,200,0.75,10,6,4,343.6901291128696,0.7840070136581764,0.1919316563834832,0.1958234456573328,130262.58680555563,353.99305555556447,130616.5798611112,2204,0,695.1627906976744,37,6,19,36.0204081632653,0.6210585585585584,44.79166666666667,1020.833333333334,27.590090090090108,0
2212,4,2,1,44,0.044444444444444446,0.022222222222222223,0.9777777777777777,45,900,600,300,0.6666666666666666,12,6,6,330.01482553880066,0.8037457912457913,0.1861252574636152,0.1903693041797854,130741.54188368066,-370.67057291665753,130370.871310764,2205,0,665.2222222222222,39,6,16,35.88519386161472,0.6223290598290598,44.32291666666667,1022.7083333333343,26.22329059829062,0
2213,4,1,0,45,0.022222222222222223,0.0,1.0,45,1000,800,200,0.8,12,8,4,329.6188818979509,0.8001262626262626,0.19402823018458215,0.19093018253334168,130901.38888888912,-370.48611111108585,130530.90277777804,2206,0,666.2,39,6,17,35.73391693811074,0.6239316239316238,44.16666666666668,1023.3333333333352,26.239316239316288,0
2214,4,0,0,45,0.0,0.0,1.0,45,1300,1000,300,0.7692307692307693,16,10,6,328.78003875426356,0.7996212121212122,0.19460779326482847,0.1911046127093826,131034.66932508699,-383.68326822914673,130650.98605685784,2207,1,667.2,39,6,18,35.620888018448824,0.6252670940170939,44.03645833333334,1023.8541666666681,26.252670940170976,0
2215,4,1,1,45,0.021739130434782608,0.021739130434782608,0.9782608695652174,46,1000,500,500,0.5,15,5,10,326.31871600930543,0.8042673107890499,0.2061469265367315,0.19191191619847994,131484.42147531253,-618.8344817899175,130865.58699352261,2208,0,653.6739130434783,40,6,19,35.230669507200425,0.6281249999999998,43.59756097560977,1025.6097560975627,25.640243902439067,0
2216,4,0,0,45,0.0,0.0,1.0,45,1000,500,500,0.5,15,5,10,328.43517603431746,0.8046717171717173,0.2026589188237362,0.19368466923145297,131588.67076475665,-356.33035065104553,131232.3404141056,2209,1,653.6444444444444,40,5,14,35.07143918383518,0.6291666666666667,43.495934959349604,1026.0162601626034,25.650406504065085,0
2217,4,1,0,46,0.021739130434782608,0.0,1.0,46,850,600,250,0.7058823529411765,11,6,5,320.357656476332,0.8123389694041868,0.1805458069016055,0.18882121835041274,131568.4692382815,-765.2441751587088,130803.22506312281,2210,0,640.4130434782609,39,7,14,35.29895167022034,0.6306089743589742,43.515625000000014,1025.937500000002,26.306089743589798,3
2218,4,0,0,46,0.0,0.0,1.0,46,1250,700,550,0.56,18,7,11,321.5058992275248,0.8120169082125605,0.18394088756900318,0.19002985153502144,131675.35942925367,-733.1190321180374,130942.24039713564,2211,1,641.4130434782609,39,7,14,35.16198535133123,0.6316773504273503,43.41145833333334,1026.3541666666683,26.31677350427355,0
2219,4,1,1,46,0.02127659574468085,0.02127659574468085,0.9787234042553191,47,850,500,350,0.5882352941176471,12,5,7,313.5732427730641,0.817491520197348,0.1771632328301147,0.18644696105589062,131901.6665014215,-1127.8333415955747,130773.83315982594,2212,0,628.7446808510638,40,7,14,35.13821560480147,0.6322916666666665,43.191056910569124,1027.2357723577268,25.68089430894317,0
2220,4,0,0,46,0.0,0.0,1.0,46,1450,1100,350,0.7586206896551724,18,11,7,318.98277758107474,0.8120772946859903,0.1785641857635365,0.18973511173127655,131916.02105034742,-784.2122395833147,131131.8088107641,2213,3,643.4130434782609,39,7,16,34.98487460285269,0.6340811965811965,43.17708333333334,1027.2916666666683,26.34081196581201,0
2221,4,0,0,46,0.0,0.0,1.0,46,800,600,200,0.75,10,6,4,317.34716339846216,0.8111714975845411,0.1791639788414392,0.18895051954996797,131953.86860499723,-824.9628197501316,131128.9057852471,2214,4,644.4130434782609,40,6,16,34.98887240356082,0.6328125,43.14024390243903,1027.4390243902455,25.685975609756138,0
2222,4,0,0,46,0.0,0.0,1.0,46,850,500,350,0.5882352941176471,12,5,7,317.88549824075915,0.8105676328502416,0.17818607010514875,0.1897930300594475,132058.30379569056,-804.1160602154649,131254.1877354751,2215,5,645.4130434782609,40,6,17,34.870188187990244,0.6338541666666666,43.03861788617887,1027.8455284552858,25.696138211382145,0
2223,4,0,0,46,0.0,0.0,1.0,46,1100,600,500,0.5454545454545454,16,6,10,315.89194125001825,0.8108695652173913,0.1808154533442392,0.18915193362544414,132168.37841907592,-849.814873866223,131318.5635452097,2216,6,646.4130434782609,41,5,17,34.81096237337189,0.6333841463414633,42.93154761904761,1028.273809523809,25.079849012775828,0
2224,4,0,0,46,0.0,0.0,1.0,46,1000,500,500,0.5,15,5,10,318.52161320432566,0.8095209339774557,0.18109934669970684,0.19113097366669984,132248.4575464967,-775.2015917012096,131473.2559547955,2217,7,647.4130434782609,42,4,17,34.66301617208352,0.6326884920634919,42.85368217054264,1028.5852713178303,24.490125507567388,0
2225,4,0,0,46,0.0,0.0,1.0,46,1000,700,300,0.7,13,7,6,321.26870508362913,0.809158615136876,0.18873703142505138,0.19381362202454344,132450.30369034663,-689.4034788179405,131760.9002115287,2218,8,648.4130434782609,40,6,20,34.38991180439004,0.6377604166666666,42.657520325203265,1029.3699186991892,25.734247967479728,0
2226,4,0,0,46,0.0,0.0,1.0,46,1200,900,300,0.75,15,9,6,320.52484157488163,0.8073470209339775,0.19074783638477766,0.19390317729422565,132554.93511013634,-702.5700847709554,131852.36502536538,2219,9,649.4130434782609,40,6,20,34.30417118984177,0.6388020833333332,42.555894308943095,1029.776422764229,25.744410569105725,0
2227,4,0,0,46,0.0,0.0,1.0,46,900,500,400,0.5555555555555556,13,5,8,322.27484038477684,0.8060185185185186,0.19114909895614374,0.1956420557976571,132685.78247901401,-647.7421260492927,132038.04035296472,2220,10,650.4130434782609,40,6,14,34.12799204313801,0.6401041666666667,42.428861788617894,1030.28455284553,25.75711382113825,0
2228,4,0,0,46,0.0,0.0,1.0,46,1450,1300,150,0.896551724137931,16,13,3,323.1635390704795,0.8054750402576489,0.18223533900012345,0.19686773434185437,132816.69439693645,-615.6973982087335,132200.99699872773,2221,11,651.4130434782609,40,6,14,33.973963981727934,0.64140625,42.301829268292686,1030.7926829268301,25.769817073170753,0
2229,4,0,0,46,0.0,0.0,1.0,46,1600,1100,500,0.6875,21,11,10,322.6834597684765,0.8044283413848632,0.18286495427626237,0.1969883503496367,132895.2725312314,-623.378734549537,132271.89379668186,2222,12,652.4130434782609,40,6,16,33.907656547736394,0.6421875,42.22560975609756,1031.0975609756097,25.77743902439024,0
2230,4,0,0,46,0.0,0.0,1.0,46,950,700,250,0.7368421052631579,12,7,5,321.8040942639662,0.8033615136876007,0.18577756643404553,0.19686496399547893,132973.87390318277,-641.6925895630777,132332.1813136197,2223,13,653.4130434782609,40,6,16,33.851652051105205,0.6429687499999999,42.149390243902445,1031.4024390243912,25.78506097560978,0
2231,4,0,0,46,0.0,0.0,1.0,46,1450,1100,350,0.7586206896551724,18,11,7,327.9787614961694,0.8027576489533012,0.18633142808211844,0.20148967471225637,133131.14636005345,-467.1623000528874,132663.98406000057,2224,14,654.4130434782609,40,6,16,33.53499917938619,0.64453125,41.99695121951219,1032.0121951219505,25.800304878048763,0
2232,4,0,0,46,0.0,0.0,1.0,46,1700,1500,200,0.8823529411764706,19,15,4,329.7951283402567,0.8027173913043478,0.1967348510783975,0.20332029756899306,133262.2777447285,-410.15000165247693,132852.127743076,2225,15,655.4130434782609,40,6,16,33.35691437007873,0.6458333333333335,41.86991869918698,1032.5203252032506,25.813008130081265,0
2233,4,0,0,46,0.0,0.0,1.0,46,1200,900,300,0.75,15,9,6,331.7393218114928,0.8029790660225443,0.19307104372885675,0.2048283712964197,133318.49666950092,-354.6024659864114,132963.8942035145,2226,16,656.4130434782609,41,5,17,33.25048030739673,0.6448170731707317,41.81547619047618,1032.7380952380936,25.188734030197406,0
2234,4,0,0,46,0.0,0.0,1.0,46,850,500,350,0.5882352941176471,12,5,7,330.71019771071826,0.8019726247987118,0.19232117812061778,0.20504032258064517,133472.2222222221,-371.60926870748904,133100.61295351462,2227,17,657.4130434782609,38,8,18,33.12331989247313,0.6513157894736842,41.666666666666664,1033.3333333333326,27.19298245614033,0
2235,4,0,0,46,0.0,0.0,1.0,46,1550,1200,350,0.7741935483870968,19,12,7,327.5154190643957,0.8013486312399356,0.1952665962695368,0.2035025362164054,133552.96359591995,-451.86903211807567,133101.0945638019,2228,18,658.4130434782609,39,7,18,33.12516795995835,0.6503739316239316,41.58854166666666,1033.6458333333317,26.503739316239272,0
2236,4,0,0,46,0.0,0.0,1.0,46,1200,800,400,0.6666666666666666,16,8,8,325.820525024333,0.8009460547504026,0.19333987317380763,0.20318757364582785,133687.58680555562,-488.3680555555507,133199.21875000006,2229,19,659.4130434782609,39,7,18,33.03451517593337,0.6517094017094017,41.458333333333336,1034.1666666666672,26.51709401709403,0
2237,4,0,0,46,0.0,0.0,1.0,46,1250,900,350,0.72,16,9,7,326.9124934775967,0.7996779388083736,0.20234113712374513,0.2044644134269202,133795.33420138902,-452.1267361111009,133343.20746527793,2230,20,660.4130434782609,39,7,14,32.898711236407564,0.6527777777777778,41.35416666666667,1034.5833333333344,26.527777777777803,0
2238,4,0,0,46,0.0,0.0,1.0,46,1150,1000,150,0.8695652173913043,13,10,3,323.8439037499484,0.7999597423510467,0.19611752450561837,0.20308043816437651,133892.60691387395,-527.9390987507481,133364.66781512322,2231,21,661.4130434782609,40,6,14,32.88103070175439,0.6520833333333333,41.260162601626014,1034.9593495934955,25.87398373983739,0
2239,4,0,0,46,0.0,0.0,1.0,46,1400,1000,400,0.7142857142857143,18,10,8,323.08583226520386,0.7996376811594204,0.1927411024509338,0.2028947156259782,133945.20147564288,-544.8406206623008,133400.3608549806,2232,22,662.4130434782609,40,6,14,32.84819032659205,0.6526041666666667,41.209349593495936,1035.1626016260168,25.87906504065042,0
2240,4,0,0,46,0.0,0.0,1.0,46,1100,600,500,0.5454545454545454,16,6,10,321.7229580670846,0.7997181964573269,0.18956598563386406,0.20218332966251634,133971.50262946982,-579.6583754709566,133391.84425399886,2233,23,663.4130434782609,40,6,14,32.85723634697817,0.6528645833333333,41.18394308943089,1035.264227642276,25.881605691056897,0
2241,4,0,1,45,0.0,0.021739130434782608,0.9782608695652174,46,950,700,250,0.7368421052631579,12,7,5,301.4768498269897,0.8001006441223832,0.08403273657288968,0.1821029863224425,132497.74770333807,-1210.9992826452822,131286.74842069278,2234,24,664.4130434782609,42,4,18,34.851764705882346,0.6351686507936508,42.61143410852713,1029.554263565891,24.513196751568834,8
2242,4,0,0,45,0.0,0.0,1.0,45,700,500,200,0.7142857142857143,9,5,4,307.72654950015,0.7950336700336701,0.10008030580450389,0.18576372333700117,132474.58944515273,-846.8103387188535,131627.77910643388,2235,25,679.1555555555556,41,4,20,34.71409125951624,0.6364329268292683,42.633928571428555,1029.464285714283,25.10888501742154,0
2243,4,0,0,45,0.0,0.0,1.0,45,1450,1000,450,0.6896551724137931,19,10,9,309.67548747510136,0.7933922558922559,0.1085516178736523,0.18783120688910315,132653.3761652806,-784.100214159763,131869.27595112086,2236,26,680.1555555555556,41,4,13,34.48494478685157,0.6382113821138213,42.46031746031745,1030.1587301587278,25.12582268679824,0
2244,4,0,1,44,0.0,0.022222222222222223,0.9777777777777777,45,750,600,150,0.8,9,6,3,311.7909168940758,0.79246632996633,0.10373222938930104,0.18950100958330954,132730.03595245935,-723.1960781998326,132006.83987425952,2237,27,681.1555555555556,41,4,14,34.353739449953466,0.6389735772357725,42.38591269841268,1030.4563492063464,25.13308168795967,0
2245,4,0,0,44,0.0,0.0,1.0,44,1150,700,450,0.6086956521739131,16,7,9,316.70401363164234,0.794661733615222,0.1019723865877713,0.19252869893434357,132738.13950029726,-392.25969165181493,132345.87980864543,2238,28,680.1136363636364,40,4,14,34.21905818540433,0.6406250000000002,42.378048780487795,1030.4878048780474,25.762195121951187,0
2246,4,0,0,44,0.0,0.0,1.0,44,1150,700,450,0.6086956521739131,16,7,9,319.56888135276336,0.7949039816772375,0.09895987380459426,0.1946779077213859,132816.69439693625,-311.1835093198597,132505.5108876164,2239,29,681.1136363636364,40,4,15,34.066597653554176,0.6414062500000001,42.30182926829268,1030.7926829268285,25.769817073170714,0
2247,4,0,0,44,0.0,0.0,1.0,44,1200,700,500,0.5833333333333334,17,7,10,316.47913456455746,0.793208245243129,0.09008489631375793,0.1935979257646638,132972.04570037857,-383.42441109308163,132588.62128928548,2240,30,682.1136363636364,42,2,15,33.99078510584994,0.6398809523809523,42.151162790697676,1031.3953488372092,24.557032115171648,0
2248,4,0,0,44,0.0,0.0,1.0,44,1050,800,250,0.7619047619047619,13,8,5,314.1863711471619,0.7920850951374208,0.09164980318826466,0.19258159433528105,133047.01232084903,-439.68840138814545,132607.32391946088,2241,31,683.1136363636364,42,2,16,33.97494599417676,0.640625,42.07848837209302,1031.6860465116274,24.563953488372082,0
2249,4,0,0,44,0.0,0.0,1.0,44,1300,1000,300,0.7692307692307693,16,10,6,313.91623807977123,0.7924815010570825,0.16627769133881598,0.18083343855581205,130688.28125000013,-592.9301123730397,130095.35113762709,2242,32,684.1136363636364,39,5,17,36.35051616408587,0.6217948717948718,44.37500000000001,1022.500000000001,26.217948717948744,5
2250,4,0,0,44,0.0,0.0,1.0,44,1350,1100,250,0.8148148148148148,16,11,5,315.0760006491749,0.7923273431994362,0.1720355932517268,0.1817518316318214,130741.54188368063,-561.2955729166573,130180.24631076398,2243,33,685.1136363636364,39,5,17,36.26714537923542,0.6223290598290598,44.32291666666667,1022.708333333334,26.223290598290617,0
2251,4,1,1,44,0.022222222222222223,0.022222222222222223,0.9777777777777777,45,1100,900,200,0.8181818181818182,13,9,4,306.6995548276266,0.7968434343434344,0.17169451337193298,0.17830340535997335,131041.8228753553,-961.9062520655671,130079.91662328973,2244,0,670.8666666666667,40,5,17,36.17886683209265,0.6236979166666667,44.02947154471545,1023.8821138211383,25.59705284552846,0
2252,4,0,0,44,0.0,0.0,1.0,44,1100,700,400,0.6363636363636364,15,7,8,312.0684317265513,0.7916005990133897,0.1708199208199206,0.1812652805560607,131008.0078125,-623.3072916666667,130384.70052083333,2245,35,687.1136363636364,39,5,17,36.075498575498564,0.625,44.0625,1023.75,26.25,0
2253,4,0,0,44,0.0,0.0,1.0,44,1050,700,350,0.6666666666666666,14,7,7,311.8478146630031,0.791688689217759,0.16273318912123047,0.1818927289084208,131168.01757812515,-619.1080729166518,130548.90950520849,2246,36,688.1136363636364,39,5,18,35.92002237136464,0.6266025641025641,43.90625000000001,1024.3750000000011,26.26602564102567,0
2254,4,1,0,45,0.022222222222222223,0.0,1.0,45,1000,700,300,0.7,13,7,6,304.9736302898068,0.7966329966329967,0.16231159269292195,0.1791393453807569,131437.65637555716,-982.8008431724252,130454.85553238472,2247,0,673.8,38,7,20,35.824954851705215,0.6310307017543859,43.6431623931624,1025.4273504273515,26.984930274403986,0
2255,4,0,0,45,0.0,0.0,1.0,45,900,700,200,0.7777777777777778,11,7,4,303.8922089596812,0.7965909090909091,0.16235809240074905,0.17874090139886642,131488.33007812515,-1008.344184027764,130479.98589409738,2248,1,674.8,39,6,20,35.801763829643164,0.6298076923076923,43.59375000000001,1025.6250000000011,26.29807692307695,0
2256,4,0,0,45,0.0,0.0,1.0,45,900,600,300,0.6666666666666666,12,6,6,303.50691849828655,0.796969696969697,0.15503666102650882,0.17901455971306135,131595.18771701402,-1011.9900173610911,130583.19769965293,2249,2,675.8,39,6,13,35.70431472081219,0.6308760683760684,43.48958333333334,1026.0416666666679,26.308760683760713,0
2257,4,0,0,45,0.0,0.0,1.0,45,700,500,200,0.7142857142857143,9,5,4,305.0249198074167,0.7960858585858587,0.15726287537918515,0.1802885743768735,131675.3594292536,-967.1468098958157,130708.2126193578,2250,3,676.8,39,6,13,35.58486839879563,0.6316773504273504,43.41145833333334,1026.3541666666679,26.316773504273534,0
2258,4,0,1,44,0.0,0.022222222222222223,0.9777777777777777,45,1250,1000,250,0.8,15,10,5,298.0765803314864,0.7956649831649832,0.13175684197250614,0.17391090547817148,131179.18469442904,-1179.7114431224472,129999.4732513066,2251,4,677.8,42,3,17,36.26146897465001,0.6220238095238098,43.89534883720928,1024.4186046511597,24.390919158360948,4
2259,4,1,2,43,0.022222222222222223,0.044444444444444446,0.9555555555555556,45,1100,800,300,0.7272727272727273,14,8,6,298.91914391244177,0.7966750841750843,0.13750590361198434,0.1748596202929966,131279.59728678796,-1151.6030331726652,130127.9942536153,2252,0,677.7777777777778,43,2,17,36.13896075894782,0.6216085271317832,43.79734848484847,1024.8106060606033,23.83280479210705,0
2260,4,0,0,43,0.0,0.0,1.0,43,1300,800,500,0.6153846153846154,18,8,10,308.73427176098835,0.7837301587301587,0.1364446196294835,0.17999330073022027,131150.2338927467,-501.88560956792344,130648.34828317878,2253,6,709.1860465116279,41,2,17,36.01765536723163,0.6232215447154472,43.9236111111111,1024.3055555555538,24.983062330623266,0
2261,4,1,0,44,0.022727272727272728,0.0,1.0,44,1300,800,500,0.6153846153846154,18,8,10,305.3959360797421,0.7936707188160677,0.14096765474367068,0.1793623396417113,131432.31232236116,-771.9800628942796,130660.33225946689,2254,0,694.0454545454545,40,4,18,35.81949950445987,0.6276041666666666,43.648373983739845,1025.4065040650416,25.635162601626043,0
2262,4,0,0,44,0.0,0.0,1.0,44,700,400,300,0.5714285714285714,10,4,6,303.9661774131954,0.7930320648343905,0.14335248662571787,0.17901018639491245,131536.5409561111,-803.4680910833204,130733.07286502777,2255,1,695.0454545454545,40,4,19,35.75143649692888,0.6286458333333332,43.54674796747969,1025.8130081300837,25.645325203252092,0
2263,4,0,0,44,0.0,0.0,1.0,44,1700,1400,300,0.8235294117647058,20,14,6,302.80857604420316,0.7928999295278365,0.13327314900234577,0.17914009927555014,131709.72620819174,-823.4330711451125,130886.29313704662,2256,2,696.0454545454545,41,3,13,35.607241229341845,0.628810975609756,43.3779761904762,1026.4880952380963,25.036295005807226,0
2264,4,0,1,43,0.0,0.022727272727272728,0.9772727272727273,44,850,500,350,0.5882352941176471,12,5,7,304.5175383322829,0.7918648696264976,0.14069828722002575,0.18051297375367295,131786.11288265313,-773.7634637188168,131012.34941893432,2257,3,697.0454545454545,41,3,13,35.4867149758454,0.6295731707317073,43.30357142857143,1026.785714285715,25.043554006968655,0
2265,4,0,0,43,0.0,0.0,1.0,43,1250,800,450,0.64,17,8,9,308.79514264945107,0.788344407530454,0.14082764014445726,0.1838585920015287,131953.86860499732,-450.6572641945626,131503.21134080275,2258,4,699.5116279069767,40,3,14,35.20853939993406,0.6328124999999998,43.14024390243904,1027.4390243902462,25.685975609756156,0
2266,4,1,1,43,0.022727272727272728,0.022727272727272728,0.9772727272727273,44,1100,600,500,0.5454545454545454,16,6,10,307.309081361454,0.7911161028893587,0.1575652356902355,0.18438544881687258,132244.89795918387,-671.9883786847838,131572.90958049908,2259,0,684.5909090909091,41,3,15,34.954909336419746,0.6341463414634145,42.85714285714287,1028.5714285714303,25.087108013937325,0
2267,4,0,0,43,0.0,0.0,1.0,43,1350,900,450,0.6666666666666666,18,9,9,314.01345904482145,0.7852067183462532,0.16352146336979456,0.18825925388232218,132215.03404058458,-296.53996463742834,131918.49407594715,2260,1,701.2325581395348,40,3,16,34.81245882740448,0.6354166666666665,42.88617886178863,1028.4552845528476,25.71138211382119,0
2268,4,0,0,43,0.0,0.0,1.0,43,1350,1000,350,0.7407407407407407,17,10,7,318.70835140668214,0.7831303063861204,0.1743290355474505,0.1918692488908482,132371.857236103,-162.39672152817633,132209.46051457484,2261,2,702.2325581395348,40,3,17,34.53444927249983,0.6369791666666667,42.73373983739838,1029.0650406504078,25.726626016260195,0
2269,4,0,1,42,0.0,0.023255813953488372,0.9767441860465116,43,1250,900,350,0.72,16,9,7,301.6970344651652,0.7832687338501292,0.1419042993045765,0.17367486177569488,130661.65500217024,-711.3960709383589,129950.25893123189,2262,3,703.2325581395348,39,4,18,36.68969689251146,0.6215277777777778,44.40104166666667,1022.3958333333342,26.2152777777778,5
2270,4,1,0,43,0.023255813953488372,0.0,1.0,43,1150,800,350,0.6956521739130435,15,8,7,296.01963839293313,0.7909745293466224,0.13867141956739037,0.17186200677417982,130989.80150910525,-844.8892648225014,130144.91224428275,2263,0,654.9069767441861,40,3,19,36.50455839041665,0.6231770833333332,44.08028455284554,1023.6788617886197,25.59197154471549,0
2271,4,0,0,43,0.0,0.0,1.0,43,1000,500,500,0.5,15,5,10,295.48630963427166,0.7896825396825397,0.1400936360809828,0.17192839278720118,131074.03175390518,-853.8836136306529,130220.14814027453,2264,1,655.9069767441861,41,2,19,36.43350771814247,0.622459349593496,43.998015873015866,1024.0079365079357,24.975803329461847,0
2272,4,0,0,43,0.0,0.0,1.0,43,850,600,250,0.7058823529411765,11,6,5,308.97371849410393,0.7897748246585455,0.15164498126571124,0.17684838128592487,130439.87509645062,-532.8482260959902,129907.02687035463,2265,2,656.9069767441861,41,2,17,36.727424654430095,0.6161077235772358,44.61805555555556,1021.5277777777777,24.91531165311653,4
2273,4,0,0,43,0.0,0.0,1.0,43,1200,900,300,0.75,15,9,6,312.65349255726113,0.7879291251384274,0.1617273554385099,0.17942304327756795,130541.23682169618,-437.16527699043553,130104.07154470574,2266,3,657.9069767441861,41,2,16,36.53114179853088,0.6171239837398375,44.5188492063492,1021.9246031746025,24.924990321331766,0
2274,4,0,0,43,0.0,0.0,1.0,43,850,600,250,0.7058823529411765,11,6,5,313.3469424870652,0.7869139904023624,0.15987022061173528,0.1803668079749607,130658.55910289359,-411.7079990685496,130246.85110382504,2267,4,658.9069767441861,42,1,16,36.395049442390935,0.616815476190476,44.40406976744187,1022.3837209302336,24.342469545957943,0
2275,4,0,0,43,0.0,0.0,1.0,43,1250,800,450,0.64,17,8,9,309.9547810851149,0.7851605758582503,0.15475967523382494,0.17887220964206602,130757.64607182563,-494.208487320471,130263.43758450515,2268,5,659.9069767441861,42,1,16,36.381849044686554,0.6178075396825395,44.30717054263566,1022.7713178294575,24.351698043558514,0
2276,4,0,0,43,0.0,0.0,1.0,43,1000,500,500,0.5,15,5,10,315.382800079313,0.7838224437061646,0.16268062661254068,0.1830606538482343,130980.72907277211,-338.18618171984696,130642.54289105226,2269,6,660.9069767441861,42,1,17,36.018159156885005,0.6200396825396826,44.08914728682171,1023.6434108527136,24.37246216315985,0
2277,4,0,1,42,0.0,0.023255813953488372,0.9767441860465116,43,950,700,250,0.7368421052631579,12,7,5,316.2230500601417,0.783453303802141,0.16514532683132943,0.18402231239182712,131079.93810468138,-309.9004341686023,130770.03767051277,2270,7,661.9069767441861,42,1,17,35.89669284632854,0.6210317460317459,43.99224806201551,1024.0310077519393,24.381690660760462,0
2278,4,0,0,42,0.0,0.0,1.0,42,1050,700,350,0.6666666666666666,14,7,7,323.9574834817581,0.7830768486256291,0.170766747376917,0.18886849333422664,131150.233892747,97.41994598766163,131247.65383873467,2271,8,673.5238095238095,41,1,18,35.62782485875705,0.623221544715447,43.923611111111114,1024.305555555556,24.98306233062332,0
2279,4,2,2,42,0.045454545454545456,0.045454545454545456,0.9545454545454546,44,1450,1100,350,0.7586206896551724,18,11,7,307.63030387972276,0.7975466878083157,0.16283765804585415,0.1817129140206438,131651.11889497325,-699.9046943751712,130951.21420059807,2272,0,643.8636363636364,42,2,14,35.5423630126208,0.6267361111111112,43.435077519379846,1026.2596899224804,24.43475452196382,0
2280,4,0,0,42,0.0,0.0,1.0,42,850,500,350,0.5882352941176471,12,5,7,320.6509005096532,0.7846254355400697,0.16419864943301699,0.18845010116732136,131458.3656078557,30.44866233722243,131488.81427019293,2273,10,675.5238095238095,40,2,18,35.402214844911306,0.6278645833333334,43.62296747967479,1025.5081300813001,25.6377032520325,0
2281,4,0,0,42,0.0,0.0,1.0,42,850,400,450,0.47058823529411764,13,4,9,322.7743223997571,0.7833914053426249,0.16712898751733696,0.19008658169796672,131536.5409561108,91.32357558331734,131627.86453169413,2274,11,676.5238095238095,40,2,19,35.26909550227856,0.6286458333333333,43.546747967479675,1025.8130081300817,25.645325203252042,0
2282,4,2,1,43,0.045454545454545456,0.022727272727272728,0.9772727272727273,44,850,600,250,0.7058823529411765,11,6,5,310.854348323181,0.7958949964763918,0.16270446829669738,0.18518536570893315,131974.50949462163,-595.0299711555919,131379.47952346603,2275,0,646.7272727272727,42,2,18,35.13493335848108,0.6299603174603174,43.120155038759684,1027.5193798449604,24.464747139165723,0
2283,4,0,0,43,0.0,0.0,1.0,43,1100,600,500,0.5454545454545454,16,6,10,313.9631214510808,0.7906976744186046,0.1678568541324208,0.18686218883605688,131938.95266439888,-315.2069160998019,131623.7457482991,2276,1,662.7674418604652,41,2,18,35.0907686365392,0.6310975609756099,43.15476190476189,1027.3809523809505,25.058072009291475,0
2284,4,1,2,42,0.022727272727272728,0.045454545454545456,0.9545454545454546,44,500,300,200,0.6,7,3,4,308.6509012377389,0.796797921071177,0.15978487161693322,0.1847205139894893,132148.80720997826,-642.4303114296083,131506.37689854865,2277,0,648.6818181818181,42,2,18,35.016727923852606,0.6316964285714286,42.950581395348834,1028.1976744186038,24.480897009966757,0
2285,4,1,0,43,0.023255813953488372,0.0,1.0,43,1150,800,350,0.6956521739130435,15,8,7,307.4504134656671,0.7943890734588409,0.15645417855311727,0.18436602760025922,132223.5414413195,-469.5635027943181,131753.9779385252,2278,0,645.8372093023256,42,1,19,34.97267759562842,0.6324404761904763,42.87790697674418,1028.4883720930222,24.487818383167195,0
2286,4,0,0,43,0.0,0.0,1.0,43,800,500,300,0.625,11,5,6,303.65670575694486,0.794204503506829,0.15677033487583647,0.18269294948628867,132348.1454408538,-562.3196284778726,131785.82581237593,2279,1,646.8372093023256,42,1,19,34.94542015883477,0.6336805555555556,42.756782945736425,1028.9728682170532,24.499354005167934,0
2287,4,0,0,43,0.0,0.0,1.0,43,950,600,350,0.631578947368421,13,6,7,304.4187821669601,0.7938815060908084,0.1516761568251428,0.1836366111845324,132447.87089305013,-536.0760884261924,131911.79480462393,2280,2,647.8372093023256,42,1,19,34.825967240892396,0.6346726190476191,42.659883720930225,1029.3604651162777,24.50858250276852,0
2288,4,0,0,43,0.0,0.0,1.0,43,1200,800,400,0.6666666666666666,16,8,8,304.5395741346352,0.7923126614987079,0.15820430455750967,0.18431928211292112,132572.58052400663,-525.2805570579023,132047.29996694872,2281,3,648.8372093023256,42,1,20,34.69804604190188,0.6359126984126986,42.538759689922465,1029.8449612403074,24.520118124769223,0
2289,4,1,1,43,0.022727272727272728,0.022727272727272728,0.9772727272727273,44,1100,800,300,0.7272727272727273,14,8,6,302.35596642478316,0.7973705073995772,0.16218941829874334,0.1841714994143122,132812.52802348754,-768.6679472279776,132043.86007625956,2282,0,635.0681818181819,43,1,15,34.51433547695608,0.6368701550387599,42.305871212121204,1030.7765151515136,23.97154686398869,0
2290,4,0,0,43,0.0,0.0,1.0,43,750,300,450,0.4,12,3,9,308.48228341575566,0.7893595422665189,0.15959777982863188,0.1874514629624653,132722.30954419787,-411.50377831863284,132310.80576587922,2283,5,650.8372093023256,42,1,16,34.44670396840323,0.6374007936507937,42.39341085271317,1030.4263565891456,24.533960871170134,0
2291,4,0,0,43,0.0,0.0,1.0,43,700,600,100,0.8571428571428571,8,6,2,309.22027201258004,0.7889442598744923,0.1601119602890857,0.18802501960284626,132747.27259667357,-390.3704517457145,132356.90214492785,2284,6,651.8372093023256,42,1,16,34.40271900955963,0.6376488095238096,42.369186046511615,1030.5232558139512,24.536267995570267,0
2292,4,0,0,43,0.0,0.0,1.0,43,800,400,400,0.5,12,4,8,311.71265726442437,0.7886674049464747,0.1676700901113608,0.18991977365286034,132822.17583829074,-319.52932516076976,132502.64651312996,2285,7,652.8372093023256,42,1,16,34.2635677132293,0.6383928571428572,42.296511627906966,1030.8139534883703,24.543189368770722,0
2293,4,0,0,43,0.0,0.0,1.0,43,1250,900,350,0.72,16,9,7,311.22195598840847,0.7876522702104097,0.16671547138804987,0.1901276725389576,132922.07969022286,-326.34607295235196,132595.7336172705,2286,8,653.8372093023256,42,1,17,34.1762983148531,0.6393849206349207,42.19961240310077,1031.2015503875964,24.552417866371343,0
2294,4,0,1,42,0.0,0.023255813953488372,0.9767441860465116,43,850,500,350,0.5882352941176471,12,5,7,314.8493475882209,0.7870062753783683,0.16313147420802254,0.19285881210726097,133022.0210999938,-223.62068836009337,132798.40041163372,2287,9,654.8372093023256,42,1,18,33.98283392823595,0.6403769841269842,42.102713178294564,1031.5891472868202,24.56164636397191,0
2295,4,0,0,42,0.0,0.0,1.0,42,1350,1000,350,0.7407407407407407,17,10,7,321.6097705913175,0.7786488579171505,0.17075248722036007,0.19667383382749012,132960.148179642,152.25655076843748,133112.40473041046,2288,13,671.2142857142857,41,1,18,33.87039887136077,0.6412601626016261,42.162698412698404,1031.3492063492047,25.154858691444016,0
2296,4,0,0,42,0.0,0.0,1.0,42,1350,900,450,0.6666666666666666,18,9,9,305.0038607700345,0.7799070847851336,0.05258476931628686,0.17265637052400612,130009.52695893154,-469.3184681280108,129540.20849080353,2289,14,672.2142857142857,41,1,17,37.2632944228275,0.6117886178861789,45.03968253968253,1019.8412698412684,24.874177313201667,8
2297,4,0,0,42,0.0,0.0,1.0,42,1350,1100,250,0.8148148148148148,16,11,5,303.70678883798445,0.7818428184281843,0.04868804664723081,0.17304224015187475,130262.58680555546,-487.1815161249741,129775.40528943049,2290,15,673.2142857142857,39,3,18,37.04081632653063,0.6175213675213675,44.791666666666664,1020.8333333333326,26.175213675213655,0
2298,4,0,0,42,0.0,0.0,1.0,42,1200,900,300,0.75,15,9,6,307.9088633243713,0.7838511420828495,0.04634418785362149,0.17603769124754884,130395.5417209202,-370.01139322916185,130025.53032769104,2291,16,674.2142857142857,39,3,18,36.799358320584744,0.6188568376068376,44.661458333333336,1021.3541666666672,26.18856837606839,0
2299,4,0,0,42,0.0,0.0,1.0,42,1550,1300,250,0.8387096774193549,18,13,5,303.18208990247814,0.783052651955091,0.04260089686098634,0.17416994532336724,130581.79253472204,-481.9878472222417,130099.8046874998,2292,17,675.2142857142857,39,3,15,36.732232640304375,0.6207264957264957,44.47916666666666,1022.0833333333319,26.207264957264922,0
2300,4,0,0,42,0.0,0.0,1.0,42,1100,800,300,0.7272727272727273,14,8,6,302.46099296460204,0.7820363917924894,0.048099215241199644,0.1744748548135405,130741.54188368036,-491.1566840277976,130250.38519965256,2293,18,676.2142857142857,39,3,16,36.58968221633735,0.6223290598290598,44.32291666666666,1022.7083333333318,26.223290598290557,0
2301,4,0,0,42,0.0,0.0,1.0,42,1200,900,300,0.75,15,9,6,301.5722791008505,0.7808507549361208,0.045566042766490567,0.17456361211594904,130874.7409396702,-506.36121961805065,130368.37972005215,2294,19,677.2142857142857,39,3,17,36.478269537480045,0.62366452991453,44.192708333333336,1023.2291666666672,26.236645299145312,0
2302,4,1,0,43,0.023255813953488372,0.0,1.0,43,1200,900,300,0.75,15,9,6,293.5886695809124,0.7899593946105574,0.0556590198193494,0.17139006165981224,131201.0476210158,-896.1717962648155,130304.875824751,2295,0,662.4418604651163,41,2,18,36.35443901100675,0.623729674796748,43.87400793650793,1024.5039682539668,24.9879016647309,0
2303,4,0,0,43,0.0,0.0,1.0,43,1100,800,300,0.7272727272727273,14,8,6,293.4761054927623,0.7915282392026578,0.0616373605596523,0.1718931475029036,131328.12499999997,-891.6051547933992,130436.51984520657,2296,1,663.4418604651163,40,3,18,36.229674796747965,0.6265625,43.75,1024.9999999999998,25.624999999999993,0
2304,4,3,3,43,0.06521739130434782,0.06521739130434782,0.9347826086956522,46,950,800,150,0.8421052631578947,11,8,3,274.88107817073694,0.813647342995169,0.05838194319161327,0.16316832472696452,131838.20740250507,-1952.0342810204374,129886.17312148464,2297,0,621.1086956521739,43,3,11,36.19534731827263,0.6271802325581396,43.25284090909091,1026.9886363636356,23.883456659619434,0
2305,4,1,1,43,0.022727272727272728,0.022727272727272728,0.9772727272727273,44,800,600,200,0.75,10,6,4,287.8362519581611,0.7957408386187457,0.05742459396751731,0.16994167752598283,131633.3616780045,-1222.2293083900292,130411.13236961447,2298,0,650.3181818181819,41,3,12,36.06801044083526,0.6280487804878049,43.45238095238095,1026.190476190476,25.029036004645754,0
2306,4,1,1,43,0.022727272727272728,0.022727272727272728,0.9772727272727273,44,1650,1200,450,0.7272727272727273,21,12,9,288.26944944435377,0.7954105003523608,0.06196949194242807,0.17042489851150203,131684.268904321,-1207.8896604938252,130476.37924382719,2299,0,651.2954545454545,41,3,13,36.00586377988272,0.6285569105691057,43.40277777777778,1026.3888888888891,25.033875338753393,0
2307,4,0,0,43,0.0,0.0,1.0,43,1100,800,300,0.7272727272727273,14,8,6,292.1856680717574,0.7879291251384274,0.062173612710107795,0.1727795812368122,131692.9613655894,-904.240820609418,130788.72054498,2300,5,667.4418604651163,40,3,15,35.89665841584157,0.6302083333333333,43.394308943089435,1026.4227642276433,25.66056910569108,0
2308,4,0,0,43,0.0,0.0,1.0,43,750,500,250,0.6666666666666666,10,5,5,292.7823228721992,0.7875138427464009,0.06567241137216895,0.17348855178755598,131771.20642681277,-883.9440189371365,130887.26240787563,2301,6,668.4418604651163,40,3,15,35.802896829324624,0.6309895833333332,43.31808943089431,1026.727642276423,25.668191056910576,0
2309,4,0,1,42,0.0,0.023255813953488372,0.9767441860465116,43,1350,1100,250,0.8148148148148148,16,11,5,307.09673674368054,0.7875138427464009,0.07757158144755016,0.17509337503343886,130289.17236328126,-596.2368568462258,129692.93550643504,2302,7,669.4418604651163,39,4,18,36.927460633268716,0.6177884615384617,44.765625,1020.9375000000001,26.177884615384617,5
2310,4,0,0,42,0.0,0.0,1.0,42,1900,1500,400,0.7894736842105263,23,15,8,315.2002490510854,0.7860772357723578,0.06639376101831673,0.1804757354147592,130453.51765103363,-176.20374936080634,130277.31390167282,2303,8,684.1428571428571,38,4,20,36.55463466499337,0.6211622807017544,44.60470085470085,1021.5811965811963,26.883715699505167,0
2311,4,0,1,41,0.0,0.023809523809523808,0.9761904761904762,42,1250,900,350,0.72,16,9,7,313.4884427999552,0.7879161827332559,0.05567501381236162,0.1801287647007309,130589.9824334319,-212.30995233398903,130377.6724810979,2304,9,685.1428571428571,38,4,14,36.46061983903002,0.6225328947368421,44.47115384615385,1022.1153846153842,26.897773279352215,0
2312,4,0,0,41,0.0,0.0,1.0,41,800,400,400,0.5,12,4,8,317.61367616719826,0.7877032520325203,0.057638727197097284,0.18267194959326286,130626.62459843421,97.7604888042548,130724.38508723846,2305,10,687.5121951219512,37,4,15,36.31822285387392,0.6247184684684683,44.43530701754386,1022.2587719298251,27.62861545756284,0
2313,4,1,0,42,0.023809523809523808,0.0,1.0,42,1450,1200,250,0.8275862068965517,17,12,5,310.0806397509694,0.7924651567944251,0.06181560943465736,0.18011066947237162,131008.00781249999,-275.39062500000034,130732.61718749999,2306,0,672.1190476190476,39,3,17,36.12637362637363,0.625,44.0625,1023.7499999999999,26.249999999999996,0
2314,4,2,1,43,0.045454545454545456,0.022727272727272728,0.9772727272727273,44,1050,800,250,0.7619047619047619,13,8,5,297.73270816789795,0.8064658210007047,0.07347246611734048,0.1754589427294181,131562.60456945284,-965.5112645829029,130597.09330486994,2307,0,642.5227272727273,40,4,11,35.88513290407795,0.62890625,43.52134146341464,1025.9146341463425,25.647865853658562,0
2315,4,0,0,43,0.0,0.0,1.0,43,750,400,350,0.5333333333333333,11,4,7,303.8849243002443,0.8018641565153193,0.07998393707111373,0.17861176595438266,131461.62245008702,-610.1589626735877,130851.46348741342,2308,1,658.4651162790698,39,4,22,35.82878364652107,0.6295405982905982,43.61979166666668,1025.520833333335,26.29540598290603,0
2316,4,0,0,43,0.0,0.0,1.0,43,1450,900,550,0.6206896551724138,20,9,11,319.660930290658,0.8026485788113695,0.11838649025231085,0.18044562699750055,129899.73855054838,-295.22574608370826,129604.51280446467,2309,2,659.4651162790698,40,3,20,37.000714451865875,0.6122395833333335,45.14735772357722,1019.4105691056892,25.48526422764223,6
2317,4,1,1,43,0.022727272727272728,0.022727272727272728,0.9772727272727273,44,1000,600,400,0.6,14,6,8,318.0521492799066,0.8115089852008457,0.059249092770075285,0.17756397134083948,129466.28146701411,-556.2776850853245,128910.00378192878,2310,0,645.4545454545455,39,5,15,37.48080859774822,0.6095085470085468,45.57291666666668,1017.7083333333352,26.095085470085518,5
2318,4,0,1,42,0.0,0.023255813953488372,0.9767441860465116,43,1550,1300,250,0.8387096774193549,18,13,5,329.08460875585206,0.8023717238833518,0.05711508734056325,0.1833746476993552,129391.54071015056,-83.84708981663559,129307.69362033391,2311,4,661.4651162790698,38,5,20,37.27598095838144,0.6104714912280702,45.64636752136752,1017.4145299145305,26.77406657669817,0
2319,4,1,1,42,0.023255813953488372,0.023255813953488372,0.9767441860465116,43,1050,800,250,0.7619047619047619,13,8,5,326.0658599358052,0.7998800295311923,0.06820827019786124,0.18270039453545922,129609.02829142023,-147.78414694278698,129461.24414447744,2312,0,662.3488372093024,38,5,15,37.1321214982688,0.6126644736842104,45.432692307692314,1018.2692307692316,26.796558704453464,0
2320,4,0,0,42,0.0,0.0,1.0,42,900,500,400,0.5555555555555556,13,5,8,331.8627482096157,0.7937475803329462,0.07402420194621007,0.1854715166544166,129508.13140822174,195.78488092489943,129703.91628914664,2313,7,679.1190476190476,37,5,16,37.0869465689971,0.6134572072072071,45.531798245614034,1017.8728070175437,27.51007586533902,0
2321,4,0,1,41,0.0,0.023809523809523808,0.9761904761904762,42,1500,1100,400,0.7333333333333333,19,11,8,333.38896065576637,0.7941105303910182,0.07425986335938961,0.18645681389928517,129536.03512619268,237.17682363804386,129773.21194983073,2314,8,680.1190476190476,37,5,16,37.019783139451384,0.6137387387387387,45.50438596491228,1017.9824561403509,27.51303935514462,0
2322,4,1,0,42,0.023809523809523808,0.0,1.0,42,1650,1300,350,0.7878787878787878,20,13,7,349.2725567248573,0.7999903213317847,0.09801192022933036,0.18886893055683762,128200.04712988628,614.2640043090374,128814.31113419532,2315,0,670.4047619047619,37,5,19,37.97729897502526,0.6002252252252251,46.8201754385965,1012.7192982456154,27.37079184447609,8
2323,4,0,0,42,0.0,0.0,1.0,42,900,700,200,0.7777777777777778,11,7,4,351.08667531850506,0.8001838946960899,0.0976167282585727,0.19024573567552322,128283.34349270939,607.7145131194324,128891.05800582882,2316,1,671.4047619047619,37,5,19,37.84624508424432,0.6010698198198197,46.73793859649123,1013.0482456140359,27.37968231389286,0
2324,4,3,2,43,0.06666666666666667,0.044444444444444446,0.9555555555555556,45,1200,800,400,0.6666666666666666,16,8,8,334.8702865689971,0.8248737373737374,0.09655939080651432,0.18461271452052583,128969.02394614677,-362.42119852597875,128606.6027476208,2317,0,627.5777777777778,40,5,16,37.55836251459061,0.6028645833333333,46.061991869918714,1015.7520325203276,25.39380081300819,0
2325,4,2,2,43,0.044444444444444446,0.044444444444444446,0.9555555555555556,45,900,600,300,0.6666666666666666,12,6,6,332.03279999999927,0.8242845117845118,0.10626666666666629,0.18364646017699138,129098.08976138593,-427.03995637512435,128671.0498050108,2318,0,628.5333333333333,40,5,16,37.49916666666666,0.6041666666666664,45.93495934959352,1016.2601626016301,25.406504065040753,0
2326,4,1,1,43,0.022727272727272728,0.022727272727272728,0.9772727272727273,44,1300,1000,300,0.7692307692307693,16,10,6,336.73959999999994,0.8188645172656801,0.118559090909091,0.18624977876106202,129098.0897613856,-105.51217859737434,128992.57758278823,2319,0,643.7954545454545,40,4,19,37.37958333333334,0.6041666666666665,45.934959349593505,1016.2601626016275,25.406504065040686,0
2327,4,0,0,43,0.0,0.0,1.0,43,1100,900,200,0.8181818181818182,13,9,4,344.4635511541683,0.8163990402362495,0.11911630768056947,0.19025467032603402,129042.58355034744,290.09331597224326,129332.67686631969,2320,1,658.7441860465116,39,4,19,37.23985031781832,0.6052350427350428,45.98958333333334,1016.0416666666684,26.052350427350472,0
2328,4,0,0,43,0.0,0.0,1.0,43,1050,900,150,0.8571428571428571,12,9,3,342.64982531577505,0.8170450350682908,0.11246664125047579,0.1900149031296573,129201.38888888911,254.16666666668706,129455.5555555558,2321,2,659.7441860465116,39,4,19,37.124316939890704,0.6068376068376068,45.83333333333334,1016.6666666666684,26.068376068376114,0
2329,4,1,1,43,0.022727272727272728,0.022727272727272728,0.9772727272727273,44,800,600,200,0.75,10,6,4,335.4600517650951,0.8227184637068359,0.11069630911509942,0.18740881451096314,129492.78564453128,-112.068684895832,129380.71695963545,2322,0,645.7272727272727,39,5,13,37.01098915157097,0.609775641025641,45.546875,1017.8125000000002,26.097756410256416,0
2330,4,0,0,43,0.0,0.0,1.0,43,1500,1300,200,0.8666666666666667,17,13,4,344.2347548325169,0.8180140273163529,0.11100885854401588,0.1923474785506973,129500.26167223683,315.6981654978458,129815.95983773467,2323,4,661.7441860465116,38,5,15,36.780116161086035,0.6115679824561404,45.539529914529915,1017.8418803418803,26.785312640575796,0
2331,4,2,2,43,0.044444444444444446,0.044444444444444446,0.9555555555555556,45,1300,1000,300,0.7692307692307693,16,10,6,335.3346479255762,0.8263047138047138,0.11535889088211215,0.1896701159687278,129977.44914568044,-282.81157049375537,129694.63757518669,2324,0,633.2888888888889,40,5,15,36.52249019998672,0.6130208333333333,45.07113821138211,1019.7154471544712,25.49288617886178,0
2332,4,2,3,42,0.044444444444444446,0.06666666666666667,0.9333333333333333,45,1000,600,400,0.6,14,6,8,334.3943657925237,0.825925925925926,0.11605778685424717,0.18966228700741986,130085.4190779321,-300.03375771604726,129785.38532021605,2325,0,634.2444444444444,41,4,15,36.43706035852054,0.6125508130081301,44.96527777777778,1020.1388888888889,24.881436314363143,0
2333,4,1,1,42,0.023255813953488372,0.023255813953488372,0.9767441860465116,43,1100,500,600,0.45454545454545453,17,5,12,350.73866990611293,0.8126153562200074,0.1171347620224763,0.1976743747904036,129837.58680555545,507.8124999999898,130345.39930555543,2326,0,664.5813953488372,39,4,15,36.27180430635051,0.6132478632478633,45.20833333333333,1019.1666666666657,26.13247863247861,0
2334,4,0,1,41,0.0,0.023809523809523808,0.9761904761904762,42,1150,900,250,0.782608695652174,14,9,5,357.6365858796737,0.8048054587688734,0.11629143636064065,0.20122596575424448,129772.26382725166,882.2618754108988,130654.52570266256,2327,10,681.4047619047619,38,4,17,36.16244626192724,0.6143092105263158,45.27243589743589,1018.9102564102552,26.813427800269874,0
2335,4,0,0,41,0.0,0.0,1.0,41,1050,700,350,0.6666666666666666,14,7,7,342.67658689827414,0.7959857723577236,0.0814239028082937,0.18672542127568298,128505.59937913588,633.470526348797,129139.06990548468,2328,13,698.780487804878,37,4,16,37.83242763418766,0.6033220720720721,46.51864035087719,1013.9254385964912,27.4033902323376,6
2336,4,1,0,42,0.023809523809523808,0.0,1.0,42,1100,800,300,0.7272727272727273,14,8,6,333.847507875525,0.7999419279907085,0.09364558297672754,0.18365380963716813,128883.87586805563,205.51215277778317,129089.38802083342,2329,0,683.1190476190476,39,3,17,37.670975242784856,0.6036324786324787,46.145833333333336,1015.4166666666673,26.0363247863248,0
2337,4,1,1,42,0.023255813953488372,0.023255813953488372,0.9767441860465116,43,1050,700,350,0.6666666666666666,14,7,7,332.56789951538184,0.8066629752676264,0.11486451820960242,0.18480524433665607,129282.86540516104,-0.1525517751555867,129282.71285338588,2330,0,668.2093023255813,38,5,18,37.297772875302016,0.609375,45.753205128205124,1016.9871794871792,26.762820512820507,0
2338,4,0,0,42,0.0,0.0,1.0,42,1000,600,400,0.6,14,6,8,343.9413412921626,0.7999177313201703,0.12667344517878343,0.1908658323041424,129229.25954380176,489.4569723376204,129718.71651613938,2331,1,684.7619047619048,37,5,18,37.0631358064632,0.6106418918918919,45.80592105263157,1016.7763157894722,27.48044096728303,0
2339,4,1,1,42,0.023255813953488372,0.023255813953488372,0.9767441860465116,43,1250,800,450,0.64,17,8,9,337.776158087419,0.8092469545957918,0.13994493585613044,0.18886920388831724,129527.44904667966,150.25682117026395,129677.70586784992,2332,0,669.8139534883721,38,5,15,36.916850335852224,0.611842105263158,45.512820512820504,1017.9487179487166,26.788124156545177,0
2340,4,0,0,42,0.0,0.0,1.0,42,1450,1000,450,0.6896551724137931,19,10,9,333.8440578344468,0.8041521486643438,0.13446274345256848,0.1873181520503696,129663.42872242302,257.47303948424656,129920.90176190727,2333,1,680.7142857142857,38,4,16,36.87891185006469,0.6132127192982457,45.3792735042735,1018.4829059829052,26.802181736392242,0
2341,4,0,0,42,0.0,0.0,1.0,42,1650,1200,450,0.7272727272727273,21,12,9,336.59021894883773,0.8045150987224158,0.1211236538212015,0.19004401592957446,129908.37191358021,345.17746913579606,130253.54938271601,2334,2,681.7142857142857,38,4,17,36.560513169845585,0.6156798245614035,45.138888888888886,1019.4444444444441,26.82748538011695,0
2342,4,0,0,42,0.0,0.0,1.0,42,1300,1100,200,0.8461538461538461,15,11,4,336.7965163206863,0.8041763453348819,0.11853392383346284,0.19095802481175234,130071.79578493668,361.5455383884703,130433.34132332515,2335,3,682.7142857142857,38,4,18,36.38960166177907,0.6173245614035088,44.97863247863247,1020.0854700854691,26.844354475933397,0
2343,4,1,1,42,0.023255813953488372,0.023255813953488372,0.9767441860465116,43,1350,900,450,0.6666666666666666,18,9,9,331.8556560482646,0.8112310815799187,0.12143121459679485,0.18959865104295948,130368.94531249999,52.734375000000114,130421.67968749999,2336,0,667.8139534883721,39,4,19,36.214810281517735,0.6185897435897436,44.6875,1021.2499999999999,26.185897435897434,0
2344,4,2,1,43,0.045454545454545456,0.022727272727272728,0.9772727272727273,44,900,500,400,0.5555555555555556,13,5,8,328.8817420991081,0.8108262861169838,0.14892065212482475,0.1899136393704831,130781.81932257579,-197.64948526010164,130584.16983731568,2337,0,653.5909090909091,40,4,15,35.873488988243096,0.62109375,44.28353658536585,1022.8658536585361,25.571646341463403,0
2345,4,0,0,43,0.0,0.0,1.0,43,1050,600,450,0.5714285714285714,15,6,9,336.2434275046067,0.8055094130675525,0.1484438863154398,0.19356183231423565,130661.65500217027,186.82454427084303,130848.47954644111,2338,1,669.7906976744187,39,4,15,35.80669468500592,0.6215277777777778,44.40104166666667,1022.3958333333344,26.215277777777803,0
2346,4,0,0,43,0.0,0.0,1.0,43,950,500,450,0.5263157894736842,14,5,9,336.22094900902187,0.80500184569952,0.15253293922319577,0.1940830980787528,130768.17626953124,193.4000651041664,130961.5763346354,2339,2,670.7906976744187,39,4,17,35.69960026479274,0.6225961538461539,44.296875,1022.8124999999999,26.225961538461537,0
2347,4,0,1,42,0.0,0.023255813953488372,0.9767441860465116,43,700,500,200,0.7142857142857143,9,5,4,335.99278630091374,0.8045865633074935,0.15211352985889248,0.19421925569519002,130821.45317925372,191.01291232641267,131012.46609158014,2340,3,671.7906976744187,39,4,17,35.65160116077793,0.6231303418803418,44.24479166666668,1023.0208333333353,26.23130341880347,0
2348,4,0,0,42,0.0,0.0,1.0,42,1350,1100,250,0.8148148148148148,16,11,5,336.75479858506736,0.8035472319008904,0.14476627986755353,0.19500831081304576,130890.45606874142,415.59783402733154,131306.05390276876,2341,4,672.3095238095239,38,4,17,35.56239994431685,0.625548245614035,44.17735042735043,1023.2905982905991,26.928699955015766,0
2349,4,0,0,42,0.0,0.0,1.0,42,1550,1100,450,0.7096774193548387,20,11,9,347.35079733556216,0.8050232288037166,0.13787896908449415,0.19804798444741273,130289.85407991838,651.2569398787559,130941.11101979714,2342,5,673.3095238095239,38,4,18,35.899347704757915,0.619517543859649,44.764957264957275,1020.9401709401726,26.866846603688753,4
2350,4,0,0,42,0.0,0.0,1.0,42,1500,1200,300,0.8,18,12,6,347.0743978666862,0.802748741773132,0.13753155764031044,0.19886593569797034,130480.80490037637,657.3093587917501,131138.11425916813,2343,6,674.3095238095239,38,4,19,35.712947471156205,0.6214364035087718,44.57799145299146,1021.6880341880354,26.886527215474615,0
2351,4,0,0,42,0.0,0.0,1.0,42,1050,600,450,0.5714285714285714,15,6,9,348.5792999120931,0.8018534649632211,0.13865282652527777,0.20000965828789286,130535.3879597671,700.3868297538274,131235.77478952092,2344,7,675.3095238095239,38,4,16,35.61922808851716,0.6219846491228069,44.524572649572654,1021.9017094017105,26.892150247413433,0
2352,4,1,0,43,0.023255813953488372,0.0,1.0,43,1100,900,200,0.8181818181818182,13,9,4,345.15371370525656,0.8065706902916205,0.14194049428667466,0.19965251919982543,130848.09570312526,432.54123263891813,131280.63693576417,2345,0,660.5813953488372,39,4,17,35.39036516663273,0.6233974358974358,44.218750000000014,1023.125000000002,26.23397435897441,0
2353,4,0,0,43,0.0,0.0,1.0,43,800,600,200,0.75,10,6,4,340.4075131596836,0.8067091177556294,0.13967690395881394,0.19731585939787,130928.03955078151,313.7776692708627,131241.81722005238,2346,1,661.5813953488372,39,4,17,35.43097964376593,0.6241987179487178,44.140625000000014,1023.437500000002,26.241987179487232,0
2354,4,1,1,43,0.022727272727272728,0.022727272727272728,0.9772727272727273,44,1200,700,500,0.5833333333333334,17,7,10,335.1817641453005,0.8128303382663848,0.14096951060049934,0.19565531930218744,131197.94894118918,-4.9680043294222855,131192.98093685976,2347,0,647.5227272727273,40,4,18,35.29225771252853,0.6252604166666667,43.87703252032521,1024.4918699186999,25.6122967479675,0
2355,4,1,2,42,0.022727272727272728,0.045454545454545456,0.9545454545454546,44,850,300,550,0.35294117647058826,14,3,11,335.552745822509,0.8202959830866808,0.13763588336889132,0.19694965278061782,131408.21533203148,18.942044704633417,131427.1573767361,2348,0,632.5227272727273,39,5,19,35.07071438247148,0.6290064102564101,43.671875000000014,1025.3125000000018,26.29006410256415,0
2356,4,0,0,42,0.0,0.0,1.0,42,1450,1100,350,0.7586206896551724,18,11,7,350.28885015565163,0.8137582268679829,0.1495704851283577,0.20458404829431806,131218.63928154006,792.8852545839895,132011.52453612405,2349,2,662.6428571428571,38,4,20,34.884428223844296,0.6288377192982455,43.856837606837615,1024.5726495726508,26.962438146648704,0
2357,4,0,0,42,0.0,0.0,1.0,42,1100,800,300,0.7272727272727273,14,8,6,353.0542770106738,0.8137824235385211,0.14347586965488834,0.2072448552621978,131412.4312889543,879.1898408842644,132291.62112983858,2350,3,663.6428571428571,37,5,22,34.617843902612904,0.6326013513513513,43.66776315789474,1025.3289473684213,27.711593172119493,0
2358,4,0,1,41,0.0,0.023809523809523808,0.9761904761904762,42,1350,1000,350,0.7407407407407407,17,10,7,347.8564212497311,0.8145325203252033,0.13947759522791614,0.20494613836350664,131553.00188519544,752.311288088644,132305.31317328408,2351,4,664.6428571428571,37,5,22,34.60925252957105,0.634009009009009,43.530701754385966,1025.877192982456,27.726410621147462,0
2359,4,1,0,42,0.023809523809523808,0.0,1.0,42,600,300,300,0.5,9,3,6,344.948432626052,0.8148954703832753,0.1465512419596775,0.2045878449362241,131806.21831957917,693.2696839412187,132499.48800352038,2352,0,663.3095238095239,37,5,16,34.42861274248087,0.6365427927927928,43.28399122807018,1026.86403508772,27.753082029397834,0
2360,4,0,0,42,0.0,0.0,1.0,42,600,400,200,0.6666666666666666,8,4,4,346.47334488107344,0.814121176926055,0.14947358253646303,0.2057968181040593,131862.52170138882,737.3697916666615,132599.89149305547,2353,1,664.3095238095239,37,5,16,34.33274171737661,0.6371058558558559,43.229166666666664,1027.0833333333328,27.759009009008995,0
2361,4,0,0,42,0.0,0.0,1.0,42,900,600,300,0.6666666666666666,12,6,6,345.84998057252847,0.8132500967866821,0.14181045871186715,0.20618995024972855,132003.33275623253,730.6700138503916,132734.0027700829,2354,2,665.3095238095239,37,5,17,34.20694622279128,0.6385135135135136,43.09210526315788,1027.631578947367,27.773826458036943,0
2362,4,0,2,40,0.0,0.047619047619047616,0.9523809523809523,42,950,700,250,0.7368421052631579,12,7,5,346.63788308541746,0.8120160665892373,0.1430196652039657,0.20727530560005566,132116.0357032932,759.2845875653888,132875.3202908586,2355,3,666.3095238095239,37,5,17,34.07325440841865,0.6396396396396398,42.98245614035087,1028.0701754385955,27.785680417259336,0
2363,4,0,0,40,0.0,0.0,1.0,40,1100,900,200,0.8181818181818182,13,9,4,363.4204871564637,0.7999732905982906,0.15009318131988603,0.2161096273690524,131905.89871966562,1587.461194302413,133493.35991396804,2356,4,700.175,36,4,18,33.85382408828473,0.6394675925925927,43.18693693693694,1027.2522522522524,28.53478478478479,0
2364,4,0,0,40,0.0,0.0,1.0,40,800,400,400,0.5,12,4,8,361.79326541175317,0.8008279914529914,0.14987943884261323,0.2154700883561904,131963.74584043506,1548.7189047155334,133512.4647451506,2357,5,701.175,36,4,18,33.837269837790444,0.6400462962962963,43.130630630630634,1027.4774774774778,28.54104104104105,0
2365,4,0,0,40,0.0,0.0,1.0,40,1250,800,450,0.64,17,8,9,361.63241037815015,0.8004540598290598,0.14873026034997894,0.21559916985140065,132003.3327562325,1547.3366805170588,133550.66943674957,2358,6,702.175,37,3,18,33.80148314127186,0.6385135135135136,43.09210526315788,1027.6315789473667,27.77382645803694,0
2366,4,0,0,40,0.0,0.0,1.0,40,1300,1000,300,0.7692307692307693,16,10,6,361.01764798838315,0.8008279914529914,0.1459324655926597,0.2153926425585685,132031.50398439888,1533.14060576329,133564.64459016218,2359,7,703.175,37,3,18,33.78887495999146,0.638795045045045,43.06469298245613,1027.741228070174,27.77678994784254,0
2367,4,0,0,40,0.0,0.0,1.0,40,1350,1000,350,0.7407407407407407,17,10,7,362.41383004976717,0.7988247863247864,0.14832302442145684,0.21687010110891297,132144.21895438983,1578.1785020390903,133722.3974564289,2360,8,704.175,37,3,18,33.639379154669236,0.6399211711711712,42.95504385964912,1028.1798245614036,27.788643907064962,0
2368,4,0,0,40,0.0,0.0,1.0,40,1050,700,350,0.6666666666666666,14,7,7,360.4120730493131,0.7973557692307692,0.14459488272921117,0.21615506682880814,132228.78674207453,1531.3702293013314,133760.15697137587,2361,9,705.175,37,3,18,33.60563255152807,0.6407657657657657,42.87280701754386,1028.5087719298251,27.79753437648176,0
2369,4,2,2,40,0.047619047619047616,0.047619047619047616,0.9523809523809523,42,850,600,250,0.7058823529411765,11,6,5,343.514653428138,0.8049506387921022,0.14137253113631076,0.20881958039570772,132736.7615516313,719.6209410587885,133456.38249269009,2362,0,672.547619047619,37,5,15,33.529740370291535,0.6458333333333333,42.37938596491228,1030.4824561403511,27.850877192982463,0
2370,4,0,0,40,0.0,0.0,1.0,40,950,800,150,0.8421052631578947,11,8,3,358.5436695619149,0.7957264957264957,0.14398774640383594,0.2158391493802805,132369.793169533,1492.0702764312127,133861.8634459642,2363,11,707.175,37,3,18,33.51169863256971,0.6421734234234234,42.73574561403509,1029.05701754386,27.81235182550973,0
2371,4,1,1,40,0.024390243902439025,0.024390243902439025,0.975609756097561,41,900,600,300,0.6666666666666666,12,6,6,348.1078784827508,0.8014735772357724,0.1399661506193608,0.21129338670697204,132680.2718144045,1037.4125932979491,133717.68440770244,2364,0,690.9024390243902,37,4,15,33.46814247197389,0.6452702702702702,42.434210526315795,1030.2631578947373,27.84495021337128,0
2372,4,0,0,40,0.0,0.0,1.0,40,600,400,200,0.6666666666666666,8,4,4,356.5450859063618,0.7940972222222222,0.14112162309963927,0.21545880505233767,132513.92598257054,1449.4378246489878,133963.36380721952,2365,13,709.175,36,4,18,33.418097633891136,0.6455439814814814,42.59572072072073,1029.6171171171181,28.600475475475506,0
2373,4,1,1,40,0.024390243902439025,0.024390243902439025,0.975609756097561,41,1050,800,250,0.7619047619047619,13,8,5,350.88452613527943,0.7973577235772358,0.13688333329007452,0.21313910097564467,132708.51518015168,1113.07289262082,133821.5880727725,2366,0,692.8536585365854,37,4,15,33.368251392288336,0.6455518018018017,42.40679824561404,1030.3728070175446,27.84791370317688,0
2374,4,0,0,40,0.0,0.0,1.0,40,700,600,100,0.8571428571428571,8,6,2,357.0943445987564,0.7927083333333333,0.13680168361211376,0.21645738701423622,132629.8992193207,1472.2773871844906,134102.1766065052,2367,15,711.175,36,4,15,33.287325534783726,0.6467013888888888,42.48310810810811,1030.067567567568,28.612987987988,0
2375,4,0,0,40,0.0,0.0,1.0,40,1050,600,450,0.5714285714285714,15,6,9,359.3227989913546,0.7934561965811966,0.11514356117420199,0.2083179506698944,130935.05333371794,1412.256276499964,132347.3096102179,2368,16,712.175,37,3,17,34.939915006071004,0.6278153153153154,44.133771929824555,1023.4649122807007,27.661213845424342,7
2376,4,0,0,40,0.0,0.0,1.0,40,550,200,350,0.36363636363636365,9,2,7,359.12233060018946,0.7939102564102564,0.11818839027524963,0.2086574487127544,131019.23338190575,1410.3864891120115,132429.61987101776,2369,17,713.175,37,3,17,34.859854164435404,0.6286599099099099,44.05153508771929,1023.793859649121,27.670104314841108,0
2377,4,0,0,40,0.0,0.0,1.0,40,1000,600,400,0.6,14,6,8,354.8143486700134,0.7951121794871795,0.09871575342465766,0.2072115796232875,131215.75869498288,1311.4467913203828,132527.20548630325,2370,18,714.175,37,3,19,34.77142194634703,0.6306306306306307,43.85964912280701,1024.5614035087704,27.69084874348028,0
2378,4,0,1,39,0.0,0.025,0.975,40,1000,600,400,0.6,14,6,8,355.608434133122,0.7939903846153846,0.0971544715447159,0.20828493999225708,131328.12499999997,1340.3258694983065,132668.45086949828,2371,19,715.175,36,4,20,34.63753387533876,0.6336805555555556,43.75,1024.9999999999998,28.472222222222214,0
2379,4,0,0,39,0.0,0.0,1.0,39,1050,700,350,0.6666666666666666,14,7,7,356.5999074624894,0.7863810166441746,0.11757348342714247,0.2088656600851723,131328.12499999997,1566.319444444444,132894.4444444444,2372,20,733.5128205128206,35,4,20,34.612127371273715,0.6357142857142857,43.75,1024.9999999999998,29.285714285714278,0
2380,4,1,1,39,0.025,0.025,0.975,40,1200,800,400,0.6666666666666666,16,8,8,331.9668494198437,0.792815170940171,0.08149045821002132,0.18901470990499972,130236.00396050328,646.8071831596976,130882.81114366298,2373,0,716.15,39,1,17,36.34650219410144,0.6172542735042736,44.81770833333332,1020.729166666665,26.172542735042693,8
2381,4,0,0,39,0.0,0.0,1.0,39,1300,700,600,0.5384615384615384,19,7,12,335.69346105789293,0.7873931623931624,0.09544740973312438,0.19126720455624105,130262.58680555534,945.6651475694239,131208.25195312477,2374,1,734.974358974359,36,3,18,36.22448979591836,0.6229745370370372,44.79166666666666,1020.8333333333317,28.356481481481435,0
2382,4,0,0,39,0.0,0.0,1.0,39,750,600,150,0.8,9,6,3,331.17870873218425,0.7871120107962214,0.029116790682626847,0.18378337319410815,129229.25954380205,759.595861226539,129988.85540502859,2375,2,735.974358974359,37,2,19,37.387554369315914,0.6106418918918919,45.80592105263158,1016.7763157894746,27.480440967283094,5
2383,4,2,0,41,0.04878048780487805,0.0,1.0,41,900,500,400,0.5555555555555556,13,5,8,321.91406687459096,0.8049796747967479,0.05117413267774085,0.1811831646816598,129784.51063368047,155.89192708332928,129940.4025607638,2376,0,701.0243902439024,39,2,17,37.05999114018946,0.6127136752136753,45.260416666666664,1018.9583333333327,26.127136752136735,0
2384,4,2,0,43,0.046511627906976744,0.0,1.0,43,900,500,400,0.5555555555555556,13,5,8,310.5380369882086,0.8158453303802141,0.06407836773072151,0.17681936151475808,130237.26974875596,-511.27478190350416,129725.99496685246,2377,0,669.3720930232558,41,2,21,36.89204895195516,0.6140752032520325,44.81646825396825,1020.7341269841269,24.895954316686023,0
2385,4,0,0,43,0.0,0.0,1.0,43,1150,700,450,0.6086956521739131,16,7,9,310.95242270863963,0.8148763381321521,0.05996719696730102,0.17763286566940803,130363.879637503,-492.6071586041998,129871.27247889881,2378,1,670.3720930232558,41,2,21,36.75361051745352,0.6153455284552847,44.69246031746031,1021.2301587301575,24.90805265195506,0
2386,4,1,1,43,0.022727272727272728,0.022727272727272728,0.9772727272727273,44,1400,1300,100,0.9285714285714286,15,13,2,303.44970163774263,0.8213090204369274,0.06019906362625904,0.17462915665677325,130649.55305899894,-870.8864210284781,129778.66663797045,2379,0,656.1136363636364,43,1,14,36.657095220452014,0.6153100775193799,44.41287878787878,1022.3484848484837,23.775546159267062,0
2387,4,2,1,44,0.044444444444444446,0.022222222222222223,0.9777777777777777,45,1150,900,250,0.782608695652174,14,9,5,301.21380270228997,0.8244949494949495,0.07767224483642443,0.17479887605636807,130972.46334876525,-1109.8572530864367,129862.60609567881,2380,0,642.4888888888889,44,1,17,36.389077340569855,0.6171875,44.097222222222214,1023.6111111111097,23.263888888888857,0
2388,4,0,1,43,0.0,0.022727272727272728,0.9772727272727273,44,950,400,550,0.42105263157894735,15,4,11,304.3809758249364,0.8180056377730797,0.0824817745653943,0.16508990473181437,128320.37278163541,-979.6633873457158,127340.70939428969,2381,1,658.0227272727273,41,3,17,38.9914610463788,0.5947662601626018,46.70138888888887,1013.1944444444412,24.712059620596126,8
2389,4,2,2,43,0.044444444444444446,0.044444444444444446,0.9555555555555556,45,1100,800,300,0.7272727272727273,14,8,6,296.75131985114245,0.8212121212121213,0.0926718464739098,0.16212906138840052,128610.97965867406,-1366.904407788027,127244.07525088603,2382,0,644.2444444444444,42,3,14,38.88955228633293,0.5962301587301588,46.41472868217053,1014.3410852713154,24.150978220745603,0
2390,4,1,1,43,0.022727272727272728,0.022727272727272728,0.9772727272727273,44,1200,900,300,0.75,15,9,6,303.27277114371475,0.8109804439746301,0.09458510392404373,0.1658431742093916,128647.25548784302,-996.958065633692,127650.29742220933,2383,0,659.8636363636364,41,3,14,38.68733294217352,0.598069105691057,46.37896825396824,1014.4841269841249,24.74351529229573,0
2391,4,0,0,43,0.0,0.0,1.0,43,900,500,400,0.5555555555555556,13,5,8,311.4338898237358,0.8092469545957918,0.09767907908840967,0.17002791140267395,128582.2137946988,-591.0281991539539,127991.18559554484,2384,4,676.2093023255813,40,3,14,38.546467935871746,0.5989583333333335,46.443089430894304,1014.2276422764218,25.355691056910544,0
2392,4,1,1,43,0.022727272727272728,0.022727272727272728,0.9772727272727273,44,1300,1000,300,0.7692307692307693,16,10,6,308.75786308305743,0.8173890063424948,0.1047639347756586,0.16991642400635298,128898.98667800408,-840.2848639456265,128058.70181405846,2385,0,661.8181818181819,41,3,14,38.29254591637359,0.6006097560975612,46.13095238095236,1015.4761904761867,24.767711962833822,0
2393,4,0,0,43,0.0,0.0,1.0,43,1400,1000,400,0.7142857142857143,18,10,8,314.3482465594157,0.8092008121077888,0.10076913286179323,0.17255425208132671,128798.26467624033,-502.49826782569926,128295.76640841464,2386,6,678.2093023255813,41,2,14,38.25294826687518,0.5995934959349596,46.230158730158706,1015.0793650793607,24.758033294618556,0
2394,4,2,0,45,0.044444444444444446,0.0,1.0,45,1050,700,350,0.6666666666666666,14,7,7,308.78411952584383,0.8247474747474748,0.12834945175071732,0.16652943230086226,128093.08824319165,-956.2364864452422,127136.85175674642,2387,0,649.0222222222222,40,5,16,39.11128400762977,0.5940104166666668,46.92581300813007,1012.2967479674778,25.307418699186947,8
2395,4,2,1,46,0.0425531914893617,0.02127659574468085,0.9787234042553191,47,1000,700,300,0.7,13,7,6,301.7817313357464,0.8408109774899784,0.1467198581560285,0.16447104357798142,128512.70957274169,-1643.4424012980326,126869.26717144366,2388,0,622.3617021276596,42,5,12,38.86181192660548,0.5952380952380953,46.51162790697673,1013.9534883720904,24.14174972314501,0
2396,4,1,1,46,0.02127659574468085,0.02127659574468085,0.9787234042553191,47,900,600,300,0.6666666666666666,12,6,6,303.35490262335173,0.8344896700585877,0.16103645935989386,0.1660443902440728,128684.70687045537,-1592.5726556396987,127092.13421481567,2389,0,623.3404255319149,42,5,13,38.64721612071434,0.5969742063492064,46.342054263565885,1014.6317829457354,24.15789959394608,0
2397,4,1,0,47,0.02127659574468085,0.0,1.0,47,1450,900,550,0.6206896551724138,20,9,11,303.10035789371324,0.8373034227567067,0.16078032048877255,0.16635600288083516,128792.54301717455,-1592.5868234905904,127199.95619368396,2390,0,624.2765957446809,43,4,14,38.54419333271139,0.596656976744186,46.23579545454545,1015.0568181818179,23.60597251585623,0
2398,4,1,2,46,0.020833333333333332,0.041666666666666664,0.9583333333333334,48,1350,1000,350,0.7407407407407407,17,10,7,295.45197278911525,0.8420323581560284,0.13856746031746026,0.16466272368820162,129398.49242834,-1944.8020923619204,127453.69033597808,2391,0,612.25,42,6,17,38.12440476190475,0.6041666666666665,45.63953488372095,1017.4418604651192,24.224806201550457,1
2399,4,1,1,46,0.02127659574468085,0.02127659574468085,0.9787234042553191,47,1600,1500,100,0.9375,17,15,2,355.933357006562,0.8413891458526056,0.19889143018610667,0.18557468703739,126725.87777364627,-261.0674501232018,126464.81032352307,2392,0,594.7234042553191,42,5,18,39.3204856767074,0.5771329365079365,48.280038759689916,1006.8798449612391,23.973329641934264,8
2400,4,3,1,48,0.061224489795918366,0.02040816326530612,0.9795918367346939,49,1250,800,450,0.64,17,8,9,347.8036571304385,0.8571782879818595,0.22561901419044283,0.18422187461229636,127367.25368677566,-938.6562024799603,126428.5974842957,2393,0,571.3265306122449,41,8,17,38.86680999181,0.585111788617886,47.64384920634921,1009.4246031746034,24.620112272551303,0
2401,4,3,1,50,0.058823529411764705,0.0196078431372549,0.9803921568627451,51,1300,1000,300,0.7692307692307693,16,10,6,342.2426498568111,0.8616013071895425,0.24475111145375616,0.18371035104374162,127904.94163940547,-1445.094768709815,126459.84687069566,2394,0,549.8627450980392,43,8,20,38.45682768520253,0.5876937984496123,47.11174242424243,1011.5530303030308,23.52448907681467,0
2402,4,1,1,50,0.0196078431372549,0.0196078431372549,0.9803921568627451,51,1250,1000,250,0.8,15,10,5,347.2275135358024,0.8614705882352942,0.24979452858987905,0.18705482180799698,128048.66850321408,-1307.5958448117412,126741.07265840234,2395,0,550.843137254902,43,8,20,38.1837886726547,0.5891472868217054,46.969696969696976,1012.1212121212131,23.537702607470074,0
2403,4,1,2,49,0.0196078431372549,0.0392156862745098,0.9607843137254902,51,2150,1500,650,0.6976744186046512,28,15,13,348.300391886605,0.8656209150326798,0.2532085279540479,0.1888469191687067,128306.84222961881,-1261.9559636167849,127044.88626600202,2396,0,551.8235294117648,38,13,23,37.892808183064446,0.5995065789473684,46.7147435897436,1013.1410256410268,26.661605937921756,0
2404,4,2,3,48,0.0392156862745098,0.058823529411764705,0.9411764705882353,51,1500,1200,300,0.8,18,12,6,337.72964323099916,0.8719281045751635,0.2558076813151866,0.1850484918085713,128725.26584201405,-1505.1323784722044,127220.13346354185,2397,0,551.3137254901961,39,12,16,37.73395264490523,0.6020299145299145,46.30208333333334,1014.791666666668,26.02029914529918,0
2405,4,1,1,48,0.02040816326530612,0.02040816326530612,0.9795918367346939,49,1450,1100,350,0.7586206896551724,18,11,7,350.9369609363676,0.8589143990929705,0.25632264586561493,0.19109323561941396,128477.80687326849,-782.4777816251355,127695.32909164336,2398,0,574.7755102040817,37,12,16,37.65141682889899,0.6030405405405406,46.54605263157894,1013.8157894736826,27.400426742531963,0
2406,4,2,2,48,0.04,0.04,0.96,50,1550,1000,550,0.6451612903225806,21,10,11,344.894993272775,0.8622448979591837,0.24998357963875195,0.1892261719847927,128778.12499999997,-1117.0138888888894,127661.11111111108,2399,0,564.24,39,11,16,37.498289545703344,0.6025641025641025,46.25,1014.9999999999998,26.02564102564102,0
2407,4,0,1,47,0.0,0.020833333333333332,0.9791666666666666,48,1150,700,450,0.6086956521739131,16,7,9,354.13807002820204,0.8497340425531915,0.2576177759517939,0.19326727857592935,128566.75347222238,-493.9236111110927,128072.82986111128,2400,6,588.75,39,9,16,37.479457682826634,0.6004273504273504,46.45833333333334,1014.166666666668,26.004273504273538,0
2408,4,1,1,47,0.020833333333333332,0.020833333333333332,0.9791666666666666,48,950,800,150,0.8421052631578947,11,8,3,356.389822972845,0.8491060874704491,0.26592281764363723,0.19514296040351228,128698.84033203124,-426.608615451388,128272.23171657984,2401,0,589.6041666666666,39,9,17,37.28751753755604,0.6017628205128205,46.328125,1014.6874999999999,26.0176282051282,0
2409,4,0,0,47,0.0,0.0,1.0,47,1400,900,500,0.6428571428571429,19,9,10,360.98121543177405,0.8435090965155719,0.2644816956610072,0.1973945006788349,128645.99745008688,-112.24229600693991,128533.75515407995,2402,8,603.1489361702128,39,8,17,37.22501026799465,0.6012286324786325,46.380208333333336,1014.4791666666673,26.01228632478634,0
2410,4,0,0,47,0.0,0.0,1.0,47,650,400,250,0.6153846153846154,9,4,5,362.56846383802286,0.8439330866481652,0.260474463716196,0.1983942043697945,128672.41753472215,-69.48784722222791,128602.92968749991,2403,9,604.1489361702128,39,8,17,37.15776865160849,0.6014957264957266,46.354166666666664,1014.5833333333327,26.01495726495725,0
2411,4,0,1,46,0.0,0.02127659574468085,0.9787234042553191,47,1050,500,550,0.47619047619047616,16,5,11,365.33521443289834,0.8447039777983348,0.2689447271282601,0.20084164326438012,128857.43408203125,15.2316623263888,128872.66574435764,2404,10,605.1489361702128,39,8,17,36.89863975240244,0.6033653846153846,46.171875,1015.3125,26.033653846153847,0
2412,4,2,1,47,0.041666666666666664,0.020833333333333332,0.9791666666666666,48,1400,900,500,0.6428571428571429,19,9,10,360.062561367924,0.8498633274231678,0.2677284409935661,0.19981209644313333,129229.25954380188,-292.50103547486464,128936.75850832701,2405,0,593.25,37,11,19,36.65334393759661,0.6106418918918919,45.805921052631575,1016.7763157894731,27.480440967283055,0
2413,4,1,0,48,0.020833333333333332,0.0,1.0,48,1150,900,250,0.782608695652174,14,9,5,365.4559304399528,0.846021719858156,0.2739942528735635,0.20381196120689657,129424.43828870413,-140.21429670668599,129284.22399199744,2406,0,594.2291666666666,37,11,21,36.31734913793104,0.6126126126126126,45.614035087719294,1017.543859649122,27.501185395922217,0
2414,4,1,1,48,0.02040816326530612,0.02040816326530612,0.9795918367346939,49,950,800,150,0.8421052631578947,11,8,3,355.13866167546956,0.8498441043083901,0.24389671705693483,0.19471671247631367,128751.69406466994,-627.2621218187537,128124.43194285118,2407,0,583.0816326530612,39,10,16,37.26532296691643,0.6022970085470087,46.27604166666666,1014.8958333333317,26.022970085470043,3
2415,4,1,0,49,0.02040816326530612,0.0,1.0,49,1050,600,450,0.5714285714285714,15,6,9,355.38887201362394,0.8493480725623583,0.24716785955096188,0.19524351446701116,128830.9950086805,-642.9796006944485,128188.01540798605,2408,0,584.0612244897959,39,10,17,37.17807305561256,0.6030982905982907,46.197916666666664,1015.2083333333329,26.030982905982896,0
2416,4,1,0,50,0.02,0.0,1.0,50,1400,900,500,0.6428571428571429,19,9,10,344.4702876166424,0.8553401360544217,0.24207906295753978,0.19065900035831998,129125.75511975627,-1104.0027990362819,128021.75232071998,2409,0,573.36,41,9,18,37.155014641288425,0.6028963414634146,45.907738095238095,1016.3690476190479,24.789488966318242,0
2417,4,0,1,49,0.0,0.02,0.98,50,1150,700,450,0.6086956521739131,16,7,9,348.2320974021088,0.854812925170068,0.23628264208909378,0.19375991060578873,129333.80126953126,-992.3195352359689,128341.48173429529,2410,1,574.36,39,11,18,36.84769158559481,0.6081730769230769,45.703125,1017.1875000000001,26.081730769230774,0
2418,4,1,1,49,0.02,0.02,0.98,50,750,400,350,0.5333333333333333,11,4,7,346.8560105214026,0.8539285714285714,0.23749258008392182,0.19377530467722281,129492.78564453126,-1016.929796006943,128475.85584852433,2411,0,574.88,39,11,16,36.72101541977962,0.6097756410256411,45.546875,1017.8125000000001,26.097756410256412,0
2419,4,2,3,48,0.0392156862745098,0.058823529411764705,0.9411764705882353,51,1350,1000,350,0.7407407407407407,17,10,7,342.08733457661725,0.8593137254901961,0.23452755990199026,0.19259459313867153,129796.16057117113,-1319.6754783858937,128476.48509278524,2412,0,564.5686274509804,40,11,16,36.53427412652504,0.6111979166666668,45.24898373983739,1019.0040650406494,25.475101626016233,0
2420,4,1,1,48,0.02040816326530612,0.02040816326530612,0.9795918367346939,49,1750,1200,550,0.6857142857142857,23,12,11,356.3026291511772,0.8500921201814059,0.2429245636377253,0.2001971460787553,129717.84056770042,-556.2384715830135,129161.6020961174,2413,0,588.530612244898,38,11,17,36.25174794616327,0.6137609649122806,45.325854700854705,1018.6965811965819,26.807804768331103,0
2421,4,0,1,47,0.0,0.020833333333333332,0.9791666666666666,48,1200,700,500,0.5833333333333334,17,7,10,362.7710110555445,0.8428080673758865,0.24422121975101385,0.2034078398459678,129636.22708013743,-194.34696654247094,129441.88011359495,2414,6,601.7916666666666,38,10,17,36.17005000699398,0.612938596491228,45.40598290598291,1018.376068376069,26.79937022042287,0
2422,4,1,3,45,0.020833333333333332,0.0625,0.9375,48,1300,1100,200,0.8461538461538461,15,11,4,363.04795596968324,0.84232786643026,0.24813858788250576,0.20433458603541088,129784.5106336805,-176.39973958333775,129608.11089409716,2415,0,602.3333333333334,39,9,17,36.01214816329312,0.6127136752136753,45.260416666666664,1018.9583333333329,26.127136752136742,0
2423,4,1,0,46,0.021739130434782608,0.0,1.0,46,1500,1000,500,0.6666666666666666,20,10,10,368.1806897071079,0.8333132045088567,0.2533511453166035,0.20701480289192103,129745.05077069183,353.9244557674086,130098.97522645924,2416,0,624.7826086956521,38,8,18,35.92155166387026,0.6140350877192982,45.2991452991453,1018.803418803419,26.8106162843005,0
2424,4,0,0,46,0.0,0.0,1.0,46,1050,600,450,0.5714285714285714,15,6,9,370.30087340914554,0.8332125603864735,0.2518972456323467,0.20864146671292605,129826.69850107742,414.9879693549487,130241.68647043237,2417,1,625.7826086956521,38,8,18,35.7844550442045,0.6148574561403508,45.21901709401709,1019.123931623931,26.81905083220871,0
2425,4,1,0,47,0.02127659574468085,0.0,1.0,47,1000,600,400,0.6,14,6,8,366.45324269772203,0.8401557200123342,0.2463461743190425,0.2077982979582393,130076.56385633686,133.39572482639267,130209.95958116325,2418,0,613.4468085106383,39,8,19,35.628446339221895,0.6156517094017094,44.973958333333336,1020.1041666666671,26.156517094017104,0
2426,4,0,2,45,0.0,0.0425531914893617,0.9574468085106383,47,1350,1000,350,0.7407407407407407,17,10,7,364.0109890109889,0.8391150169596052,0.1872808043020806,0.19485294117647048,127793.20987654323,-78.39656876929203,127714.81330777393,2419,1,614.4468085106383,38,9,17,38.020833333333336,0.5942982456140351,47.22222222222222,1011.1111111111113,26.60818713450293,6
2427,4,0,0,45,0.0,0.0,1.0,45,1150,700,450,0.6086956521739131,16,7,9,376.36305664789035,0.8289141414141414,0.20224513172966807,0.20058910162002935,127617.73003472216,606.1197916666563,128223.84982638882,2420,14,642.6666666666666,37,8,17,37.88874570446734,0.5943130630630631,47.39583333333333,1010.4166666666661,27.30855855855854,0
2428,4,0,0,45,0.0,0.0,1.0,45,1250,900,350,0.72,16,9,7,373.98099581865165,0.8286616161616162,0.19162871394491487,0.2002818085621138,127811.68845221582,559.8285049245662,128371.51695714038,2421,15,643.6666666666666,37,8,18,37.74985541820287,0.5962837837837839,47.20394736842104,1011.1842105263138,27.32930298719767,0
2429,4,1,0,46,0.021739130434782608,0.0,1.0,46,850,700,150,0.8235294117647058,10,7,3,369.0126899118155,0.8354066022544284,0.1921438416238559,0.19874319818088707,128039.084201389,249.6093750000087,128288.69357638902,2422,0,630.6521739130435,39,7,19,37.6423768354604,0.59508547008547,46.97916666666667,1012.0833333333344,25.950854700854727,0
2430,4,1,1,46,0.02127659574468085,0.02127659574468085,0.9787234042553191,47,950,700,250,0.7368421052631579,12,7,5,362.42962475910747,0.8359543632439099,0.18755573427317795,0.19627058848333356,128258.57688347128,-102.88481048616669,128155.69207298511,2423,0,618.2127659574468,36,11,19,37.584306095979244,0.6027199074074074,46.762387387387385,1012.9504504504501,28.137512512512505,0
2431,4,2,1,47,0.041666666666666664,0.020833333333333332,0.9791666666666666,48,1200,800,400,0.6666666666666666,16,8,8,358.5109970845047,0.8454122340425532,0.19677377220480619,0.195899895689826,128616.79945993003,-377.89259676053666,128238.9068631695,2424,0,606.2916666666666,37,11,16,37.31747468742119,0.6044481981981982,46.40899122807018,1014.3640350877198,27.415244191559996,0
2432,4,1,1,47,0.020833333333333332,0.020833333333333332,0.9791666666666666,48,750,500,250,0.6666666666666666,10,5,5,357.89494267303974,0.8445257092198581,0.19927879553590255,0.19603726444685854,128713.06911571318,-386.84870151218047,128326.220414201,2425,0,607.2708333333334,38,10,17,37.234812592124655,0.6036184210526316,46.314102564102555,1014.7435897435884,26.70377867746285,0
2433,4,0,0,47,0.0,0.0,1.0,47,1400,1000,400,0.7142857142857143,18,10,8,366.06941086948353,0.8388837496145544,0.19907829014543177,0.20016986934778147,128644.60699445989,18.57109879963909,128663.17809325953,2426,1,621.1276595744681,37,10,17,37.09738434932988,0.6047297297297296,46.381578947368425,1014.4736842105268,27.41820768136559,0
2434,4,0,0,47,0.0,0.0,1.0,47,1000,400,600,0.4,16,4,12,368.9336182467827,0.8397702744372494,0.19937571933344356,0.20263625668097865,128821.50472094389,105.31676893857212,128926.82148988247,2427,2,622.1276595744681,38,9,20,36.84399775485862,0.6047149122807017,46.20726495726496,1015.1709401709408,26.715024741340546,0
2435,4,0,0,47,0.0,0.0,1.0,47,1300,900,400,0.6923076923076923,17,9,8,365.81196581196565,0.838691026827012,0.19146753955264573,0.20150659133709972,128936.76757812503,33.32248263889045,128970.09006076392,2428,3,623.1276595744681,39,8,20,36.80555555555554,0.6041666666666666,46.09375,1015.6250000000002,26.04166666666667,0
2436,4,1,0,48,0.020833333333333332,0.0,1.0,48,1200,700,500,0.5833333333333334,17,7,10,358.65406109580505,0.8409426713947991,0.20740128124343649,0.1997136824417692,129364.36760355023,-320.04630485700784,129044.32129869322,2429,0,611.125,38,10,21,36.55153854232306,0.6101973684210527,45.67307692307692,1017.3076923076917,26.77125506072873,0
2437,4,1,0,49,0.02040816326530612,0.0,1.0,49,800,500,300,0.625,11,5,6,351.6845927265811,0.8431476757369615,0.21732533897084738,0.19753725630518318,129704.91672092026,-676.9558376736014,129027.96088324666,2430,0,599.6326530612245,39,10,18,36.38249054095512,0.6119123931623931,45.33854166666667,1018.6458333333343,26.119123931623957,0
2438,4,2,1,50,0.0392156862745098,0.0196078431372549,0.9803921568627451,51,1350,1000,350,0.7407407407407407,17,10,7,344.36305928905415,0.8540849673202615,0.23129173909065992,0.19595172311757664,130211.95515243118,-1231.9625535399477,128979.99259889123,2431,0,577.0784313725491,41,10,19,36.0545457490928,0.6138211382113821,44.841269841269835,1020.6349206349194,24.89353464963218,0
2439,4,3,2,51,0.05660377358490566,0.03773584905660377,0.9622641509433962,53,950,700,250,0.7368421052631579,12,7,5,330.5216970247667,0.8555273343009192,0.2317048792114531,0.19039911842694307,130688.28125,-1960.898132401107,128727.38311759889,2432,0,556.2452830188679,39,14,17,35.92603911980441,0.6217948717948718,44.375,1022.5,26.21794871794872,0
2440,4,0,1,50,0.0,0.0196078431372549,0.9803921568627451,51,1450,1100,350,0.7586206896551724,18,11,7,342.01144820051337,0.8508169934640524,0.23444534652003868,0.19610296706173339,130508.09500328744,-1272.9474852070866,129235.14751808035,2433,1,579.0588235294117,38,13,17,35.8146434546215,0.6217105263157894,44.55128205128206,1021.7948717948727,26.88933873144402,0
2441,4,0,0,50,0.0,0.0,1.0,50,1300,700,600,0.5384615384615384,19,7,12,353.5967308264369,0.8463095238095237,0.2511139729555698,0.20263310810828639,130486.5499480608,-772.076504309036,129714.47344375176,2434,2,591.46,37,13,21,35.5405308721471,0.6233108108108109,44.57236842105262,1021.7105263157883,27.613798008534822,0
2442,4,0,0,50,0.0,0.0,1.0,50,1200,800,400,0.6666666666666666,16,8,8,354.9799109644675,0.8471938775510204,0.25371085371085433,0.20431065986621536,130654.64854570616,-724.0448984303064,129930.60364727586,2435,3,592.46,37,13,17,35.33488845988847,0.625,44.407894736842096,1022.3684210526299,27.631578947368375,0
2443,4,0,0,50,0.0,0.0,1.0,50,1350,1100,250,0.8148148148148148,16,11,5,353.17596332920493,0.8470238095238095,0.24951972555746194,0.203862957050422,130766.77439212041,-763.2636965220306,130003.51069559838,2436,4,593.46,37,13,17,35.267474271012006,0.6261261261261262,44.298245614035075,1022.8070175438577,27.64343290659075,0
2444,4,0,0,50,0.0,0.0,1.0,50,1850,1400,450,0.7567567567567568,23,14,9,352.9617034469789,0.8456802721088436,0.2510853959069972,0.20448116562822172,130906.99932912036,-758.968504732239,130148.03082438812,2437,5,594.46,37,13,17,35.13105378763527,0.6275337837837839,44.16118421052631,1023.3552631578935,27.658250355618744,0
2445,4,1,2,49,0.0196078431372549,0.0392156862745098,0.9607843137254902,51,1350,1000,350,0.7407407407407407,17,10,7,347.67664749818243,0.8455228758169936,0.2574525745257452,0.20363917924893535,131328.125,-1066.7029759156667,130261.42202408433,2438,0,583.7843137254902,36,15,19,34.84078590785908,0.6336805555555556,43.75,1025.0,28.47222222222222,0
2446,4,0,0,49,0.0,0.0,1.0,49,1100,900,200,0.8181818181818182,13,9,4,362.1573838021239,0.8377621882086168,0.25861965170566203,0.21079746833384733,131088.00048828128,-305.10253906249886,130782.89794921878,2439,1,607.795918367347,39,10,19,34.71258010375342,0.625801282051282,43.984375,1024.0625000000002,26.258012820512825,0
2447,4,0,0,49,0.0,0.0,1.0,49,1050,800,250,0.7619047619047619,13,8,5,363.55586547634306,0.837124433106576,0.26102113443242025,0.2122001149531061,131194.69536675367,-260.6797960069247,130934.01557074675,2440,2,608.795918367347,39,10,19,34.568823080833766,0.626869658119658,43.88020833333334,1024.4791666666683,26.268696581196625,0
2448,4,0,0,49,0.0,0.0,1.0,49,1700,1200,500,0.7058823529411765,22,12,10,354.6467894494487,0.8370535714285714,0.21898745232757877,0.20945535918683253,131645.74361100968,-456.82313899097016,131188.9204720187,2441,3,609.795918367347,36,13,19,34.34150846775668,0.6368634259259258,43.44031531531532,1026.238738738739,28.506631631631635,4
2449,4,0,0,49,0.0,0.0,1.0,49,1350,1000,350,0.7407407407407407,17,10,7,353.0667905539714,0.8348214285714286,0.2137955423450364,0.20931488922438965,131790.2425229284,-493.8484092200213,131296.39411370837,2442,4,610.795918367347,36,13,20,34.236309132119615,0.6383101851851851,43.29954954954955,1026.8018018018024,28.52227227227229,0
2450,4,1,0,50,0.02,0.0,1.0,50,950,700,250,0.7368421052631579,12,7,5,344.7504403694039,0.8374659863945578,0.21557126520428316,0.20558924277205798,132013.445158978,-897.66132935204,131115.78382962596,2443,0,599.56,38,12,21,34.225014727795674,0.6367872807017544,43.082264957264954,1027.67094017094,27.04397210976158,0
2451,4,0,0,50,0.0,0.0,1.0,50,1400,1300,100,0.9285714285714286,15,13,2,348.446993488846,0.837891156462585,0.2103117206982541,0.2085481259537723,132150.7232084157,-790.4955621301618,131360.22764628555,2444,1,600.56,38,12,21,33.99184330839566,0.638157894736842,42.948717948717956,1028.2051282051298,27.058029689608677,0
2452,4,0,1,49,0.0,0.02,0.98,50,1250,900,350,0.72,16,9,7,350.1483937672574,0.8374489795918367,0.21331915324622663,0.20989769834026306,132210.4614257813,-741.3438585069434,131469.11756727437,2445,2,601.56,39,11,21,33.88798153212464,0.6370192307692308,42.890625,1028.4375000000005,26.37019230769232,0
2453,4,0,0,49,0.0,0.0,1.0,49,1550,1200,350,0.7741935483870968,19,12,7,356.42892507216385,0.8291524943310657,0.2207202432188331,0.2136354192244489,132205.6544031704,-375.6161425232017,131830.03826064718,2446,3,614.5510204081633,38,11,21,33.731343929635,0.6387061403508772,42.89529914529914,1028.418803418803,27.06365272154745,0
2454,4,1,0,50,0.02,0.0,1.0,50,1300,1000,300,0.7692307692307693,16,10,6,349.89490377333453,0.8330612244897959,0.22559746364928346,0.21209335220773323,132629.89921932088,-718.2753604595873,131911.6238588613,2447,0,603.24,36,14,17,33.472723297255946,0.6467013888888888,42.48310810810812,1030.0675675675693,28.612987987988035,0
2455,4,0,0,50,0.0,0.0,1.0,50,1200,700,500,0.5833333333333334,17,7,10,352.50476275792045,0.8329421768707482,0.23270819672131182,0.21417122040072878,132716.9124360849,-643.3312535508235,132073.58118253408,2448,1,604.24,36,14,17,33.31807832422587,0.6475694444444444,42.39864864864866,1030.4054054054068,28.62237237237241,0
2456,4,0,1,49,0.0,0.02,0.98,50,1100,1000,100,0.9090909090909091,12,10,2,354.70191545142137,0.8331462585034013,0.23173917668333144,0.21610840616712992,132821.5187004656,-577.5905807556089,132243.92811970998,2449,2,605.24,37,13,17,33.156379640463776,0.6466779279279279,42.29714912280702,1030.8114035087724,27.859767662399253,0
2457,4,0,0,49,0.0,0.0,1.0,49,1500,1300,200,0.8666666666666667,17,13,4,360.4399485025224,0.8294359410430839,0.22786848320357533,0.21916185838847752,132745.92318247317,-230.61325683790034,132515.30992563526,2450,3,618.469387755102,36,13,17,33.08449896186208,0.6478587962962963,42.370495495495504,1030.5180180180193,28.625500500500536,0
2458,4,0,0,49,0.0,0.0,1.0,49,1050,900,150,0.8571428571428571,12,9,3,352.6291639005407,0.829577664399093,0.27623144068646077,0.20929814633032076,131834.36850761762,-488.10285378026765,131346.26565383736,2451,4,619.469387755102,37,12,16,34.203057157093035,0.6368243243243243,43.25657894736842,1026.9736842105256,27.756045519203393,3
2459,4,0,0,49,0.0,0.0,1.0,49,1450,900,550,0.6206896551724138,20,9,11,356.1649669769016,0.8291170634920635,0.27965452392561163,0.212972112906596,132116.03570329316,-388.97930132350047,131727.05640196966,2452,5,620.469387755102,37,12,18,33.828391638225256,0.6396396396396395,42.98245614035087,1028.0701754385952,27.785680417259332,0
2460,4,0,0,49,0.0,0.0,1.0,49,1800,1400,400,0.7777777777777778,22,14,8,356.8542471265063,0.8289753401360545,0.2869009300324845,0.21466978476423373,132343.03232750745,-354.56536726569004,131988.46696024176,2453,6,621.469387755102,38,11,18,33.58209600941405,0.6400767543859649,42.761752136752136,1028.9529914529912,27.077710301394507,0
2461,4,0,1,48,0.0,0.02040816326530612,0.9795918367346939,49,1300,1000,300,0.7692307692307693,16,10,6,354.5569587856071,0.8289753401360545,0.2859896066352339,0.2141061879428361,132487.35592689048,-405.1029581803804,132082.2529687101,2454,7,622.469387755102,35,14,20,33.495994940978065,0.6473214285714286,42.62152777777778,1029.5138888888891,29.41468253968255,0
2462,4,0,1,47,0.0,0.020833333333333332,0.9791666666666666,48,1200,900,300,0.75,15,9,6,349.89490377333453,0.828125,0.2822487336467332,0.2120933522077333,132629.89921932085,-318.6948350377159,132311.20438428313,2455,8,632.4583333333334,36,12,16,33.472723297255946,0.6467013888888888,42.48310810810812,1030.067567567569,28.61298798798803,0
2463,4,0,0,47,0.0,0.0,1.0,47,1150,500,650,0.43478260869565216,18,5,13,346.70757448331517,0.8273203823620104,0.27752344238625204,0.21081202751473896,132745.92318247317,-195.19659017123507,132550.72659230194,2456,9,639.0,36,11,17,33.438285433285984,0.6478587962962963,42.370495495495504,1030.5180180180193,28.625500500500536,0
2464,4,1,1,47,0.020833333333333332,0.020833333333333332,0.9791666666666666,48,1250,1000,250,0.8,15,10,5,340.29587844326846,0.8299534574468085,0.27783316071120345,0.20834221346669357,133003.43940618387,-547.8955502593221,132455.54385592454,2457,0,626.6666666666666,38,10,17,33.345201104781644,0.6466557017543859,42.1207264957265,1031.5170940170947,27.145186684660388,0
2465,4,0,0,47,0.0,0.0,1.0,47,1200,700,500,0.5833333333333334,17,7,10,345.66864504608054,0.8253931544865865,0.28094520405346035,0.21076372248529507,132849.77709487543,-215.59951138811107,132634.17758348733,2458,11,641.0,37,10,17,33.36080975678934,0.6469594594594594,42.26973684210527,1030.9210526315796,27.862731152204855,0
2466,4,0,0,47,0.0,0.0,1.0,47,1300,1100,200,0.8461538461538461,15,11,4,346.0456495369946,0.8240826395312981,0.28454449626992284,0.21163233937223486,132962.84072983998,-197.75748307171222,132765.08324676828,2459,12,642.0,37,10,17,33.23764972712453,0.6480855855855856,42.16008771929825,1031.3596491228072,27.874585111427223,0
2467,4,0,0,47,0.0,0.0,1.0,47,1000,600,400,0.6,14,6,8,350.80246500590005,0.8241211840888066,0.2896909477797398,0.21502934157918654,133047.67001625497,-65.30987900123898,132982.36013725374,2460,13,643.0,37,10,17,33.02987830800296,0.6489301801801801,42.07785087719298,1031.6885964912278,27.883475580843996,0
2468,4,1,0,48,0.020833333333333332,0.0,1.0,48,1300,600,700,0.46153846153846156,20,6,14,346.340417115297,0.8273123522458629,0.2927717747216767,0.21457131159013682,133444.62393390673,-356.5466569873642,133088.07727691936,2461,0,630.5833333333334,38,10,20,32.747173680763794,0.6510416666666666,41.69337606837607,1033.2264957264954,27.19017094017093,0
2469,4,2,2,48,0.04,0.04,0.96,50,1200,800,400,0.6666666666666666,16,8,8,333.8129551658107,0.8344897959183674,0.28126099395994464,0.20903734956202752,133840.7145107148,-1064.438552829267,132776.27595788555,2462,0,606.32,37,13,18,32.67490992900285,0.6568130630630631,41.310307017543856,1034.7587719298242,27.966453295400655,0
2470,4,0,0,48,0.0,0.0,1.0,48,1200,1000,200,0.8333333333333334,14,10,4,348.74818605564616,0.8264442966903073,0.28684012271720594,0.21707505736792448,133617.7198101818,-280.21251826150666,133337.50729192028,2463,2,632.5833333333334,36,12,20,32.51166358058309,0.6565393518518519,41.5259009009009,1033.8963963963963,28.719344344344343,0
2471,4,0,0,48,0.0,0.0,1.0,48,1150,800,350,0.6956521739130435,15,8,7,346.73308012290033,0.8252437943262411,0.2852803187048534,0.2161608876285535,133675.94103816646,-330.0258451018689,133345.9151930646,2464,3,633.5833333333334,36,12,20,32.50549021743075,0.6571180555555556,41.46959459459459,1034.121621621621,28.725600600600583,0
2472,4,0,0,48,0.0,0.0,1.0,48,1300,1100,200,0.8461538461538461,15,11,4,343.24878426455024,0.8231752364066194,0.28367303436014657,0.21466484554380003,133792.4215389376,-415.182792589889,133377.23874634772,2465,4,634.5833333333334,36,12,18,32.479091832662085,0.658275462962963,41.35698198198198,1034.5720720720722,28.738113113113116,0
2473,4,0,0,48,0.0,0.0,1.0,48,1400,900,500,0.6428571428571429,19,9,10,341.89532339358203,0.8226396276595744,0.28340904145359613,0.21449555749559135,133908.95276611074,-443.4310577469277,133465.5217083638,2466,5,635.5833333333334,36,12,19,32.397635367932395,0.6594328703703705,41.24436936936937,1035.0225225225229,28.750625625625634,0
2474,4,0,0,48,0.0,0.0,1.0,48,1350,1000,350,0.7407407407407407,17,10,7,342.9473631374209,0.8224918735224586,0.28185168062656407,0.21549658983747855,133967.23740209814,-411.257837229108,133555.97956486902,2467,6,636.5833333333334,36,12,19,32.31217593096197,0.6600115740740741,41.18806306306307,1035.2477477477485,28.756881881881903,0
2475,4,0,0,48,0.0,0.0,1.0,48,1450,1300,150,0.896551724137931,16,13,3,341.0563946535599,0.8205710697399528,0.28259441484542025,0.2149894216332277,134083.84471887437,-453.9694677785823,133629.8752510958,2468,7,637.5833333333334,36,12,19,32.244663114783805,0.6611689814814814,41.075450450450454,1035.698198198199,28.769394394394414,0
2476,4,0,0,48,0.0,0.0,1.0,48,1100,800,300,0.7272727272727273,14,8,6,341.25360393753795,0.8202570921985816,0.2877715762000497,0.2160206169332666,134238.1204433094,-438.15152258387934,133799.9689207255,2469,8,638.5833333333334,37,11,19,32.085559729129194,0.6607545045045045,40.926535087719294,1036.2938596491222,28.00794215267898,0
2477,4,0,0,48,0.0,0.0,1.0,48,950,500,450,0.5263157894736842,14,5,9,340.5325869428911,0.8182439420803782,0.282624788494078,0.2164029665411276,134380.1939058172,-447.83298707294216,133932.36091874426,2470,9,639.5833333333334,37,11,19,31.962510575296108,0.6621621621621622,40.78947368421053,1036.8421052631581,28.022759601706976,0
2478,4,0,0,48,0.0,0.0,1.0,48,1100,700,400,0.6363636363636364,15,7,8,340.31618610014783,0.8176344562647754,0.28714763918252295,0.21694010246006742,134493.906779009,-445.90931825175943,134047.99746075724,2471,10,640.5833333333334,37,11,20,31.854739252995067,0.6632882882882882,40.679824561403514,1037.2807017543867,28.03461356092937,0
2479,4,0,0,48,0.0,0.0,1.0,48,1450,1000,450,0.6896551724137931,19,10,9,341.1235302656407,0.8178006796690307,0.2900769745649263,0.21779425393883228,134550.78125000015,-420.3124999999861,134130.46875000015,2472,11,641.5833333333334,37,11,20,31.777108433734938,0.6638513513513513,40.62500000000001,1037.5000000000011,28.040540540540572,0
2480,4,0,0,48,0.0,0.0,1.0,48,1350,1100,250,0.8148148148148148,16,11,5,339.0272164050443,0.8175051713947991,0.2863226996527777,0.21697741849922844,134638.42220598992,-470.78209966722085,134167.6401063227,2473,12,642.5833333333334,36,12,20,31.744158709490744,0.6666666666666665,40.54054054054055,1037.8378378378388,28.828828828828858,0
2481,4,0,0,48,0.0,0.0,1.0,48,1250,1000,250,0.8,15,10,5,335.14581589594724,0.8168587470449172,0.28319189892636354,0.21535746121090826,134784.55387397553,-565.5041443470301,134219.0497296285,2474,13,643.5833333333334,36,12,15,31.699381845786796,0.6681134259259258,40.399774774774784,1038.4009009009023,28.84446946946951,0
2482,4,0,0,48,0.0,0.0,1.0,48,1350,1100,250,0.8148148148148148,16,11,5,333.6776429111537,0.8159722222222222,0.27870425562660306,0.21545441645494878,134960.01649876242,-593.3719614884976,134366.6445372739,2475,14,644.5833333333334,36,12,15,31.56294028394929,0.669849537037037,40.230855855855864,1039.0765765765777,28.86323823823827,0
2483,4,0,0,48,0.0,0.0,1.0,48,1550,1000,550,0.6451612903225806,21,10,11,333.8077184332263,0.8162492612293144,0.27493635575777264,0.2162371262355869,135077.0549899563,-582.0472922246448,134495.00769773163,2476,15,645.5833333333334,36,12,17,31.44318961470407,0.6710069444444444,40.11824324324325,1039.5270270270278,28.875750750750772,0
2484,4,0,0,48,0.0,0.0,1.0,48,1400,900,500,0.6428571428571429,19,9,10,331.22654011876006,0.8152149822695035,0.2728410936654029,0.21526228698077085,135194.14420755234,-644.0222739631299,134550.1219335892,2477,16,646.5833333333334,36,12,17,31.39392708897311,0.6721643518518517,40.00563063063064,1039.9774774774792,28.888263263263312,0
2485,4,0,2,46,0.0,0.041666666666666664,0.9583333333333334,48,1300,800,500,0.6153846153846154,18,8,10,332.61628342797167,0.8143838652482269,0.2748962842712843,0.2170462188470664,135340.57706355012,-596.7040520249864,134743.87301152514,2478,17,647.5833333333334,36,12,18,31.212346681096676,0.673611111111111,39.86486486486487,1040.5405405405413,28.903903903903924,0
2486,4,0,0,46,0.0,0.0,1.0,46,1650,1200,450,0.7272727272727273,21,12,9,345.94683349689063,0.8098027375201289,0.2806928057088547,0.22505863620717287,135230.9541524942,156.5440759637031,135387.4982284579,2479,18,671.9130434782609,34,12,18,30.974590820647826,0.6767769607843138,39.97023809523809,1040.1190476190466,30.59173669467784,0
2487,4,0,1,45,0.0,0.021739130434782608,0.9782608695652174,46,1250,900,350,0.72,16,9,7,348.647212405633,0.8095813204508857,0.28487137536115803,0.2279897216202279,135416.7534722221,242.5347222222024,135659.2881944443,2480,19,672.9130434782609,34,12,18,30.719575660528417,0.6786151960784315,39.79166666666666,1040.8333333333323,30.612745098039188,0
2488,4,0,0,45,0.0,0.0,1.0,45,1050,700,350,0.6666666666666666,14,7,7,345.2399197172915,0.8058922558922559,0.2651020434081355,0.22693494046630966,135602.68034297033,363.0916950113142,135965.77203798163,2481,20,671.2666666666667,34,11,21,30.623499828551832,0.6804534313725491,39.61309523809523,1041.5476190476177,30.63375350140052,0
2489,4,0,0,45,0.0,0.0,1.0,45,1200,800,400,0.6666666666666666,16,8,8,344.49436245073696,0.8050084175084176,0.26563173781802507,0.22724868610695245,135729.43887266918,351.6088451311909,136081.04771780036,2482,21,672.2666666666667,33,12,22,30.517047904661105,0.6840277777777778,39.49142156862745,1042.0343137254904,31.57679738562092,0
2490,4,0,0,45,0.0,0.0,1.0,45,1450,1100,350,0.7586206896551724,18,11,7,343.3500712832135,0.802946127946128,0.26460750377217357,0.22845684697454804,136037.0057397959,341.66312358276156,136378.66886337864,2483,22,673.2666666666667,34,11,19,30.24173608733691,0.6847426470588236,39.19642857142857,1043.2142857142853,30.682773109243687,0
2491,4,0,0,45,0.0,0.0,1.0,45,1300,900,400,0.6923076923076923,17,9,8,343.6200787197036,0.8016835016835018,0.2620899380393058,0.22984015791709203,136223.35778061204,361.81618480723176,136585.17396541926,2484,23,674.2666666666667,34,11,20,30.04998669555631,0.6865808823529412,39.01785714285713,1043.9285714285697,30.70378151260499,0
2492,4,0,0,45,0.0,0.0,1.0,45,1250,800,450,0.64,17,8,9,343.6123982205071,0.8011784511784512,0.26868802006155224,0.23064357839238772,136347.66333616775,370.1495181405777,136717.81285430834,2485,24,675.2666666666667,34,11,20,29.927048900034197,0.6878063725490196,38.89880952380952,1044.4047619047615,30.717787114845926,0
2493,4,0,1,44,0.0,0.022222222222222223,0.9777777777777777,45,1350,800,550,0.5925925925925926,19,8,11,343.7462020873262,0.8010942760942762,0.2682977483980442,0.23093638415882092,136378.74858276654,375.935374149662,136754.6839569162,2486,25,676.2666666666667,34,11,20,29.89277030620773,0.6881127450980392,38.86904761904762,1044.52380952381,30.72128851540618,0
2494,4,0,0,44,0.0,0.0,1.0,44,1200,800,400,0.6666666666666666,16,8,8,346.6353904433096,0.8008060253699789,0.2614710969786733,0.2334933861796567,136472.02558106568,661.2067743764032,137133.23235544207,2487,26,651.2954545454545,34,10,20,29.724943982378182,0.6890318627450981,38.7797619047619,1044.8809523809518,30.73179271708682,0
2495,4,0,0,44,0.0,0.0,1.0,44,1500,1100,400,0.7333333333333333,19,11,8,349.2897429388197,0.7991102889358703,0.26694352159468493,0.23573141844077292,136539.41213348767,738.3632330246919,137277.77536651236,2488,27,652.2954545454545,35,9,20,29.58887043189369,0.6875,38.71527777777778,1045.138888888889,29.86111111111111,0
2496,4,0,0,44,0.0,0.0,1.0,44,950,600,350,0.631578947368421,13,6,7,350.8321166508846,0.7983174770965469,0.2649770512923746,0.23717931718493926,136599.9014060356,784.7265089163177,137384.62791495194,2489,28,653.2954545454545,35,9,20,29.48866991437851,0.6880952380952381,38.657407407407405,1045.37037037037,29.867724867724856,0
2497,4,0,0,44,0.0,0.0,1.0,44,1300,800,500,0.6153846153846154,18,8,10,360.7257608925921,0.7987579281183933,0.242436974789916,0.24115935700122745,136205.37088334875,1026.5572099107442,137231.92809325948,2490,29,654.2954545454545,37,7,21,29.62141106442577,0.6801801801801801,39.03508771929825,1043.8596491228072,28.21242294926506,4
2498,4,0,1,43,0.0,0.022727272727272728,0.9772727272727273,44,1150,800,350,0.6956521739130435,15,8,7,361.16422455067095,0.797150281888654,0.2420925793366735,0.2424305312787276,136348.48132358046,1048.838705178529,137397.320028759,2491,30,655.2954545454545,37,7,21,29.46795713035869,0.6815878378378377,38.89802631578948,1044.4078947368432,28.22724039829306,0
2499,4,0,0,43,0.0,0.0,1.0,43,1150,700,450,0.6086956521739131,16,7,9,361.94302120307555,0.7956810631229235,0.2347037503070526,0.24369429250523533,136456.05698604044,1277.8635053973308,137733.92049143778,2492,31,656.7674418604652,36,7,22,29.34091399008408,0.6846064814814814,38.795045045045065,1044.8198198198224,29.022772772772846,0
2500,4,0,0,43,0.0,0.0,1.0,43,1250,800,450,0.64,17,8,9,361.7477798008323,0.7947582133628645,0.235545308740978,0.24396943288893375,136514.89327165027,1276.7919101534274,137791.6851818037,2493,32,657.7674418604652,36,7,22,29.287670617816108,0.6851851851851851,38.73873873873875,1045.045045045047,29.02902902902908,0
2501,4,0,0,43,0.0,0.0,1.0,43,1550,1300,250,0.8387096774193549,18,13,5,359.518102887255,0.793235511258767,0.23607894005373753,0.2438893076343277,136720.92013888928,1230.729166666707,137951.649305556,2494,33,658.7674418604652,36,7,22,29.141766268260287,0.6872106481481479,38.541666666666686,1045.8333333333364,29.050925925926013,0
2502,4,0,0,43,0.0,0.0,1.0,43,1150,800,350,0.6956521739130435,15,8,7,361.1969767369104,0.7894518272425248,0.2421558565098758,0.24564567451580546,136809.2649237078,1283.0185760084796,138092.28349971626,2495,34,659.7674418604652,36,7,23,29.01036060279872,0.6880787037037035,38.457207207207226,1046.1711711711735,29.060310310310374,0
2503,4,0,0,43,0.0,0.0,1.0,43,1500,1100,400,0.7333333333333333,19,11,8,359.71639958843383,0.7876984126984127,0.24087057916835475,0.24546286474118284,136927.10235573445,1250.9848530963723,138178.0872088308,2496,35,660.7674418604652,36,7,23,28.93242055806613,0.6892361111111109,38.34459459459461,1046.6216216216242,29.072822822822893,0
2504,4,0,0,43,0.0,0.0,1.0,43,1200,1100,100,0.9166666666666666,13,11,2,359.9407035702724,0.7871908453303802,0.24064777084881084,0.24623758065436566,137015.5137189557,1263.4920816086687,138279.0058005644,2497,36,661.7674418604652,36,7,21,28.839052023950384,0.6901041666666665,38.26013513513515,1046.9594594594616,29.08220720720727,0
2505,4,0,0,43,0.0,0.0,1.0,43,1200,900,300,0.75,15,9,6,360.6312179301897,0.7867755629383536,0.236625030639247,0.24691819324852057,137044.99051416304,1284.5403680708018,138329.53088223384,2498,37,662.7674418604652,36,7,21,28.791810066681023,0.6903935185185184,38.231981981981995,1047.072072072074,29.085335335335387,0
2506,4,0,0,43,0.0,0.0,1.0,43,1300,800,500,0.6153846153846154,18,8,10,360.32602291187914,0.7866371354743448,0.23323984262397213,0.24725820192918624,137122.57617728543,1281.7665050784954,138404.34268236393,2499,38,663.7674418604652,37,6,21,28.72304229480737,0.6891891891891891,38.15789473684211,1047.3684210526324,28.307254623044116,0
2507,4,0,0,43,0.0,0.0,1.0,43,1250,800,450,0.64,17,8,9,358.02099771599626,0.7856681432262828,0.2348654667591541,0.2462844228348703,137208.72197455,1224.7207073330414,138433.44268188303,2500,39,664.7674418604652,37,6,22,28.69821646607361,0.6900337837837837,38.07565789473685,1047.6973684210539,28.316145092460914,0
2508,4,0,1,42,0.0,0.023255813953488372,0.9767441860465116,43,1200,800,400,0.6666666666666666,16,8,8,357.1809698469224,0.7852528608342562,0.23033889685144926,0.2461123668945233,137266.16753472228,1205.772569444449,138471.94010416672,2501,40,665.7674418604652,37,6,22,28.66343605036448,0.6905968468468467,38.020833333333336,1047.916666666667,28.322072072072082,0
2509,4,0,0,42,0.0,0.0,1.0,42,900,700,200,0.7777777777777778,11,7,4,362.32809720969493,0.7803668215253581,0.24631997421295826,0.24997684215942426,137310.42433903506,1550.2849555636847,138860.70929459875,2502,41,679.9285714285714,36,6,23,28.48483220515024,0.6929976851851851,37.97860360360361,1048.0855855855864,29.11348848848851,0
2510,4,0,0,42,0.0,0.0,1.0,42,1100,800,300,0.7272727272727273,14,8,6,362.9288121783311,0.779979674796748,0.24571285325475256,0.2506039602192812,137339.93283824384,1568.9237379271383,138908.85657617098,2503,42,680.9285714285714,36,6,23,28.439917275461962,0.693287037037037,37.95045045045046,1048.1981981981999,29.116616616616664,0
2511,4,0,0,42,0.0,0.0,1.0,42,1000,800,200,0.8,12,8,4,364.4683602100088,0.779447348044909,0.2471878213096388,0.2518809179803248,137369.44450785258,1613.3632365473754,138982.80774439996,2504,43,681.9285714285714,36,6,23,28.37039424213129,0.6935763888888888,37.922297297297305,1048.3108108108117,29.11974474474477,0
2512,4,0,0,42,0.0,0.0,1.0,42,1400,1200,200,0.8571428571428571,16,12,4,366.02791754883145,0.7786488579171505,0.2513420657075369,0.25403755767882397,137517.05041189844,1667.015917944978,139184.06632984342,2505,44,682.9285714285714,36,6,23,28.183603535895788,0.6950231481481481,37.781531531531535,1048.8738738738743,29.135385385385398,0
2513,4,0,0,42,0.0,0.0,1.0,42,1300,1100,200,0.8461538461538461,15,11,4,362.03928541786223,0.7773906310491676,0.2567346646844555,0.2527766426501794,137723.83183436815,1572.2875324648971,139296.11936683304,2506,45,683.9285714285714,36,6,23,28.083985981475518,0.6970486111111112,37.58445945945946,1049.6621621621623,29.157282282282285,0
2514,4,0,0,42,0.0,0.0,1.0,42,1050,600,450,0.5714285714285714,15,6,9,360.9221466364324,0.7770034843205574,0.2537792894935753,0.2526455026455026,137812.5,1547.9737338690052,139360.473733869,2507,46,684.9285714285714,34,8,23,28.025793650793645,0.7022058823529411,37.5,1050.0,30.88235294117647,0
2515,4,0,0,42,0.0,0.0,1.0,42,1050,800,250,0.7619047619047619,13,8,5,354.59237761019057,0.7765921409214093,0.24675396213349288,0.24931332390144825,137964.4515844692,1384.2285826045852,139348.6801670738,2508,47,685.9285714285714,35,7,23,28.04214406375086,0.7014880952380953,37.35532407407407,1050.578703703703,30.01653439153437,0
2516,4,0,0,42,0.0,0.0,1.0,42,1500,1100,400,0.7333333333333333,19,11,8,354.62213580561354,0.7762775842044135,0.24629402322726857,0.24955501929018273,137994.85194830238,1387.2058256172766,139382.05777391966,2509,48,686.9285714285714,35,7,23,28.011401189689373,0.7017857142857142,37.326388888888886,1050.694444444444,30.019841269841255,0
2517,4,0,0,42,0.0,0.0,1.0,42,1000,800,200,0.8,12,8,4,353.7115022608627,0.7748741773132017,0.24443045940843278,0.24935562426464536,138055.662722908,1366.375171467749,139422.03789437574,2510,49,687.9285714285714,35,7,20,27.97540381791482,0.7023809523809523,37.26851851851851,1050.9259259259252,30.026455026455004,0
2518,4,0,0,42,0.0,0.0,1.0,42,1350,900,450,0.6666666666666666,18,9,9,351.71098930952996,0.773301393728223,0.2386560171063805,0.24927036262608315,138238.1754222392,1323.9770876200062,139562.1525098592,2511,50,688.9285714285714,35,7,21,27.848246386381973,0.7041666666666667,37.0949074074074,1051.620370370369,30.04629629629626,0
2519,4,0,0,42,0.0,0.0,1.0,42,900,700,200,0.7777777777777778,11,7,4,351.71098930952996,0.77347077042199,0.2386560171063805,0.24927036262608315,138238.1754222392,1323.9770876200062,139562.1525098592,2512,51,689.9285714285714,35,7,21,27.848246386381973,0.7041666666666667,37.0949074074074,1051.620370370369,30.04629629629626,0
2520,4,0,0,42,0.0,0.0,1.0,42,1000,600,400,0.6,14,6,8,352.5427432553065,0.7728174603174603,0.24415241448692182,0.2503053477112675,138299.03978052118,1351.264574759933,139650.3043552811,2513,52,690.9285714285714,35,7,21,27.766468603286384,0.7047619047619047,37.03703703703703,1051.851851851851,30.05291005291003,0
2521,4,0,0,42,0.0,0.0,1.0,42,1250,900,350,0.72,16,9,7,357.95285068218647,0.7701558265582655,0.2555374029972668,0.25551202700971787,138481.71323088143,1513.9848036694202,139995.69803455085,2514,53,691.9285714285714,35,7,21,27.44437724507001,0.706547619047619,36.86342592592593,1052.546296296297,30.072751322751344,0
2522,4,0,0,42,0.0,0.0,1.0,42,1550,1100,450,0.7096774193548387,20,11,9,357.5339200923966,0.768970189701897,0.2568847275893147,0.2566396588353174,138671.0966667681,1515.9241589562555,140187.02082572435,2515,54,692.9285714285714,36,6,21,27.2691026052247,0.7063078703703705,36.68355855855856,1053.2657657657658,29.25738238238238,0
2523,4,0,0,42,0.0,0.0,1.0,42,1050,700,350,0.6666666666666666,14,7,7,358.3556780187407,0.7680023228803716,0.26047934675259876,0.2574546092309754,138700.7510043827,1540.8403335768164,140241.59133795951,2516,55,693.9285714285714,36,6,21,27.218302330553772,0.7065972222222223,36.6554054054054,1053.378378378378,29.260510510510503,0
2524,4,0,0,42,0.0,0.0,1.0,42,1000,500,500,0.5,15,5,10,357.72093975123465,0.7665021293070073,0.2613497844507209,0.25769851806666905,138792.85573445674,1529.8221568174802,140322.67789127422,2517,56,694.9285714285714,37,5,21,27.144467568505025,0.7055180180180181,36.56798245614035,1053.7280701754385,28.47913703176861,0
2525,4,0,0,42,0.0,0.0,1.0,42,1150,800,350,0.6956521739130435,15,8,7,357.99369378707354,0.7644938056523423,0.2688055117456627,0.25952280834353564,139005.32735306138,1552.7984859228723,140558.12583898424,2518,57,695.9285714285714,33,9,22,26.928505713732317,0.7162247474747474,36.36642156862745,1054.5343137254906,31.955585264408807,0
2526,4,0,0,42,0.0,0.0,1.0,42,2100,1500,600,0.7142857142857143,27,15,12,354.91366121855106,0.7633081687959736,0.2663055743624463,0.2582302845417733,139128.125,1475.694444444445,140603.81944444444,2519,58,696.9285714285714,34,8,22,26.889152185360707,0.7150735294117647,36.25,1055.0,31.029411764705884,0
2527,4,0,0,42,0.0,0.0,1.0,42,1150,900,250,0.782608695652174,14,9,5,368.0613322178546,0.762461285327139,0.24654642639130375,0.24885020735457744,136603.17147806604,1655.6690558802202,138258.84053394626,2520,59,697.9285714285714,36,6,21,29.035153865488883,0.6860532407407407,38.65427927927929,1045.3828828828841,29.038413413413448,4
2528,4,0,0,42,0.0,0.0,1.0,42,1300,900,400,0.6923076923076923,17,9,8,366.9013752604178,0.760670731707317,0.2395416725946773,0.2491125265385722,136751.18319455168,1634.890162916152,138386.07335746783,2521,60,698.9285714285714,35,7,21,28.918727638228045,0.6895833333333332,38.51273148148149,1045.9490740740746,29.884259259259274,0
2529,4,0,0,42,0.0,0.0,1.0,42,1650,1100,550,0.6666666666666666,22,11,11,356.189853864935,0.7596544715447154,0.22860943026688885,0.2387791242576046,136302.2374260355,1309.894806048655,137612.13223208417,2522,61,699.9285714285714,38,4,19,29.64369756496829,0.6792763157894737,38.94230769230769,1044.2307692307693,27.479757085020243,1
2530,4,0,0,42,0.0,0.0,1.0,42,950,800,150,0.8421052631578947,11,8,3,357.6443866683625,0.7577429345722029,0.23124972603340166,0.240322279619009,136385.9226043722,1355.531928007893,137741.4545323801,2523,62,700.9285714285714,38,4,20,29.522731921857407,0.6800986842105263,38.86217948717949,1044.5512820512827,27.48819163292849,0
2531,4,0,0,42,0.0,0.0,1.0,42,1250,700,550,0.56,18,7,11,358.0859217852463,0.7564847077042199,0.2324258401857826,0.24138100627026146,136497.54279211414,1375.5696864270585,137873.1124785412,2524,63,701.9285714285714,38,4,20,29.400538458916945,0.6811951754385964,38.75534188034188,1044.9786324786326,27.49943769680612,0
2532,4,0,0,42,0.0,0.0,1.0,42,1350,800,550,0.5925925925925926,19,8,11,356.82591913332584,0.7562427409988386,0.22741344314481426,0.24091290316641295,136553.37000739636,1345.1563527284588,137898.52636012482,2525,64,702.9285714285714,38,4,20,29.37813043033836,0.6817434210526316,38.70192307692307,1045.192307692307,27.50506072874492,0
2533,4,1,1,42,0.023255813953488372,0.023255813953488372,0.9767441860465116,43,1200,1000,200,0.8333333333333334,14,10,4,347.4148457705155,0.7625968992248062,0.21338507250227234,0.23625695249440393,136806.93969538694,905.9578278580342,137712.897523245,2526,0,687.5581395348837,37,6,20,29.37312213953813,0.6860923423423424,38.4594298245614,1046.1622807017536,28.27465623518253,0
2534,4,0,0,42,0.0,0.0,1.0,42,1350,1100,250,0.8148148148148148,16,11,5,355.85496108451474,0.7560975609756098,0.22548808498420914,0.24160678936790725,136750.36523009487,1332.6591794497087,138083.0244095446,2527,66,704.9285714285714,36,6,20,29.208387166236,0.6875,38.51351351351351,1045.9459459459451,29.05405405405403,0
2535,4,0,0,42,0.0,0.0,1.0,42,1200,1000,200,0.8333333333333334,14,10,4,359.2055358374188,0.7563395276809911,0.22988541090133907,0.24470218761006532,136868.1772989204,1432.761393149891,138300.93869207028,2528,67,705.9285714285714,36,6,20,29.004116444253118,0.6886574074074074,38.40090090090089,1046.3963963963952,29.066566566566532,0
2536,4,0,0,42,0.0,0.0,1.0,42,950,600,350,0.631578947368421,13,6,7,359.2055358374188,0.7563395276809911,0.22988541090133907,0.24470218761006532,136868.1772989204,1432.761393149891,138300.93869207028,2529,68,706.9285714285714,36,6,20,29.004116444253118,0.6886574074074074,38.40090090090089,1046.3963963963952,29.066566566566532,0
2537,4,0,0,42,0.0,0.0,1.0,42,1450,1100,350,0.7586206896551724,18,11,7,358.9242481358923,0.7565572977158344,0.22726620768789396,0.2453352801964158,136986.0400941482,1433.5222891810663,138419.56238332926,2530,69,707.9285714285714,36,6,15,28.894820352839915,0.6898148148148149,38.288288288288285,1046.8468468468468,29.07907907907908,0
2538,4,0,0,42,0.0,0.0,1.0,42,1100,1000,100,0.9090909090909091,12,10,2,358.18614868770965,0.7568476577622919,0.22218637992831547,0.24565864179909278,137103.95361577783,1421.7474230987627,138525.7010388766,2531,70,708.9285714285714,36,6,16,28.797491039426514,0.6909722222222223,38.17567567567567,1047.2972972972966,29.091591591591573,0
2539,4,0,0,42,0.0,0.0,1.0,42,1350,1100,250,0.8148148148148148,16,11,5,360.1511195071274,0.7569444444444444,0.22543419173538526,0.24763384070767208,137192.42204620148,1482.0008775667438,138674.42292376823,2532,71,709.9285714285714,36,6,17,28.65854204736823,0.6918402777777779,38.09121621621621,1047.635135135134,29.100975975975945,0
2540,4,0,0,42,0.0,0.0,1.0,42,1300,800,500,0.6153846153846154,18,8,10,361.10426713905196,0.7562185443283004,0.22904127257093743,0.24849956371758405,137221.9178638096,1510.284017125216,138732.2018809348,2533,72,710.9285714285714,36,6,17,28.604408498137005,0.6921296296296298,38.063063063063055,1047.7477477477464,29.104104104104067,0
2541,4,1,1,42,0.023255813953488372,0.023255813953488372,0.9767441860465116,43,950,700,250,0.7368421052631579,12,7,5,354.7492068055011,0.7581210778885197,0.22877010418312937,0.24606063546733975,137496.0700047129,1155.3243546091028,138651.394359322,2534,0,695.3720930232558,37,6,17,28.50006534239415,0.6928490990990992,37.801535087719294,1048.7938596491222,28.345779990516814,0
2542,4,0,0,42,0.0,0.0,1.0,42,1100,700,400,0.6363636363636364,15,7,8,360.4603686594072,0.7556378242353852,0.23797324011691923,0.24960771220057265,137438.57635282,1508.2319800323057,138946.80833285232,2535,74,712.9285714285714,37,5,17,28.407120324863183,0.6922860360360361,37.8563596491228,1048.574561403508,28.33985301090562,0
2543,4,0,0,42,0.0,0.0,1.0,42,1100,900,200,0.8181818181818182,13,9,4,360.20253837863345,0.7554684475416182,0.24359123549633765,0.25071219910818965,137616.25580986543,1513.944932975368,139130.2007428408,2536,75,713.9285714285714,38,4,17,28.238383735532704,0.6921600877192983,37.686965811965806,1049.2521367521356,27.611898335582516,0
2544,4,0,0,42,0.0,0.0,1.0,42,850,600,250,0.7058823529411765,11,6,5,361.2383047080953,0.7522744870305846,0.24143584800461193,0.252465994094881,137757.81792534728,1552.680121527783,139310.49804687506,2537,76,714.9285714285714,39,3,18,28.07145928424952,0.6917735042735043,37.552083333333336,1049.791666666667,26.91773504273505,0
2545,4,0,0,42,0.0,0.0,1.0,42,900,500,400,0.5555555555555556,13,5,8,363.0036199713133,0.7505565234223771,0.24584809130263663,0.2547763226016758,137903.66090374227,1611.9490258487629,139515.60992959104,2538,77,715.9285714285714,35,7,19,27.881198347107425,0.7008928571428572,37.41319444444444,1050.3472222222222,30.009920634920633,0
2546,4,0,0,42,0.0,0.0,1.0,42,900,600,300,0.6666666666666666,12,6,6,361.56091211506,0.7492499032133179,0.24786923250410386,0.25466342289314436,138025.2556611154,1580.907466349449,139606.16312746485,2539,78,716.9285714285714,35,7,20,27.799156478319933,0.7020833333333334,37.2974537037037,1050.8101851851852,30.02314814814815,0
2547,4,0,0,42,0.0,0.0,1.0,42,900,600,300,0.6666666666666666,12,6,6,357.91218467712326,0.7472657762291909,0.24895066733987226,0.2533605813745488,138197.05843935144,1492.4822203960648,139689.5406597475,2540,79,717.9285714285714,36,6,17,27.725714897718756,0.7016782407407408,37.134009009009006,1051.4639639639634,29.207332332332314,0
2548,4,0,0,42,0.0,0.0,1.0,42,1150,800,350,0.6956521739130435,15,8,7,356.68044917094835,0.7457413859852884,0.24785148484570474,0.25358514125989334,138345.1081994156,1468.9990666341996,139814.1072660498,2541,80,718.9285714285714,36,6,18,27.612306429743807,0.703125,36.99324324324324,1052.0270270270269,29.22297297297297,0
2549,4,0,1,41,0.0,0.023809523809523808,0.9761904761904762,42,1400,1100,300,0.7857142857142857,17,11,6,356.68044917094835,0.7457413859852884,0.24785148484570474,0.25358514125989334,138345.1081994156,1468.9990666341996,139814.1072660498,2542,81,719.9285714285714,36,6,18,27.612306429743807,0.703125,36.99324324324324,1052.0270270270269,29.22297297297297,0
2550,4,0,0,41,0.0,0.0,1.0,41,1250,1000,250,0.8,15,10,5,355.0229720302041,0.7445630081300812,0.23325894896188126,0.2530655738842302,138433.97610025565,1629.4483250142005,140063.42442526986,2543,82,721.9512195121952,36,5,19,27.56844123417156,0.7039930555555556,36.90878378378378,1052.3648648648648,29.232357357357355,0
2551,4,0,0,41,0.0,0.0,1.0,41,1000,700,300,0.7,13,7,6,355.4093717274377,0.7428861788617886,0.23481316640099714,0.25422511218667293,138552.51102031092,1648.572178597522,140201.08319890845,2544,83,722.9512195121952,36,5,20,27.441660427140146,0.705150462962963,36.796171171171174,1052.815315315316,29.244869869869888,0
2552,4,0,0,41,0.0,0.0,1.0,41,800,500,300,0.625,11,5,6,351.58709485195413,0.7422764227642277,0.22884010086759687,0.2523709975556659,138671.0966667681,1550.9936034006994,140222.09027016882,2545,84,723.9512195121952,36,5,21,27.425692291243454,0.7063078703703705,36.68355855855856,1053.2657657657658,29.25738238238238,0
2553,4,0,0,41,0.0,0.0,1.0,41,1850,1600,250,0.8648648648648649,21,16,5,351.6863204760277,0.7417682926829269,0.23534009557138558,0.2535676838781019,138821.74232696585,1564.3415522083562,140386.0838791742,2546,85,724.9512195121952,37,4,21,27.27506242846738,0.7057995495495496,36.54057017543859,1053.8377192982443,28.48210052157417,0
2554,4,0,0,41,0.0,0.0,1.0,41,1050,600,450,0.5714285714285714,15,6,9,351.9739943869225,0.7402439024390244,0.23626895634429967,0.2549005452399814,138971.17524092973,1582.9290856173993,140554.10432654712,2547,86,725.9512195121952,34,7,21,27.120733130104256,0.7135416666666666,36.398809523809526,1054.4047619047622,31.01190476190477,0
2555,4,0,1,40,0.0,0.024390243902439025,0.975609756097561,41,850,600,250,0.7058823529411765,11,6,5,354.53759752250124,0.7375,0.24382538533723364,0.25819775898454617,139159.52558106574,1667.4567743764173,140826.98235544216,2548,87,726.9512195121952,34,7,17,26.868253789160924,0.7153799019607843,36.220238095238095,1055.1190476190475,31.032913165266102,0
2556,4,0,0,40,0.0,0.0,1.0,40,800,700,100,0.875,9,7,2,355.022972030204,0.7360844017094017,0.237568218298555,0.25306557388423023,138433.97610025576,1829.4483250142162,140263.42442526997,2549,88,708.4,36,4,17,27.56844123417157,0.7039930555555556,36.90878378378379,1052.3648648648657,29.23235735735738,2
2557,4,0,0,40,0.0,0.0,1.0,40,900,400,500,0.4444444444444444,14,4,10,355.022972030204,0.7360844017094017,0.237568218298555,0.25306557388423023,138433.97610025576,1829.4483250142162,140263.42442526997,2550,89,709.4,36,4,17,27.56844123417157,0.7039930555555556,36.90878378378379,1052.3648648648657,29.23235735735738,0
2558,4,0,0,40,0.0,0.0,1.0,40,1150,800,350,0.6956521739130435,15,8,7,367.4097801113542,0.7360844017094017,0.2289111700364599,0.25250006983962564,137175.2176167053,2089.6205846542007,139264.83820135953,2551,90,710.4,35,5,17,28.48545740802121,0.6937499999999999,38.10763888888889,1047.569444444445,29.93055555555557,3
2559,4,0,1,39,0.0,0.025,0.975,40,1200,600,600,0.5,18,6,12,365.71104177567486,0.7357905982905983,0.2270987517949854,0.2517704989502042,137235.84754640356,2037.7329550325946,139273.58050143614,2552,91,711.4,35,5,18,28.46995931367135,0.694345238095238,38.049768518518526,1047.8009259259268,29.937169312169335,0
2560,4,0,0,39,0.0,0.0,1.0,39,1250,600,650,0.48,19,6,13,391.6741245053706,0.7345366621682411,0.21990552504865368,0.24016784080194556,133060.97902549486,2652.2503762723436,135713.2294017672,2553,92,717.974358974359,33,6,18,31.962302529991675,0.6575126262626263,42.06495098039215,1031.7401960784302,31.2648544266191,8
2561,4,0,0,39,0.0,0.0,1.0,39,650,400,250,0.6153846153846154,9,4,5,388.67739110530323,0.7331309041835358,0.21343368101857774,0.23893729838604816,133155.8249831794,2550.931732987291,135706.75671616668,2554,93,718.974358974359,33,6,19,31.944114620438512,0.658459595959596,41.97303921568626,1032.1078431372537,31.275995246583445,0
2562,4,0,0,39,0.0,0.0,1.0,39,950,600,350,0.631578947368421,13,6,7,385.54656392579807,0.7330184435447593,0.20829376384931986,0.23741551568062283,133219.0743944636,2472.4312764321317,135691.5056708957,2555,94,719.974358974359,33,6,19,31.96126147515035,0.6590909090909092,41.91176470588235,1032.3529411764698,31.283422459893025,0
2563,4,0,0,39,0.0,0.0,1.0,39,800,600,200,0.75,10,6,4,384.9843901493063,0.7317251461988304,0.20998496716512394,0.2374728017128882,133282.33882400987,2462.3239859669234,135744.66280997678,2556,95,720.974358974359,33,6,19,31.912137036157926,0.6597222222222223,41.850490196078425,1032.5980392156855,31.29084967320259,0
2564,4,0,0,39,0.0,0.0,1.0,39,950,800,150,0.8421052631578947,11,8,3,382.4410865881582,0.730825461088619,0.20724543775914106,0.2365074041710626,133377.263627571,2401.7891255766854,135779.05275314767,2557,96,721.974358974359,33,6,19,31.882365444694905,0.660669191919192,41.75857843137254,1032.9656862745087,31.30199049316693,0
2565,4,0,0,39,0.0,0.0,1.0,39,950,600,350,0.631578947368421,13,6,7,383.6858943626193,0.7306567701304544,0.19966736295444942,0.2380885317998503,133503.88259623686,2444.7113189638403,135948.5939152007,2558,97,722.974358974359,33,6,20,31.72296829914226,0.6619318181818183,41.636029411764696,1033.4558823529399,31.316844919786057,0
2566,4,0,0,39,0.0,0.0,1.0,39,950,600,350,0.631578947368421,13,6,7,386.5229733704057,0.7299257759784076,0.2013588071679362,0.24025949007954117,133567.21460796334,2525.359387014617,136092.57399497795,2559,98,723.974358974359,33,6,20,31.586025489033794,0.6625631313131313,41.57475490196079,1033.7009803921571,31.324272133095672,0
2567,4,0,0,39,0.0,0.0,1.0,39,950,800,150,0.8421052631578947,11,8,3,386.96545458723176,0.7306005398110662,0.20069162093338422,0.24115321313198415,133662.24078479444,2544.533953287215,136206.77473808164,2560,99,724.974358974359,33,6,21,31.479122224855818,0.6635101010101009,41.48284313725491,1034.0686274509815,31.335412953060043,0
2568,4,0,0,39,0.0,0.0,1.0,39,950,500,450,0.5263157894736842,14,5,9,388.0764133779565,0.7297008547008548,0.2003159557661931,0.24226071959393153,133725.6103421762,2579.1510476739873,136304.76138985017,2561,100,725.974358974359,33,6,16,31.386749605055293,0.6641414141414141,41.42156862745099,1034.313725490197,31.342840166369605,0
2569,4,1,0,40,0.025,0.0,1.0,40,950,700,250,0.7368421052631579,12,7,5,372.44905628071166,0.7389690170940171,0.19173403395311261,0.22695541015726106,132827.17013888876,1955.7856353325453,134782.9557742213,2562,0,708.8,34,6,13,32.69334411209917,0.6528799019607844,42.29166666666666,1030.8333333333321,30.318627450980358,5
2570,4,0,0,40,0.0,0.0,1.0,40,1050,600,450,0.5714285714285714,15,6,9,372.44905628071166,0.738167735042735,0.19173403395311261,0.22695541015726106,132827.17013888876,1894.2708333333142,134721.44097222207,2563,1,709.8,34,6,13,32.69334411209917,0.6528799019607844,42.29166666666666,1030.8333333333321,30.318627450980358,0
2571,4,1,0,41,0.024390243902439025,0.0,1.0,41,1200,800,400,0.6666666666666666,16,8,8,362.5642839615041,0.7481707317073171,0.18716872972721643,0.22298953685301307,133173.39275763012,1456.7831575788475,134630.17591520897,2564,0,693.4634146341464,35,6,14,32.600265380877616,0.6541666666666668,41.956018518518505,1032.1759259259243,29.490740740740694,0
2572,4,0,0,41,0.0,0.0,1.0,41,1050,500,550,0.47619047619047616,16,5,11,362.64151702226104,0.7476117886178861,0.18663458383462794,0.2233951886628843,133233.13185871035,1463.173010973918,134696.30486968427,2565,1,694.4634146341464,35,6,14,32.538303437967116,0.6547619047619049,41.89814814814814,1032.4074074074058,29.49735449735445,0
2573,4,0,0,41,0.0,0.0,1.0,41,950,600,350,0.631578947368421,13,6,7,361.63090688880726,0.7476117886178861,0.18710409231932634,0.2231874102934984,133302.3201850569,1441.2477877808544,134743.56797283774,2566,2,695.4634146341464,37,4,16,32.49495646634106,0.651463963963964,41.83114035087719,1032.675438596491,27.91014698909435,0
2574,4,0,0,41,0.0,0.0,1.0,41,1000,600,400,0.6,14,6,8,357.3751300728409,0.7449186991869918,0.16994492525570415,0.22157258064516117,133472.22222222207,1340.1469682979193,134812.36919052,2567,3,696.4634146341464,35,6,18,32.43447580645161,0.6571428571428573,41.66666666666666,1033.3333333333321,29.52380952380949,0
2575,4,0,1,40,0.0,0.024390243902439025,0.975609756097561,41,900,700,200,0.7777777777777778,11,7,4,353.5078284188287,0.7457825203252032,0.16481460879104404,0.21967820029692126,133557.2138181939,1242.7041253077741,134799.91794350167,2568,4,697.4634146341464,37,4,18,32.44923712032813,0.6539977477477478,41.5844298245614,1033.6622807017534,27.936818397344688,0
2576,4,0,0,40,0.0,0.0,1.0,40,1250,800,450,0.64,17,8,9,358.6775741523913,0.7431623931623932,0.15948801742919372,0.2230799546557558,133588.6139517898,1583.0479973216652,135171.66194911147,2569,5,703.45,36,4,18,32.284177559912855,0.65625,41.55405405405406,1033.783783783785,28.716216216216253,0
2577,4,0,0,40,0.0,0.0,1.0,40,1050,700,350,0.6666666666666666,14,7,7,357.7607401412488,0.7440705128205128,0.16685717396037436,0.22356395639030713,133763.2966581448,1571.0512032302763,135334.34786137508,2570,6,704.45,36,4,16,32.13291058857682,0.657986111111111,41.385135135135144,1034.4594594594607,28.73498498498502,0
2578,4,0,0,40,0.0,0.0,1.0,40,1200,1000,200,0.8333333333333334,14,10,4,380.74494229551675,0.7441239316239316,0.16895999550511287,0.23065005047568482,132606.5394188317,2102.4762831956077,134709.0157020273,2571,7,705.45,35,5,18,32.70182511143576,0.6485119047619046,42.50578703703705,1029.976851851854,29.427910052910114,4
2579,4,1,0,41,0.024390243902439025,0.0,1.0,41,850,700,150,0.8235294117647058,10,7,3,370.9214272900316,0.754369918699187,0.17307779366689768,0.22693850050430237,132978.12328798426,1664.8870576658103,134643.01034565008,2572,0,689.219512195122,36,5,18,32.58088583178659,0.6501736111111109,42.14527027027029,1031.4189189189217,28.6505255255256,0
2580,4,0,0,41,0.0,0.0,1.0,41,1400,900,500,0.6428571428571429,19,9,10,369.49565893397016,0.7529979674796748,0.1745771958537914,0.22712459517973468,133152.4065239229,1639.8472374401786,134792.25376136307,2573,1,690.219512195122,36,5,18,32.44248954355338,0.6519097222222221,41.97635135135137,1032.094594594597,28.669294294294364,0
2581,4,0,0,41,0.0,0.0,1.0,41,1150,800,350,0.6956521739130435,15,8,7,397.600623377807,0.7523882113821139,0.1915004172636945,0.22395758749535366,129815.23762119096,2123.307498840434,131938.5451200314,2574,2,691.219512195122,37,4,16,35.10060253927262,0.6165540540540542,45.230263157894726,1019.0789473684197,27.54267425320053,6
2582,4,2,0,43,0.046511627906976744,0.0,1.0,43,500,400,100,0.8,6,4,2,382.622751179721,0.7725175341454411,0.18796412543282792,0.2178570795357397,130236.00396050327,1366.2516276041415,131602.2555881074,2575,0,660.0232558139535,39,4,18,35.053853284348726,0.6172542735042736,44.81770833333332,1020.7291666666649,26.17254273504269,0
2583,4,0,0,43,0.0,0.0,1.0,43,1000,700,300,0.7,13,7,6,380.4776322152095,0.7727943890734588,0.1890561832483304,0.21712286437191297,130323.35778061218,1317.0380815086378,131640.39586212081,2576,1,661.0232558139535,34,9,18,35.01977187050638,0.6277573529411764,44.732142857142854,1021.0714285714281,30.031512605042003,0
2584,4,2,2,43,0.044444444444444446,0.044444444444444446,0.9555555555555556,45,950,600,350,0.631578947368421,13,6,7,364.418270542803,0.7872053872053872,0.19532502173162336,0.2108113380306815,130850.9003371228,536.8917599645849,131387.7920970874,2577,0,632.6,37,8,15,34.89477280034294,0.6269707207207208,44.216008771929815,1023.1359649122794,27.65232337600755,0
2585,4,0,2,41,0.0,0.046511627906976744,0.9534883720930233,43,1400,1000,400,0.7142857142857143,18,10,8,377.83723546028716,0.7739018087855297,0.20350208718810592,0.2177818329976908,130710.70545744844,1277.4743190212362,131988.17977646968,2578,1,662.7209302325581,37,6,15,34.69377725355636,0.6255630630630631,44.353070175438596,1022.5877192982456,27.63750592697961,0
2586,4,3,2,42,0.06818181818181818,0.045454545454545456,0.9545454545454546,44,700,400,300,0.5714285714285714,10,4,6,372.1377173216647,0.7810958421423538,0.2056082748149557,0.2158038336526358,130945.12473518871,945.9239626707457,131891.04869785946,2579,0,648.4545454545455,38,6,16,34.6018180236604,0.6260964912280702,44.12393162393162,1023.5042735042725,26.93432298695454,0
2587,4,1,1,42,0.023255813953488372,0.023255813953488372,0.9767441860465116,43,900,700,200,0.7777777777777778,11,7,4,380.67139608975623,0.7730712440014765,0.2127093235102795,0.22021356459476216,130850.9003371229,1362.238982186821,132213.13931930973,2580,0,664.5116279069767,37,6,16,34.47904386810988,0.6269707207207207,44.21600877192982,1023.1359649122802,27.652323376007573,0
2588,4,1,0,43,0.023255813953488372,0.0,1.0,43,600,200,400,0.3333333333333333,10,2,8,378.6922369854229,0.7660114433370248,0.21806408247695952,0.2196593813824538,130954.69292534726,1318.305121527782,132272.99804687506,2581,0,665.4883720930233,39,4,17,34.424401248388634,0.624465811965812,44.114583333333336,1023.541666666667,26.244658119658126,0
2589,4,0,0,43,0.0,0.0,1.0,43,1600,1100,500,0.6875,21,11,10,377.42461351566874,0.7646271686969361,0.21544972470543633,0.21986619971161353,131119.8742894443,1297.573575583332,132417.44786502764,2582,1,666.4883720930233,40,3,17,34.28941754316331,0.6244791666666667,43.95325203252033,1024.1869918699201,25.604674796748004,0
2590,4,1,0,44,0.022727272727272728,0.0,1.0,44,1300,1000,300,0.7692307692307693,16,10,6,370.6519488689982,0.7700405214940099,0.21825473991249433,0.21741503901663328,131384.3261869037,940.232292622783,132324.5584795265,2583,0,652.3181818181819,37,7,18,34.19518716577541,0.6323198198198199,43.69517543859649,1025.2192982456143,27.708629682313898,0
2591,4,0,2,42,0.0,0.045454545454545456,0.9545454545454546,44,1200,1000,200,0.8333333333333334,14,10,4,365.291015625,0.7689834390415786,0.2168323863636361,0.21487706801470588,131492.4391847469,806.6013313609506,132299.04051610787,2584,1,653.3181818181819,38,6,18,34.223307291666664,0.631578947368421,43.58974358974359,1025.6410256410259,26.990553306342786,0
2592,4,0,1,41,0.0,0.023809523809523808,0.9761904761904762,42,1050,600,450,0.5714285714285714,15,6,9,373.2607361722092,0.7663811459543167,0.2057045135283695,0.21991356723093153,131553.00188519558,1420.7140658664373,132973.715951062,2585,2,662.952380952381,37,5,19,33.95770984751318,0.6340090090090089,43.53070175438597,1025.8771929824572,27.726410621147494,0
2593,4,0,0,41,0.0,0.0,1.0,41,1050,700,350,0.6666666666666666,14,7,7,376.2464387464387,0.7678353658536585,0.1977902855951632,0.22232744107744118,131665.51246537405,1707.7360341643684,133373.24849953843,2586,3,667.5853658536586,37,4,15,33.76736111111112,0.6351351351351351,43.42105263157895,1026.3157894736848,27.73826458036986,0
2594,4,1,0,42,0.023809523809523808,0.0,1.0,42,750,400,350,0.5333333333333333,11,4,7,367.7564136727194,0.7757452574525745,0.20127664210442897,0.21883327189832125,131931.11257213829,1303.7025622762862,133234.81513441456,2587,0,652.6666666666666,38,4,16,33.717025443704934,0.6359649122807017,43.162393162393165,1027.350427350428,27.035537561853367,0
2595,4,0,0,42,0.0,0.0,1.0,42,1800,1500,300,0.8333333333333334,21,15,6,366.34561911948464,0.7754065040650406,0.20369545197991812,0.21830930388421335,131985.99810979617,1270.498438527282,133256.49654832346,2588,1,653.6666666666666,38,4,16,33.69788417550425,0.6365131578947368,43.10897435897436,1027.5641025641025,27.04116059379217,0
2596,4,0,0,42,0.0,0.0,1.0,42,1450,1100,350,0.7586206896551724,18,11,7,368.2046618316746,0.775479094076655,0.2028917748917749,0.22053328376663792,132178.1873790088,1333.724957082341,133511.91233609113,2589,2,654.6666666666666,38,4,17,33.456277056277045,0.6384320175438596,42.92200854700855,1028.3119658119667,27.060841205578072,0
2597,4,0,0,42,0.0,0.0,1.0,42,850,500,350,0.5882352941176471,12,5,7,372.43669679325575,0.7739305071622145,0.21162440879966415,0.2238927117606203,132317.61203342033,1455.9868706597417,133773.59890408008,2590,3,655.6666666666666,39,3,17,33.20688215045053,0.6380876068376067,42.78645833333334,1028.8541666666683,26.38087606837611,0
2598,4,0,0,42,0.0,0.0,1.0,42,1200,1000,200,0.8333333333333334,14,10,4,376.227323480874,0.7749467673248162,0.20888822797219708,0.22683831511964003,132428.6352040817,1564.7762653238428,133993.41146940552,2591,4,656.6666666666666,34,8,18,32.99743619400109,0.6488970588235293,42.67857142857143,1029.2857142857147,30.27310924369749,0
2599,4,0,0,42,0.0,0.0,1.0,42,1150,800,350,0.6956521739130435,15,8,7,372.3401674343975,0.7749709639953543,0.20334446728331623,0.22502297075383168,132517.1467764061,1468.2913237311434,133985.43810013722,2592,5,657.6666666666666,35,7,18,33.00828087529976,0.6476190476190475,42.592592592592595,1029.6296296296302,29.417989417989435,0
2600,4,0,0,42,0.0,0.0,1.0,42,1350,900,450,0.6666666666666666,18,9,9,372.96923176461064,0.7722125435540069,0.20776824991384402,0.22638364997805416,132680.2718144043,1497.1318097876092,134177.4036241919,2593,6,658.6666666666666,37,5,15,32.827799063431236,0.6452702702702704,42.43421052631578,1030.2631578947357,27.844950213371238,0
2601,4,0,0,42,0.0,0.0,1.0,42,1000,700,300,0.7,13,7,6,372.8945446894877,0.7701074332171893,0.2080668088130775,0.2271266772199607,132810.65088757398,1504.8734385272833,134315.52432610127,2594,7,659.6666666666666,38,4,17,32.69848673300165,0.6447368421052632,42.30769230769231,1030.769230769231,27.125506072874497,0
2602,4,0,0,42,0.0,0.0,1.0,42,1100,700,400,0.6363636363636364,15,7,8,372.72749321220476,0.77022841656988,0.2122133901742238,0.22752644130240274,132893.25741699536,1506.5941403681786,134399.85155736352,2595,8,660.6666666666666,38,4,17,32.61967671743862,0.6455592105263158,42.2275641025641,1031.0897435897432,27.133940620782717,0
2603,4,0,0,42,0.0,0.0,1.0,42,1500,1200,300,0.8,18,12,6,381.0828865256166,0.77022841656988,0.22333763670628737,0.22857850146929046,132233.12428090078,1678.3561390532568,133911.48041995405,2596,9,661.6666666666666,38,4,19,33.06975173989819,0.6389802631578947,42.868589743589745,1028.5256410256413,27.06646423751688,1
2604,4,1,0,43,0.023255813953488372,0.0,1.0,43,850,500,350,0.5882352941176471,12,5,7,373.04089259701084,0.7780546327057954,0.2244436510769965,0.22567765446311586,132555.70461180783,1290.356044251571,133846.0606560594,2597,0,647.2558139534884,33,10,20,32.95140128525527,0.6524621212121213,42.55514705882352,1029.779411764705,31.205436720142576,0
2605,4,0,1,42,0.0,0.023255813953488372,0.9767441860465116,43,1350,800,550,0.5925925925925926,19,8,11,369.7318180286021,0.77750092284976,0.22366423494955212,0.22456343052895084,132704.4802295917,1213.0137471655162,133917.4939767572,2598,1,648.2558139534884,34,9,17,32.886818794531095,0.651654411764706,42.41071428571428,1030.3571428571418,30.304621848739462,0
2606,4,0,0,42,0.0,0.0,1.0,42,1350,1200,150,0.8888888888888888,15,12,3,369.6211921587428,0.7689943863724351,0.23159782147023922,0.2166601521475834,131357.78523930468,1314.9530907720634,132672.73833007674,2599,12,664.6666666666666,35,7,20,34.248452259982706,0.6360119047619047,43.72106481481482,1025.1157407407406,29.28902116402116,2
2607,4,0,0,42,0.0,0.0,1.0,42,800,500,300,0.625,11,5,6,368.53589174296144,0.7679539295392954,0.23021785754599833,0.21635914280655402,131417.1157648536,1286.38478973768,132703.50055459127,2600,13,665.6666666666666,35,7,20,34.21626312224856,0.6366071428571427,43.66319444444446,1025.347222222224,29.29563492063497,0
2608,4,0,0,42,0.0,0.0,1.0,42,1000,700,300,0.7,13,7,6,367.6492619070669,0.7678329461866047,0.2281737074062129,0.21600613133266677,131446.78605109753,1265.2627743484366,132712.04882544596,2601,14,666.6666666666666,35,7,20,34.20899172310008,0.6369047619047619,43.63425925925927,1025.462962962964,29.298941798941826,0
2609,4,0,0,42,0.0,0.0,1.0,42,1100,800,300,0.7272727272727273,14,8,6,367.74395295529735,0.7680507162214479,0.22922544483316387,0.21622953995599828,131476.45968632132,1269.9346011231326,132746.39428744445,2602,15,667.6666666666666,35,7,20,34.17656490990483,0.6372023809523808,43.60532407407408,1025.578703703705,29.302248677248716,0
2610,4,1,1,42,0.023255813953488372,0.023255813953488372,0.9767441860465116,43,1050,700,350,0.6666666666666666,14,7,7,359.52881449086465,0.7735326688815061,0.22979118698290413,0.21292019545085175,131749.92696069946,873.5790098876598,132623.5059705871,2603,0,653.1162790697674,37,6,18,34.111106660970485,0.6359797297297296,43.338815789473685,1026.6447368421054,27.747155049786635,0
2611,4,0,0,42,0.0,0.0,1.0,42,1100,500,600,0.45454545454545453,17,5,12,364.3792461100154,0.7670102593883081,0.23648758648758683,0.21531500906500906,131665.51246537393,1195.236034164355,132860.74849953828,2604,17,669.6666666666666,37,5,19,34.07184829059829,0.6351351351351351,43.421052631578945,1026.315789473684,27.738264580369837,0
2612,4,0,0,42,0.0,0.0,1.0,42,950,600,350,0.631578947368421,13,6,7,363.02102783979785,0.765364885791715,0.2342549923195083,0.2148295109125277,131721.78578985843,1163.5556132656195,132885.34140312404,2605,18,670.6666666666666,37,5,19,34.04988250373851,0.6356981981981982,43.36622807017544,1026.5350877192984,27.74419155998104,0
2613,4,0,0,42,0.0,0.0,1.0,42,1400,1100,300,0.7857142857142857,17,11,6,357.56749427703176,0.7662359659310879,0.22747424829423624,0.21222922378952325,131834.36850761762,1027.9369613727242,132862.30546899035,2606,19,671.6666666666666,37,5,20,34.076268773578214,0.6368243243243243,43.25657894736842,1026.9736842105256,27.756045519203393,0
2614,4,0,0,42,0.0,0.0,1.0,42,750,400,350,0.5333333333333333,11,4,7,357.5027050293297,0.7641792489353465,0.2277038256865349,0.21266303767744682,131918.8371061287,1032.2682219528942,132951.10532808158,2607,20,672.6666666666666,37,5,20,33.99275536343261,0.637668918918919,43.17434210526315,1027.3026315789464,27.764935988620174,0
2615,4,0,0,42,0.0,0.0,1.0,42,850,600,250,0.7058823529411765,11,6,5,357.35800230579406,0.7634775454897406,0.22580940186574017,0.21305083954261453,132003.33275623262,1034.4894582948516,133037.82221452746,2608,21,673.6666666666666,37,5,20,33.91129605918338,0.6385135135135136,43.09210526315789,1027.6315789473679,27.773826458036968,0
2616,4,0,1,41,0.0,0.023809523809523808,0.9761904761904762,42,1300,1000,300,0.7692307692307693,16,10,6,355.8191786666667,0.7637921022067363,0.22179301587301614,0.21260706182281708,132087.85545792937,999.8784481763591,133087.73390610574,2609,22,674.6666666666666,37,5,20,33.86566666666667,0.6393581081081081,43.00986842105263,1027.9605263157894,27.782716927453766,0
2617,4,0,0,41,0.0,0.0,1.0,41,950,600,350,0.631578947368421,13,6,7,359.2699509149972,0.7621951219512195,0.21173648599918216,0.21511435552818636,132166.31063073222,1296.6767865838965,133462.98741731612,2610,23,680.609756097561,36,5,20,33.697933778702584,0.6420717592592592,42.933558558558566,1028.265765765767,28.56293793793797,0
2618,4,0,0,41,0.0,0.0,1.0,41,1150,1000,150,0.8695652173913043,13,10,3,356.6358610830997,0.7619918699186992,0.20376449989056655,0.2146863306045698,132369.0307706357,1241.5086539242172,133610.53942455992,2611,24,681.609756097561,36,5,20,33.56154701977093,0.6440972222222221,42.7364864864865,1029.0540540540558,28.584834834834883,0
2619,4,1,0,42,0.023809523809523808,0.0,1.0,42,850,200,650,0.23529411764705882,15,2,13,329.9128972414309,0.7692847464188928,0.19382204377671286,0.18854607547010258,130380.76560356638,265.040282712623,130645.805886279,2612,0,666.3571428571429,35,7,20,36.252455424599574,0.6261904761904763,44.67592592592592,1021.2962962962952,29.17989417989415,7
2620,4,2,1,43,0.045454545454545456,0.022727272727272728,0.9772727272727273,44,1100,700,400,0.6363636363636364,15,7,8,316.82228537137576,0.7853021494009866,0.19868160875875485,0.18354453068721596,130906.99932912046,-505.14906028778216,130401.85026883267,2613,0,637.0227272727273,37,7,18,36.05564038001358,0.6275337837837838,44.161184210526315,1023.3552631578943,27.658250355618765,0
2621,4,1,1,43,0.022727272727272728,0.022727272727272728,0.9772727272727273,44,850,700,150,0.8235294117647058,10,7,3,318.61167189614446,0.7838266384778013,0.20296781418902454,0.18485021486330078,130963.11034404818,-454.72489131271004,130508.38545273547,2614,0,638.0,37,7,18,35.95328959114445,0.6280968468468469,44.10635964912281,1023.5745614035088,27.66417733522997,0
2622,4,0,0,43,0.0,0.0,1.0,43,1000,700,300,0.7,13,7,6,326.0281442447203,0.7763473606496862,0.20796658658878187,0.18874036241263825,130878.9483302554,-65.95587103724574,130812.99245921815,2615,2,653.8372093023256,37,6,18,35.84842477496786,0.6272522522522522,44.18859649122807,1023.2456140350872,27.655286865813167,0
2623,4,1,1,43,0.022727272727272728,0.022727272727272728,0.9772727272727273,44,1000,700,300,0.7,13,7,6,320.4392693620469,0.7852140591966174,0.20875526225964292,0.18688392424837616,131163.9135437212,-393.9862754766626,130769.92726824453,2616,0,639.9545454545455,38,6,20,35.704135377555275,0.6282894736842106,43.91025641025641,1024.3589743589741,26.956815114709844,0
2624,4,0,0,43,0.0,0.0,1.0,43,1300,1100,200,0.8461538461538461,15,11,4,330.33371635327893,0.7806847545219638,0.21580239780442034,0.19207074989457779,131047.29940943372,57.8682863958241,131105.16769582956,2617,1,655.1627906976744,37,6,20,35.5683765260227,0.6289414414414414,44.02412280701755,1023.9035087719302,27.673067804646763,0
2625,4,0,0,43,0.0,0.0,1.0,43,950,500,450,0.5263157894736842,14,5,9,331.6601599150872,0.7782392026578073,0.21889933099713277,0.19368953339041092,131215.75869498303,103.80790243151097,131319.56659741455,2618,2,656.1627906976744,37,6,20,35.36449414954339,0.6306306306306306,43.859649122807014,1024.5614035087715,27.69084874348031,0
2626,4,0,0,43,0.0,0.0,1.0,43,1350,1100,250,0.8148148148148148,16,11,5,331.8080284722783,0.7766242155777039,0.22044934024342044,0.1939490058600572,131250.0116188283,109.96151844142275,131359.97313726973,2619,3,657.1627906976744,40,3,20,35.32616780720023,0.62578125,43.82621951219513,1024.6951219512214,25.617378048780534,0
2627,4,0,0,43,0.0,0.0,1.0,43,900,500,400,0.5555555555555556,13,5,8,337.82732478587627,0.7752860834256182,0.2271171373687011,0.1981688121682098,131385.8453047642,277.23867743252197,131663.08398219672,2620,4,658.1627906976744,36,7,20,35.03496631517284,0.6342592592592593,43.693693693693696,1025.2252252252251,28.478478478478475,0
2628,4,0,0,43,0.0,0.0,1.0,43,1750,1600,150,0.9142857142857143,19,16,3,331.8858578613162,0.7754706533776301,0.22232122320012637,0.1959289283809427,131629.4461451711,137.19033073999026,131766.63647591107,2621,5,659.1627906976744,38,5,16,34.941870553531146,0.6329495614035088,43.45619658119657,1026.175213675212,27.00461088618979,0
2629,4,0,0,43,0.0,0.0,1.0,43,1400,1000,400,0.7142857142857143,18,10,8,335.4981121754631,0.7749630860095976,0.226536026179734,0.19848927720331566,131711.6845642485,237.80430455108194,131949.48886879958,2622,6,660.1627906976744,38,5,16,34.766383916180956,0.6337719298245614,43.37606837606837,1026.4957264957252,27.013045434098032,0
2630,4,0,0,43,0.0,0.0,1.0,43,1250,800,450,0.64,17,8,9,335.4098850739472,0.7749630860095976,0.2288374028386948,0.19915350371932383,131848.80566741532,244.6785512089899,132093.4842186243,2623,7,661.1627906976744,38,5,16,34.630621727521756,0.6351425438596492,43.24252136752136,1027.0299145299136,27.027103013945094,0
2631,4,0,0,43,0.0,0.0,1.0,43,1550,1000,550,0.6451612903225806,21,10,11,337.2886448556936,0.7730712440014765,0.23369469277998478,0.20084860046917685,131958.55391418296,301.62436536635346,132260.17827954932,2624,8,662.1627906976744,38,5,16,34.47194204706942,0.6362390350877192,43.13568376068376,1027.4572649572654,27.038349077822772,0
2632,4,0,0,43,0.0,0.0,1.0,43,950,600,350,0.631578947368421,13,6,7,336.29620762195333,0.7735326688815061,0.23281745423684796,0.20045692375773852,131996.2904188369,277.9703776041721,132274.26079644109,2625,9,663.1627906976744,39,4,16,34.45947372867038,0.6348824786324787,43.098958333333336,1027.6041666666674,26.348824786324805,0
2633,4,0,0,43,0.0,0.0,1.0,43,1150,900,250,0.782608695652174,14,9,5,334.35959637232935,0.7733019564414912,0.23185783898923273,0.19967145694603472,132066.38681224792,231.53275777902252,132297.91957002695,2626,10,664.1627906976744,41,2,16,34.438740629926315,0.6323678861788619,43.03075396825396,1027.8769841269832,25.070170344560566,0
2634,4,0,0,43,0.0,0.0,1.0,43,1350,900,450,0.6666666666666666,18,9,9,335.1452225732857,0.7726559616094499,0.23702713253077,0.2008159177569176,132193.88247197008,260.8296327790224,132454.7121047491,2627,11,665.1627906976744,41,2,17,34.290388449417975,0.633638211382114,42.906746031746025,1028.3730158730143,25.082268679829617,0
2635,4,0,0,43,0.0,0.0,1.0,43,1100,800,300,0.7272727272727273,14,8,6,335.7166928607137,0.7727482465854558,0.23605694074690486,0.2015660908090756,132270.40939350252,281.07688098385086,132551.48627448638,2628,12,666.1627906976744,41,2,18,34.198793679879124,0.6344004065040652,42.83234126984126,1028.670634920633,25.089527680991047,0
2636,4,0,0,43,0.0,0.0,1.0,43,900,500,400,0.5555555555555556,13,5,8,355.1761763743741,0.772609819121447,0.22456817523883088,0.21506899122166842,132590.49236613314,838.2092661124573,133428.7016322456,2629,13,667.1627906976744,38,5,18,33.3763399031812,0.6425438596491229,42.52136752136751,1029.914529914528,27.10301394511916,3
2637,4,0,0,43,0.0,0.0,1.0,43,850,500,350,0.5882352941176471,12,5,7,354.01860791829796,0.7716869693613879,0.2242225148695387,0.21468222751875626,132645.514875082,791.7961045364702,133437.3109796185,2630,14,668.1627906976744,38,5,15,33.35083488902716,0.643092105263158,42.46794871794871,1030.1282051282037,27.108636977057994,0
2638,4,0,0,43,0.0,0.0,1.0,43,1150,800,350,0.6956521739130435,15,8,7,355.24724016732256,0.7697028423772609,0.22995487677889614,0.216377864465551,132810.65088757395,836.1234385272821,133646.77432610124,2631,15,669.1627906976744,38,5,17,33.153244195688224,0.6447368421052632,42.30769230769231,1030.7692307692307,27.125506072874494,0
2639,4,0,0,43,0.0,0.0,1.0,43,1050,700,350,0.6666666666666666,14,7,7,353.3006523665064,0.7689645625692137,0.23092420773587174,0.21550893143721794,132865.71905361972,788.3090437577657,133654.02809737748,2632,16,670.1627906976744,38,5,17,33.14810017271158,0.6452850877192982,42.254273504273506,1030.9829059829062,27.131129104813322,0
2640,4,0,0,43,0.0,0.0,1.0,43,1050,800,250,0.7619047619047619,13,8,5,379.57196141531097,0.7689645625692137,0.24700481641429928,0.21594856787865424,130205.11379200136,1307.05947006297,131512.17326206432,2633,17,671.1627906976744,36,7,19,35.163117437198856,0.6223958333333335,44.84797297297297,1020.6081081081073,28.350225225225202,5
2641,4,0,0,43,0.0,0.0,1.0,43,1200,1000,200,0.8333333333333334,14,10,4,380.6146907526746,0.7665651531930602,0.24322023848738406,0.21768792261129946,130410.31867551855,1327.2293043285567,131737.5479798471,2634,18,672.1627906976744,35,8,19,34.92788007554296,0.6264880952380952,44.64699074074073,1021.4120370370359,29.183201058201025,0
2642,4,0,0,43,0.0,0.0,1.0,43,1300,700,600,0.5384615384615384,19,7,12,381.59277028059137,0.7665651531930602,0.24673446649124053,0.2189137471609707,130528.56445312488,1361.7513020833194,131890.3157552082,2635,19,673.1627906976744,35,8,18,34.782747196738036,0.6276785714285715,44.53124999999999,1021.8749999999991,29.196428571428545,0
2643,4,0,1,42,0.0,0.023255813953488372,0.9767441860465116,43,800,600,200,0.75,10,6,4,380.68979295579095,0.7649501661129567,0.24932056342646103,0.21916820737131398,130665.2529852486,1348.5856210940515,132013.83860634264,2636,20,674.1627906976744,36,7,18,34.66699709953374,0.627025462962963,44.397522522522515,1022.4099099099086,28.400275275275238,0
2644,4,0,0,42,0.0,0.0,1.0,42,950,500,450,0.5263157894736842,14,5,9,388.39703047948535,0.7634533488192025,0.2513544985525058,0.2234990860081622,130646.86381440736,1748.5707893946906,132395.43460380204,2637,21,683.9285714285714,35,7,18,34.48868353522774,0.6288690476190478,44.415509259259245,1022.3379629629612,29.209656084656036,0
2645,4,0,0,42,0.0,0.0,1.0,42,1400,900,500,0.6428571428571429,19,9,10,384.48115912482706,0.7616144018583043,0.24839146097818054,0.22168085117540004,130722.82745160683,1652.092844533696,132374.92029614054,2638,22,684.9285714285714,36,6,18,34.51161766325292,0.6276041666666669,44.3412162162162,1022.6351351351336,28.40653153153149,0
2646,4,0,0,42,0.0,0.0,1.0,42,850,600,250,0.7058823529411765,11,6,5,381.26292190621155,0.7630178087495161,0.2485726868089524,0.22015328160674608,130780.41459956559,1572.3445996672133,132352.7591992328,2639,23,685.9285714285714,36,6,18,34.53544166758412,0.6281828703703705,44.2849099099099,1022.8603603603589,28.412787787787746,0
2647,4,1,0,43,0.023255813953488372,0.0,1.0,43,1150,700,450,0.6086956521739131,16,7,9,373.91215981913615,0.7695644149132521,0.22346528290209733,0.20874981722474034,129466.28146701373,1094.0347891176446,130560.31625613138,2640,0,670.953488372093,35,8,16,36.059578642101656,0.6169642857142857,45.57291666666666,1017.708333333332,29.077380952380913,4
2648,4,1,0,44,0.022727272727272728,0.0,1.0,44,1200,800,400,0.6666666666666666,16,8,8,369.8152800417078,0.7786293164200141,0.2227905505167691,0.20854816820295918,129860.54202428761,804.8825430159652,130665.42456730358,2641,0,656.6818181818181,36,8,17,35.762392737450725,0.6189236111111112,45.1858108108108,1019.2567567567553,28.312687687687646,0
2649,4,1,1,44,0.022222222222222223,0.022222222222222223,0.9777777777777777,45,1400,800,600,0.5714285714285714,20,8,12,360.2541596995703,0.7858585858585859,0.22299476439790622,0.20454383026937498,130126.2932372704,375.70768500251575,130502.00092227291,2642,0,643.0666666666667,38,7,17,35.736038394415374,0.6178728070175441,44.925213675213655,1020.2991452991421,26.84997750787216,0
2650,4,1,0,45,0.022222222222222223,0.0,1.0,45,1250,800,450,0.64,17,8,9,363.15968526478474,0.7852693602693603,0.2217737973774705,0.20707379338853693,130292.12648158867,463.583546748555,130755.71002833723,2643,0,644.0444444444445,35,10,20,35.493542871178626,0.6252976190476189,44.76273148148148,1020.9490740740741,29.169973544973548,0
2651,4,2,2,45,0.0425531914893617,0.0425531914893617,0.9574468085106383,47,1550,1000,550,0.6451612903225806,21,10,11,352.14550227265465,0.8009173604687018,0.2265064746429768,0.20371169756392682,130850.90033712295,-184.28879559095623,130666.611541532,2644,0,617.5957446808511,37,10,14,35.20869056549852,0.6269707207207207,44.21600877192982,1023.1359649122805,27.652323376007583,0
2652,4,0,0,45,0.0,0.0,1.0,45,1000,600,400,0.6,14,6,8,367.93862433544285,0.77996632996633,0.24929897966674042,0.2123010537620388,130751.61944038629,621.7141973054136,131373.3336376917,2645,1,646.0222222222222,36,9,15,34.905353079351094,0.6278935185185186,44.31306306306306,1022.7477477477474,28.409659659659653,0
2653,4,0,0,45,0.0,0.0,1.0,45,950,600,350,0.631578947368421,13,6,7,369.21200758251354,0.7803030303030304,0.24865354152523178,0.2132742302623697,130794.81336805563,658.2031250000058,131453.01649305565,2646,2,647.0222222222222,37,8,15,34.829005431092995,0.6264076576576576,44.270833333333336,1022.9166666666673,27.646396396396415,0
2654,4,0,1,44,0.0,0.022222222222222223,0.9777777777777777,45,1100,900,200,0.8181818181818182,13,9,4,372.63186704264206,0.7801346801346801,0.24759864309944657,0.216191328703733,130963.1103440482,760.2056642428463,131723.31600829103,2647,3,648.0222222222222,37,8,17,34.570947152294245,0.6280968468468469,44.10635964912281,1023.5745614035089,27.664177335229972,0
2655,4,0,1,43,0.0,0.022727272727272728,0.9772727272727273,44,1250,900,350,0.72,16,9,7,375.9656628270158,0.7782108879492601,0.24111606607207103,0.21856008992475898,131039.71370018675,1053.286563590625,132093.0002637774,2648,4,657.9318181818181,36,8,18,34.40799604047514,0.630787037037037,44.031531531531535,1023.8738738738745,28.44094094094096,0
2656,4,0,0,43,0.0,0.0,1.0,43,1200,900,300,0.75,15,9,6,379.8309865941546,0.771594684385382,0.23888031263724563,0.22025215832472844,130942.84664619768,1347.2301258144669,132290.07677201214,2649,5,674.046511627907,35,8,18,34.40727599984922,0.6318452380952382,44.126157407407405,1023.4953703703701,29.24272486772486,0
2657,4,0,0,43,0.0,0.0,1.0,43,1000,600,400,0.6,14,6,8,379.00274209335396,0.7715485418973791,0.2399305875083808,0.22011025960707248,131002.08340031283,1330.0297657321562,132332.113166045,2650,6,675.046511627907,35,8,18,34.36840493687582,0.6324404761904763,44.06828703703703,1023.726851851851,29.249338624338602,0
2658,4,0,0,43,0.0,0.0,1.0,43,800,400,400,0.5,12,4,8,377.35972453394123,0.7722868217054263,0.23762563606543607,0.21966308175502053,131090.963648834,1293.6899862825785,132384.65363511659,2651,7,676.046511627907,35,8,20,34.3203737191079,0.6333333333333333,43.98148148148148,1024.074074074074,29.259259259259256,0
2659,4,2,1,44,0.044444444444444446,0.022222222222222223,0.9777777777777777,45,1400,1100,300,0.7857142857142857,17,11,6,361.4650884399465,0.7820286195286196,0.2338259681982242,0.21332058846274585,131616.8533398265,515.1938412386603,132132.04718106517,2652,0,646.9555555555555,36,9,14,34.19574919520048,0.636574074074074,43.46846846846848,1026.1261261261277,28.50350350350355,0
2660,4,0,0,44,0.0,0.0,1.0,44,750,600,150,0.8,9,6,3,368.15504126296327,0.7753920014094433,0.23571499850314304,0.2169400016756531,131559.0823086601,886.827875172474,132445.91018383257,2653,1,662.6590909090909,36,8,15,34.0825100622027,0.6359953703703705,43.52477477477478,1025.9009009009014,28.497247247247262,0
2661,4,0,0,44,0.0,0.0,1.0,44,1050,700,350,0.6666666666666666,14,7,7,370.2562480152316,0.7747753699788584,0.2380613843406072,0.2183433447033513,131587.96623904322,944.2533327246315,132532.21957176784,2654,2,663.6590909090909,36,8,15,33.99942377346065,0.6362847222222221,43.49662162162163,1026.0135135135145,28.500375375375402,0
2662,4,1,0,45,0.022222222222222223,0.0,1.0,45,900,400,500,0.4444444444444444,14,4,10,360.1347948039148,0.7809343434343434,0.23237390448405537,0.21422875508050027,131918.83710612878,501.7126663973519,132420.54977252614,2655,0,649.8888888888889,37,8,17,33.92515654463301,0.637668918918919,43.17434210526316,1027.3026315789473,27.7649359886202,0
2663,4,0,0,45,0.0,0.0,1.0,45,950,700,250,0.7368421052631579,12,7,5,359.0796217893423,0.7792929292929294,0.2409785932721713,0.21439569265307612,132059.67821829792,483.9878616497334,132543.66607994767,2656,1,650.8888888888889,37,8,18,33.81027309579688,0.6390765765765766,43.03728070175438,1027.8508771929824,27.77975343764817,0
2664,4,0,0,45,0.0,0.0,1.0,45,1200,800,400,0.6666666666666666,16,8,8,362.73989666946636,0.7787457912457912,0.24416426074139053,0.21554075553890575,131876.97991488114,582.437076146492,132459.41699102763,2657,2,651.8888888888889,36,9,18,33.9004769213902,0.6391782407407407,43.215090090090094,1027.1396396396399,28.531656656656665,2
2665,4,0,0,45,0.0,0.0,1.0,45,1300,800,500,0.6153846153846154,18,8,10,363.4326890598613,0.7793350168350168,0.24859178082191824,0.2166115798609559,131992.6741564199,594.0905009739488,132586.76465739385,2658,3,652.8888888888889,36,9,18,33.76598173515982,0.6403356481481481,43.10247747747748,1027.59009009009,28.544169169169166,0
2666,4,0,0,45,0.0,0.0,1.0,45,1300,900,400,0.6923076923076923,17,9,8,365.5697368784106,0.7783249158249159,0.25488621151271706,0.21871898412188012,132137.36329234648,661.0842261180164,132798.4475184645,2659,4,653.8888888888889,36,9,18,33.565169769989055,0.6417824074074074,42.961711711711715,1028.1531531531537,28.559809809809824,0
2667,4,0,0,45,0.0,0.0,1.0,45,1150,900,250,0.782608695652174,14,9,5,360.38398666157036,0.7778619528619529,0.25277570503026237,0.216299563587472,132256.98201610093,532.6596885579983,132789.64170465892,2660,5,654.8888888888889,37,8,18,33.577954553530176,0.6410472972972974,42.845394736842096,1028.61842105263,27.800497866287298,0
2668,4,0,0,45,0.0,0.0,1.0,45,1050,700,350,0.6666666666666666,14,7,7,358.87155991165827,0.7779040404040405,0.25467590126087747,0.21603653558504873,132369.79316953284,500.75083198675316,132870.5440015196,2661,6,655.8888888888889,37,8,19,33.503263185935005,0.6421734234234234,42.73574561403508,1029.0570175438588,27.812351825509698,0
2669,4,0,0,45,0.0,0.0,1.0,45,1250,800,450,0.64,17,8,9,361.65954070450425,0.7781565656565657,0.25725208005396905,0.218222520693749,132457.56842635458,580.9146834472328,133038.4831098018,2662,7,656.8888888888889,35,10,20,33.3431714264298,0.6470238095238094,42.65046296296296,1029.398148148148,29.411375661375658,0
2670,4,0,0,45,0.0,0.0,1.0,45,950,700,250,0.7368421052631579,12,7,5,361.61768880220734,0.7784090909090909,0.25851410587838597,0.21871601477044444,132546.94097490137,586.2636906292814,133133.20466553065,2663,8,657.8888888888889,35,10,20,33.254303885204756,0.6479166666666667,42.563657407407405,1029.74537037037,29.421296296296287,0
2671,4,0,0,45,0.0,0.0,1.0,45,600,300,300,0.5,9,3,6,359.7974250014848,0.7783249158249159,0.2552196876053492,0.21796033254514705,132606.53941883135,542.2982842506731,133148.837703082,2664,9,658.8888888888889,35,10,21,33.241211559351235,0.6485119047619048,42.50578703703703,1029.976851851851,29.42791005291003,0
2672,4,0,0,45,0.0,0.0,1.0,45,1300,1000,300,0.7692307692307693,16,10,6,361.56584885550706,0.7773989898989899,0.2572319943673598,0.22018710675811426,132803.95418645005,603.474885358339,133407.42907180838,2665,10,659.8888888888889,36,9,15,32.99715029680615,0.6484375,42.31418918918919,1030.7432432432438,28.631756756756772,0
2673,4,0,0,45,0.0,0.0,1.0,45,1500,1200,300,0.8,18,12,6,375.75757575757586,0.7770622895622896,0.27340067340067353,0.2296296296296296,132934.5703125,990.2343749999993,133924.8046875,2666,11,660.8888888888889,39,6,17,32.49999999999999,0.6442307692307693,42.1875,1031.25,26.442307692307693,3
2674,4,0,0,45,0.0,0.0,1.0,45,1050,500,550,0.47619047619047616,16,5,11,375.1403218313866,0.7768097643097643,0.2720258533629569,0.22958216729137135,132988.28667534716,977.8537326388836,133966.14040798604,2667,12,661.8888888888889,39,6,17,32.46187638860836,0.6447649572649572,42.135416666666664,1031.458333333333,26.447649572649564,0
2675,4,1,1,45,0.021739130434782608,0.021739130434782608,0.9782608695652174,46,1400,1200,200,0.8571428571428571,16,12,4,368.55169572718194,0.7831119162640902,0.2666422915404385,0.22677589556719843,133190.45970529405,617.5139558137903,133807.97366110786,2668,0,648.4782608695652,41,5,17,32.428620054460986,0.6435467479674797,41.93948412698412,1032.2420634920625,25.176635694928354,0
2676,4,0,0,45,0.0,0.0,1.0,45,1050,600,450,0.5714285714285714,15,6,9,373.96327495865387,0.7767676767676768,0.2698959666568215,0.23006329398879746,133183.5911680382,961.1543847907975,134144.745552829,2669,14,663.8888888888889,40,5,17,32.29587148436219,0.6450520833333333,41.94613821138211,1032.2154471544713,25.805386178861784,0
2677,4,0,0,45,0.0,0.0,1.0,45,1050,900,150,0.8571428571428571,12,9,3,375.85203971399477,0.7770622895622896,0.2754540782293955,0.2318781163044265,133288.5117675492,1019.3518036552447,134307.86357120445,2670,15,664.8888888888889,40,5,17,32.141685529639474,0.6460937499999999,41.84451219512196,1032.6219512195132,25.81554878048783,0
2678,4,0,0,45,0.0,0.0,1.0,45,1450,1100,350,0.7586206896551724,18,11,7,375.107954326122,0.7746632996632997,0.27751504364776647,0.23274954001695905,133501.315399014,1015.9871283459885,134517.30252736,2671,16,665.8888888888889,36,9,17,31.947168646253314,0.6553819444444444,41.63851351351352,1033.4459459459472,28.706831831831867,0
2679,4,0,0,45,0.0,0.0,1.0,45,1350,900,450,0.6666666666666666,18,9,9,372.5630457592174,0.7734848484848486,0.2751237448734265,0.23169685985606242,133585.5503616499,953.8079024315348,134539.3582640814,2672,17,666.8888888888889,37,8,17,31.928387073964085,0.6542792792792792,41.55701754385966,1033.7719298245627,27.939781887150342,0
2680,4,0,1,44,0.0,0.022222222222222223,0.9777777777777777,45,1000,700,300,0.7,13,7,6,372.1111594655304,0.7736111111111111,0.2737889018512629,0.2315931434059728,133613.88991083798,943.843899084339,134557.73380992233,2673,18,667.8888888888889,37,8,17,31.911633435853915,0.6545608108108107,41.5296052631579,1033.8815789473688,27.942745376955912,0
2681,4,0,0,44,0.0,0.0,1.0,44,1250,1000,250,0.8,15,10,5,373.2745271571853,0.773916490486258,0.2755181721777691,0.23249529663753363,133642.23246575875,1177.0482263773538,134819.2806921361,2674,19,677.7272727272727,37,7,17,31.853128313891826,0.6548423423423423,41.502192982456144,1033.991228070176,27.945708866761514,0
2682,4,0,0,44,0.0,0.0,1.0,44,1000,700,300,0.7,13,7,6,374.11253030391526,0.7731677237491191,0.2801167082678797,0.23355416931547532,133727.2781649161,1205.8100809864557,134933.08824590256,2675,20,678.7272727272727,37,7,16,31.74615269090781,0.6556869369369369,41.41995614035088,1034.3201754385964,27.95459933617828,0
2683,4,0,0,44,0.0,0.0,1.0,44,1050,600,450,0.5714285714285714,15,6,9,374.9584049597653,0.77336592670895,0.2815150889572857,0.23527182818978032,133914.18292059327,1242.4496858791854,135156.63260647247,2676,21,679.7272727272727,38,6,16,31.536866914395834,0.6557017543859648,41.239316239316246,1035.0427350427358,27.23796671165094,0
2684,4,0,0,44,0.0,0.0,1.0,44,550,400,150,0.7272727272727273,7,4,3,382.8744035800848,0.77336592670895,0.3154310328992076,0.23364308548925303,132880.86480034742,1375.3363715277985,134256.20117187523,2677,22,680.7272727272727,39,5,17,32.37059675355291,0.6436965811965811,42.23958333333334,1031.0416666666683,26.436965811965855,2
2685,4,0,0,44,0.0,0.0,1.0,44,850,700,150,0.8235294117647058,10,7,3,382.0952464420393,0.7730796335447498,0.3151305457851572,0.23333503050769605,132907.71620008702,1356.6813151041927,134264.3975151912,2678,23,681.7272727272727,39,5,17,32.36364363403712,0.6439636752136751,42.21354166666668,1031.145833333335,26.439636752136796,0
2686,4,0,0,44,0.0,0.0,1.0,44,1400,1100,300,0.7857142857142857,17,11,6,391.7977740333007,0.7730796335447498,0.3299822885818482,0.22198773582765133,130044.55133912282,1410.4208649794246,131454.97220410223,2679,24,682.7272727272727,38,6,19,35.01470793617543,0.6170504385964912,45.00534188034189,1019.9786324786338,26.84154295996405,7
2687,4,0,0,44,0.0,0.0,1.0,44,1200,900,300,0.75,15,9,6,387.6748923194163,0.7735200845665963,0.3261212000506961,0.2204434466971449,130184.79100568444,1293.8749669508877,131478.66597263532,2680,25,683.7272727272727,40,4,19,34.9770547035783,0.6151041666666668,44.86788617886179,1020.5284552845528,25.51321138211382,0
2688,4,2,1,45,0.043478260869565216,0.021739130434782608,0.9782608695652174,46,700,500,200,0.7142857142857143,9,5,4,369.87097245482994,0.7914653784219002,0.3120600580455515,0.2142772058299768,130906.99932912046,502.48745319625607,131409.48678231673,2681,0,654.9565217391304,37,9,20,34.69844905175185,0.6275337837837838,44.161184210526315,1023.3552631578943,27.658250355618765,2
2689,4,0,0,45,0.0,0.0,1.0,45,850,400,450,0.47058823529411764,13,4,9,378.3138285052609,0.7826599326599327,0.32490337100640976,0.2186134108232689,130809.21292914524,897.3868293969523,131706.5997585422,2682,1,670.5111111111111,36,9,20,34.58163621018642,0.6284722222222223,44.25675675675675,1022.972972972972,28.41591591591589,0
2690,4,0,0,45,0.0,0.0,1.0,45,950,500,450,0.5263157894736842,14,5,9,379.0095621223288,0.7812289562289563,0.3278376726561545,0.21999980330089192,130982.06948502548,928.6913602791852,131910.76084530467,2683,2,671.5111111111111,36,9,20,34.38852218555188,0.6302083333333335,44.08783783783783,1023.648648648648,28.434684684684665,0
2691,4,0,0,45,0.0,0.0,1.0,45,1000,700,300,0.7,13,7,6,378.2563059549126,0.7790404040404041,0.32539119549342876,0.2202894865664514,131109.19922017664,918.5762747461371,132027.77549492277,2684,3,672.5111111111111,38,7,20,34.27893977328049,0.6277412280701755,43.96367521367521,1024.1452991452982,26.951192082771005,0
2692,4,0,0,45,0.0,0.0,1.0,45,1000,700,300,0.7,13,7,6,380.08844747870694,0.778956228956229,0.33233495322159445,0.22216996034364048,131250.01161882796,977.3226295525037,132227.33424838047,2685,4,673.5111111111111,40,5,20,34.089350061159045,0.6257812500000001,43.82621951219512,1024.6951219512187,25.617378048780466,0
2693,4,1,0,46,0.021739130434782608,0.0,1.0,46,1650,1100,550,0.6666666666666666,22,11,11,370.2271278812719,0.7886272141706925,0.32695150179881227,0.21780531787430238,131496.76462950098,536.8268495165476,132033.59147901752,2686,0,659.8478260869565,37,9,21,34.09236690186015,0.633445945945946,43.58552631578945,1025.657894736839,27.720483641536187,0
2694,4,2,1,47,0.041666666666666664,0.020833333333333332,0.9791666666666666,48,1350,1100,250,0.8148148148148148,16,11,5,327.2321136519431,0.800956708037825,0.24172752353132165,0.1840456630452056,129756.7131598009,-1078.431119613642,128678.28204018726,2687,0,633.3125,41,7,17,36.95269393054205,0.6092479674796747,45.28769841269841,1018.8492063492058,24.849980642663557,8
2695,4,1,0,48,0.020833333333333332,0.0,1.0,48,900,500,400,0.5555555555555556,13,5,8,325.4566277606322,0.7966903073286051,0.2525212067737843,0.18394706095006455,129948.59931882765,-1141.473416695344,128807.1259021323,2688,0,634.2708333333334,43,5,18,36.80352388470946,0.6082848837209303,45.09943181818183,1019.602272727274,23.711680761099394,0
2696,4,1,0,49,0.02040816326530612,0.0,1.0,49,1150,900,250,0.782608695652174,14,9,5,320.4023389527744,0.8056618480725624,0.2542689789994379,0.1824439764780675,130238.95747599451,-1454.2266803840828,128784.73079561043,2689,0,622.3061224489796,44,5,19,36.63862179487182,0.6098484848484849,44.81481481481482,1020.7407407407406,23.198653198653197,0
2697,4,1,2,48,0.02,0.04,0.96,50,1250,900,350,0.72,16,9,7,313.17685690701705,0.8126700680272109,0.2517049118149064,0.17969331517635473,130534.75320743947,-1823.9008246310398,128710.85238280843,2690,0,610.84,42,8,10,36.52431411593654,0.6155753968253967,44.525193798449614,1021.8992248062016,24.33093392395718,0
2698,4,0,0,48,0.0,0.0,1.0,48,1450,900,550,0.6206896551724138,20,9,11,320.143695352819,0.8065713652482269,0.23904626662782813,0.1834813532798378,130490.55103812368,-1244.8545564058854,129245.6964817178,2691,2,624.5625,41,7,10,36.39097242450725,0.6166158536585366,44.56845238095239,1021.7261904761913,24.920150987224176,0
2699,4,0,1,47,0.0,0.020833333333333332,0.9791666666666666,48,1850,1600,250,0.8648648648648649,21,16,5,312.96786132635816,0.8054632092198581,0.23514041129110508,0.18054760394031494,130744.07837498431,-1416.2610819790757,129327.81729300524,2692,3,625.5625,41,7,10,36.31848789083972,0.6191565040650406,44.32043650793651,1022.7182539682544,24.944347657762304,0
2700,4,1,0,48,0.020833333333333332,0.0,1.0,48,1300,900,400,0.6923076923076923,17,9,8,312.41165043228307,0.8042442375886525,0.23198022224326742,0.18075367763914962,130856.77059859692,-1423.7640654107267,129433.0065331862,2693,0,626.4791666666666,42,6,12,36.21910218770716,0.6187996031746031,44.21027131782946,1023.1589147286828,24.360926541159113,0
2701,4,0,3,45,0.0,0.0625,0.9375,48,1100,800,300,0.7272727272727273,14,8,6,311.4411917488634,0.8044104609929078,0.22369283313288246,0.1806960730871429,130964.38573411702,-1442.459126061731,129521.92660805529,2694,1,627.4791666666666,43,5,12,36.13549279921051,0.6184593023255813,44.10511363636365,1023.5795454545478,23.804175475687156,0
2702,4,0,0,45,0.0,0.0,1.0,45,1350,900,450,0.6666666666666666,18,9,9,326.23889895927067,0.7981060606060606,0.23688617334238482,0.18845094045764949,130794.81336805565,-465.9288194444383,130328.88454861121,2695,2,663.4888888888889,41,4,12,35.9279531568228,0.6196646341463414,44.270833333333336,1022.9166666666674,24.949186991869936,0
2703,4,0,2,43,0.0,0.044444444444444446,0.9555555555555556,45,1000,600,400,0.6,14,6,8,322.8107159615119,0.7968013468013468,0.22734959875047123,0.18696196154649045,130896.31287989729,-549.0535045036594,130347.25937539364,2696,3,664.4888888888889,41,4,12,35.913212958474695,0.6206808943089431,44.17162698412698,1023.3134920634918,24.958865660085166,0
2704,4,1,0,44,0.022727272727272728,0.0,1.0,44,750,500,250,0.6666666666666666,10,5,5,327.88612715807284,0.7904334038054969,0.2312220566318932,0.1893387188666669,130781.81932257589,-223.69115192675272,130558.12817064913,2697,0,680.1590909090909,40,4,13,35.898948501407546,0.62109375,44.28353658536586,1022.8658536585369,25.571646341463424,0
2705,4,0,1,43,0.0,0.022727272727272728,0.9772727272727273,44,1350,1100,250,0.8148148148148148,16,11,5,326.4581109495863,0.7890900281888654,0.23007315031066855,0.18907441967686606,130896.3128798974,-253.5673933925348,130642.74548650488,2698,1,681.1590909090909,41,3,15,35.81990224592018,0.620680894308943,44.17162698412699,1023.3134920634927,24.958865660085188,0
2706,4,0,0,43,0.0,0.0,1.0,43,1050,800,250,0.7619047619047619,13,8,5,331.8048670595644,0.7875138427464009,0.2435199785750064,0.19263806489285273,130989.80150910518,92.61073517748449,131082.41224428266,2699,2,695.2325581395348,40,3,15,35.58874383665905,0.6231770833333332,44.080284552845534,1023.6788617886191,25.591971544715477,0
2707,4,0,0,43,0.0,0.0,1.0,43,1050,600,450,0.5714285714285714,15,6,9,336.5406209440461,0.7868217054263565,0.2511637138221745,0.1959168016899568,131093.85456945264,223.6814437504101,131317.53601320306,2700,3,696.2325581395348,40,3,16,35.36250041348286,0.62421875,43.978658536585364,1024.085365853658,25.60213414634145,0
2708,4,1,0,44,0.022727272727272728,0.0,1.0,44,1500,1300,200,0.8666666666666667,17,13,4,334.4560992691154,0.7879228329809725,0.2637084422020004,0.1964296881039215,131432.31232236087,-8.12316164321544,131424.18916071765,2701,0,681.3863636363636,40,4,17,35.07453749587051,0.6276041666666667,43.64837398373983,1025.4065040650394,25.635162601625986,0
2709,4,0,0,44,0.0,0.0,1.0,44,800,500,300,0.625,11,5,6,336.30298809184546,0.7877906976744187,0.26854386944539477,0.1980538134071813,131536.54095611078,47.22635336109454,131583.76730947188,2702,1,682.3863636363636,40,4,18,34.922148471038895,0.6286458333333333,43.546747967479675,1025.8130081300815,25.645325203252035,0
2710,4,0,0,44,0.0,0.0,1.0,44,1000,800,200,0.8,12,8,4,335.0476873480846,0.788363284002819,0.2647013810115415,0.1978544764234479,131640.81090124926,21.18985061801874,131662.00075186728,2703,2,683.3863636363636,40,4,12,34.84931009440814,0.6296875,43.44512195121951,1026.219512195122,25.65548780487805,0
2711,4,0,1,43,0.0,0.022727272727272728,0.9772727272727273,44,900,500,400,0.5555555555555556,13,5,8,337.4004661175172,0.788363284002819,0.27352305885027905,0.19790310958824536,131382.8849806413,70.07218620607063,131452.95716684737,2704,3,684.3863636363636,38,6,14,35.048891899402534,0.6304824561403508,43.69658119658119,1025.2136752136744,26.979307242465115,1
2712,4,0,0,43,0.0,0.0,1.0,43,850,500,350,0.5882352941176471,12,5,7,342.338460888152,0.7832225913621262,0.2778784949311832,0.20037288023072722,131301.43364800335,389.90614149305014,131691.33978949641,2705,4,701.1395348837209,39,4,14,35.004510112816355,0.6279380341880343,43.776041666666664,1024.8958333333326,26.279380341880323,0
2713,4,1,1,43,0.022727272727272728,0.022727272727272728,0.9772727272727273,44,1150,800,350,0.6956521739130435,15,8,7,313.65161195048114,0.790301268498943,0.21339904151297429,0.18935973615800905,132478.41932508687,-485.0260416666613,131993.3932834202,2706,0,686.1818181818181,39,5,18,34.55776333097237,0.639690170940171,42.630208333333336,1029.4791666666672,26.396901709401725,4
2714,4,0,0,43,0.0,0.0,1.0,43,1300,900,400,0.6923076923076923,17,9,8,321.02529586280593,0.7822074566260613,0.2211908830258622,0.19382203953220534,132480.48159105846,-94.08284023669415,132386.39875082177,2707,6,703.1395348837209,38,5,20,34.365919468659186,0.6414473684210527,42.628205128205124,1029.487179487179,27.09176788124155,0
2715,4,0,0,43,0.0,0.0,1.0,43,900,500,400,0.5555555555555556,13,5,8,321.2598191920421,0.7815614617940199,0.22434452771732083,0.19424731100206383,132535.48127145867,-84.33505004019554,132451.1462214185,2708,7,704.1395348837209,38,5,20,34.30474856470914,0.6419956140350878,42.57478632478632,1029.7008547008534,27.09739091318035,0
2716,4,0,0,43,0.0,0.0,1.0,43,1050,800,250,0.7619047619047619,13,8,5,327.8805157137859,0.7822997416020672,0.16711757996248178,0.19585501991910664,132076.58420138905,61.06770833335452,132137.6519097224,2709,8,705.1395348837209,39,4,15,34.59498716389678,0.6356837606837606,43.02083333333334,1027.916666666668,26.356837606837644,4
2717,4,0,0,43,0.0,0.0,1.0,43,1050,800,250,0.7619047619047619,13,8,5,357.97952851837397,0.7828534514581026,0.17568032728020144,0.2164704283526109,132539.10007165652,992.8593413357823,133531.9594129923,2710,9,706.1395348837209,37,6,20,33.35585045965996,0.6438626126126127,42.571271929824555,1029.7149122807007,27.83013276434326,8
2718,4,0,0,43,0.0,0.0,1.0,43,1050,700,350,0.6666666666666666,14,7,7,353.99609373371766,0.7810538944259874,0.1688991852049857,0.21486739642907027,132680.27181440426,793.6595875653859,133473.93140196963,2711,10,707.1395348837209,37,6,14,33.316482191003246,0.6452702702702704,42.43421052631578,1030.2631578947355,27.84495021337123,0
2719,4,0,0,43,0.0,0.0,1.0,43,1200,800,400,0.6666666666666666,16,8,8,355.10010781945346,0.7815153193060169,0.16637593806367335,0.2160249782132712,132765.01092884337,828.9739390966326,133593.98486794002,2712,11,708.1395348837209,37,6,15,33.202889491789904,0.6461148648648649,42.35197368421052,1030.592105263157,27.85384068278803,0
2720,4,1,1,43,0.022727272727272728,0.022727272727272728,0.9772727272727273,44,1100,900,200,0.8181818181818182,13,9,4,346.16978669322066,0.7893983439041579,0.15829527800009435,0.21193844581629961,133003.43940618375,408.3544497406639,133411.79385592442,2713,0,693.0227272727273,38,6,15,33.19372518556879,0.6466557017543859,42.120726495726494,1031.5170940170938,27.145186684660363,0
2721,4,0,0,43,0.0,0.0,1.0,43,1450,1100,350,0.7586206896551724,18,11,7,351.32901631415496,0.7812846068660022,0.15731248562433064,0.21437681637910438,132878.03849501768,736.782110841793,133614.82060585948,2714,13,710.1395348837209,37,6,15,33.186549505476975,0.647240990990991,42.24232456140351,1031.0307017543857,27.865694642010425,0
2722,4,0,1,42,0.0,0.023255813953488372,0.9767441860465116,43,1100,800,300,0.7272727272727273,14,8,6,351.1732041681301,0.7813768918420081,0.1572004053085534,0.21541980777197534,133075.95245652494,746.5417243767123,133822.49418090165,2715,14,711.1395348837209,37,6,15,32.99194119730783,0.6492117117117118,42.05043859649122,1031.798245614034,27.886439070649566,0
2723,4,0,0,42,0.0,0.0,1.0,42,950,800,150,0.8421052631578947,11,8,3,362.76166824384245,0.7827864885791715,0.154942575348733,0.22194616696361757,132978.123287984,1247.873168776892,134225.99645676088,2716,15,720.9285714285714,36,6,16,32.79128907813808,0.6501736111111112,42.145270270270274,1031.4189189189194,28.650525525525538,0
2724,4,0,0,42,0.0,0.0,1.0,42,1250,1000,250,0.8,15,10,5,367.6545332051393,0.7810927216415021,0.15694637204297734,0.2252898447285808,133036.20501836305,1382.2727710819045,134418.47778944497,2717,16,721.9285714285714,36,6,16,32.60674780773569,0.6507523148148149,42.08896396396397,1031.644144144145,28.656781781781806,0
2725,4,0,0,42,0.0,0.0,1.0,42,1100,700,400,0.6363636363636364,15,7,8,370.4704449962064,0.7799070847851336,0.15577884362414807,0.22760233866215995,133132.5263542627,1464.3332563865654,134596.85961064926,2718,17,722.9285714285714,37,5,16,32.43731406714832,0.6497747747747749,41.99561403508771,1032.017543859648,27.892366050260755,0
2726,4,0,0,42,0.0,0.0,1.0,42,550,400,150,0.7272727272727273,7,4,3,375.05175269970476,0.7802216415021294,0.15330257873278907,0.2307671372493476,133189.11227493064,1590.5619998460947,134779.67427477674,2719,18,723.9285714285714,37,5,16,32.26223355286452,0.6503378378378378,41.940789473684205,1032.2368421052624,27.898293029871958,0
2727,4,0,0,42,0.0,0.0,1.0,42,900,600,300,0.6666666666666666,12,6,6,377.291067651201,0.7798102981029811,0.14997446360937938,0.23267517904855006,133274.01369892654,1656.6189837257566,134930.6326826523,2720,19,724.9285714285714,37,5,16,32.11910640331315,0.6511824324324325,41.858552631578945,1032.565789473684,27.907183499288756,0
2728,4,0,0,42,0.0,0.0,1.0,42,1200,900,300,0.75,15,9,6,376.8937020259158,0.7790602013162988,0.14942188787607624,0.23278437897587545,133330.6296769198,1650.2949224761455,134980.92459939595,2721,20,725.9285714285714,37,5,16,32.07247319248328,0.6517454954954955,41.80372807017544,1032.7850877192982,27.913110478899952,0
2729,4,1,1,42,0.023255813953488372,0.023255813953488372,0.9767441860465116,43,750,400,350,0.5333333333333333,11,4,7,368.9890772105007,0.7833148763381321,0.14042288679934067,0.22947420975861504,133585.5503616499,1258.3969346337512,134843.94729628364,2722,0,710.0232558139535,37,6,16,32.02075378305756,0.6542792792792792,41.55701754385966,1033.7719298245627,27.939781887150342,0
2730,4,0,0,42,0.0,0.0,1.0,42,1100,900,200,0.8181818181818182,13,9,4,382.9009222240151,0.778164924506388,0.1482602628152252,0.23795853521288,133559.51126379767,1828.012006939381,135387.52327073706,2723,22,727.9285714285714,36,6,16,31.687366089261715,0.6559606481481481,41.58220720720721,1033.6711711711719,28.713088088088107,0
2731,4,0,0,42,0.0,0.0,1.0,42,700,400,300,0.5714285714285714,10,4,6,381.2309868693673,0.777826171118854,0.1473825343229549,0.23729367392865527,133617.71981018194,1787.8430372940647,135405.56284747602,2724,23,728.9285714285714,36,6,16,31.672067312928885,0.6565393518518519,41.52590090090091,1033.8963963963974,28.719344344344375,0
2732,4,0,0,42,0.0,0.0,1.0,42,850,500,350,0.5882352941176471,12,5,7,381.1498525706127,0.776543747580333,0.15130183620872928,0.23761704658220914,133675.94103816673,1790.1130437870488,135466.05408195377,2725,24,729.9285714285714,36,6,17,31.61571200406548,0.6571180555555556,41.469594594594604,1034.121621621623,28.72560060060064,0
2733,4,0,0,42,0.0,0.0,1.0,42,1200,900,300,0.75,15,9,6,385.78495307451414,0.7751403406891212,0.15261448292906854,0.24232839267973952,133954.19894823394,1935.5028710757022,135889.70181930964,2726,25,730.9285714285714,37,5,13,31.216568689757448,0.6579391891891893,41.200657894736835,1035.1973684210516,27.978307254623015,0
2734,4,0,0,42,0.0,0.0,1.0,42,500,100,400,0.2,9,1,8,384.457276005433,0.774366047231901,0.1475325658072537,0.24177647383313766,133997.13187824163,1903.2344628899111,135900.36634113154,2727,26,731.9285714285714,38,4,13,31.20786468544698,0.6565241228070176,41.159188034188034,1035.3632478632478,27.246401259559153,0
2735,4,0,1,41,0.0,0.023809523809523808,0.9761904761904762,42,1200,900,300,0.75,15,9,6,385.99201617800185,0.7726722802942315,0.15240011201013992,0.24310725229456595,134052.44545118336,1948.6347386587681,136001.08018984212,2728,27,732.9285714285714,38,4,13,31.112658619622394,0.6570723684210527,41.105769230769226,1035.5769230769224,27.252024291497957,0
2736,4,0,0,41,0.0,0.0,1.0,41,900,600,300,0.6666666666666666,12,6,6,395.25990875473343,0.7640752032520325,0.16013556449904698,0.2484716417085345,133982.577571945,2391.5882771621773,136374.16584910717,2729,28,750.6585365853658,37,4,13,30.942861681847056,0.6582207207207208,41.173245614035075,1035.307017543858,27.981270744428592,0
2737,4,0,0,41,0.0,0.0,1.0,41,1000,800,200,0.8,12,8,4,397.42850688686843,0.7628048780487805,0.15580217203823565,0.2506081225669797,134096.12212411495,2458.7243190212193,136554.84644313616,2730,29,751.6585365853658,37,4,13,30.772725668713388,0.6593468468468469,41.06359649122806,1035.7456140350864,27.993124703650984,0
2738,4,1,0,42,0.023809523809523808,0.0,1.0,42,1100,900,200,0.8181818181818182,13,9,4,358.9447155079457,0.7694057297715834,0.09595832047216879,0.2247709159472269,133840.02267995267,1209.0032404150118,135049.02592036768,2731,0,734.7380952380952,40,2,16,32.0254697832777,0.6515624999999998,41.31097560975611,1034.7560975609777,25.868902439024442,7
2739,4,0,0,42,0.0,0.0,1.0,42,1300,1100,200,0.8461538461538461,15,11,4,359.1195673366234,0.7684620596205962,0.09774177712322052,0.2253624641604139,133918.9029037779,1218.5796938000299,135137.48259757794,2732,1,735.7380952380952,40,2,16,31.941989854360997,0.6523437499999998,41.234756097561,1035.0609756097592,25.87652439024398,0
2740,4,0,0,42,0.0,0.0,1.0,42,900,500,400,0.5555555555555556,13,5,8,357.5118454362026,0.7670586527293844,0.10867695787707565,0.22499618240577368,134024.11268300976,1183.0415716505004,135207.15425466027,2733,2,736.7380952380952,40,2,16,31.87833284260805,0.6533854166666665,41.13313008130083,1035.467479674799,25.886686991869976,0
2741,4,0,0,42,0.0,0.0,1.0,42,1100,800,300,0.7272727272727273,14,8,6,356.74794430793827,0.7648325590398761,0.10791953394720077,0.2251598635498958,134129.3637736302,1170.0749595148532,135299.43873314507,2734,3,737.7380952380952,40,2,16,31.792856208509114,0.6544270833333332,41.03150406504066,1035.8739837398382,25.896849593495954,0
2742,4,0,0,42,0.0,0.0,1.0,42,1100,800,300,0.7272727272727273,14,8,6,358.0824481743408,0.7642518389469609,0.10894218891730123,0.22685793426788012,134267.88199365413,1215.7943790942493,135483.67637274836,2735,4,738.7380952380952,41,1,17,31.61982307520501,0.6542174796747966,40.89781746031747,1036.4087301587317,25.278261711188577,0
2743,4,0,0,42,0.0,0.0,1.0,42,700,300,400,0.42857142857142855,11,3,8,357.1796863466034,0.7638162988772745,0.11069411973804777,0.22660416166579608,134319.2960778062,1195.2248086734828,135514.5208864797,2736,5,739.7380952380952,41,1,17,31.591838931955223,0.6547256097560975,40.84821428571429,1036.6071428571436,25.283101045296185,0
2744,4,0,0,42,0.0,0.0,1.0,42,1250,900,350,0.72,16,9,7,357.86478017902266,0.7634775454897406,0.11438730280211185,0.22767866994591157,134422.15377180983,1220.9909021479114,135643.14467395775,2737,6,740.7380952380952,41,1,17,31.47132800790841,0.6557418699186991,40.749007936507944,1037.0039682539696,25.292779713511454,0
2745,4,0,0,42,0.0,0.0,1.0,42,1000,500,500,0.5,15,5,10,357.8974532668826,0.7628726287262872,0.11369286670491507,0.22850375862424072,134550.78125000012,1231.0763888889032,135781.85763888902,2738,7,741.7380952380952,41,1,19,31.342034805890233,0.6570121951219511,40.62500000000001,1037.500000000001,25.30487804878051,0
2746,4,0,0,42,0.0,0.0,1.0,42,950,800,150,0.8421052631578947,11,8,3,356.13798618245875,0.7636711188540457,0.11732698020529986,0.22790015795628504,134633.92710387913,1189.6511341223031,135823.57823800144,2739,8,742.7380952380952,38,4,20,31.3046891085032,0.662828947368421,40.5448717948718,1037.8205128205138,27.31106612685563,0
2747,4,0,0,42,0.0,0.0,1.0,42,1000,700,300,0.7,13,7,6,356.716815235233,0.7631629887727449,0.11452344190378105,0.22844455240674305,134661.64809564265,1207.2148486010783,135868.86294424374,2740,9,743.7380952380952,38,4,20,31.262008920912663,0.6631030701754386,40.5181623931624,1037.9273504273517,27.313877642825044,0
2748,4,0,0,42,0.0,0.0,1.0,42,850,500,350,0.5882352941176471,12,5,7,356.716815235233,0.7631629887727449,0.11452344190378105,0.22844455240674305,134661.64809564265,1207.2148486010783,135868.86294424374,2741,10,744.7380952380952,38,4,20,31.262008920912663,0.6631030701754386,40.5181623931624,1037.9273504273517,27.313877642825044,0
2749,4,1,0,43,0.023255813953488372,0.0,1.0,43,600,400,200,0.6666666666666666,8,4,4,353.7856940176002,0.7681339977851606,0.12085375464579995,0.2282444057006172,134929.30230034713,947.2113715277726,135876.5136718749,2742,0,728.3953488372093,39,4,17,31.071201791324118,0.6639957264957266,40.260416666666664,1038.9583333333328,26.63995726495725,0
2750,4,0,0,43,0.0,0.0,1.0,43,1050,900,150,0.8571428571428571,12,9,3,352.66422006317555,0.7674880029531193,0.1240582953013114,0.22812757612815282,135025.6659912254,923.7442370612658,135949.41022828667,2743,1,729.3953488372093,40,3,17,31.004326782047524,0.66328125,40.167682926829265,1039.3292682926824,25.98323170731706,0
2751,4,0,1,42,0.0,0.023255813953488372,0.9767441860465116,43,900,500,400,0.5555555555555556,13,5,8,332.4197033153424,0.7675341454411222,0.10595627915893036,0.20854688903722005,133908.25897778105,304.114601963288,134212.37357974434,2744,2,730.3953488372093,41,2,14,32.64351496852936,0.650660569105691,41.24503968253969,1035.0198412698423,25.24438637243518,6
2752,4,0,0,42,0.0,0.0,1.0,42,1050,900,150,0.8571428571428571,12,9,3,337.8659641818064,0.7625580720092915,0.11271057234522197,0.2115714174230726,133840.0226799527,643.9976617754298,134484.02034172814,2745,14,748.7380952380952,40,2,15,32.570753944870035,0.6515624999999998,41.31097560975611,1034.7560975609779,25.868902439024446,0
2753,4,0,0,42,0.0,0.0,1.0,42,900,600,300,0.6666666666666666,12,6,6,331.16028459034965,0.7612756484707704,0.1341018555434872,0.2018232561394913,132832.28344868054,397.75535793022146,133230.03880661077,2746,15,749.7380952380952,41,1,12,33.75226558239502,0.6399898373983739,42.286706349206355,1030.8531746031758,25.14276035617502,6
2754,4,0,0,42,0.0,0.0,1.0,42,1000,700,300,0.7,13,7,6,329.1500867258441,0.7597270615563299,0.1379990379990379,0.2011472752213493,132934.57031250003,351.0850694444441,133285.65538194447,2747,16,750.7380952380952,41,1,13,33.70159932659933,0.6410060975609755,42.1875,1031.2500000000002,25.15243902439025,0
2755,4,0,0,42,0.0,0.0,1.0,42,1250,800,450,0.64,17,8,9,339.33590143120966,0.7605497483546264,0.15437552213868,0.2014806914747807,131848.0642804967,598.0695433609258,132446.13382385764,2748,17,751.7380952380952,36,6,17,34.53056469298246,0.6388888888888888,43.24324324324324,1027.0270270270269,28.528528528528525,8
2756,4,0,0,42,0.0,0.0,1.0,42,1100,700,400,0.6363636363636364,15,7,8,337.4547204947336,0.7588317847464189,0.15881714369219857,0.20097499150091058,131963.7458404351,506.357793604422,132470.10363403952,2749,18,752.7380952380952,36,6,18,34.462452506210724,0.6400462962962963,43.130630630630634,1027.477477477478,28.541041041041055,0
2757,4,0,0,42,0.0,0.0,1.0,42,800,400,400,0.5,12,4,8,339.4012894916528,0.7588075880758808,0.15394147140613645,0.2025974865395889,132050.54029959018,563.6247311500744,132614.16503074026,2750,19,753.7380952380952,36,6,18,34.325125086738986,0.6409143518518519,43.046171171171174,1027.8153153153157,28.550425425425438,0
2758,4,1,0,43,0.023255813953488372,0.0,1.0,43,950,600,350,0.631578947368421,13,6,7,332.3124415824681,0.7648578811369509,0.15540880425220793,0.20004825299881115,132369.79316953314,197.6258319867831,132567.4190015199,2751,0,737.1860465116279,37,6,19,34.18653436334576,0.6421734234234233,42.735745614035096,1029.057017543861,27.812351825509758,0
2759,4,0,0,43,0.0,0.0,1.0,43,1200,800,400,0.6666666666666666,16,8,8,332.6491806247436,0.762735326688815,0.1501014299266581,0.2008516499604962,132482.65241468526,214.0491545475488,132696.7015692328,2752,1,738.1860465116279,37,6,19,34.064574679589576,0.6432995495495495,42.62609649122807,1029.4956140350876,27.824205784732097,0
2760,4,0,0,43,0.0,0.0,1.0,43,900,700,200,0.7777777777777778,11,7,4,332.64473153417714,0.7624584717607973,0.15520383503030777,0.20130150248511575,132567.32840874133,219.56467374578514,132786.8930824871,2753,2,739.1860465116279,37,6,19,33.9797167802385,0.644144144144144,42.543859649122815,1029.8245614035102,27.833096254148924,0
2761,4,0,0,43,0.0,0.0,1.0,43,1200,900,300,0.75,15,9,6,333.3781539732546,0.7622739018087855,0.1543029937096958,0.20265769023548824,132736.76155163138,250.30730609419777,132987.0688577256,2754,3,740.1860465116279,37,6,16,33.790877491664894,0.6458333333333333,42.37938596491229,1030.4824561403518,27.85087719298248,0
2762,4,0,1,42,0.0,0.023255813953488372,0.9767441860465116,43,750,300,450,0.4,12,3,9,333.8506797071956,0.7623200442967885,0.15781985713472735,0.20309789893643596,132765.01092884364,264.7378279855509,133029.74875682918,2755,4,741.1860465116279,37,6,16,33.75037681313616,0.6461148648648647,42.351973684210535,1030.592105263159,27.853840682788082,0
2763,4,0,2,40,0.0,0.047619047619047616,0.9523809523809523,42,1050,600,450,0.5714285714285714,15,6,9,335.97711483622885,0.762461285327139,0.14552852939538008,0.20500926741110073,132878.03849501783,528.7959997306975,133406.83449474853,2756,5,743.9761904761905,37,5,17,33.58225654932822,0.6472409909909909,42.242324561403514,1031.0307017543869,27.865694642010457,0
2764,4,0,1,39,0.0,0.025,0.975,40,1150,800,350,0.6956521739130435,15,8,7,349.762452702682,0.7529113247863248,0.13723458038422653,0.21221783173187295,132666.1512586807,1280.327690972246,133946.47894965296,2757,26,765.175,35,5,17,33.43971183013147,0.6491071428571427,42.44791666666668,1030.2083333333346,29.434523809523846,0
2765,4,0,0,39,0.0,0.0,1.0,39,1200,900,300,0.75,15,9,6,346.9361788460649,0.749212775528565,0.14806497492327275,0.21134156010964808,132815.23946544935,1415.6823345336215,134230.92179998299,2758,27,782.0769230769231,35,4,18,33.36280784489858,0.650595238095238,42.30324074074075,1030.7870370370379,29.451058201058224,0
2766,4,0,0,39,0.0,0.0,1.0,39,550,300,250,0.5454545454545454,8,3,5,344.6089601219881,0.74842555105713,0.14851590583995988,0.21042640340827903,132904.73257726768,1360.0323377486247,134264.7649150163,2759,28,783.0769230769231,35,4,18,33.33298256444793,0.6514880952380953,42.21643518518518,1031.1342592592594,29.46097883597884,0
2767,4,0,0,39,0.0,0.0,1.0,39,750,500,250,0.6666666666666666,10,5,5,351.91695004180724,0.7479757085020243,0.14654255021227502,0.21481010630551908,132891.02447041633,1553.3208039120132,134444.34527432834,2760,29,784.0769230769231,36,3,14,33.15835699723313,0.6493055555555556,42.229729729729726,1031.0810810810808,28.641141141141134,1
2768,4,0,0,39,0.0,0.0,1.0,39,800,600,200,0.75,10,6,4,351.9972445224157,0.7460076473234368,0.14440152278580243,0.21552772458725436,133007.16256797328,1563.6309451343118,134570.7935131076,2761,30,785.0769230769231,36,3,14,33.039710698689944,0.650462962962963,42.11711711711711,1031.5315315315308,28.653653653653635,0
2769,4,0,0,39,0.0,0.0,1.0,39,900,600,300,0.6666666666666666,12,6,6,353.94002571577664,0.7453328834907783,0.1506837047112095,0.21705478685461463,133065.2506391525,1619.4236466195707,134684.67428577208,2762,31,786.0769230769231,36,3,14,32.93131048533798,0.6510416666666667,42.0608108108108,1031.7567567567555,28.659909909909874,0
2770,4,0,0,39,0.0,0.0,1.0,39,850,600,250,0.7058823529411765,11,6,5,353.5626379275101,0.7446581196581197,0.1546855588758691,0.21716139503804952,133123.35139193232,1613.488657576479,134736.84004950878,2763,32,787.0769230769231,36,3,15,32.882747708424276,0.6516203703703705,42.004504504504496,1031.9819819819807,28.66616616616613,0
2771,4,0,0,39,0.0,0.0,1.0,39,800,500,300,0.625,11,5,6,355.17305663299885,0.7437022042285201,0.14845922355216068,0.2187020489339228,133217.40974386327,1663.0469230916983,134880.45666695497,2764,33,788.0769230769231,37,2,15,32.746835723136826,0.6506193693693694,41.913377192982445,1032.3464912280685,27.901256519677528,0
2772,4,0,0,39,0.0,0.0,1.0,39,1150,900,250,0.782608695652174,14,9,5,354.79337898930754,0.7427462887989204,0.1516354389575878,0.21896749956233943,133302.32018505692,1658.9561211141872,134961.27630617112,2765,34,789.0769230769231,37,2,15,32.67148014440433,0.651463963963964,41.83114035087719,1032.6754385964912,27.910146989094358,0
2773,4,0,0,39,0.0,0.0,1.0,39,1450,1000,450,0.6896551724137931,19,10,9,350.0743890844601,0.7383603238866397,0.14351374534440908,0.21721654284165584,133501.31539901384,1547.1864924275087,135048.50189144135,2766,35,790.0769230769231,36,3,17,32.59393955904252,0.6553819444444444,41.63851351351351,1033.4459459459456,28.70683183183182,0
2774,4,0,0,39,0.0,0.0,1.0,39,1100,900,200,0.8181818181818182,13,9,4,350.0743890844601,0.7383603238866397,0.14351374534440908,0.21721654284165584,133501.31539901384,1547.0782860563172,135048.39368507016,2767,36,791.0769230769231,36,3,17,32.59393955904252,0.6553819444444444,41.63851351351351,1033.4459459459456,28.70683183183182,0
2775,4,0,0,39,0.0,0.0,1.0,39,850,700,150,0.8235294117647058,10,7,3,350.4008561095139,0.7382478632478633,0.14250874774679234,0.21841576166350457,133670.57802641185,1567.6569954216495,135238.2350218335,2768,37,792.0769230769231,37,2,18,32.41603488495386,0.6551238738738739,41.474780701754376,1034.1008771929814,27.948672356567066,0
2776,4,0,0,39,0.0,0.0,1.0,39,900,700,200,0.7777777777777778,11,7,4,350.7274973467814,0.7385852451641925,0.14639435815906454,0.21929184476254984,133783.99032635018,1584.3448224453432,135368.3351487955,2769,38,793.0769230769231,37,2,14,32.29409556615439,0.6562500000000002,41.365131578947356,1034.5394736842086,27.960526315789423,0
2777,4,0,0,39,0.0,0.0,1.0,39,650,400,250,0.6153846153846154,9,4,5,350.5438840471167,0.7375730994152047,0.14917229160552647,0.2193456293016305,133812.35091566612,1581.4202446906513,135393.77116035676,2770,39,794.0769230769231,37,2,14,32.270471244877776,0.6565315315315317,41.3377192982456,1034.6491228070156,27.963489805595017,0
2778,4,0,0,39,0.0,0.0,1.0,39,1650,1200,450,0.7272727272727273,21,12,9,350.63499710536894,0.7370670265407108,0.14404374967755285,0.2205893589384408,134010.9592013888,1597.7864583333246,135608.7456597221,2771,40,795.0769230769231,37,2,14,32.0695003353454,0.6585022522522523,41.14583333333333,1035.4166666666658,27.98423423423421,0
2779,4,0,1,38,0.0,0.02564102564102564,0.9743589743589743,39,950,700,250,0.7368421052631579,12,7,5,330.3389005052844,0.7362235717498876,0.07180801542185566,0.19577806736275197,131778.0711372729,916.050251038771,132694.12138831167,2772,41,796.0769230769231,37,2,15,34.83198063505625,0.6362612612612613,43.311403508771924,1026.7543859649115,27.750118539592204,6
2780,4,0,0,38,0.0,0.0,1.0,38,800,600,200,0.75,10,6,4,337.7791599704342,0.7274182076813656,0.08278677166809056,0.19994771573314796,131732.4334469605,1299.2941421150915,133031.7275890756,2773,42,815.9473684210526,36,2,15,34.686951513821846,0.6377314814814814,43.35585585585586,1026.5765765765768,28.516016016016025,0
2781,4,0,0,38,0.0,0.0,1.0,38,850,500,350,0.5882352941176471,12,5,7,337.5235198485883,0.7267366050260787,0.08167217979136687,0.19994814362960253,131761.33639974444,1294.5100083191428,133055.84640806357,2774,43,816.9473684210526,36,2,15,34.66440897956199,0.6380208333333333,43.32770270270271,1026.68918918919,28.519144144144168,0
2782,4,0,0,38,0.0,0.0,1.0,38,1000,600,400,0.6,14,6,8,336.7679641523817,0.7267069701280228,0.07973205322009269,0.20026058468044508,131905.89871966562,1284.3361943024136,133190.23491396804,2775,44,817.9473684210526,36,2,16,34.53829569538845,0.6394675925925927,43.18693693693694,1027.2522522522524,28.53478478478479,0
2783,4,2,1,39,0.05,0.025,0.975,40,900,700,200,0.7777777777777778,11,7,4,324.96033712195157,0.7439636752136752,0.08630286566528178,0.19591539399895685,132426.21678064397,607.5698554020648,133033.78663604605,2776,0,778.0,37,3,17,34.319071588366896,0.6427364864864864,42.680921052631575,1029.276315789473,27.818278805120894,0
2784,4,0,0,39,0.0,0.0,1.0,39,1100,900,200,0.8181818181818182,13,9,4,334.22523814887086,0.7329622132253711,0.08966238828143136,0.20105704363596344,132343.03232750745,1046.476299400978,133389.5086269084,2777,1,798.9487179487179,38,1,17,34.16420067144292,0.6400767543859649,42.761752136752136,1028.9529914529912,27.077710301394507,0
2785,4,0,1,38,0.0,0.02564102564102564,0.9743589743589743,39,1150,800,350,0.6956521739130435,15,8,7,332.7421765522494,0.7313877642825012,0.09125670523199259,0.20075729778100998,132454.43309479827,1014.6466866657199,133469.07978146398,2778,2,799.9487179487179,37,2,19,34.09050560999857,0.6430180180180181,42.653508771929815,1029.3859649122796,27.821242294926478,0
2786,4,0,0,38,0.0,0.0,1.0,38,950,600,350,0.631578947368421,13,6,7,340.1592962846914,0.7300853485064012,0.08972011584589956,0.20524066847117928,132455.95838659618,1411.2251186997914,133867.18350529598,2779,3,807.0526315789474,36,2,20,33.89809648834919,0.6449652777777778,42.65202702702703,1029.3918918918928,28.594219219219244,0
2787,4,0,0,38,0.0,0.0,1.0,38,850,500,350,0.5882352941176471,12,5,7,339.9955719664526,0.7301149834044571,0.09554151125846122,0.2056163697130452,132542.91453615786,1412.8008075643309,133955.7153437222,2780,4,808.0526315789474,36,2,20,33.814978856809574,0.6458333333333334,42.56756756756757,1029.7297297297303,28.603603603603617,0
2788,4,0,0,38,0.0,0.0,1.0,38,800,500,300,0.625,11,5,6,337.61555999328965,0.7284257942152679,0.09462366796275279,0.20461681100496534,132623.7941001077,1355.171302708518,133978.96540281622,2781,5,809.0526315789474,37,1,21,33.795064225392075,0.6447072072072072,42.489035087719294,1030.0438596491226,27.83902323376007,0
2789,4,0,0,38,0.0,0.0,1.0,38,900,500,400,0.5555555555555556,13,5,8,339.0813081655975,0.7264995258416311,0.09427374692716417,0.20627994921996448,132765.01092884355,1403.6267168744262,134168.63764571797,2782,6,810.0526315789474,37,1,14,33.615610703266306,0.6461148648648647,42.35197368421053,1030.5921052631584,27.853840682788064,0
2790,4,0,0,38,0.0,0.0,1.0,38,1250,700,550,0.56,18,7,11,349.7540254478714,0.7267958748221907,0.08821337033617893,0.21735898439986526,133559.51126379744,1812.5988509682843,135372.11011476573,2783,7,811.0526315789474,36,2,20,32.54394087954388,0.6559606481481483,41.5822072072072,1033.67117117117,28.713088088088057,3
2791,4,1,1,38,0.02564102564102564,0.02564102564102564,0.9743589743589743,39,1100,900,200,0.8181818181818182,13,9,4,344.51441975304635,0.7387539361223572,0.07918639941528616,0.2157387245659915,133840.71451071452,1422.0112197983638,135262.72573051287,2784,0,791.2307692307693,37,2,17,32.39807407014942,0.6568130630630633,41.31030701754384,1034.758771929822,27.966453295400594,0
2792,4,2,1,39,0.05,0.025,0.975,40,950,600,350,0.631578947368421,13,6,7,338.4914993714358,0.746474358974359,0.09231601731601735,0.21464343313082804,134301.49778106503,1091.9830703484506,135393.48085141348,2785,0,772.4,38,2,18,32.09389816532673,0.6595394736842106,40.86538461538461,1036.5384615384612,27.27732793522266,0
2793,4,0,1,38,0.0,0.02564102564102564,0.9743589743589743,39,750,600,150,0.8,9,6,3,343.81016957414187,0.7352676563202879,0.09002716336825789,0.2173018255723119,134181.312098434,1426.5799332486804,135607.89203168268,2786,1,793.2051282051282,37,2,19,32.07603538293295,0.6601914414414415,40.9813596491228,1036.0745614035077,28.002015173067775,0
2794,4,0,0,38,0.0,0.0,1.0,38,1500,1000,500,0.6666666666666666,20,10,10,346.8244328922496,0.7350640113798008,0.09067505720823821,0.21914730649784983,134171.33349565772,1706.7793300056728,135878.11282566338,2787,2,809.4473684210526,36,2,19,32.00792572463767,0.6620370370370371,40.99099099099099,1036.0360360360353,28.778778778778758,0
2795,4,0,0,38,0.0,0.0,1.0,38,900,600,300,0.6666666666666666,12,6,6,362.7959079074302,0.735567804646752,0.10253852925771989,0.2287697026764741,134096.12212411498,2129.9048745767755,136226.02699869176,2788,3,810.4473684210526,37,1,18,31.669489731103106,0.6593468468468469,41.06359649122806,1035.7456140350866,27.99312470365099,1
2796,4,0,0,38,0.0,0.0,1.0,38,1350,1100,250,0.8148148148148148,16,11,5,364.8116057159615,0.7345009483167378,0.1059093542492977,0.23039706221954556,134152.91243459514,2188.107879347479,136341.02031394263,2789,4,811.4473684210526,37,1,18,31.56047135196161,0.6599099099099099,41.008771929824555,1035.964912280701,27.999051683262188,0
2797,4,0,0,38,0.0,0.0,1.0,38,950,700,250,0.7368421052631579,12,7,5,365.17717692117986,0.7340267899478425,0.1024901441076238,0.23134414720234525,134266.52912434592,2206.2144121268034,136472.74353647273,2790,5,812.4473684210526,37,1,18,31.437350119904078,0.6610360360360361,40.89912280701754,1036.4035087719296,28.010905642484584,0
2798,4,0,0,38,0.0,0.0,1.0,38,950,400,550,0.42105263157894735,15,4,11,368.02443929202354,0.7327524893314367,0.1062734838153021,0.2336918115182055,134351.77320185045,2288.947200100018,136640.72040195047,2791,6,813.4473684210526,37,1,18,31.27831394323991,0.6618806306306306,40.816885964912274,1036.73245614035,28.01979611190135,0
2799,4,0,0,38,0.0,0.0,1.0,38,850,600,250,0.7058823529411765,11,6,5,368.3921172489932,0.7323672356567094,0.11151663513964594,0.23483756261290264,134493.9067790089,2309.299015081561,136803.20579409046,2792,7,814.4473684210526,37,1,20,31.126673713883008,0.6632882882882883,40.67982456140351,1037.2807017543857,28.034613560929344,0
2800,4,0,0,38,0.0,0.0,1.0,38,700,500,200,0.7142857142857143,9,5,4,367.5747165368303,0.732604314841157,0.10938490805326606,0.23468231901966835,134550.78124999985,2291.529124345939,136842.3103743458,2793,8,815.4473684210526,34,4,20,31.09103078982598,0.6700367647058825,40.62499999999999,1037.4999999999989,30.514705882352906,0
2801,4,0,0,38,0.0,0.0,1.0,38,1100,900,200,0.8181818181818182,13,9,4,370.88178877402004,0.7334340919867236,0.12109367926065895,0.2375987006848404,134674.321499433,2389.6506519274217,137063.97215136042,2794,9,816.4473684210526,34,4,20,30.881790725236062,0.6712622549019609,40.50595238095237,1037.9761904761895,30.528711484593806,0
2802,4,0,0,38,0.0,0.0,1.0,38,700,500,200,0.7142857142857143,9,5,4,372.09933946092195,0.7327228544333808,0.12920168701014267,0.23919104923490195,134797.91843820843,2431.643282312906,137229.56172052133,2795,10,817.4473684210526,34,4,20,30.72671863655471,0.6724877450980393,40.38690476190475,1038.4523809523796,30.542717086834696,0
2803,4,0,0,38,0.0,0.0,1.0,38,800,600,200,0.75,10,6,4,368.17150254435825,0.7330784732100522,0.12816021609758144,0.23788075837969672,134983.42013888882,2339.4097222222135,137322.82986111104,2796,11,818.4473684210526,34,4,20,30.64354450681636,0.6743259803921569,40.20833333333333,1039.166666666666,30.56372549019606,0
2804,4,0,0,38,0.0,0.0,1.0,38,1000,600,400,0.6,14,6,8,363.41555357543723,0.7314485538169748,0.12367276101864455,0.23581511477918776,135138.10232426296,2222.2576530612127,137360.35997732417,2797,12,819.4473684210526,34,4,20,30.612882604381337,0.6758578431372548,40.0595238095238,1039.7619047619041,30.58123249299718,0
2805,4,0,0,38,0.0,0.0,1.0,38,850,800,50,0.9411764705882353,9,8,1,362.6299922444528,0.7316559981033666,0.1218479799957819,0.23550728492604409,135169.04939058947,2203.2702664398967,137372.31965702935,2798,13,820.4473684210526,34,4,20,30.60246136233543,0.6761642156862746,40.0297619047619,1039.8809523809516,30.5847338935574,0
2806,4,0,0,38,0.0,0.0,1.0,38,950,700,250,0.7368421052631579,12,7,5,363.92020039937285,0.731359649122807,0.12410317885821343,0.2367513619426151,135230.95415249435,2242.6551870748303,137473.60933956917,2799,14,821.4473684210526,34,4,20,30.50722978901988,0.6767769607843137,39.970238095238095,1040.1190476190477,30.591736694677873,0
2807,4,0,0,38,0.0,0.0,1.0,38,1000,700,300,0.7,13,7,6,361.25425469957673,0.7297297297297297,0.1239380295214616,0.23548328466239968,135302.33417191767,2175.7087780778256,137478.0429499955,2800,15,822.4473684210526,35,3,20,30.50545574220343,0.6752976190476192,39.90162037037036,1040.393518518517,29.72552910052906,0
2808,4,0,0,38,0.0,0.0,1.0,38,850,600,250,0.7058823529411765,11,6,5,362.77007003457413,0.72958155523945,0.125046825248174,0.23706602251096584,135392.66117969813,2223.281035665285,137615.9422153634,2801,16,823.4473684210526,35,3,20,30.376075029655993,0.6761904761904762,39.81481481481481,1040.74074074074,29.735449735449713,0
2809,4,0,0,38,0.0,0.0,1.0,38,1150,900,250,0.782608695652174,14,9,5,365.30044181485925,0.730766951161688,0.1311577075191317,0.23952206811709004,135513.1440757888,2300.602280521267,137813.74635631006,2802,17,824.4473684210526,35,3,20,30.1902697495183,0.6773809523809524,39.699074074074076,1041.203703703704,29.748677248677254,0
2810,4,0,0,38,0.0,0.0,1.0,38,1600,1300,300,0.8125,19,13,6,366.3999999999999,0.7291666666666666,0.12905263157894709,0.24105263157894755,135633.6805555557,2339.2896947873996,137972.97025034312,2803,18,825.4473684210526,34,4,20,30.04166666666668,0.6807598039215685,39.58333333333334,1041.6666666666679,30.63725490196082,0
2811,4,0,0,38,0.0,0.0,1.0,38,650,300,350,0.46153846153846156,10,3,7,366.3999999999999,0.7291666666666666,0.12905263157894709,0.24105263157894755,135633.6805555557,2339.236111111131,137972.91666666683,2804,19,826.4473684210526,34,4,20,30.04166666666668,0.6807598039215685,39.58333333333334,1041.6666666666679,30.63725490196082,0
2812,4,0,0,38,0.0,0.0,1.0,38,700,500,200,0.7142857142857143,9,5,4,366.3999999999999,0.7291666666666666,0.12905263157894709,0.24105263157894755,135633.6805555557,2339.236111111131,137972.91666666683,2805,20,827.4473684210526,34,4,20,30.04166666666668,0.6807598039215685,39.58333333333334,1041.6666666666679,30.63725490196082,0
2813,4,0,0,38,0.0,0.0,1.0,38,1400,1000,400,0.7142857142857143,18,10,8,369.00105778903696,0.7288703176861072,0.12877658039064732,0.24318503447060633,135695.6916099774,2414.370748299324,138110.06235827671,2806,21,828.4473684210526,34,4,20,29.912210542352224,0.6813725490196079,39.523809523809526,1041.9047619047624,30.644257703081248,0
2814,4,0,0,38,0.0,0.0,1.0,38,600,400,200,0.6666666666666666,8,4,4,369.00105778903696,0.7297297297297297,0.12877658039064732,0.24318503447060633,135695.6916099774,2414.370748299324,138110.06235827671,2807,22,829.4473684210526,34,4,20,29.912210542352224,0.6813725490196079,39.523809523809526,1041.9047619047624,30.644257703081248,0
2815,4,0,0,38,0.0,0.0,1.0,38,950,700,250,0.7368421052631579,12,7,5,367.08621181118485,0.7298482693219536,0.12408162283707913,0.2423433407386962,135757.71683673467,2366.9571995464876,138124.67403628115,2808,23,830.4473684210526,34,4,20,29.900378874419328,0.6819852941176471,39.464285714285715,1042.142857142857,30.65126050420168,0
2816,4,0,0,38,0.0,0.0,1.0,38,950,500,450,0.5263157894736842,14,5,9,365.4246866295932,0.72958155523945,0.12366948546426015,0.24187634019768317,135850.78125,2328.645833333334,138179.42708333334,2809,24,831.4473684210526,34,4,20,29.851119104716243,0.6829044117647058,39.375,1042.5,30.66176470588235,0
2817,4,0,0,38,0.0,0.0,1.0,38,800,400,400,0.5,12,4,8,364.251787186942,0.7276256519677572,0.12753590974354023,0.24194161543175147,135974.91673752846,2305.821286848085,138280.73802437654,2810,25,832.4473684210526,34,4,19,29.758303846592852,0.6841299019607843,39.25595238095239,1042.9761904761915,30.67577030812328,0
2818,4,0,0,38,0.0,0.0,1.0,38,750,500,250,0.6666666666666666,10,5,5,366.3239251856091,0.7287814129919393,0.12600718085425777,0.24438322132245416,136130.16581632648,2373.5473356009006,138503.71315192737,2811,26,833.4473684210526,34,4,19,29.55001330899688,0.6856617647058824,39.107142857142854,1043.571428571428,30.69327731092435,0
2819,4,0,0,38,0.0,0.0,1.0,38,700,700,0,1.0,7,7,0,364.10213505125455,0.727181128496918,0.12727177224498343,0.2432202262142382,136176.75781250003,2316.449652777778,138493.2074652778,2812,27,834.4473684210526,35,3,19,29.561709913506313,0.6839285714285714,39.0625,1043.7500000000002,29.821428571428577,0
2820,4,0,0,38,0.0,0.0,1.0,38,650,300,350,0.46153846153846156,10,3,7,363.96467476368184,0.7278330962541489,0.12548685629932432,0.24343091883544965,136220.83865960562,2315.9146477558716,138536.7533073615,2813,28,835.4473684210526,36,2,19,29.521530025170808,0.6822916666666667,39.020270270270274,1043.9189189189194,28.997747747747763,0
2821,4,0,0,38,0.0,0.0,1.0,38,850,500,350,0.5882352941176471,12,5,7,362.8645624460015,0.7275367472735894,0.12569946539845378,0.24350260145616628,136338.4224596218,2294.476402077755,138632.89886169956,2814,29,836.4473684210526,36,2,19,29.43354180145209,0.6834490740740741,38.90765765765766,1044.3693693693695,29.010260260260264,0
2822,4,0,0,38,0.0,0.0,1.0,38,850,500,350,0.5882352941176471,12,5,7,361.8515994507449,0.7276256519677572,0.12591005816427847,0.24302487942836068,136367.82633562628,2268.9832146335634,138636.80955025984,2815,30,837.4473684210526,36,2,19,29.430817610062896,0.6837384259259259,38.87950450450451,1044.4819819819827,29.013388388388407,0
2823,4,0,0,38,0.0,0.0,1.0,38,800,500,300,0.625,11,5,6,363.2153070579199,0.7273589378852536,0.131159165428121,0.24455091573899707,136456.05698604003,2312.5857276195075,138768.64271365953,2816,31,838.4473684210526,36,2,19,29.30768125314364,0.6846064814814815,38.79504504504504,1044.8198198198195,29.022772772772765,0
2824,4,0,0,38,0.0,0.0,1.0,38,750,400,350,0.5333333333333333,11,4,7,364.81563355828155,0.7266773352299668,0.1317887704931977,0.24624391964032105,136544.31617005527,2362.700242472213,138907.01641252748,2817,32,839.4473684210526,36,2,19,29.1783392594189,0.685474537037037,38.71058558558559,1045.1576576576583,29.032157157157176,0
2825,4,0,0,38,0.0,0.0,1.0,38,1250,1100,150,0.88,14,11,3,358.2221971450806,0.7261735419630156,0.15025835657780418,0.227797651333695,134404.77639801972,2029.4689960230612,136434.24539404278,2818,33,840.4473684210526,36,2,18,31.479420069504773,0.6643518518518519,40.76576576576577,1036.9369369369376,28.803803803803824,7
2826,4,0,0,38,0.0,0.0,1.0,38,1050,700,350,0.6666666666666666,14,7,7,353.52776655418796,0.7255215742057848,0.14064035468610747,0.2255330876383088,134521.5739388037,1911.4223175878635,136432.99625639155,2819,34,841.4473684210526,36,2,18,31.484522000289495,0.6655092592592593,40.653153153153156,1037.3873873873874,28.816316316316318,0
2827,4,1,1,38,0.02564102564102564,0.02564102564102564,0.9743589743589743,39,1100,900,200,0.8181818181818182,13,9,4,346.42836054376795,0.7359424201529465,0.13471197276075353,0.22332645884110844,134901.5162755662,1546.7453940427047,136448.26166960888,2820,0,820.8461538461538,36,3,16,31.289972899728994,0.6692708333333333,40.28716216216217,1038.8513513513522,28.856981981982003,0
2828,4,0,0,38,0.0,0.0,1.0,38,550,300,250,0.5454545454545454,8,3,5,355.6802369708213,0.7255808440018966,0.08582535885167442,0.21067214035964038,131755.55555555562,1805.6240361983669,133561.179591754,2821,36,843.4473684210526,34,4,18,34.20420725108226,0.642156862745098,43.333333333333336,1026.6666666666672,30.196078431372566,8
2829,4,1,1,38,0.02564102564102564,0.02564102564102564,0.9743589743589743,39,1000,700,300,0.7,13,7,6,345.97495101235614,0.7369545659019343,0.07981390801594568,0.20652147664419745,132050.54029959036,1337.2358422612024,133387.77614185156,2822,0,822.7948717948718,36,3,18,34.15621233702201,0.6409143518518517,43.04617117117118,1027.815315315317,28.550425425425473,0
2830,4,1,0,39,0.02564102564102564,0.0,1.0,39,900,600,300,0.6666666666666666,12,6,6,346.32304352451104,0.7341992802519118,0.07758845774831769,0.20768012846417355,132224.21481870403,1358.4585007304813,133582.6733194345,2823,0,823.7692307692307,36,3,19,33.97249899631373,0.6426504629629629,42.87725225225226,1028.4909909909925,28.569194194194235,0
2831,4,0,0,39,0.0,0.0,1.0,39,1100,600,500,0.5454545454545454,16,6,10,346.0456756205506,0.7340868196131354,0.07595760923256534,0.20799166397824695,132311.09487866264,1357.1364438763298,133668.23132253898,2824,1,824.7692307692307,36,3,20,33.89224861354349,0.6435185185185185,42.7927927927928,1028.8288288288304,28.57857857857862,0
2832,4,0,0,39,0.0,0.0,1.0,39,800,300,500,0.375,13,3,10,346.6701634185117,0.733187134502924,0.07079829751894517,0.20884763503505493,132398.0034722224,1379.68750000002,133777.69097222242,2825,2,825.7692307692307,36,3,20,33.78879892037787,0.644386574074074,42.70833333333334,1029.166666666668,28.587962962963005,0
2833,4,0,0,39,0.0,0.0,1.0,39,950,700,250,0.7368421052631579,12,7,5,347.1206847471662,0.7326248313090419,0.07000553403431131,0.20978163121676574,132517.14677640607,1399.8885459533662,133917.03532235944,2826,3,826.7692307692307,35,4,20,33.657449040767396,0.6476190476190475,42.592592592592595,1029.62962962963,29.41798941798943,0
2834,4,0,0,39,0.0,0.0,1.0,39,1200,800,400,0.6666666666666666,16,8,8,343.4940032824136,0.7320625281151597,0.06859118409680187,0.20824908918347973,132636.3436642662,1311.9577331961657,133948.30139746238,2827,4,827.7692307692307,35,4,16,33.63108614232208,0.6488095238095237,42.476851851851855,1030.0925925925933,29.43121693121695,0
2835,4,0,0,39,0.0,0.0,1.0,39,1050,800,250,0.7619047619047619,13,8,5,339.7504852339573,0.7321749887539362,0.06601092896174854,0.20642210756246424,132716.91243608482,1218.127079782494,133935.0395158673,2828,5,828.7692307692307,36,3,16,33.64663023679417,0.6475694444444444,42.39864864864865,1030.405405405406,28.622372372372393,0
2836,4,0,0,39,0.0,0.0,1.0,39,950,700,250,0.7368421052631579,12,7,5,340.649470312456,0.7309941520467836,0.05941165429857653,0.20744940796872344,132803.95418645008,1247.919329802785,134051.87351625288,2829,6,829.7692307692307,36,3,16,33.53613569321532,0.6484375,42.31418918918919,1030.743243243244,28.63175675675678,0
2837,4,0,0,39,0.0,0.0,1.0,39,600,300,300,0.5,9,3,6,340.1954587137424,0.7325686009896536,0.0546254371743069,0.20781653205081635,132920.05423920535,1243.759764832389,134163.81400403773,2830,7,830.7692307692307,36,3,16,33.43139128535546,0.6495949074074074,42.20157657657657,1031.1936936936931,28.644269269269255,0
2838,4,0,1,38,0.0,0.02564102564102564,0.9743589743589743,39,700,400,300,0.5714285714285714,10,4,6,340.2407332763595,0.7315564552406658,0.0555485566949705,0.2081673263913278,132978.12328798397,1248.9148354435602,134227.03812342754,2831,8,831.7692307692307,36,3,16,33.37200203806822,0.6501736111111112,42.145270270270274,1031.4189189189192,28.650525525525534,0
2839,4,0,1,37,0.0,0.02631578947368421,0.9736842105263158,38,950,600,350,0.631578947368421,13,6,7,342.7942114285282,0.7239805595068753,0.0736859820368827,0.20998795920704247,133024.10361207544,1519.9785397376372,134544.08215181308,2832,9,853.2105263157895,35,3,17,33.26005553685627,0.6526785714285714,42.100694444444436,1031.597222222221,29.474206349206316,0
2840,4,0,0,37,0.0,0.0,1.0,37,1000,800,200,0.8,12,8,4,352.26008328055025,0.716091091091091,0.08061305359850746,0.21518172365134874,132919.22477324257,1964.4274376417175,134883.6522108843,2833,48,877.027027027027,34,3,17,33.121199876856764,0.6537990196078431,42.20238095238095,1031.1904761904757,30.32913165266105,0
2841,4,0,0,37,0.0,0.0,1.0,37,1450,1000,450,0.6896551724137931,19,10,9,352.2438233549954,0.7148398398398398,0.08462126292478334,0.21570266638664531,133011.31129535128,1970.4825680271886,134981.79386337847,2834,49,878.027027027027,34,3,17,33.029188305443355,0.654718137254902,42.11309523809523,1031.5476190476174,30.33963585434169,0
2842,4,0,0,37,0.0,0.0,1.0,37,800,600,200,0.75,10,6,4,350.88059315225644,0.7158408408408409,0.08105076132897548,0.21511345305083968,133053.9547432268,1937.2101123113582,134991.16485553814,2835,50,879.027027027027,35,2,17,33.02155784907637,0.6529761904761906,42.071759259259245,1031.712962962961,29.47751322751317,0
2843,4,0,0,37,0.0,0.0,1.0,37,1100,700,400,0.6363636363636364,15,7,8,351.7791417604225,0.7147147147147147,0.08304861226902704,0.21583696137606095,133083.80922335814,1963.2216381601422,135047.0308615183,2836,51,880.027027027027,35,2,17,32.96842867825762,0.6532738095238095,42.04282407407407,1031.8287037037032,29.480820105820094,0
2844,4,0,0,37,0.0,0.0,1.0,37,900,700,200,0.7777777777777778,11,7,4,352.4610187127181,0.7157157157157157,0.08794845529539397,0.2167756803365527,133173.39275763012,1987.685935356626,135161.07869298675,2837,52,881.027027027027,35,2,17,32.860974059953634,0.6541666666666668,41.956018518518505,1032.1759259259243,29.490740740740694,0
2845,4,0,0,37,0.0,0.0,1.0,37,700,300,400,0.42857142857142855,11,3,8,352.4610187127181,0.7157157157157157,0.08794845529539397,0.2167756803365527,133173.39275763012,1987.685935356626,135161.07869298675,2838,53,882.027027027027,35,2,17,32.860974059953634,0.6541666666666668,41.956018518518505,1032.1759259259243,29.490740740740694,0
2846,4,0,0,37,0.0,0.0,1.0,37,950,700,250,0.7368421052631579,12,7,5,347.7029571235849,0.7162162162162162,0.08873298315127531,0.21453705279783,133292.8843557098,1869.266010802458,135162.15036651227,2839,54,883.027027027027,35,2,17,32.863987895090794,0.655357142857143,41.84027777777777,1032.6388888888882,29.503968253968235,0
2847,4,0,0,37,0.0,0.0,1.0,37,950,600,350,0.631578947368421,13,6,7,362.01582673885855,0.7162162162162162,0.09685603971318213,0.20626483151400096,130262.58680555568,2037.3312114197633,132299.91801697545,2840,55,884.027027027027,35,2,20,35.552721088435376,0.625,44.79166666666667,1020.8333333333344,29.166666666666696,5
2848,4,2,2,37,0.05128205128205128,0.05128205128205128,0.9487179487179487,39,1250,900,350,0.72,16,9,7,345.8940596557278,0.7406657669815565,0.08867615497571446,0.1992841409691631,130694.03863322789,1241.2583191299495,131935.29695235784,2841,0,839.6410256410256,36,3,16,35.52725770925111,0.6273148148148149,44.36936936936937,1022.522522522523,28.403403403403416,0
2849,4,0,0,37,0.0,0.0,1.0,37,1150,1000,150,0.8695652173913043,13,10,3,361.6849713520808,0.7164039039039038,0.10202372029452,0.20720830601759385,130475.34722222216,2038.1944444444352,132513.5416666666,2842,57,886.027027027027,34,3,21,35.34529635671559,0.6292892156862746,44.58333333333333,1021.6666666666661,30.04901960784312,0
2850,4,3,3,37,0.075,0.075,0.925,40,600,400,200,0.6666666666666666,8,4,4,339.64023861817884,0.7514957264957265,0.09768736616702389,0.1977705628861467,131103.44048168676,905.6007617728674,132009.04124345962,2843,0,820.5,37,3,17,35.273465381870096,0.6295045045045045,43.96929824561404,1024.1228070175446,27.678994784257963,0
2851,4,0,0,37,0.0,0.0,1.0,37,1050,700,350,0.6666666666666666,14,7,7,360.1529243875366,0.7256006006006006,0.11550199792341798,0.20763178660999596,130718.71456916102,2015.7454648526073,132734.46003401364,2844,1,882.5675675675676,34,3,18,35.13775708187815,0.6317401960784313,44.345238095238095,1022.6190476190478,30.077030812324935,0
2852,4,0,0,37,0.0,0.0,1.0,37,1050,800,250,0.7619047619047619,13,8,5,359.7103312023408,0.7237862862862863,0.11722717481879807,0.20819597957468813,130870.93431122445,2015.125425170064,132886.05973639453,2845,2,883.5675675675676,34,3,18,34.99490983129727,0.6332720588235294,44.19642857142857,1023.2142857142853,30.09453781512604,0
2853,4,1,0,38,0.02631578947368421,0.0,1.0,38,1200,1000,200,0.8333333333333334,14,10,4,347.7046435948696,0.7336119013750593,0.12313792160545889,0.20334061521723754,131268.81456832998,1528.555276920446,132797.36984525042,2846,0,861.2894736842105,35,3,19,34.89995105790226,0.6351190476190476,43.807870370370374,1024.7685185185192,29.279100529100546,0
2854,4,0,0,38,0.0,0.0,1.0,38,1250,700,550,0.56,18,7,11,347.72905098948877,0.7327228544333808,0.12188318748106286,0.20414391403021084,131417.11576485337,1539.5097897376504,132956.625554591,2847,1,862.2894736842105,35,3,20,34.74961903149339,0.6366071428571429,43.66319444444444,1025.3472222222222,29.29563492063492,0
2855,4,2,2,38,0.05,0.05,0.95,40,1250,900,350,0.72,16,9,7,331.7767391107912,0.7526709401709402,0.10890816871329445,0.19677575438711573,131806.21831957897,746.0474617189809,132552.26578129796,2848,0,820.125,37,3,14,34.76675120128138,0.6365427927927929,43.28399122807017,1026.8640350877183,27.753082029397792,0
2856,4,1,1,38,0.02564102564102564,0.02564102564102564,0.9743589743589743,39,900,400,500,0.4444444444444444,14,4,10,343.24107386342683,0.7419590643274854,0.10817088018535581,0.20364446015358417,131819.15181651243,1249.149445053163,133068.3012615656,2849,0,842.1282051282051,36,3,16,34.45941623716051,0.6385995370370371,43.2713963963964,1026.9144144144143,28.525400400400397,0
2857,4,0,1,37,0.0,0.02631578947368421,0.9736842105263158,38,1000,800,200,0.8,12,8,4,349.0625583875317,0.7317152678994784,0.10981427638995966,0.20668791007325804,131743.67310742455,1597.3567172496505,133341.0298246742,2850,4,865.2894736842105,35,3,16,34.38603908305147,0.6398809523809523,43.344907407407405,1026.6203703703702,29.33201058201058,0
2858,4,0,0,37,0.0,0.0,1.0,37,750,600,150,0.8,9,6,3,356.00965592848706,0.7272272272272272,0.11332923832923836,0.2108672577422578,131755.5555555556,1981.2500000000052,133736.8055555556,2851,5,881.8918918918919,34,3,18,34.19575216450217,0.642156862745098,43.333333333333336,1026.666666666667,30.19607843137256,0
2859,4,0,0,37,0.0,0.0,1.0,37,1150,800,350,0.6956521739130435,15,8,7,357.2785966094376,0.7283533533533534,0.11201306118470544,0.21204902927863153,131832.80452942822,2020.2078778720906,133853.01240730032,2852,6,882.8918918918919,35,2,18,34.08526334573049,0.6407738095238095,43.258101851851855,1026.967592592593,29.34193121693123,0
2860,4,0,1,36,0.0,0.02702702702702703,0.972972972972973,37,900,500,400,0.5555555555555556,13,5,8,357.54721682205934,0.7284784784784785,0.10683517320137059,0.21254062620869224,131892.24222232934,2031.5408254029473,133923.7830477323,2853,7,883.8918918918919,35,2,18,34.01842723004697,0.6413690476190477,43.20023148148148,1027.1990740740737,29.34854497354496,0
2861,4,0,0,36,0.0,0.0,1.0,36,400,0,400,0.0,8,0,8,362.6908056820432,0.7271494708994709,0.11689076929021347,0.21534298558974455,131847.23816609985,2363.9562074830096,134211.19437358287,2854,8,903.8611111111111,34,2,18,33.931745295776835,0.6430759803921567,43.24404761904763,1027.0238095238103,30.206582633053245,0
2862,4,1,1,36,0.02702702702702703,0.02702702702702703,0.972972972972973,37,1450,1100,350,0.7586206896551724,18,11,7,352.8889096286799,0.7364239239239239,0.10557198273129176,0.21132772634085317,132172.40521121884,1928.4351915974173,134100.84040281625,2855,0,880.4054054054054,37,0,18,33.85583280017062,0.6402027027027026,42.92763157894737,1028.2894736842106,27.791607396870557,0
2863,4,0,0,36,0.0,0.0,1.0,36,900,700,200,0.7777777777777778,11,7,4,364.9128026594077,0.7264550264550265,0.11504807107216775,0.21832594287551735,132137.36329234648,2443.723115006905,134581.08640735337,2856,10,905.8611111111111,36,0,19,33.582055494706104,0.6417824074074073,42.961711711711715,1028.1531531531537,28.559809809809824,0
2864,4,0,0,36,0.0,0.0,1.0,36,650,500,150,0.7692307692307693,8,5,3,364.7051194467479,0.725760582010582,0.12052447169604719,0.21870333919285304,132224.214818704,2444.5696118415913,134668.78443054558,2857,11,906.8611111111111,36,0,19,33.49985400927043,0.6426504629629629,42.87725225225226,1028.4909909909923,28.56919419419423,0
2865,4,0,0,36,0.0,0.0,1.0,36,950,600,350,0.631578947368421,13,6,7,368.68014682202516,0.7251984126984128,0.12869721735746253,0.2215961724582912,132311.0948786626,2556.094777209661,134867.18965587227,2858,12,907.8611111111111,36,0,19,33.31007370110916,0.6435185185185184,42.7927927927928,1028.8288288288302,28.578578578578615,0
2866,4,0,0,36,0.0,0.0,1.0,36,900,700,200,0.7777777777777778,11,7,4,366.4409099570129,0.7260912698412699,0.12728563535201687,0.22111755397057145,132459.27047902482,2507.7561885175187,134967.02666754235,2859,13,908.8611111111111,34,2,19,33.21840908214796,0.649203431372549,42.64880952380952,1029.404761904761,30.276610644257676,0
2867,4,0,0,36,0.0,0.0,1.0,36,650,300,350,0.46153846153846156,10,3,7,364.8392125015296,0.7268518518518519,0.12868100524205972,0.2203302730246668,132489.9092970522,2467.5028344671223,134957.41213151932,2860,14,909.8611111111111,34,2,19,33.22878122109158,0.6495098039215685,42.61904761904762,1029.5238095238096,30.28011204481793,0
2868,4,0,0,36,0.0,0.0,1.0,36,1400,800,600,0.5714285714285714,20,8,12,360.6240150756981,0.7267526455026455,0.12981047035710147,0.21867411369656742,132643.15653344677,2366.861536281179,135010.01806972796,2861,15,910.8611111111111,34,2,18,33.1830964212797,0.6510416666666667,42.470238095238095,1030.119047619048,30.297619047619058,0
2869,4,0,0,36,0.0,0.0,1.0,36,550,200,350,0.36363636363636365,9,2,7,365.01988651889155,0.7267526455026455,0.13609477320316365,0.20814378333941727,130293.86421388415,2314.5532140552396,132608.4174279394,2862,16,911.8611111111111,33,3,18,35.44429940383307,0.6297348484848484,44.76102941176471,1020.9558823529417,30.93805704099823,6
2870,4,0,0,36,0.0,0.0,1.0,36,850,500,350,0.5882352941176471,12,5,7,365.9990873413889,0.7285714285714286,0.1311885808765687,0.20903840951444785,130356.43029423783,2342.066903354486,132698.4971975923,2863,17,912.8611111111111,33,3,18,35.35578923156926,0.6303661616161615,44.69975490196079,1021.2009803921571,30.945484254307793,0
2871,4,0,1,35,0.0,0.027777777777777776,0.9722222222222222,36,950,600,350,0.631578947368421,13,6,7,361.74099668136444,0.7289351851851852,0.1278986328272531,0.20705097514330226,130439.87509645052,2237.0900848765327,132676.96518132705,2864,18,913.8611111111111,35,1,19,35.37984364377975,0.6267857142857143,44.61805555555555,1021.5277777777769,29.186507936507912,0
2872,4,1,1,35,0.027777777777777776,0.027777777777777776,0.9722222222222222,36,650,400,250,0.6153846153846154,9,4,5,359.18348894757935,0.73369708994709,0.11606042311272091,0.20684660634699584,130676.44702717768,2187.3644332990443,132863.81146047672,2865,0,880.75,35,1,15,35.20536185948231,0.6291666666666667,44.386574074074076,1022.453703703704,29.212962962962973,0
2873,4,0,0,35,0.0,0.0,1.0,35,1100,900,200,0.8181818181818182,13,9,4,364.9845421956521,0.7261204481792717,0.11768659944760573,0.20975617665942922,130597.00255102055,2533.177437641741,133130.17998866228,2866,20,906.9142857142857,34,1,16,35.13762714496467,0.6305147058823529,44.46428571428572,1022.1428571428582,30.063025210084067,0
2874,4,1,0,36,0.027777777777777776,0.0,1.0,36,400,300,100,0.75,5,3,2,356.1557330772514,0.7382605820105821,0.1193249208270668,0.20627069129846937,130895.6269402849,2123.845593904719,133019.4725341896,2867,0,882.6944444444445,36,0,17,35.06084699754229,0.6293402777777778,44.1722972972973,1023.310810810811,28.425300300300304,0
2875,4,0,0,36,0.0,0.0,1.0,36,950,600,350,0.631578947368421,13,6,7,358.7739174857724,0.737202380952381,0.1235684865373563,0.208409820055154,131010.89000740621,2200.658048250966,133211.5480556572,2868,1,883.6944444444445,36,0,18,34.8772137278627,0.6304976851851851,44.05968468468469,1023.7612612612626,28.43781281281285,0
2876,4,0,0,36,0.0,0.0,1.0,36,1100,1000,100,0.9090909090909091,12,10,2,353.68542102766634,0.7365079365079366,0.11844195195855622,0.20591646727436624,131097.3705969484,2073.4457430403495,133170.81633998876,2869,2,884.6944444444445,36,0,18,34.92000219925224,0.6313657407407407,43.97522522522523,1024.0990990991,28.44719719719722,0
2877,4,1,0,37,0.02702702702702703,0.0,1.0,37,1000,900,100,0.9,11,9,2,377.3400330826131,0.7491866866866866,0.16369017061754487,0.1979597477191902,126978.48820103875,2227.7094239509634,129206.19762498971,2870,0,861.7567567567568,36,1,16,38.52141527001862,0.5896990740740742,48.02927927927927,1007.8828828828819,27.99674674674672,8
2878,4,2,1,38,0.05128205128205128,0.02564102564102564,0.9743589743589743,39,1300,1100,200,0.8461538461538461,15,11,4,357.5756671874166,0.7737854251012146,0.16351942372009276,0.19024043503387444,127546.62390430953,1321.6152808213342,128868.23918513086,2871,0,818.5128205128206,36,3,16,38.43622259383128,0.5954861111111112,47.4662162162162,1010.1351351351335,28.059309309309263,0
2879,4,2,1,39,0.05,0.025,0.975,40,650,500,150,0.7692307692307693,8,5,3,351.29391047505135,0.7834935897435897,0.15741353138891956,0.18826169298729775,127839.40882050226,981.841167474585,128821.24998797684,2872,0,799.0,37,3,18,38.2950007228306,0.5965653153153154,47.17653508771929,1011.2938596491211,27.332266477003273,0
2880,4,1,0,40,0.025,0.0,1.0,40,1250,900,350,0.72,16,9,7,352.1433999441323,0.7787660256410256,0.16735268630849243,0.18989415118482642,128089.02739304397,1021.1411203447176,129110.1685133887,2873,0,799.975,37,3,20,38.01812536106298,0.5990990990990992,46.92982456140351,1012.2807017543856,27.358937885253667,0
2881,4,2,1,41,0.047619047619047616,0.023809523809523808,0.9761904761904762,42,900,600,300,0.6666666666666666,12,6,6,336.9238413966501,0.7974496709252806,0.16285854769681563,0.18367284196987976,128523.4166689495,260.53267363507643,128783.94934258459,2874,0,762.8333333333334,38,4,16,37.9600849928002,0.6016995614035088,46.501068376068375,1013.9957264957263,26.68409806567701,0
2882,4,0,0,41,0.0,0.0,1.0,41,1150,800,350,0.6956521739130435,15,8,7,342.52050238246136,0.7864329268292682,0.1637685741384758,0.1864702838271473,128469.25593770554,600.6708168967858,129069.92675460233,2875,1,782.439024390244,38,3,16,37.873458741700915,0.6011513157894737,46.55448717948718,1013.782051282052,26.67847503373821,0
2883,4,1,0,42,0.023809523809523808,0.0,1.0,42,1450,1200,250,0.8275862068965517,17,12,5,334.838154041865,0.793166860240031,0.16672529877947473,0.18395336241781401,128830.99500868077,227.5065104166923,129058.50151909745,2876,0,764.7857142857143,39,3,17,37.69965455913537,0.6030982905982905,46.19791666666668,1015.2083333333351,26.03098290598295,0
2884,4,2,1,43,0.045454545454545456,0.022727272727272728,0.9772727272727273,44,1250,900,350,0.72,16,9,7,326.2016463184649,0.8025237843551798,0.1868076490030146,0.18184470394991492,129408.11107806208,-356.84053984689353,129051.27053821519,2877,0,730.9772727272727,40,4,20,37.33249267545612,0.6072916666666666,45.63008130081301,1017.4796747967486,25.436991869918714,0
2885,4,1,2,42,0.022727272727272728,0.045454545454545456,0.9545454545454546,44,1400,1000,400,0.7142857142857143,18,10,8,328.69191756208147,0.8018851303735025,0.1800716748321538,0.18419983299620002,129614.99851279006,-279.3195188049374,129335.67899398512,2878,0,731.8409090909091,40,4,14,37.05921490352629,0.609375,45.426829268292686,1018.2926829268297,25.457317073170742,0
2886,4,0,0,42,0.0,0.0,1.0,42,1000,600,400,0.6,14,6,8,340.9105413016282,0.7918360433604336,0.18084584952561,0.18970247011880761,129337.19735051855,418.4827918401484,129755.68014235869,2879,2,767.6666666666666,38,4,21,37.03042397507264,0.6099232456140351,45.69978632478632,1017.2008547008537,26.768443544759307,0
2887,4,0,0,42,0.0,0.0,1.0,42,1000,800,200,0.8,12,8,4,340.7040734081473,0.7927797135114208,0.18164979377577883,0.19011167540788504,129445.89548405632,420.5487754766413,129866.44425953296,2880,3,768.6666666666666,38,4,15,36.925196850393704,0.6110197368421053,45.59294871794871,1017.6282051282034,26.779689608636932,0
2888,4,1,0,43,0.023255813953488372,0.0,1.0,43,1200,800,400,0.6666666666666666,16,8,8,331.18510457024536,0.7969269102990033,0.1813883894913877,0.18621035744905826,129744.38707325328,-6.118319948447237,129738.26875330483,2881,0,751.7674418604652,40,3,16,36.86450540315878,0.6106770833333334,45.29979674796748,1018.8008130081296,25.47002032520324,0
2889,4,1,1,43,0.022727272727272728,0.022727272727272728,0.9772727272727273,44,1200,1000,200,0.8333333333333334,14,10,4,324.8319581915641,0.8044177237491191,0.1776228537072737,0.18411919482500855,130060.11924445679,-350.4633566389752,129709.6558878178,2882,0,735.6590909090909,41,3,18,36.70654217726772,0.6122967479674797,44.99007936507935,1020.0396825396804,24.879016647309278,0
2890,4,1,1,43,0.022727272727272728,0.022727272727272728,0.9772727272727273,44,1250,900,350,0.72,16,9,7,326.3635599553998,0.8056950317124736,0.17485508270889283,0.18570953013391311,130211.95515243121,-300.7125535399464,129911.24259889126,2883,0,736.5,41,3,20,36.5138186884396,0.6138211382113821,44.841269841269835,1020.6349206349196,24.893534649632183,0
2891,4,1,2,42,0.022727272727272728,0.045454545454545456,0.9545454545454546,44,1300,900,400,0.6923076923076923,17,9,8,324.8355554541779,0.8089323467230445,0.16552214999118964,0.18546085906332643,130342.35161675388,-332.0142788741251,130010.33733787976,2884,0,737.25,39,5,20,36.42092981740282,0.6183226495726495,44.713541666666686,1021.1458333333366,26.18322649572658,0
2892,4,1,0,43,0.023255813953488372,0.0,1.0,43,1600,1300,300,0.8125,19,13,6,335.2029542940993,0.8045865633074935,0.1797611565053423,0.19164227211974638,130395.54172092045,141.79416232642393,130537.33588324687,2885,0,754.9767441860465,39,4,21,36.102434982152,0.6188568376068375,44.66145833333335,1021.3541666666691,26.18856837606844,0
2893,4,1,0,44,0.022727272727272728,0.0,1.0,44,1050,900,150,0.8571428571428571,12,9,3,332.8021152189699,0.8089323467230445,0.188830988205118,0.19230689390322384,130807.80805902607,-93.37695815979555,130714.43110086626,2886,0,738.7954545454545,40,4,16,35.74698655540101,0.6213541666666664,44.25813008130083,1022.9674796747996,25.57418699186999,0
2894,4,1,1,44,0.022222222222222223,0.022222222222222223,0.9777777777777777,45,1300,1000,300,0.7692307692307693,16,10,6,323.117052432997,0.8162457912457913,0.18741602800643364,0.18815559929280168,131104.74623107104,-527.5641675680392,130577.182063503,2887,0,723.3555555555556,42,3,17,35.69519349039645,0.6212797619047619,43.96802325581396,1024.1279069767456,24.38399778516061,0
2895,4,0,1,43,0.0,0.022727272727272728,0.9772727272727273,44,950,600,350,0.631578947368421,13,6,7,327.21030975436213,0.8108042635658915,0.18695213595397697,0.1900103087425588,130997.85175933824,-227.23046973416558,130770.62128960408,2888,1,740.7045454545455,41,3,17,35.698206383047456,0.6216971544715446,44.07242063492065,1023.7103174603195,24.968544328300474,0
2896,4,0,2,41,0.0,0.046511627906976744,0.9534883720930233,43,950,700,250,0.7368421052631579,12,7,5,334.2445512248265,0.8039405684754521,0.19047970888671295,0.19392345160924318,130963.79469892295,154.7869571683897,131118.58165609135,2889,2,758.7906976744187,40,3,17,35.55256321154356,0.6229166666666666,44.10569105691059,1023.5772357723606,25.589430894309015,0
2897,4,0,0,41,0.0,0.0,1.0,41,1150,1000,150,0.8695652173913043,13,10,3,344.9424555763961,0.7900406504065041,0.19509137742583915,0.1990436484166874,130753.83434007248,820.5097386587961,131574.3440787313,2890,3,796.170731707317,38,3,18,35.491094745638776,0.6241776315789472,44.310897435897445,1022.7564102564116,26.91464237516873,0
2898,4,1,1,41,0.023809523809523808,0.023809523809523808,0.9761904761904762,42,450,300,150,0.6666666666666666,6,3,3,339.413214231523,0.7973528842431281,0.19194687135055455,0.19701202931206033,130981.34901258706,491.36013454863564,131472.7091471357,2891,0,778.1904761904761,39,3,18,35.40256860350735,0.6247329059829059,44.08854166666668,1023.6458333333354,26.247329059829113,0
2899,4,0,0,41,0.0,0.0,1.0,41,650,300,350,0.46153846153846156,10,3,7,346.27043609268577,0.7902947154471545,0.19619181048207324,0.20009290438065588,130808.47447083435,859.0214999269589,131667.49597076132,2892,5,798.170731707317,38,3,18,35.40187119234117,0.6247258771929824,44.25747863247864,1022.9700854700862,26.920265407107532,0
2900,4,1,0,42,0.023809523809523808,0.0,1.0,42,900,400,500,0.4444444444444444,14,4,10,339.5154037767165,0.7957559039876113,0.19907474688756444,0.19748144491864658,131061.33355034748,499.46831597224724,131560.80186631973,2893,0,780.1428571428571,39,3,19,35.31917599186165,0.6255341880341879,44.01041666666668,1023.9583333333354,26.255341880341934,0
2901,4,1,1,42,0.023255813953488372,0.023255813953488372,0.9767441860465116,43,800,600,200,0.75,10,6,4,332.5894300647269,0.8048634182355112,0.19351401713974647,0.1945378081654703,131276.04683059035,132.2051193072982,131408.25194989765,2894,0,762.9767441860465,40,3,19,35.279898849662814,0.6260416666666666,43.800813008130085,1024.7967479674805,25.619918699187014,0
2902,4,0,0,42,0.0,0.0,1.0,42,600,300,300,0.5,9,3,6,339.0996404361372,0.7952719705768486,0.19820605215234965,0.19751348724929535,131114.67013888908,492.1875000000204,131606.8576388891,2895,2,782.1428571428571,39,3,19,35.275969622999725,0.6260683760683761,43.95833333333334,1024.1666666666683,26.260683760683804,0
2903,4,0,0,42,0.0,0.0,1.0,42,900,400,500,0.4444444444444444,14,4,10,338.6502705124716,0.7951751838946961,0.2015989230754336,0.19752590511385823,131168.01757812512,484.0169270833484,131652.03450520846,2896,3,783.1428571428571,39,3,19,35.233628228594675,0.6266025641025641,43.90625000000001,1024.375000000001,26.266025641025664,0
2904,4,0,0,42,0.0,0.0,1.0,42,1350,1000,350,0.7407407407407407,17,10,7,362.39660381450494,0.795150987224158,0.2328584952441055,0.19972779782402902,128957.11343277461,972.5269405407777,129929.64037331539,2897,4,784.1428571428571,38,4,15,36.87151572525509,0.6060855263157894,46.073717948717956,1015.7051282051292,26.72908232118761,5
2905,4,1,0,43,0.023255813953488372,0.0,1.0,43,900,700,200,0.7777777777777778,11,7,4,356.30762671776813,0.803063861203396,0.22770555857482377,0.19773211810908023,129230.01284646161,609.8212527656676,129839.83409922729,2898,0,766.8837209302326,36,7,16,36.7480248827851,0.6125578703703702,45.805180180180194,1016.7792792792816,28.243868868868933,0
2906,4,1,1,43,0.022727272727272728,0.022727272727272728,0.9772727272727273,44,1000,500,500,0.5,15,5,10,348.16381044229723,0.8075669485553206,0.2203743989008473,0.19467751090928445,129527.44904667977,219.3540433924999,129746.80309007227,2899,0,750.4318181818181,38,6,15,36.65249790092362,0.6118421052631579,45.51282051282051,1017.9487179487176,26.788124156545198,0
2907,4,0,0,43,0.0,0.0,1.0,43,700,500,200,0.7142857142857143,9,5,4,356.5197060003863,0.8025101513473606,0.22378113118644993,0.19868746858724234,129396.54659366344,626.4837498076372,130023.03034347108,2900,2,768.8837209302326,37,6,16,36.57306372813162,0.612331081081081,45.641447368421055,1017.4342105263158,27.498221906116644,0
2908,4,0,1,42,0.0,0.023255813953488372,0.9767441860465116,43,1100,900,200,0.8181818181818182,13,9,4,352.64115179680056,0.8024178663713547,0.21569811282940288,0.19708415485428665,129508.13140822186,533.9793253693565,130042.11073359121,2901,3,769.8837209302326,37,6,15,36.55820226938132,0.6134572072072071,45.53179824561404,1017.8728070175446,27.510075865339044,0
2909,4,0,1,41,0.0,0.023809523809523808,0.9761904761904762,42,950,700,250,0.7368421052631579,12,7,5,361.22102733505335,0.7930700735578784,0.22345335567287306,0.20177476174624331,129487.77113261934,954.741143170224,130442.51227578956,2902,4,788.8809523809524,36,6,15,36.36059784613115,0.615162037037037,45.551801801801815,1017.7927927927947,28.272022022022075,0
2910,4,2,2,41,0.046511627906976744,0.046511627906976744,0.9534883720930233,43,1350,800,550,0.5925925925925926,19,8,11,354.1721555195905,0.7976651901070505,0.21838588481476195,0.19906917706790775,129731.4453125,589.4531250000002,130320.8984375,2903,0,771.3953488372093,37,6,15,36.292177914110425,0.6157094594594594,45.3125,1018.75,27.533783783783782,0
2911,4,2,1,42,0.046511627906976744,0.023255813953488372,0.9767441860465116,43,1150,700,450,0.6086956521739131,16,7,9,359.4178391252641,0.7996031746031745,0.23149764640557846,0.20302959101984863,129927.00277970156,739.6165166205127,130666.61929632208,2904,0,772.3488372093024,37,6,16,35.95979422097944,0.6176801801801801,45.120614035087726,1019.5175438596501,27.554528212422976,0
2912,4,0,0,42,0.0,0.0,1.0,42,500,300,200,0.6,7,3,4,366.43792509393745,0.7898277197057685,0.2335143583347794,0.20634080797604545,129803.15778193777,1112.9599616508858,130916.11774358866,2905,1,791.7380952380952,36,6,16,35.9068221166243,0.6183449074074072,45.24211711711714,1019.031531531535,28.30643143143153,0
2913,4,1,0,43,0.023255813953488372,0.0,1.0,43,1400,900,500,0.6428571428571429,19,9,10,363.62742080311693,0.7964193429309708,0.2550811132844424,0.2074981310688936,130321.66950660139,879.3297563548173,131200.9992629562,2906,0,774.3023255813954,35,8,17,35.451617169198215,0.6255952380952381,44.73379629629629,1021.064814814814,29.1732804232804,0
2914,4,0,1,42,0.0,0.023255813953488372,0.9767441860465116,43,1250,1100,150,0.88,14,11,3,364.5668342418335,0.7930509413067552,0.25772120420227407,0.20898675407057815,130498.99798525363,915.1213134430545,131414.1192986967,2907,1,775.3023255813954,35,8,17,35.24769672254947,0.6273809523809524,44.560185185185176,1021.7592592592581,29.19312169312166,0
2915,4,2,1,43,0.045454545454545456,0.022727272727272728,0.9772727272727273,44,900,600,300,0.6666666666666666,12,6,6,352.82418123219963,0.8028761451726568,0.24884437596302011,0.20418856755896578,130866.81909950472,434.5956598490159,131301.41475935373,2908,0,747.9772727272727,36,8,18,35.17522378751191,0.629050925925926,44.20045045045044,1023.1981981981967,28.42217217217213,0
2916,4,0,0,43,0.0,0.0,1.0,43,1000,600,400,0.6,14,6,8,362.49227438081004,0.7983573274270949,0.2634395869843229,0.20939259614232641,130794.81336805536,882.4218749999753,131677.23524305533,2909,1,766.3720930232558,35,8,18,35.0008486082824,0.6303571428571428,44.27083333333332,1022.916666666665,29.22619047619043,0
2917,4,1,0,44,0.022727272727272728,0.0,1.0,44,1550,1200,350,0.7741935483870968,19,12,7,354.51054430189544,0.8026999647639183,0.2704090568534536,0.20688269927624028,131187.6746330601,501.48278797321217,131689.1574210333,2910,0,749.9318181818181,37,7,20,34.807587677048765,0.6303490990990992,43.88706140350877,1024.4517543859643,27.68788525367471,0
2918,4,3,3,44,0.06382978723404255,0.06382978723404255,0.9361702127659575,47,1150,700,450,0.6086956521739131,16,7,9,336.90784880749953,0.8181082331174837,0.25108023292455006,0.19983378902192106,131809.03320312485,-518.4252907144651,131290.6079124104,2911,0,703.0,39,8,17,34.632193818894976,0.6330128205128207,43.28124999999999,1026.8749999999989,26.330128205128176,0
2919,4,0,0,44,0.0,0.0,1.0,44,850,600,250,0.7058823529411765,11,6,5,354.54262377688406,0.8025237843551798,0.26439268304940033,0.19905884742780336,129688.42734203776,397.3279946965314,130085.75533673429,2912,2,751.9318181818181,36,8,16,36.32646950433021,0.6171875000000002,45.35472972972972,1018.5810810810792,28.293918918918866,5
2920,4,0,0,44,0.0,0.0,1.0,44,1100,900,200,0.8181818181818182,13,9,4,353.16847955637553,0.8023476039464412,0.2678471834913556,0.19850504195754864,129731.44531249974,363.4114583333044,130094.85677083304,2913,3,752.9318181818181,37,7,16,36.317740286298566,0.6157094594594597,45.312499999999986,1018.749999999998,27.53378378378373,0
2921,4,1,1,44,0.022222222222222223,0.022222222222222223,0.9777777777777777,45,1300,1000,300,0.7692307692307693,16,10,6,350.43703446182303,0.8068602693602694,0.2591783246536641,0.19871626395394493,130076.56385633661,116.72905815969727,130193.29291449631,2914,0,737.1777777777778,39,6,17,36.03690135811293,0.6156517094017095,44.97395833333332,1020.104166666665,26.15651709401705,0
2922,4,0,0,44,0.0,0.0,1.0,44,800,400,400,0.5,12,4,8,357.0694492410071,0.8012905214940099,0.26337171510818114,0.2020641565358067,129996.88042534703,483.58289930553093,130480.46332465256,2915,5,754.9318181818181,39,5,17,35.94867211440245,0.6148504273504274,45.05208333333332,1019.791666666665,26.148504273504233,0
2923,4,1,0,45,0.022222222222222223,0.0,1.0,45,1450,1000,450,0.6896551724137931,19,10,9,342.31389411448555,0.8071548821548822,0.2717668488160292,0.1898286140089418,129201.38888888879,-146.9184027777868,129054.47048611101,2916,0,739.1333333333333,38,7,16,37.13285519125684,0.6085526315789473,45.83333333333333,1016.6666666666658,26.75438596491226,3
2924,4,2,1,46,0.0425531914893617,0.02127659574468085,0.9787234042553191,47,1100,600,500,0.5454545454545454,16,6,10,333.3931465724702,0.8184165895775516,0.2798401762050975,0.18769977993723505,129796.16057117115,-745.3699228303375,129050.79064834082,2917,0,708.6382978723404,40,7,16,36.75575944948638,0.6111979166666668,45.24898373983739,1019.0040650406495,25.475101626016237,0
2925,4,1,1,46,0.02127659574468085,0.02127659574468085,0.9787234042553191,47,1500,1300,200,0.8666666666666667,17,13,4,333.13022050498546,0.8216543324082639,0.28009588256507056,0.18792441572919039,129873.84018276157,-747.0197964174795,129126.8203863441,2918,0,709.6170212765958,40,7,16,36.68369890329013,0.6119791666666667,45.172764227642276,1019.3089430894308,25.48272357723577,0
2926,4,0,0,46,0.0,0.0,1.0,46,900,600,300,0.6666666666666666,12,6,6,344.1067380959439,0.8139492753623189,0.28771175704449115,0.19354272601014544,129757.97661675354,-269.8811848958287,129488.09543185771,2919,2,726.0434782608696,39,7,16,36.52159373615512,0.6124465811965811,45.286458333333336,1018.8541666666672,26.124465811965827,0
2927,4,1,1,46,0.02127659574468085,0.02127659574468085,0.9787234042553191,47,1700,1200,500,0.7058823529411765,22,12,10,342.66675461964326,0.8207292630280604,0.28476568624542864,0.1948504841387577,130184.79100568459,-478.00003304909876,129706.79097263548,2920,0,711.5744680851063,40,7,16,36.12535683462789,0.6151041666666666,44.867886178861795,1020.528455284554,25.513211382113848,0
2928,4,0,0,46,0.0,0.0,1.0,46,1200,500,700,0.4166666666666667,19,5,14,348.00505654932374,0.8159621578099839,0.28273550372393075,0.19776685147327858,130161.33334120677,-140.6395660115985,130020.69377519518,2921,4,728.0434782608696,41,5,16,36.012946399637045,0.6133130081300813,44.89087301587301,1020.4365079365073,24.88869531552457,0
2929,4,0,0,46,0.0,0.0,1.0,46,1150,600,550,0.5217391304347826,17,6,11,349.529371878723,0.814573268921095,0.2919136942365632,0.19902090244937357,130237.26974875595,-95.6497819035061,130141.61996685245,2922,5,729.0434782608696,41,5,17,35.89705429746978,0.6140752032520325,44.81646825396825,1020.7341269841268,24.89595431668602,0
2930,4,0,0,46,0.0,0.0,1.0,46,1250,700,550,0.56,18,7,11,351.90516622608106,0.8121376811594203,0.3048208113516455,0.2012089347560611,130398.95171305457,-22.37966291735063,130376.57205013723,2923,6,730.0434782608696,38,8,17,35.672506973500695,0.6206140350877192,44.65811965811967,1021.3675213675238,26.878092667566413,0
2931,4,0,0,46,0.0,0.0,1.0,46,1300,900,400,0.6923076923076923,17,9,8,354.45965630967663,0.8125805152979066,0.30866291388921674,0.20295468464869051,130453.5176510339,48.10180619477785,130501.61945722868,2924,7,731.0434782608696,38,8,17,35.55196785888586,0.6211622807017543,44.604700854700866,1021.5811965811984,26.88371569950522,0
2932,4,0,0,46,0.0,0.0,1.0,46,750,500,250,0.6666666666666666,10,5,5,352.7068245038381,0.811694847020934,0.30993087651846607,0.20266343483652988,130589.98243343212,11.995603221579984,130601.9780366537,2925,8,732.0434782608696,38,8,15,35.45847705654853,0.622532894736842,44.471153846153854,1022.115384615386,26.897773279352265,0
2933,4,0,0,46,0.0,0.0,1.0,46,1700,1300,400,0.7647058823529411,21,13,8,355.3873438844911,0.8113325281803543,0.31420901542542534,0.20492576238929805,130726.51855504415,91.71004090875317,130818.22859595291,2926,9,733.0434782608696,38,8,15,35.25168895389329,0.6239035087719298,44.337606837606835,1022.6495726495723,26.91183085919927,0
2934,4,0,0,46,0.0,0.0,1.0,46,1100,800,300,0.7272727272727273,14,8,6,352.8690353547413,0.8113123993558776,0.30697413640470184,0.20419496988473454,130863.1260158704,35.509008145227824,130898.63502401562,2927,10,734.0434782608696,38,8,15,35.17781316348195,0.6252741228070176,44.20405982905983,1023.1837606837605,26.92588843904633,0
2935,4,0,0,46,0.0,0.0,1.0,46,1300,1000,300,0.7692307692307693,16,10,6,351.8020991934577,0.8119162640901771,0.3024891406473398,0.2038664433257188,130917.78897518074,11.430596646934305,130929.21957182768,2928,11,735.0434782608696,38,8,15,35.149806869193036,0.6258223684210527,44.15064102564102,1023.3974358974353,26.93151147098514,0
2936,4,1,0,47,0.02127659574468085,0.0,1.0,47,1750,1300,450,0.7428571428571429,22,13,9,347.2456356959891,0.8171060746222633,0.29720566672644244,0.20324853371991014,131302.08462431433,-281.1848312842785,131020.89979303005,2929,0,720.3829787234042,40,7,16,34.87811931912082,0.6263020833333333,43.775406504065046,1024.8983739837406,25.622459349593516,0
2937,4,0,0,47,0.0,0.0,1.0,47,1550,1000,550,0.6451612903225806,21,10,11,345.14699115218116,0.8170289855072463,0.29529597897412363,0.20272237356217612,131434.9175347223,-327.12415414931183,131107.79338057298,2930,1,721.3829787234042,39,8,17,34.79784640390086,0.6292735042735043,43.645833333333336,1025.4166666666672,26.292735042735057,0
2938,4,0,0,47,0.0,0.0,1.0,47,1450,1000,450,0.6896551724137931,19,10,9,348.39808388625806,0.8170289855072463,0.30089241158514834,0.20534845770172083,131568.46923828125,-232.3594835069449,131336.1097547743,2931,2,722.3829787234042,39,8,15,34.57975852032355,0.6306089743589745,43.515625,1025.9375,26.306089743589745,0
2939,4,0,0,47,0.0,0.0,1.0,47,1300,900,400,0.6923076923076923,17,9,8,351.1716621837205,0.8153715695343817,0.30505451412357454,0.20756415041968762,131675.35942925324,-151.86903211807964,131523.49039713515,2932,3,723.3829787234042,39,8,16,34.400795865895326,0.6316773504273505,43.41145833333332,1026.3541666666647,26.316773504273453,0
2940,4,0,1,46,0.0,0.02127659574468085,0.9787234042553191,47,900,400,500,0.4444444444444444,14,4,10,350.841421080712,0.8154101140918901,0.30575959626920346,0.20795212793701578,131782.29302300327,-153.06260850696398,131629.2304144963,2933,4,724.3829787234042,39,8,16,34.30144820939436,0.6327457264957267,43.30729166666666,1026.7708333333317,26.32745726495722,0
2941,4,0,1,45,0.0,0.021739130434782608,0.9782608695652174,46,1200,700,500,0.5833333333333334,17,7,10,353.9966100750549,0.817632850241546,0.29901941332345805,0.21041353658529868,131889.27001953076,137.6708984374553,132026.9409179682,2934,5,721.6086956521739,39,7,16,34.112602677213275,0.6338141025641028,43.20312499999998,1027.1874999999961,26.338141025640926,0
2942,4,0,0,45,0.0,0.0,1.0,45,1000,500,500,0.5,15,5,10,363.2235758580478,0.8103535353535354,0.3083038501560875,0.21520213094918833,131766.5244448095,572.1416374460982,132338.6660822556,2935,18,738.5333333333333,38,7,16,33.99952306625042,0.6343201754385966,43.32264957264956,1026.7094017094,27.018668466036843,0
2943,4,0,0,45,0.0,0.0,1.0,45,800,600,200,0.75,10,6,4,362.2461623345356,0.810395622895623,0.3074351505063124,0.21493272298515737,131821.3757396446,550.357495068999,132371.7332347136,2936,19,739.5333333333333,38,7,16,33.96925717852683,0.6348684210526319,43.26923076923075,1026.9230769230742,27.024291497975636,0
2944,4,1,0,46,0.021739130434782608,0.0,1.0,46,950,800,150,0.8421052631578947,11,8,3,359.230080638593,0.8128824476650564,0.31335054430429965,0.21473299005586136,132103.35422091998,291.0997178819249,132394.45393880192,2937,0,724.4347826086956,39,7,17,33.76239149525449,0.6359508547008549,42.99479166666666,1028.020833333332,26.35950854700851,0
2945,4,0,0,46,0.0,0.0,1.0,46,1350,900,450,0.6666666666666666,18,9,9,359.1007275015409,0.8119162640901771,0.31161768720662963,0.2154168033627104,132237.24500868045,297.29817708332405,132534.54318576376,2938,1,725.4347826086956,39,7,17,33.630831814192156,0.6372863247863249,42.86458333333333,1028.5416666666658,26.372863247863226,0
2946,4,0,0,46,0.0,0.0,1.0,46,1550,1200,350,0.7741935483870968,19,12,7,359.45516235309566,0.809158615136876,0.30883647245203294,0.2165498173200356,132398.00347222213,318.32682291665736,132716.3302951388,2939,2,726.4347826086956,38,8,17,33.459851551956824,0.640625,42.70833333333333,1029.1666666666658,27.08333333333331,0
2947,4,0,0,46,0.0,0.0,1.0,46,1100,800,300,0.7272727272727273,14,8,6,359.0702574428499,0.8088768115942029,0.3075539811827348,0.21663380904582707,132452.98603121116,311.9855586602364,132764.9715898714,2940,3,727.4347826086956,38,8,17,33.41441792077495,0.6411732456140351,42.65491452991453,1029.3803418803416,27.088956365272146,0
2948,4,0,0,46,0.0,0.0,1.0,46,1300,900,400,0.6923076923076923,17,9,8,357.07951303656154,0.8085950080515298,0.30486628315871145,0.21685609721187632,132700.54879830504,276.9294689166354,132977.47826722168,2941,4,728.4347826086956,38,8,15,33.216680492188594,0.6436403508771931,42.41452991452991,1030.341880341879,27.114260008996816,0
2949,4,0,0,46,0.0,0.0,1.0,46,1150,800,350,0.6956521739130435,15,8,7,357.02540801519973,0.8089170692431562,0.30162789963989756,0.21730120574906175,132783.12108490377,281.3895965738785,133064.51068147767,2942,5,729.4347826086956,38,8,15,33.135085173283585,0.6444627192982457,42.3344017094017,1030.662393162392,27.12269455690505,0
2950,4,0,0,46,0.0,0.0,1.0,46,1300,800,500,0.6153846153846154,18,8,10,356.1677379859199,0.8084339774557167,0.30228370663153314,0.21765806210250657,132934.57031249997,269.4010416666664,133203.97135416663,2943,6,730.4347826086956,39,7,15,33.005050505050505,0.6442307692307693,42.1875,1031.2499999999998,26.442307692307686,0
2951,4,0,0,46,0.0,0.0,1.0,46,1150,800,350,0.6956521739130435,15,8,7,357.1757439372865,0.8080515297906603,0.3047823453506435,0.21921827258009682,133095.75195312515,307.71484375001353,133403.46679687515,2944,7,731.4347826086956,39,7,15,32.8172319806178,0.6458333333333333,42.03125000000001,1031.8750000000011,26.458333333333364,0
2952,4,0,1,45,0.0,0.021739130434782608,0.9782608695652174,46,900,500,400,0.5555555555555556,13,5,8,358.2923489858732,0.8078703703703703,0.30777315995277776,0.22006213895865154,133122.62505425364,339.3636067708529,133461.9886610245,2945,8,732.4347826086956,39,7,15,32.76145234009625,0.6461004273504274,42.00520833333334,1031.979166666668,26.46100427350431,0
2953,4,0,0,45,0.0,0.0,1.0,45,1350,900,450,0.6666666666666666,18,9,9,366.7692868599746,0.8035774410774411,0.3125556564942853,0.2252686500261484,133122.62505425367,765.0580512152985,133887.68310546898,2946,29,749.5333333333333,39,6,15,32.54275175801622,0.6461004273504274,42.00520833333334,1031.9791666666683,26.461004273504315,0
2954,4,0,0,45,0.0,0.0,1.0,45,1300,800,500,0.6153846153846154,18,8,10,365.55972733936153,0.8028619528619529,0.30824203459511446,0.22568760323345047,133314.74837233147,746.9006130610258,134061.6489853925,2947,30,750.5333333333333,40,5,15,32.381051958275926,0.6463541666666666,41.81910569105692,1032.7235772357737,25.818089430894343,0
2955,4,0,0,45,0.0,0.0,1.0,45,1400,1100,300,0.7857142857142857,17,11,6,366.96523331427363,0.8018939393939394,0.3105733709314267,0.22719662374378258,133419.72061107823,792.0797805539195,134211.80039163216,2948,31,751.5333333333333,40,5,15,32.23940914158306,0.6473958333333333,41.717479674796756,1033.1300813008145,25.82825203252036,0
2956,4,0,0,45,0.0,0.0,1.0,45,1050,700,350,0.6666666666666666,14,7,7,366.30473690490436,0.8012205387205388,0.33635339193148583,0.21757618710134646,131862.5217013887,660.3939195832311,132522.91562097194,2949,32,752.5333333333333,39,6,16,33.8235294117647,0.6335470085470087,43.22916666666666,1027.0833333333317,26.335470085470043,4
2957,4,0,0,45,0.0,0.0,1.0,45,1100,900,200,0.8181818181818182,13,9,4,407.7292548531398,0.8016414141414142,0.41229453615112344,0.22532904955887345,129065.65176647305,1526.9385432646632,130592.59030973772,2950,33,753.5333333333333,38,7,15,35.60920688325799,0.6071820175438596,45.96688034188034,1016.1324786324784,26.740328385065222,6
2958,4,0,0,45,0.0,0.0,1.0,45,1200,800,400,0.6666666666666666,16,8,8,409.3730001386972,0.8012205387205388,0.4193352284613776,0.22718062804255074,129230.01284646144,1580.7982918116008,130810.81113827304,2951,34,754.5333333333333,36,9,15,35.39913057924466,0.6125578703703705,45.80518018018019,1016.7792792792801,28.24386886886889,0
2959,4,1,1,45,0.021739130434782608,0.021739130434782608,0.9782608695652174,46,1000,500,500,0.5,15,5,10,404.08732734723964,0.8078301127214171,0.4135679898094897,0.22599679199348013,129536.03512619255,1268.7740458602516,130804.8091720528,2952,0,739.1086956521739,37,9,15,35.22054071520896,0.6137387387387387,45.504385964912274,1017.9824561403499,27.513039355144592,0
2960,4,1,1,45,0.021739130434782608,0.021739130434782608,0.9782608695652174,46,750,400,350,0.5333333333333333,11,4,7,401.12562226082895,0.8079710144927537,0.4075978637136901,0.22506948540391308,129663.42872242317,1202.2647061509276,130865.6934285741,2953,0,740.0869565217391,38,8,15,35.16578376866323,0.6132127192982456,45.379273504273506,1018.4829059829063,26.80218173639227,0
2961,4,2,0,47,0.0425531914893617,0.0,1.0,47,1200,900,300,0.75,15,9,6,394.5893753026233,0.8119796484736355,0.4151924150924533,0.2234485004967027,130023.43885633703,861.1735026041943,130884.61235894123,2954,0,725.2978723404256,39,8,17,34.96504017294796,0.6151175213675213,45.02604166666668,1019.8958333333352,26.151175213675263,0
2962,4,0,0,47,0.0,0.0,1.0,47,1350,1000,350,0.7407407407407407,17,10,7,395.497310312063,0.8102836879432623,0.4179177733522419,0.2248802756312992,130182.84640842034,897.3931206597453,131080.23952908008,2955,1,726.2978723404256,39,8,17,34.779460549147714,0.6167200854700854,44.86979166666668,1020.520833333335,26.167200854700898,0
2963,4,0,0,47,0.0,0.0,1.0,47,1650,1100,550,0.6666666666666666,22,11,11,393.3294014487232,0.8088189947579402,0.413059270190379,0.22475276350266304,130374.544330948,856.0771252933614,131230.62145624135,2956,2,727.2978723404256,37,10,17,34.63961062200272,0.6221846846846846,44.68201754385965,1021.2719298245615,27.601944049312475,0
2964,4,4,3,48,0.0784313725490196,0.058823529411764705,0.9411764705882353,51,1400,1200,200,0.8571428571428571,16,12,4,365.98678540649234,0.8268300653594772,0.3936457294782316,0.21337174248006963,131150.23389274688,-600.149498456797,130550.08439429008,2957,0,671.1764705882352,41,10,15,34.55155367231638,0.6232215447154472,43.92361111111111,1024.3055555555552,24.983062330623298,0
2965,4,0,0,48,0.0,0.0,1.0,48,1050,700,350,0.6666666666666666,14,7,7,385.10751947388854,0.8137559101654847,0.4113065392249031,0.22222027027869412,130753.83434007234,470.85696088100144,131224.69130095333,2958,1,714.125,38,10,15,34.46411783140082,0.6241776315789473,44.31089743589744,1022.7564102564104,26.914642375168693,0
2966,4,0,1,47,0.0,0.020833333333333332,0.9791666666666666,48,1250,800,450,0.64,17,8,9,391.13657529625357,0.8130171394799054,0.41845026797522156,0.22649976530758842,130890.45606874114,639.2089451384136,131529.66501387957,2959,2,715.125,38,10,15,34.17119092364447,0.6255482456140351,44.17735042735042,1023.2905982905968,26.928699955015706,0
2967,4,0,0,47,0.0,0.0,1.0,47,1650,1100,550,0.6666666666666666,22,11,11,394.4317470061932,0.8107076780758556,0.41825193916020287,0.22784233856475378,130794.81336805546,917.9253472222124,131712.73871527766,2960,3,731.2340425531914,37,10,15,34.1840631364562,0.6264076576576577,44.27083333333333,1022.9166666666658,27.646396396396373,0
2968,4,1,0,48,0.020833333333333332,0.0,1.0,48,1200,1100,100,0.9166666666666666,13,11,2,393.3884209975757,0.8103021572104019,0.42566788717114123,0.22913477223034182,131114.67013888905,715.7986111111293,131830.46875000017,2961,0,716.9791666666666,39,9,16,33.88595063737456,0.626068376068376,43.95833333333334,1024.166666666668,26.260683760683797,0
2969,4,0,0,48,0.0,0.0,1.0,48,1500,1000,500,0.6666666666666666,20,10,10,391.75044954413755,0.8092124704491725,0.42091127829741004,0.22881576138456922,131221.3758680559,681.206597222261,131902.58246527816,2962,1,717.9791666666666,39,9,16,33.819642130947564,0.627136752136752,43.854166666666686,1024.5833333333362,26.271367521367594,0
2970,4,0,0,48,0.0,0.0,1.0,48,1100,700,400,0.6363636363636364,15,7,8,389.27773849700714,0.8092124704491725,0.4177698444963909,0.22784673819583956,131301.43364800382,622.54503038198,131923.97867838579,2963,2,718.9791666666666,39,9,16,33.80181336179151,0.6279380341880341,43.776041666666686,1024.8958333333362,26.279380341880415,0
2971,4,0,0,48,0.0,0.0,1.0,48,900,600,300,0.6666666666666666,12,6,6,391.8767298661334,0.808806146572104,0.4193713780386843,0.22988371345392125,131387.44882758922,697.5476090963723,132084.9964366856,2964,3,719.9791666666666,35,13,16,33.64802062166027,0.6363095238095238,43.69212962962963,1025.231481481482,29.292328042328055,0
2972,4,1,0,49,0.02040816326530612,0.0,1.0,49,1100,500,600,0.45454545454545453,17,5,12,385.15127452021716,0.8123228458049887,0.42621379873946186,0.22781660397480755,131703.53366457697,345.15676994564257,132048.6904345226,2965,0,706.265306122449,36,13,16,33.50041140976412,0.6374421296296295,43.38400900900902,1026.4639639639656,28.512887887887935,0
2973,4,0,0,49,0.0,0.0,1.0,49,1000,600,400,0.6,14,6,8,384.2353857193547,0.8118622448979592,0.42570139069230106,0.2274473880660805,131732.43344696064,323.2524754484402,132055.6859224091,2966,1,707.265306122449,36,13,16,33.494679684071954,0.6377314814814814,43.355855855855864,1026.5765765765777,28.51601601601605,0
2974,4,0,0,49,0.0,0.0,1.0,49,1500,1000,500,0.6666666666666666,20,10,10,382.78171115977074,0.8121456916099773,0.39597379574634783,0.2125956681876957,129261.91184807252,154.42400739817757,129416.3358554707,2967,2,708.265306122449,34,15,18,36.0424959025989,0.6170343137254901,45.77380952380952,1016.9047619047615,29.90896358543416,6
2975,4,1,1,49,0.02,0.02,0.98,50,1400,800,600,0.5714285714285714,20,8,12,370.1270041231851,0.8165816326530612,0.38925798960521885,0.20750517658313503,129631.08114448929,-404.0072589481194,129227.07388554118,2968,0,695.08,36,14,16,35.98801098455526,0.6166087962962963,45.411036036036045,1018.3558558558575,28.287662662662708,0
2976,4,1,0,50,0.02,0.0,1.0,50,900,400,500,0.4444444444444444,14,4,10,355.52015338875447,0.8167006802721088,0.3474389216512217,0.19447116224536937,128658.8684345095,-851.8358718679175,127807.03256264157,2969,0,696.06,38,12,13,37.3503755967425,0.6030701754385964,46.36752136752137,1014.5299145299148,26.69815564552407,6
2977,4,2,1,51,0.038461538461538464,0.019230769230769232,0.9807692307692307,52,1100,700,400,0.6363636363636364,15,7,8,344.54574154595554,0.8245663650075414,0.34058436315259244,0.19094133255868123,129175.56023407048,-1498.6221619075786,127676.9380721629,2970,0,670.25,40,12,15,37.10241094338365,0.6049479166666666,45.85873983739838,1016.5650406504077,25.41412601626019,0
2978,4,1,0,52,0.019230769230769232,0.0,1.0,52,800,500,300,0.625,11,5,6,341.96804526531713,0.8269230769230769,0.3420385948750275,0.19002882795566572,129282.86540516114,-1557.8730822959965,127724.99232286515,2971,0,671.2307692307693,38,14,16,37.05877718247716,0.609375,45.75320512820513,1016.98717948718,26.762820512820525,0
2979,4,1,1,52,0.018867924528301886,0.018867924528301886,0.9811320754716981,53,1400,1000,400,0.7142857142857143,18,10,8,332.0342823611144,0.8289187227866472,0.33363306923127367,0.1863737780095856,129678.39084201408,-1988.4657118055356,127689.92513020855,2972,0,659.5471698113207,39,14,13,36.909814549669335,0.6116452991452991,45.36458333333334,1018.5416666666682,26.11645299145303,0
2980,4,0,2,50,0.0,0.038461538461538464,0.9615384615384616,52,850,600,250,0.7058823529411765,11,6,5,337.78647262959504,0.8250534188034188,0.33976780223239134,0.18926765847340818,129609.02829142024,-1643.9647024983426,127965.0635889219,2973,1,672.8846153846154,38,14,13,36.83375301647256,0.6126644736842104,45.432692307692314,1018.2692307692317,26.796558704453467,0
2981,4,2,1,51,0.038461538461538464,0.019230769230769232,0.9807692307692307,52,1300,1000,300,0.7692307692307693,16,10,6,339.81103579791943,0.8223353443941679,0.3499330823248652,0.1917289824096955,129881.14458917745,-1572.990745306453,128308.153843871,2974,0,673.4807692307693,38,14,14,36.5060440904168,0.6154057017543859,45.16559829059829,1019.3376068376069,26.824673864147552,0
2982,4,0,0,51,0.0,0.0,1.0,51,900,500,400,0.5555555555555556,13,5,8,335.9597851021831,0.8192483660130719,0.3352215553978697,0.18908852807074555,129784.51063368063,-1479.5247395833242,128304.9858940973,2975,1,687.6862745098039,39,12,17,36.702191099298034,0.6127136752136751,45.26041666666667,1018.958333333334,26.12713675213677,4
2983,4,0,1,50,0.0,0.0196078431372549,0.9803921568627451,51,1650,1200,450,0.7272727272727273,21,12,9,313.2526512975313,0.8194771241830067,0.28942356696440585,0.1721711940590188,128848.62075617258,-2117.5612461419987,126731.05951003058,2976,2,688.6862745098039,41,10,16,38.22959416324668,0.6001016260162602,46.18055555555554,1015.2777777777757,24.762872628726235,7
2984,4,4,1,53,0.07407407407407407,0.018518518518518517,0.9814814814814815,54,1300,800,500,0.6153846153846154,18,8,10,298.9947616823677,0.8378610528767761,0.3113842476345958,0.1675398995503127,129610.88266363925,-3048.9227522223514,126561.9599114169,2977,0,651.2777777777778,43,11,16,37.81938761275922,0.6048934108527132,45.43087121212121,1018.2765151515152,23.68084918957012,0
2985,4,0,0,53,0.0,0.0,1.0,53,1350,800,550,0.5925925925925926,19,8,11,304.84801213175405,0.8338473633284954,0.312950706312358,0.17043259007153133,129521.75842985688,-2703.109882969781,126818.6485468871,2978,1,664.566037735849,42,11,16,37.76059019514516,0.605406746031746,45.518410852713174,1017.9263565891465,24.236341823551108,0
2986,4,0,0,53,0.0,0.0,1.0,53,1350,1000,350,0.7407407407407407,17,10,7,306.4883253668383,0.8344823415578132,0.31903179510212953,0.1718443926483304,129634.9907096532,-2653.6777576905597,126981.31295196264,2979,2,665.566037735849,43,10,17,37.60422478457628,0.6051356589147288,45.40719696969696,1018.3712121212109,23.68305144467932,0
2987,4,1,0,54,0.018518518518518517,0.0,1.0,54,1500,1200,300,0.8,18,12,6,301.6887560291342,0.8353278593058467,0.3153413765640527,0.17027107624633242,129892.98220568126,-2962.5495562907277,126930.43264939052,2980,0,654.2222222222222,45,9,18,37.46556779811618,0.6050925925925927,45.15398550724636,1019.384057971012,22.65297906602249,0
2988,4,1,0,55,0.01818181818181818,0.0,1.0,55,1200,900,300,0.75,15,9,6,337.61528424557514,0.8394500561167227,0.38114140299351495,0.18278172395848177,128247.44824715781,-2307.2261570734295,125940.22209008438,2981,0,643.3090909090909,40,15,18,38.22405605163705,0.5955729166666668,46.77337398373984,1012.906504065041,25.322662601626025,5
2989,4,3,3,55,0.05172413793103448,0.05172413793103448,0.9482758620689655,58,1450,1100,350,0.7586206896551724,18,11,7,324.13103527966877,0.8507637628554144,0.3717943770140677,0.17822220309069783,128864.64520919418,-3246.1938274793397,125618.45138171484,2982,0,610.9827586206897,43,15,16,37.93718522663683,0.5973837209302326,46.16477272727273,1015.3409090909088,23.612579281183926,0
2990,4,0,0,55,0.0,0.0,1.0,55,1700,1200,500,0.7058823529411765,22,12,10,349.5218282958951,0.8397867564534232,0.2959889975975767,0.188165256428986,128021.92251066644,-2035.6253543939033,125986.29715627253,2983,2,645.3090909090909,42,13,18,38.15308630154475,0.5902777777777778,46.99612403100775,1012.0155038759691,24.095607235142122,7
2991,4,1,0,56,0.017857142857142856,0.0,1.0,56,1150,900,250,0.782608695652174,14,9,5,346.2874394044317,0.8442911255411255,0.30039943609022535,0.18798460996240618,128355.55555555591,-2310.18193017243,126045.37362538348,2984,0,634.7678571428571,39,17,19,37.894051535087726,0.5982905982905982,46.666666666666686,1013.3333333333362,25.982905982906058,0
2992,4,1,1,56,0.017543859649122806,0.017543859649122806,0.9824561403508771,57,1300,1000,300,0.7692307692307693,16,10,6,337.672008958352,0.8475355054302423,0.30714671081188816,0.1847112145441773,128659.52934967644,-2711.05565057172,125948.47369910471,2985,0,624.6140350877193,40,17,15,37.8023890614044,0.5997395833333332,46.3668699186992,1014.5325203252057,25.36331300813014,0
2993,4,0,0,56,0.0,0.0,1.0,56,1650,1300,350,0.7878787878787878,20,13,7,351.9501469558794,0.8428165584415584,0.26397970392844083,0.18883612010540413,127886.84842249664,-2198.040980795603,125688.80744170104,2986,1,636.75,44,12,19,38.229853228365684,0.5861742424242424,47.12962962962963,1011.481481481482,22.9882154882155,2
2994,4,1,1,56,0.017543859649122806,0.017543859649122806,0.9824561403508771,57,1400,1100,300,0.7857142857142857,17,11,6,348.35475621941066,0.8498590225563909,0.2629413038769759,0.18811156835848195,128144.53125000016,-2471.2705761316715,125673.26067386848,2987,0,626.561403508772,42,15,19,38.05727023319617,0.5915178571428571,46.87500000000001,1012.5000000000013,24.107142857142886,0
2995,4,3,3,56,0.05084745762711865,0.05084745762711865,0.9491525423728814,59,1400,1100,300,0.7857142857142857,17,11,6,332.3742058945089,0.8553233976232222,0.2619500951999203,0.18134293059711903,128556.44710696355,-3254.2305960406998,125302.21651092285,2988,0,606.271186440678,40,19,17,38.04176270167353,0.5986979166666666,46.46849593495936,1014.1260162601634,25.353150406504085,0
2996,4,2,3,55,0.034482758620689655,0.05172413793103448,0.9482758620689655,58,1250,800,450,0.64,17,8,9,342.383380434097,0.8536877394636015,0.27447177797849887,0.18672841504346996,128540.34423828141,-2797.9844835069293,125742.35975477449,2989,0,617.6896551724138,39,19,17,37.80442133196371,0.6001602564102564,46.48437500000001,1014.0625000000013,26.001602564102598,0
2997,4,1,1,55,0.017857142857142856,0.017857142857142856,0.9821428571428571,56,1550,1100,450,0.7096774193548387,20,11,9,352.8090896034036,0.8441558441558441,0.28420607455699964,0.19224665006262043,128505.59937913572,-2132.4112948214984,126373.18808431421,2990,0,640.2321428571429,37,19,17,37.575587577953215,0.6033220720720722,46.518640350877185,1013.9254385964898,27.403390232337564,0
2998,4,1,2,54,0.017857142857142856,0.03571428571428571,0.9642857142857143,56,800,300,500,0.375,13,3,10,354.7989582407435,0.848728354978355,0.28430710193492637,0.19387153943798657,128616.79945992977,-2073.3787078716746,126543.4207520581,2991,0,641.2142857142857,37,19,17,37.41160865492018,0.6044481981981983,46.408991228070164,1014.3640350877176,27.415244191559935,0
2999,4,2,2,54,0.03571428571428571,0.03571428571428571,0.9642857142857143,56,1750,1100,650,0.6285714285714286,24,11,13,354.80038884266185,0.8482954545454545,0.29123957315698523,0.19527375193685578,128902.8613873365,-2053.04293136826,126849.81845596824,2992,0,641.875,38,18,17,37.11971769244257,0.6055372807017544,46.12713675213675,1015.4914529914525,26.72345928924875,0
3000,4,1,1,54,0.01818181818181818,0.01818181818181818,0.9818181818181818,55,1400,1100,300,0.7857142857142857,17,11,6,363.44620724078584,0.8405723905723906,0.29708226978205365,0.19985224934974316,128867.17547706973,-1632.7427670052539,127234.43271006447,2993,0,654.5272727272727,37,18,17,36.93664506839451,0.6069819819819819,46.162280701754376,1015.3508771929813,27.441915599810308,0
3001,4,2,2,54,0.03571428571428571,0.03571428571428571,0.9642857142857143,56,1500,1200,300,0.8,18,12,6,358.2515343341429,0.8401920995670996,0.29669002300773895,0.1982867082254616,129125.75511975623,-1948.1000212585066,127177.65509849772,2994,0,643.8035714285714,41,15,17,36.8048438262567,0.6028963414634146,45.907738095238095,1016.3690476190476,24.789488966318235,0
3002,4,3,3,54,0.05263157894736842,0.05263157894736842,0.9473684210526316,57,2100,1500,600,0.7142857142857143,27,15,12,350.9318545465004,0.8516342940685045,0.29906118973452434,0.1953934145667688,129360.29188368063,-2320.60414009353,127039.6877435871,2995,0,633.4561403508771,39,18,18,36.75208205338249,0.608440170940171,45.677083333333336,1017.2916666666673,26.084401709401725,0
3003,4,2,2,54,0.03571428571428571,0.03571428571428571,0.9642857142857143,56,1400,1000,400,0.7142857142857143,18,10,8,348.4421894367635,0.8471185064935065,0.296874331360103,0.19462624245450008,129485.67450137153,-2176.345615209201,127309.32888616233,2996,0,643.5,40,16,15,36.68788483940756,0.6080729166666667,45.55386178861789,1017.7845528455284,25.444613821138212,0
3004,4,2,4,52,0.03571428571428571,0.07142857142857142,0.9285714285714286,56,1600,1100,500,0.6875,21,11,10,344.9069278757105,0.8484442640692641,0.29905494933749055,0.19323824823778865,129605.14298311903,-2259.657659360052,127345.48532375899,2997,0,644.4642857142857,41,15,16,36.65643673681475,0.6077235772357723,45.43650793650793,1018.2539682539671,24.83546264034066,0
3005,4,1,1,52,0.018867924528301886,0.018867924528301886,0.9811320754716981,53,1250,900,350,0.72,16,9,7,366.8368718086531,0.8366594097726173,0.2992576554283948,0.20342771982116262,129201.38888888921,-1120.833333333299,128080.55555555591,2998,0,681.5094339622641,41,12,18,36.50956284153007,0.6036585365853657,45.83333333333335,1016.6666666666692,24.79674796747974,0
3006,4,1,0,53,0.018867924528301886,0.0,1.0,53,1850,1300,550,0.7027027027027027,24,13,11,372.0526951906087,0.8344521044992743,0.3142092681970412,0.20789126258539167,129500.26167223684,-963.8157233910431,128536.4459488458,2999,0,682.4905660377359,38,15,17,36.072259543053086,0.6115679824561404,45.539529914529915,1017.8418803418804,26.7853126405758,0
3007,4,0,0,53,0.0,0.0,1.0,53,1400,1000,400,0.7142857142857143,18,10,8,368.8311853621327,0.8345730527334301,0.31437274864774056,0.20646941613570935,129572.31445312503,-1041.9379340277774,128530.37651909725,3000,1,683.4905660377359,39,14,17,36.08084373507946,0.6105769230769231,45.46875,1018.1250000000002,26.105769230769237,0
3008,4,0,0,53,0.0,0.0,1.0,53,1150,700,450,0.6086956521739131,16,7,9,368.84711549912396,0.8341194968553459,0.31569176427615164,0.20683922464559176,129640.87106095921,-1036.4677316742582,128604.40332928495,3001,2,684.4905660377359,40,13,17,36.01062768186807,0.6096354166666667,45.40142276422765,1018.3943089430904,25.45985772357726,0
3009,4,0,0,53,0.0,0.0,1.0,53,1550,1100,450,0.7096774193548387,20,11,9,368.0440685371866,0.834028785679729,0.3095250643738048,0.20679785555026683,129718.50419723715,-1051.5747901381394,128666.92940709901,3002,3,685.4905660377359,40,13,18,35.95204841713222,0.6104166666666666,45.32520325203252,1018.6991869918703,25.467479674796756,0
3010,4,1,1,53,0.018518518518518517,0.018518518518518517,0.9814814814814815,54,1250,1000,250,0.8,15,10,5,338.72581103393236,0.8400011646866993,0.2665302524233477,0.18621322505063384,128857.43408203122,-2048.4048139774004,126809.02926805383,3003,0,673.7777777777778,39,15,16,37.57406124961526,0.6033653846153847,46.171875,1015.3124999999998,26.03365384615384,5
3011,4,1,1,53,0.018518518518518517,0.018518518518518517,0.9814814814814815,54,1450,900,550,0.6206896551724138,20,9,11,337.0134435740077,0.8463778243652458,0.2651114943900261,0.18629404762701318,129075.34490937553,-2099.9747063177383,126975.3702030578,3004,0,669.7222222222222,41,13,17,37.395762146506556,0.602388211382114,45.95734126984126,1016.1706349206329,24.78464963221056,0
3012,4,2,2,53,0.03636363636363636,0.03636363636363636,0.9636363636363636,55,1500,1300,200,0.8666666666666667,17,13,4,329.88214358682876,0.8541245791245792,0.26637251812165097,0.1833127918740819,129282.86540516104,-2470.1321987265287,126812.73320643451,3005,0,658.5090909090909,38,17,17,37.36605735896627,0.609375,45.753205128205124,1016.9871794871792,26.762820512820507,0
3013,4,0,0,53,0.0,0.0,1.0,53,1200,900,300,0.75,15,9,6,343.60877480895056,0.8417392356071601,0.2676487068274309,0.1901732903632715,129123.91067031863,-1726.3782512062858,127397.53241911234,3006,3,684.3584905660377,40,13,17,37.17878212178784,0.6044270833333333,45.90955284552846,1016.3617886178864,25.40904471544716,0
3014,4,0,0,53,0.0,0.0,1.0,53,1450,800,650,0.5517241379310345,21,8,13,343.2017480630053,0.8413461538461539,0.27227680752378114,0.19019651445286637,129175.56023407016,-1733.3443841298283,127442.21584994033,3007,4,685.3584905660377,40,13,17,37.136567363124406,0.6049479166666667,45.85873983739837,1016.5650406504051,25.414126016260127,0
3015,4,2,1,54,0.03636363636363636,0.01818181818181818,0.9818181818181818,55,1300,900,400,0.6923076923076923,17,9,8,333.9993861439378,0.8517115600448933,0.280800420892219,0.18742115609935847,129666.74619108981,-2338.2721098552593,127328.47408123456,3008,0,661.4,40,15,18,36.871590833499624,0.6098958333333334,45.376016260162594,1018.4959349593485,25.46239837398371,0
3016,4,0,0,54,0.0,0.0,1.0,54,1200,500,700,0.4166666666666667,19,5,14,321.27268838199086,0.845722688096902,0.18384768843785237,0.17173690277805465,127737.36230379067,-2589.563125588013,125147.79917820265,3009,1,674.6481481481482,43,11,17,39.15817720530835,0.5859980620155039,47.27746212121212,1010.8901515151508,23.50907329105002,5
3017,4,1,1,54,0.01818181818181818,0.01818181818181818,0.9818181818181818,55,1100,700,400,0.6363636363636364,15,7,8,323.290826262934,0.8499438832772166,0.19783015338570897,0.1745770461819847,128144.53125000026,-2714.4097222221926,125430.12152777807,3010,0,663.3636363636364,44,11,18,38.69170096021952,0.588778409090909,46.875000000000014,1012.500000000002,23.011363636363683,0
3018,4,1,1,54,0.01818181818181818,0.01818181818181818,0.9818181818181818,55,1450,1100,350,0.7586206896551724,18,11,7,316.97964449541274,0.8559203142536476,0.20775298860161295,0.1727539062500002,128512.70957274221,-2852.8174012979753,125659.89217144424,3011,0,662.4909090909091,42,13,16,38.47656250000003,0.5952380952380951,46.511627906976756,1013.9534883720945,24.141749723145107,0
3019,4,1,1,54,0.01818181818181818,0.01818181818181818,0.9818181818181818,55,1100,600,500,0.5454545454545454,16,6,10,292.2930813335928,0.8540123456790124,0.10855552941749069,0.1604962548998323,128810.30545217669,-3456.2543815851745,125354.05107059152,3012,0,663.4727272727273,45,10,14,38.80043350881888,0.5942129629629629,46.21829710144928,1015.1268115942041,22.558373590982313,6
3020,4,1,0,55,0.01818181818181818,0.0,1.0,55,1100,800,300,0.7272727272727273,14,8,6,294.67348854333017,0.8538439955106621,0.11624930093829589,0.16268200518448792,129024.94454089539,-3395.9538966049126,125628.99064429048,3013,0,663.9636363636364,47,8,16,38.52244246981088,0.5939716312056736,46.00694444444446,1015.9722222222249,21.616430260047338,0
3021,4,1,1,55,0.017857142857142856,0.017857142857142856,0.9821428571428571,56,1700,1100,600,0.6470588235294118,23,11,12,288.2396019861012,0.8551948051948052,0.12095609290486786,0.15993522156668252,129224.41225746971,-3750.1196789889927,125474.29257848072,3014,0,653.0892857142857,45,11,16,38.4839458054937,0.5983796296296295,45.81068840579711,1016.757246376813,22.59460547504029,0
3022,4,1,1,55,0.017857142857142856,0.017857142857142856,0.9821428571428571,56,1100,700,400,0.6363636363636364,15,7,8,294.56886088439944,0.8565340909090909,0.1391000864567966,0.1645017753925009,129477.80468914121,-3571.974112581367,125905.83057655985,3015,0,654.0714285714286,45,11,11,38.06663106680905,0.6009259259259259,45.56159420289856,1017.753623188408,22.616747181964623,0
3023,4,2,1,56,0.03508771929824561,0.017543859649122806,0.9824561403508771,57,1500,1000,500,0.6666666666666666,20,10,10,288.9572624601148,0.8585265246449456,0.15357326580176167,0.16255437187734234,129765.31554153487,-3900.6739317690044,125864.64160976587,3016,0,643.438596491228,46,11,12,37.91891441167086,0.6025815217391304,45.279255319148945,1018.8829787234062,22.14962997224796,0
3024,4,0,1,55,0.0,0.017857142857142856,0.9821428571428571,56,1550,1100,450,0.7096774193548387,20,11,9,293.617039072268,0.8553436147186148,0.14260151913526076,0.16503302540958578,129731.44531250054,-3581.7274305555125,126149.71788194502,3017,1,655.9285714285714,45,11,12,37.834441036128126,0.6034722222222221,45.31250000000002,1018.7500000000043,22.638888888888985,0
3025,4,1,0,56,0.017857142857142856,0.0,1.0,56,1500,1000,500,0.6666666666666666,20,10,10,293.9864067452316,0.857805735930736,0.15715931247749015,0.16634164470193832,129991.23004533257,-3556.869074115959,126434.3609712166,3018,0,656.8392857142857,46,10,13,37.56266481207801,0.6048460144927535,45.05762411347519,1019.769503546102,22.168902251002216,0
3026,4,1,2,55,0.017543859649122806,0.03508771929824561,0.9649122807017544,57,1750,1300,450,0.7428571428571429,22,13,9,288.6266877448993,0.8603017961570593,0.15999092893386546,0.16435647560253178,130240.43424629913,-3881.826970606638,126358.6072756925,3019,0,646.2982456140351,47,10,13,37.44800082206537,0.6061613475177303,44.81336805555557,1020.7465277777811,21.71801122931449,0
3027,4,0,0,55,0.0,0.0,1.0,55,1400,900,500,0.6428571428571429,19,9,10,301.4950853126052,0.8521604938271605,0.15788462625007038,0.17106998215999394,130100.82018122535,-3155.048424044292,126945.77175718106,3020,2,670.6727272727272,45,10,15,37.260554470389785,0.6071759259259257,44.9501811594203,1020.1992753623213,22.671095008051584,0
3028,4,2,2,55,0.03508771929824561,0.03508771929824561,0.9649122807017544,57,1000,600,400,0.6,14,6,8,290.52507323135484,0.8581349206349206,0.17175456480140228,0.16666964727483022,130528.56445312529,-3815.6358506944152,126712.92860243088,3021,0,648.1052631578947,47,10,11,37.10924226979274,0.6090425531914893,44.531250000000014,1021.8750000000023,21.742021276595793,0
3029,4,2,3,54,0.03508771929824561,0.05263157894736842,0.9473684210526316,57,1500,900,600,0.6,21,9,12,275.38359240719126,0.8583176691729323,0.15678254942058611,0.15478457090473166,129731.4453125,-4225.792100694445,125505.65321180556,3022,0,649.0701754385965,49,8,10,38.29882413087935,0.5988520408163266,45.3125,1018.75,20.790816326530614,7
3030,4,0,2,52,0.0,0.037037037037037035,0.962962962962963,54,1450,1000,450,0.6896551724137931,19,10,9,286.1112831800988,0.8471494293035173,0.1409590516900936,0.15964219765446405,129444.19672459702,-3392.9109549817003,126051.28576961532,3023,5,686.0185185185185,47,7,10,38.31579302795075,0.5981826241134753,45.59461805555554,1017.6215277777753,21.651521867612242,0
3031,4,0,0,52,0.0,0.0,1.0,52,1400,1200,200,0.8571428571428571,16,12,4,287.4626683821225,0.8423359728506786,0.14339347219944276,0.16057645482517305,129488.36809323143,-2955.3856366946516,126532.98245653677,3024,6,704.4423076923077,47,5,11,38.23676261549397,0.5986258865248227,45.55121527777777,1017.7951388888877,21.655215721040165,0
3032,4,1,0,53,0.018867924528301886,0.0,1.0,53,1400,600,800,0.42857142857142855,22,6,16,286.35142807232046,0.8479983067247218,0.1547566566743077,0.16126106738809645,129807.25623582776,-3165.9013605442115,126641.35487528355,3025,0,692.1320754716982,48,5,12,37.94295171339564,0.6006944444444444,45.23809523809524,1019.0476190476198,21.230158730158745,0
3033,4,1,1,53,0.018518518518518517,0.018518518518518517,0.9814814814814815,54,1700,1400,300,0.8235294117647058,20,14,6,280.47042018711244,0.8535406475658048,0.15522898071725355,0.15867390345953286,129986.25781250003,-3508.5399305555547,126477.71788194447,3026,0,680.2962962962963,49,5,12,37.9122572253548,0.6014030612244898,45.0625,1019.7500000000002,20.811224489795922,0
3034,4,1,1,53,0.018518518518518517,0.018518518518518517,0.9814814814814815,54,1450,1000,450,0.6896551724137931,19,10,9,283.0036241207181,0.8527836012112742,0.14701078079059138,0.16071875573905733,130135.01388888899,-3434.263888888879,126700.75000000012,3027,0,681.2777777777778,49,5,12,37.697715888054006,0.602891156462585,44.91666666666667,1020.3333333333342,20.823129251700696,0
3035,4,0,1,52,0.0,0.018867924528301886,0.9811320754716981,53,700,500,200,0.7142857142857143,9,5,4,286.8740440924187,0.8484518626028059,0.13173419140948783,0.16272472373412503,130089.03354071204,-3136.166571220335,126952.8669694917,3028,3,695.1320754716982,48,5,13,37.645348837209305,0.603515625,44.961734693877546,1020.1530612244885,21.25318877551018,0
3036,4,0,1,51,0.0,0.019230769230769232,0.9807692307692307,52,1800,1200,600,0.6666666666666666,24,12,12,292.0904577530024,0.8493589743589742,0.13225939451054325,0.16585658166322656,130129.69970703125,-2798.0712890625,127331.62841796875,3029,4,680.0192307692307,47,5,14,37.47128637059724,0.6050531914893618,44.921875,1020.3125,21.70877659574468,0
3037,4,2,3,50,0.03773584905660377,0.05660377358490566,0.9433962264150944,53,1150,900,250,0.782608695652174,14,9,5,284.75465353069154,0.858399854862119,0.1335475739178127,0.1627999637241072,130395.5417209205,-3173.7847222221867,127221.75699869831,3030,0,655.9056603773585,47,6,14,37.39057453680096,0.6077127659574466,44.66145833333335,1021.3541666666696,21.73093971631212,0
3038,4,1,1,50,0.0196078431372549,0.0196078431372549,0.9803921568627451,51,1500,900,600,0.6,21,9,12,293.00911647488385,0.8497712418300655,0.1295084647305791,0.1673447203210658,130355.07000236285,-2560.9552221172107,127794.11478024564,3031,0,682.0,45,6,17,37.22059606173498,0.6097222222222222,44.701086956521735,1021.1956521739123,22.69323671497583,0
3039,4,2,3,49,0.038461538461538464,0.057692307692307696,0.9423076923076923,52,1300,800,500,0.6153846153846154,18,8,10,287.60830119673307,0.859445701357466,0.14394565898814182,0.1656980092908651,130692.81364745233,-2882.3323776470043,127810.48126980533,3032,0,661.8653846153846,46,6,12,37.01845269059591,0.6118659420289856,44.37056737588652,1022.5177304964539,22.228646315140303,0
3040,4,0,0,49,0.0,0.0,1.0,49,1350,900,450,0.6666666666666666,18,9,9,302.6244670253307,0.8483914399092971,0.13999307171157072,0.17253275404548357,130286.75538230326,-1914.4080183941585,128372.34736390911,3033,8,703.3673469387755,43,6,17,37.04404739820053,0.6116763565891472,44.76799242424243,1020.9280303030313,23.742512332628635,0
3041,4,0,0,49,0.0,0.0,1.0,49,1600,1200,400,0.75,20,12,8,302.22277014705213,0.8472576530612245,0.14900474688412269,0.17291558492888393,130424.45393726355,-1916.5520472327348,128507.90189003081,3034,9,704.3673469387755,45,4,18,36.915384558541014,0.6104166666666666,44.63315217391304,1021.4673913043465,22.69927536231881,0
3042,4,0,0,49,0.0,0.0,1.0,49,1400,1000,400,0.7142857142857143,18,10,8,305.21813648088516,0.8478954081632654,0.14125444540517829,0.17515111982590764,130540.13485218436,-1831.3566608905744,128708.7781912938,3035,10,705.3673469387755,45,4,14,36.72221237369262,0.611574074074074,44.51992753623188,1021.920289855072,22.709339774557158,0
3043,4,0,0,49,0.0,0.0,1.0,49,1300,800,500,0.6153846153846154,18,8,10,304.48743162212133,0.8468324829931974,0.14291139103169237,0.1751501097496055,130632.71650519839,-1844.7959331022964,128787.92057209609,3036,11,706.3673469387755,45,4,14,36.64754267824445,0.6125,44.42934782608695,1022.2826086956513,22.717391304347807,0
3044,4,0,0,49,0.0,0.0,1.0,49,1300,600,700,0.46153846153846156,20,6,14,303.3379598207079,0.8457695578231292,0.14306679100970898,0.17511719030140221,130771.65051984855,-1866.3988657845186,128905.25165406404,3037,12,707.3673469387755,45,4,14,36.53692879914982,0.6138888888888889,44.293478260869556,1022.82608695652,22.72946859903378,0
3045,4,0,0,49,0.0,0.0,1.0,49,1250,900,350,0.72,16,9,7,303.5833718699592,0.843360260770975,0.14637952897569062,0.17589153514804068,130910.65837665385,-1851.5401832598382,129059.11819339401,3038,13,708.3673469387755,45,4,14,36.39065911370746,0.6152777777777778,44.157608695652165,1023.3695652173895,22.741545893719767,0
3046,4,1,0,50,0.02,0.0,1.0,50,1400,800,600,0.5714285714285714,20,8,12,300.8765110448617,0.8447448979591836,0.15938397646651614,0.17581045069042023,131237.27192419904,-2102.7575008802396,129134.5144233188,3039,0,695.18,46,4,15,36.13135923170096,0.6173007246376812,43.8386524822695,1024.6453900709223,22.274899784150485,0
3047,4,0,0,50,0.0,0.0,1.0,50,1100,700,400,0.6363636363636364,15,7,8,300.943550664382,0.8443197278911564,0.15672369789205054,0.1763812644032406,131352.9566000389,-2093.9092219021777,129259.0473781367,3040,1,696.18,42,8,16,36.01336767810442,0.6237599206349207,43.72577519379844,1025.0968992248047,24.407069029162017,0
3048,4,0,1,49,0.0,0.02,0.98,50,1450,1000,450,0.6896551724137931,19,10,9,295.8573426512399,0.8438945578231293,0.151078286558346,0.1741699312825123,131522.3255280072,-2217.6308539945026,129304.6946740127,3041,2,697.18,43,7,18,35.9736582964057,0.624031007751938,43.560606060606055,1025.7575757575746,23.85482734319941,0
3049,4,0,0,49,0.0,0.0,1.0,49,1400,1100,300,0.7857142857142857,17,11,6,299.9216600458178,0.8448837868480726,0.15331471211323877,0.17669842041764458,131551.69390548943,-1908.9595164052644,129642.73438908417,3042,3,693.9591836734694,42,7,19,35.839945215830745,0.6257440476190477,43.531976744186046,1025.8720930232557,24.425526024363233,0
3050,4,0,0,49,0.0,0.0,1.0,49,900,600,300,0.6666666666666666,12,6,6,298.62654828748776,0.8438208616780045,0.15005684993544177,0.17627955107940324,131626.2591265548,-1938.5809146085066,129687.67821194629,3043,4,694.9591836734694,42,7,12,35.798316021403835,0.6264880952380953,43.45930232558139,1026.1627906976737,24.43244739756366,0
3051,4,1,1,49,0.02,0.02,0.98,50,1100,600,500,0.5454545454545454,16,6,10,292.0414738726712,0.8476700680272109,0.1503695511934391,0.17402207759430807,131984.12682399256,-2291.032214904747,129693.09460908781,3044,0,682.04,43,7,12,35.608565262802216,0.6286337209302326,43.110795454545446,1027.5568181818164,23.8966701902748,0
3052,4,0,0,49,0.0,0.0,1.0,49,1000,700,300,0.7,13,7,6,300.65157681147133,0.841624149659864,0.15359828141783072,0.17887250377975392,131924.7312736612,-1867.324304428841,130057.40696923235,3045,6,696.9591836734694,42,7,12,35.446928252530974,0.6294642857142858,43.16860465116278,1027.325581395347,24.460132890365404,0
3053,4,0,1,48,0.0,0.02040816326530612,0.9795918367346939,49,1450,900,550,0.6206896551724138,20,9,11,299.66437301567134,0.8402069160997733,0.15475077896264966,0.17879370205272532,132032.78456618713,-1886.8956790920884,130145.88888709503,3046,7,697.9591836734694,43,6,13,35.363973862833625,0.6291182170542637,43.063446969696955,1027.7462121212095,23.901074700493243,0
3054,4,1,1,48,0.02040816326530612,0.02040816326530612,0.9795918367346939,49,1200,800,400,0.6666666666666666,16,8,8,302.24146219092256,0.8464427437641724,0.16131379618297959,0.1810514390017467,132183.68055555545,-1809.7222222222265,130373.95833333321,3047,0,690.1020408163265,44,5,14,35.146542409508385,0.6292613636363636,42.916666666666664,1028.3333333333326,23.371212121212103,0
3055,4,0,0,48,0.0,0.0,1.0,48,1550,1100,450,0.7096774193548387,20,11,9,305.07356150941285,0.841404403073286,0.15886026541764253,0.18228884175874582,132088.48165294912,-1540.6592935528247,130547.82235939629,3048,9,705.4791666666666,44,4,14,35.16915120398726,0.628314393939394,43.00925925925925,1027.962962962962,23.362794612794588,0
3056,4,0,0,48,0.0,0.0,1.0,48,1300,900,400,0.6923076923076923,17,9,8,302.91569504063216,0.8409611406619385,0.1562199915976472,0.181683992468215,132231.292866941,-1589.013203017841,130642.27966392315,3049,10,706.4791666666666,44,4,14,35.081510322890395,0.6297348484848486,42.87037037037037,1028.5185185185182,23.37542087542087,0
3057,4,0,0,48,0.0,0.0,1.0,48,1300,800,500,0.6153846153846154,18,8,10,301.75704239491006,0.8411643026004728,0.14732994395046495,0.18145358626594915,132328.09648872324,-1613.8129955629347,130714.2834931603,3050,11,707.4791666666666,45,3,14,35.01436085923054,0.6293981481481483,42.77626811594202,1028.89492753623,22.86433172302733,0
3058,4,1,0,49,0.02040816326530612,0.0,1.0,49,1300,800,500,0.6153846153846154,18,8,10,329.6479535084677,0.8455569727891157,0.15381670528918012,0.18497938354209761,129666.74619108994,-1115.144167551157,128551.60202353878,3051,0,694.0204081632653,40,9,14,36.982388744761515,0.6098958333333333,45.3760162601626,1018.4959349593495,25.46239837398374,8
3059,4,0,0,49,0.0,0.0,1.0,49,750,600,150,0.8,9,6,3,342.2342673316072,0.8443877551020409,0.17317766831804926,0.19421649574573246,130107.01844346964,-891.852258080492,129215.16618538916,3052,1,695.0204081632653,40,9,18,36.21521897931403,0.6143229166666666,44.94410569105692,1020.2235772357735,25.50558943089434,1
3060,4,0,0,49,0.0,0.0,1.0,49,850,200,650,0.23529411764705882,15,2,13,351.3536026655559,0.842828798185941,0.17709287796751338,0.20018984337921217,130262.58680555563,-645.9823641681451,129616.60444138749,3053,2,696.0204081632653,36,13,18,35.824829931972786,0.622974537037037,44.79166666666667,1020.833333333334,28.356481481481502,0
3061,4,0,0,49,0.0,0.0,1.0,49,1650,1100,550,0.6666666666666666,22,11,11,348.6272614752743,0.8426516439909297,0.18173347857007838,0.1990775823084247,130348.8201038876,-711.3695621297015,129637.45054175789,3054,3,697.0204081632653,36,13,18,35.807004484634625,0.6238425925925927,44.707207207207205,1021.1711711711706,28.36586586586585,0
3062,4,0,0,49,0.0,0.0,1.0,49,1750,1300,450,0.7428571428571429,22,13,9,348.3635374783909,0.842828798185941,0.1800488134184972,0.20192753721092566,130928.03955078126,-677.8889973958321,130250.15055338544,3055,4,698.0204081632653,39,10,13,35.227417302798976,0.624198717948718,44.140625,1023.4375000000001,26.241987179487182,2
3063,4,1,0,50,0.02,0.0,1.0,50,950,500,450,0.5263157894736842,14,5,9,342.4597827333744,0.8488605442176871,0.18162285487550855,0.19990370988622735,131197.94894118904,-1013.9957821072148,130183.95315908182,3056,0,685.04,40,10,14,35.105850940713566,0.6252604166666667,43.8770325203252,1024.4918699186987,25.61229674796747,0
3064,4,0,2,48,0.0,0.04,0.96,50,1350,900,450,0.6666666666666666,18,9,9,343.38026307092366,0.8483503401360544,0.18032520325203283,0.20112272551296936,131328.12499999985,-980.9027777777924,130347.22222222206,3057,1,686.04,40,10,15,34.95088075880759,0.6265625000000001,43.74999999999999,1024.9999999999989,25.62499999999997,0
3065,4,0,1,47,0.0,0.020833333333333332,0.9791666666666666,48,1350,900,450,0.6666666666666666,18,9,9,352.5749910648763,0.8444148936170213,0.192631748183683,0.20577246435307953,131191.27498584622,-349.0474788151134,130842.2275070311,3058,2,672.0625,38,10,15,34.85352139604408,0.6285635964912281,43.883547008547005,1024.4658119658113,26.959626630679246,0
3066,4,0,0,47,0.0,0.0,1.0,47,1700,1200,500,0.7058823529411765,22,12,10,358.8304850056431,0.8418131359851988,0.20291795915950428,0.20925058619991982,131159.59357686967,12.812115266223117,131172.4056921359,3059,3,686.6595744680851,37,10,15,34.72534432312853,0.6300675675675677,43.91447368421052,1024.3421052631568,27.684921763869102,0
3067,4,0,0,47,0.0,0.0,1.0,47,1600,1300,300,0.8125,19,13,6,357.0176260502187,0.8414662349676225,0.2009979590304367,0.20957136354021283,131412.4312889541,-16.689149546037186,131395.74213940807,3060,4,687.6595744680851,37,10,17,34.51625049014365,0.6326013513513514,43.667763157894726,1025.3289473684197,27.71159317211945,0
3068,4,0,0,47,0.0,0.0,1.0,47,750,500,250,0.6666666666666666,10,5,5,358.4616897600647,0.8422756706753006,0.20024522795052646,0.21072860995134393,131468.650510253,25.294922476127425,131493.94543272915,3061,5,688.6595744680851,37,10,17,34.422444670159294,0.6331644144144146,43.61293859649122,1025.548245614034,27.717520151730646,0
3069,4,1,1,47,0.020833333333333332,0.020833333333333332,0.9791666666666666,48,650,300,350,0.46153846153846156,10,3,7,349.00878812480045,0.8461140661938534,0.19890108936996964,0.20648253918122408,131711.6845642485,-406.2929176711406,131305.39164657737,3062,0,675.2916666666666,38,10,12,34.41966763807938,0.6337719298245614,43.37606837606837,1026.4957264957252,27.013045434098032,0
3070,4,0,0,47,0.0,0.0,1.0,47,1300,900,400,0.6923076923076923,17,9,8,356.9651366888251,0.8417745914276904,0.20759403989638514,0.2114941407878918,131766.52444480956,7.211081890556841,131773.73552670013,3063,7,690.6595744680851,38,9,12,34.16016302462713,0.6343201754385965,43.32264957264957,1026.7094017094005,27.018668466036853,0
3071,4,0,0,47,0.0,0.0,1.0,47,1050,800,250,0.7619047619047619,13,8,5,356.47778753780926,0.841427690410114,0.21111482456159836,0.21166281479931795,131848.8056674153,0.23410676454429336,131849.03977417984,3064,8,691.6595744680851,38,9,12,34.08968757585215,0.6351425438596492,43.24252136752136,1027.0299145299134,27.02710301394509,0
3072,4,1,1,47,0.020833333333333332,0.020833333333333332,0.9791666666666666,48,1450,1200,250,0.8275862068965517,17,12,5,348.30008148577286,0.8438792848699763,0.2092514267382568,0.20849424526052548,132156.90239800353,-393.94802517360733,131762.95437282993,3065,0,678.2291666666666,39,9,15,33.989400769932125,0.6364850427350428,42.942708333333336,1028.229166666667,26.364850427350436,0
3073,4,1,2,46,0.020833333333333332,0.041666666666666664,0.9583333333333334,48,1150,900,250,0.782608695652174,14,9,5,347.8479539379581,0.8464095744680851,0.20890162746260832,0.2082559525410804,132162.78029777246,-405.4894573335959,131757.29084043886,3066,0,679.2083333333334,40,8,15,33.99510772880018,0.6348958333333332,42.9369918699187,1028.252032520325,25.706300813008124,0
3074,4,1,1,46,0.02127659574468085,0.02127659574468085,0.9787234042553191,47,1300,900,400,0.6923076923076923,17,9,8,355.1558316021996,0.8377274128893,0.2091091773107141,0.21214756333235515,132076.58420138893,-18.4461805555502,132058.13802083337,3067,0,694.4255319148937,39,8,15,33.894068369139305,0.6356837606837606,43.020833333333336,1027.916666666667,26.356837606837615,0
3075,4,1,1,46,0.02127659574468085,0.02127659574468085,0.9787234042553191,47,1050,500,550,0.47619047619047616,16,5,11,352.3479795843852,0.8376888683317915,0.20073105969171356,0.21106670233355884,132183.6805555555,-85.06944444444895,132098.61111111107,3068,0,695.4042553191489,39,8,16,33.858387358184764,0.6367521367521367,42.916666666666664,1028.333333333333,26.36752136752136,0
3076,4,0,0,46,0.0,0.0,1.0,46,1100,600,500,0.5454545454545454,16,6,10,361.0446784391296,0.8330314009661836,0.20409837176827872,0.21561830237510002,132068.3478180472,336.51483399078,132404.86265203796,3069,30,711.5217391304348,38,8,16,33.751039392994485,0.6373355263157896,43.028846153846146,1027.884615384614,27.049595141700372,0
3077,4,0,1,45,0.0,0.021739130434782608,0.9782608695652174,46,1900,1700,200,0.8947368421052632,21,17,4,360.9806173047734,0.8329106280193237,0.20738791643139454,0.21620649916356202,132178.18737900862,342.75273486010354,132520.94011386874,3070,31,712.5217391304348,38,8,16,33.64199134199135,0.6384320175438596,42.922008547008545,1028.3119658119654,27.060841205578036,0
3078,4,0,0,45,0.0,0.0,1.0,45,1300,900,400,0.6923076923076923,17,9,8,362.83669028819,0.8339646464646465,0.20723498100615445,0.21700295031965497,132123.26189139078,587.8334109503887,132711.09530234116,3071,32,715.1111111111111,38,7,16,33.64963282413661,0.6378837719298246,42.975427350427346,1028.0982905982899,27.055218173639208,0
3079,4,0,0,45,0.0,0.0,1.0,45,800,500,300,0.625,11,5,6,360.7599027832028,0.8318602693602694,0.20564095462309018,0.21654590673295984,132260.59701219955,542.864024033893,132803.46103623344,3072,33,716.1111111111111,38,7,16,33.564646517102894,0.6392543859649124,42.84188034188034,1028.6324786324785,27.069275753486277,0
3080,4,0,0,45,0.0,0.0,1.0,45,750,500,250,0.6666666666666666,10,5,5,375.38143441818687,0.8312710437710438,0.24008833463237123,0.21031195648844314,129605.1429831195,730.2728961955467,130335.41587931504,3073,34,717.1111111111111,41,4,14,35.880667056378286,0.6077235772357723,45.43650793650795,1018.2539682539708,24.83546264034075,7
3081,4,1,1,45,0.021739130434782608,0.021739130434782608,0.9782608695652174,46,1250,1100,150,0.88,14,11,3,370.50959562251734,0.835950080515298,0.23882870334012485,0.2089753585176014,129867.21543364302,423.40989498830083,130290.62532863133,3074,0,702.5,42,4,14,35.7379107646481,0.6088789682539681,45.17926356589148,1019.2829457364359,24.268641565153235,0
3082,4,1,0,46,0.021739130434782608,0.0,1.0,46,900,300,600,0.3333333333333333,15,3,12,372.0787224256167,0.8345008051529791,0.23823797974622862,0.21039142375522657,129966.00193986246,471.5167921098548,130437.51873197232,3075,0,703.4782608695652,42,4,15,35.59742152111249,0.6098710317460316,45.082364341085274,1019.6705426356594,24.277870062753795,0
3083,4,0,0,46,0.0,0.0,1.0,46,1400,1100,300,0.7857142857142857,17,11,6,370.2518454526286,0.8347020933977456,0.23818639534273855,0.2105648621869647,130190.09452658697,440.62455162420406,130630.71907821117,3076,1,704.4782608695652,43,3,15,35.41618338436793,0.6107073643410852,44.8626893939394,1020.5492424242431,23.7337033121917,0
3084,4,1,0,47,0.02127659574468085,0.0,1.0,47,1000,700,300,0.7,13,7,6,364.8098811598942,0.838613937711995,0.24792964840344833,0.20905192320380023,130485.24728081241,120.50186454882868,130605.74914536125,3077,0,690.468085106383,42,5,16,35.25543753161355,0.6150793650793651,44.57364341085271,1021.7054263565888,24.326319675156874,0
3085,4,0,0,47,0.0,0.0,1.0,47,1250,900,350,0.72,16,9,7,364.04932448235337,0.8385753931544865,0.24551811516719058,0.20888270816054927,130534.75320743935,104.2177453277944,130638.97095276715,3078,1,691.468085106383,42,5,15,35.224650736456155,0.615575396825397,44.52519379844961,1021.8992248062007,24.330933923957158,0
3086,4,0,0,47,0.0,0.0,1.0,47,1000,800,200,0.8,12,8,4,360.4414995170821,0.8384983040394696,0.23983059392961636,0.2073423020668055,130633.79322907266,17.168063818269047,130650.96129289093,3079,2,692.468085106383,42,5,15,35.216429699842024,0.6165674603174605,44.428294573643406,1022.2868217054254,24.340162421557746,0
3087,4,0,1,46,0.0,0.02127659574468085,0.9787234042553191,47,1300,1000,300,0.7692307692307693,16,10,6,359.4490762272448,0.8376888683317915,0.23763433924842614,0.20756807705989014,130782.42368247084,1.924275884846594,130784.34795835568,3080,3,693.468085106383,42,5,15,35.09121984337502,0.6180555555555556,44.2829457364341,1022.8682170542622,24.354005167958626,0
3088,4,0,0,46,0.0,0.0,1.0,46,1050,600,450,0.5714285714285714,15,6,9,364.75393728799116,0.8359903381642513,0.2387508224932937,0.21028431686602958,130718.71456916085,336.03316326529125,131054.74773242614,3081,4,704.4565217391304,41,5,16,35.02012999611951,0.6189024390243902,44.34523809523809,1022.6190476190463,24.941927990708447,0
3089,4,0,1,45,0.0,0.021739130434782608,0.9782608695652174,46,1250,700,550,0.56,18,7,11,363.14707694794197,0.8355072463768116,0.2375902880156815,0.20997299224624125,130831.9859458564,302.2506535063768,131134.23659936278,3082,5,705.4565217391304,42,4,16,34.946446612363445,0.6185515873015873,44.234496124031,1023.0620155038742,24.35861941675891,0
3090,4,1,1,45,0.021739130434782608,0.021739130434782608,0.9782608695652174,46,1300,900,400,0.6923076923076923,17,9,8,363.7624785283073,0.8371376811594203,0.23833610457172005,0.21114213314137578,130980.7290727721,329.17492939126333,131309.90400216336,3083,0,706.2826086956521,42,4,16,34.780070680297854,0.6200396825396826,44.08914728682171,1023.6434108527135,24.372462163159845,0
3091,4,0,0,45,0.0,0.0,1.0,45,1000,500,500,0.5,15,5,10,370.31630417839193,0.8321548821548822,0.23862869948393084,0.21419360880492197,130845.5582030267,690.848706380713,131536.4069094074,3084,7,722.9777777777778,41,4,16,34.74932528523869,0.6201727642276422,44.221230158730165,1023.1150793650803,24.95402632597757,0
3092,4,1,0,46,0.021739130434782608,0.0,1.0,46,850,600,250,0.7058823529411765,11,6,5,364.34069283939994,0.8376207729468599,0.23882196164239322,0.21243494009957517,131154.36952594502,356.97477239950354,131511.3442983445,3085,0,708.2391304347826,42,4,17,34.58952164727399,0.6217757936507936,43.91957364341086,1024.321705426357,24.388612033960882,0
3093,4,0,2,44,0.0,0.043478260869565216,0.9565217391304348,46,1350,1100,250,0.8148148148148148,16,11,5,366.1223939796892,0.8366747181964573,0.24194649082417885,0.21416540037219017,131278.46884201694,412.79745808547256,131691.2663001024,3086,1,709.2391304347826,42,4,17,34.4183371154816,0.6230158730158729,43.79844961240311,1024.8062015503895,24.400147655961653,0
3094,4,0,0,44,0.0,0.0,1.0,44,1150,600,550,0.5217391304347826,17,6,11,380.74982308153375,0.8354254756871037,0.26891121870294676,0.22255654876122394,131250.01161882837,1194.6837406636587,132444.69535949203,3087,2,729.9318181818181,40,4,17,34.07240735230918,0.6257812499999998,43.82621951219514,1024.695121951222,25.61737804878055,0
3095,4,0,0,44,0.0,0.0,1.0,44,1200,900,300,0.75,15,9,6,379.3839124457137,0.8356677237491191,0.2716447960585531,0.22236949541335518,131355.5035635365,1166.8794479545913,132522.3830114911,3088,3,730.9318181818181,38,6,17,34.000564530137225,0.6302083333333333,43.7232905982906,1025.1068376068383,26.976495726495745,0
3096,4,0,1,43,0.0,0.022727272727272728,0.9772727272727273,44,950,700,250,0.7368421052631579,12,7,5,356.62570869740205,0.8356457011980268,0.2269214304990741,0.19896496563477542,129439.78000217007,432.3106553819356,129872.090657552,3089,4,731.9318181818181,39,5,17,36.52636315556009,0.6092414529914532,45.59895833333333,1017.6041666666661,26.092414529914514,6
3097,4,0,0,43,0.0,0.0,1.0,43,800,600,200,0.75,10,6,4,363.6866808096188,0.8308877814691767,0.2350786184258733,0.20251605699819805,129364.3676035501,809.6194937540882,130173.98709730418,3090,13,749.8604651162791,38,5,19,36.42354547363999,0.6101973684210527,45.67307692307691,1017.3076923076907,26.771255060728702,0
3098,4,2,3,42,0.044444444444444446,0.06666666666666667,0.9333333333333333,45,1350,1000,350,0.7407407407407407,17,10,7,352.2313535885494,0.8416245791245792,0.21802567680110774,0.1984899997485005,129832.53146455329,146.21765951749876,129978.74912407079,3091,0,717.4888888888889,41,4,17,36.23890700541874,0.610010162601626,45.213293650793645,1019.1468253968244,24.857239643824986,0
3099,4,0,0,42,0.0,0.0,1.0,42,1150,700,450,0.6086956521739131,16,7,9,368.49621582824,0.8303571428571429,0.23165930992818673,0.20628190226261273,129572.314453125,1149.3815104166656,130721.69596354167,3092,15,764.6428571428571,39,3,17,36.08936975649682,0.6105769230769231,45.46875,1018.125,26.10576923076923,0
3100,4,1,1,42,0.023255813953488372,0.023255813953488372,0.9767441860465116,43,1100,600,500,0.5454545454545454,16,6,10,364.98074220715694,0.8362403100775193,0.23021609425688783,0.20575558536231434,129847.94439693615,878.3998240134638,130726.34422094961,3093,0,747.8372093023256,40,3,18,35.89839465549906,0.6117187500000001,45.19817073170731,1019.2073170731691,25.480182926829226,0
3101,4,1,1,42,0.023255813953488372,0.023255813953488372,0.9767441860465116,43,750,400,350,0.5333333333333333,11,4,7,363.9298370066823,0.835640457733481,0.23965281945174954,0.20625430683433452,130055.18297846829,866.1923086456264,130921.37528711391,3094,0,748.8139534883721,40,3,19,35.71452293181893,0.6138020833333334,44.99491869918698,1020.0203252032504,25.50050813008126,0
3102,4,0,0,42,0.0,0.0,1.0,42,1500,1100,400,0.7333333333333333,19,11,8,368.4123035193568,0.8371806039488966,0.2321938983841798,0.20933682861227515,130156.27170138907,1190.2343750000186,131346.50607638908,3095,1,762.8571428571429,39,3,20,35.49748196542807,0.6164529914529915,44.89583333333334,1020.4166666666681,26.16452991452995,0
3103,4,1,1,42,0.023255813953488372,0.023255813953488372,0.9767441860465116,43,1100,700,400,0.6363636363636364,15,7,8,335.24951657050445,0.8425618309339239,0.18199611270438876,0.18806948290233866,129655.65653344669,93.44263747165112,129749.09917091834,3096,0,746.0930232558139,41,2,14,36.85101305279563,0.6082317073170731,45.38690476190476,1018.4523809523807,24.84030197444831,4
3104,4,2,1,43,0.045454545454545456,0.022727272727272728,0.9772727272727273,44,1100,800,300,0.7272727272727273,14,8,6,339.306077075235,0.8441904510218464,0.21217182965512627,0.19284611216048175,130165.93491735542,33.21854912764843,130199.15346648307,3097,0,730.0909090909091,43,1,17,36.2302029200693,0.6104651162790697,44.88636363636364,1020.4545454545458,23.73150105708246,0
3105,4,1,1,43,0.022727272727272728,0.022727272727272728,0.9772727272727273,44,1250,1000,250,0.8,15,10,5,336.8456395237144,0.8441904510218464,0.20650215104106828,0.19204866904922702,130287.90632283018,-22.54563436752744,130265.36068846265,3098,0,731.0681818181819,41,3,17,36.16944822336668,0.6145833333333333,44.76686507936508,1020.9325396825407,24.900793650793673,0
3106,4,2,2,43,0.044444444444444446,0.044444444444444446,0.9555555555555556,45,750,300,450,0.4,12,3,9,336.1193422841293,0.8494107744107745,0.20632151210569583,0.1928571590711876,130534.75320743948,-224.94892133885992,130309.80428610063,3099,0,715.7777777777778,42,3,12,35.93819141538657,0.6155753968253967,44.525193798449614,1021.8992248062017,24.330933923957183,0
3107,4,0,0,43,0.0,0.0,1.0,43,1250,1000,250,0.8,15,10,5,347.7105877092384,0.8409929863418235,0.21001279775611126,0.19864375758329397,130366.35068618238,465.95208292024324,130832.30276910262,3100,3,750.0697674418604,40,3,17,35.81264304905962,0.6169270833333333,44.690040650406516,1021.2398373983757,25.530995934959392,0
3108,4,1,0,44,0.022727272727272728,0.0,1.0,44,1200,900,300,0.75,15,9,6,338.81939603310445,0.8414596546863989,0.21098477497662427,0.19507668690040086,130667.99433893933,54.57018455530866,130722.56452349464,3101,0,734.0,41,3,13,35.73444271945145,0.6183943089430894,44.39484126984127,1022.4206349206353,24.93708865660086,0
3109,4,1,0,45,0.022222222222222223,0.0,1.0,45,800,600,200,0.75,10,6,4,331.99267159147684,0.8443602693602694,0.2145503897989458,0.19232992894556172,130906.34694617221,-308.01042981189914,130598.33651636032,3102,0,718.6666666666666,42,3,15,35.66818167471516,0.6192956349206349,44.16182170542636,1023.3527131782954,24.365540789959415,0
3110,4,1,1,45,0.021739130434782608,0.021739130434782608,0.9782608695652174,46,900,600,300,0.6666666666666666,12,6,6,329.3244563204359,0.846598228663446,0.21607276900282568,0.19205674540184414,131162.08954903978,-561.0232338820289,130601.06631515775,3103,0,704.0217391304348,44,2,16,35.47843411973846,0.6190814393939394,43.91203703703704,1024.351851851852,23.280723905723907,0
3111,4,0,0,45,0.0,0.0,1.0,45,850,500,350,0.5882352941176471,12,5,7,335.66562384545415,0.8430134680134681,0.21846953769639432,0.19524219422490025,131061.33355034718,-201.4431423611158,130859.89040798607,3104,2,720.6666666666666,43,2,16,35.41772634791454,0.6194282945736433,44.010416666666664,1023.9583333333329,23.81298449612402,0
3112,4,0,0,45,0.0,0.0,1.0,45,1150,900,250,0.782608695652174,14,9,5,337.5595044177046,0.8417929292929294,0.21842162028905143,0.1968399546785073,131158.31723664195,-145.25268666781773,131013.06454997412,3105,3,721.6666666666666,43,2,16,35.27135142214416,0.6203972868217055,43.915719696969695,1024.3371212121208,23.82179351656095,0
3113,4,1,1,45,0.021739130434782608,0.021739130434782608,0.9782608695652174,46,800,500,300,0.625,11,5,6,330.71004467487467,0.8459943639291465,0.2195917210093563,0.19407892305628677,131402.62684221205,-508.546577179523,130894.08026503252,3106,0,706.9565217391304,42,4,17,35.20047727057934,0.6242559523809523,43.67732558139535,1025.2906976744189,24.411683277962354,0
3114,4,0,0,45,0.0,0.0,1.0,45,1100,900,200,0.8181818181818182,13,9,4,337.379108887598,0.8405303030303031,0.2213792658538163,0.1978703581864039,131378.97317491804,-135.09582073570851,131243.87735418233,3107,1,723.4,41,4,17,35.05338365266758,0.6255081300813008,43.70039682539682,1025.198412698412,25.00483933410761,0
3115,4,0,0,45,0.0,0.0,1.0,45,1050,600,450,0.5714285714285714,15,6,9,336.7470677044271,0.8401094276094276,0.21160442513172528,0.198264986580593,131526.84352653075,-141.74422360436256,131385.0993029264,3108,2,724.4,42,3,19,34.92053183449838,0.6254960317460319,43.55620155038759,1025.7751937984488,24.423218899963064,0
3116,4,0,0,45,0.0,0.0,1.0,45,1450,1000,450,0.6896551724137931,19,10,9,339.4120667952703,0.8402777777777778,0.21486867923736375,0.2002247562838505,131601.40170550143,-66.57925079623271,131534.8224547052,3109,3,725.4,42,3,13,34.7770485094595,0.6262400793650793,43.48352713178294,1026.0658914728679,24.43014027316352,0
3117,4,0,0,45,0.0,0.0,1.0,45,1300,900,400,0.6923076923076923,17,9,8,338.78630551093687,0.8380892255892256,0.2190377293181034,0.20037762893787567,131700.84547390474,-76.31142584580692,131624.53404805894,3110,4,726.4,42,3,13,34.692918279366886,0.6272321428571428,43.38662790697674,1026.4534883720926,24.43936877076411,0
3118,4,0,1,44,0.0,0.022222222222222223,0.9777777777777777,45,1300,900,400,0.6923076923076923,17,9,8,342.73994304022784,0.8367003367003367,0.21708595387840735,0.2036459302817498,131874.96244216093,39.76342317168445,131914.7258653326,3111,5,727.4,42,3,13,34.41607704402517,0.628968253968254,43.21705426356589,1027.1317829457364,24.455518641565153,0
3119,4,0,0,44,0.0,0.0,1.0,44,950,600,350,0.631578947368421,13,6,7,343.18938637200165,0.8360200845665963,0.2140734856530937,0.20439404684616588,131964.43457301916,257.75866480852835,132222.19323782768,3112,6,739.5454545454545,41,3,14,34.31445318786006,0.63135162601626,43.12996031746032,1027.4801587301597,25.060491676345357,0
3120,4,0,1,43,0.0,0.022727272727272728,0.9772727272727273,44,1300,900,400,0.6923076923076923,17,9,8,340.41426396468046,0.8344344608879493,0.20767283956032379,0.20356105120980872,132117.37769471225,194.92797697783755,132312.3056716901,3113,7,740.5454545454545,41,3,14,34.23186255588794,0.6328760162601625,42.9811507936508,1028.0753968253975,25.075009678668234,0
3121,4,1,2,42,0.022727272727272728,0.045454545454545456,0.9545454545454546,44,850,500,350,0.5882352941176471,12,5,7,334.4834400305608,0.8368128964059197,0.196481007456617,0.20123964020875518,132348.14544085404,53.6525937443775,132401.7980345984,3114,0,693.8409090909091,42,2,15,34.15242332925259,0.6336805555555556,42.75678294573644,1028.9728682170553,24.499354005167984,0
3122,4,0,0,42,0.0,0.0,1.0,42,950,700,250,0.7368421052631579,12,7,5,346.368658974275,0.831833139759969,0.2049708882267942,0.20722718644841753,132136.65729930927,753.5993580210172,132890.2566573303,3115,1,727.2857142857143,40,2,17,34.05942143586702,0.6346354166666668,42.96239837398374,1028.150406504065,25.703760162601622,0
3123,4,0,0,42,0.0,0.0,1.0,42,850,500,350,0.5882352941176471,12,5,7,345.3406938771816,0.8306233062330624,0.20511101387497033,0.20718394562720552,132241.164784933,733.6511211911027,132974.8159061241,3116,2,728.2857142857143,40,2,17,33.98070842802095,0.6356770833333333,42.86077235772358,1028.5569105691065,25.713922764227664,0
3124,4,0,0,42,0.0,0.0,1.0,42,1300,900,400,0.6923076923076923,17,9,8,347.23436702291383,0.8298248161053039,0.20408096084572502,0.20904252083674374,132371.85723610298,792.8116118051583,133164.66884790815,3117,3,729.2857142857143,40,2,18,33.80057113700705,0.6369791666666667,42.73373983739838,1029.0650406504076,25.72662601626019,0
3125,4,0,0,42,0.0,0.0,1.0,42,900,800,100,0.8888888888888888,10,8,2,345.41530558464797,0.8299941927990708,0.20206532319464943,0.20838791512744162,132451.61132812515,750.1653423784767,133201.77667050363,3118,4,730.2857142857143,39,3,19,33.76720299534508,0.6394230769230769,42.65625000000001,1029.3750000000011,26.3942307692308,0
3126,4,1,1,42,0.023255813953488372,0.023255813953488372,0.9767441860465116,43,850,600,250,0.7058823529411765,11,6,5,337.9710066372905,0.8332410483573274,0.19629934606642063,0.20531384279781284,132711.95969867505,370.55892243377184,133082.51862110881,3119,0,714.2790697674419,40,3,13,33.6974389321761,0.6403645833333332,42.40345528455286,1030.3861788617912,25.75965447154478,0
3127,4,0,0,42,0.0,0.0,1.0,42,1400,1100,300,0.7857142857142857,17,11,6,343.5247874370281,0.8289537359659311,0.19990510016161145,0.208251629513261,132633.43578557757,712.5745670566702,133346.01035263424,3120,6,732.2857142857143,40,2,13,33.63321329913181,0.6395833333333333,42.47967479674798,1030.0813008130099,25.752032520325248,0
3128,4,0,1,41,0.0,0.023809523809523808,0.9761904761904762,42,750,400,350,0.5333333333333333,11,4,7,340.0245528370106,0.8289537359659311,0.17378605065361863,0.19901853511977102,131301.43364800356,545.5454558892585,131846.9791038928,3121,7,733.2857142857143,39,3,15,35.0637979808246,0.6279380341880341,43.77604166666667,1024.8958333333342,26.279380341880362,4
3129,4,1,1,41,0.023809523809523808,0.023809523809523808,0.9761904761904762,42,1250,600,650,0.48,19,6,13,340.11151371913957,0.8344947735191638,0.19132369850521447,0.2012186837323576,131711.68456424848,559.3347950024711,132271.01935925096,3122,0,729.1428571428571,38,4,15,34.647992991951156,0.6337719298245614,43.37606837606837,1026.495726495725,27.013045434098025,0
3130,4,0,0,41,0.0,0.0,1.0,41,950,700,250,0.7368421052631579,12,7,5,352.3341500517857,0.8328760162601626,0.20927511913726193,0.2083512304886139,131693.64762474963,1080.0338806170803,132773.68150536672,3123,1,747.7317073170732,37,4,15,34.352521988391565,0.6354166666666667,43.39364035087718,1026.4254385964887,27.74122807017537,0
3131,4,0,0,41,0.0,0.0,1.0,41,950,800,150,0.8421052631578947,11,8,3,352.95838592564024,0.8319613821138211,0.21166335942667613,0.2094935514942675,131834.3685076175,1106.4091835949303,132940.77769121242,3124,2,748.7317073170732,37,4,15,34.19460459819204,0.6368243243243243,43.25657894736841,1026.9736842105247,27.75604551920337,0
3132,4,0,0,41,0.0,0.0,1.0,41,1400,1100,300,0.7857142857142857,17,11,6,348.4660336011689,0.8314024390243903,0.20850362557679625,0.2079555361813427,132040.8950617284,1002.3533950617311,133043.24845679014,3125,3,749.7317073170732,38,3,16,34.10191441441442,0.6370614035087719,43.05555555555556,1027.7777777777778,27.046783625730995,0
3133,4,0,0,41,0.0,0.0,1.0,41,1100,600,500,0.5454545454545454,16,6,10,330.9438865996728,0.8320630081300813,0.1776617226873365,0.18460953406810687,129433.9629705365,367.0757526934816,129801.03872322997,3126,4,750.7317073170732,40,1,15,37.18561703119279,0.6075520833333334,45.60467479674796,1017.5813008130064,25.43953252032516,8
3134,4,1,2,40,0.023809523809523808,0.047619047619047616,0.9523809523809523,42,1100,700,400,0.6363636363636364,15,7,8,325.23235109733116,0.836164343786295,0.17967054371417457,0.18268521778268013,129706.17992567384,36.92916981606328,129743.10909548991,3127,0,733.8333333333334,41,1,15,37.05484677314634,0.608739837398374,45.33730158730158,1018.6507936507926,24.845141308555917,0
3135,4,1,1,40,0.024390243902439025,0.024390243902439025,0.975609756097561,41,600,400,200,0.6666666666666666,8,4,4,329.3616360094184,0.8399390243902439,0.1745046492381095,0.18457514501198938,129614.99851278991,338.04159230615744,129953.04010509606,3128,0,747.2682926829268,40,1,15,37.042165668662676,0.609375,45.42682926829268,1018.2926829268285,25.457317073170714,0
3136,4,1,0,41,0.024390243902439025,0.0,1.0,41,850,600,250,0.7058823529411765,11,6,5,333.1296737399574,0.8399390243902439,0.18436941999581502,0.1874275033062186,129770.27253123146,446.06570989490274,130216.33824112636,3129,0,748.2439024390244,40,1,16,36.78872431677635,0.6109375,45.27439024390244,1018.9024390243907,25.472560975609767,0
3137,4,1,1,41,0.023809523809523808,0.023809523809523808,0.9761904761904762,42,1150,900,250,0.782608695652174,14,9,5,327.70518857212073,0.8430845915602013,0.18098943857698724,0.18550712216527535,130009.52695893169,120.95930964978231,130130.48626858147,3130,0,731.4047619047619,41,1,16,36.68450064850844,0.6117886178861789,45.03968253968254,1019.8412698412695,24.874177313201695,0
3138,4,1,0,42,0.023809523809523808,0.0,1.0,42,1000,700,300,0.7,13,7,6,330.6967727579463,0.8469076655052264,0.18737502777160708,0.18817524325960994,130211.95515243118,212.13466868227448,130424.08982111346,3131,0,732.3809523809524,41,1,17,36.40325298081908,0.6138211382113821,44.841269841269835,1020.6349206349194,24.89353464963218,0
3139,4,0,0,42,0.0,0.0,1.0,42,1300,1000,300,0.7692307692307693,16,10,6,328.66342443102155,0.8460607820363918,0.1883293542834934,0.18750576298470464,130313.2283005794,165.8383723859804,130479.06667296537,3132,1,733.3809523809524,41,1,18,36.35266873947403,0.6148373983739838,44.74206349206349,1021.0317460317453,24.90321331784745,0
3140,4,0,0,42,0.0,0.0,1.0,42,1300,1200,100,0.9230769230769231,14,12,2,327.72096395761645,0.8454558652729385,0.1902102268785122,0.18733411015789342,130389.20899667733,146.2554524124397,130535.46444908978,3133,2,734.3809523809524,41,1,19,36.29988262910796,0.615599593495935,44.66765873015873,1021.3293650793648,24.9104723190089,0
3141,4,0,0,42,0.0,0.0,1.0,42,1100,800,300,0.7272727272727273,14,8,6,317.182938892627,0.8441250483933411,0.17119387854296053,0.1803682085344639,130186.64301658148,-141.40359268708596,130045.2394238944,3134,3,735.3809523809524,41,1,21,36.77365850102073,0.6135670731707317,44.86607142857142,1020.5357142857131,24.89111498257837,1
3142,4,0,0,42,0.0,0.0,1.0,42,1450,1000,450,0.6896551724137931,19,10,9,319.41159727426145,0.843036198219125,0.1621175288704393,0.18247681301927562,130366.3506861824,-71.87299502760243,130294.4776911548,3135,4,736.3809523809524,40,2,21,36.53514445881846,0.6169270833333333,44.690040650406516,1021.2398373983758,25.530995934959396,0
3143,4,1,1,42,0.023255813953488372,0.023255813953488372,0.9767441860465116,43,1250,1000,250,0.8,15,10,5,313.27006415793454,0.8463455149501661,0.1632126281303512,0.18048488268730195,130693.35322381271,-411.5369701121172,130281.81625370058,3136,0,720.2325581395348,41,2,19,36.36191827560556,0.6186483739837398,44.370039682539684,1022.5198412698415,24.93950832365467,0
3144,4,2,0,44,0.045454545454545456,0.0,1.0,44,900,500,400,0.5555555555555556,13,5,8,308.0676290307516,0.8444106765327696,0.16602633050811,0.17892987909345207,131005.52780970205,-728.2875315485722,130277.24027815348,3137,0,704.8181818181819,42,2,21,36.18039122890047,0.6202876984126984,44.06492248062016,1023.7403100775202,24.374769287560007,0
3145,4,2,0,46,0.043478260869565216,0.0,1.0,46,950,500,450,0.5263157894736842,14,5,9,296.80456970481373,0.855012077294686,0.17451172833447814,0.17438252570190005,131446.78605109753,-1397.198645404649,130049.58740569289,3138,0,675.1304347826087,44,2,23,36.025206922498135,0.6219223484848484,43.63425925925927,1025.462962962964,23.305976430976454,0
3146,4,0,0,46,0.0,0.0,1.0,46,1400,1000,400,0.7142857142857143,18,10,8,302.5787186070454,0.8546900161030596,0.18588133730968437,0.17832830862585458,131565.50068587123,-1238.2158779149363,130327.2848079563,3139,1,676.1304347826087,44,2,14,35.75793471720819,0.6231060606060606,43.518518518518526,1025.9259259259272,23.316498316498347,0
3147,4,1,2,45,0.02127659574468085,0.0425531914893617,0.9574468085106383,47,1000,700,300,0.7,13,7,6,297.42700571890555,0.8543786617329633,0.18244910751652976,0.17644845441314663,131816.00934841682,-1558.8718067370282,130257.13754167978,3140,0,662.7234042553191,45,2,14,35.63874555290938,0.6243055555555556,43.27445652173913,1026.9021739130435,22.820048309178745,0
3148,4,0,1,44,0.0,0.022222222222222223,0.9777777777777777,45,1550,1300,250,0.8387096774193549,18,13,5,309.27411119129624,0.8487794612794614,0.17785977859778623,0.18299843697126927,131716.66953627186,-852.6888200183589,130863.9807162535,3141,3,693.1333333333333,43,2,14,35.434348093480935,0.625968992248062,43.371212121212125,1026.515151515152,23.872445384073302,0
3149,4,0,0,44,0.0,0.0,1.0,44,850,500,350,0.5882352941176471,12,5,7,310.5974264023322,0.8433756166314306,0.17468734173955602,0.1834655517583435,131651.11889497325,-621.900257646776,131029.21863732647,3142,4,709.6590909090909,42,2,14,35.466237056620415,0.626736111111111,43.435077519379846,1026.2596899224804,24.43475452196382,0
3150,4,0,1,43,0.0,0.022727272727272728,0.9772727272727273,44,1400,900,500,0.6428571428571429,19,9,10,308.3449868401942,0.8419221282593375,0.17146693434915394,0.1827306197180483,131775.45294753948,-673.5399390060415,131101.91300853345,3143,5,710.6590909090909,42,2,15,35.39916792500315,0.6279761904761902,43.31395348837211,1026.744186046514,24.446290143964617,0
3151,4,1,0,44,0.022727272727272728,0.0,1.0,44,1300,900,400,0.6923076923076923,17,9,8,309.5344829101694,0.8417459478505991,0.17748795253039695,0.18415738427685874,131924.7312736617,-632.9493044287959,131291.7819692329,3144,0,711.5,42,2,17,35.21878733572282,0.6294642857142856,43.1686046511628,1027.3255813953508,24.460132890365497,0
3152,4,1,1,44,0.022222222222222223,0.022222222222222223,0.9777777777777777,45,1450,1300,150,0.896551724137931,16,13,3,307.90695921094965,0.8421717171717172,0.18969780641202694,0.18513608809225046,132324.91933719284,-851.2472918101597,131473.67204538267,3145,0,696.6666666666666,43,2,18,34.85935342843994,0.6320251937984496,42.779356060606055,1028.8825757575748,23.927501761804066,0
3153,4,0,0,44,0.0,0.0,1.0,44,1700,1200,500,0.7058823529411765,22,12,10,314.4788571508741,0.8360421071176886,0.1925472352301616,0.18920402176119708,132348.14544085378,-475.8612951445395,131872.28414570924,3146,1,713.1363636363636,42,2,18,34.66702765483252,0.6336805555555556,42.756782945736425,1028.972868217053,24.49935400516793,0
3154,4,0,0,44,0.0,0.0,1.0,44,1400,1000,400,0.7142857142857143,18,10,8,314.87846228009886,0.8345886187455955,0.1921413723192218,0.19045039377635775,132547.63390308557,-452.72097154619604,132094.91293153938,3147,2,714.1363636363636,42,2,18,34.456847338540186,0.6356646825396826,42.562984496124024,1029.7480620155025,24.517811000369107,0
3155,4,0,0,44,0.0,0.0,1.0,44,850,700,150,0.8235294117647058,10,7,3,313.74559350687014,0.8353373854827344,0.1865149947409377,0.19026978919404072,132647.43447096017,-476.490388948995,132170.94408201118,3148,3,715.1363636363636,42,2,15,34.386072178848025,0.6366567460317462,42.46608527131782,1030.1356589147279,24.52703949796971,0
3156,4,0,0,44,0.0,0.0,1.0,44,650,300,350,0.46153846153846156,10,3,7,313.74559350687014,0.8353373854827344,0.1865149947409377,0.19026978919404072,132647.43447096017,-476.490388948995,132170.94408201118,3149,4,716.1363636363636,42,2,15,34.386072178848025,0.6366567460317462,42.46608527131782,1030.1356589147279,24.52703949796971,0
3157,4,0,0,44,0.0,0.0,1.0,44,1000,800,200,0.8,12,8,4,312.892266941017,0.8345225510923185,0.18697647782830185,0.19038456242475135,132772.2379965145,-491.31869328767965,132280.91930322684,3150,5,717.1363636363636,42,2,15,34.28313432368058,0.6378968253968255,42.34496124031007,1030.6201550387586,24.538575119970442,0
3158,4,0,0,44,0.0,0.0,1.0,44,1100,600,500,0.5454545454545454,16,6,10,312.892266941017,0.8345225510923185,0.18697647782830185,0.19038456242475135,132772.2379965145,-491.31869328767965,132280.91930322684,3151,6,718.1363636363636,42,2,15,34.28313432368058,0.6378968253968255,42.34496124031007,1030.6201550387586,24.538575119970442,0
3159,4,1,0,45,0.022222222222222223,0.0,1.0,45,1200,1000,200,0.8333333333333334,14,10,4,304.6972010325122,0.8373737373737374,0.19197944388363863,0.18705833237471994,133105.5236760356,-888.6238987890538,132216.89977724655,3152,0,703.1555555555556,43,2,16,34.1612561561286,0.6397771317829459,42.02178030303029,1031.9128787878763,23.997973925299448,0
3160,4,0,0,45,0.0,0.0,1.0,45,1450,1200,250,0.8275862068965517,17,12,5,304.6405501746794,0.8372474747474747,0.18776483536641364,0.18776121642478955,133252.14256377684,-881.1987954832518,132370.9437682936,3153,1,704.1555555555556,43,2,17,34.0163448897857,0.6412306201550388,41.879734848484844,1032.4810606060596,24.011187455954875,0
3161,4,0,1,44,0.0,0.022222222222222223,0.9777777777777777,45,1100,700,400,0.6363636363636364,15,7,8,305.84368151935723,0.8366582491582492,0.15291291291291254,0.18251961639058414,132040.89506172843,-866.0596355760862,131174.83542615233,3154,2,705.1555555555556,41,4,16,35.197072072072075,0.6321138211382114,43.05555555555556,1027.777777777778,25.067750677506783,5
3162,4,1,1,44,0.022222222222222223,0.022222222222222223,0.9777777777777777,45,1100,900,200,0.8181818181818182,13,9,4,302.9692085045246,0.8372895622895623,0.149300062169057,0.1815363477085491,132193.8824719701,-989.864811665422,131204.0176603047,3155,0,705.9111111111112,41,4,16,35.11761206508458,0.6336382113821138,42.906746031746025,1028.3730158730145,25.082268679829625,0
3163,4,0,0,44,0.0,0.0,1.0,44,1100,700,400,0.6363636363636364,15,7,8,306.1406535515823,0.8322542283298098,0.14053262412622014,0.18328586583638512,132162.78029777246,-707.920012889153,131454.86028488333,3156,4,722.9545454545455,40,4,17,35.06724813863084,0.6348958333333334,42.9369918699187,1028.252032520325,25.706300813008124,0
3164,4,1,2,43,0.022222222222222223,0.044444444444444446,0.9555555555555556,45,1500,1300,200,0.8666666666666667,17,13,4,307.9494619430344,0.8361952861952863,0.13098736787831933,0.18181673711979163,131633.36167800458,-892.7154195011251,130740.64625850346,3157,0,707.8666666666667,41,4,13,35.55201082753288,0.6280487804878048,43.452380952380956,1026.1904761904766,25.02903600464577,3
3165,4,1,1,43,0.022727272727272728,0.022727272727272728,0.9772727272727273,44,950,600,350,0.631578947368421,13,6,7,316.6449929918467,0.8352492952783651,0.112849071458343,0.18227980095102506,130661.65500217026,-428.8677743232612,130232.787227847,3158,0,724.8181818181819,39,5,15,36.3076286296485,0.6215277777777778,44.40104166666667,1022.3958333333343,26.215277777777803,6
3166,4,1,1,43,0.022727272727272728,0.022727272727272728,0.9772727272727273,44,1050,900,150,0.8571428571428571,12,9,3,318.0637656271,0.8364605355884426,0.1159141835959927,0.1834753261414143,130741.54188368077,-483.1705729166415,130258.37131076412,3159,0,725.7954545454545,39,5,16,36.1907550757113,0.6223290598290598,44.32291666666668,1022.7083333333351,26.223290598290642,0
3167,4,2,1,44,0.044444444444444446,0.022222222222222223,0.9777777777777777,45,800,500,300,0.625,11,5,6,314.31745777635484,0.835479797979798,0.13112324234904937,0.18273216313310883,131041.82287535541,-762.2534742877746,130279.56940106764,3160,0,710.6222222222223,40,5,17,35.983870967741964,0.6236979166666666,44.029471544715456,1023.8821138211392,25.59705284552848,0
3168,4,1,0,45,0.022222222222222223,0.0,1.0,45,950,600,350,0.631578947368421,13,6,7,314.4297760322754,0.8361531986531987,0.1348998848756764,0.1835566024355743,131201.047621016,-749.2967962648017,130451.75082475122,3161,0,711.6,41,4,19,35.82064410445109,0.6237296747967479,43.87400793650794,1024.5039682539684,24.987901664730938,0
3169,4,0,1,44,0.0,0.022222222222222223,0.9777777777777777,45,950,600,350,0.631578947368421,13,6,7,310.43070916023584,0.8331228956228957,0.14153310641860295,0.18194738891919218,131354.16795764753,-844.6649860776829,130509.50297156985,3162,1,712.6,40,5,19,35.769017877796514,0.6268229166666666,43.72459349593496,1025.10162601626,25.6275406504065,0
3170,4,0,0,44,0.0,0.0,1.0,44,1550,1100,450,0.7096774193548387,20,11,9,317.3184039808818,0.8278276955602537,0.15926180820500502,0.18598751718736486,131354.81906467004,-463.7396918402869,130891.07937282976,3163,2,729.25,39,5,19,35.59184788131287,0.6284722222222223,43.72395833333333,1025.1041666666658,26.2847222222222,0
3171,4,0,1,43,0.0,0.022727272727272728,0.9772727272727273,44,1050,600,450,0.5714285714285714,15,6,9,316.0874039733373,0.8268146582100071,0.15423331240072446,0.18565420075856387,131434.91753472213,-491.0156250000098,130943.90190972212,3164,3,730.25,39,5,19,35.54280102939185,0.6292735042735043,43.64583333333333,1025.4166666666658,26.29273504273502,0
3172,4,0,0,43,0.0,0.0,1.0,43,1000,800,200,0.8,12,8,4,323.1952715465544,0.8230435585086747,0.15616487489942532,0.18957101624454362,131382.8849806413,-107.53456242239122,131275.3504182189,3165,4,747.7906976744187,38,5,19,35.41297589273309,0.6304824561403508,43.69658119658119,1025.2136752136744,26.979307242465115,0
3173,4,0,1,42,0.0,0.023255813953488372,0.9767441860465116,43,1000,500,500,0.5,15,5,10,324.126140921298,0.8225359911406422,0.15993642086287374,0.1903893941592788,131437.6563755569,-79.52393345023233,131358.13244210667,3166,5,748.7906976744187,38,5,19,35.33396714593317,0.631030701754386,43.643162393162385,1025.4273504273492,26.984930274403926,0
3174,4,1,0,43,0.023255813953488372,0.0,1.0,43,1200,600,600,0.5,18,6,12,319.97122195985844,0.8252122554448136,0.17037903956508638,0.18952141608391607,131755.55555555545,-168.40277777778823,131587.15277777766,3167,0,743.9767441860465,39,4,16,35.12073863636363,0.6324786324786326,43.33333333333333,1026.6666666666658,26.324786324786302,0
3175,4,0,0,43,0.0,0.0,1.0,43,1350,1100,250,0.8148148148148148,16,11,5,320.666956372097,0.8241048357327426,0.17606861396858497,0.1903344685654727,131835.77609592004,-144.92458767362098,131690.85150824641,3168,1,744.9767441860465,39,4,16,35.02225124251951,0.6332799145299146,43.25520833333333,1026.9791666666658,26.332799145299123,0
3176,4,0,0,43,0.0,0.0,1.0,43,900,700,200,0.7777777777777778,11,7,4,338.4766290829415,0.8237356958287191,0.19769940950082487,0.18909406190791414,129492.7856445311,176.1501736110976,129668.9358181422,3169,2,745.9767441860465,39,4,14,36.93423139903797,0.6097756410256412,45.54687499999999,1017.8124999999989,26.09775641025638,6
3177,4,1,1,43,0.022727272727272728,0.022727272727272728,0.9772727272727273,44,1500,1100,400,0.7333333333333333,19,11,8,328.7817125304647,0.8321661381254405,0.1903233411312404,0.18498122614087767,129770.27253123141,-266.78151232732006,129503.4910189041,3170,0,730.0,40,4,15,36.89947802380476,0.6109375000000001,45.27439024390244,1018.9024390243903,25.47256097560976,0
3178,4,1,0,44,0.022727272727272728,0.0,1.0,44,1300,1000,300,0.7692307692307693,16,10,6,329.18715735583186,0.8291930937279774,0.20035104407301763,0.18631658906180312,130003.35784131454,-240.91283710094513,129762.4450042136,3171,0,730.9772727272727,40,4,17,36.65296462381664,0.61328125,45.04573170731707,1019.8170731707305,25.49542682926826,0
3179,4,0,0,44,0.0,0.0,1.0,44,1800,1500,300,0.8333333333333334,21,15,6,332.66618649838483,0.8290389358703313,0.20237127251515785,0.1890499665371479,130161.33334120648,-139.94512156718218,130021.3882196393,3172,1,731.9772727272727,41,3,17,36.40425497439887,0.6133130081300815,44.890873015873,1020.436507936505,24.88869531552451,0
3180,4,0,0,44,0.0,0.0,1.0,44,1050,600,450,0.5714285714285714,15,6,9,335.01452418962384,0.8278937632135307,0.20875940529074355,0.19114828702568568,130317.12420784937,-68.25602515277279,130248.86818269659,3173,2,732.9772727272727,38,6,18,36.186608419657496,0.6197916666666666,44.738247863247864,1021.0470085470085,26.86965811965812,0
3181,4,0,0,44,0.0,0.0,1.0,44,1500,1200,300,0.8,18,12,6,334.69495866714726,0.8266825229034531,0.20607106193680869,0.19190782881850113,130508.09500328744,-63.919707429308914,130444.17529585813,3174,3,733.9772727272727,38,6,16,36.001542241739855,0.6217105263157894,44.55128205128206,1021.7948717948727,26.88933873144402,0
3182,4,2,1,45,0.043478260869565216,0.021739130434782608,0.9782608695652174,46,1050,700,350,0.6666666666666666,14,7,7,291.26986705912134,0.8384057971014492,0.10803933204689331,0.16986391878097334,131162.08954903993,-1559.2871227709015,129602.80242626903,3175,0,703.0217391304348,44,2,17,36.4529663442707,0.6190814393939392,43.912037037037045,1024.351851851853,23.280723905723935,6
3183,4,1,1,45,0.021739130434782608,0.021739130434782608,0.9782608695652174,46,1100,700,400,0.6363636363636364,15,7,8,293.2615451275979,0.8352657004830918,0.10618086799347681,0.17123688637661605,131209.51753257902,-1504.2588305898344,129705.25870198918,3176,0,704.0,44,2,17,36.354307877692406,0.6195549242424241,43.86574074074075,1024.5370370370383,23.28493265993269,0
3184,4,0,0,45,0.0,0.0,1.0,45,1400,1100,300,0.7857142857142857,17,11,6,294.8709547984574,0.8337542087542088,0.11322095877887728,0.17194712226711137,131158.3172366421,-1265.0443533344685,129893.27288330763,3177,2,720.6444444444444,43,2,17,36.36453807278669,0.6203972868217054,43.9157196969697,1024.337121212122,23.821793516560977,0
3185,4,0,0,45,0.0,0.0,1.0,45,1250,1000,250,0.8,15,10,5,295.67849656841196,0.8327861952861954,0.11828851307642552,0.17285451168918362,131255.33679300116,-1238.1238700929612,130017.21292290819,3178,3,721.6444444444444,43,2,17,36.24636124202939,0.6213662790697674,43.821022727272734,1024.7159090909101,23.83060253699791,0
3186,4,1,1,45,0.021739130434782608,0.021739130434782608,0.9782608695652174,46,850,400,450,0.47058823529411764,13,4,9,293.7054311443741,0.8372181964573269,0.12609927912755903,0.1728111166572098,131501.99549493744,-1475.3895895404423,130026.605905397,3179,0,706.9347826086956,42,4,18,36.049244213509674,0.6252480158730158,43.58042635658916,1025.6782945736452,24.42091177556298,0
3187,4,0,0,45,0.0,0.0,1.0,45,900,500,400,0.5555555555555556,13,5,8,298.72661467728767,0.8312710437710438,0.1285680493731589,0.17520095550936973,131378.97317491833,-1150.7208207356775,130228.25235418265,3180,5,723.6444444444444,41,4,18,36.04404554544869,0.6255081300813007,43.70039682539684,1025.1984126984146,25.004839334107672,0
3188,4,0,0,45,0.0,0.0,1.0,45,800,400,400,0.5,12,4,8,303.60815739786165,0.8313973063973065,0.14221018581208145,0.178657071106232,131506.1366705249,-1014.7328317901009,130491.4038387348,3181,6,724.6444444444444,41,4,19,35.791158880613864,0.6267784552845528,43.5763888888889,1025.6944444444462,25.016937669376734,0
3189,4,1,0,46,0.021739130434782608,0.0,1.0,46,1150,1000,150,0.8695652173913043,13,10,3,297.2893577527142,0.8362721417069243,0.1530763771807837,0.17652492452778853,131850.0815474584,-1360.4747874225964,130489.6067600358,3182,0,709.8695652173913,42,4,16,35.60811554549172,0.6287202380952379,43.24127906976746,1027.0348837209328,24.453211517165066,0
3190,4,0,0,46,0.0,0.0,1.0,46,950,700,250,0.7368421052631579,12,7,5,300.001488121592,0.8355877616747183,0.1548515801516388,0.17860279497772283,131949.6192104593,-1282.983575956952,130666.63563450234,3183,1,710.8695652173913,42,4,16,35.438673017070634,0.6297123015873015,43.14437984496125,1027.4224806201564,24.46244001476563,0
3191,4,0,0,46,0.0,0.0,1.0,46,850,500,350,0.5882352941176471,12,5,7,301.56670511341775,0.8352455716586151,0.16028510066233825,0.18012497791909574,132074.09410492177,-1234.170121987843,130839.92398293392,3184,2,711.8695652173913,42,4,16,35.27369281045752,0.6309523809523809,43.0232558139535,1027.9069767441874,24.47397563676637,0
3192,4,0,2,44,0.0,0.043478260869565216,0.9565217391304348,46,1100,800,300,0.7272727272727273,14,8,6,291.8822554451062,0.8354669887278583,0.12932854596255283,0.1692720196417737,130947.07739866752,-1554.9809316360222,129392.0964670315,3185,3,712.8695652173913,41,5,11,36.65339972860327,0.621189024390244,44.122023809523796,1023.5119047619025,24.963704994192746,2
3193,4,0,0,44,0.0,0.0,1.0,44,1100,600,500,0.5454545454545454,16,6,10,305.8674154673389,0.826946793516561,0.1379818867085858,0.17631828641473074,130714.91021050337,-803.7136501736206,129911.19656032974,3186,4,745.6363636363636,39,5,11,36.5294259957217,0.6220619658119659,44.34895833333333,1022.6041666666657,26.220619658119634,0
3194,4,1,2,43,0.022222222222222223,0.044444444444444446,0.9555555555555556,45,1400,1100,300,0.7857142857142857,17,11,6,300.5459963284612,0.8318181818181819,0.14122397643398554,0.17425438854484337,130937.79047070183,-1129.4342611871352,129808.35620951469,3187,0,730.0444444444445,40,5,11,36.44106013967496,0.6226562500000001,44.131097560975604,1023.4756097560966,25.586890243902413,0
3195,4,1,0,44,0.022727272727272728,0.0,1.0,44,1100,700,400,0.6363636363636364,15,7,8,310.9157302994397,0.8340600775193798,0.16142214862577187,0.1804706959038742,130981.34901258668,-655.1676432291736,130326.18136935751,3188,0,742.9090909090909,39,5,13,36.1318518706964,0.6247329059829061,44.088541666666664,1023.6458333333323,26.247329059829035,0
3196,4,2,0,46,0.043478260869565216,0.0,1.0,46,1150,800,350,0.6956521739130435,15,8,7,303.21183832482745,0.8418478260869565,0.1787812990056692,0.17832248673509082,131484.42147531235,-1226.014928838542,130258.40654647381,3189,0,711.5652173913044,40,6,15,35.82313548685427,0.628125,43.59756097560976,1025.6097560975613,25.640243902439032,0
3197,4,0,0,46,0.0,0.0,1.0,46,1600,1400,200,0.875,18,14,4,302.04823708248665,0.8408011272141708,0.18649658926479673,0.17812377345705532,131588.6707647565,-1250.7747950955036,130337.895969661,3190,1,712.5652173913044,40,6,12,35.7482748943476,0.6291666666666667,43.4959349593496,1026.0162601626023,25.650406504065057,0
3198,4,2,0,48,0.041666666666666664,0.0,1.0,48,1350,1000,350,0.7407407407407407,17,10,7,295.2846721830636,0.8471852836879432,0.20778152197819466,0.1764887373064857,132098.99612590892,-1798.6382466498412,130300.35787925907,3191,0,683.8333333333334,42,6,14,35.41018631979138,0.6312003968253969,42.99903100775194,1028.0038759689924,24.476282761166484,0
3199,4,0,0,48,0.0,0.0,1.0,48,1550,1000,550,0.6451612903225806,21,10,11,295.1272453347066,0.8472960992907801,0.2088278698819388,0.1772098889407945,132273.37599903866,-1792.5045820563566,130480.8714169823,3192,1,684.8333333333334,42,6,15,35.23965398141169,0.6329365079365079,42.82945736434109,1028.6821705426366,24.49243263196754,0
3200,4,1,1,48,0.02040816326530612,0.02040816326530612,0.9795918367346939,49,1400,1100,300,0.7857142857142857,17,11,6,289.3164069908918,0.8511196145124716,0.1960504292010259,0.17557146342050045,132672.39048134154,-2123.0814516855694,130549.30902965597,3193,0,671.8367346938776,42,7,11,34.99028091296714,0.6369047619047618,42.44186046511629,1030.232558139537,24.529346622369932,0
3201,4,0,0,48,0.0,0.0,1.0,48,1350,900,450,0.6666666666666666,18,9,9,297.82725262993625,0.8470375295508275,0.2012484349417314,0.18052191267114032,132627.8278238381,-1699.9636833900026,130927.8641404481,3194,3,686.8333333333334,41,7,11,34.81562409708177,0.6379573170731706,42.48511904761906,1030.0595238095257,25.12340301974453,0
3202,4,0,0,48,0.0,0.0,1.0,48,950,600,350,0.631578947368421,13,6,7,300.6279950913791,0.8457077423167848,0.2052642980935877,0.18259195070286932,132704.48022959195,-1621.0636337868364,131083.41659580512,3195,4,687.8333333333334,41,7,11,34.66685923358368,0.6387195121951219,42.41071428571429,1030.3571428571438,25.130662020905945,0
3203,4,0,0,48,0.0,0.0,1.0,48,850,400,450,0.47058823529411764,13,4,9,300.34590212163675,0.8452644799054373,0.206265443984468,0.18254493185122542,132730.03595245976,-1627.0155226442348,131103.02042981551,3196,5,688.8333333333334,41,7,11,34.648579153428976,0.6389735772357723,42.3859126984127,1030.4563492063498,25.133081687959752,0
3204,4,0,0,48,0.0,0.0,1.0,48,1250,1100,150,0.88,14,11,3,302.3731174382642,0.8449874408983451,0.21028852632592177,0.18402778658852534,132781.1547796202,-1570.10965844671,131211.0451211735,3197,6,689.8333333333334,41,7,12,34.54525218981614,0.6394817073170731,42.336309523809526,1030.6547619047622,25.13792102206737,0
3205,4,0,0,48,0.0,0.0,1.0,48,1150,800,350,0.6956521739130435,15,8,7,302.08115953079556,0.8440270390070922,0.2087322396484812,0.18435287674712614,132883.42195964043,-1571.6843624023627,131311.73759723807,3198,7,690.8333333333334,41,7,12,34.45057169889989,0.6404979674796747,42.23710317460318,1031.0515873015881,25.147599690282636,0
3206,4,1,2,47,0.02040816326530612,0.04081632653061224,0.9591836734693877,49,1100,700,400,0.6363636363636364,15,7,8,316.20499052514805,0.8441043083900227,0.2459365425559532,0.18924146387266497,132148.80720997852,-1442.777533651816,130706.02967632671,3199,0,677.7142857142857,42,7,14,34.82255049791096,0.6316964285714286,42.95058139534884,1028.1976744186059,24.480897009966807,3
3207,4,0,0,47,0.0,0.0,1.0,47,1300,900,400,0.6923076923076923,17,9,8,330.073010863169,0.8364168979340116,0.2586986576658661,0.1966628292774015,131979.97352972775,-687.3945526802779,131292.57897704747,3200,1,707.1702127659574,40,7,14,34.63575149177462,0.6330729166666667,43.114837398373986,1027.5406504065047,25.68851626016262,0
3208,4,1,0,48,0.020833333333333332,0.0,1.0,48,1450,700,750,0.4827586206896552,22,7,15,320.6224039193514,0.8389295212765957,0.25724314462982645,0.19250339931903612,132270.4093935028,-1118.228674571677,131152.18071893114,3201,0,693.4166666666666,41,7,15,34.586969974603804,0.634400406504065,42.83234126984127,1028.6706349206352,25.0895276809911,0
3209,4,0,1,47,0.0,0.020833333333333332,0.9791666666666666,48,1150,600,550,0.5217391304347826,17,6,11,319.48735736291405,0.8394651300236406,0.25756589521054307,0.19195155827655994,132295.923288297,-1146.6250157470215,131149.29827254996,3202,1,694.4166666666666,41,7,15,34.590565734490525,0.6346544715447153,42.80753968253969,1028.7698412698428,25.091947348044947,0
3210,4,1,2,46,0.020833333333333332,0.041666666666666664,0.9583333333333334,48,1500,1100,400,0.7333333333333333,19,11,8,313.08316683516114,0.8392065602836879,0.24932951114537172,0.18912555910449957,132500.1230237466,-1303.2490079365,131196.87401581008,3203,0,689.3125,41,7,15,34.55065202029936,0.6366869918699187,42.60912698412699,1029.5634920634925,25.111304684475428,0
3211,4,1,1,46,0.02127659574468085,0.02127659574468085,0.9787234042553191,47,1000,700,300,0.7,13,7,6,322.1620034708807,0.8337958680234351,0.2679049492809469,0.19489358693554829,132554.93511013614,-859.1673069931949,131695.76780314295,3204,0,704.6595744680851,40,7,17,34.26202342182309,0.6388020833333334,42.55589430894309,1029.7764227642274,25.744410569105685,0
3212,4,0,1,45,0.0,0.021739130434782608,0.9782608695652174,46,1700,1300,400,0.7647058823529411,21,13,8,314.8457333329876,0.8306360708534621,0.20295588663367647,0.18674784832711142,131809.033203125,-885.1842449207652,130923.84895820424,3205,1,720.0217391304348,39,7,16,35.19856968959221,0.6330128205128205,43.28125,1026.875,26.330128205128204,4
3213,4,0,0,45,0.0,0.0,1.0,45,1100,700,400,0.6363636363636364,15,7,8,323.51501137630714,0.8268939393939394,0.21113364886184427,0.19216012121508358,131862.5217013888,-468.09895833333695,131394.42274305545,3206,2,736.9333333333333,39,6,17,34.922244759972955,0.6335470085470085,43.229166666666664,1027.0833333333326,26.335470085470067,0
3214,4,0,0,45,0.0,0.0,1.0,45,850,600,250,0.7058823529411765,11,6,5,322.2729600344413,0.826388888888889,0.21242479551138982,0.19169215511819437,131916.02105034734,-497.4066840277751,131418.61436631955,3207,3,737.9333333333333,39,6,17,34.90037517744879,0.6340811965811965,43.177083333333336,1027.2916666666674,26.340811965811984,0
3215,4,0,0,45,0.0,0.0,1.0,45,1100,700,400,0.6363636363636364,15,7,8,324.92295134034333,0.8266414141414142,0.2179164977705712,0.19408835858513984,132076.58420138896,-417.0572916666621,131659.5269097223,3208,4,738.9333333333333,39,6,17,34.67099040670179,0.6356837606837606,43.020833333333336,1027.9166666666672,26.35683760683762,0
3216,4,0,0,45,0.0,0.0,1.0,45,1000,700,300,0.7,13,7,6,327.2634834318528,0.8258417508417509,0.218900366844462,0.19631832535881627,132237.24500868065,-344.7157118055497,131892.5292968751,3209,5,739.9333333333333,39,6,19,34.449480116129905,0.6372863247863249,42.864583333333336,1028.5416666666674,26.37286324786327,0
3217,4,0,1,44,0.0,0.022222222222222223,0.9777777777777777,45,1200,900,300,0.75,15,9,6,325.58544034621315,0.8253367003367004,0.2187362112680693,0.1956024577225351,132293.43401951555,-385.43680596866363,131907.99721354689,3210,6,740.9333333333333,40,5,19,34.43622608581118,0.6361979166666667,42.8099593495935,1028.7601626016265,25.71900406504066,0
3218,4,0,0,44,0.0,0.0,1.0,44,1050,700,350,0.6666666666666666,14,7,7,331.85854958624066,0.8259117336152221,0.22257259653451644,0.19907480672020322,132237.24500868074,-23.187934027757706,132214.05707465298,3211,7,751.3863636363636,39,5,19,34.33132469110797,0.6372863247863247,42.86458333333334,1028.5416666666683,26.37286324786329,0
3219,4,0,1,43,0.0,0.022727272727272728,0.9772727272727273,44,1000,800,200,0.8,12,8,4,331.81895287001777,0.8247004933051445,0.22080455847619684,0.1993473744749668,132293.43401951555,-20.506250413108887,132272.92776910245,3212,8,752.3863636363636,40,4,19,34.27590635187197,0.6361979166666667,42.8099593495935,1028.7601626016265,25.71900406504066,0
3220,4,0,0,43,0.0,0.0,1.0,43,1300,1000,300,0.7692307692307693,16,10,6,340.87980549744333,0.8255352528608342,0.2224985164881741,0.20477670067474155,132290.8203125,419.05381944444457,132709.87413194444,3213,9,699.4186046511628,39,4,19,34.04549750236264,0.6378205128205128,42.8125,1028.75,26.378205128205128,0
3221,4,0,0,43,0.0,0.0,1.0,43,1300,900,400,0.6923076923076923,17,9,8,339.6494596574559,0.8241509782207457,0.22283853239020934,0.20477546578292535,132426.97934420916,395.88060399928406,132822.85994820844,3214,10,700.4186046511628,36,7,19,33.940326404084615,0.6446759259259258,42.68018018018019,1029.27927927928,28.591091091091112,0
3222,4,0,1,42,0.0,0.023255813953488372,0.9767441860465116,43,900,600,300,0.6666666666666666,12,6,6,340.27749850339455,0.8232742709486895,0.2174390634614698,0.20610450339814892,132600.90115453306,424.22058883208877,133025.12174336513,3215,11,701.4186046511628,36,7,20,33.74949887018004,0.646412037037037,42.51126126126127,1029.954954954956,28.609859859859892,0
3223,4,1,0,43,0.023255813953488372,0.0,1.0,43,1150,700,450,0.6086956521739131,16,7,9,331.6838433284495,0.8226282761166481,0.20058681544220724,0.202919887420333,132975.889628534,221.1908284023823,133197.08045693638,3216,0,684.0232558139535,38,5,18,33.59488295007251,0.6463815789473684,42.147435897435905,1031.4102564102575,27.142375168690986,0
3224,4,0,0,43,0.0,0.0,1.0,43,1250,1000,250,0.8,15,10,5,358.2372881355932,0.8226282761166481,0.20326369728025195,0.2088537549407114,131150.23389274688,799.3544942563296,131949.5883870032,3217,1,685.0232558139535,35,8,20,34.74999999999999,0.6339285714285714,43.92361111111111,1024.3055555555552,29.265873015873005,5
3225,4,0,0,43,0.0,0.0,1.0,43,1200,700,500,0.5833333333333334,17,7,10,357.9544970390077,0.8212440014765596,0.20023008914641083,0.2093348161679903,131268.81456832986,797.6524991426538,132066.46706747252,3218,2,686.0232558139535,35,8,20,34.63735787967772,0.6351190476190476,43.80787037037037,1024.7685185185182,29.27910052910052,0
3226,4,0,0,43,0.0,0.0,1.0,43,1150,900,250,0.782608695652174,14,9,5,358.90999735970445,0.8206441491325212,0.20243261652233158,0.2103911792511511,131359.5300635573,829.2765094948033,132188.8065730521,3219,3,687.0232558139535,33,10,21,34.521194461048005,0.6404671717171717,43.71936274509804,1025.1225490196077,31.06431966726084,0
3227,4,0,0,43,0.0,0.0,1.0,43,1000,400,600,0.4,16,4,12,355.162887570943,0.8199520118124769,0.2018779596222482,0.20868847977736038,131450.17715419497,737.2448979591795,132187.42205215414,3220,4,688.0232558139535,34,9,21,34.52567525733302,0.639093137254902,43.63095238095238,1025.4761904761904,30.161064425770306,0
3228,4,0,0,43,0.0,0.0,1.0,43,750,400,350,0.5333333333333333,11,4,7,357.19239065494537,0.8192598744924326,0.20279739154844467,0.2102165053198776,131511.2244897959,794.9617346938735,132306.18622448976,3221,5,689.0232558139535,34,9,21,34.411995125348184,0.6397058823529411,43.57142857142857,1025.7142857142853,30.168067226890745,0
3229,4,0,0,43,0.0,0.0,1.0,43,900,600,300,0.6666666666666666,12,6,6,338.00770691796316,0.8193983019564415,0.17732061220433293,0.19973182681516014,131665.51246537408,300.79158971992416,131966.304055094,3222,6,690.0232558139535,37,6,15,34.748486467236475,0.6351351351351351,43.42105263157895,1026.315789473685,27.738264580369865,5
3230,4,0,0,43,0.0,0.0,1.0,43,1400,1200,200,0.8571428571428571,16,12,4,339.8903101843662,0.8184293097083795,0.1827444690787301,0.20188665412155718,131862.52170138885,363.7586805555515,132226.2803819444,3223,7,691.0232558139535,37,6,17,34.50177484787019,0.6371058558558559,43.229166666666664,1027.083333333333,27.759009009009002,0
3231,4,0,0,43,0.0,0.0,1.0,43,1800,1400,400,0.7777777777777778,22,14,8,335.27934060315545,0.8194444444444444,0.1403196805181648,0.19870605983594586,131778.07113727287,237.57802881654737,132015.64916608942,3224,8,692.0232558139535,37,6,14,34.7051651715791,0.6362612612612613,43.311403508771924,1026.7543859649113,27.750118539592197,3
3232,4,1,1,43,0.022727272727272728,0.022727272727272728,0.9772727272727273,44,850,700,150,0.8235294117647058,10,7,3,329.3910261926786,0.8261319591261452,0.1397157075058748,0.1963409349480833,131996.29041883693,-104.32128906248022,131891.96912977446,3225,0,677.2727272727273,39,5,14,34.636868558878206,0.6348824786324785,43.09895833333334,1027.6041666666679,26.34882478632482,0
3233,4,0,0,43,0.0,0.0,1.0,43,1200,900,300,0.75,15,9,6,336.2350588605692,0.8195828719084532,0.14118979182998026,0.19949946825727108,131821.37573964504,264.5936061801539,132085.9693458252,3226,10,694.0232558139535,38,5,14,34.63704223886808,0.6348684210526315,43.269230769230774,1026.9230769230774,27.02429149797572,0
3234,4,0,0,43,0.0,0.0,1.0,43,1350,1000,350,0.7407407407407407,17,10,7,335.9729960708183,0.8181985972683646,0.14969615337181508,0.20006515809368794,131958.55391418294,266.90214314413237,132225.45605732707,3227,11,695.0232558139535,38,5,15,34.505736369623236,0.6362390350877192,43.13568376068376,1027.4572649572651,27.038349077822765,0
3235,4,0,0,43,0.0,0.0,1.0,43,1000,900,100,0.9,11,9,2,337.3826878741728,0.817921742340347,0.1480482375037162,0.20148720298183861,132068.34781804745,311.51483399080956,132379.86265203825,3228,12,696.0232558139535,38,5,15,34.35908429477185,0.6373355263157894,43.02884615384616,1027.8846153846164,27.049595141700433,0
3236,4,0,0,43,0.0,0.0,1.0,43,1250,700,550,0.56,18,7,11,351.13962364139434,0.8175526024363233,0.17180954380807378,0.20630617144978472,131446.7860510974,662.592861462164,132109.37891255956,3229,13,697.0232558139535,35,8,20,34.63224228743417,0.6369047619047619,43.63425925925926,1025.462962962963,29.2989417989418,3
3237,4,1,0,44,0.022727272727272728,0.0,1.0,44,1100,700,400,0.6363636363636364,15,7,8,343.24107386342666,0.8195031712473573,0.17521608230567565,0.20364446015358426,131819.15181651257,249.14944505317902,132068.30126156576,3230,0,682.1590909090909,36,8,17,34.45941623716051,0.638599537037037,43.271396396396405,1026.9144144144154,28.52540040040043,0
3238,4,0,0,44,0.0,0.0,1.0,44,550,400,150,0.7272727272727273,7,4,3,345.65213848707566,0.8197454193093728,0.1789230830559485,0.20554359890998086,131905.89871966577,318.71119430242777,132224.6099139682,3231,1,683.1590909090909,36,8,17,34.31013849302054,0.6394675925925926,43.186936936936945,1027.2522522522536,28.534784784784822,0
3239,4,0,0,44,0.0,0.0,1.0,44,1150,500,650,0.43478260869565216,18,5,13,347.30948401104666,0.8183359760394644,0.1777190046420818,0.20715989222776574,132021.60564280517,370.4711468225239,132392.0767896277,3232,2,684.1590909090909,36,8,17,34.151051939513486,0.6406249999999998,43.07432432432434,1027.7027027027043,28.54729729729734,0
3240,4,0,0,44,0.0,0.0,1.0,44,1000,500,500,0.5,15,5,10,349.85103728773294,0.817543164200141,0.18381730548999697,0.20915455922722453,132108.419124361,443.6534930200719,132552.07261738108,3233,3,685.1590909090909,36,8,17,33.99833862781614,0.6414930555555554,42.98986486486488,1028.040540540542,28.556681681681724,0
3241,4,0,0,44,0.0,0.0,1.0,44,1350,1000,350,0.7407407407407407,17,10,7,350.08449850191556,0.8163759689922481,0.18219385978006697,0.21025784969197892,132282.1316882762,461.9847465709053,132744.1164348471,3234,4,686.1590909090909,36,8,19,33.8175059295749,0.6432291666666665,42.82094594594595,1028.7162162162167,28.575450450450465,0
3242,4,0,0,44,0.0,0.0,1.0,44,900,600,300,0.6666666666666666,12,6,6,350.85453731087154,0.8161997885835095,0.18177589620623413,0.21104397020470272,132340.06123944905,486.4221907718686,132826.48343022092,3235,5,687.1590909090909,36,8,20,33.7394203057167,0.6438078703703702,42.76463963963965,1028.9414414414425,28.581706706706736,0
3243,4,0,0,44,0.0,0.0,1.0,44,1300,900,400,0.6923076923076923,17,9,8,350.4743583561238,0.8136231501057083,0.185556350910681,0.2119535405296561,132542.914536158,490.57858534212255,133033.49312150013,3236,6,688.1590909090909,36,8,21,33.54522090988626,0.6458333333333333,42.56756756756758,1029.7297297297316,28.603603603603656,0
3244,4,0,0,44,0.0,0.0,1.0,44,1050,800,250,0.7619047619047619,13,8,5,354.4763661167848,0.8133809020436927,0.1852047864674955,0.21487046526641695,132629.89921932074,602.832942740047,133232.7321620608,3237,7,689.1590909090909,36,8,15,33.354742902955444,0.6467013888888888,42.48310810810811,1030.0675675675682,28.612987987988006,0
3245,4,0,0,44,0.0,0.0,1.0,44,900,600,300,0.6666666666666666,12,6,6,355.86249049612013,0.8131606765327696,0.18455260726597156,0.21637858143056457,132745.92318247305,647.8589653843072,133393.78214785736,3238,8,690.1590909090909,36,8,16,33.20242778567004,0.6478587962962963,42.3704954954955,1030.5180180180184,28.62550050050051,0
3246,4,0,0,44,0.0,0.0,1.0,44,1200,700,500,0.5833333333333334,17,7,10,358.7343526337032,0.8106721282593375,0.1798594905913311,0.21880166544713855,132861.99787202728,732.4325592484219,133594.4304312757,3239,9,691.1590909090909,36,8,16,33.01178772983797,0.6490162037037038,42.257882882882875,1030.9684684684673,28.63801301301298,0
3247,4,0,0,44,0.0,0.0,1.0,44,1150,900,250,0.782608695652174,14,9,5,357.2183501458782,0.8093948202959831,0.1833167923779273,0.21872460476846547,133007.16256797328,702.5198340232009,133709.68240199648,3240,10,692.1590909090909,36,8,17,32.9050673216885,0.650462962962963,42.11711711711711,1031.5315315315308,28.653653653653635,0
3248,4,0,0,44,0.0,0.0,1.0,44,850,700,150,0.8235294117647058,10,7,3,363.30235909579187,0.8093948202959831,0.19429400386847195,0.22331764729127618,133152.40652392237,874.916681884565,134027.32320580693,3241,11,693.1590909090909,36,8,17,32.60229132569559,0.6519097222222223,41.97635135135134,1032.094594594593,28.66929429429425,0
3249,4,0,1,43,0.0,0.022727272727272728,0.9772727272727273,44,600,400,200,0.6666666666666666,8,4,4,359.93443073900823,0.808557963354475,0.1911228021460376,0.22159294335691648,133210.52629910305,789.4109903822568,133999.9372894853,3242,12,694.1590909090909,36,8,17,32.63085887785898,0.652488425925926,41.920045045045036,1032.3198198198188,28.675550550550522,0
3250,4,0,0,43,0.0,0.0,1.0,43,1150,900,250,0.782608695652174,14,9,5,366.43124863876767,0.8052787006275378,0.21277128090719355,0.22627446585492872,133322.76562767895,1170.7254961848191,134493.49112386376,3243,13,710.4186046511628,35,8,17,32.35050338077627,0.6556547619047619,41.81134259259258,1032.754629629628,29.507275132275083,0
3251,4,0,0,43,0.0,0.0,1.0,43,1400,1200,200,0.8571428571428571,16,12,4,364.9666366020033,0.804032853451458,0.21153440448811933,0.22646192482413374,133502.12358807,1144.7642050325635,134646.88779310256,3244,14,711.4186046511628,35,8,18,32.20837066487476,0.6574404761904763,41.637731481481474,1033.449074074073,29.52711640211637,0
3252,4,0,1,42,0.0,0.023255813953488372,0.9767441860465116,43,700,400,300,0.5714285714285714,10,4,6,363.76946989713446,0.804125138427464,0.20739081746920474,0.22590134674418705,133532.02830289773,1114.9750300068474,134647.00333290457,3245,15,712.4186046511628,35,8,18,32.20931317655841,0.6577380952380952,41.60879629629629,1033.5648148148143,29.530423280423268,0
3253,4,0,0,42,0.0,0.0,1.0,42,1000,800,200,0.8,12,8,4,369.732049947971,0.8030632984901278,0.2181259600614438,0.2292338709677419,133472.22222222216,1469.791666666663,134942.01388888882,3246,16,728.6190476190476,34,8,18,32.11525537634409,0.6593137254901962,41.666666666666664,1033.333333333333,30.39215686274509,0
3254,4,1,1,42,0.023255813953488372,0.023255813953488372,0.9767441860465116,43,1550,1200,350,0.7741935483870968,19,12,7,361.2238986474786,0.8078165374677002,0.21067398914641933,0.22522927665144588,133681.6021117325,1057.7978984481958,134739.4000101807,3247,0,712.6511627906976,35,8,19,32.12518653236336,0.6592261904761906,41.46412037037036,1034.143518518517,29.54695767195763,0
3255,4,0,1,41,0.0,0.023809523809523808,0.9761904761904762,42,1200,1100,100,0.9166666666666666,13,11,2,371.1591892930094,0.8019986449864499,0.2218247114620171,0.23107652752758337,133626.03635204086,1519.3062641723423,135145.3426162132,3248,18,730.6190476190476,34,8,21,31.92405488389945,0.660845588235294,41.517857142857146,1033.9285714285718,30.40966386554623,0
3256,4,0,0,41,0.0,0.0,1.0,41,900,500,400,0.5555555555555556,13,5,8,376.3927137439151,0.8021341463414634,0.22618510680128123,0.23416290067431206,133598.8862456749,1857.1294694348535,135456.01571510974,3249,19,742.6829268292682,33,8,21,31.816026552868664,0.6628787878787878,41.54411764705883,1033.823529411766,31.327985739750485,0
3257,4,1,1,41,0.023809523809523808,0.023809523809523808,0.9761904761904762,42,900,500,400,0.5555555555555556,13,5,8,366.65015223523284,0.8067411924119241,0.21842149950973133,0.229797388131282,133872.32320011352,1416.8615362811959,135289.1847363947,3250,0,725.9761904761905,34,8,17,31.793780436366426,0.6632965686274509,41.27976190476191,1034.8809523809537,30.43767507002805,0
3258,4,0,1,40,0.0,0.024390243902439025,0.975609756097561,41,1150,900,250,0.782608695652174,14,9,5,374.98820534278235,0.7998475609756097,0.2306858798951692,0.23429129839366575,133757.3007527153,1831.4820321510956,135588.7827848664,3251,21,744.6829268292682,33,8,17,31.6933963195514,0.6644570707070707,41.39093137254902,1034.4362745098038,31.346553773024358,0
3259,4,0,0,40,0.0,0.0,1.0,40,900,800,100,0.8888888888888888,10,8,2,374.3137512070527,0.7973557692307692,0.21757636751124831,0.23487770748103778,133915.8091238947,2025.3057718185403,135941.11489571322,3252,22,740.4,33,7,18,31.551918067724372,0.6660353535353535,41.23774509803922,1035.0490196078435,31.36512180629829,0
3260,4,0,0,40,0.0,0.0,1.0,40,1150,1000,150,0.8695652173913043,13,10,3,375.271491549013,0.7972222222222223,0.2174952651515154,0.23588493754509382,133979.23875432528,2055.7177527873955,136034.95650711269,3253,23,741.4,33,7,19,31.463561395202035,0.6666666666666666,41.1764705882353,1035.294117647059,31.37254901960785,0
3261,4,0,0,40,0.0,0.0,1.0,40,600,300,300,0.5,9,3,6,372.9510871468086,0.7960202991452991,0.22002958579881637,0.2348313477191157,134042.68340301808,1998.2728998462162,136040.9563028643,3254,24,742.4,33,7,19,31.46005917159764,0.6672979797979798,41.115196078431374,1035.5392156862747,31.379976232917414,0
3262,4,0,0,40,0.0,0.0,1.0,40,1050,800,250,0.7619047619047619,13,8,5,371.56457590527083,0.7960202991452991,0.2157240889730243,0.2343629698172649,134106.14306997307,1965.818435217226,136071.9615051903,3255,25,743.4,33,7,19,31.432402587158858,0.6679292929292928,41.05392156862745,1035.7843137254902,31.387403446226976,0
3263,4,0,0,40,0.0,0.0,1.0,40,1050,800,250,0.7619047619047619,13,8,5,370.5457039231946,0.7957799145299145,0.22042874039030202,0.23432789279510916,134201.36072964725,1945.5475358035364,136146.9082654508,3256,26,744.4,33,7,19,31.36346836191603,0.6688762626262627,40.96200980392157,1036.1519607843136,31.398544266191323,0
3264,4,0,0,40,0.0,0.0,1.0,40,1150,800,350,0.6956521739130435,15,8,7,374.93427946671665,0.7948450854700855,0.229350910380705,0.23772069982979654,134296.6121804112,2070.480704536698,136367.0928849479,3257,27,745.4,33,7,19,31.15442973122094,0.6698232323232324,40.87009803921568,1036.5196078431359,31.409685086155633,0
3265,4,0,0,40,0.0,0.0,1.0,40,1050,700,350,0.6666666666666666,14,7,7,377.94835822818186,0.7932425213675214,0.2311923895060275,0.24046609077645664,134423.66667868115,2161.040825643974,136584.70750432514,3258,28,746.4,33,7,19,30.949145198140723,0.6710858585858586,40.74754901960784,1037.0098039215677,31.42453951277478,0
3266,4,0,0,40,0.0,0.0,1.0,40,900,600,300,0.6666666666666666,12,6,6,377.6708830525036,0.7916399572649573,0.22412965855835765,0.2407316112316171,134490.7474387002,2158.647869513024,136649.39530821322,3259,29,747.4,35,5,19,30.88921743658409,0.6672619047619048,40.68287037037037,1037.268518518518,29.636243386243372,0
3267,4,0,0,40,0.0,0.0,1.0,40,450,300,150,0.6666666666666666,6,3,3,377.7886425093788,0.791292735042735,0.22677395961173774,0.24100495393676571,134520.76266986007,2164.0832636745363,136684.8459335346,3260,30,748.4,35,5,19,30.856135408531383,0.6675595238095239,40.653935185185176,1037.3842592592578,29.639550264550223,0
3268,4,0,1,39,0.0,0.025,0.975,40,800,600,200,0.75,10,6,4,380.4266412003417,0.789556623931624,0.23358120868744137,0.24416473517040074,134741.56574394443,2251.8629551682766,136993.4286991127,3261,31,749.4,33,7,21,30.566867327667605,0.6742424242424243,40.441176470588225,1038.2352941176455,31.46167557932259,0
3269,4,0,0,39,0.0,0.0,1.0,39,1050,900,150,0.8571428571428571,12,9,3,380.65234506331467,0.7879554655870445,0.22033790592742508,0.24452367852323476,134773.37630058147,2460.3603481833825,137233.73664876484,3262,32,747.3589743589744,33,6,21,30.52920551555921,0.6745580808080809,40.41053921568627,1038.3578431372548,31.46538918597742,0
3270,4,0,0,39,0.0,0.0,1.0,39,1250,900,350,0.72,16,9,7,380.6339528495015,0.7873931623931624,0.2242282127682087,0.24530368335042463,134890.65334467113,2468.7925170067947,137359.44586167793,3263,33,748.3589743589744,34,5,18,30.41246466498586,0.6734068627450981,40.297619047619044,1038.8095238095232,30.553221288515388,0
3271,4,0,0,39,0.0,0.0,1.0,39,350,100,250,0.2857142857142857,6,1,5,392.05125475354873,0.7873931623931624,0.2354654755389205,0.2500977038010559,134519.90504535148,2747.739512471657,137267.64455782314,3264,34,749.3589743589744,34,5,20,30.48709930380231,0.6697303921568627,40.654761904761905,1037.3809523809525,30.51120448179272,1
3272,4,1,1,39,0.025,0.025,0.975,40,1150,800,350,0.6956521739130435,15,8,7,382.08084456649135,0.7887286324786325,0.22411154419351176,0.24560731077033912,134797.91843820855,2300.7440476190427,137098.6624858276,3265,0,731.6,34,6,17,30.46758569299552,0.6724877450980392,40.38690476190476,1038.4523809523805,30.54271708683472,0
3273,4,0,0,39,0.0,0.0,1.0,39,1350,1000,350,0.7407407407407407,17,10,7,390.8234920278605,0.7841880341880342,0.23777049299419728,0.2506181529877372,134709.7589418734,2729.547679978864,137439.30662185227,3266,36,751.3589743589744,33,6,20,30.328842521544093,0.6739267676767677,40.4718137254902,1038.11274509804,31.457961972667878,0
3274,4,0,0,39,0.0,0.0,1.0,39,1050,800,250,0.7619047619047619,13,8,5,389.3215451395737,0.7830634278002699,0.23883237245602595,0.250902496520526,134890.65334467127,2703.16751700681,137593.82086167808,3267,37,752.3589743589744,34,5,18,30.186845824738327,0.673406862745098,40.29761904761905,1038.8095238095243,30.55322128851542,0
3275,4,0,0,39,0.0,0.0,1.0,39,750,600,150,0.8,9,6,3,386.0763728975017,0.782276203328835,0.240432343525127,0.24966272114038443,135014.34948979592,2625.1700680272156,137639.51955782314,3268,38,753.3589743589744,34,5,18,30.14747995418099,0.6746323529411764,40.17857142857143,1039.2857142857144,30.567226890756306,0
3276,4,0,0,39,0.0,0.0,1.0,39,1000,600,400,0.6,14,6,8,386.712490035252,0.7818825910931174,0.2462830052984606,0.2511474795879501,135169.0493905897,2654.311933106591,137823.3613236963,3269,39,754.3589743589744,34,5,18,29.976388093875208,0.6761642156862744,40.02976190476191,1039.8809523809534,30.584733893557456,0
3277,4,0,0,39,0.0,0.0,1.0,39,950,700,250,0.7368421052631579,12,7,5,383.0012749787682,0.7814327485380117,0.24691444970685072,0.24937892256069133,135261.91184807254,2561.096938775508,137823.00878684805,3270,40,755.3589743589744,34,5,18,29.980163271534288,0.6770833333333333,39.94047619047619,1040.2380952380952,30.595238095238095,0
3278,4,0,1,38,0.0,0.02564102564102564,0.9743589743589743,39,550,300,250,0.5454545454545454,8,3,5,380.89097698300105,0.7809266756635178,0.2427432581912501,0.24821821385939197,135292.87308673467,2506.3669217687047,137799.24000850337,3271,41,756.3589743589744,34,5,18,30.00414807186177,0.677389705882353,39.910714285714285,1040.3571428571427,30.598739495798313,0
3279,4,0,0,38,0.0,0.0,1.0,38,1200,900,300,0.75,15,9,6,381.7755261590522,0.7786569464201043,0.22759349466217915,0.2492232915725374,135354.80619331062,2735.0304705215394,138089.83666383216,3272,42,736.2368421052631,34,4,19,29.91934561263014,0.6780024509803921,39.851190476190474,1040.5952380952378,30.60574229691876,0
3280,4,0,0,38,0.0,0.0,1.0,38,950,600,350,0.631578947368421,13,6,7,380.8661716684631,0.779427453769559,0.2278444825614634,0.2494887394187796,135478.71492346935,2719.851899092964,138198.5668225623,3273,43,737.2368421052631,34,4,19,29.819420621307412,0.6792279411764706,39.732142857142854,1041.0714285714282,30.619747899159652,0
3281,4,0,0,38,0.0,0.0,1.0,38,750,600,150,0.8,9,6,3,381.3146735241845,0.7795459933617829,0.2271301865156441,0.2500223617364115,135513.14407578882,2734.6300582990434,138247.77413408787,3274,44,738.2368421052631,35,3,19,29.773417815325324,0.6773809523809524,39.699074074074076,1041.2037037037042,29.74867724867726,0
3282,4,0,0,38,0.0,0.0,1.0,38,1450,1200,250,0.8275862068965517,17,12,5,383.0715932646659,0.7789236605026079,0.23039693132763395,0.25289658577970486,135757.71683673467,2801.0385610005333,138558.75539773522,3275,45,739.2368421052631,34,4,19,29.48390259690809,0.6819852941176471,39.464285714285715,1042.142857142857,30.65126050420168,0
3283,4,0,0,38,0.0,0.0,1.0,38,700,600,100,0.8571428571428571,8,6,2,381.7527147344347,0.7787458511142722,0.23117381164194173,0.2524642575690867,135819.75623582755,2769.9121315192597,138589.6683673468,3276,46,740.2368421052631,34,4,19,29.45646794578955,0.6825980392156863,39.4047619047619,1042.3809523809516,30.658263305322105,0
3284,4,0,0,38,0.0,0.0,1.0,38,1000,700,300,0.7,13,7,6,382.95277847556736,0.7793385490753912,0.23174000312496257,0.2536989738191388,135881.80980725607,2807.263321995448,138689.0731292515,3277,47,741.2368421052631,34,4,17,29.363391565806506,0.6832107843137256,39.34523809523809,1042.6190476190463,30.66526610644254,0
3285,4,0,0,38,0.0,0.0,1.0,38,600,500,100,0.8333333333333334,7,5,2,383.5383072653432,0.7786569464201043,0.234757031864969,0.25430825384838274,135912.84190759616,2825.5562641723036,138738.39817176847,3278,48,742.2368421052631,34,4,17,29.31722609125851,0.6835171568627452,39.315476190476176,1042.7380952380934,30.668767507002745,0
3286,4,0,0,38,0.0,0.0,1.0,38,950,700,250,0.7368421052631579,12,7,5,386.83258062598463,0.7764046941678521,0.24380398611227916,0.2571644212021908,136005.95946712003,2922.3072562358084,138928.26672335583,3279,49,743.2368421052631,34,4,17,29.138609906414057,0.684436274509804,39.22619047619047,1043.095238095237,30.67927170868344,0
3287,4,0,0,38,0.0,0.0,1.0,38,650,400,250,0.6153846153846154,9,4,5,387.6981961063275,0.7760194404931247,0.24324462302624084,0.25796501841152175,136037.00573979563,2948.260345804954,138985.26608560057,3280,50,744.2368421052631,34,4,17,29.085121153334082,0.6847426470588236,39.196428571428555,1043.2142857142835,30.682773109243634,0
3288,4,0,0,38,0.0,0.0,1.0,38,1200,1000,200,0.8333333333333334,14,10,4,383.5831993674364,0.7756934566145093,0.22681560881609042,0.2501878479456266,135323.83786848083,2783.3049886621434,138107.14285714296,3281,51,745.2368421052631,34,4,17,29.90322273073989,0.6776960784313726,39.88095238095239,1040.4761904761913,30.602240896358566,2
3289,4,0,1,37,0.0,0.02631578947368421,0.9736842105263158,38,1500,1200,300,0.8,18,12,6,382.4680018084337,0.7730263157894737,0.2249857061177818,0.25053802815091764,135478.71492346932,2763.2546768707407,138241.96960034006,3282,52,746.2368421052631,34,4,17,29.777730131503727,0.6792279411764706,39.732142857142854,1041.071428571428,30.61974789915965,0
3290,4,1,0,38,0.02631578947368421,0.0,1.0,38,900,600,300,0.6666666666666666,12,6,6,377.27885242066463,0.7747747747747747,0.22652136279483526,0.24950556131384732,135819.75623582755,2648.3843537414823,138468.14058956903,3283,0,741.8157894736842,34,4,19,29.57305466727578,0.6825980392156863,39.4047619047619,1042.3809523809516,30.658263305322105,0
3291,4,0,0,38,0.0,0.0,1.0,38,850,700,150,0.8235294117647058,10,7,3,380.3974532063886,0.7749525841631105,0.23205850891215296,0.252006119151403,135881.80980725607,2737.8188775510043,138619.62868480707,3284,1,742.8157894736842,34,4,16,29.429997335769205,0.6832107843137256,39.34523809523809,1042.6190476190463,30.66526610644254,0
3292,4,0,0,38,0.0,0.0,1.0,38,650,500,150,0.7692307692307693,8,5,3,397.2051805440317,0.7750414888572783,0.2387141875399894,0.2377877913715076,132159.8776148832,2901.50051790261,135061.37813278582,3285,2,743.8157894736842,35,3,18,32.72925108809845,0.6440476190476192,42.9398148148148,1028.240740740739,29.37830687830683,8
3293,4,0,0,38,0.0,0.0,1.0,38,800,600,200,0.75,10,6,4,399.8748951950916,0.7753378378378378,0.23861899854294788,0.239763044446935,132219.3889853392,2974.2428626542883,135193.6318479935,3286,3,744.8157894736842,35,3,18,32.600438892640106,0.6446428571428573,42.88194444444443,1028.47222222222,29.38492063492057,0
3294,4,0,0,38,0.0,0.0,1.0,38,700,500,200,0.7142857142857143,9,5,4,401.8484656746505,0.7742709815078236,0.23788431474726446,0.24132629479164133,132278.9137517146,3031.2157064471776,135310.12945816177,3287,4,745.8157894736842,35,3,18,32.48949894989499,0.6452380952380953,42.82407407407407,1028.703703703703,29.39153439153437,0
3295,4,0,0,38,0.0,0.0,1.0,38,950,600,350,0.631578947368421,13,6,7,399.1214410988544,0.7745080606922712,0.23513743873854676,0.2404463315888219,132398.00347222216,2968.683556241417,135366.68702846358,3288,5,746.8157894736842,33,5,18,32.43927125506073,0.6508838383838385,42.70833333333333,1029.166666666666,31.186868686868667,0
3296,4,0,0,38,0.0,0.0,1.0,38,900,700,200,0.7777777777777778,11,7,4,397.78759118118285,0.7740931721194879,0.23620919783683525,0.23984335809983867,132429.53619100817,2935.765240532477,135365.30143154063,3289,6,747.8157894736842,33,5,18,32.44173413501607,0.651199494949495,42.67769607843137,1029.2892156862738,31.19058229352345,0
3297,4,1,1,38,0.02564102564102564,0.02564102564102564,0.9743589743589743,39,1000,600,400,0.6,14,6,8,393.50807309583377,0.7744601889338731,0.23315244582996608,0.24018135455130488,132888.53635204077,2658.542375283441,135547.0787273242,3290,0,729.6153846153846,34,5,18,32.08876958011007,0.6534926470588236,42.232142857142854,1031.0714285714282,30.32563025210083,0
3298,4,0,0,38,0.0,0.0,1.0,38,750,500,250,0.6666666666666666,10,5,5,402.24882929217483,0.770388809862494,0.2437207002522359,0.2445777588950034,132745.06987997398,3079.3097907054917,135824.37967067948,3291,8,749.8157894736842,33,5,18,32.008240179173114,0.6543560606060606,42.37132352941176,1030.5147058823525,31.227718360071286,0
3299,4,0,0,38,0.0,0.0,1.0,38,600,400,200,0.6666666666666666,8,4,4,402.80183032232753,0.769825746799431,0.24224791651024824,0.24553398526604517,132839.8032006922,3101.623173779335,135941.42637447154,3292,9,750.8157894736842,33,5,18,31.898379299413545,0.6553030303030303,42.27941176470589,1030.8823529411777,31.23885918003569,0
3300,4,0,0,38,0.0,0.0,1.0,38,900,500,400,0.5555555555555556,13,5,8,405.0800139602298,0.7704777145566619,0.24630002627200276,0.24733985758065122,132902.97752066512,3167.26799788543,136070.24551855057,3293,10,751.8157894736842,33,5,18,31.775909198954125,0.6559343434343434,42.21813725490196,1031.1274509803923,31.24628639334522,0
3301,4,0,0,38,0.0,0.0,1.0,38,800,400,400,0.5,12,4,8,400.3360952011766,0.7696183025130393,0.23358583491146812,0.24589571536754998,133124.2059093859,3058.8849541041973,136183.0908634901,3294,11,752.8157894736842,33,5,19,31.675152396785798,0.6581439393939392,42.00367647058824,1031.9852941176478,31.27228163992872,0
3302,4,0,0,38,0.0,0.0,1.0,38,1550,1200,350,0.7741935483870968,19,12,7,397.59204477253047,0.7682550972024657,0.23204252272368753,0.2452854478205498,133287.7621882087,2998.830782312938,136286.59297052163,3295,12,753.8157894736842,34,4,20,31.581210129890106,0.6574754901960783,41.8452380952381,1032.6190476190482,30.371148459383768,0
3303,4,1,0,39,0.02564102564102564,0.0,1.0,39,700,500,200,0.7142857142857143,9,5,4,390.36228712054105,0.7742352676563203,0.2290671238039661,0.24285370605817755,133598.88624567486,2630.6484603645576,136229.5347060394,3296,0,735.4615384615385,33,6,21,31.454974711553668,0.6628787878787878,41.54411764705883,1033.8235294117658,31.327985739750478,0
3304,4,0,0,39,0.0,0.0,1.0,39,1100,800,300,0.7272727272727273,14,8,6,394.3434857103289,0.7746288798920378,0.2310457248246085,0.24596191248407023,133693.92368620267,2744.2655769415915,136438.18926314428,3297,1,736.4615384615385,33,6,21,31.256542046846004,0.6638257575757575,41.452205882352956,1034.19117647059,31.339126559714853,0
3305,4,1,2,38,0.025,0.05,0.95,40,800,500,300,0.625,11,5,6,381.087170099942,0.7805822649572649,0.21283542039356007,0.2393569978492896,133951.045953361,2209.405006858737,136160.45096021972,3298,0,719.025,35,5,17,31.341308884913552,0.6619047619047618,41.20370370370372,1035.1851851851868,29.576719576719622,0
3306,4,0,0,38,0.0,0.0,1.0,38,550,300,250,0.5454545454545454,8,3,5,397.4379040020092,0.7684329065908013,0.22944985433834675,0.24746742406383432,133630.56163795188,3021.970065599787,136652.53170355165,3299,16,757.8157894736842,33,5,20,31.24024633558533,0.6631944444444444,41.51348039215687,1033.9460784313735,31.33169934640526,0
3307,4,0,0,38,0.0,0.0,1.0,38,1050,700,350,0.6666666666666666,14,7,7,396.19056175737296,0.768640350877193,0.23328760289349004,0.24732606074202876,133725.61034217617,2996.164936562876,136721.77527873905,3300,17,758.8157894736842,33,5,17,31.176935229067933,0.664141414141414,41.42156862745099,1034.3137254901967,31.342840166369598,0
3308,4,0,0,38,0.0,0.0,1.0,38,600,400,200,0.6666666666666666,8,4,4,395.31081856766866,0.7681365576102418,0.2358445865908556,0.24720103187764889,133788.99491782015,2977.6474192618352,136766.64233708198,3301,18,759.8157894736842,33,5,17,31.135986733001662,0.6647727272727272,41.360294117647065,1034.5588235294124,31.350267379679163,0
3309,4,0,0,38,0.0,0.0,1.0,38,1000,700,300,0.7,13,7,6,396.5125226056107,0.7662102892366051,0.23988968869776617,0.24859304034182503,133884.09994052773,3017.3444408400705,136901.4443813678,3302,19,760.8157894736842,33,5,17,31.009349713834624,0.6657196969696969,41.26838235294118,1034.9264705882356,31.361408199643503,0
3310,4,0,0,38,0.0,0.0,1.0,38,850,600,250,0.7058823529411765,11,6,5,373.1802721088437,0.7668918918918919,0.2004260651629075,0.2251949917898193,132461.07266435964,2367.5455353709863,134828.61819973064,3303,20,761.8157894736842,33,5,18,33.04315476190476,0.6515151515151516,42.6470588235294,1029.4117647058806,31.1942959001782,8
3311,4,0,0,38,0.0,0.0,1.0,38,1050,800,250,0.7619047619047619,13,8,5,372.15806504185747,0.767425320056899,0.1945289705348312,0.2257114498370741,132650.37035034568,2273.3810313340564,134923.75138167973,3304,21,762.8157894736842,33,5,16,32.8787968911095,0.6534090909090912,42.463235294117624,1030.1470588235265,31.216577540106865,0
3312,4,0,0,38,0.0,0.0,1.0,38,600,300,300,0.5,9,3,6,375.9654225124107,0.7672771455666193,0.19244633581575843,0.22878937795436824,132776.64389898095,2383.8854046520337,135160.529303633,3305,22,763.8157894736842,33,5,16,32.65358699960365,0.6546717171717172,42.34068627450979,1030.637254901959,31.23143196672603,0
3313,4,0,0,38,0.0,0.0,1.0,38,1000,600,400,0.6,14,6,8,373.4022477958877,0.7664177335229967,0.18122052218733176,0.2279975698805949,132902.97752066507,2325.254108996528,135228.2316296616,3306,23,764.8157894736842,33,5,16,32.5925045558989,0.6559343434343434,42.218137254901954,1031.1274509803916,31.2462863933452,0
3314,4,0,0,38,0.0,0.0,1.0,38,950,700,250,0.7368421052631579,12,7,5,366.97096082209225,0.7673660502607871,0.05985985055374066,0.20801144950729158,130061.48674011881,1945.757750994268,132007.2444911131,3307,24,765.8157894736842,36,2,17,35.63056598218885,0.620949074074074,44.98873873873875,1020.0450450450476,28.334584584584654,8
3315,4,0,0,38,0.0,0.0,1.0,38,700,400,300,0.5714285714285714,10,4,6,367.57683781808305,0.7672771455666193,0.062342770492850974,0.20850836404471007,130090.20580969503,1963.6292965262805,132053.83510622132,3308,25,766.8157894736842,36,2,17,35.585927438642976,0.6212384259259258,44.9605855855856,1020.1576576576593,28.337712712712758,0
3316,4,1,0,39,0.02564102564102564,0.0,1.0,39,1150,700,450,0.6086956521739131,16,7,9,359.0790635726008,0.7746288798920378,0.06487824434799316,0.20552735506431738,130439.87509645053,1567.8739092414382,132007.74900569196,3309,0,748.1282051282051,35,4,19,35.447824609109446,0.6267857142857143,44.61805555555555,1021.527777777777,29.186507936507915,0
3317,4,0,1,38,0.0,0.02564102564102564,0.9743589743589743,39,1150,700,450,0.6086956521739131,16,7,9,364.99818155437623,0.7756972559604138,0.022334114362630553,0.20042426837665592,128811.51532202233,1603.1937711603775,130414.70909318271,3310,1,749.1282051282051,37,2,19,36.95407575430259,0.6064189189189189,46.217105263157904,1015.1315789473698,27.435988620199183,7
3318,4,1,0,39,0.02564102564102564,0.0,1.0,39,1100,700,400,0.6363636363636364,15,7,8,358.9054573828873,0.7807579847053532,0.04317032413709154,0.19846872189884246,129089.93632656203,1466.2165281625087,130556.15285472454,3311,0,750.0769230769231,37,2,20,36.824737447849216,0.6092342342342343,45.94298245614035,1016.2280701754387,27.4656235182551,0
3319,4,0,0,39,0.0,0.0,1.0,39,1150,1000,150,0.8695652173913043,13,10,3,356.5668950385418,0.7804768331084121,0.044282258621880954,0.1981520641990701,129285.00987082579,1419.7509089335292,130704.76077975932,3312,1,751.0769230769231,37,2,22,36.68542228212039,0.611204954954955,45.751096491228076,1016.9956140350889,27.486367946894294,0
3320,4,1,0,40,0.025,0.0,1.0,40,1100,700,400,0.6363636363636364,15,7,8,350.6314075284435,0.7911324786324786,0.045540398740818944,0.19632886684759496,129581.83235627145,1087.092053838851,130668.9244101103,3313,0,733.275,38,2,19,36.53440888422527,0.612390350877193,45.45940170940171,1018.1623931623931,26.79374718848403,0
3321,4,0,0,40,0.0,0.0,1.0,40,750,500,250,0.6666666666666666,10,5,5,351.3876618353285,0.7911324786324786,0.03976080570709195,0.19702512897731478,129636.22708013731,1110.514144568625,130746.74122470594,3314,1,734.275,38,2,19,36.45986326758987,0.6129385964912281,45.4059829059829,1018.3760683760681,26.799370220422844,0
3322,4,1,2,39,0.024390243902439025,0.04878048780487805,0.9512195121951219,41,800,700,100,0.875,9,7,2,360.96403745836693,0.7966463414634146,0.08560533690397132,0.19264652769274876,127673.13169677217,1078.3193997137778,128751.45109648594,3315,0,717.3414634146342,37,4,19,38.22092781454559,0.594876126126126,47.34100877192983,1010.6359649122813,27.314485538169766,7
3323,4,1,0,40,0.025,0.0,1.0,40,650,300,350,0.46153846153846156,10,3,7,366.2014654624585,0.7835202991452992,0.13145251085625187,0.19634957381005003,127859.63909433073,1364.4774419689868,129224.11653629973,3316,0,736.1,36,4,20,37.897366662955136,0.5986689814814815,47.15653153153153,1011.3738738738732,28.0937187187187,0
3324,4,2,2,40,0.047619047619047616,0.047619047619047616,0.9523809523809523,42,1300,1000,300,0.7692307692307693,16,10,6,352.8192592592593,0.8041037553232675,0.13858201058201058,0.19174959742351053,128401.20525931346,661.1177055433945,129062.32296485685,3317,0,702.0,36,6,15,37.68194444444446,0.6041666666666665,46.62162162162163,1013.5135135135142,28.153153153153173,0
3325,4,2,2,40,0.047619047619047616,0.047619047619047616,0.9523809523809523,42,950,800,150,0.8421052631578947,11,8,3,351.2771192663715,0.799675764614789,0.13131080673575957,0.19104805743302772,128429.74044568211,622.885850377399,129052.6262960595,3318,0,702.952380952381,36,6,16,37.69187682850053,0.6044560185185186,46.593468468468465,1013.6261261261257,28.156281281281267,0
3326,4,1,2,39,0.024390243902439025,0.04878048780487805,0.9512195121951219,41,1050,700,350,0.6666666666666666,14,7,7,355.5392344479408,0.7903963414634146,0.12931328913200235,0.19295187162621064,128344.1443977762,926.2757690122642,129270.42016678846,3319,0,721.0731707317074,36,5,21,37.67133437060088,0.6035879629629629,46.67792792792793,1013.2882882882886,28.146896896896905,0
3327,4,3,1,41,0.07142857142857142,0.023809523809523808,0.9761904761904762,42,900,700,200,0.7777777777777778,11,7,4,344.04620754312805,0.80381339527681,0.169681354506257,0.1898743695605111,129011.37689248672,477.1749899554437,129488.55188244216,3320,0,702.3809523809524,38,4,18,37.28222385809936,0.6066337719298245,46.02029914529915,1015.9188034188038,26.734705353126415,0
3328,4,1,0,42,0.023809523809523808,0.0,1.0,42,1250,900,350,0.72,16,9,7,343.62071512594264,0.8059185056136275,0.1716267755788463,0.1902914716943084,129147.08547921688,475.5227737599513,129622.60825297683,3321,0,703.3571428571429,38,4,20,37.154894541377615,0.6080043859649124,45.886752136752136,1016.4529914529915,26.74876293297346,0
3329,4,0,1,41,0.0,0.023809523809523808,0.9761904761904762,42,1050,800,250,0.7619047619047619,13,8,5,326.0252358880612,0.8059185056136275,0.1391774891774895,0.17405184715017247,127685.2080137335,-69.4831388341141,127615.72487489939,3322,1,704.3571428571429,38,4,15,39.09134954193095,0.593201754385965,47.32905982905982,1010.6837606837594,26.596941070625245,8
3330,4,3,1,43,0.06818181818181818,0.022727272727272728,0.9772727272727273,44,1150,800,350,0.6956521739130435,15,8,7,309.7527442111983,0.8186002466525722,0.15074488069758973,0.16804043184285133,128329.1680230034,-849.1129271934924,127480.0550958099,3323,0,673.2272727272727,39,5,18,38.8464454610877,0.5980235042735043,46.69270833333333,1013.229166666666,25.980235042735025,0
3331,4,3,3,43,0.06521739130434782,0.06521739130434782,0.9347826086956522,46,1050,800,250,0.7619047619047619,13,8,5,297.8009047074751,0.8284822866344606,0.16073955106879256,0.16357469983207684,128823.44148596929,-1527.2525155895787,127296.1889703797,3324,0,644.8913043478261,41,5,14,38.64732971758037,0.5998475609756098,46.20535714285714,1015.1785714285706,24.760452961672456,0
3332,4,0,0,43,0.0,0.0,1.0,43,1150,800,350,0.6956521739130435,15,8,7,318.8713076995122,0.8133074935400516,0.16516554051570087,0.17359551570629198,128469.25593770537,-406.9680719921189,128062.28786571325,3325,1,690.8372093023256,38,5,14,38.472836969122135,0.6011513157894737,46.554487179487175,1013.7820512820506,26.678475033738174,0
3333,4,0,0,43,0.0,0.0,1.0,43,950,800,150,0.8421052631578947,11,8,3,319.3632714792018,0.8134920634920635,0.16920803796987616,0.17409975931126384,128523.41666894949,-390.8682381839467,128132.54843076554,3326,2,691.8372093023256,38,5,14,38.405243564078255,0.6016995614035088,46.501068376068375,1013.9957264957262,26.684098065677006,0
3334,4,0,0,43,0.0,0.0,1.0,43,1100,800,300,0.7272727272727273,14,8,6,319.5645500625175,0.8143687707641196,0.16315074029170828,0.17468424886837086,128631.77237426027,-378.7691074950771,128253.0032667652,3327,3,692.8372093023256,38,5,14,38.289889415481845,0.602796052631579,46.39423076923077,1014.4230769230762,26.695344129554638,0
3335,4,1,1,43,0.022727272727272728,0.022727272727272728,0.9772727272727273,44,1550,1300,250,0.8387096774193549,18,13,5,312.1052321984682,0.8216834038054969,0.1578882352392761,0.17203720289244018,128963.21750217032,-749.9810112847038,128213.23649088561,3328,0,678.0681818181819,39,5,17,38.142348648001914,0.6044337606837606,46.06770833333334,1015.7291666666681,26.044337606837644,0
3336,4,1,1,43,0.022727272727272728,0.022727272727272728,0.9772727272727273,44,1050,700,350,0.6666666666666666,14,7,7,313.38217330083864,0.8200757575757576,0.15374491994654016,0.17321770872499076,129072.2714344139,-710.2102130015345,128362.06122141235,3329,0,678.8863636363636,40,4,18,37.999216588325496,0.6039062500000001,45.96036585365853,1016.1585365853647,25.403963414634116,0
3337,4,3,2,44,0.06521739130434782,0.043478260869565216,0.9565217391304348,46,550,300,250,0.5454545454545454,8,3,5,300.65603194875695,0.8333333333333334,0.1585793627594272,0.16833785356738065,129579.88989866755,-1408.1403474970953,128171.74955117045,3330,0,650.304347826087,41,5,15,37.808450258209106,0.6074695121951221,45.46130952380951,1018.1547619047599,24.833042973286826,0
3338,4,1,0,45,0.022222222222222223,0.0,1.0,45,1250,900,350,0.72,16,9,7,306.5912087999649,0.823442760942761,0.16981148813484137,0.17181453647514813,129614.99851279006,-1052.2361854716055,128562.76232731846,3331,0,665.7333333333333,40,5,16,37.62183965402527,0.609375,45.426829268292686,1018.2926829268297,25.457317073170742,0
3339,4,1,1,45,0.021739130434782608,0.021739130434782608,0.9782608695652174,46,1000,800,200,0.8,12,8,4,303.7220114360014,0.8294082125603865,0.17385802913221204,0.17126454146506453,129857.80915375396,-1311.8650006298974,128545.94415312406,3332,0,652.2391304347826,41,5,16,37.44930569074036,0.6102642276422765,45.188492063492056,1019.2460317460307,24.859659310878797,0
3340,4,1,1,45,0.021739130434782608,0.021739130434782608,0.9782608695652174,46,1250,800,450,0.64,17,8,9,302.13946101384244,0.827194041867955,0.1759723620002871,0.1712567771854646,130060.11924445699,-1340.741134416739,128719.37811004026,3333,0,653.2173913043479,41,5,17,37.285223367697576,0.6122967479674797,44.99007936507936,1020.0396825396822,24.87901664730932,0
3341,4,1,1,45,0.021739130434782608,0.021739130434782608,0.9782608695652174,46,850,800,50,0.9411764705882353,9,8,1,304.1807729705997,0.8276368760064412,0.1789785334804168,0.17297443955492292,130186.64301658148,-1279.945259353753,128906.69775722772,3334,0,654.0869565217391,41,5,17,37.10538786818316,0.6135670731707317,44.86607142857142,1020.5357142857131,24.89111498257837,0
3342,4,2,1,46,0.0425531914893617,0.02127659574468085,0.9787234042553191,47,1250,1000,250,0.8,15,10,5,295.83075687386565,0.8275901942645698,0.17484269196536428,0.16999131556449712,130591.93244716851,-1673.3558122323172,128918.5766349362,3335,0,641.1276595744681,41,6,14,36.90986039664823,0.6176321138211383,44.469246031746025,1022.1230158730145,24.929829655439377,0
3343,4,0,0,46,0.0,0.0,1.0,46,1100,800,300,0.7272727272727273,14,8,6,299.85433782170617,0.8232890499194847,0.16720703149735971,0.17185307875491096,130490.55103812352,-1374.3684452947878,129116.18259282873,3336,1,656.0652173913044,41,5,14,36.909226623944065,0.6166158536585367,44.56845238095238,1021.72619047619,24.920150987224147,0
3344,4,0,1,45,0.0,0.021739130434782608,0.9782608695652174,46,1000,700,300,0.7,13,7,6,300.53757088846936,0.8235305958132045,0.17550803402646564,0.17280910326086957,130617.28395061703,-1348.919753086438,129268.3641975306,3337,2,657.0652173913044,41,5,14,36.76403985507249,0.6178861788617886,44.444444444444436,1022.2222222222201,24.932249322493174,0
3345,4,0,0,45,0.0,0.0,1.0,45,1050,700,350,0.6666666666666666,14,7,7,307.84794423440496,0.8192340067340068,0.1807367149758461,0.1770125679347826,130617.28395061706,-957.9475308642154,129659.33641975284,3338,3,672.2888888888889,41,4,15,36.57721920289857,0.6178861788617886,44.444444444444436,1022.2222222222204,24.932249322493178,0
3346,4,1,1,45,0.021739130434782608,0.021739130434782608,0.9782608695652174,46,1200,800,400,0.6666666666666666,16,8,8,306.7841894862729,0.8228059581320452,0.19648774022531468,0.17795504632309178,130955.9326832072,-1164.9580666726702,129790.97461653453,3339,0,658.6521739130435,42,4,16,36.2631749187415,0.6197916666666666,44.11337209302326,1023.5465116279074,24.3701550387597,0
3347,4,0,0,45,0.0,0.0,1.0,45,1000,500,500,0.5,15,5,10,313.3647170585951,0.8169191919191919,0.20105532941353887,0.181850233442665,130972.46334876539,-791.5702160493847,130180.89313271601,3340,1,674.1555555555556,41,4,16,36.078132066938025,0.6214430894308942,44.09722222222222,1023.6111111111109,24.966124661246607,0
3348,4,1,1,45,0.021739130434782608,0.021739130434782608,0.9782608695652174,46,900,600,300,0.6666666666666666,12,6,6,311.68304746575495,0.8209943639291466,0.2081591119333952,0.18220277650361266,131253.64428407222,-1018.0928317108553,130235.55145236137,3341,0,660.4782608695652,42,4,17,35.83806146572106,0.6227678571428572,43.82267441860464,1024.7093023255795,24.397840531561418,0
3349,4,0,0,45,0.0,0.0,1.0,45,1100,600,500,0.5454545454545454,16,6,10,319.5276181266989,0.8148569023569024,0.2058493124152625,0.18640916298171145,131175.63952664402,-617.1520691609942,130558.48745748303,3342,1,675.9111111111112,41,4,17,35.7156691845826,0.6234756097560975,43.898809523809526,1024.4047619047622,24.985481997677127,0
3350,4,0,0,45,0.0,0.0,1.0,45,1150,900,250,0.782608695652174,14,9,5,323.0647508754033,0.8148569023569024,0.20834543518249604,0.18884752754906875,131251.87119118503,-519.429386337845,130732.44180484719,3343,2,676.9111111111112,41,4,18,35.54827427630943,0.6242378048780487,43.82440476190477,1024.7023809523826,24.9927409988386,0
3351,4,0,1,44,0.0,0.022222222222222223,0.9777777777777777,45,900,800,100,0.8888888888888888,10,8,2,322.7357976296743,0.8149410774410775,0.20832230933866724,0.18890558217066097,131302.70460325343,-524.7833797870977,130777.92122346633,3344,3,677.9111111111112,41,4,18,35.505497209047206,0.6247459349593496,43.77480158730159,1024.9007936507942,24.9975803329462,0
3352,4,1,1,44,0.022222222222222223,0.022222222222222223,0.9777777777777777,45,1600,1100,500,0.6875,21,11,10,324.45749108790693,0.821969696969697,0.20139943214892408,0.19073858668417307,131468.65051025312,-468.7924578463577,130999.85805240677,3345,0,670.4666666666667,37,8,19,35.29426832745287,0.6331644144144144,43.612938596491226,1025.5482456140348,27.71752015173067,0
3353,4,2,1,45,0.043478260869565216,0.021739130434782608,0.9782608695652174,46,700,500,200,0.7142857142857143,9,5,4,318.9391434599054,0.8285225442834139,0.20120740274956628,0.18910080862388354,131793.9486654431,-793.1501798889634,131000.79848555414,3346,0,656.8478260869565,38,8,15,35.108642874484076,0.6345942982456141,43.29594017094017,1026.8162393162397,27.02147998200631,0
3354,4,0,0,45,0.0,0.0,1.0,45,1150,800,350,0.6956521739130435,15,8,7,328.5621095732357,0.8231902356902357,0.20906404642386667,0.19458108993891263,131749.9269606995,-342.3932123345639,131407.53374836492,3347,1,672.4444444444445,37,8,15,34.90590177649613,0.6359797297297296,43.338815789473685,1026.6447368421057,27.747155049786638,0
3355,4,0,0,45,0.0,0.0,1.0,45,1050,700,350,0.6666666666666666,14,7,7,331.76029069243896,0.8236952861952862,0.2110452418096722,0.19727119325960418,131903.67408366202,-247.9197485207151,131655.7543351413,3348,2,673.4444444444445,38,7,15,34.669136765470626,0.6356907894736842,43.18910256410256,1027.2435897435894,27.03272604588393,0
3356,4,1,3,43,0.021739130434782608,0.06521739130434782,0.9347826086956522,46,1300,1100,200,0.8461538461538461,15,11,4,323.45300231947823,0.826670692431562,0.20414347121414922,0.19375776935060027,132183.68055555568,-648.9583333333245,131534.72222222236,3349,0,659.7826086956521,39,7,16,34.60122906537007,0.6367521367521367,42.91666666666667,1028.3333333333344,26.367521367521395,0
3357,4,0,0,43,0.0,0.0,1.0,43,1000,700,300,0.7,13,7,6,343.4528009362498,0.815983757844223,0.2114577673704372,0.2034606358762696,131761.33639974432,450.7600083191287,132212.09640806346,3350,4,705.0930232558139,36,7,17,34.512220759752836,0.6380208333333334,43.3277027027027,1026.6891891891892,28.519144144144143,0
3358,4,0,0,43,0.0,0.0,1.0,43,1550,1200,350,0.7741935483870968,19,12,7,344.33596451156546,0.8163528977482466,0.21003655869020976,0.2047609301352348,131905.89871966562,483.98897208019036,132389.88769174583,3351,5,706.0930232558139,36,7,19,34.34393956003801,0.6394675925925927,43.18693693693694,1027.2522522522524,28.53478478478479,0
3359,4,0,0,43,0.0,0.0,1.0,43,1300,900,400,0.6923076923076923,17,9,8,357.46587029731177,0.8155223329641934,0.20402239163826685,0.2042758650111101,130377.57087746523,747.3604516678728,131124.9313291331,3352,6,707.0930232558139,36,7,20,35.55220163928401,0.6241319444444444,44.67905405405405,1021.2837837837833,28.368993993993982,5
3360,4,1,2,42,0.022727272727272728,0.045454545454545456,0.9545454545454546,44,750,400,350,0.5333333333333333,11,4,7,351.99015893996585,0.8221238548273432,0.20383370383370347,0.20258989147878032,130654.64854570634,397.8301015697071,131052.47864727605,3353,0,692.0,37,7,18,35.41130416130416,0.625,44.4078947368421,1022.3684210526313,27.631578947368414,0
3361,4,1,1,42,0.023255813953488372,0.023255813953488372,0.9767441860465116,43,1300,800,500,0.6153846153846154,18,8,10,361.4655227168412,0.8141380583241048,0.20723707811042646,0.20763677747962356,130578.91506371237,839.9551578605628,131418.87022157293,3354,0,708.9069767441861,36,7,18,35.24588658733656,0.6261574074074074,44.48198198198198,1022.0720720720722,28.390890890890894,0
3362,4,0,0,42,0.0,0.0,1.0,42,1300,1100,200,0.8461538461538461,15,11,4,365.6320237416105,0.8102255129694154,0.21015970098538905,0.2097573188833449,130528.5644531249,1145.0846354166517,131673.64908854154,3355,16,726.7857142857143,35,7,18,35.19049439347606,0.6276785714285715,44.53124999999999,1021.8749999999992,29.196428571428548,0
3363,4,0,0,42,0.0,0.0,1.0,42,1350,700,650,0.5185185185185185,20,7,13,365.99666216930086,0.807999419279907,0.203994379872394,0.211338059916323,130780.41459956585,1173.039044111687,131953.45364367752,3356,17,727.7857142857143,36,6,18,34.92582296598041,0.6281828703703705,44.28490990990991,1022.8603603603609,28.412787787787803,0
3364,4,0,0,42,0.0,0.0,1.0,42,900,700,200,0.7777777777777778,11,7,4,368.4243077830389,0.8067895857530004,0.2000110047320347,0.21337614307358027,130895.6269402849,1245.0261494602746,132140.65308974517,3357,18,728.7857142857143,36,6,18,34.74698286930048,0.6293402777777778,44.1722972972973,1023.310810810811,28.425300300300304,0
3365,4,1,1,42,0.023255813953488372,0.023255813953488372,0.9767441860465116,43,1450,1100,350,0.7586206896551724,18,11,7,362.4508227585436,0.8120616463639719,0.20176777042382166,0.21151642954610064,131187.67463306012,909.8161213065471,132097.49075436668,3358,0,712.8139534883721,37,6,18,34.6042268721681,0.6303490990990992,43.88706140350877,1024.4517543859645,27.687885253674715,0
3366,4,1,0,43,0.023255813953488372,0.0,1.0,43,950,600,350,0.631578947368421,13,6,7,362.54874743869385,0.8083241048357327,0.20514274910190977,0.2123499806426637,131328.12500000012,922.56944444446,132250.69444444458,3359,0,713.7906976744187,37,6,20,34.459688346883475,0.6317567567567567,43.75000000000001,1025.000000000001,27.702702702702727,0
3367,4,1,1,43,0.022727272727272728,0.022727272727272728,0.9772727272727273,44,1200,900,300,0.75,15,9,6,354.3115929380866,0.8136451726568006,0.20035495430752315,0.20952058253274983,131693.64762474995,532.1172139504456,132225.7648387004,3360,0,698.5454545454545,37,7,18,34.30177954634475,0.6354166666666666,43.39364035087719,1026.4254385964914,27.741228070175442,0
3368,4,0,0,43,0.0,0.0,1.0,43,1550,1200,350,0.7741935483870968,19,12,7,356.96741079702105,0.8068936877076411,0.2046233323476716,0.21077968439427885,131637.38031173052,798.0509627962397,132435.43127452675,3361,2,715.7906976744187,37,6,18,34.29041119065426,0.6348536036036037,43.4484649122807,1026.2061403508771,27.735301090564246,0
3369,4,0,1,42,0.0,0.023255813953488372,0.9767441860465116,43,1150,900,250,0.782608695652174,14,9,5,357.4194698454404,0.8064784053156145,0.20475648713502848,0.21151460661776322,131721.78578985843,815.9861688211752,132537.7719586796,3362,3,716.7906976744187,37,6,18,34.19363739941607,0.6356981981981982,43.36622807017544,1026.5350877192984,27.74419155998104,0
3370,4,0,1,41,0.0,0.023809523809523808,0.9761904761904762,42,800,500,300,0.625,11,5,6,363.44368510183665,0.8029423151374371,0.2038599021698233,0.2144882680471462,131616.8533398264,1167.062839866902,132783.9161796933,3363,24,734.7857142857143,36,6,18,34.14499195200468,0.6365740740740741,43.46846846846847,1026.1261261261268,28.503503503503524,0
3371,4,0,0,41,0.0,0.0,1.0,41,1200,900,300,0.75,15,9,6,365.4759826901534,0.8034552845528455,0.20055178560131148,0.21590110183301728,131654.57182623885,1423.3168027692025,133077.88862900806,3364,25,739.609756097561,35,6,18,34.05475827976393,0.6389880952380952,43.43171296296296,1026.273148148148,29.322089947089943,0
3372,4,1,0,42,0.023809523809523808,0.0,1.0,42,1050,1000,50,0.9523809523809523,11,10,1,359.4867629949334,0.8091124661246613,0.20784083496412253,0.21425974606980835,131992.67415641996,1089.9238343072823,133082.59799072726,3365,0,722.9761904761905,36,6,19,33.8673515981735,0.6403356481481481,43.10247747747748,1027.5900900900904,28.544169169169177,0
3373,4,0,0,42,0.0,0.0,1.0,42,1700,1600,100,0.9411764705882353,18,16,2,358.7215923043427,0.8081445993031359,0.20689951958437036,0.2144577220790012,132108.41912436092,1078.0284930200596,133186.447617381,3366,1,723.9761904761905,36,6,20,33.77035637346187,0.6414930555555556,42.98986486486487,1028.0405405405413,28.556681681681702,0
3374,4,0,0,42,0.0,0.0,1.0,42,1050,700,350,0.6666666666666666,14,7,7,360.109600466189,0.8071283391405343,0.20692361035074325,0.21594753651068316,132224.21481870385,1123.0418340638005,133347.25665276765,3367,2,724.9761904761905,36,6,20,33.61801525603126,0.642650462962963,42.877252252252255,1028.4909909909911,28.569194194194196,0
3375,4,0,2,40,0.0,0.047619047619047616,0.9523809523809523,42,1450,1000,450,0.6896551724137931,19,10,9,360.3654937345516,0.8069831591173054,0.2098401580178968,0.21676494511208694,132340.06123944905,1138.1583018829797,133478.21954133202,3368,3,725.9761904761905,36,6,20,33.49476487541499,0.6438078703703702,42.76463963963965,1028.9414414414425,28.581706706706736,0
3376,4,1,0,41,0.024390243902439025,0.0,1.0,41,1200,600,600,0.5,18,6,12,364.47954945396225,0.8143292682926829,0.19828040007018766,0.2202724233656553,132517.14677640592,1459.957990397796,133977.1047668037,3369,0,716.170731707317,35,6,21,33.21061900479617,0.6476190476190476,42.59259259259259,1029.6296296296289,29.417989417989396,0
3377,4,0,1,40,0.0,0.024390243902439025,0.975609756097561,41,1300,800,500,0.6153846153846154,18,8,10,360.8858208749228,0.8138211382113821,0.18910454018594813,0.2189669183099988,132666.1512586804,1375.466579861091,134041.61783854148,3370,1,717.170731707317,35,6,17,33.15322716548703,0.6491071428571429,42.44791666666666,1030.208333333332,29.434523809523768,0
3378,4,0,0,40,0.0,0.0,1.0,40,1000,700,300,0.7,13,7,6,365.5322341175345,0.8158653846153846,0.1869785045648913,0.2216503449067289,132643.15653344657,1697.0698696144968,134340.22640306107,3371,2,727.3,34,6,17,33.05669517315768,0.6510416666666667,42.47023809523809,1030.1190476190463,30.29761904761901,0
3379,4,0,1,39,0.0,0.025,0.975,40,1100,900,200,0.8181818181818182,13,9,4,364.82586711013806,0.8149305555555556,0.18516753321779356,0.22158371086584158,132704.4802295917,1682.8054138321827,134387.28564342388,3372,3,728.3,34,6,17,33.01319083381475,0.651654411764706,42.41071428571428,1030.3571428571418,30.304621848739462,0
3380,4,1,1,39,0.025,0.025,0.975,40,1500,1200,300,0.8,18,12,6,353.6902188331984,0.8152777777777778,0.18315484025367934,0.20597833859157083,131108.39468293462,1278.7802161305938,132387.17489906523,3373,0,729.2,33,7,19,34.908734194886534,0.6379419191919191,43.96446078431374,1024.1421568627466,31.034610814022624,7
3381,4,0,0,39,0.0,0.0,1.0,39,1200,900,300,0.75,15,9,6,362.22126844184385,0.8061740890688259,0.1955419719900331,0.2107744372632346,131077.01965590165,1695.7768646674451,132772.7965205691,3374,1,748.6923076923077,33,6,19,34.72205600765916,0.6376262626262625,43.99509803921569,1024.019607843138,31.030897207367815,0
3382,4,0,0,39,0.0,0.0,1.0,39,800,600,200,0.75,10,6,4,359.69237331727453,0.8061740890688259,0.18709034659954904,0.2021719201748819,129731.44531250001,1532.6822916666672,131264.1276041667,3375,2,749.6923076923077,33,6,19,36.151584867075655,0.6240530303030303,45.3125,1018.7500000000001,30.871212121212125,3
3383,4,0,0,39,0.0,0.0,1.0,39,1100,800,300,0.7272727272727273,14,8,6,362.50116783450113,0.805386864597391,0.19348579348579342,0.20571385291221703,130106.25608239631,1632.733954488673,131738.990036885,3376,3,750.6923076923077,33,6,20,35.69907407407409,0.627840909090909,44.94485294117648,1020.220588235295,30.915775401069546,1
3384,4,0,0,39,0.0,0.0,1.0,39,900,300,600,0.3333333333333333,15,3,12,352.34890179923207,0.8039248762932973,0.1521254452102323,0.19836026529861964,129793.87622849371,1346.545949875032,131140.42217836875,3377,4,751.6923076923077,33,6,17,36.27518039687312,0.6246843434343434,45.25122549019607,1018.9950980392146,30.878639334521655,1
3385,4,0,0,39,0.0,0.0,1.0,39,600,500,100,0.8333333333333334,7,5,2,355.80678836170847,0.804093567251462,0.15745895524688525,0.20078703294387307,129887.55076172625,1442.9744569396346,131330.5252186659,3378,5,752.6923076923077,33,6,17,36.09190911276749,0.6256313131313131,45.15931372549019,1019.3627450980391,30.889780154486033,0
3386,4,0,0,39,0.0,0.0,1.0,39,1100,600,500,0.5454545454545454,16,6,10,360.2679023428603,0.803812415654521,0.15758046327620923,0.2039557471630803,130012.50270328706,1567.8663254517257,131580.3690287388,3379,6,753.6923076923077,33,6,17,35.85125771048625,0.6268939393939394,45.03676470588234,1019.8529411764695,30.904634581105135,0
3387,4,0,0,39,0.0,0.0,1.0,39,1150,800,350,0.6956521739130435,15,8,7,362.2705219459045,0.8027440395861449,0.16150120245232547,0.2059130809722554,130168.77710796306,1631.2621647923584,131800.0392727554,3380,7,754.6923076923077,33,6,17,35.64146251150875,0.6284722222222223,44.883578431372534,1020.465686274508,30.92320261437903,0
3388,4,0,0,39,0.0,0.0,1.0,39,900,700,200,0.7777777777777778,11,7,4,362.99951734296735,0.8031938821412505,0.1667944254089051,0.20665912371494,130231.31315179245,1654.7807634082876,131886.09391520073,3381,8,755.6923076923077,33,6,17,35.55936587025252,0.6291035353535355,44.82230392156862,1020.7107843137244,30.93062982768862,0
3389,4,1,1,39,0.025,0.025,0.975,40,1200,800,400,0.6666666666666666,16,8,8,352.7064481431869,0.8076121794871794,0.15883808969132218,0.2025407931310542,130566.58340419494,1210.3351757369503,131776.9185799319,3382,0,737.775,34,6,16,35.48218792467481,0.6302083333333334,44.49404761904761,1022.023809523809,30.059523809523792,0
3390,4,1,0,40,0.025,0.0,1.0,40,800,500,300,0.625,11,5,6,354.1086714377525,0.8120993589743589,0.167695844488418,0.2043080991485381,130749.15143140589,1259.8816609977303,132009.0330924036,3383,0,738.75,34,6,17,35.2614654871377,0.632046568627451,44.31547619047619,1022.7380952380952,30.080532212885153,0
3391,4,0,0,40,0.0,0.0,1.0,40,900,600,300,0.6666666666666666,12,6,6,353.6993834288707,0.8123130341880341,0.16679469273743042,0.204232869786348,130779.59183673479,1251.3321995464973,132030.9240362813,3384,1,739.75,34,6,17,35.2411157666046,0.6323529411764706,44.28571428571429,1022.8571428571436,30.0840336134454,0
3392,4,0,0,40,0.0,0.0,1.0,40,900,600,300,0.6666666666666666,12,6,6,354.61914715275475,0.8105502136752136,0.16583876221498328,0.20541146825640713,130901.38888888899,1284.0277777777865,132185.41666666677,3385,2,740.75,34,6,19,35.094326818675334,0.633578431372549,44.16666666666667,1023.3333333333342,30.0980392156863,0
3393,4,1,0,41,0.024390243902439025,0.0,1.0,41,1050,800,250,0.7619047619047619,13,8,5,346.5469722857273,0.8140752032520325,0.16973163293137516,0.2025069535079566,131239.16437596444,896.1070119598648,132135.2713879243,3386,0,723.6585365853658,35,6,20,34.959547610979314,0.6348214285714286,43.83680555555555,1024.6527777777771,29.275793650793634,0
3394,4,0,0,41,0.0,0.0,1.0,41,1100,900,200,0.8181818181818182,13,9,4,347.6766474981823,0.8140243902439024,0.16874876065833844,0.20363917924893535,131328.125,931.9745852623457,132260.09958526236,3387,1,724.6585365853658,34,7,20,34.84078590785908,0.6378676470588236,43.75,1025.0,30.147058823529413,0
3395,4,1,1,41,0.023809523809523808,0.023809523809523808,0.9761904761904762,42,950,500,450,0.5263157894736842,14,5,9,341.4099534301933,0.8164440572977159,0.16126407707551316,0.20168434757265316,131654.57182623883,589.6362472136467,132244.20807345246,3388,0,708.3809523809524,35,7,17,34.67221627006505,0.6389880952380952,43.43171296296296,1026.2731481481478,29.32208994708994,0
3396,4,0,1,40,0.0,0.024390243902439025,0.975609756097561,41,900,500,400,0.5555555555555556,13,5,8,349.93170918219977,0.8142276422764227,0.16321308059877238,0.20594341573181935,131511.22448979603,1003.989512471665,132515.2140022677,3389,3,726.6585365853658,34,7,21,34.598179743113576,0.6397058823529411,43.57142857142858,1025.7142857142865,30.168067226890777,0
3397,4,0,0,40,0.0,0.0,1.0,40,750,400,350,0.5333333333333333,11,4,7,351.25571698721933,0.8115117521367521,0.14772885485555154,0.2072192350932816,131602.8220663266,1245.2487244898045,132848.0707908164,3390,4,692.975,34,6,17,34.47180647406892,0.640625,43.48214285714286,1026.0714285714291,30.178571428571445,0
3398,4,0,0,40,0.0,0.0,1.0,40,650,400,250,0.6153846153846154,9,4,5,360.55792606403963,0.8115117521367521,0.15608982035928132,0.20878354248507144,130888.84833958092,1451.7861556387284,132340.63449521965,3391,5,693.975,33,7,19,34.955089820359284,0.6357323232323232,44.17892156862745,1023.2843137254902,31.008615567439097,3
3399,4,0,0,40,0.0,0.0,1.0,40,1300,1000,300,0.7692307692307693,16,10,6,360.7136656848735,0.8095352564102564,0.15280703854440958,0.20955507393125417,131014.2808655326,1451.7283016147753,132466.00916714736,3392,6,694.975,33,7,20,34.824136142366925,0.6369949494949494,44.05637254901961,1023.7745098039225,31.023469994058257,0
3400,4,0,0,40,0.0,0.0,1.0,40,1150,800,350,0.6956521739130435,15,8,7,354.8537411268882,0.8084134615384615,0.10867791754888567,0.1931607245767988,128464.33280086202,1164.3070894317505,129628.63989029377,3393,7,695.975,32,8,19,37.56590692074564,0.6136067708333335,46.559343434343425,1013.7626262626251,31.680082070707034,8
3401,4,0,0,40,0.0,0.0,1.0,40,1000,700,300,0.7,13,7,6,356.68331175774046,0.8073717948717949,0.11316280806572099,0.19493834875249577,128624.38303489446,1175.634182736464,129800.01721763093,3394,8,696.975,32,8,19,37.356080408264866,0.615234375,46.401515151515156,1014.39393939394,31.699810606060623,0
3402,4,0,0,40,0.0,0.0,1.0,40,1200,700,500,0.5833333333333334,17,7,10,357.48934441686913,0.8065972222222222,0.11023957685127517,0.19553620710616385,128656.40503838909,1198.6587784409892,129855.06381683008,3395,9,697.975,32,8,19,37.30294544700267,0.6155598958333333,46.3699494949495,1014.5202020202032,31.70375631313135,0
3403,4,0,0,40,0.0,0.0,1.0,40,700,500,200,0.7142857142857143,9,5,4,357.48934441686913,0.8065972222222222,0.11023957685127517,0.19553620710616385,128656.40503838909,1198.6587784409892,129855.06381683008,3396,10,698.975,32,8,19,37.30294544700267,0.6155598958333333,46.3699494949495,1014.5202020202032,31.70375631313135,0
3404,4,1,0,41,0.024390243902439025,0.0,1.0,41,1450,1100,350,0.7586206896551724,18,11,7,346.1626978060091,0.8194105691056911,0.112221006435824,0.1913587393471619,129076.82742214542,736.3165609381094,129813.14398308353,3397,0,682.9024390243902,33,8,21,37.16182264029585,0.6174242424242424,45.95588235294118,1016.176470588236,30.793226381461697,0
3405,4,3,0,44,0.06818181818181818,0.0,1.0,44,650,400,250,0.6153846153846154,9,4,5,336.1278935566005,0.8401383016208598,0.18464149153748122,0.17743618752807117,127230.25504241681,-246.87247518468075,126983.38256723214,3398,0,637.2727272727273,37,7,19,39.301774263666985,0.5903716216216216,47.77960526315789,1008.8815789473678,27.26706970128021,6
3406,4,3,1,46,0.06382978723404255,0.02127659574468085,0.9787234042553191,47,950,500,450,0.5263157894736842,14,5,9,320.14205210842533,0.8573080481036077,0.20594017934229747,0.1721022824401447,127964.52591050293,-1206.6348155859714,126757.89109491695,3399,0,597.531914893617,40,7,18,38.95494341770458,0.5927083333333334,47.05284552845528,1011.7886178861783,25.294715447154456,0
3407,4,0,0,46,0.0,0.0,1.0,46,1050,500,550,0.47619047619047616,16,5,11,319.4308619693199,0.8553542673107891,0.20346446933128481,0.1723819202025116,128118.80845561503,-1014.9797161081414,127103.82873950689,3400,1,602.4347826086956,40,6,19,38.81562437261592,0.5942708333333333,46.90040650406504,1012.3983739837397,25.30995934959349,0
3408,4,1,0,47,0.02127659574468085,0.0,1.0,47,1400,1100,300,0.7857142857142857,17,11,6,314.56585222382284,0.8593509096515571,0.21097989745767531,0.17147613736425005,128521.48216057236,-1314.3060870181578,127207.1760735542,3401,0,590.5957446808511,41,6,15,38.528825457391655,0.596798780487805,46.50297619047618,1013.9880952380936,24.731416957026674,0
3409,4,1,0,48,0.020833333333333332,0.0,1.0,48,1250,800,450,0.64,17,8,9,312.95384266143054,0.8639369089834515,0.22822810282841788,0.17193588933213458,128832.22467287116,-1536.292046000845,127295.93262687032,3402,0,579.2708333333334,42,6,16,38.253833794661325,0.5984623015873016,46.19670542635659,1015.2131782945731,24.17174234034698,0
3410,4,1,2,47,0.02040816326530612,0.04081632653061224,0.9591836734693877,49,1100,900,200,0.8181818181818182,13,9,4,314.4223546365549,0.8665320294784581,0.2488054280371086,0.1747043033230431,129278.89034511537,-1668.780907241708,127610.10943787366,3403,0,568.4285714285714,40,9,18,37.76314912894307,0.6059895833333333,45.75711382113821,1016.9715447154474,25.424288617886184,0
3411,4,2,2,47,0.04081632653061224,0.04081632653061224,0.9591836734693877,49,1300,1000,300,0.7692307692307693,16,10,6,318.6339556390287,0.8624929138321996,0.26368830279715705,0.17809362163395698,129511.53413973156,-1546.6455152356498,127964.88862449591,3404,0,569.2244897959183,40,9,18,37.42012779552715,0.6083333333333334,45.52845528455284,1017.886178861788,25.4471544715447,0
3412,4,0,0,47,0.0,0.0,1.0,47,1400,900,500,0.6428571428571429,19,9,10,306.10512203935116,0.8626657415972864,0.13279146710495393,0.1630920216138922,127604.89477989289,-1585.7261922466832,126019.1685876462,3405,1,584.063829787234,40,7,16,39.67658251190236,0.5890625,47.40853658536585,1010.3658536585363,25.259146341463406,6
3413,4,1,0,48,0.020833333333333332,0.0,1.0,48,1150,800,350,0.6956521739130435,15,8,7,320.1629253628605,0.867113622931442,0.19047834557428978,0.16702725307516328,126750.88026258691,-1481.5361862591049,125269.3440763278,3406,0,572.875,39,9,18,40.19527343884692,0.5819978632478633,48.255208333333336,1006.9791666666675,25.819978632478655,4
3414,4,1,1,48,0.02040816326530612,0.02040816326530612,0.9795918367346939,49,1500,1300,200,0.8666666666666667,17,13,4,340.940061008038,0.8711380385487528,0.2696551889350334,0.17167916774348896,125293.97605970148,-1137.0219505767361,124156.95410912475,3407,0,562.1632653061224,38,11,15,41.172678120442505,0.5688048245614034,49.70619658119659,1001.1752136752158,26.346716149347785,5
3415,4,6,4,50,0.1111111111111111,0.07407407407407407,0.9259259259259259,54,1600,1300,300,0.8125,19,13,6,316.79563040509777,0.89548392732355,0.29235152312075385,0.16422840962718283,126492.52409297072,-2781.069822187015,123711.45427078371,3408,0,509.2962962962963,41,13,15,40.5448717948718,0.5762195121951219,48.51190476190477,1005.9523809523826,24.535423925667867,0
3416,4,4,6,48,0.07407407407407407,0.1111111111111111,0.8888888888888888,54,950,600,350,0.631578947368421,13,6,7,292.89822349514395,0.9015111809923131,0.1658579126350761,0.1565831431090075,127740.92667779549,-3316.981901690047,124423.94477610545,3409,0,510.14814814814815,46,8,13,39.871634657546274,0.5822010869565217,47.27393617021277,1010.9042553191498,21.97617946345978,6
3417,4,6,2,52,0.1111111111111111,0.037037037037037035,0.962962962962963,54,1250,800,450,0.64,17,8,9,293.722351567594,0.9001426741206615,0.21054077313187336,0.15852308127407896,128122.55953565048,-3273.5081048659426,124849.05143078453,3410,0,510.98148148148147,47,7,17,39.46249178313183,0.5848847517730498,46.896701388888886,1012.4131944444438,21.540706264775398,0
3418,4,0,1,51,0.0,0.019230769230769232,0.9807692307692307,52,1150,900,250,0.782608695652174,14,9,5,320.08067761776704,0.8932566616390145,0.19238341126845881,0.1691019835633588,127263.05815643563,-2239.5399186557484,125023.51823777988,3411,1,531.6346153846154,42,10,20,39.67296488363904,0.5825892857142858,47.7470930232558,1009.0116279069744,24.024086378737486,5
3419,4,1,0,52,0.019230769230769232,0.0,1.0,52,1600,1100,500,0.6875,21,11,10,313.58828816511334,0.8947335344394167,0.20313885664433995,0.16703312263772294,127593.81030654546,-2397.61508910125,125196.19521744421,3412,0,532.3653846153846,43,9,17,39.49887915143564,0.584544573643411,47.41950757575757,1010.3219696969688,23.495859760394623,0
3420,4,2,1,53,0.037037037037037035,0.018518518518518517,0.9814814814814815,54,1450,900,550,0.6206896551724138,20,9,11,312.08327346751196,0.8996622408572095,0.23500021261215331,0.1688351125404988,128218.12466197945,-2793.4957255240934,125424.62893645537,3413,0,513.6111111111111,42,12,19,38.90044967470342,0.5922619047619047,46.80232558139535,1012.7906976744187,24.114064230343303,0
3421,4,1,2,52,0.018518518518518517,0.037037037037037035,0.962962962962963,54,1850,1200,650,0.6486486486486487,25,12,13,313.12212190070187,0.8990507803400886,0.23469246526047716,0.17030788581428422,128432.33471074385,-2756.998966942145,125675.3357438017,3414,0,514.5370370370371,43,11,16,38.65610986547086,0.5930232558139534,46.59090909090909,1013.636363636364,23.572938689217768,0
3422,4,2,2,52,0.037037037037037035,0.037037037037037035,0.962962962962963,54,1550,1100,450,0.7096774193548387,20,11,9,317.7728351267239,0.8998223852783601,0.245909262197884,0.17377745700421618,128648.39916386885,-2623.8066926365836,126024.59247123226,3415,0,515.3888888888889,43,11,17,38.318417654563014,0.595203488372093,46.377840909090914,1014.4886363636367,23.592758985200852,0
3423,4,0,1,51,0.0,0.019230769230769232,0.9807692307692307,52,1400,800,600,0.5714285714285714,20,8,12,328.5023349357266,0.8955033936651583,0.26247187713978337,0.17929948585413402,128571.78411005596,-1952.773742598898,126619.01036745706,3416,1,535.9807692307693,41,11,17,38.12430711793668,0.5973069105691058,46.45337301587301,1014.1865079365072,24.73625629113432,0
3424,4,1,2,50,0.019230769230769232,0.038461538461538464,0.9615384615384616,52,1350,800,550,0.5925925925925926,19,8,11,324.9790183740903,0.8914655605832076,0.2768151996829733,0.17909726974748755,128955.2207274202,-2018.4517907577751,126936.76893666243,3417,0,536.5961538461538,42,10,18,37.823570565413725,0.5997023809523809,46.075581395348834,1015.6976744186043,24.18327796234772,0
3425,4,1,2,49,0.0196078431372549,0.0392156862745098,0.9607843137254902,51,1550,1300,250,0.8387096774193549,18,13,5,329.48420888767834,0.8913071895424838,0.2681397432069281,0.18224817688149958,129100.54878432838,-1692.6815633661013,127407.86722096227,3402,0,481.0,41,10,19,37.56141806585969,0.6026422764227642,45.93253968253968,1016.2698412698398,24.787069299264388,0
3426,4,0,0,49,0.0,0.0,1.0,49,1150,700,450,0.6086956521739131,16,7,9,333.509344859647,0.8850977891156463,0.27852050749595847,0.1848221292723053,129174.91455078125,-1183.7917751736125,127991.12277560764,3403,1,500.6530612244898,39,10,20,37.383547665402865,0.6065705128205128,45.859375,1016.5625,26.065705128205128,0
3427,4,0,1,48,0.0,0.02040816326530612,0.9795918367346939,49,1600,1300,300,0.8125,19,13,6,337.01758036476514,0.8848143424036281,0.2835053814540045,0.18742056807335508,129312.88954293627,-1083.8511459054725,128229.0383970308,3404,2,501.6530612244898,37,12,21,37.15412534138279,0.6114864864864864,45.723684210526315,1017.1052631578946,27.489331436699853,0
3428,4,2,2,48,0.04,0.04,0.96,50,1200,500,700,0.4166666666666667,19,5,14,328.29987176110114,0.8848979591836734,0.27178637200736655,0.18378023749100822,129572.314453125,-1492.2851562500005,128080.029296875,3405,0,492.34,39,11,17,37.112492326580735,0.6105769230769231,45.46875,1018.125,26.10576923076923,0
3429,4,0,0,48,0.0,0.0,1.0,48,1150,800,350,0.6956521739130435,15,8,7,340.28632766223336,0.8793587470449172,0.284514120944271,0.18937230124310364,129340.77222077937,-797.4207207987221,128543.35149998065,3406,4,513.8541666666666,37,11,21,37.04266375624304,0.6117680180180181,45.696271929824555,1017.2149122807009,27.49229492650543,0
3430,4,1,2,47,0.02040816326530612,0.04081632653061224,0.9591836734693877,49,1150,800,350,0.6956521739130435,15,8,7,364.8162426757013,0.8843183106575964,0.27103075778647434,0.19541515206143273,127820.21747616709,-443.5179090721505,127376.69956709494,3407,0,504.3469387755102,38,11,18,37.97279450607501,0.5945723684210527,47.195512820512825,1011.2179487179494,26.610998650472354,6
3431,4,2,2,47,0.04081632653061224,0.04081632653061224,0.9591836734693877,49,1150,700,450,0.6086956521739131,16,7,9,363.6879356341335,0.8854875283446713,0.27896543476434,0.19559843488874945,127982.3229988494,-490.8746301775182,127491.44836867187,3408,0,505.0,38,11,18,37.83523387181925,0.5962171052631579,47.03525641025641,1011.858974358974,26.62786774628879,0
3432,4,1,0,48,0.020833333333333332,0.0,1.0,48,1250,800,450,0.64,17,8,9,374.54768854896247,0.8804484338061466,0.29038673384620894,0.20155688732468666,128005.79415060411,-11.145136003380998,127994.64901460073,3409,0,516.5,37,11,19,37.536456640300486,0.5982545045045045,47.012061403508774,1011.9517543859655,27.350047415836904,0
3433,4,3,1,50,0.058823529411764705,0.0196078431372549,0.9803921568627451,51,850,700,150,0.8235294117647058,10,7,3,330.7600705430877,0.8929411764705883,0.2712580542938623,0.17741108146353618,127874.24123612029,-1740.711102992747,126133.53013312754,3410,0,487.05882352941177,38,13,17,38.778564135065665,0.5951206140350876,47.14209401709402,1011.4316239316244,26.616621682411168,3
3434,4,4,3,51,0.07407407407407407,0.05555555555555555,0.9444444444444444,54,900,400,500,0.4444444444444444,14,4,10,319.1529164437485,0.8959789191707431,0.2957545804670634,0.17446793055539409,128633.75491605519,-2588.947036230258,126044.80787982493,3411,0,460.9259259259259,40,14,13,38.29831196153077,0.5994791666666668,46.392276422764226,1014.4308943089425,25.36077235772356,0
3435,4,1,0,52,0.019230769230769232,0.0,1.0,52,850,400,450,0.47058823529411764,13,4,9,338.37492963032486,0.8894859225741578,0.3148050579557433,0.1843385810672664,128496.33487654307,-1704.012345679026,126792.32253086404,3412,0,479.5576923076923,38,14,15,37.950913242009136,0.6014254385964912,46.52777777777777,1013.8888888888878,26.681286549707572,0
3436,4,1,3,50,0.018867924528301886,0.05660377358490566,0.9433962264150944,53,1950,1600,350,0.8205128205128205,23,16,7,330.3093301946555,0.8942005321722303,0.3081535213093938,0.18182866516474872,128910.32036675359,-2083.9436848958235,126826.37668185776,3413,0,471.49056603773585,39,14,15,37.733891510240355,0.6038995726495726,46.11979166666667,1015.5208333333343,26.038995726495752,0
3437,4,3,0,53,0.05660377358490566,0.0,1.0,53,1550,1200,350,0.7741935483870968,19,12,7,331.0778767888163,0.8942307692307692,0.31727039642364097,0.1833517549208437,129148.44292534704,-2048.36154513891,127100.08138020814,3414,0,472.3207547169811,39,14,19,37.4722449955592,0.6063034188034189,45.88541666666666,1016.4583333333319,26.063034188034152,0
3438,4,0,0,53,0.0,0.0,1.0,53,1700,1200,500,0.7058823529411765,22,12,10,331.8776039827697,0.8940493468795355,0.31769858886950986,0.18454876109322235,129310.02995105549,-2016.9685670862698,127293.06138396922,3415,1,473.3207547169811,38,15,20,37.28772759103641,0.6096491228070176,45.72649572649572,1017.0940170940163,26.765632028789902,0
3439,4,0,0,53,0.0,0.0,1.0,53,1600,900,700,0.5625,23,9,14,332.7744214973591,0.8927491533623608,0.31931034892682786,0.1854307089478848,129391.54071015044,-1988.3609787055402,127403.17973144489,3416,2,474.3207547169811,38,15,20,37.182129230984614,0.6104714912280702,45.646367521367516,1017.4145299145296,26.774066576698146,0
3440,4,1,3,51,0.018518518518518517,0.05555555555555555,0.9444444444444444,54,2150,1900,250,0.8837209302325582,24,19,5,314.6155246705758,0.8947268809690193,0.29460442858760927,0.17146546094546394,128512.7095727421,-2713.5812901868785,125799.12828255522,3417,0,466.51851851851853,42,12,15,38.5364901885831,0.5952380952380951,46.51162790697675,1013.9534883720936,24.141749723145086,8
3441,4,1,0,52,0.019230769230769232,0.0,1.0,52,900,500,400,0.5555555555555556,13,5,8,324.10947202507936,0.889564479638009,0.3043637569810851,0.17603592892342576,128376.1525877456,-2078.414592834935,126297.73799491067,3418,0,485.3269230769231,40,12,16,38.43490941302312,0.5968749999999999,46.64634146341464,1013.4146341463431,25.33536585365858,0
3442,4,1,2,51,0.018867924528301886,0.03773584905660377,0.9622641509433962,53,1150,600,550,0.5217391304347826,17,6,11,320.4349335449318,0.8909651669085631,0.30729028257595914,0.17500677139761647,128596.93877551009,-2358.60969387756,126238.32908163253,3419,0,477.1509433962264,41,12,16,38.30325704225352,0.5975609756097562,46.42857142857142,1014.2857142857133,24.73867595818813,0
3443,4,1,2,50,0.019230769230769232,0.038461538461538464,0.9615384615384616,52,1350,800,550,0.5925925925925926,19,8,11,326.6040162211422,0.886767848164907,0.31423358226784814,0.17842554383706719,128607.98306439607,-1999.2232426135301,126608.75982178254,3420,0,487.15384615384613,40,12,17,38.13558260695323,0.5992187500000001,46.417682926829265,1014.329268292682,25.35823170731705,0
3444,4,0,1,49,0.0,0.02,0.98,50,1350,800,550,0.5925925925925926,19,8,11,329.1745548532904,0.8837244897959183,0.30238193018480497,0.18012135754331712,128672.41753472204,-1528.862847222243,127143.5546874998,3421,1,499.0,39,11,17,38.00479123887748,0.6014957264957267,46.35416666666666,1014.5833333333319,26.01495726495723,0
3445,4,0,0,49,0.0,0.0,1.0,49,1300,1100,200,0.8461538461538461,15,11,4,335.7606522764545,0.8851686507936508,0.29809459328755294,0.18353755862780238,128631.77237425999,-1162.1024408284354,127469.66993343156,3422,2,503.2448979591837,38,11,17,37.87914691943129,0.6027960526315791,46.39423076923075,1014.423076923074,26.695344129554577,0
3446,4,1,1,49,0.02,0.02,0.98,50,1450,1000,450,0.6896551724137931,19,10,9,326.2403995894031,0.8872619047619047,0.28821864424161636,0.17982872449950618,128963.21750216991,-1585.3976779514142,127377.81982421849,3423,0,494.16,39,11,17,37.78341110313471,0.6044337606837609,46.06770833333332,1015.7291666666648,26.04433760683756,0
3447,4,2,1,50,0.0392156862745098,0.0196078431372549,0.9803921568627451,51,1150,700,450,0.6086956521739131,16,7,9,323.61720189380566,0.8901307189542484,0.29486433253961275,0.17957793150014006,129227.2201256692,-1835.9697228832101,127391.250402786,3424,0,485.4313725490196,40,11,18,37.58183408295852,0.60546875,45.80792682926829,1016.7682926829266,25.419207317073166,0
3448,4,3,3,50,0.05660377358490566,0.05660377358490566,0.9433962264150944,53,1300,900,400,0.6923076923076923,17,9,8,313.87599825336173,0.8955914368650217,0.2888032606530284,0.1763644238181502,129719.10609526165,-2456.857216363205,127262.24887889845,3425,0,468.0566037735849,42,11,15,37.33096325184692,0.607390873015873,45.32461240310077,1018.7015503875965,24.2547988187523,0
3449,4,1,3,48,0.0196078431372549,0.058823529411764705,0.9411764705882353,51,1900,1500,400,0.7894736842105263,23,15,8,326.99806606107194,0.8888562091503269,0.29363434826080903,0.18337143928360394,129640.87106095906,-1721.53717611872,127919.33388484034,3426,0,487.37254901960785,40,11,17,37.07609852642782,0.6096354166666667,45.40142276422764,1018.3943089430893,25.459857723577233,0
3450,4,0,0,48,0.0,0.0,1.0,48,1250,800,450,0.64,17,8,9,350.3650787752676,0.8817412825059101,0.3180495689655174,0.19539590931697604,129424.43828870416,-530.8392967066873,128893.59899199747,3427,2,517.5833333333334,37,11,18,36.70123922413792,0.6126126126126126,45.614035087719294,1017.5438596491223,27.501185395922224,0
3451,4,1,0,49,0.02040816326530612,0.0,1.0,49,1700,1300,400,0.7647058823529411,21,13,8,345.9451031635844,0.8841057256235828,0.32575209920480463,0.195325927478516,129908.3719135802,-811.7669753086489,129096.60493827154,3428,0,508.0,38,11,18,36.32209355131699,0.6156798245614035,45.138888888888886,1019.444444444444,26.827485380116947,0
3452,4,0,0,49,0.0,0.0,1.0,49,1650,1300,350,0.7878787878787878,20,13,7,344.57946574372266,0.8838577097505669,0.323789568210731,0.19496212214130618,129990.0710082001,-841.618156001158,129148.45285219894,3429,1,509.0,38,11,18,36.274009079797445,0.6165021929824561,45.05876068376069,1019.764957264958,26.83591992802521,0
3453,4,0,0,49,0.0,0.0,1.0,49,1150,800,350,0.6956521739130435,15,8,7,347.4906526678915,0.8838577097505669,0.26129311679562095,0.19192660397070307,129042.5835503473,-831.7816840277718,128210.80186631954,3430,2,510.0,39,10,19,37.162958786139015,0.6052350427350428,45.989583333333336,1016.0416666666673,26.052350427350444,4
3454,4,1,1,49,0.02,0.02,0.98,50,850,600,250,0.7058823529411765,11,6,5,341.2966062831791,0.8904761904761904,0.2651812165143397,0.18965571484002217,129282.865405161,-1175.0440448307095,128107.8213603303,3431,0,500.78,38,12,20,37.07584830339322,0.609375,45.753205128205124,1016.987179487179,26.7628205128205,0
3455,4,1,1,49,0.02,0.02,0.98,50,1400,800,600,0.5714285714285714,20,8,12,338.18352054057937,0.8884183673469388,0.27148940526154175,0.18867588875847607,129439.78000216992,-1245.1199001736345,128194.66010199628,3432,0,501.7,39,11,15,36.99553434333096,0.6092414529914532,45.59895833333332,1017.6041666666649,26.092414529914485,0
3456,4,2,4,47,0.0392156862745098,0.0784313725490196,0.9215686274509804,51,1450,1000,450,0.6896551724137931,19,10,9,329.6362526370121,0.8936601307189543,0.26003660339285317,0.18570743491258182,129822.05119307284,-1641.1891070130291,128180.86208605982,3433,0,492.8235294117647,40,11,17,36.825222709746036,0.6114583333333334,45.22357723577235,1019.10569105691,25.47764227642275,0
3457,4,1,1,47,0.020833333333333332,0.020833333333333332,0.9791666666666666,48,1600,1100,500,0.6875,21,11,10,347.4645817322821,0.8799867021276595,0.27094102232751816,0.19460531399070988,129591.85157933203,-594.2842990150923,128997.56728031693,3434,0,523.2291666666666,37,11,17,36.6048352358389,0.6143018018018018,45.44956140350877,1018.2017543859643,27.518966334755792,0
3458,4,0,0,47,0.0,0.0,1.0,47,600,200,400,0.3333333333333333,10,2,8,356.0568970943584,0.8772741288930003,0.2770077624140943,0.19874528591980956,129459.11864144554,-181.0375831912947,129278.08105825425,3435,2,535.3617021276596,36,11,17,36.521153775220384,0.6148726851851851,45.57995495495496,1017.6801801801805,28.268893893893903,0
3459,4,1,0,48,0.020833333333333332,0.0,1.0,48,1400,1000,400,0.7142857142857143,18,10,8,350.4583018845118,0.8789154846335697,0.2760158883867727,0.19740360349785774,129815.2376211911,-501.03445290859463,129314.2031682825,3436,0,525.1875,37,11,19,36.30164622336991,0.6165540540540541,45.23026315789473,1019.0789473684208,27.542674253200563,0
3460,4,1,1,48,0.02040816326530612,0.02040816326530612,0.9795918367346939,49,1500,900,600,0.6,21,9,12,347.9828476553623,0.8826884920634921,0.2849323146343965,0.19785310480976315,130180.80210387896,-739.8627547666076,129440.93934911235,3437,0,515.4489795918367,38,11,21,35.99377093802346,0.618421052631579,44.87179487179487,1020.51282051282,26.855600539811054,0
3461,4,0,0,48,0.0,0.0,1.0,48,2000,1600,400,0.8,24,16,8,342.6299739750014,0.8809840425531915,0.2784855726201987,0.19535993188495013,130290.57167830471,-671.6832812178596,129618.88839708685,3438,1,524.8125,37,11,21,36.01911269824222,0.6213400900900901,44.764254385964904,1020.9429824561391,27.593053579895653,0
3462,4,0,0,48,0.0,0.0,1.0,48,1150,900,250,0.782608695652174,14,9,5,330.2439432223543,0.8814642434988179,0.23749999999999982,0.18417450679708228,129424.43828870429,-974.9122326100282,128449.52605609426,3439,2,525.8125,37,11,20,37.21309267241379,0.6126126126126126,45.6140350877193,1017.5438596491233,27.501185395922253,8
3463,4,0,0,48,0.0,0.0,1.0,48,800,600,200,0.75,10,6,4,334.2086970017171,0.8808916962174941,0.24556761463607346,0.1867826209673053,129508.13140822187,-943.4512301861982,128564.68017803568,3440,3,526.8125,37,11,17,37.02724963194369,0.6134572072072071,45.53179824561404,1017.8728070175447,27.510075865339047,0
3464,4,0,0,48,0.0,0.0,1.0,48,1900,1600,300,0.8421052631578947,22,16,6,335.2404515769262,0.8808362884160756,0.2466231376772574,0.18762553302542267,129563.94184989615,-912.9851252308375,128650.9567246653,3441,4,527.8125,37,11,17,36.94433225632741,0.6140202702702702,45.47697368421053,1018.092105263158,27.51600284495022,0
3465,4,0,1,47,0.0,0.020833333333333332,0.9791666666666666,48,1600,1200,400,0.75,20,12,8,335.64987063187044,0.8801159869976359,0.24874865446716932,0.18852402044559116,129703.52055440143,-893.0060210833983,128810.51453331803,3442,5,528.8125,37,11,19,36.792249730893445,0.6154279279279278,45.33991228070176,1018.6403508771936,27.530820293978206,0
3466,4,0,0,47,0.0,0.0,1.0,47,1150,700,450,0.6086956521739131,16,7,9,331.48699275235435,0.8809744064138143,0.23729527428381747,0.18685091556295555,129843.17440222,-791.7353175977137,129051.43908462228,3443,6,519.5531914893617,37,10,19,36.75665680473372,0.6168355855855854,45.202850877192986,1019.1885964912287,27.545637743006182,0
3467,4,0,1,46,0.0,0.02127659574468085,0.9787234042553191,47,1500,1100,400,0.7333333333333333,19,11,8,330.73277354570655,0.8812827628738822,0.1715425531914898,0.17954064849624063,128355.55555555547,-909.0459324022829,127446.5096231532,3444,7,520.5531914893617,39,8,17,38.28810307017544,0.5982905982905983,46.666666666666664,1013.3333333333327,25.982905982905965,5
3468,4,1,0,47,0.02127659574468085,0.0,1.0,47,850,600,250,0.7058823529411765,11,6,5,334.413302377286,0.8828245451742214,0.19116162609299847,0.18274504705667846,128619.58007812499,-797.5802951388895,127821.9997829861,3445,0,521.1276595744681,39,8,15,37.925737660026016,0.6009615384615385,46.40625,1014.3749999999999,26.009615384615383,0
3469,4,0,0,47,0.0,0.0,1.0,47,1250,800,450,0.64,17,8,9,331.43697391048033,0.8823234659266112,0.18246396018255373,0.1816536565021986,128736.86814230958,-866.3683984400689,127870.49974386951,3446,1,522.1276595744681,40,7,15,37.88178449829762,0.6005208333333333,46.29065040650407,1014.8373983739847,25.37093495934962,0
3470,4,1,0,48,0.020833333333333332,0.0,1.0,48,1250,600,650,0.48,19,6,13,327.9344440112111,0.8862293144208038,0.19014814995606777,0.18127536481418427,129075.34490937582,-1134.3497063177067,127940.99520305812,3447,0,512.2291666666666,41,7,17,37.62640746526083,0.6023882113821137,45.95734126984127,1016.1706349206352,24.784649632210613,0
3471,4,2,0,50,0.04,0.0,1.0,50,1200,900,300,0.75,15,9,6,317.7094715648458,0.890765306122449,0.19904091341579466,0.17818177941016686,129645.08311549775,-1762.04431860568,127883.03879689207,3448,0,492.7,42,8,16,37.308317475420246,0.6066468253968255,45.39728682170542,1018.4108527131774,24.247877445551843,0
3472,4,1,2,49,0.0196078431372549,0.0392156862745098,0.9607843137254902,51,1500,1100,400,0.7333333333333333,19,11,8,314.16548709173463,0.8920588235294119,0.20466164851191637,0.17748979878743387,129931.9712362824,-2035.971793552829,127895.99944272958,3449,0,484.01960784313724,44,7,16,37.108156994520634,0.6067708333333335,45.11574074074073,1019.5370370370357,23.171296296296266,0
3473,4,0,0,49,0.0,0.0,1.0,49,1150,800,350,0.6956521739130435,15,8,7,321.8543886352107,0.8846017573696145,0.2035923958624546,0.18073361823361817,129694.42942130867,-1451.4557418424547,128242.97367946622,3450,2,504.734693877551,42,7,16,37.15277777777777,0.6071428571428572,45.34883720930232,1018.6046511627894,24.25249169435213,0
3474,4,0,0,49,0.0,0.0,1.0,49,1900,1300,600,0.6842105263157895,25,13,12,322.3835156174111,0.8838222789115646,0.2062080084434197,0.18183121719997536,129867.2154336425,-1426.5901050117445,128440.62532863076,3451,3,505.734693877551,42,7,17,36.96426307950692,0.6088789682539684,45.17926356589146,1019.2829457364317,24.268641565153136,0
3475,4,0,0,49,0.0,0.0,1.0,49,1100,800,300,0.7272727272727273,14,8,6,326.95804821644606,0.8826530612244898,0.21150489842459264,0.18499497308762758,129990.70443482934,-1299.6985983414718,128691.00583648786,3452,4,506.734693877551,42,7,17,36.72261022424934,0.6101190476190477,45.05813953488371,1019.7674418604628,24.280177187153875,0
3476,4,0,0,49,0.0,0.0,1.0,49,1000,500,500,0.5,15,5,10,325.79904249797426,0.8827593537414966,0.21164624299420498,0.184689634915249,130064.82600392099,-1325.0008450513876,128739.8251588696,3453,5,507.734693877551,42,7,17,36.67711598746081,0.6108630952380953,44.985465116279066,1020.0581395348834,24.287098560354366,0
3477,4,0,1,48,0.0,0.02040816326530612,0.9795918367346939,49,1150,800,350,0.6956521739130435,15,8,7,324.270633291694,0.8803146258503401,0.21059565951131298,0.1845241804679311,130213.13252095695,-1355.1410109068245,128857.99151005012,3454,6,508.734693877551,42,7,18,36.566030570587685,0.6123511904761906,44.840116279069754,1020.6395348837183,24.3009413067552,0
3478,4,0,0,48,0.0,0.0,1.0,48,1350,900,450,0.6666666666666666,18,9,9,333.02790503956714,0.8782136524822695,0.2170918367346939,0.18974845752254368,130262.58680555524,-923.7847222222574,129338.80208333298,3455,7,518.5208333333334,41,7,18,36.2925170068027,0.6143292682926831,44.79166666666665,1020.8333333333309,24.898373983739777,0
3479,4,3,0,51,0.058823529411764705,0.0,1.0,51,1800,1200,600,0.6666666666666666,24,12,12,326.32638521433745,0.8840849673202615,0.2626487066903398,0.1906614455534242,131233.23473936884,-1635.0265775034404,129598.2081618654,3456,0,488.96078431372547,44,7,18,35.48350051207906,0.6197916666666667,43.84259259259259,1024.6296296296284,23.28703703703701,0
3480,4,0,2,49,0.0,0.0392156862745098,0.9607843137254902,51,1100,800,300,0.7272727272727273,14,8,6,326.6353979922138,0.8840522875816994,0.25975475579225993,0.19096006072793603,131256.95408950615,-1625.3665123456833,129631.58757716046,3457,1,489.96078431372547,44,7,19,35.45168067226891,0.6200284090909092,43.81944444444444,1024.7222222222222,23.28914141414141,0
3481,4,0,1,48,0.0,0.02040816326530612,0.9795918367346939,49,1200,1000,200,0.8333333333333334,14,10,4,335.04043163575693,0.8768069727891157,0.26072572223820023,0.1956036711035261,131204.00221027882,-1008.2708934258719,130195.73131685295,3458,2,508.6326530612245,42,7,19,35.28977111510451,0.6222718253968254,43.87112403100775,1024.515503875969,24.393226282761166,0
3482,4,0,1,47,0.0,0.020833333333333332,0.9791666666666666,48,1900,1700,200,0.8947368421052632,21,17,4,341.40831388850035,0.875849586288416,0.25646301316808673,0.19943806933486627,131226.45817586317,-639.6392353237331,130586.81894053944,3459,3,520.0208333333334,41,7,21,35.10400529305449,0.6239837398373982,43.84920634920636,1024.6031746031765,24.99032133178479,0
3483,4,0,0,47,0.0,0.0,1.0,47,1250,800,450,0.64,17,8,9,345.14408304565507,0.8732654949121184,0.2580887583832401,0.20119764100735493,131145.89659139776,-347.153955152309,130798.74263624546,3460,4,531.6170212765958,40,7,21,35.08966663359462,0.6247395833333331,43.92784552845531,1024.2886178861825,25.607215447154562,0
3484,4,0,0,47,0.0,0.0,1.0,47,1200,600,600,0.5,18,6,12,350.88175889175983,0.8729185938945421,0.266736990896528,0.2053768159270693,131302.08462431445,-185.6987201731505,131116.3859041413,3461,5,532.6170212765958,40,7,21,34.78495290034706,0.6263020833333333,43.77540650406505,1024.8983739837417,25.622459349593544,0
3485,4,1,1,47,0.020833333333333332,0.020833333333333332,0.9791666666666666,48,1450,800,650,0.5517241379310345,21,8,13,359.36096506931494,0.8731346040189125,0.26510286131996685,0.20780438414877783,130835.79881656807,-196.5364684472859,130639.26234812078,3462,0,522.5,38,10,18,35.03942147034254,0.625,44.23076923076923,1023.0769230769232,26.923076923076927,1
3486,4,0,0,47,0.0,0.0,1.0,47,900,600,300,0.6666666666666666,12,6,6,367.8376974415259,0.8733811285846438,0.26900727737347885,0.21255557954149723,130808.47447083423,223.2576110380544,131031.7320818723,3463,7,534.6170212765958,38,9,19,34.8503046127067,0.6247258771929824,44.25747863247863,1022.9700854700853,26.920265407107507,0
3487,4,0,0,47,0.0,0.0,1.0,47,1300,900,400,0.6923076923076923,17,9,8,368.5734303480743,0.8712226333641689,0.26540858988154636,0.21393804489252977,130981.3490125869,255.24902343751148,131236.5980360244,3464,8,535.6170212765958,39,8,19,34.65632526033717,0.624732905982906,44.08854166666667,1023.6458333333342,26.24732905982908,0
3488,4,0,0,47,0.0,0.0,1.0,47,1900,1400,500,0.7368421052631579,24,14,10,365.46834877344935,0.8696423065063212,0.2666164564112219,0.21272464989886208,131088.00048828125,181.70301649305543,131269.7035047743,3465,9,536.6170212765958,39,8,19,34.62781422710473,0.625801282051282,43.984375,1024.0625,26.25801282051282,0
3489,4,0,0,47,0.0,0.0,1.0,47,1000,600,400,0.6,14,6,8,362.47467571199894,0.8695266728337958,0.26457924958567536,0.21142206174091346,131168.01757812515,109.01692708334838,131277.0345052085,3466,10,537.6170212765958,39,8,19,34.62350010168802,0.6266025641025641,43.90625000000001,1024.3750000000011,26.26602564102567,0
3490,4,1,1,47,0.020833333333333332,0.020833333333333332,0.9791666666666666,48,1600,1200,400,0.75,20,12,8,354.7234460179366,0.8697916666666666,0.25185392117025573,0.20834711232700287,131434.9175347223,-275.29296874999443,131159.6245659723,3467,0,527.3958333333334,39,9,20,34.552349993227686,0.6292735042735043,43.645833333333336,1025.4166666666672,26.292735042735057,0
3491,4,0,0,47,0.0,0.0,1.0,47,1350,900,450,0.6666666666666666,18,9,9,361.1859081898273,0.8685630588960838,0.26008620613198796,0.2118545216986296,131382.8849806413,90.72932646649855,131473.6143071078,3468,12,539.6170212765958,38,9,20,34.439262887314165,0.6304824561403508,43.69658119658119,1025.2136752136744,26.979307242465115,0
3492,4,0,0,47,0.0,0.0,1.0,47,1150,800,350,0.6956521739130435,15,8,7,366.04755172084333,0.8677921677459142,0.2631890300238624,0.21578604292051917,131574.6348002958,232.51458744246173,131807.14938773826,3469,13,540.6170212765958,38,9,19,34.12084765177549,0.6324013157894738,43.50961538461538,1025.9615384615379,26.998987854251,0
3493,4,0,0,47,0.0,0.0,1.0,47,1250,800,450,0.64,17,8,9,342.4160344448544,0.8670983657107616,0.21007929973566775,0.19779561519108677,130794.81336805574,-442.75173611109204,130352.06163194464,3470,14,541.6170212765958,39,8,20,35.5142566191446,0.6228632478632478,44.27083333333334,1022.9166666666681,26.228632478632516,3
3494,4,0,0,47,0.0,0.0,1.0,47,1300,900,400,0.6923076923076923,17,9,8,370.2874333033025,0.8669441874807277,0.15417420898007062,0.2043565411074348,129011.37689248659,173.78957328876376,129185.16646577536,3471,15,542.6170212765958,38,9,20,36.61574999123637,0.6066337719298246,46.02029914529914,1015.9188034188028,26.73470535312639,6
3495,4,2,2,47,0.04081632653061224,0.04081632653061224,0.9591836734693877,49,1150,800,350,0.6956521739130435,15,8,7,353.56385681512813,0.8749645691609977,0.15002123027165704,0.1972100623568823,129430.46932067185,-647.0535160807368,128783.41580459112,3472,0,521.4285714285714,36,13,17,36.61373026412868,0.6145833333333335,45.6081081081081,1017.5675675675661,28.265765765765725,0
3496,4,1,1,47,0.020833333333333332,0.020833333333333332,0.9791666666666666,48,1750,1300,450,0.7428571428571429,22,13,9,359.75297255094176,0.8723034869976359,0.15091370943281746,0.2006946785956775,129436.8355624141,-286.9427297668267,129149.89283264727,3473,0,533.2708333333334,35,13,18,36.449802851076726,0.6166666666666668,45.60185185185184,1017.5925925925912,29.074074074074037,0
3497,4,2,2,47,0.04081632653061224,0.04081632653061224,0.9591836734693877,49,1200,700,500,0.5833333333333334,17,7,10,350.93579357374244,0.875389739229025,0.15941736143445784,0.19739076234184105,129759.37307633106,-692.558287165293,129066.81478916577,3474,0,523.3469387755102,37,12,19,36.34622973166882,0.615990990990991,45.28508771929824,1018.8596491228061,27.536747273589356,0
3498,4,0,0,47,0.0,0.0,1.0,47,1100,700,400,0.6363636363636364,15,7,8,362.49620712193064,0.8698735738513721,0.17199039712646824,0.2033130900814306,129647.68005540162,-0.6415435518681534,129647.03851184975,3475,1,546.0,37,10,19,36.16539262130346,0.6148648648648649,45.39473684210526,1018.4210526315786,27.524893314366988,0
3499,4,0,0,47,0.0,0.0,1.0,47,1500,1300,200,0.8666666666666667,17,13,4,362.75495602178813,0.8697964847363552,0.16929665849804154,0.20374809803158472,129703.52055440134,10.118978916587423,129713.63953331794,3476,2,547.0,37,10,21,36.10199138858988,0.6154279279279279,45.33991228070175,1018.6403508771929,27.530820293978184,0
3500,4,0,0,47,0.0,0.0,1.0,47,1100,800,300,0.7272727272727273,14,8,6,358.79151722562,0.8699892075238975,0.16640715971500297,0.2020161447047205,129799.4797373805,-85.80954598581758,129713.67019139469,3477,3,548.0,38,9,21,36.1053592646956,0.6145833333333333,45.2457264957265,1019.017094017095,26.816239316239344,0
3501,4,0,0,47,0.0,0.0,1.0,47,1550,1000,550,0.6451612903225806,21,10,11,372.7084938081373,0.8707215541165587,0.17337610903819423,0.20700103732829034,129261.91184807238,239.52590089835832,129501.43774897074,3478,4,549.0,34,13,22,36.29858346991337,0.6170343137254903,45.77380952380951,1016.9047619047604,29.90896358543413,3
3502,4,3,3,47,0.06,0.06,0.94,50,1100,700,400,0.6363636363636364,15,7,8,351.0657085388223,0.8793877551020408,0.16289845960389804,0.1983552431371211,129935.6020915514,-876.8131574622204,129058.78893408917,3479,0,517.0,38,12,15,36.163942156554526,0.6159539473684212,45.112179487179475,1019.5512820512803,26.830296896086324,0
3503,4,2,1,48,0.04081632653061224,0.02040816326530612,0.9795918367346939,49,1350,900,450,0.6666666666666666,18,9,9,355.4186814141819,0.8777636054421769,0.17267525005183826,0.2013757953389431,130044.55133912252,-555.9474075900489,129488.60393153247,3480,0,528.5102040816327,38,11,16,35.94235536468699,0.6170504385964912,45.005341880341874,1019.9786324786314,26.841542959963984,0
3504,4,0,1,47,0.0,0.020833333333333332,0.9791666666666666,48,1400,1000,400,0.7142857142857143,18,10,8,363.8786248079853,0.8744459219858156,0.17845176664516593,0.20613879220242867,130038.81602993223,-136.33089027393567,129902.4851396583,3481,1,540.5208333333334,37,11,16,35.73245896939726,0.6188063063063063,45.0109649122807,1019.9561403508768,27.56638217164532,0
3505,4,0,1,46,0.0,0.02127659574468085,0.9787234042553191,47,1100,500,600,0.45454545454545453,17,5,12,368.6704519312044,0.8712226333641689,0.20374535704391072,0.20959169607280886,130176.38204082457,198.4371195519799,130374.81916037654,3482,2,552.4893617021277,36,11,17,35.470462738174064,0.6221064814814815,44.876126126126124,1020.4954954954951,28.347097097097087,0
3506,4,1,0,47,0.02127659574468085,0.0,1.0,47,1750,1300,450,0.7428571428571429,22,13,9,359.1313208884691,0.8727644156645081,0.2177382053654029,0.20650050951086954,130617.28395061713,-18.2199231889727,130599.06402742816,3483,0,551.5957446808511,35,12,16,35.26664402173913,0.6285714285714286,44.444444444444436,1022.2222222222209,29.20634920634917,0
3507,4,0,1,46,0.0,0.02127659574468085,0.9787234042553191,47,1150,900,250,0.782608695652174,14,9,5,359.82658661340554,0.8721862473018809,0.21659107168235203,0.2070585172349322,130646.86381440745,2.04301161692635,130648.90682602438,3484,1,552.5957446808511,35,12,16,35.21889976980264,0.6288690476190477,44.41550925925925,1022.3379629629619,29.209656084656054,0
3508,4,0,1,45,0.0,0.021739130434782608,0.9782608695652174,46,1550,1300,250,0.8387096774193549,18,13,5,358.1783715846544,0.8703301127214171,0.21504471796688196,0.2069006828800765,130794.81336805534,169.57465277775287,130964.3880208331,3485,2,563.3913043478261,35,11,16,35.111167684996595,0.6303571428571428,44.27083333333332,1022.9166666666649,29.226190476190425,0
3509,4,0,0,45,0.0,0.0,1.0,45,1300,1200,100,0.9230769230769231,14,12,2,366.4615297046546,0.8681397306397307,0.22157547535894495,0.2112687610847637,130718.71456916085,580.6760204081475,131299.390589569,3486,3,575.7555555555556,34,11,16,34.976474582848276,0.6317401960784315,44.34523809523809,1022.6190476190463,30.077030812324892,0
3510,4,0,0,45,0.0,0.0,1.0,45,1350,900,450,0.6666666666666666,18,9,9,364.750926475707,0.868013468013468,0.21552538964303647,0.2110208239558408,130854.01663237298,545.824759945114,131399.8413923181,3487,4,576.7555555555556,35,10,17,34.88310708898943,0.630952380952381,44.212962962962955,1023.1481481481471,29.232804232804202,0
3511,4,0,0,45,0.0,0.0,1.0,45,1050,800,250,0.7619047619047619,13,8,5,361.68152529715786,0.8670875420875421,0.21733865902981941,0.21021253434813778,131031.70680084011,478.3495156035591,131510.05631644366,3488,5,577.7555555555556,35,10,18,34.78172808802473,0.6327380952380952,44.03935185185185,1023.8425925925919,29.252645502645482,0
3512,4,0,0,45,0.0,0.0,1.0,45,1100,900,200,0.8181818181818182,13,9,4,361.25723832531315,0.866372053872054,0.22637947482050502,0.21093991251026845,131209.51753257873,480.0775891632227,131689.59512174196,3489,6,578.7555555555556,35,10,19,34.61270522669077,0.6345238095238095,43.86574074074073,1024.537037037036,29.272486772486744,0
3513,4,0,1,44,0.0,0.022222222222222223,0.9777777777777777,45,1100,800,300,0.7272727272727273,14,8,6,361.5572741093265,0.866456228956229,0.22728093947606132,0.2117692605497482,131328.1249999999,496.58136145403284,131824.70636145395,3490,7,579.7555555555556,34,11,19,34.48509485094851,0.6378676470588236,43.74999999999999,1024.9999999999993,30.14705882352939,0
3514,4,1,0,45,0.022222222222222223,0.0,1.0,45,800,400,400,0.5,12,4,8,359.0642500089177,0.8668771043771044,0.2234863305743675,0.21096215219356795,131446.78605109712,439.56832990395003,131886.35438100106,3491,0,579.8,35,10,20,34.42908201655381,0.636904761904762,43.634259259259245,1025.4629629629608,29.298941798941737,0
3515,4,2,3,44,0.0425531914893617,0.06382978723404255,0.9361702127659575,47,1150,700,450,0.6086956521739131,16,7,9,343.5109792675553,0.8714539007092198,0.21449225324759436,0.20403724431193337,131862.52170138882,-340.7552083333381,131521.76649305547,3492,0,556.0851063829788,37,10,16,34.408806626098716,0.6371058558558559,43.229166666666664,1027.0833333333328,27.759009009008995,0
3516,4,1,1,44,0.022222222222222223,0.022222222222222223,0.9777777777777777,45,1200,700,500,0.5833333333333334,17,7,10,361.5704723827398,0.8662878787878788,0.219516167424612,0.213927186094898,131713.96933138295,524.7764221107741,132238.7457534937,3493,0,581.7555555555556,35,10,16,34.09499849663621,0.6395833333333333,43.373842592592595,1026.5046296296302,29.32870370370372,0
3517,4,0,0,44,0.0,0.0,1.0,44,600,500,100,0.8333333333333334,7,5,2,371.7200059919714,0.8612138830162086,0.22526032050808675,0.21894130496464936,131541.75347222228,979.3402777777881,132521.09375000006,3494,11,595.9772727272727,34,10,22,34.008597346330895,0.6400122549019608,43.54166666666667,1025.833333333334,30.171568627451,0
3518,4,1,2,43,0.022222222222222223,0.044444444444444446,0.9555555555555556,45,1200,600,600,0.5,18,6,12,361.2463319621978,0.8650673400673401,0.2126640617172626,0.21423646104068306,131803.09070644714,522.6766117969711,132325.76731824412,3495,0,583.7111111111111,35,10,17,34.01337541328522,0.6404761904761905,43.28703703703703,1026.8518518518513,29.33862433862432,0
3519,4,0,0,43,0.0,0.0,1.0,43,1750,1400,350,0.8,21,14,7,368.5275763197842,0.8607881136950905,0.22206282090003016,0.21828171828171825,131755.55555555547,1111.1111111111013,132866.66666666657,3496,13,604.2093023255813,34,9,17,33.874458874458874,0.6421568627450981,43.33333333333333,1026.666666666666,30.19607843137253,0
3520,4,0,0,43,0.0,0.0,1.0,43,850,700,150,0.8235294117647058,10,7,3,367.7183313228831,0.8605112587670727,0.21929914428525965,0.21815256712456582,131816.67375283426,1094.2814625850076,132910.95521541926,3497,14,605.2093023255813,34,9,18,33.83351688693097,0.6427696078431373,43.27380952380951,1026.9047619047603,30.203081232492952,0
3521,4,0,1,42,0.0,0.023255813953488372,0.9767441860465116,43,1000,700,300,0.7,13,7,6,369.83313162028765,0.8606035437430786,0.21710278056301235,0.21976034845866682,131877.806122449,1154.5564058956938,133032.36252834467,3498,15,606.2093023255813,34,9,18,33.7174992273219,0.6433823529411764,43.214285714285715,1027.1428571428573,30.21008403361345,0
3522,4,0,0,42,0.0,0.0,1.0,42,1150,800,350,0.6956521739130435,15,8,7,372.41169111648514,0.8584252806813782,0.2243843147946203,0.22175423425572505,131956.93963860034,1428.4614090734117,133385.40104767375,3499,16,618.2857142857143,33,9,20,33.57138597328244,0.6464646464646466,43.13725490196077,1027.4509803921553,31.134878193701677,0
3523,4,0,0,42,0.0,0.0,1.0,42,1050,800,250,0.7619047619047619,13,8,5,371.876974564498,0.8585220673635308,0.22259988073941606,0.22161964688865068,131988.41979346875,1416.69084606881,133405.11063953757,3500,17,619.2857142857143,33,9,20,33.55334426555357,0.6467803030303031,43.10661764705882,1027.573529411764,31.138591800356483,0
3524,4,0,1,41,0.0,0.023809523809523808,0.9761904761904762,42,1150,900,250,0.782608695652174,14,9,5,372.3423509172196,0.8575783972125436,0.23105170554515064,0.22282113581993357,132145.8768862935,1440.7012927719816,133586.5781790655,3501,18,620.2857142857143,33,9,20,33.382499006754074,0.648358585858586,42.953431372549005,1028.186274509802,31.157159833630363,0
3525,4,0,0,41,0.0,0.0,1.0,41,1300,800,500,0.6153846153846154,18,8,10,377.07931758584755,0.8553861788617886,0.22523196859067607,0.2253342496438609,132091.88102324252,1761.82327097504,133853.70429421755,3502,19,626.390243902439,34,7,21,33.31523837097085,0.6455269607843138,43.00595238095237,1027.9761904761895,30.234593837534984,0
3526,4,0,1,40,0.0,0.024390243902439025,0.975609756097561,41,1050,700,350,0.6666666666666666,14,7,7,374.9942333965467,0.8546747967479674,0.22547212160395702,0.22481437767611145,132214.28748582763,1715.9190759637136,133930.20656179136,3503,20,627.390243902439,34,7,21,33.245311957402485,0.6467524509803921,42.88690476190476,1028.4523809523807,30.248599439775905,0
3527,4,0,0,40,0.0,0.0,1.0,40,850,700,150,0.8235294117647058,10,7,3,374.39849393015123,0.852991452991453,0.22258185815110498,0.22518623403189242,132336.75063775497,1909.3360260770748,134246.08666383204,3504,21,639.475,34,6,21,33.13712445524316,0.6479779411764707,42.76785714285713,1028.9285714285702,30.26260504201677,0
3528,4,0,0,40,0.0,0.0,1.0,40,1000,700,300,0.7,13,7,6,375.17336362436964,0.853258547008547,0.21823133706393616,0.22620826138414066,132429.5361910082,1936.8210795347443,134366.35727054294,3505,22,640.475,33,7,22,33.02364864864863,0.651199494949495,42.67769607843137,1029.289215686274,31.190582293523455,0
3529,4,0,0,40,0.0,0.0,1.0,40,850,500,350,0.5882352941176471,12,5,7,378.09523809523813,0.8525641025641025,0.22016666666666662,0.22816091954022977,132461.0726643598,2016.5801614763434,134477.65282583612,3506,23,641.475,33,7,22,32.91666666666666,0.6515151515151516,42.647058823529406,1029.4117647058818,31.194295900178236,0
3530,4,0,0,40,0.0,0.0,1.0,40,900,700,200,0.7777777777777778,11,7,4,378.27978025166215,0.8511485042735043,0.22394680471260275,0.22884701176779826,132555.70461180797,2028.628562331795,134584.33317413976,3507,24,642.475,33,7,22,32.81652881907255,0.6524621212121213,42.55514705882353,1029.779411764706,31.205436720142607,0
3531,4,1,0,41,0.024390243902439025,0.0,1.0,41,450,200,250,0.4444444444444444,7,2,5,368.5279207721503,0.8544715447154472,0.22418518445491697,0.22456602856903915,132827.17013888873,1590.1041666666479,134417.2743055554,3508,0,627.780487804878,34,7,18,32.79439504176773,0.6528799019607844,42.29166666666666,1030.833333333332,30.31862745098035,0
3532,4,1,1,41,0.023809523809523808,0.023809523809523808,0.9761904761904762,42,1000,600,400,0.6,14,6,8,359.8129101054496,0.8526422764227642,0.20428684537948194,0.22081812704722203,133092.5905901577,1180.8114667435702,134273.40205690125,3509,0,613.8095238095239,33,9,18,32.75237529691212,0.6578282828282829,42.0343137254902,1031.8627450980398,31.268568033273933,1
3533,4,1,1,41,0.023809523809523808,0.023809523809523808,0.9761904761904762,42,1200,1000,200,0.8333333333333334,14,10,4,360.0989973684147,0.8541666666666666,0.20631167932517247,0.22160528077938427,133195.5800028345,1192.7189625850356,134388.29896541953,3510,0,614.7857142857143,34,8,19,32.6416118863645,0.6565563725490196,41.93452380952381,1032.261904761905,30.36064425770309,0
3534,4,1,1,41,0.023809523809523808,0.023809523809523808,0.9761904761904762,42,1250,800,450,0.64,17,8,9,358.2786526375257,0.8542634533488193,0.2046338535414165,0.22159646394940502,133382.53821855696,1157.623215663565,134540.16143422053,3511,0,615.7142857142857,35,7,20,32.50105042016806,0.65625,41.753472222222214,1032.9861111111102,29.51388888888886,0
3535,4,0,0,41,0.0,0.0,1.0,41,1450,1000,450,0.6896551724137931,19,10,9,365.1321745052278,0.8496443089430894,0.2126660574963095,0.22544637820874397,133318.49666950115,1535.7745181405887,134854.27118764175,3512,2,631.7317073170732,34,7,20,32.38832853025936,0.657781862745098,41.81547619047619,1032.7380952380954,30.374649859943982,0
3536,4,0,0,41,0.0,0.0,1.0,41,950,600,350,0.631578947368421,13,6,7,365.30999884460607,0.8498983739837398,0.21147018892108926,0.225929783319647,133379.97626133793,1545.0077947845928,134924.9840561225,3513,3,632.7317073170732,34,7,21,32.32203910721833,0.6583946078431373,41.75595238095239,1032.976190476191,30.381652661064443,0
3537,4,1,0,42,0.023809523809523808,0.0,1.0,42,850,700,150,0.8235294117647058,10,7,3,356.8773087921504,0.8550377468060395,0.2112312293102625,0.22215923341047236,133621.76254125938,1137.3150023576816,134759.07754361705,3514,0,618.6428571428571,35,7,22,32.29749710810106,0.6586309523809524,41.52199074074074,1033.9120370370367,29.540343915343907,0
3538,4,0,0,42,0.0,0.0,1.0,42,900,700,200,0.7777777777777778,11,7,4,355.42911735216074,0.8549893534649632,0.2047576416421535,0.22179571177785662,133711.52692043895,1104.9939986282538,134816.5209190672,3515,1,619.6428571428571,35,7,16,32.24503879438972,0.6595238095238095,41.43518518518518,1034.2592592592591,29.550264550264547,0
3539,4,0,0,42,0.0,0.0,1.0,42,1150,900,250,0.782608695652174,14,9,5,355.1754382055925,0.8549167634533488,0.2049196048972286,0.22199706760011073,133771.3865847907,1102.4621699245433,134873.84875471526,3516,2,620.6428571428571,35,7,16,32.191672260759304,0.6601190476190477,41.37731481481481,1034.49074074074,29.556878306878286,0
3540,4,1,0,43,0.023255813953488372,0.0,1.0,43,1000,800,200,0.8,12,8,4,348.7942753529326,0.8541435954226652,0.21233349428780146,0.22021678373175194,134142.16739966316,757.6040144874573,134899.77141415063,3517,0,607.1860465116279,36,7,18,31.98604014929158,0.6617476851851851,41.01914414414414,1035.9234234234234,28.77565065065065,0
3541,4,0,0,43,0.0,0.0,1.0,43,1200,1000,200,0.8333333333333334,14,10,4,348.404052658637,0.8534514581026209,0.21153919063398074,0.2203206658771215,134200.5027620526,751.1998062251454,134951.70256827775,3518,1,608.1860465116279,36,7,19,31.937878129188853,0.6623263888888888,40.96283783783784,1036.1486486486488,28.78190690690691,0
3542,4,0,0,43,0.0,0.0,1.0,43,900,600,300,0.6666666666666666,12,6,6,349.9740023253596,0.8530361757105943,0.21263830410982476,0.22148973654731482,134229.67519884746,795.3793320347343,135025.0545308822,3519,2,609.1860465116279,36,7,19,31.868072158226486,0.6626157407407407,40.93468468468468,1036.2612612612609,28.785035035035023,0
3543,4,0,3,40,0.0,0.06976744186046512,0.9302325581395349,43,1150,800,350,0.6956521739130435,15,8,7,352.36393795616266,0.8510981912144703,0.2140646514154343,0.22353618531264458,134317.21153163278,865.708318115395,135182.91984974817,3520,3,610.1860465116279,36,7,19,31.718721709216013,0.6634837962962964,40.850225225225216,1036.5990990990977,28.79441941941938,0
3544,4,0,0,40,0.0,0.0,1.0,40,1300,1000,300,0.7692307692307693,16,10,6,341.88180755192815,0.847008547008547,0.1345019157088121,0.2053313814587025,132282.13168827622,1045.1737632903275,133327.30545156656,3521,4,577.775,36,4,15,34.02846195949644,0.6432291666666665,42.82094594594595,1028.716216216217,28.57545045045047,6
3545,4,0,2,38,0.0,0.05,0.95,40,850,600,250,0.7058823529411765,11,6,5,343.71977904899245,0.847275641025641,0.13896761133603253,0.20707020835390555,132398.0034722224,1101.5625000000205,133499.56597222242,3522,5,578.775,36,4,16,33.86470985155196,0.6443865740740741,42.70833333333334,1029.166666666668,28.587962962963005,0
3546,4,1,0,39,0.02564102564102564,0.0,1.0,39,900,500,400,0.5555555555555556,13,5,8,354.0073471669866,0.8432860998650472,0.15276203986425507,0.21343642971905155,132427.78427479847,1576.0817204646721,134003.86599526313,3523,0,591.1025641025641,35,4,17,33.570059784849505,0.6467261904761905,42.679398148148145,1029.282407407407,29.40806878306877,0
3547,4,0,0,39,0.0,0.0,1.0,39,1450,1100,350,0.7586206896551724,18,11,7,356.0510026395902,0.8421052631578948,0.14863552393056745,0.2153491346352435,132546.94097490126,1638.6942461848232,134185.6352210861,3524,1,592.1025641025641,35,4,18,33.397610617811246,0.6479166666666668,42.5636574074074,1029.745370370369,29.42129629629626,0
3548,4,0,1,38,0.0,0.02564102564102564,0.9743589743589743,39,1000,700,300,0.7,13,7,6,353.6883473517082,0.8419928025191183,0.14077934199268904,0.21459986228885827,132666.15125868042,1584.4943576388703,134250.6456163193,3525,2,593.1025641025641,35,4,15,33.33859959555105,0.6491071428571429,42.44791666666666,1030.2083333333321,29.434523809523775,0
3549,4,2,3,37,0.05,0.075,0.925,40,500,300,200,0.6,7,3,4,346.3995848141856,0.852056623931624,0.12860926067489342,0.2116064708568041,132920.05423920526,1208.6903203879301,134128.74455959318,3526,0,579.025,36,4,15,33.271449892614015,0.6495949074074076,42.201576576576564,1031.1936936936922,28.64426926926923,0
3550,4,0,0,37,0.0,0.0,1.0,37,1200,900,300,0.75,15,9,6,368.59297052154216,0.8364614614614615,0.14720720720720748,0.22242679255610265,132461.07266435956,2364.8440503652055,134825.91671472476,3527,44,626.8918918918919,33,4,19,33.16121031746031,0.6515151515151517,42.64705882352939,1029.41176470588,31.19429590017818,0
3551,4,0,0,37,0.0,0.0,1.0,37,1100,800,300,0.7272727272727273,14,8,6,367.8375627962992,0.836086086086086,0.14701003164764637,0.2226845875262965,132581.84700963684,2353.716695011297,134935.56370464814,3528,45,627.8918918918919,34,3,19,33.059039417408385,0.6504289215686276,42.529761904761884,1029.8809523809496,30.290616246498516,0
3552,4,0,0,37,0.0,0.0,1.0,37,1450,1300,150,0.896551724137931,16,13,3,371.7265605183893,0.8344594594594594,0.15048188933097673,0.2255905788728006,132673.8166099771,2463.676303854846,135137.49291383196,3529,46,628.8918918918919,34,3,15,32.86630459902935,0.6513480392156864,42.440476190476176,1030.2380952380934,30.301120448179216,0
3553,4,0,0,37,0.0,0.0,1.0,37,950,700,250,0.7368421052631579,12,7,5,370.94684300733786,0.833958958958959,0.15111033408365104,0.22567019113946024,132765.81809807237,2449.8122165532714,135215.63031462565,3530,47,629.8918918918919,34,3,15,32.793789226444886,0.6522671568627452,42.35119047619047,1030.5952380952367,30.311624649859905,0
3554,4,0,0,37,0.0,0.0,1.0,37,1250,900,350,0.72,16,9,7,372.5052526818389,0.8310185185185185,0.15972841925277903,0.22754869525600013,132919.2247732423,2502.621882086133,135421.84665532844,3531,48,630.8918918918919,34,3,15,32.599284229969975,0.6537990196078434,42.202380952380935,1031.1904761904739,30.329131652660998,0
3555,4,0,0,37,0.0,0.0,1.0,37,850,600,250,0.7058823529411765,11,6,5,371.9506918386994,0.8298923923923924,0.16400264530458486,0.2275833894131701,132980.61224489778,2492.4461451246952,135473.0583900225,3532,49,631.8918918918919,34,3,16,32.55184287473068,0.6544117647058825,42.14285714285713,1031.42857142857,30.33613445378147,0
3556,4,0,1,36,0.0,0.02702702702702703,0.972972972972973,37,1000,700,300,0.7,13,7,6,372.84375237395295,0.8287037037037037,0.16191274906236264,0.2290703394280506,133134.14292800444,2527.646683673459,135661.7896116779,3533,50,632.8918918918919,34,3,17,32.37445687699465,0.6559436274509804,41.99404761904761,1032.0238095238087,30.353641456582608,0
3557,4,0,0,36,0.0,0.0,1.0,36,650,400,250,0.6153846153846154,9,4,5,382.1049837147102,0.8278439153439154,0.1683891660727015,0.23410187430206908,133029.3712153979,2966.2371443675484,135995.60835976544,3534,51,647.6111111111111,33,3,17,32.240932129563625,0.6571969696969697,42.095588235294116,1031.6176470588234,31.261140819964346,0
3558,4,1,0,37,0.02702702702702703,0.0,1.0,37,1750,1200,550,0.6857142857142857,23,12,11,369.280516298325,0.8322697697697697,0.1291194106728084,0.212623005346924,130669.48596993953,2386.504139033073,133055.9901089726,3535,0,631.081081081081,33,4,18,34.95432797954372,0.6335227272727272,44.39338235294118,1022.426470588236,30.982620320855638,8
3559,4,0,1,36,0.0,0.02702702702702703,0.972972972972973,37,750,600,150,0.8,9,6,3,369.21123279185804,0.8304554554554554,0.13112057913207886,0.21344704787717667,130826.15460399848,2260.4971645520986,133086.65176855057,3536,1,632.081081081081,33,4,19,34.79725682798274,0.6351010101010102,44.240196078431374,1023.0392156862747,31.001188354129535,0
3560,4,2,2,36,0.05263157894736842,0.05263157894736842,0.9473684210526316,38,1150,800,350,0.6956521739130435,15,8,7,357.1055974983126,0.8385787102892366,0.1137496559527813,0.20833177399816813,131175.63952664405,1768.7110260771015,132944.35055272115,3537,0,602.2631578947369,34,4,19,34.7532926593066,0.6363357843137254,43.898809523809526,1024.4047619047624,30.129551820728306,0
3561,4,0,1,35,0.0,0.027777777777777776,0.9722222222222222,36,1100,800,300,0.7272727272727273,14,8,6,374.11103241617565,0.8263558201058202,0.12175531696079656,0.2163755671426319,130843.25140610665,2589.980773645567,133433.2321797522,3538,3,636.7222222222222,32,4,19,34.65460323337036,0.6376953125,44.22348484848486,1023.1060606060616,31.972064393939426,0
3562,4,0,0,35,0.0,0.0,1.0,35,900,500,400,0.5555555555555556,13,5,8,375.95585362927125,0.8238095238095238,0.1118959500898804,0.21798985332753046,130940.15438475675,2845.543503213966,133785.69788797072,3539,4,636.8285714285714,32,3,19,34.50915988156921,0.638671875,44.12878787878788,1023.4848484848492,31.983901515151537,0
3563,4,0,0,35,0.0,0.0,1.0,35,750,500,250,0.6666666666666666,10,5,5,376.69069924056794,0.823109243697479,0.10876735499330437,0.2187828215933042,131004.77629833695,2869.6561575349497,133874.4324558719,3540,5,637.8285714285714,32,3,20,34.42484788686071,0.6393229166666666,44.06565656565657,1023.7373737373741,31.99179292929294,0
3564,4,0,0,35,0.0,0.0,1.0,35,500,300,200,0.6,7,3,4,375.749415012336,0.8226190476190476,0.10855880545451524,0.2185139092982489,131053.71492346934,2848.6713435374068,133902.38626700675,3541,6,638.8285714285714,34,1,20,34.399343099639566,0.635110294117647,44.01785714285714,1023.928571428571,30.11554621848738,0
3565,4,0,0,35,0.0,0.0,1.0,35,900,400,500,0.4444444444444444,14,4,10,372.7322020522482,0.8224789915966386,0.10786934790189462,0.21710325892048024,131114.67013888893,2774.13194444445,133888.80208333337,3542,7,639.8285714285714,34,1,20,34.414835909953894,0.6357230392156863,43.958333333333336,1024.166666666667,30.122549019607852,0
3566,4,0,0,35,0.0,0.0,1.0,35,850,500,350,0.5882352941176471,12,5,7,371.3332349710871,0.8218487394957983,0.10903959491989701,0.2166320330119461,131175.63952664405,2741.9749149659906,133917.61444161003,3543,8,640.8285714285714,34,1,20,34.388921169862485,0.6363357843137254,43.898809523809526,1024.4047619047624,30.129551820728306,0
3567,4,1,1,35,0.027777777777777776,0.027777777777777776,0.9722222222222222,36,750,400,350,0.5333333333333333,11,4,7,364.0778622432507,0.8263558201058202,0.09471016175218683,0.2139267875418393,131450.17715419506,2371.7084750567024,133821.88562925177,3544,0,624.0,34,2,20,34.29712290070429,0.6390931372549019,43.63095238095239,1025.476190476191,30.161064425770324,0
3568,4,0,0,35,0.0,0.0,1.0,35,700,500,200,0.7142857142857143,9,5,4,373.1244629519464,0.8219887955182072,0.10058072009291519,0.21854432830042594,131328.12500000015,2800.3472222222376,134128.4722222224,3545,10,642.8285714285714,34,1,20,34.18868563685636,0.6378676470588235,43.75000000000001,1025.0000000000011,30.147058823529445,0
3569,4,0,1,34,0.0,0.02857142857142857,0.9714285714285714,35,600,400,200,0.6666666666666666,8,4,4,373.4481296238668,0.8214285714285714,0.1033899752369567,0.21891335699394862,131359.53006355738,2811.1941621011297,134170.72422565852,3546,11,643.8285714285714,33,2,20,34.14861028093245,0.6404671717171717,43.719362745098046,1025.1225490196086,31.064319667260868,0
3570,4,0,0,34,0.0,0.0,1.0,34,600,500,100,0.8333333333333334,7,5,2,376.58369530927695,0.8220068330362449,0.08470008693132414,0.22094361314388225,131392.84256708508,3096.080438220602,134488.9230053057,3547,12,634.9705882352941,32,2,20,34.03453407224957,0.6432291666666666,43.68686868686869,1025.252525252526,32.03914141414144,0
3571,4,0,0,34,0.0,0.0,1.0,34,650,300,350,0.46153846153846156,10,3,7,378.0172487759161,0.8221553773024362,0.08236163216825765,0.22216035416483285,131457.57607642072,3138.6462478318476,134596.22232425257,3548,13,635.9705882352941,32,2,20,33.932272428794214,0.6438802083333334,43.62373737373737,1025.5050505050501,32.047032828282816,0
3572,4,0,0,34,0.0,0.0,1.0,34,800,500,300,0.625,11,5,6,376.6330761617786,0.8207813428401665,0.08070049725316464,0.22228736455822648,131619.4795971075,3114.449896694221,134733.92949380173,3549,14,636.9705882352941,32,2,20,33.803986710963464,0.6455078125,43.46590909090909,1026.1363636363642,32.06676136363638,0
3573,4,0,0,34,0.0,0.0,1.0,34,1150,1000,150,0.8695652173913043,13,10,3,377.07355350096947,0.8184789067142009,0.07727775728513464,0.2236863027442295,131813.89534550058,3140.7067837465665,134954.60212924716,3550,15,637.9705882352941,32,2,20,33.596151481618094,0.6474609375,43.276515151515156,1026.8939393939402,32.09043560606063,0
3574,4,0,0,34,0.0,0.0,1.0,34,1150,700,450,0.6086956521739131,16,7,9,376.4807033600976,0.8194444444444445,0.07502543056578626,0.2243632336655591,131988.41979346873,3138.2186238465756,135126.6384173153,3551,16,638.9705882352941,33,1,20,33.43507751937983,0.6467803030303032,43.10661764705881,1027.5735294117635,31.13859180035647,0
3575,4,0,0,34,0.0,0.0,1.0,34,750,500,250,0.6666666666666666,10,5,5,372.26927888542093,0.8187759952465835,0.07196048046110803,0.22259208699713423,132114.37795859753,3036.4248426086,135150.80280120613,3552,17,639.9705882352941,33,1,20,33.41615508403863,0.6480429292929294,42.984068627450974,1028.063725490195,31.15344622697561,0
3576,4,1,0,35,0.02857142857142857,0.0,1.0,35,800,300,500,0.375,13,3,10,361.52587709965064,0.8182773109243697,0.07196550413851255,0.21815172779348732,132459.2704790247,2577.4907879818356,135036.76126700654,3553,0,622.6571428571428,34,1,22,33.34489803785513,0.6492034313725491,42.64880952380951,1029.40476190476,30.27661064425765,0
3577,4,0,0,35,0.0,0.0,1.0,35,600,400,200,0.6666666666666666,8,4,4,359.62593028792213,0.8169467787114846,0.07614422806930632,0.21735881698534157,132520.55165816317,2531.565334467109,135052.11699263027,3554,1,623.6571428571428,34,1,22,33.33212895517786,0.6498161764705883,42.58928571428571,1029.6428571428564,30.28361344537813,0
3578,4,0,0,35,0.0,0.0,1.0,35,1050,700,350,0.6666666666666666,14,7,7,360.60383500893505,0.8157563025210084,0.07676054013008016,0.21884050407905462,132673.8166099771,2568.537414965957,135242.35402494305,3555,2,624.6571428571428,34,1,18,33.15278098759724,0.6513480392156864,42.440476190476176,1030.2380952380934,30.301120448179216,0
3579,4,0,0,35,0.0,0.0,1.0,35,850,600,250,0.7058823529411765,11,6,5,358.611662613417,0.815546218487395,0.07411075348683682,0.21780939929256982,132704.48022959157,2517.874858276614,135222.3550878682,3556,3,625.6571428571428,34,1,18,33.17326208357403,0.6516544117647061,42.41071428571427,1030.3571428571408,30.304621848739437,0
3580,4,0,0,35,0.0,0.0,1.0,35,900,500,400,0.5555555555555556,13,5,8,360.10022496509004,0.8145658263305322,0.0749430749430755,0.21925089646608625,132796.4923469386,2564.009353741478,135360.5017006801,3557,4,626.6571428571428,34,1,18,33.04241741741741,0.6525735294117647,42.32142857142856,1030.7142857142844,30.31512605042013,0
3581,4,0,0,35,0.0,0.0,1.0,35,950,600,350,0.631578947368421,13,6,7,360.96985366707895,0.8129551820728291,0.07486683926716275,0.22068326339575886,132949.91673752826,2598.1823979591763,135548.09913548743,3558,5,627.6571428571428,34,1,19,32.86582785024434,0.6541053921568627,42.172619047619044,1031.3095238095232,30.33263305322127,0
3582,4,0,0,35,0.0,0.0,1.0,35,1000,500,500,0.5,15,5,10,359.79538502985656,0.8114845938375349,0.07420593713428603,0.22068978075398196,133072.72002551012,2575.7901077097404,135648.51013321985,3559,6,628.6571428571428,34,1,19,32.772777970078074,0.6553308823529412,42.05357142857142,1031.7857142857138,30.34663865546217,0
3583,4,0,0,35,0.0,0.0,1.0,35,850,500,350,0.5882352941176471,12,5,7,362.7058573123772,0.811204481792717,0.07308433695240324,0.22320954497910725,133195.58000283435,2662.1634070294654,135857.74340986382,3560,7,629.6571428571428,34,1,20,32.574337831084456,0.6565563725490196,41.9345238095238,1032.261904761904,30.360644257703058,0
3584,4,0,0,35,0.0,0.0,1.0,35,1000,700,300,0.7,13,7,6,362.83855833253887,0.8104341736694677,0.07666710595677384,0.2234755666093593,133226.3038548753,2667.9280045351475,135894.23185941044,3561,8,630.6571428571428,34,1,20,32.54007149446495,0.6568627450980392,41.904761904761905,1032.3809523809525,30.36414565826331,0
3585,4,0,0,35,0.0,0.0,1.0,35,1000,700,300,0.7,13,7,6,364.7988721307171,0.8100140056022408,0.07015291425937864,0.22598782378461754,133441.47002551012,2735.859552154193,136177.32957766432,3562,9,631.6571428571428,34,1,20,32.27354341898068,0.6590073529411764,41.69642857142857,1033.214285714285,30.388655462184857,0
3586,4,0,0,35,0.0,0.0,1.0,35,800,400,400,0.5,12,4,8,366.58793456375827,0.8088235294117646,0.07502344482650813,0.22785132683014414,133564.50007086174,2792.6268424036352,136357.12691326538,3563,10,632.6571428571428,34,1,20,32.10391953625857,0.6602328431372548,41.577380952380956,1033.6904761904768,30.40266106442579,0
3587,4,0,0,35,0.0,0.0,1.0,35,1000,700,300,0.7,13,7,6,364.9743097927964,0.8076330532212884,0.06814780706803236,0.2276045821371159,133687.58680555574,2758.5069444444634,136446.0937500002,3564,11,633.6571428571428,34,1,21,32.02222669889872,0.6614583333333333,41.45833333333334,1034.166666666668,30.41666666666671,0
3588,4,0,0,35,0.0,0.0,1.0,35,900,600,300,0.6666666666666666,12,6,6,367.84318505210194,0.807422969187675,0.06517271426927351,0.2297763792176645,133749.1514314059,2839.742772108847,136588.89420351473,3565,12,634.6571428571428,34,1,19,31.886340967506825,0.6620710784313726,41.398809523809526,1034.404761904762,30.423669467787114,0
3589,4,0,0,35,0.0,0.0,1.0,35,550,300,250,0.5454545454545454,8,3,5,369.3135792596629,0.8064425770308122,0.0689961212280592,0.2312733163490626,133841.52494331065,2885.898526077097,136727.42346938775,3566,13,635.6571428571428,34,1,20,31.75573324129469,0.6629901960784313,41.30952380952381,1034.7619047619046,30.434173669467782,0
3590,4,0,0,35,0.0,0.0,1.0,35,700,400,300,0.5714285714285714,10,4,6,369.5680443780033,0.8060924369747898,0.06612874069448349,0.23162617229834048,133872.32320011334,2894.9865362811793,136767.30973639453,3567,14,636.6571428571428,34,1,20,31.718288661375063,0.663296568627451,41.279761904761905,1034.8809523809523,30.437675070028007,0
3591,4,0,0,35,0.0,0.0,1.0,35,950,700,250,0.7368421052631579,12,7,5,369.30159178177473,0.8065826330532212,0.06673018793533969,0.2320409423507453,133964.73922902506,2894.6782879818725,136859.41751700692,3568,15,637.6571428571428,34,1,20,31.63259927936216,0.6642156862745097,41.1904761904762,1035.238095238096,30.44817927170871,0
3592,4,0,1,34,0.0,0.02857142857142857,0.9714285714285714,35,650,300,350,0.46153846153846156,10,3,7,368.8698862231717,0.8061624649859943,0.06432431544539186,0.23196394797418132,133995.55165816337,2885.3847789115766,136880.93643707494,3569,16,638.6571428571428,34,1,20,31.612912498562725,0.6645220588235293,41.16071428571429,1035.3571428571436,30.451680672268928,0
3593,4,0,0,34,0.0,0.0,1.0,34,500,200,300,0.4,8,2,6,374.79764528464847,0.8022875816993464,0.06655687017319067,0.23538406763713215,133947.52206182727,3240.643172097278,137188.16523392455,3570,17,650.9705882352941,33,1,20,31.50761118345764,0.6663510101010102,41.20710784313726,1035.1715686274515,31.368835412953075,0
3594,4,0,1,33,0.0,0.029411764705882353,0.9705882352941176,34,1350,900,450,0.6666666666666666,18,9,9,374.76367257873216,0.8022875816993464,0.06468221091253423,0.23576904464763265,134010.9592013888,3244.4878472222113,137255.447048611,3571,18,651.9705882352941,33,1,21,31.44491951710261,0.6669823232323233,41.14583333333333,1035.4166666666658,31.3762626262626,0
3595,4,0,0,33,0.0,0.0,1.0,33,1000,700,300,0.7,13,7,6,387.32421177870333,0.8005050505050506,0.06273466371027347,0.24356277121053405,133994.6178961329,3779.871951841629,137774.48984797453,3572,19,667.5151515151515,32,1,22,31.136178861788608,0.6692708333333335,41.16161616161615,1035.3535353535342,32.354797979797944,0
3596,4,0,0,33,0.0,0.0,1.0,33,650,300,350,0.46153846153846156,10,3,7,388.4006380944077,0.7998737373737375,0.06641395668462269,0.2446745033525599,134059.98909550035,3813.7970615243253,137873.78615702468,3573,20,668.5151515151515,32,1,22,31.042733479639114,0.669921875,41.098484848484844,1035.6060606060598,32.36268939393937,0
3597,4,0,0,33,0.0,0.0,1.0,33,1100,700,400,0.6363636363636364,15,7,8,389.77847014399777,0.7980587121212122,0.0658565673796574,0.24663931414585905,134223.48684126625,3863.485071676364,138086.97191294262,3574,21,669.5151515151515,32,1,22,30.84308110962186,0.6715494791666666,40.94065656565657,1036.2373737373741,32.38241792929294,0
3598,4,0,0,33,0.0,0.0,1.0,33,600,400,200,0.6666666666666666,8,4,4,391.3224863175979,0.7965593434343435,0.06820211862842807,0.24828111380737874,134321.63331547816,3912.615103050729,138234.24841852888,3575,22,670.5151515151515,32,1,22,30.70467925294357,0.6725260416666665,40.845959595959606,1036.6161616161628,32.39425505050509,0
3599,4,0,0,33,0.0,0.0,1.0,33,950,700,250,0.7368421052631579,12,7,5,388.8246527379449,0.7948232323232324,0.06410341545476661,0.24758183702244044,134452.55107897162,3855.6932966024006,138308.24437557402,3576,23,671.5151515151515,32,1,22,30.638239590942288,0.673828125,40.719696969696976,1037.121212121213,32.410037878787904,0
3600,4,0,0,33,0.0,0.0,1.0,33,1100,800,300,0.7272727272727273,14,8,6,390.90491491179256,0.7946654040404041,0.0655852586232335,0.24935363205864033,134518.03387409454,3916.7521171309145,138434.78599122545,3577,24,672.5151515151515,32,1,22,30.51870334307043,0.6744791666666666,40.65656565656566,1037.3737373737379,32.41792929292931,0
3601,4,0,0,33,0.0,0.0,1.0,33,500,200,300,0.4,8,2,6,390.84438508416355,0.7932449494949496,0.06809546239598063,0.2497780341763031,134585.64573939182,3920.41676115893,138506.06250055076,3578,25,673.5151515151515,30,3,22,30.452558290155437,0.6805555555555556,40.59139784946237,1037.6344086021506,34.587813620071685,0
3602,4,0,0,33,0.0,0.0,1.0,33,600,400,200,0.6666666666666666,8,4,4,390.59025651705105,0.7924558080808082,0.06890084321134426,0.25033431959179975,134690.26630607588,3921.741133368024,138612.0074394439,3579,26,674.5151515151515,30,3,22,30.354406750399242,0.6815972222222222,40.490591397849464,1038.0376344086023,34.60125448028675,0
3603,4,0,0,33,0.0,0.0,1.0,33,900,700,200,0.7777777777777778,11,7,4,390.1922347461206,0.7910353535353536,0.0682739621924573,0.2507480315955128,134787.2945997451,3918.59113905166,138705.88573879676,3580,27,675.5151515151515,31,2,19,30.267633228840115,0.679771505376344,40.39713541666667,1038.4114583333342,33.497143817204325,0
3604,4,0,0,33,0.0,0.0,1.0,33,1050,700,350,0.6666666666666666,14,7,7,383.4590497092539,0.7902462121212122,0.05214762564554731,0.23839321813952769,133573.15275404198,3646.6159396701496,137219.76869371213,3581,28,676.5151515151515,31,2,21,31.659240248561943,0.6676747311827957,41.56901041666667,1033.7239583333342,33.34593413978497,6
3605,4,0,0,33,0.0,0.0,1.0,33,650,400,250,0.6153846153846154,9,4,5,384.9684395594693,0.788431186868687,0.05514151717400706,0.23976740223856824,133640.46096801758,3689.471944173177,137329.93291219076,3582,29,677.5151515151515,31,2,21,31.55262246568443,0.6683467741935484,41.50390625,1033.984375,33.35433467741935,0
3606,4,0,0,33,0.0,0.0,1.0,33,900,700,200,0.7777777777777778,11,7,4,385.4605889954721,0.7870896464646465,0.058866392745279716,0.24051166208884822,133707.78613620347,3707.816399468336,137415.60253567182,3583,30,678.5151515151515,31,2,18,31.472286919300007,0.669018817204301,41.43880208333334,1034.2447916666679,33.3627352150538,0
3607,4,0,0,33,0.0,0.0,1.0,33,1150,800,350,0.6956521739130435,15,8,7,388.9121096067284,0.7848011363636365,0.06045353497222128,0.24355276083882363,133842.4873352052,3810.592820909303,137653.0801561145,3584,31,679.5151515151515,31,2,18,31.247771695818123,0.6703629032258064,41.30859375000001,1034.765625000001,33.37953629032261,0
3608,4,0,0,33,0.0,0.0,1.0,33,750,400,350,0.5333333333333333,11,4,7,389.924281573557,0.7855113636363638,0.0600266090264836,0.2446336317465041,133909.86336602116,3842.9414537218086,137752.80481974297,3585,32,680.5151515151515,31,2,18,31.153944940663404,0.671034946236559,41.24348958333334,1035.0260416666677,33.38793682795702,0
3609,4,0,0,33,0.0,0.0,1.0,33,1000,900,100,0.9,11,9,2,388.4747236323056,0.7853535353535355,0.058077727753258035,0.24385266342554698,133929.26263901655,3805.626657994095,137734.88929701064,3586,33,681.5151515151515,32,1,18,31.171983003984707,0.6686197916666666,41.22474747474748,1035.101010101011,32.346906565656596,0
3610,4,0,0,33,0.0,0.0,1.0,33,950,700,250,0.7368421052631579,12,7,5,390.5633551457466,0.7844854797979799,0.05980783444198101,0.24559965584318433,133994.6178961331,3866.6775073972144,137861.29540353033,3587,34,682.5151515151515,32,1,18,31.05233739837399,0.6692708333333333,41.161616161616166,1035.3535353535358,32.35479797979799,0
3611,4,0,0,33,0.0,0.0,1.0,33,950,600,350,0.631578947368421,13,6,7,390.0827532727728,0.7825915404040404,0.06716605351417626,0.24617222368075625,134125.3762371188,3863.999209264377,137989.37544638317,3588,35,683.5151515151515,32,1,19,30.933589306029596,0.6705729166666665,41.03535353535354,1035.8585858585868,32.37058080808084,0
3612,4,0,0,33,0.0,0.0,1.0,33,600,400,200,0.6666666666666666,8,4,4,391.0697873392844,0.7821969696969697,0.06486067253891803,0.24701521209536814,134158.07578627195,3893.0340335170113,138051.10981978895,3589,36,684.5151515151515,32,1,19,30.875228519195616,0.6708984375,41.00378787878789,1035.9848484848496,32.37452651515155,0
3613,4,0,0,33,0.0,0.0,1.0,33,850,600,250,0.7058823529411765,11,6,5,391.7227896412681,0.7820391414141414,0.06816150783979236,0.24764847548507307,134190.77932098773,3913.1172839506316,138103.89660493835,3590,37,685.5151515151515,32,1,19,30.825513851653266,0.6712239583333333,40.97222222222223,1036.1111111111118,32.37847222222224,0
3614,4,0,0,33,0.0,0.0,1.0,33,750,400,350,0.5333333333333333,11,4,7,388.148276392736,0.7812500000000001,0.06623250044302664,0.24582724171539966,134256.19834710754,3822.2623966942238,138078.46074380176,3591,38,686.5151515151515,32,1,19,30.852521929824547,0.671875,40.909090909090914,1036.3636363636372,32.38636363636366,0
3615,4,0,0,33,0.0,0.0,1.0,33,1000,800,200,0.8,12,8,4,388.74051704625646,0.7784090909090909,0.06861801213596741,0.24775045364895257,134485.2904837518,3855.9762715539428,138341.26675530575,3592,39,687.5151515151515,32,1,20,30.607628322174897,0.6741536458333333,40.68813131313132,1037.2474747474757,32.41398358585862,0
3616,4,0,0,33,0.0,0.0,1.0,33,800,500,300,0.625,11,5,6,386.8553499714267,0.7758049242424243,0.06675031367628637,0.24745081374576833,134618.3353000218,3815.580585262964,138433.91588528478,3593,40,688.5151515151515,31,2,21,30.523316603931413,0.6780913978494623,40.55989583333334,1037.7604166666677,33.47614247311831,0
3617,4,0,0,33,0.0,0.0,1.0,33,900,500,400,0.5555555555555556,13,5,8,384.32845045872375,0.7741477272727273,0.06613919480736641,0.24675000514958642,134753.4942626953,3757.9203287760424,138511.41459147134,3594,41,689.5151515151515,31,2,21,30.453661901178833,0.6794354838709677,40.4296875,1038.28125,33.492943548387096,0
3618,4,0,0,33,0.0,0.0,1.0,33,400,100,300,0.25,7,1,6,385.04008411867,0.7729640151515152,0.06981666191697511,0.2474371209384686,134787.2945997451,3779.7022501627703,138566.99684990788,3595,42,690.5151515151515,31,2,18,30.401384535005217,0.679771505376344,40.39713541666667,1038.4114583333342,33.497143817204325,0
3619,4,0,0,33,0.0,0.0,1.0,33,900,700,200,0.7777777777777778,11,7,4,385.1437367828016,0.7724116161616162,0.07060450309792143,0.247965422785828,134854.90798950198,3787.704637315538,138642.6126268175,3596,43,691.5151515151515,31,2,19,30.331082069282512,0.6804435483870968,40.33203125,1038.6718750000002,33.50554435483872,0
3620,4,0,1,32,0.0,0.030303030303030304,0.9696969696969697,33,800,600,200,0.75,10,6,4,383.61316825899326,0.7698863636363636,0.06728943571048829,0.24767257950701993,134956.35986328128,3754.207356770833,138710.56722005212,3597,44,692.5151515151515,31,2,19,30.269423558897234,0.6814516129032258,40.234375,1039.0625000000002,33.51814516129033,0
3621,4,0,0,32,0.0,0.0,1.0,32,800,600,200,0.75,10,6,4,383.2770404364692,0.7676831317204301,0.07482697607415756,0.24815090136288187,135057.84988403323,3952.91459825304,139010.76448228626,3598,45,709.625,31,1,19,30.17675581443902,0.6824596774193548,40.13671875,1039.4531250000002,33.53074596774194,0
3622,4,0,0,32,0.0,0.0,1.0,32,1000,800,200,0.8,12,8,4,382.79165582220566,0.765498991935484,0.07061083635908316,0.24876785639153448,135193.22925143785,3950.168016221799,139143.39726765966,3599,46,710.625,31,1,20,30.054176578606885,0.6838037634408602,40.00651041666667,1039.9739583333344,33.54754704301079,0
3623,4,0,1,31,0.0,0.03125,0.96875,32,700,500,200,0.7142857142857143,9,5,4,381.59777318644524,0.7668010752688172,0.0696417396745932,0.24869218660356446,135294.80828179262,3925.6395128038307,139220.44779459646,3600,47,711.625,31,1,20,29.98383395911555,0.6848118279569892,39.90885416666667,1040.3645833333342,33.56014784946239,0
3624,4,0,0,31,0.0,0.0,1.0,31,500,300,200,0.6,7,3,4,391.18372026847624,0.7630824372759857,0.08126446608420035,0.25363001477591496,135109.15505043944,4370.500382992265,139479.6554334317,3601,48,733.483870967742,30,1,20,29.920006464124125,0.6857638888888888,40.087365591397855,1039.6505376344094,34.65501792114698,0
3625,4,0,0,31,0.0,0.0,1.0,31,750,600,150,0.8,9,6,3,390.28956747081975,0.7611111111111111,0.07949680920682423,0.2540328816363898,135248.92915727253,4357.249212336687,139606.17836960923,3602,49,734.483870967742,30,1,20,29.803592195374083,0.6871527777777777,39.95295698924731,1040.1881720430108,34.67293906810036,0
3626,4,0,0,31,0.0,0.0,1.0,31,850,700,150,0.8235294117647058,10,7,3,392.75262292960406,0.7620967741935484,0.08702970008290545,0.25663152399526784,135388.77552679504,4434.859340675227,139823.63486747027,3603,50,735.483870967742,30,1,20,29.59985363123681,0.6885416666666666,39.818548387096776,1040.7258064516132,34.690860215053775,0
3627,4,0,0,31,0.0,0.0,1.0,31,950,600,350,0.631578947368421,13,6,7,391.90222520495234,0.7603942652329749,0.08565790131064022,0.2573269865159298,135563.68510810498,4425.541970169959,139989.22707827494,3604,51,736.483870967742,30,1,20,29.447384271209778,0.6902777777777778,39.6505376344086,1041.3978494623655,34.713261648745515,0
3628,4,0,0,31,0.0,0.0,1.0,31,650,500,150,0.7692307692307693,8,5,3,394.1143998497229,0.7579749103942652,0.08599857242369802,0.2598107405687716,135706.02816358028,4496.758034808143,140202.78619838844,3605,52,737.483870967742,29,2,20,29.247756153914512,0.694683908045977,39.51388888888889,1041.9444444444448,35.92911877394637,0
3629,4,0,0,31,0.0,0.0,1.0,31,550,300,250,0.5454545454545454,8,3,5,393.0758764067344,0.7573476702508961,0.08499825876101186,0.2593885928478213,135742.20920138885,4471.39756944444,140213.60677083328,3606,53,738.483870967742,29,2,20,29.238721178195387,0.6950431034482758,39.479166666666664,1042.083333333333,35.933908045977,0
3630,4,0,0,31,0.0,0.0,1.0,31,750,400,350,0.5333333333333333,11,4,7,384.1959580275759,0.7569892473118279,0.08591212748414057,0.23381068302821062,132778.6810613944,4002.60651520408,136781.28757659846,3607,54,739.483870967742,30,1,20,32.439467049208844,0.6624999999999999,42.33870967741936,1030.645161290323,34.35483870967743,6
3631,4,0,0,31,0.0,0.0,1.0,31,800,600,200,0.75,10,6,4,385.88448059707645,0.7563620071684588,0.09168656867032188,0.23570905534560285,132917.24476818144,4058.1403919528407,136975.3851601343,3608,55,740.483870967742,30,1,21,32.25636513729579,0.6638888888888889,42.20430107526882,1031.1827956989257,34.37275985663086,0
3632,4,0,0,31,0.0,0.0,1.0,31,600,400,200,0.6666666666666666,8,4,4,386.3357678948558,0.7558243727598566,0.09613525351627206,0.23642270197967488,132986.5537200832,4075.492470227766,137062.04619031097,3609,56,741.483870967742,30,1,21,32.17493050125967,0.6645833333333333,42.137096774193544,1031.4516129032254,34.381720430107514,0
3633,4,0,0,31,0.0,0.0,1.0,31,950,700,250,0.7368421052631579,12,7,5,386.6041605679242,0.7558243727598566,0.08977801308474831,0.23724701364348144,133090.55102107173,4090.6721514047786,137181.22317247652,3610,57,742.483870967742,30,1,21,32.06330597889801,0.6656249999999999,42.03629032258064,1031.8548387096769,34.39516129032256,0
3634,4,0,0,31,0.0,0.0,1.0,31,1050,800,250,0.7619047619047619,13,8,5,386.5921284707737,0.7542114695340502,0.09033601975549232,0.2381246302152377,133229.27731890976,4101.077978668063,137330.35529757783,3611,58,743.483870967742,30,1,22,31.924011630430073,0.6670138888888888,41.90188172043011,1032.39247311828,34.413082437275996,0
3635,4,0,0,31,0.0,0.0,1.0,31,900,700,200,0.7777777777777778,11,7,4,387.7082708078206,0.7531362007168458,0.0966188847146725,0.2397053951052373,133368.0758794368,4141.5812160365185,137509.65709547332,3612,59,744.483870967742,30,1,23,31.755584471914986,0.6684027777777779,41.76747311827956,1032.9301075268806,34.43100358422935,0
3636,4,0,0,31,0.0,0.0,1.0,31,750,600,150,0.8,9,6,3,387.5498733126771,0.753494623655914,0.1015791218521429,0.24005607382389565,133437.50225820884,4142.737419065765,137580.2396772746,3613,60,745.483870967742,30,1,23,31.689866007545202,0.6690972222222222,41.70026881720429,1033.1989247311813,34.439964157706044,0
3637,4,0,0,31,0.0,0.0,1.0,31,950,500,450,0.5263157894736842,14,5,9,387.53803398435673,0.7525089605734767,0.09735502943190788,0.24073940308110026,133543.99112654311,4150.679670739054,137694.67079728216,3614,61,746.483870967742,29,2,23,31.58313177461256,0.673132183908046,41.597222222222214,1033.6111111111104,35.64176245210726,0
3638,4,0,0,31,0.0,0.0,1.0,31,400,200,200,0.5,6,2,4,387.53803398435673,0.7525089605734767,0.09735502943190788,0.24073940308110026,133543.99112654311,4150.675154320971,137694.6662808641,3615,62,747.483870967742,29,2,23,31.58313177461256,0.673132183908046,41.597222222222214,1033.6111111111104,35.64176245210726,0
3639,4,0,0,31,0.0,0.0,1.0,31,650,500,150,0.7692307692307693,8,5,3,386.81814929231297,0.7537634408602151,0.09656456224791832,0.24118142955065275,133680.636851081,4142.01930859058,137822.6561596716,3616,63,748.483870967742,30,1,23,31.46445282037951,0.6715277777777778,41.46505376344086,1034.1397849462362,34.47132616487454,0
3640,4,0,0,31,0.0,0.0,1.0,31,800,600,200,0.75,10,6,4,387.0846656736742,0.7529569892473118,0.10165669909097375,0.24203011142894137,133784.9051371545,4157.217055439925,137942.12219259443,3617,64,749.483870967742,30,1,21,31.352853925771957,0.6725694444444446,41.36424731182795,1034.5430107526877,34.48476702508959,0
3641,4,0,0,31,0.0,0.0,1.0,31,400,100,300,0.25,7,1,6,387.0846656736742,0.7529569892473118,0.10165669909097375,0.24203011142894137,133784.9051371545,4157.217055439925,137942.12219259443,3618,65,750.483870967742,30,1,21,31.352853925771957,0.6725694444444446,41.36424731182795,1034.5430107526877,34.48476702508959,0
3642,4,0,0,31,0.0,0.0,1.0,31,800,300,500,0.375,13,3,10,385.3706244264724,0.7530465949820788,0.09595716242997598,0.24141321704307633,133854.4399099605,4116.713818071424,137971.1537280319,3619,66,751.483870967742,30,1,21,31.327391003160585,0.6732638888888889,41.297043010752674,1034.8118279569876,34.49372759856625,0
3643,4,0,0,31,0.0,0.0,1.0,31,800,500,300,0.625,11,5,6,385.3706244264724,0.7530465949820788,0.09595716242997598,0.24141321704307633,133854.4399099605,4116.713818071424,137971.1537280319,3620,67,752.483870967742,30,1,21,31.327391003160585,0.6732638888888889,41.297043010752674,1034.8118279569876,34.49372759856625,0
3644,4,0,0,31,0.0,0.0,1.0,31,1000,800,200,0.8,12,8,4,398.8860032969678,0.753405017921147,0.12190990777360833,0.231962868176817,131052.73189097016,4255.020089027641,135307.7519799978,3621,68,753.483870967742,30,1,22,33.80808611184037,0.6451388888888889,44.01881720430108,1023.9247311827966,34.13082437275988,8
3645,4,0,0,31,0.0,0.0,1.0,31,1100,1000,100,0.9090909090909091,12,10,2,389.4195902485006,0.7531362007168458,0.10394876635442851,0.2270670770683873,131155.97043372056,4014.9408529887774,135170.91128670934,3622,69,754.483870967742,30,1,22,33.94567642041728,0.6461805555555555,43.91801075268817,1024.3279569892466,34.14426523297489,1
3646,4,0,0,31,0.0,0.0,1.0,31,700,500,200,0.7142857142857143,9,5,4,389.4195902485006,0.7531362007168458,0.10394876635442851,0.2270670770683873,131155.97043372056,4014.9408529887774,135170.91128670934,3623,70,755.483870967742,30,1,22,33.94567642041728,0.6461805555555555,43.91801075268817,1024.3279569892466,34.14426523297489,0
3647,4,0,0,31,0.0,0.0,1.0,31,850,600,250,0.7058823529411765,11,6,5,388.79679677254916,0.7523297491039427,0.1051518126121247,0.22731493700873584,131259.24962423404,4006.635160134126,135265.88478436816,3624,71,756.483870967742,30,1,22,33.85689926547744,0.6472222222222221,43.81720430107527,1024.7311827956992,34.15770609318997,0
3648,4,1,1,31,0.03125,0.03125,0.96875,32,750,500,250,0.6666666666666666,10,5,5,379.4480661702179,0.7663390456989247,0.1021890862944157,0.22380619471716462,131595.187717014,3586.7078993055607,135181.89561631955,3625,0,733.8125,31,1,20,33.75634517766494,0.6478494623655914,43.489583333333336,1026.0416666666674,33.09811827956992,0
3649,4,0,0,31,0.0,0.0,1.0,31,850,600,250,0.7058823529411765,11,6,5,391.94843890572923,0.7503584229390681,0.11766396335098417,0.23102258178899057,131569.3310823504,4113.6787851196395,135683.00986747004,3626,73,758.483870967742,30,1,20,33.46188698196427,0.6503472222222224,43.514784946236546,1025.9408602150525,34.19802867383508,0
3650,4,0,0,31,0.0,0.0,1.0,31,450,200,250,0.4444444444444444,7,2,5,390.2911530456584,0.7510752688172043,0.12081880981050763,0.2304619453599071,131638.28775364193,4075.4518224650064,135713.73957610692,3627,74,759.483870967742,30,1,20,33.43456668849594,0.6510416666666667,43.44758064516128,1026.209677419354,34.206989247311796,0
3651,4,0,0,31,0.0,0.0,1.0,31,750,600,150,0.8,9,6,3,387.17938299719054,0.7490143369175627,0.11874548686916464,0.2294540967195918,131776.255293242,4004.2098436235397,135780.46513686553,3628,75,760.483870967742,30,1,21,33.37478727582143,0.6524305555555556,43.31317204301075,1026.747311827957,34.22491039426523,0
3652,4,0,0,31,0.0,0.0,1.0,31,850,500,350,0.5882352941176471,12,5,7,391.23451776608005,0.7478494623655914,0.1212484487256329,0.23248943893999874,131879.77837033186,4119.184298762861,135998.9626690947,3629,76,761.483870967742,30,1,21,33.165946959783646,0.6534722222222222,43.21236559139785,1027.1505376344087,34.23835125448029,0
3653,4,0,0,31,0.0,0.0,1.0,31,700,600,100,0.8571428571428571,8,6,2,378.23756317883715,0.7479390681003584,0.10124291673392394,0.21531754533583886,130228.28686842414,3651.4459764134626,133879.7328448376,3630,77,762.483870967742,30,1,20,35.173601966464744,0.6368055555555555,44.825268817204304,1020.6989247311831,34.023297491039436,4
3654,4,0,0,31,0.0,0.0,1.0,31,800,600,200,0.75,10,6,4,386.0474481887095,0.7491039426523297,0.09093459135534854,0.21899104123709306,130091.13228407913,3844.2699300497197,133935.40221412884,3631,78,763.483870967742,30,1,21,35.11391084760649,0.6354166666666666,44.95967741935484,1020.161290322581,34.00537634408603,1
3655,4,0,0,31,0.0,0.0,1.0,31,550,400,150,0.7272727272727273,7,4,3,387.2611967519152,0.7491039426523297,0.1053369945509448,0.2107304434273408,128450.91376170653,3748.810917447099,132199.72467915362,3632,79,764.483870967742,30,1,17,36.75832007425086,0.61875,46.57258064516129,1013.7096774193545,33.79032258064515,4
3656,4,2,0,33,0.06060606060606061,0.0,1.0,33,500,300,200,0.6,7,3,4,368.9873733091634,0.7712279040404041,0.09893590975008015,0.2034615091344908,128976.84427928278,2918.1653976635143,131895.0096769463,3633,0,719.0909090909091,32,1,19,36.684016987777085,0.6188151041666666,46.054292929292934,1015.7828282828287,31.7432133838384,0
3657,4,1,1,33,0.029411764705882353,0.029411764705882353,0.9705882352941176,34,700,600,100,0.8571428571428571,8,6,2,360.13501934603363,0.7782234105763518,0.08776028188785467,0.19986891341231044,129232.53864198868,2508.2325607939283,131740.7712027826,3634,0,698.9117647058823,33,1,19,36.64816098188101,0.6190025252525253,45.802696078431374,1016.7892156862747,30.811794414735598,0
3658,4,0,0,33,0.0,0.0,1.0,33,750,500,250,0.6666666666666666,10,5,5,366.9268932525754,0.7719381313131314,0.09039713909279157,0.20314728271549037,129137.2133583307,2876.7833001734457,132013.99665850415,3635,2,721.0909090909091,32,1,21,36.5727225672878,0.6204427083333334,45.89646464646464,1016.4141414141408,31.7629419191919,0
3659,4,2,1,34,0.05714285714285714,0.02857142857142857,0.9714285714285714,35,750,600,150,0.8,9,6,3,349.35701571397783,0.7935574229691876,0.07938548885363605,0.19598355865134945,129655.65653344667,2059.2226473922847,131714.87918083897,3636,0,680.8285714285714,34,1,15,36.49181765049678,0.6210171568627452,45.38690476190476,1018.4523809523806,29.954481792717075,0
3660,4,1,1,34,0.02857142857142857,0.02857142857142857,0.9714285714285714,35,900,700,200,0.7777777777777778,11,7,4,349.8249930187815,0.7866946778711484,0.07391580142222809,0.1967018587552385,129746.60572562354,2077.7210884353663,131824.3268140589,3637,0,681.8,34,1,15,36.387493183765685,0.6219362745098039,45.297619047619044,1018.8095238095234,29.964985994397747,0
3661,4,3,1,36,0.08108108108108109,0.02702702702702703,0.972972972972973,37,600,400,200,0.6666666666666666,8,4,4,361.4198612503063,0.8013638638638638,0.11165158768992622,0.18749903299118104,126522.46492346936,1799.1815476190416,128321.6464710884,3638,0,645.8648648648649,34,3,20,39.39178795408825,0.5891544117647058,48.482142857142854,1006.0714285714284,29.59033613445378,8
3662,4,3,2,37,0.07692307692307693,0.05128205128205128,0.9487179487179487,39,500,200,300,0.4,8,2,6,344.66637512759604,0.8257984705353126,0.1125077684890039,0.18119777196226486,127063.62771132632,958.9119947650504,128022.53970609137,3639,0,613.5384615384615,36,3,21,39.257325291336244,0.5905671296296295,47.94481981981983,1008.2207207207218,28.006131131131163,0
3663,4,5,3,39,0.11904761904761904,0.07142857142857142,0.9285714285714286,42,800,500,300,0.625,11,5,6,326.1464682193473,0.8493757259001161,0.1164380873898796,0.17473675019169016,127828.32031250015,-61.84895833331913,127766.47135416683,3640,0,570.5952380952381,39,3,17,38.94210960032964,0.5929487179487178,47.18750000000001,1011.2500000000011,25.929487179487207,0
3664,4,3,1,41,0.07142857142857142,0.023809523809523808,0.9761904761904762,42,1100,800,300,0.7272727272727273,14,8,6,327.2742964005288,0.846447928765002,0.13991494323833042,0.1766118204728896,128118.16541883688,-14.043511284711926,128104.12190755217,3641,0,571.5238095238095,39,3,19,38.61776331584183,0.5958867521367521,46.90104166666667,1012.395833333334,25.95886752136754,0
3665,4,0,2,39,0.0,0.04878048780487805,0.9512195121951219,41,1150,700,450,0.6086956521739131,16,7,9,337.87043003285976,0.8364329268292683,0.1497588767826903,0.18257331447271635,128171.57594601503,461.0770965738874,128632.65304258892,3642,1,586.4634146341464,38,3,19,38.29504290637966,0.5981359649122808,46.848290598290596,1012.6068376068374,26.64754835807467,0
3666,4,1,1,39,0.025,0.025,0.975,40,1100,800,300,0.7272727272727273,14,8,6,339.7322212940931,0.8348824786324787,0.131495615459565,0.1838375236141497,128227.80957842788,712.6237159510538,128940.43329437893,3643,0,591.175,37,3,19,38.19049745588396,0.6005067567567568,46.79276315789473,1012.8289473684204,27.373755334281633,0
3667,4,1,1,39,0.025,0.025,0.975,40,700,400,300,0.5714285714285714,10,4,6,341.8804589310632,0.8396634615384615,0.12905712431028915,0.1857731382657153,128394.44739006233,779.1105195829538,129173.55790964529,3644,0,592.15,37,3,17,37.96600580619569,0.6021959459459458,46.62828947368421,1013.4868421052632,27.39153627311522,0
3668,4,4,3,40,0.09302325581395349,0.06976744186046512,0.9302325581395349,43,1250,900,350,0.72,16,9,7,324.30019999999996,0.8534514581026209,0.1439395348837209,0.17936957964601785,129098.08976138559,-226.69273415293117,128871.39702723266,3645,0,551.7441860465116,40,3,19,37.69562500000001,0.6041666666666665,45.934959349593505,1016.2601626016274,25.406504065040686,0
3669,4,1,1,40,0.024390243902439025,0.024390243902439025,0.975609756097561,41,1100,600,500,0.5454545454545454,16,6,10,341.2120793368856,0.845020325203252,0.17204435498993687,0.18858491976947978,129069.04432508674,607.9833984374966,129677.02772352424,3646,0,579.5365853658536,39,2,20,37.295510849137194,0.6055021367521367,45.963541666666664,1016.1458333333328,26.055021367521356,0
3670,4,1,0,41,0.024390243902439025,0.0,1.0,41,1400,800,600,0.5714285714285714,20,8,12,338.1717104299653,0.8429878048780488,0.16664475033795023,0.18779667320523932,129257.13320444745,542.3567978849211,129799.49000233237,3647,0,580.3658536585366,37,4,21,37.181457120264554,0.6109234234234234,45.77850877192982,1016.8859649122801,27.48340445708865,0
3671,4,1,1,41,0.023809523809523808,0.023809523809523808,0.9761904761904762,42,1350,1100,250,0.8148148148148148,16,11,5,330.64517329034663,0.8487224157955865,0.1583427071616048,0.1844988444985677,129445.8954840565,160.13210880998923,129606.02759286649,3648,0,567.5238095238095,38,4,16,37.181102362204726,0.6110197368421053,45.592948717948715,1017.6282051282049,26.77968960863697,0
3672,4,0,0,41,0.0,0.0,1.0,41,950,500,450,0.5263157894736842,14,5,9,335.2742271105828,0.8416666666666667,0.16797729184188426,0.1869798574270557,129424.43828870414,478.5357032933141,129902.97399199745,3649,2,582.3658536585366,37,4,21,37.08512931034482,0.6126126126126126,45.614035087719294,1017.5438596491222,27.50118539592222,0
3673,4,1,1,41,0.023809523809523808,0.023809523809523808,0.9761904761904762,42,1200,800,400,0.6666666666666666,16,8,8,327.82566148518947,0.846278552071235,0.16793261271788862,0.18426063042098575,129731.44531250001,105.85937500000026,129837.30468750001,3650,0,569.4761904761905,39,3,17,36.963190184049076,0.6121794871794872,45.3125,1018.7500000000001,26.121794871794876,0
3674,4,0,1,40,0.0,0.024390243902439025,0.975609756097561,41,1400,900,500,0.6428571428571429,19,9,10,333.2844102016891,0.8374491869918699,0.17067685295540302,0.18758274456806248,129784.51063368066,451.0308159722323,130235.5414496529,3651,1,584.2926829268292,39,2,17,36.77034348803925,0.6127136752136751,45.26041666666667,1018.9583333333343,26.127136752136778,0
3675,4,1,0,41,0.024390243902439025,0.0,1.0,41,1200,1000,200,0.8333333333333334,14,10,4,321.46617923897895,0.8350609756097561,0.17760100588907046,0.17692739048445216,128902.8613873362,96.70750265949152,128999.5688899957,3652,0,585.0,38,3,19,37.96598281606172,0.6055372807017545,46.127136752136735,1015.4914529914502,26.723459289248687,6
3676,4,1,0,42,0.023809523809523808,0.0,1.0,42,1100,600,500,0.5454545454545454,16,6,10,318.4748853556291,0.8428184281842819,0.19089644683256823,0.1768520396041351,129255.70371283496,-166.7156339031518,129088.98807893181,3653,0,572.047619047619,38,4,20,37.68364327239616,0.6091008771929824,45.77991452991452,1016.8803418803406,26.760008996851067,0
3677,4,0,0,42,0.0,0.0,1.0,42,1150,700,450,0.6086956521739131,16,7,9,315.37353155700737,0.8422377080913667,0.1847150958682151,0.1756132612564808,129364.36760355023,-240.38050624589806,129123.98709730433,3654,1,573.047619047619,38,4,20,37.652278932997284,0.6101973684210527,45.67307692307692,1017.3076923076917,26.77125506072873,0
3678,4,0,0,42,0.0,0.0,1.0,42,1450,1100,350,0.7586206896551724,18,11,7,316.1589336657061,0.8415118079752226,0.1906261559841238,0.17653751477722848,129473.07715136246,-213.18599788150607,129259.89115348096,3655,2,574.047619047619,38,4,17,37.52208866960599,0.6112938596491228,45.56623931623932,1017.7350427350432,26.782501124606398,0
3679,4,2,2,42,0.045454545454545456,0.045454545454545456,0.9545454545454546,44,1000,800,200,0.8,12,8,4,301.9522940155578,0.8504448555320648,0.17980397132525505,0.17044926625042556,129899.73855054867,-955.2951905281222,128944.44336002055,3656,0,548.9090909090909,40,4,17,37.45202372644801,0.6122395833333334,45.14735772357724,1019.4105691056916,25.48526422764229,0
3680,4,0,0,42,0.0,0.0,1.0,42,1150,900,250,0.782608695652174,14,9,5,318.11155271981994,0.8411004645760743,0.18888023057749304,0.17849072584332235,129663.42872242327,-150.51307162683622,129512.91565079644,3657,4,576.047619047619,38,4,18,37.279494038253105,0.6132127192982455,45.37927350427351,1018.4829059829071,26.802181736392292,0
3681,4,0,0,42,0.0,0.0,1.0,42,950,900,50,0.9473684210526315,10,9,1,335.02569149510634,0.8411004645760743,0.21452169552520606,0.17693886847446014,127249.61480034718,126.3780381944398,127375.99283854161,3658,5,577.047619047619,39,3,18,39.30974258379791,0.5870726495726496,47.760416666666664,1008.9583333333329,25.870726495726483,7
3682,4,3,3,42,0.06666666666666667,0.06666666666666667,0.9333333333333333,45,950,600,350,0.631578947368421,13,6,7,319.3136591327339,0.8578282828282828,0.20129716604364356,0.17075342930455223,127752.38985224754,-841.3833866654535,126911.00646558208,3659,0,539.5111111111111,42,3,14,39.19234640084349,0.5875496031746031,47.26259689922481,1010.9496124031014,24.070228866740507,0
3683,4,3,2,43,0.06666666666666667,0.044444444444444446,0.9555555555555556,45,1100,900,200,0.8181818181818182,13,9,4,319.4165425586939,0.85993265993266,0.22389904986859932,0.17185301153737462,127997.40780489454,-823.1021084970807,127174.30569639745,3660,0,540.4444444444445,42,3,15,38.93976028599702,0.5900297619047619,47.020348837209305,1011.9186046511628,24.09330011074197,0
3684,4,2,1,44,0.044444444444444446,0.022222222222222223,0.9777777777777777,45,1150,900,250,0.782608695652174,14,9,5,321.4679439286909,0.8565235690235691,0.2309520011061128,0.17338025865890694,128095.48071217151,-764.2818377802029,127331.19887439131,3661,0,541.4,42,3,17,38.78784978143644,0.5910218253968255,46.92344961240309,1012.3062015503857,24.102528608342517,0
3685,4,0,0,44,0.0,0.0,1.0,44,1250,900,350,0.72,16,9,7,329.9387302391193,0.8530214940098662,0.22627418049548798,0.17794888563800104,128095.4807121718,-347.2679488912855,127748.21276328052,3662,1,554.7045454545455,42,2,18,38.57347404358508,0.5910218253968254,46.923449612403104,1012.306201550388,24.10252860834257,0
3686,4,0,2,42,0.0,0.045454545454545456,0.9545454545454546,44,1200,800,400,0.6666666666666666,16,8,8,330.93620291191843,0.8511055320648344,0.21928352546330054,0.17928109079489146,128273.18395135176,-309.9331346239853,127963.25081672777,3663,2,555.7045454545455,40,4,18,38.36694087747458,0.5958333333333332,46.7479674796748,1013.0081300813013,25.32520325203253,0
3687,4,1,0,43,0.023255813953488372,0.0,1.0,43,1450,1000,450,0.6896551724137931,19,10,9,341.7602282772283,0.848375784422296,0.24063340675933254,0.1862650650644203,128513.93771701414,184.19053819447018,128698.1282552086,3664,0,569.046511627907,39,4,16,37.84715088007669,0.5998931623931623,46.51041666666668,1013.9583333333354,25.99893162393168,0
3688,4,2,1,44,0.044444444444444446,0.022222222222222223,0.9777777777777777,45,1050,900,150,0.8571428571428571,12,9,3,367.9846747761569,0.8591750841750843,0.3151617797537143,0.1947535698941375,127334.5172789284,417.39372739975045,127751.91100632814,3665,0,544.7111111111111,38,7,15,38.391155922515104,0.5896381578947367,47.67628205128206,1009.2948717948723,26.560391363022955,7
3689,4,1,1,44,0.022222222222222223,0.022222222222222223,0.9777777777777777,45,1300,800,500,0.6153846153846154,18,8,10,365.256836292081,0.8632996632996633,0.31380870137346784,0.1946047268064344,127604.23657909638,321.6639500693981,127925.90052916578,3666,0,545.6,38,7,15,38.183135948679976,0.5923793859649122,47.409188034188034,1010.3632478632481,26.588506522717058,0
3690,4,1,1,44,0.022222222222222223,0.022222222222222223,0.9777777777777777,45,1350,1000,350,0.7407407407407407,17,10,7,365.0298876947228,0.8626262626262626,0.3150793650793653,0.19539835164835173,127793.2098765433,329.6682098765565,128122.87808641986,3667,0,546.5777777777778,38,7,16,37.99507783882785,0.594298245614035,47.22222222222223,1011.1111111111119,26.608187134502945,0
3691,4,2,1,45,0.043478260869565216,0.021739130434782608,0.9782608695652174,46,1300,900,400,0.6923076923076923,17,9,8,361.74642303364385,0.8677133655394526,0.3148035469813968,0.1950861120444482,128091.8023003474,67.35026041668553,128159.15256076408,3668,0,535.6521739130435,39,7,17,37.77226109624751,0.595619658119658,46.92708333333334,1012.2916666666681,25.956196581196618,0
3692,4,2,2,45,0.0425531914893617,0.0425531914893617,0.9574468085106383,47,950,300,650,0.3157894736842105,16,3,13,354.0506311732288,0.8703361085414739,0.31628435853141146,0.1924532201852246,128408.33875868075,-307.3784722222018,128100.96028645855,3669,0,525.2127659574468,39,8,16,37.643456663240826,0.5988247863247862,46.61458333333334,1013.5416666666682,25.988247863247903,0
3693,4,1,1,45,0.021739130434782608,0.021739130434782608,0.9782608695652174,46,1450,1100,350,0.7586206896551724,18,11,7,359.31391850170365,0.8671296296296297,0.32111761984803455,0.19614531502798543,128577.58881446758,39.943453685413374,128617.532268153,3670,0,536.9347826086956,38,8,16,37.337160714912734,0.6022478070175439,46.44764957264956,1014.2094017093998,26.689721097615784,0
3694,4,2,1,46,0.0425531914893617,0.02127659574468085,0.9787234042553191,47,950,700,250,0.7368421052631579,12,7,5,384.25320998792955,0.8731113166820844,0.35193563212019985,0.20451327692771815,127562.34039560279,406.26682965178304,127968.60722525457,3671,0,526.468085106383,37,10,16,37.7463683563081,0.5937499999999998,47.45065789473686,1010.197368421055,27.302631578947434,2
3695,4,2,0,48,0.041666666666666664,0.0,1.0,48,600,400,200,0.6666666666666666,8,4,4,378.7141317321017,0.8794695626477541,0.3567411280101387,0.20326901356233254,127901.25739645005,87.60272846815226,127988.8601249182,3672,0,516.4583333333334,38,10,19,37.538286861005496,0.595394736842105,47.115384615384635,1011.5384615384644,26.61943319838064,0
3696,4,3,3,48,0.058823529411764705,0.058823529411764705,0.9411764705882353,51,1200,800,400,0.6666666666666666,16,8,8,362.60445581130523,0.8887908496732027,0.34988519417876596,0.1983463083170601,128658.86843450982,-868.850788041459,127790.01764646836,3673,0,487.01960784313724,38,13,15,37.1706946784611,0.6030701754385963,46.367521367521384,1014.5299145299174,26.698155645524142,0
3697,4,5,5,48,0.09433962264150944,0.09433962264150944,0.9056603773584906,53,900,500,400,0.5555555555555556,13,5,8,352.1138091483681,0.8942610062893082,0.3542283210234025,0.1953941382090521,129227.86593967034,-1498.275347750109,127729.59059192023,3674,0,469.47169811320754,39,14,17,36.85681538776766,0.6071047008547008,45.80729166666668,1016.7708333333351,26.071047008547055,0
3698,4,3,3,48,0.058823529411764705,0.058823529411764705,0.9411764705882353,51,1450,1200,250,0.8275862068965517,17,12,5,371.19574176791417,0.8909150326797386,0.3838109074423255,0.20570340611075724,129174.23575726857,-610.214748155458,128564.02100911312,3675,0,488.7450980392157,38,13,19,36.42647574005955,0.6082785087719298,45.86004273504273,1016.5598290598288,26.75157444894286,0
3699,4,1,0,49,0.02040816326530612,0.0,1.0,49,1550,1200,350,0.7741935483870968,19,12,7,379.5188776741438,0.8780116213151927,0.35890044270565147,0.20399927276419294,127960.02739800386,-69.53882800796481,127890.4885699959,3676,0,509.44897959183675,39,10,17,37.457638388414146,0.5942841880341878,47.057291666666686,1011.7708333333364,25.94284188034196,4
3700,4,2,1,50,0.0392156862745098,0.0196078431372549,0.9803921568627451,51,1250,800,450,0.64,17,8,9,362.6946894351659,0.8813398692810458,0.35261885576148266,0.1975874054385607,128496.33487654335,-878.6135826581617,127617.72129388519,3677,0,490.4313725490196,38,13,16,37.334474885844756,0.6014254385964912,46.527777777777786,1013.8888888888899,26.68128654970763,0
3701,4,2,2,50,0.038461538461538464,0.038461538461538464,0.9615384615384616,52,1200,900,300,0.75,15,9,6,359.1839158922538,0.8866264454499748,0.35530242619948016,0.19693465911864017,128751.69406467034,-1150.892469618033,127600.80159505231,3678,0,481.96153846153845,39,13,16,37.1626851756817,0.6022970085470085,46.27604166666668,1014.8958333333351,26.02297008547013,0
3702,4,0,0,50,0.0,0.0,1.0,50,1050,700,350,0.6666666666666666,14,7,7,332.2570349008405,0.878860544217687,0.25082458770614724,0.17729235382308853,127665.57621671261,-1507.629360903059,126157.94685580955,3679,2,502.24,43,7,16,38.95396051974014,0.5852713178294573,47.34848484848485,1010.6060606060609,23.502466525722344,8
3703,4,2,3,49,0.038461538461538464,0.057692307692307696,0.9423076923076923,52,1850,1600,250,0.8648648648648649,21,16,5,310.9134550518706,0.8878519356460532,0.24518413207664103,0.16741378473708657,128029.91694398479,-2436.961731374386,125592.95521261041,3680,0,483.88461538461536,45,7,17,39.12174811301051,0.5863425925925927,46.98822463768115,1012.0471014492738,22.48993558776164,1
3704,4,0,1,48,0.0,0.02040816326530612,0.9795918367346939,49,1150,900,250,0.782608695652174,14,9,5,323.3423458156783,0.8838931405895691,0.24659619384135656,0.1726975939172215,127703.41443009717,-1541.6156819001412,126161.79874819702,3681,1,514.204081632653,42,7,17,39.14054261336402,0.5870535714285714,47.3110465116279,1010.7558139534868,24.065614617940163,0
3705,4,1,0,49,0.02040816326530612,0.0,1.0,49,1000,600,400,0.6,14,6,8,317.9424610366499,0.8869756235827665,0.26068070113342956,0.16563039499999585,126692.1965545476,-1726.3651567631973,124965.8313977844,3682,0,514.8367346938776,41,8,19,40.3113092891867,0.5782520325203253,48.313492063492056,1006.7460317460306,24.554781262098306,5
3706,4,3,1,51,0.057692307692307696,0.019230769230769232,0.9807692307692307,52,800,500,300,0.625,11,5,6,304.2541415289166,0.8972002262443438,0.27009702009702075,0.16082004623671278,127283.05785123949,-2654.0906188768913,124628.9672323626,3683,0,486.0769230769231,43,9,21,40.05177052052051,0.5813953488372094,47.72727272727272,1009.0909090909076,23.467230443974596,0
3707,4,0,1,50,0.0,0.0196078431372549,0.9803921568627451,51,1300,700,600,0.5384615384615384,19,7,12,307.8086579306368,0.8939869281045753,0.26849284120753514,0.16281499097753027,127311.94907344773,-2362.4559634337224,124949.49311001401,3684,1,496.6078431372549,42,9,22,39.93258921427428,0.5830853174603176,47.698643410852696,1009.205426356586,24.028700627537763,0
3708,4,1,2,49,0.0196078431372549,0.0392156862745098,0.9607843137254902,51,1000,500,500,0.5,15,5,10,307.2905876126268,0.8947385620915034,0.2729556269297859,0.1631316970713794,127458.67816124302,-2366.6295783006094,125092.04858294241,3685,0,496.6470588235294,42,9,16,39.79584492850976,0.5845734126984128,47.5532945736434,1009.786821705424,24.042543373938667,0
3709,4,1,0,50,0.02,0.0,1.0,50,1500,1200,300,0.8,18,12,6,315.5289804581281,0.8925,0.2852352421176705,0.16774937598142003,127517.50996984405,-1952.9060177312072,125564.60395211284,3686,0,507.12,41,9,17,39.527776413580845,0.5866361788617888,47.49503968253966,1010.0198412698383,24.634630274874105,0
3710,4,1,1,50,0.0196078431372549,0.0196078431372549,0.9803921568627451,51,1350,800,550,0.5925925925925926,19,8,11,310.8344907862851,0.8960784313725491,0.28915273220654947,0.1663203629161074,127776.88108436971,-2256.5076467760605,125520.37343759365,3687,0,498.15686274509807,42,9,18,39.38166890294549,0.5877976190476191,47.238372093023244,1011.0465116279053,24.0725359911406,0
3711,4,2,0,52,0.038461538461538464,0.0,1.0,52,1300,900,400,0.6923076923076923,17,9,8,311.77496655320164,0.8936494469582704,0.304131054131054,0.1683584819387288,128144.53124999985,-2406.9078255513678,125737.62342444848,3688,0,489.4423076923077,38,14,20,38.983196159122095,0.5978618421052633,46.87499999999999,1012.4999999999989,26.64473684210523,0
3712,4,0,0,52,0.0,0.0,1.0,52,1300,1000,300,0.7692307692307693,16,10,6,311.0903298775082,0.8931623931623931,0.2986335872289687,0.16867178949276218,128306.84222961866,-2416.996425049308,125889.84580456936,3689,1,490.4423076923077,38,14,20,38.835284192766004,0.5995065789473684,46.71474358974359,1013.1410256410255,26.661605937921724,0
3713,4,0,1,51,0.0,0.019230769230769232,0.9807692307692307,52,900,300,600,0.3333333333333333,15,3,12,312.31884318886387,0.8926282051282051,0.29659903663698683,0.1696825055263208,128388.03624260348,-2380.399408284034,126007.63683431945,3690,2,491.4423076923077,38,14,13,38.72153700189751,0.600328947368421,46.63461538461538,1013.461538461538,26.670040485829947,0
3714,4,3,3,51,0.05555555555555555,0.05555555555555555,0.9444444444444444,54,1100,900,200,0.8181818181818182,13,9,4,283.4914386350001,0.8979880037269975,0.23317937448007786,0.15516604797214784,128683.20202230562,-3503.8827861076397,125179.31923619797,3691,0,473.72222222222223,48,6,14,39.15259386523631,0.5894097222222222,46.343537414965986,1014.6258503401368,21.13803854875285,4
3715,4,1,0,52,0.019230769230769232,0.0,1.0,52,1950,1500,450,0.7692307692307693,24,15,9,292.0969231760936,0.8922982654600301,0.2553150029565132,0.16014969236206497,128751.13173381607,-2878.438113022493,125872.69362079358,3692,0,492.71153846153845,46,6,15,38.86541317260658,0.5923913043478262,46.27659574468085,1014.8936170212755,22.062904717853815,0
3716,4,2,2,52,0.037037037037037035,0.037037037037037035,0.962962962962963,54,1400,900,500,0.6428571428571429,19,9,10,284.19779629131983,0.8987304914977872,0.25910746812386165,0.15760059612518612,129201.38888888861,-3454.678147477515,125746.7107414111,3693,0,475.4259259259259,46,8,16,38.609972677595636,0.5969202898550725,45.83333333333332,1016.6666666666645,22.10144927536227,0
3717,4,1,2,51,0.018867924528301886,0.03773584905660377,0.9622641509433962,53,1100,900,200,0.8181818181818182,13,9,4,287.80848733601806,0.8979801644895984,0.25698280807833385,0.15924677550709362,129113.1516444831,-3168.0278260030777,125945.12381848003,3694,0,485.2641509433962,47,6,17,38.60750483999546,0.5948581560283688,45.92013888888889,1016.319444444445,21.623817966903086,0
3718,4,2,1,52,0.03773584905660377,0.018867924528301886,0.9811320754716981,53,1900,1300,600,0.6842105263157895,25,13,12,289.5150770633601,0.8920234639574262,0.28345531457731776,0.16205923636415204,129570.00892669628,-3097.445494461636,126472.56343223465,3695,0,485.9622641509434,45,8,14,38.102016607354685,0.6018518518518519,45.47101449275363,1018.1159420289871,22.62479871175527,0
3719,4,0,0,52,0.0,0.0,1.0,52,1850,1600,250,0.8648648648648649,21,16,5,291.52305259718776,0.8872549019607843,0.275582729384112,0.16321728545614453,129578.206447188,-2844.9931412894243,126733.21330589858,3696,1,496.3076923076923,44,8,14,38.04262155935493,0.603219696969697,45.46296296296297,1018.1481481481487,23.139730639730654,0
3720,4,2,2,52,0.037037037037037035,0.037037037037037035,0.962962962962963,54,1650,1200,450,0.7272727272727273,21,12,9,283.4446995431627,0.8919170743070114,0.27070639771604377,0.16074904670493714,130081.65086168962,-3425.809111085956,126655.84175060366,3697,0,478.8888888888889,46,8,15,37.74025231018801,0.6057518115942029,44.968971631205676,1020.1241134751779,22.176611162503868,0
3721,4,0,0,52,0.0,0.0,1.0,52,1350,900,450,0.6666666666666666,18,9,9,292.96247685637854,0.8838769482151834,0.27051119014512603,0.1653113227940478,129884.77473422498,-2789.7269375857354,127095.04779663925,3698,1,498.2307692307692,44,8,15,37.69624095437066,0.6062973484848484,45.16203703703704,1019.351851851852,23.167087542087543,0
3722,4,0,0,52,0.0,0.0,1.0,52,2200,1400,800,0.6363636363636364,30,14,16,293.2816773880095,0.8843954248366012,0.2737122557726466,0.16611426998938567,130031.52239550513,-2772.827399705947,127258.69499579919,3699,2,499.2307692307692,45,7,16,37.539964476021304,0.6064814814814814,45.018115942028984,1019.927536231884,22.665056360708533,0
3723,4,0,0,52,0.0,0.0,1.0,52,1400,900,500,0.6428571428571429,19,9,10,292.4534643630834,0.8842697335344393,0.2715320440400828,0.16585815743844268,130081.6508616896,-2791.4341110859577,127290.21675060365,3700,3,500.2307692307692,46,6,17,37.51050085455231,0.6057518115942029,44.968971631205676,1020.1241134751778,22.176611162503864,0
3724,4,0,0,52,0.0,0.0,1.0,52,1400,1000,400,0.7142857142857143,18,10,8,289.9406332754902,0.8836569884364001,0.2640944350533505,0.1650067479436837,130217.34103069533,-2848.940335621934,127368.40069507339,3701,4,501.2307692307692,46,6,17,37.43775152725904,0.6071105072463767,44.835992907801426,1020.6560283687959,22.18817452975643,0
3725,4,0,0,52,0.0,0.0,1.0,52,1300,1100,200,0.8461538461538461,15,11,4,292.6270759647814,0.88232151835093,0.2628844584272172,0.16693216589051432,130309.85189471873,-2773.5460956037277,127536.305799115,3702,5,502.2307692307692,44,8,19,37.275928780871176,0.6105587121212122,44.74537037037037,1021.018518518518,23.204966329966318,0
3726,4,1,1,52,0.018867924528301886,0.018867924528301886,0.9811320754716981,53,1250,800,450,0.64,17,8,9,286.7633535144162,0.8856132075471698,0.265611966346323,0.16505344064850655,130655.86704637931,-3106.537081889319,127549.32996449,3703,0,493.7358490566038,45,8,14,37.07722379728891,0.6127314814814815,44.40670289855072,1022.3731884057961,22.71940418679547,0
3727,4,0,0,52,0.0,0.0,1.0,52,1800,1400,400,0.7777777777777778,22,14,8,292.3628184113735,0.8812531422825539,0.26924121884274044,0.1683144025494468,130664.61334019214,-2759.705075445808,127904.90826474634,3704,7,504.2307692307692,44,8,14,36.925300368290756,0.6141098484848484,44.39814814814815,1022.4074074074082,23.236531986532004,0
3728,4,0,0,52,0.0,0.0,1.0,52,1000,600,400,0.6,14,6,8,290.58784890211126,0.8806246857717445,0.26723597727399273,0.167908711018333,130806.6529492456,-2797.835219478737,128008.81772976686,3705,8,505.2307692307692,44,8,14,36.82774408641078,0.615530303030303,44.25925925925926,1022.9629629629635,23.24915824915826,0
3729,4,0,1,51,0.0,0.019230769230769232,0.9807692307692307,52,1200,900,300,0.75,15,9,6,290.594930991832,0.8805461287078933,0.262553684664806,0.1682223458559839,130877.70168895737,-2793.5206618655825,128084.18102709179,3706,9,506.2307692307692,44,8,14,36.75610050372514,0.6162405303030304,44.18981481481481,1023.2407407407399,23.25547138047136,0
3730,4,0,0,51,0.0,0.0,1.0,51,1200,500,700,0.4166666666666667,19,5,14,296.86891480195965,0.8800326797385621,0.26557619252458897,0.17159309184620494,130819.03126614148,-2432.7792305153903,128386.2520356261,3707,10,516.9411764705883,43,8,14,36.65465225708905,0.6170058139534884,44.247159090909086,1023.0113636363633,23.790961945031704,0
3731,4,0,0,51,0.0,0.0,1.0,51,1050,800,250,0.7619047619047619,13,8,5,298.2112187553754,0.8800980392156864,0.2668553082657674,0.17312906953520962,130988.61932535561,-2387.5448375803726,128601.07448777524,3708,11,517.9411764705883,43,8,14,36.449660807893935,0.618701550387597,44.081439393939384,1023.6742424242407,23.806377730796296,0
3732,4,0,1,50,0.0,0.0196078431372549,0.9803921568627451,51,1600,1100,500,0.6875,21,11,10,299.5516791565968,0.8796732026143792,0.2674716488537163,0.17445618794176596,131109.82090973653,-2345.166598513548,128764.65431122298,3709,12,518.9411764705883,43,8,15,36.293438896594225,0.6199127906976745,43.96306818181818,1024.147727272727,23.817389006342488,0
3733,4,0,0,50,0.0,0.0,1.0,50,1450,1200,250,0.8275862068965517,17,12,5,304.0597613286008,0.8757142857142857,0.2649820177929212,0.17671592069295886,131030.32889399654,-2031.789893936681,128998.53900005986,3710,13,529.86,42,8,15,36.25800523692347,0.6205357142857143,44.040697674418595,1023.8372093023239,24.377076411960093,0
3734,4,0,0,50,0.0,0.0,1.0,50,800,400,400,0.5,12,4,8,303.85222989682694,0.8753401360544217,0.26440491958372725,0.17705171278993714,131129.55670482543,-2031.198357971278,129098.35834685415,3711,14,530.86,42,8,15,36.163473667612735,0.6215277777777778,43.9437984496124,1024.2248062015503,24.38630490956072,0
3735,4,0,0,50,0.0,0.0,1.0,50,1100,700,400,0.6363636363636364,15,7,8,301.53398415089316,0.8744047619047619,0.2549399640729886,0.176498337042833,131303.2957473257,-2081.5188202331856,129221.7769270925,3712,15,531.86,42,8,15,36.04814692256781,0.6232638888888891,43.77422480620154,1024.9031007751921,24.402454780361715,0
3736,4,0,1,49,0.0,0.02,0.98,50,1300,700,600,0.5384615384615384,19,7,12,302.84677382138955,0.8725680272108843,0.25512478235635494,0.17809044071476243,131480.69905045338,-2036.2965471928987,129444.40250326047,3713,16,532.86,41,9,16,35.83623524859741,0.6265243902439025,43.60119047619047,1025.595238095237,25.014518002322852,0
3737,4,1,1,49,0.02,0.02,0.98,50,1650,1100,550,0.6666666666666666,22,11,11,301.4533409262784,0.8735034013605442,0.24890392422192176,0.17821921515561576,131684.26890432098,-2060.667438271604,129623.60146604938,3714,0,533.1,41,9,13,35.66756878664863,0.6285569105691057,43.40277777777778,1026.388888888889,25.03387533875339,0
3738,4,0,1,48,0.0,0.02040816326530612,0.9795918367346939,49,1400,900,500,0.6428571428571429,19,9,10,309.3077313451532,0.8721301020408163,0.2483528605977583,0.1830297243302518,131719.04047070222,-1651.6564834093215,130067.38398729291,3715,18,544.9795918367347,40,9,14,35.431104181104175,0.6304687499999999,43.3689024390244,1026.5243902439045,25.66310975609761,0
3739,4,0,0,48,0.0,0.0,1.0,48,1400,800,600,0.5714285714285714,20,8,12,317.98114306991033,0.8706966607565012,0.2473458701316278,0.18768317797373818,131621.90890842036,-1229.3429904513637,130392.565917969,3716,19,556.4791666666666,39,9,14,35.30616604067269,0.6311431623931623,43.46354166666668,1026.145833333335,26.311431623931668,0
3740,4,0,0,48,0.0,0.0,1.0,48,1500,1200,300,0.8,18,12,6,340.04261984248853,0.8702164598108747,0.27701587551084517,0.19212710012770087,129935.60209155166,-750.3564517330254,129185.24563981863,3717,20,557.4791666666666,38,10,16,36.44490726186733,0.615953947368421,45.11217948717949,1019.5512820512824,26.83029689608638,4
3741,4,0,0,48,0.0,0.0,1.0,48,1400,1000,400,0.7142857142857143,18,10,8,342.4023088256891,0.8706781914893617,0.2819886700883345,0.1940008808521577,130044.55133912282,-694.489074256687,129350.06226486612,3718,21,558.4791666666666,38,10,16,36.274265912503054,0.6170504385964912,45.00534188034189,1019.9786324786338,26.84154295996405,0
3742,4,1,0,49,0.02040816326530612,0.0,1.0,49,1600,1100,500,0.6875,21,11,10,335.07043571204986,0.8743976757369615,0.27251493253517833,0.19146294713018602,130374.544330948,-1062.7036682783446,129311.84066266965,3719,0,548.0612244897959,37,12,18,36.12706678118961,0.6221846846846846,44.68201754385965,1021.2719298245615,27.601944049312475,0
3743,4,1,1,49,0.02,0.02,0.98,50,1400,900,500,0.6428571428571429,19,9,10,329.1280859975229,0.8759523809523809,0.28500730841511746,0.19059182634125002,130890.45606874135,-1384.0549437504587,129506.4011249909,3720,0,538.08,38,12,14,35.7575085264843,0.6255482456140351,44.177350427350426,1023.2905982905985,26.928699955015748,0
3744,4,1,1,49,0.02,0.02,0.98,50,1450,1000,450,0.6896551724137931,19,10,9,330.81784858856076,0.8734863945578231,0.28670284938941615,0.19197854677934592,130972.46334876544,-1334.3942901234582,129638.06905864198,3721,0,539.04,38,12,15,35.63150158299412,0.6263706140350876,44.09722222222222,1023.6111111111112,26.93713450292398,0
3745,4,1,2,48,0.02,0.04,0.96,50,1600,1100,500,0.6875,21,11,10,333.23446299586107,0.873843537414966,0.2882787398289173,0.19406959673622845,131109.19922017658,-1261.979280809432,129847.21993936715,3722,0,540.02,38,12,15,35.43166249391474,0.6277412280701755,43.9636752136752,1024.1452991452975,26.951192082770987,0
3746,4,0,0,48,0.0,0.0,1.0,48,1200,600,600,0.5,18,6,12,347.52995651600367,0.8656730200945626,0.29391272460579376,0.20172715866733532,130982.06948502548,-495.9614174985928,130486.10806752689,3723,3,561.8333333333334,36,12,16,35.194123579024556,0.6302083333333335,44.08783783783783,1023.648648648648,28.434684684684665,0
3747,4,0,0,48,0.0,0.0,1.0,48,1200,900,300,0.75,15,9,6,350.2056761601761,0.8649711879432624,0.2976145855643608,0.20362519327420428,131047.29940943349,-421.29838027087357,130626.00102916261,3724,4,562.8333333333334,37,11,16,35.05970229171129,0.6289414414414415,44.024122807017534,1023.9035087719284,27.673067804646713,0
3748,4,1,1,48,0.02040816326530612,0.02040816326530612,0.9795918367346939,49,1500,900,600,0.6,21,9,12,342.7228206779613,0.8686933106575964,0.2945004542002352,0.20059426594043203,131300.74929003205,-800.0473692380851,130500.70192079396,3725,0,552.3265306122449,38,11,16,34.99535251398589,0.6296600877192983,43.7767094017094,1024.8931623931617,26.970872694556885,0
3749,4,0,0,48,0.0,0.0,1.0,48,1150,800,350,0.6956521739130435,15,8,7,355.4397864856504,0.8645648640661938,0.2981429463171037,0.2077288808448029,131243.84576263832,-270.14309691445715,130973.70266572386,3726,6,564.8333333333334,37,11,16,34.7270153379704,0.6309121621621623,43.83223684210525,1024.6710526315774,27.693812233285875,0
3750,4,1,1,48,0.02040816326530612,0.02040816326530612,0.9795918367346939,49,1250,900,350,0.72,16,9,7,346.57845715538025,0.8662485827664399,0.28922902494331093,0.20479636104636098,131665.51246537393,-673.4869142428489,130992.02555113108,3727,0,554.2857142857143,37,12,14,34.52857905982906,0.6351351351351351,43.421052631578945,1026.315789473684,27.738264580369837,0
3751,4,0,0,48,0.0,0.0,1.0,48,1300,900,400,0.6923076923076923,17,9,8,353.17439231268474,0.8615728427895981,0.29109260072455845,0.20795510921630536,131530.20154867697,-309.38019945621807,131220.82134922076,3728,8,566.8333333333334,36,12,19,34.4958740439858,0.6357060185185186,43.552927927927925,1025.7882882882877,28.494119119119105,0
3752,4,0,0,48,0.0,0.0,1.0,48,1050,600,450,0.5714285714285714,15,6,9,337.9479351540968,0.8615174349881797,0.2358708030269634,0.19383941615602232,130521.37230135537,-674.8100296242235,129846.56227173115,3729,9,567.8333333333334,36,12,15,35.90501248989788,0.6255787037037037,44.538288288288285,1021.8468468468466,28.384634634634626,6
3753,4,0,0,48,0.0,0.0,1.0,48,1400,1200,200,0.8571428571428571,16,12,4,334.55089471130987,0.8619791666666666,0.23894297822122068,0.19213486688873185,130570.58572108719,-863.4987448061049,129707.08697628109,3730,10,568.8333333333334,37,11,15,35.94202607016414,0.6241554054054055,44.49013157894736,1022.0394736842101,27.622688477951623,0
3754,4,0,1,47,0.0,0.020833333333333332,0.9791666666666666,48,1500,1000,500,0.6666666666666666,20,10,10,332.92946373669037,0.8615543735224586,0.2520190108633502,0.1921761161965253,130766.7743921207,-892.7775854108922,129873.99680670981,3731,11,569.8333333333334,37,11,16,35.78518081761004,0.6261261261261261,44.29824561403509,1022.8070175438601,27.643432906590814,0
3755,4,0,0,47,0.0,0.0,1.0,47,1400,900,500,0.6428571428571429,19,9,10,335.8451083845979,0.8584643848288621,0.235813513544314,0.19484860700871476,130963.11034404815,-603.3360024238209,130359.77434162433,3732,12,504.97872340425533,37,10,17,35.512296911265864,0.6280968468468469,44.10635964912281,1023.5745614035086,27.66417733522996,0
3756,4,0,0,47,0.0,0.0,1.0,47,1150,500,650,0.43478260869565216,18,5,13,337.2655651821716,0.8580018501387603,0.23452858369822582,0.19655714124021165,131136.5549551648,-554.4311354006841,130582.1238197641,3733,13,505.97872340425533,38,9,17,35.300841417196885,0.628015350877193,43.93696581196581,1024.2521367521372,26.954003598740453,0
3757,4,0,0,47,0.0,0.0,1.0,47,1400,1000,400,0.7142857142857143,18,10,8,329.0221310202179,0.8589269195189638,0.1844787149678575,0.19297530568209068,131380.213497257,-748.5622851780552,130631.65121207896,3734,14,506.97872340425533,40,7,19,35.26632302405498,0.6270833333333332,43.69918699186992,1025.2032520325208,25.63008130081302,2
3758,4,0,0,47,0.0,0.0,1.0,47,1250,700,550,0.56,18,7,11,331.9760331758204,0.8588112858464384,0.17966949918945319,0.195372250894668,131510.47992473075,-668.3345107079012,130842.14541402285,3735,15,507.97872340425533,40,7,20,35.059364576108855,0.6283854166666667,43.57215447154472,1025.7113821138219,25.642784552845548,0
3759,4,0,0,47,0.0,0.0,1.0,47,1950,1400,550,0.717948717948718,25,14,11,331.40370666639865,0.8577705827937094,0.1835949354283979,0.19543527000607244,131588.6707647564,-678.2053506510742,130910.46541410532,3736,16,508.97872340425533,40,7,17,34.99529516640253,0.6291666666666667,43.49593495934959,1026.0162601626014,25.650406504065035,0
3760,4,0,0,47,0.0,0.0,1.0,47,1100,600,500,0.5454545454545454,16,6,10,332.01534410388024,0.8561131668208448,0.1878119774049376,0.19660134854263767,131745.12215777647,-651.7195865556212,131093.40257122085,3737,17,509.97872340425533,40,7,17,34.82210618359401,0.6307291666666668,43.34349593495935,1026.6260162601627,25.665650406504067,0
3761,4,0,0,47,0.0,0.0,1.0,47,1150,800,350,0.6956521739130435,15,8,7,332.92142556682103,0.8563058896083873,0.19100082545779262,0.19740833825863602,131797.29327781074,-624.3714472205752,131172.92183059017,3738,18,510.97872340425533,40,7,18,34.746346331485896,0.6312500000000001,43.292682926829265,1026.8292682926822,25.670731707317053,0
3762,4,0,0,47,0.0,0.0,1.0,47,1600,1200,400,0.75,20,12,8,332.8065855216753,0.8552266419981498,0.1955552749542273,0.1981551578106086,131953.86860499685,-616.9767086390515,131336.8918963578,3739,19,511.97872340425533,40,7,18,34.59178206396308,0.6328125,43.14024390243902,1027.4390243902426,25.685975609756063,0
3763,4,0,0,47,0.0,0.0,1.0,47,1150,600,550,0.5217391304347826,17,6,11,332.0461637567632,0.854841196423065,0.19593996006035108,0.1978384656302083,131979.97352972775,-635.3112193469447,131344.6623103808,3740,20,512.9787234042553,40,7,18,34.58506412158374,0.6330729166666667,43.114837398373986,1027.5406504065047,25.68851626016262,0
3764,4,0,1,46,0.0,0.02127659574468085,0.9787234042553191,47,800,500,300,0.625,11,5,6,336.08995176418864,0.8545713845205056,0.20274725390323378,0.20052375706143002,132032.19112507434,-525.0614506907289,131507.1296743836,3741,21,513.9787234042553,40,7,18,34.428664425327135,0.6335937500000001,43.0640243902439,1027.7439024390242,25.693597560975604,0
3765,4,0,0,46,0.0,0.0,1.0,46,1300,800,500,0.6153846153846154,18,8,10,341.682482789851,0.850523349436393,0.21093213020567148,0.20409943947761777,132076.58420138867,-174.3489583333573,131902.23524305533,3742,22,524.695652173913,39,7,18,34.24030536413998,0.6356837606837609,43.02083333333332,1027.916666666665,26.356837606837562,0
3766,4,0,0,46,0.0,0.0,1.0,46,1000,700,300,0.7,13,7,6,340.62878206964086,0.8504428341384863,0.2057398352495483,0.20375794418347598,132130.12695312488,-198.53515625001467,131931.59179687485,3743,23,525.695652173913,39,7,18,34.21352583586626,0.6362179487179489,42.96874999999999,1028.124999999999,26.362179487179464,0
3767,4,0,0,46,0.0,0.0,1.0,46,950,600,350,0.631578947368421,13,6,7,342.5202359398297,0.8483494363929147,0.20760913589377816,0.20576215633465683,132290.8203125,-137.54340277777783,132153.27690972222,3744,24,526.695652173913,39,7,19,34.003307681922514,0.6378205128205128,42.8125,1028.75,26.378205128205128,0
3768,4,0,0,46,0.0,0.0,1.0,46,1200,800,400,0.6666666666666666,16,8,8,340.72762253411025,0.8480676328502416,0.20766271889867371,0.2051217661800411,132371.20361328113,-179.49490017362552,132191.7087131075,3745,25,527.695652173913,39,7,19,33.968624523399804,0.6386217948717949,42.73437499999999,1029.062499999999,26.386217948717924,0
3769,4,0,0,46,0.0,0.0,1.0,46,1500,1100,400,0.7333333333333333,19,11,8,341.37529963006216,0.8475040257648954,0.2036438708512891,0.2059581097016689,132452.9860312113,-156.76172866613865,132296.22430254516,3746,26,528.695652173913,38,8,19,33.869788963847085,0.641173245614035,42.654914529914535,1029.3803418803427,27.08895636527218,0
3770,4,0,0,46,0.0,0.0,1.0,46,1200,900,300,0.75,15,9,6,352.448588467993,0.8480877616747182,0.14694750153652936,0.2054313556849897,131141.34250217024,48.02274629436596,131189.3652484646,3747,27,529.695652173913,39,7,16,34.90722143123496,0.62633547008547,43.93229166666667,1024.2708333333342,26.263354700854723,3
3771,4,0,1,45,0.0,0.021739130434782608,0.9782608695652174,46,900,500,400,0.5555555555555556,13,5,8,352.529022616065,0.8483494363929147,0.14823178977699558,0.20619384806758925,131274.7450086807,55.63151041668627,131330.3765190974,3748,28,530.695652173913,39,7,17,34.77036321745613,0.6276709401709402,43.80208333333334,1024.791666666668,26.27670940170944,0
3772,4,0,1,44,0.0,0.022222222222222223,0.9777777777777777,45,1150,900,250,0.782608695652174,14,9,5,357.921871901646,0.8470117845117846,0.149412827461608,0.20963995354239248,131328.12499999988,401.0633680555409,131729.18836805542,3749,29,541.2222222222222,36,9,17,34.57825203252032,0.6336805555555556,43.74999999999999,1024.999999999999,28.472222222222197,0
3773,4,0,0,44,0.0,0.0,1.0,44,1000,700,300,0.7,13,7,6,366.5146407561636,0.844366631430585,0.1516999260901699,0.2146728610143245,131328.12500000012,826.7361111111253,132154.86111111124,3750,30,547.4090909090909,37,7,17,34.35806233062331,0.6317567567567567,43.75000000000001,1025.000000000001,27.702702702702727,0
3774,4,1,0,45,0.022222222222222223,0.0,1.0,45,1200,900,300,0.75,15,9,6,358.6031143487351,0.8479377104377105,0.15864028189277812,0.2117919754413496,131645.7436110097,441.7147299326382,132087.45834094234,3751,0,536.2222222222222,36,9,14,34.24000512088956,0.6368634259259259,43.44031531531532,1026.2387387387391,28.50663163163164,0
3775,4,0,0,45,0.0,0.0,1.0,45,1500,1000,500,0.6666666666666666,20,10,10,357.79870124203757,0.8472643097643098,0.157937465715853,0.21163758350559214,131703.53366457683,424.6706588345182,132128.20432341134,3752,1,537.2222222222222,36,9,15,34.202322179557505,0.6374421296296295,43.38400900900901,1026.4639639639645,28.512887887887903,0
3776,4,0,0,45,0.0,0.0,1.0,45,1250,800,450,0.64,17,8,9,354.4785414742998,0.8461279461279462,0.1562719298245614,0.21047163400036548,131848.0642804967,347.46190447203674,132195.52618496874,3753,2,538.2222222222222,36,9,15,34.14176717836258,0.6388888888888888,43.24324324324324,1027.0270270270269,28.528528528528525,0
3777,4,0,0,45,0.0,0.0,1.0,45,1300,800,500,0.6153846153846154,18,8,10,358.48715782632405,0.8445286195286196,0.15326661309567302,0.21382704590346624,132021.60564280505,465.6100357113979,132487.21567851646,3754,3,539.2222222222222,36,9,15,33.86386879976625,0.640625,43.07432432432433,1027.7027027027034,28.547297297297316,0
3778,4,0,1,44,0.0,0.022222222222222223,0.9777777777777777,45,900,600,300,0.6666666666666666,12,6,6,356.77899946053276,0.844402356902357,0.15474480240855337,0.2130220599326772,132059.6782182978,423.2239727608296,132482.90219105865,3755,4,540.2222222222222,37,8,15,33.869390512765804,0.6390765765765766,43.037280701754376,1027.8508771929812,27.77975343764814,0
3779,4,1,1,44,0.022222222222222223,0.022222222222222223,0.9777777777777777,45,1150,800,350,0.6956521739130435,15,8,7,350.9318297300397,0.8459175084175085,0.1462887989203776,0.21141502913004845,132398.0034722223,292.96754770699056,132690.9710199293,3756,0,538.6,37,8,15,33.679149797570844,0.642454954954955,42.708333333333336,1029.1666666666672,27.81531531531533,0
3780,4,0,0,44,0.0,0.0,1.0,44,1300,800,500,0.6153846153846154,18,8,10,357.079900193574,0.8406888653981678,0.1545197904258313,0.21527996294907373,132426.21678064394,657.3480542089794,133083.5648348529,3757,6,551.8409090909091,37,7,16,33.49257394978872,0.6427364864864864,42.680921052631575,1029.2763157894728,27.818278805120887,0
3781,4,0,1,43,0.0,0.022727272727272728,0.9772727272727273,44,400,400,0,1.0,4,4,0,357.97359999956393,0.8398740310077519,0.15804508657086402,0.21598047280179364,132454.43309479853,683.0380501692914,133137.47114496783,3758,7,552.8409090909091,37,7,16,33.441183780712954,0.6430180180180181,42.65350877192983,1029.3859649122817,27.82124229492653,0
3782,4,0,1,42,0.0,0.023255813953488372,0.9767441860465116,43,1000,500,500,0.5,15,5,10,359.9707585217636,0.8398394241417497,0.1525921178457339,0.21769660158220966,132542.9145361579,942.3146964532195,133485.22923261113,3759,8,556.2325581395348,36,7,17,33.300752770487016,0.6458333333333334,42.56756756756757,1029.7297297297307,28.60360360360363,0
3783,4,0,0,42,0.0,0.0,1.0,42,1050,700,350,0.6666666666666666,14,7,7,363.58240156548413,0.8373015873015873,0.15914674288283392,0.21990432540639776,132546.94097490134,1238.3470239626151,133785.28799886396,3760,9,567.952380952381,35,7,18,33.20372503840247,0.6479166666666667,42.563657407407405,1029.7453703703698,29.42129629629628,0
3784,4,0,0,42,0.0,0.0,1.0,42,1000,600,400,0.6,14,6,8,364.15739974911105,0.8366240805265196,0.15467764456642152,0.22095194377415373,132666.15125868047,1262.272135416662,133928.42339409713,3761,10,568.952380952381,35,7,14,33.06896697000337,0.6491071428571429,42.447916666666664,1030.2083333333328,29.434523809523796,0
3785,4,0,1,41,0.0,0.023809523809523808,0.9761904761904762,42,1350,1100,250,0.8148148148148148,16,11,5,360.32141585719353,0.8370838172667441,0.14767038891028061,0.21914630374265381,132755.59413580247,1166.9367283950542,133922.53086419753,3762,11,569.952380952381,35,7,14,33.07783018867924,0.65,42.36111111111111,1030.5555555555554,29.44444444444444,0
3786,4,0,0,41,0.0,0.0,1.0,41,1000,700,300,0.7,13,7,6,370.0172927180103,0.8354166666666667,0.15288422523781553,0.22492062400049834,132735.14739229015,1622.8599773242463,134358.0073696144,3763,12,581.829268292683,34,7,14,32.84860212569314,0.6519607843137256,42.38095238095237,1030.4761904761897,30.308123249299697,0
3787,4,0,1,40,0.0,0.024390243902439025,0.975609756097561,41,950,700,250,0.7368421052631579,12,7,5,371.27375529846455,0.8358231707317073,0.1520438838441751,0.22586907235550271,132765.8180980724,1658.492772108827,134424.31087018122,3764,13,582.829268292683,34,7,14,32.785366370182125,0.6522671568627452,42.35119047619047,1030.595238095237,30.31162464985991,0
3788,4,0,0,40,0.0,0.0,1.0,40,750,600,150,0.8,9,6,3,381.76794154631403,0.834909188034188,0.1471931493815415,0.23192954136715374,132713.49961553246,2133.151912725869,134846.65152825834,3765,14,570.0,33,7,14,32.5676934665398,0.6540404040404041,42.40196078431372,1030.3921568627447,31.22400475341651,0
3789,4,0,0,40,0.0,0.0,1.0,40,1000,700,300,0.7,13,7,6,381.3849760324138,0.834909188034188,0.15032398050172402,0.2322830581758603,132808.22167255374,2130.212087898876,134938.4337604526,3766,15,571.0,33,7,14,32.482141441762764,0.6549873737373737,42.31004901960784,1030.759803921568,31.235145573380848,0
3790,4,1,1,40,0.024390243902439025,0.024390243902439025,0.975609756097561,41,1200,900,300,0.75,15,9,6,370.20057965126915,0.8407520325203252,0.15290666111597084,0.22782180455331094,133195.58000283435,1661.816184807243,134857.3961876416,3767,0,558.0487804878048,34,7,15,32.38092492215431,0.6565563725490196,41.9345238095238,1032.261904761904,30.360644257703058,0
3791,4,0,0,40,0.0,0.0,1.0,40,1150,1000,150,0.8695652173913043,13,10,3,380.1844017181835,0.8346955128205128,0.160365712967236,0.2333879882502278,133103.42970521547,2120.769557823133,135224.1992630386,3768,17,573.0,34,6,15,32.21595716043685,0.6556372549019608,42.023809523809526,1031.9047619047624,30.350140056022422,0
3792,4,0,0,40,0.0,0.0,1.0,40,950,700,250,0.7368421052631579,12,7,5,380.16387096259234,0.8346153846153846,0.16479238754325287,0.23376033767699825,133164.85969387754,2124.8937074829946,135289.75340136053,3769,18,574.0,34,6,15,32.15470011534026,0.65625,41.964285714285715,1032.142857142857,30.357142857142858,0
3793,4,1,2,39,0.024390243902439025,0.04878048780487805,0.9512195121951219,41,1250,1000,250,0.8,15,10,5,375.2601456815819,0.8376524390243902,0.15243902439024426,0.2326612903225806,133472.22222222204,1817.7154195011144,135289.93764172317,3770,0,560.9756097560976,34,7,15,31.972446236559147,0.6593137254901962,41.66666666666666,1033.333333333332,30.392156862745054,0
3794,4,0,0,39,0.0,0.0,1.0,39,950,600,350,0.631578947368421,13,6,7,384.9044142693329,0.8305780476833109,0.14207456521353734,0.23824539993076096,133410.72137188193,2470.075113378667,135880.7964852606,3771,20,574.1025641025641,34,5,15,31.78511753860336,0.6587009803921569,41.72619047619047,1033.095238095237,30.385154061624615,0
3795,4,0,1,38,0.0,0.02564102564102564,0.9743589743589743,39,850,600,250,0.7058823529411765,11,6,5,385.0568209737291,0.8300719748088169,0.14380949849213875,0.238933399776479,133502.97796201808,2481.2464569160943,135984.22441893417,3772,21,575.1025641025641,34,5,15,31.688457550973396,0.6596200980392157,41.63690476190476,1033.4523809523805,30.395658263305307,0
3796,4,0,0,38,0.0,0.0,1.0,38,700,400,300,0.5714285714285714,10,4,6,390.5130990521631,0.8254800853485064,0.14706947018916927,0.24232501576945473,133503.88259623686,2827.002985630507,136330.88558186736,3773,22,588.2894736842105,33,5,15,31.546577927981335,0.6619318181818183,41.636029411764696,1033.4558823529399,31.316844919786057,0
3797,4,0,0,38,0.0,0.0,1.0,38,850,600,250,0.7058823529411765,11,6,5,392.9612775161926,0.8247392128971076,0.15321554241221835,0.24447060008308255,133598.88624567466,2899.8378027681574,136498.72404844282,3774,23,589.2894736842105,33,5,16,31.387802275960162,0.662878787878788,41.54411764705882,1033.8235294117642,31.32798573975043,0
3798,4,0,0,38,0.0,0.0,1.0,38,750,600,150,0.8,9,6,3,391.9163585323342,0.8246206733048839,0.15363717460060045,0.24402939608393348,133630.56163795153,2874.4006211552996,136504.96225910683,3775,24,590.2894736842105,33,5,16,31.3829708427166,0.6631944444444446,41.51348039215685,1033.9460784313708,31.331699346405173,0
3799,4,0,0,38,0.0,0.0,1.0,38,1450,1200,250,0.8275862068965517,17,12,5,394.13305855436965,0.8254504504504505,0.15468671085366514,0.24625293466006162,133757.3007527152,2943.6348099288584,136700.93556264407,3776,25,591.2894736842105,33,5,15,31.198293053745605,0.6644570707070707,41.39093137254901,1034.436274509803,31.346553773024336,0
3800,4,0,0,38,0.0,0.0,1.0,38,1300,1100,200,0.8461538461538461,15,11,4,382.71225572839273,0.8279694167852063,0.12259972698316401,0.2363009835191319,133318.49666950098,2604.5245181405735,135923.02118764154,3777,26,592.2894736842105,34,4,16,31.934438040345828,0.6577818627450981,41.81547619047618,1032.738095238094,30.374649859943943,8
3801,4,0,0,38,0.0,0.0,1.0,38,1600,1300,300,0.8125,19,13,6,383.77836954393877,0.8274656235182551,0.12031981752444776,0.23715535143612587,133349.23469387737,2635.3103741496443,135984.54506802702,3778,27,593.2894736842105,34,4,16,31.876008529276167,0.6580882352941178,41.78571428571428,1032.8571428571415,30.37815126050416,0
3802,4,1,0,39,0.02564102564102564,0.0,1.0,39,1300,900,400,0.6923076923076923,17,9,8,387.5903441064623,0.8317588843904634,0.06718919793762002,0.22985972813586453,131803.0907064472,2417.1210562414285,134220.21176268862,3779,0,579.0512820512821,35,4,17,33.33709047189661,0.6404761904761904,43.28703703703704,1026.851851851852,29.338624338624342,7
3803,4,0,0,39,0.0,0.0,1.0,39,1150,800,350,0.6956521739130435,15,8,7,389.8390859456325,0.8312528115159694,0.0683413949134033,0.23155502333879133,131862.52170138882,2481.032986111106,134343.5546874999,3780,1,580.0512820512821,35,4,17,33.219235970250175,0.6410714285714285,43.229166666666664,1027.0833333333328,29.34523809523808,0
3804,4,0,0,39,0.0,0.0,1.0,39,1150,700,450,0.6086956521739131,16,7,9,366.06029498087435,0.8291722896986056,-0.01381678715568313,0.21333860474052535,131136.55495516473,1801.862267377092,132938.41722254182,3781,2,581.0512820512821,38,1,20,34.563514829108875,0.628015350877193,43.93696581196581,1024.2521367521367,26.95400359874044,8
3805,4,0,0,39,0.0,0.0,1.0,39,1200,900,300,0.75,15,9,6,364.6994035719092,0.8281601439496177,-0.016890703075515212,0.21316387599149567,131248.05908203125,1773.2177734374993,133021.27685546875,3782,3,582.0512820512821,39,0,20,34.485551997560236,0.6274038461538461,43.828125,1024.6875,26.27403846153846,0
3806,4,0,0,39,0.0,0.0,1.0,39,900,700,200,0.7777777777777778,11,7,4,369.41425465009263,0.8282726045883941,-0.014920010641477965,0.21653002299208235,131356.22409058543,1905.0211513398215,133261.24524192524,3783,4,583.0512820512821,37,2,21,34.25533479516527,0.6320382882882883,43.72258771929824,1025.1096491228059,27.705666192508268,0
3807,4,0,0,39,0.0,0.0,1.0,39,850,500,350,0.5882352941176471,12,5,7,366.43699514960593,0.827710301394512,-0.007742804241710255,0.21508843073093367,131410.2692513148,1830.7168392504793,133240.98609056527,3784,5,584.0512820512821,38,1,21,34.27698760029175,0.6307565789473685,43.66987179487179,1025.3205128205118,26.98211875843452,0
3808,4,0,0,39,0.0,0.0,1.0,39,1000,800,200,0.8,12,8,4,367.9316406250003,0.827485380116959,-0.004439102564102404,0.21643037683823524,131492.43918474676,1876.0457758053806,133368.48496055213,3785,6,585.0512820512821,38,1,21,34.15559895833333,0.631578947368421,43.589743589743584,1025.6410256410247,26.990553306342758,0
3809,4,0,0,39,0.0,0.0,1.0,39,1150,800,350,0.6956521739130435,15,8,7,363.20441134788297,0.826135852451642,-0.010620851229988348,0.21422535639381138,131595.18771701396,1759.1905381944487,133354.3782552084,3786,7,586.0512820512821,39,0,15,34.17301184433164,0.6308760683760684,43.489583333333336,1026.0416666666672,26.3087606837607,0
3810,4,1,1,39,0.025,0.025,0.975,40,1200,1000,200,0.8333333333333334,14,10,4,356.83676637380574,0.8291666666666667,-0.00811399168810567,0.2118796921841175,131849.47472569233,1409.7480418401751,133259.2227675325,3787,0,572.375,40,0,16,34.07979583085956,0.6317708333333333,43.24186991869919,1027.032520325203,25.675813008130074,0
3811,4,0,0,39,0.0,0.0,1.0,39,1400,1100,300,0.7857142857142857,17,11,6,354.295437695579,0.8232118758434548,0.011722807926502155,0.20172812283433916,130236.00396050338,1428.4044053819352,131664.40836588532,3788,9,588.0512820512821,39,0,16,35.77671616151309,0.6172542735042736,44.81770833333333,1020.7291666666658,26.172542735042715,4
3812,4,0,0,39,0.0,0.0,1.0,39,650,400,250,0.6153846153846154,9,4,5,355.8946527825536,0.8232118758434548,0.01815744370343997,0.20292710202054243,130291.32806793257,1474.0055306837426,131765.3335986163,3789,10,589.0512820512821,36,3,16,35.67978343995883,0.6232638888888891,44.7635135135135,1020.945945945944,28.359609609609556,0
3813,4,0,0,39,0.0,0.0,1.0,39,900,600,300,0.6666666666666666,12,6,6,353.1419068480956,0.8228744939271255,0.022494904867300436,0.20210411590025684,130435.08193582078,1412.4187109406503,131847.50064676144,3790,11,590.0512820512821,36,3,17,35.604306765149005,0.6247106481481483,44.62274774774774,1021.5090090090075,28.375250250250208,0
3814,4,0,0,39,0.0,0.0,1.0,39,850,500,350,0.5882352941176471,12,5,7,352.91195955533084,0.8229307242465137,0.023798624415772407,0.20242244759829758,130521.37230135521,1412.5106525444166,131933.88295389962,3791,12,591.0512820512821,36,3,15,35.52273896113439,0.6255787037037038,44.53828828828828,1021.8468468468452,28.38463463463459,0
3815,4,0,0,39,0.0,0.0,1.0,39,750,400,350,0.5333333333333333,11,4,7,352.0072639159422,0.8221434997750787,0.02420521622409577,0.2023065175230834,130598.6036568944,1394.3314289011919,131992.9350857956,3792,13,592.0512820512821,37,2,15,35.467621397411136,0.6244369369369369,44.46271929824561,1022.1491228070173,27.625651967757225,0
3816,4,0,0,39,0.0,0.0,1.0,39,1500,1000,500,0.6666666666666666,20,10,10,352.6545482787444,0.8219185784975259,0.027467027467027894,0.20297228445376597,130654.64854570616,1415.191212680806,132069.83975838698,3793,14,593.0512820512821,37,2,16,35.394322894322904,0.625,44.407894736842096,1022.3684210526299,27.631578947368375,0
3817,4,0,0,39,0.0,0.0,1.0,39,900,700,200,0.7777777777777778,11,7,4,351.73123093717237,0.8206815114709852,0.03590898219396177,0.20288170630494767,130738.73842191813,1396.9794792628381,132135.71790118096,3794,15,594.0512820512821,37,2,16,35.33279278796328,0.6258445945945947,44.325657894736835,1022.6973684210514,27.640469416785173,0
3818,4,2,2,39,0.04878048780487805,0.04878048780487805,0.9512195121951219,41,1100,600,500,0.5454545454545454,16,6,10,334.65633383324734,0.8286077235772358,0.032533227534218945,0.1954811794731637,131223.97898902788,582.9871438958451,131806.96613292373,3795,0,566.0243902439024,40,1,17,35.27945844078555,0.6255208333333333,43.85162601626017,1024.5934959349609,25.61483739837402,0
3819,4,3,2,40,0.07142857142857142,0.047619047619047616,0.9523809523809523,42,550,200,350,0.36363636363636365,9,2,7,328.62796389771137,0.8346157568718544,0.04589764419171383,0.1935602983531497,131541.7534722223,245.74234499968009,131787.495817222,3796,0,553.4761904761905,39,3,19,35.113728675873276,0.6303418803418803,43.54166666666667,1025.8333333333342,26.303418803418825,0
3820,4,0,1,39,0.0,0.025,0.975,40,700,500,200,0.7142857142857143,9,5,4,339.26872372672926,0.8282318376068376,0.04396256684491995,0.19900643455739778,131384.32618690372,914.918532625428,132299.24471952915,3797,1,566.55,37,3,19,34.99955436720143,0.6323198198198199,43.69517543859649,1025.2192982456145,27.708629682313905,0
3821,4,0,0,39,0.0,0.0,1.0,39,950,700,250,0.7368421052631579,12,7,5,345.2773955448681,0.8254610886189834,0.04649460003660977,0.2026918559920067,131414.71021274655,1274.905775708141,132689.6159884547,3798,2,580.1025641025641,36,3,20,34.814891085484156,0.6345486111111112,43.66554054054054,1025.337837837838,28.481606606606608,0
3822,4,1,1,39,0.025,0.025,0.975,40,1300,1100,200,0.8461538461538461,15,11,4,335.7364482925843,0.8298878205128205,0.043800749531543115,0.19834466926805427,131656.85609796178,840.4010519395051,132497.25714990127,3799,0,566.575,38,2,15,34.81547990839058,0.6332236842105263,43.429487179487175,1026.2820512820506,27.007422402159225,0
3823,4,0,0,39,0.0,0.0,1.0,39,1100,800,300,0.7272727272727273,14,8,6,343.97809613838325,0.8243364822312191,0.04497189256714562,0.20321362801385656,131656.8560979618,1257.4149408283938,132914.2710387902,3800,4,582.1025641025641,38,1,16,34.6040235269623,0.6332236842105263,43.429487179487175,1026.2820512820508,27.007422402159232,0
3824,4,0,2,37,0.0,0.05128205128205128,0.9487179487179487,39,950,600,350,0.631578947368421,13,6,7,342.9479581679371,0.8234367971210077,0.05657826313052561,0.20392360035774326,131903.67408366175,1247.2191403681459,133150.8932240299,3801,5,583.1025641025641,38,1,17,34.38182527301092,0.6356907894736843,43.18910256410255,1027.2435897435873,27.032726045883877,0
3825,4,0,1,36,0.0,0.02702702702702703,0.972972972972973,37,1150,800,350,0.6956521739130435,15,8,7,356.559336337019,0.8143768768768769,0.05931952136427743,0.21106460454858877,131732.43344696052,1994.0858087817578,133726.51925574229,3802,6,614.1351351351351,36,1,17,34.20496928477401,0.6377314814814814,43.35585585585586,1026.576576576577,28.516016016016028,0
3826,4,1,1,36,0.02702702702702703,0.02702702702702703,0.972972972972973,37,1050,700,350,0.6666666666666666,14,7,7,351.9120555820431,0.8161286286286287,0.06347767886229416,0.209905190800113,132021.60564280508,1891.998924600287,133913.60456740536,3803,0,612.1081081081081,36,1,17,34.03280005844108,0.640625,43.07432432432433,1027.7027027027036,28.547297297297323,0
3827,4,0,0,36,0.0,0.0,1.0,36,750,600,150,0.8,9,6,3,360.7383594719817,0.8080687830687832,0.06880139686831166,0.2147736027520309,131951.69331114975,2320.007474922846,134271.7007860726,3804,8,630.1111111111111,35,1,17,33.876520784048665,0.6419642857142855,43.142361111111114,1027.4305555555559,29.355158730158738,0
3828,4,0,0,36,0.0,0.0,1.0,36,950,700,250,0.7368421052631579,12,7,5,359.61489023866477,0.8075066137566138,0.0692551713781584,0.21444060513291494,132011.157795889,2294.635604209532,134305.79340009854,3805,9,631.1111111111111,35,1,17,33.84542647445283,0.6425595238095239,43.08449074074074,1027.6620370370367,29.361772486772477,0
3829,4,1,1,36,0.02702702702702703,0.02702702702702703,0.972972972972973,37,950,400,550,0.42105263157894735,15,4,11,352.04536974723914,0.8145645645645646,0.060620042235275395,0.21192296368578883,132369.0307706357,1919.9808761464403,134289.01164678214,3806,0,615.027027027027,36,1,19,33.67964361275262,0.6440972222222221,42.7364864864865,1029.0540540540558,28.584834834834883,0
3830,4,1,1,36,0.02702702702702703,0.02702702702702703,0.972972972972973,37,1050,900,150,0.8571428571428571,12,9,3,352.4846948107157,0.8119369369369369,0.0669385373680409,0.21268649088510885,132457.56842635456,1937.8562868267393,134395.4247131813,3807,0,616.0,35,2,19,33.57928566074507,0.6470238095238094,42.65046296296296,1029.3981481481478,29.41137566137565,0
3831,4,0,0,36,0.0,0.0,1.0,36,1000,800,200,0.8,12,8,4,365.9804971600656,0.8069444444444445,0.08098529651812503,0.2132035167458473,131120.5970963006,2401.3876832561764,133521.98477955678,3808,12,634.1111111111111,35,1,18,34.58170885599126,0.6336309523809524,43.9525462962963,1024.189814814815,29.262566137566143,3
3832,4,0,0,36,0.0,0.0,1.0,36,1000,800,200,0.8,12,8,4,369.01685700448405,0.8060185185185186,0.08332078549469912,0.21597120084432933,131298.4681096749,2490.269606267128,133788.73771594203,3809,13,635.1111111111111,35,1,19,34.32394598155469,0.6354166666666667,43.778935185185176,1024.8842592592578,29.282407407407366,0
3833,4,1,0,37,0.02702702702702703,0.0,1.0,37,950,600,350,0.631578947368421,13,6,7,364.4869677890591,0.8145645645645646,0.09169133044175348,0.21531685165793377,131654.57182623885,2197.2784850823023,133851.85031132115,3810,0,618.918918918919,35,2,17,34.08013326566671,0.6389880952380952,43.43171296296296,1026.273148148148,29.322089947089943,0
3834,4,0,0,37,0.0,0.0,1.0,37,950,600,350,0.631578947368421,13,6,7,363.8877485005131,0.8132507507507507,0.09858923184740598,0.2154662436047763,131743.6731074245,2187.981717249652,133931.65482467413,3811,1,619.918918918919,35,2,18,34.005543028936486,0.6398809523809523,43.344907407407405,1026.6203703703698,29.332010582010565,0
3835,4,0,0,37,0.0,0.0,1.0,37,1150,800,350,0.6956521739130435,15,8,7,366.28927590825157,0.813501001001001,0.09433229698609669,0.2173189269360668,131819.1518165125,2256.7883339420537,134075.94015045455,3812,2,620.918918918919,36,1,18,33.86770296450633,0.638599537037037,43.2713963963964,1026.9144144144148,28.52540040040041,0
3836,4,0,0,37,0.0,0.0,1.0,37,700,400,300,0.5714285714285714,10,4,6,367.0440304622015,0.8138763763763763,0.09471142612353023,0.21833876326351515,131918.83710612875,2284.004333064019,134202.84143919277,3813,3,621.918918918919,37,0,18,33.74770964528411,0.637668918918919,43.17434210526316,1027.302631578947,27.76493598862019,0
3837,4,0,0,37,0.0,0.0,1.0,37,900,600,300,0.6666666666666666,12,6,6,363.3522061142749,0.8145645645645646,0.08874460122593253,0.21694672484810265,132059.6782182978,2196.835083871941,134256.51330216974,3814,4,622.918918918919,37,0,18,33.700483607140306,0.6390765765765766,43.037280701754376,1027.8508771929812,27.77975343764814,0
3838,4,0,0,37,0.0,0.0,1.0,37,850,600,250,0.7058823529411765,11,6,5,363.0686904154558,0.8128128128128128,0.08958286501472701,0.21742389391546246,132172.40521121878,2197.532413819626,134369.9376250384,3815,5,623.918918918919,37,0,18,33.59413876448425,0.6402027027027027,42.92763157894736,1028.28947368421,27.79160739687054,0
3839,4,0,0,37,0.0,0.0,1.0,37,1150,700,450,0.6086956521739131,16,7,9,364.61234362475426,0.8126876876876877,0.08626063710267506,0.21900083277128318,132285.18029586025,2246.561922899351,134531.7422187596,3816,6,624.918918918919,37,0,18,33.44080864065941,0.6413288288288288,42.81798245614035,1028.7280701754385,27.80346135609293,0
3840,4,0,0,37,0.0,0.0,1.0,37,500,300,200,0.6,7,3,4,365.1014765567768,0.8123748748748749,0.0844821379717493,0.21978687347564768,132369.79316953284,2265.6813875423095,134635.47455707515,3817,7,625.918918918919,37,0,18,33.342989699875694,0.6421734234234234,42.73574561403508,1029.0570175438588,27.812351825509698,0
3841,4,0,0,37,0.0,0.0,1.0,37,500,400,100,0.8,6,4,2,361.9185516258421,0.8099974974974975,0.08661523125623027,0.21874448308958133,132520.55165816328,2192.3382405536104,134712.88989871688,3818,8,626.918918918919,34,3,18,33.2731144255598,0.6498161764705883,42.589285714285715,1029.6428571428573,30.28361344537816,0
3842,4,0,0,37,0.0,0.0,1.0,37,850,600,250,0.7058823529411765,11,6,5,359.2952790666463,0.8094344344344344,0.08213043179532686,0.2180463776327317,132673.81660997716,2133.8151927437484,134807.63180272092,3819,9,627.918918918919,34,3,15,33.18648409213466,0.6513480392156863,42.44047619047618,1030.238095238094,30.301120448179237,0
3843,4,0,0,37,0.0,0.0,1.0,37,1450,1100,350,0.7586206896551724,18,11,7,357.66764983545715,0.8080580580580581,0.07802259534361133,0.2181268906742996,132857.85147392275,2103.7910997732224,134961.64257369598,3820,10,628.918918918919,34,3,16,33.04344688221708,0.653186274509804,42.26190476190475,1030.9523809523798,30.322128851540583,0
3844,4,0,0,37,0.0,0.0,1.0,37,1050,700,350,0.6666666666666666,14,7,7,356.92770849438085,0.8071821821821822,0.07642835076156884,0.21785418486750022,132888.53635204062,2086.320153061203,134974.85650510184,3821,11,629.918918918919,34,3,16,33.031693799792166,0.6534926470588236,42.23214285714285,1031.071428571427,30.325630252100797,0
3845,4,0,0,37,0.0,0.0,1.0,37,1300,900,400,0.6923076923076923,17,9,8,375.2310836412338,0.8079954954954955,0.10895446594820268,0.22189591242487808,131694.45153061242,2484.4494047619246,134178.90093537435,3822,12,630.918918918919,34,3,14,33.76415951442048,0.6415441176470587,43.39285714285715,1026.428571428573,30.189075630252145,2
3846,4,1,2,36,0.02631578947368421,0.05263157894736842,0.9473684210526316,38,600,300,300,0.5,9,3,6,365.72791701640153,0.8127667140825036,0.10159863380849554,0.21757379299179544,131921.96609224993,2049.5091735254077,133971.47526577534,3823,0,615.2894736842105,35,3,14,33.77835361273847,0.6416666666666664,43.17129629629631,1027.314814814817,29.351851851851915,0
3847,4,0,0,36,0.0,0.0,1.0,36,700,400,300,0.5714285714285714,10,4,6,380.2935845263081,0.7951058201058202,0.11995914252361217,0.22495332372827412,131705.23356401408,2817.331074586727,134522.5646386008,3824,28,650.1111111111111,33,3,16,33.62334845590577,0.6439393939393938,43.382352941176485,1026.470588235296,31.105169340463515,0
3848,4,0,0,36,0.0,0.0,1.0,36,950,700,250,0.7368421052631579,12,7,5,380.53763977057696,0.7944775132275133,0.11258636008009426,0.22565639657732958,131799.5951827423,2830.941374711661,134630.53655745398,3825,29,651.1111111111111,33,3,16,33.52167621434539,0.6448863636363635,43.290441176470594,1026.8382352941185,31.116310160427833,0
3849,4,0,0,36,0.0,0.0,1.0,36,600,200,400,0.3333333333333333,10,2,8,379.24264899054486,0.7941798941798942,0.11308833758404835,0.22498948350704556,131816.6737528346,2798.1009070294967,134614.7746598641,3826,30,652.1111111111111,34,2,16,33.53765746966535,0.6427696078431371,43.27380952380953,1026.904761904763,30.20308123249303,0
3850,4,0,0,36,0.0,0.0,1.0,36,1050,700,350,0.6666666666666666,14,7,7,381.1181722117864,0.7951058201058202,0.12005922492596888,0.22683102249570475,131938.95266439923,2856.8664965986545,134795.8191609979,3827,31,653.1111111111111,34,2,16,33.365923136346076,0.6439950980392156,43.15476190476191,1027.3809523809534,30.217086834733923,0
3851,4,1,0,37,0.02702702702702703,0.0,1.0,37,850,500,350,0.5882352941176471,12,5,7,372.8063930700157,0.8016141141141141,0.12401351503410685,0.22370900845464117,132249.14969403748,2460.665696802156,134709.81539083965,3828,0,636.4324324324324,35,2,17,33.26640504857282,0.644940476190476,42.853009259259274,1028.587962962965,29.388227513227573,0
3852,4,0,0,37,0.0,0.0,1.0,37,1050,800,250,0.7619047619047619,13,8,5,373.28174248185195,0.8009884884884885,0.12563159334812868,0.22452467460511963,132338.45191400917,2479.9055855624397,134818.3574995716,3829,1,637.4324324324324,35,2,17,33.16413573303336,0.6458333333333331,42.76620370370372,1028.935185185187,29.398148148148202,0
3853,4,0,0,37,0.0,0.0,1.0,37,900,700,200,0.7777777777777778,11,7,4,371.91234080217635,0.8003003003003003,0.12364591311959705,0.22405450775155547,132398.0034722225,2448.090277777812,134846.09375000032,3830,2,638.4324324324324,35,2,18,33.139338731444,0.6464285714285712,42.70833333333335,1029.166666666669,29.404761904761973,0
3854,4,0,0,37,0.0,0.0,1.0,37,850,600,250,0.7058823529411765,11,6,5,375.7173241927131,0.7991116116116116,0.12417892779711392,0.22710625596166722,132524.15687475973,2558.324322376009,135082.48119713576,3831,3,639.4324324324324,33,4,18,32.914286281044184,0.6521464646464646,42.58578431372549,1029.6568627450981,31.201723113487823,0
3855,4,0,0,37,0.0,0.0,1.0,37,950,700,250,0.7368421052631579,12,7,5,371.6941983959876,0.7992992992992993,0.1177884990709952,0.22575531839419472,132704.48022959192,2465.0970804988788,135169.5773100908,3832,4,640.4324324324324,34,3,16,32.83626997881764,0.6516544117647058,42.41071428571429,1030.3571428571436,30.304621848739515,0
3856,4,0,0,37,0.0,0.0,1.0,37,1000,700,300,0.7,13,7,6,371.14201111119087,0.7981731731731732,0.12174179029474086,0.22615894962785382,132827.17013888896,2459.548611111121,135286.7187500001,3833,5,641.4324324324324,34,3,16,32.72702775532202,0.6528799019607843,42.29166666666667,1030.833333333334,30.31862745098041,0
3857,4,0,0,37,0.0,0.0,1.0,37,1400,1000,400,0.7142857142857143,18,10,8,371.82235875401955,0.7954204204204204,0.1252631743110686,0.2276919249896522,133011.3112953514,2491.3159013605364,135502.62719671192,3834,6,642.4324324324324,34,3,16,32.52428351606079,0.654718137254902,42.113095238095234,1031.5476190476184,30.339635854341715,0
3858,4,0,0,37,0.0,0.0,1.0,37,1450,1100,350,0.7586206896551724,18,11,7,371.63468166623556,0.7936686686686687,0.11896629101426148,0.2288931789353404,133226.30385487518,2502.3030045351334,135728.6068594103,3835,7,643.4324324324324,34,3,17,32.31304773985241,0.6568627450980392,41.9047619047619,1032.3809523809516,30.364145658263283,0
3859,4,0,0,37,0.0,0.0,1.0,37,650,300,350,0.46153846153846156,10,3,7,370.19110382689405,0.7926676676676676,0.11746493525910351,0.22894855366400257,133379.97626133775,2475.216128117897,135855.19238945565,3836,8,644.4324324324324,34,3,19,32.19598747647035,0.6583946078431373,41.75595238095237,1032.9761904761895,30.381652661064397,0
3860,4,0,1,36,0.0,0.02702702702702703,0.972972972972973,37,800,600,200,0.75,10,6,4,367.86174012157903,0.7909159159159159,0.12141305092238075,0.22845319225576136,133533.73724489775,2424.3905895691405,135958.1278344669,3837,9,645.4324324324324,34,3,19,32.101858250787075,0.6599264705882353,41.60714285714285,1033.5714285714268,30.399159663865497,0
3861,4,0,0,36,0.0,0.0,1.0,36,850,500,350,0.5882352941176471,12,5,7,376.9035772763144,0.7912698412698413,0.1170449004335854,0.23348082733406345,133440.56560277284,2858.8453058919467,136299.41090866478,3838,10,625.6944444444445,33,3,19,31.961782904360884,0.6613005050505052,41.69730392156862,1033.2107843137244,31.309417706476495,0
3862,4,0,0,36,0.0,0.0,1.0,36,800,600,200,0.75,10,6,4,379.7467357892661,0.7912698412698413,0.12477933233209515,0.23584565314040257,133535.5467248172,2941.937596116856,136477.48432093405,3839,11,626.6944444444445,33,3,19,31.792941269464862,0.6622474747474748,41.605392156862735,1033.5784313725476,31.320558526440834,0
3863,4,0,0,36,0.0,0.0,1.0,36,850,500,350,0.5882352941176471,12,5,7,379.9663255379361,0.7903439153439153,0.12500658553290123,0.2363861299585564,133598.88624567457,2952.61558054592,136551.50182622048,3840,12,627.6944444444445,33,3,19,31.723664453927594,0.6628787878787881,41.54411764705881,1033.8235294117633,31.327985739750403,0
3864,4,0,0,36,0.0,0.0,1.0,36,1050,800,250,0.7619047619047619,13,8,5,379.82161871028825,0.7887896825396826,0.12545758605251356,0.23670124214751917,133662.24078479412,2953.561731064948,136615.80251585908,3841,13,628.6944444444445,33,3,20,31.66380263885595,0.6635101010101011,41.48284313725489,1034.068627450979,31.33541295305997,0
3865,4,0,0,36,0.0,0.0,1.0,36,1000,500,500,0.5,15,5,10,383.8694355319013,0.7863095238095239,0.13184329978290932,0.24066647238804018,133884.09994052752,3078.802774173375,136962.9027147009,3842,14,629.6944444444445,33,3,17,31.33646635089796,0.665719696969697,41.26838235294117,1034.926470588234,31.361408199643453,0
3866,4,0,0,36,0.0,0.0,1.0,36,950,800,150,0.8421052631578947,11,8,3,383.06458509042045,0.7859457671957673,0.13217959849501404,0.24036875822241388,133915.8091238946,3059.6807718185255,136975.48989571314,3843,15,630.6944444444445,33,3,17,31.32547951693109,0.6660353535353536,41.23774509803921,1035.0490196078429,31.36512180629827,0
3867,4,1,1,36,0.02702702702702703,0.02702702702702703,0.972972972972973,37,850,600,250,0.7058823529411765,11,6,5,373.84716360728316,0.7931681681681682,0.12375974733782424,0.2362811811818577,134180.50063775489,2632.599914965965,136813.10055272086,3844,0,614.6216216216217,34,3,17,31.298833735493517,0.6663602941176471,40.98214285714285,1036.0714285714268,30.4726890756302,0
3868,4,1,0,37,0.02702702702702703,0.0,1.0,37,800,500,300,0.625,11,5,6,374.6831505283792,0.7892267267267267,0.1415583206627984,0.23821096650380885,134396.43565759627,2671.2159863945467,137067.65164399083,3845,0,615.5945945945946,34,3,19,31.061040949100644,0.6685049019607843,40.77380952380952,1036.904761904761,30.497198879551796,0
3869,4,0,0,37,0.0,0.0,1.0,37,850,600,250,0.7058823529411765,11,6,5,372.1846526888979,0.7874124124124124,0.13983365199611586,0.237234627126451,134490.7474387002,2611.0784250685792,137101.82586376878,3846,1,616.5945945945946,35,2,20,31.0314847876218,0.6672619047619048,40.68287037037037,1037.268518518518,29.636243386243372,0
3870,4,0,0,37,0.0,0.0,1.0,37,1500,1300,200,0.8666666666666667,17,13,4,372.79468351108346,0.7867242242242242,0.13719696523413427,0.23841902099531262,134612.54428854858,2636.581564853291,137249.12585340187,3847,2,617.5945945945946,34,3,21,30.8938950709342,0.6706495098039216,40.56547619047618,1037.738095238094,30.521708683473353,0
3871,4,0,0,37,0.0,0.0,1.0,37,750,400,350,0.5333333333333333,11,4,7,370.86553286551685,0.7864114114114114,0.131772639512578,0.23799251744813613,134736.112882653,2593.796060090698,137329.9089427437,3848,3,618.5945945945946,34,3,22,30.820481213928083,0.671875,40.44642857142857,1038.214285714285,30.535714285714267,0
3872,4,1,0,38,0.02631578947368421,0.0,1.0,38,850,500,350,0.5882352941176471,12,5,7,362.9038532037617,0.7893551446183025,0.12873668973681274,0.2349848237651753,135061.60950627993,2202.87570194615,137264.48520822608,3849,0,603.2894736842105,35,3,17,30.702431986044612,0.6729166666666667,40.13310185185185,1039.467592592592,29.699074074074055,0
3873,4,0,0,38,0.0,0.0,1.0,38,950,600,350,0.631578947368421,13,6,7,360.83858329345827,0.7875177809388336,0.13523920516769827,0.23481943143072442,135242.13291162957,2160.115928283578,137402.24883991314,3850,1,604.2894736842105,35,3,20,30.576225844738683,0.6747023809523811,39.959490740740726,1040.1620370370351,29.718915343915288,0
3874,4,0,0,38,0.0,0.0,1.0,38,1200,800,400,0.6666666666666666,16,8,8,362.7310532899618,0.7871917970602181,0.139857151220655,0.23664384390977872,135332.43982553124,2217.8556884430395,137550.29551397427,3851,2,605.2894736842105,35,3,20,30.43705969595848,0.6755952380952381,39.87268518518517,1040.5092592592569,29.72883597883591,0
3875,4,0,0,38,0.0,0.0,1.0,38,1100,900,200,0.8181818181818182,13,9,4,363.9479094932117,0.7857100521574206,0.1303272072156385,0.2390367364686068,135573.40561771236,2268.331511488308,137841.73712920066,3852,3,606.2894736842105,35,3,21,30.165499740683114,0.6779761904761907,39.64120370370369,1041.4351851851832,29.755291005290946,0
3876,4,0,0,38,0.0,0.0,1.0,38,1100,900,200,0.8181818181818182,13,9,4,365.9192363415009,0.784228307254623,0.13853005440804167,0.24138178949664732,135729.43887266918,2333.229316107648,138062.66818877682,3853,4,607.2894736842105,33,5,21,29.95891156062565,0.6840277777777778,39.49142156862745,1042.0343137254904,31.57679738562092,0
3877,4,0,1,37,0.0,0.02631578947368421,0.9736842105263158,38,1100,800,300,0.7272727272727273,14,8,6,376.64262070047374,0.784228307254623,0.12834117174390824,0.2298035935068369,132874.89819101506,2425.1330154504844,135300.03120646556,3854,5,608.2894736842105,35,3,19,32.537232450232,0.6511904761904762,42.24537037037037,1031.0185185185182,29.45767195767195,8
3878,4,0,0,37,0.0,0.0,1.0,37,950,600,350,0.631578947368421,13,6,7,382.3251259148694,0.7801551551551551,0.14355103544292747,0.23278276653804078,132796.49234693876,2754.28713151927,135550.77947845802,3855,10,625.5945945945946,34,3,19,32.469729344729345,0.6525735294117647,42.32142857142857,1030.7142857142856,30.31512605042016,0
3879,4,1,0,38,0.02631578947368421,0.0,1.0,38,900,800,100,0.8888888888888888,10,8,2,374.69351012937506,0.7862434803224277,0.14006943542387518,0.22971237615496887,133053.9547432269,2370.8906678669273,135424.84541109382,3856,0,610.1052631578947,35,3,20,32.40735547079502,0.6529761904761905,42.07175925925925,1031.712962962962,29.477513227513196,0
3880,4,0,0,38,0.0,0.0,1.0,38,1450,1000,450,0.6896551724137931,19,10,9,372.34163742807095,0.7849395448079659,0.12932448861557333,0.22900294638507154,133173.39275763035,2317.199824245543,135490.59258187588,3857,1,611.1052631578947,35,3,20,32.34796665919114,0.6541666666666666,41.95601851851852,1032.1759259259263,29.49074074074075,0
3881,4,0,2,36,0.0,0.05263157894736842,0.9473684210526316,38,750,600,150,0.8,9,6,3,371.4371895674557,0.7857693219535324,0.12480528675949953,0.22881351733022812,133233.13185871052,2297.5480109739315,135530.67986968445,3858,2,612.1052631578947,35,3,20,32.311285500747374,0.6547619047619049,41.898148148148145,1032.4074074074072,29.49735449735449,0
3882,4,0,0,36,0.0,0.0,1.0,36,1250,900,350,0.72,16,9,7,385.81303497999187,0.787962962962963,0.11519054968538534,0.2373778812006188,133187.4478115389,3077.0906922818212,136264.53850382072,3859,3,621.1388888888889,33,3,20,31.986203450868658,0.6587752525252526,41.942401960784316,1032.2303921568632,31.27970885323828,0
3883,4,0,0,36,0.0,0.0,1.0,36,850,600,250,0.7058823529411765,11,6,5,384.68870134645636,0.7869378306878307,0.10991456034175862,0.23749243122685626,133313.97667063153,3056.876111351405,136370.85278198295,3860,4,622.1388888888889,33,3,20,31.88795439262687,0.6600378787878787,41.81985294117647,1032.7205882352944,31.294563279857407,0
3884,4,0,0,36,0.0,0.0,1.0,36,1150,900,250,0.782608695652174,14,9,5,388.8241481259996,0.7876322751322752,0.09773590757540518,0.22558097338646074,130962.30867346957,2984.261621315216,133946.5702947848,3861,5,623.1388888888889,34,2,17,34.157410638132916,0.6341911764705881,44.10714285714287,1023.57142857143,30.105042016806767,4
3885,4,0,1,35,0.0,0.027777777777777776,0.9722222222222222,36,800,500,300,0.625,11,5,6,383.5162994217775,0.7870370370370371,0.0949649952207492,0.2232075241966262,131084.1907596374,2854.5847505669144,133938.77551020432,3862,6,624.1388888888889,34,2,17,34.169621405874594,0.6354166666666665,43.98809523809525,1024.0476190476206,30.119047619047667,0
3886,4,0,0,35,0.0,0.0,1.0,35,1150,900,250,0.782608695652174,14,9,5,394.59301686351574,0.7801820728291315,0.10638625288535519,0.2294241235834846,131045.64838343424,3341.9395484909605,134387.5879319252,3863,18,642.8,33,2,17,33.92516955914621,0.6373106060606061,44.025735294117645,1023.8970588235293,31.02718360071301,0
3887,4,0,0,35,0.0,0.0,1.0,35,750,400,350,0.5333333333333333,11,4,7,398.0502480768425,0.7799019607843136,0.11287030547530708,0.231812259454925,131108.39468293454,3437.5458056997395,134545.94048863428,3864,19,643.8,33,2,17,33.772959794184516,0.6379419191919191,43.96446078431373,1024.1421568627457,31.034610814022596,0
3888,4,0,0,35,0.0,0.0,1.0,35,950,800,150,0.8421052631578947,11,8,3,393.89208122524684,0.7790616246498598,0.11271360218728654,0.22995375691641495,131202.54229142627,3335.9284890426657,134538.47078046895,3865,20,644.8,33,2,17,33.783891547049436,0.638888888888889,43.87254901960784,1024.509803921568,31.045751633986907,0
3889,4,0,0,35,0.0,0.0,1.0,35,800,700,100,0.875,9,7,2,397.3049519748561,0.7799019607843136,0.08209062574922088,0.22857364892236218,130638.16350682439,3386.0594482891293,134024.2229551135,3866,21,645.8,33,2,17,34.269859346279866,0.6332070707070707,44.42401960784314,1022.3039215686282,30.978906714200853,4
3890,4,0,0,35,0.0,0.0,1.0,35,1150,800,350,0.6956521739130435,15,8,7,395.7561788611862,0.7789915966386554,0.07293142994077573,0.22842192730120756,130763.47588667826,3350.0907103037352,134113.566596982,3867,22,646.8,33,2,17,34.18204329419283,0.634469696969697,44.3014705882353,1022.7941176470594,30.99376114081998,0
3891,4,0,0,35,0.0,0.0,1.0,35,1100,800,300,0.7272727272727273,14,8,6,394.9055832526763,0.7791316526610643,0.07409612785106856,0.22848695180710993,130857.49959450694,3335.2714400711284,134192.77103457807,3868,23,647.8,33,2,18,34.10825148720406,0.6354166666666666,44.20955882352941,1023.1617647058825,31.00490196078432,0
3892,4,0,0,35,0.0,0.0,1.0,35,1050,800,250,0.7619047619047619,13,8,5,400.3005553950224,0.7801820728291315,0.07634548314299416,0.2329325515933707,131077.0196559014,3494.0407535563054,134571.06040945768,3869,24,648.8,33,2,19,33.747207595340676,0.6376262626262628,43.99509803921568,1024.0196078431359,31.030897207367754,0
3893,4,1,1,35,0.027777777777777776,0.027777777777777776,0.9722222222222222,36,1050,700,350,0.6666666666666666,14,7,7,390.9709828805608,0.7872354497354498,0.06594399277326146,0.22899728997289956,131328.12499999977,3069.337514417502,134397.46251441728,3870,0,631.75,33,3,19,33.73136856368563,0.6401515151515154,43.749999999999986,1024.9999999999982,31.060606060606005,0
3894,4,0,0,35,0.0,0.0,1.0,35,1000,700,300,0.7,13,7,6,397.25281334572384,0.7815826330532213,0.07650023060760924,0.23248602365362375,131296.723691008,3431.5985738657932,134728.3222648738,3871,26,650.8,33,2,21,33.60225098648811,0.6398358585858587,43.78063725490195,1024.87745098039,31.05689245395121,0
3895,4,0,0,35,0.0,0.0,1.0,35,700,200,500,0.2857142857142857,12,2,10,401.3583197845131,0.7820728291316527,0.07694581280788193,0.23547901420883277,131392.84256708485,3547.125859452791,134939.96842653764,3872,27,651.8,32,3,21,33.399527914614126,0.6432291666666667,43.68686868686868,1025.2525252525243,32.03914141414138,0
3896,4,0,0,35,0.0,0.0,1.0,35,1200,900,300,0.75,15,9,6,399.67837839275575,0.7816526610644258,0.07366736427428333,0.23508960663898293,131489.94880943265,3510.737903020099,135000.68671245276,3873,28,652.8,32,3,21,33.344105215642834,0.6442057291666667,43.592171717171716,1025.6313131313127,32.05097853535352,0
3897,4,0,0,35,0.0,0.0,1.0,35,200,100,100,0.5,3,1,2,399.67837839275575,0.7816526610644258,0.07366736427428333,0.23508960663898293,131489.94880943265,3510.737903020099,135000.68671245276,3874,29,653.8,32,3,21,33.344105215642834,0.6442057291666667,43.592171717171716,1025.6313131313127,32.05097853535352,0
3898,4,0,0,35,0.0,0.0,1.0,35,650,500,150,0.7692307692307693,8,5,3,403.51541731148154,0.7816526610644258,0.06853486164340228,0.23795110893128424,131587.09092184462,3619.4839812263917,135206.574903071,3875,30,654.8,32,3,18,33.14720239560259,0.6451822916666667,43.49747474747474,1026.0101010101002,32.06281565656563,0
3899,4,0,0,35,0.0,0.0,1.0,35,750,400,350,0.5333333333333333,11,4,7,400.00292975366267,0.7807422969187674,0.06155035762613581,0.23648173207036527,131684.2689043209,3534.8186728394926,135219.0875771604,3876,31,655.8,32,3,18,33.13881371222372,0.6461588541666667,43.40277777777777,1026.3888888888882,32.07465277777776,0
3900,4,0,0,35,0.0,0.0,1.0,35,900,600,300,0.6666666666666666,12,6,6,387.3249610643528,0.7822829131652661,0.03926164469971116,0.22614101865127717,131206.12953514766,3163.8818027211187,134370.01133786878,3877,32,656.8,34,1,18,33.94845650321482,0.636642156862745,43.869047619047635,1024.5238095238117,30.133053221288577,4
3901,4,0,0,35,0.0,0.0,1.0,35,1100,900,200,0.8181818181818182,13,9,4,390.5705522214897,0.7829131652661064,0.03914176194348107,0.22858068552513983,131297.6208191611,3256.196853741512,134553.8176729026,3878,33,657.8,34,1,19,33.77255391644404,0.6375612745098038,43.77976190476191,1024.8809523809532,30.143557422969213,0
3902,4,1,0,36,0.027777777777777776,0.0,1.0,36,450,300,150,0.6666666666666666,6,3,3,378.0276641849539,0.7880952380952382,0.06308931667742468,0.20885493164755908,129054.34355977812,2557.222409765106,131611.56596954324,3879,0,640.5,35,1,18,36.37527527812582,0.612797619047619,45.97800925925927,1016.0879629629643,29.031084656084694,8
3903,4,1,1,36,0.02702702702702703,0.02702702702702703,0.972972972972973,37,900,700,200,0.7777777777777778,11,7,4,370.752188454111,0.8008633633633634,0.06040177637810773,0.20621330583131212,129319.08543381361,2189.150511188293,131508.2359450019,3880,0,624.1621621621622,35,2,18,36.290016689424974,0.6154761904761903,45.7175925925926,1017.129629629631,29.060846560846603,0
3904,4,0,0,36,0.0,0.0,1.0,36,550,400,150,0.7272727272727273,7,4,3,378.9344480680112,0.7883267195767196,0.06581011665274983,0.20982360169818884,129142.56071030528,2587.312992969835,131729.8737032751,3881,2,642.5,35,1,18,36.26214605632735,0.613690476190476,45.89120370370371,1016.4351851851857,29.041005291005305,0
3905,4,2,2,36,0.05263157894736842,0.05263157894736842,0.9473684210526316,38,1050,800,250,0.7619047619047619,13,8,5,363.47354922076875,0.8039651493598862,0.05238705170004665,0.20332926268290571,129545.08562616698,1817.255807249349,131362.34143341632,3882,0,609.6315789473684,36,2,14,36.244929941002944,0.6157407407407407,45.49549549549551,1018.0180180180203,28.27827827827834,0
3906,4,0,0,36,0.0,0.0,1.0,36,950,800,150,0.8421052631578947,11,8,3,379.8775933173419,0.7885251322751323,0.06391099667082778,0.2113069112827715,129322.44897959188,2625.3401360544244,131947.7891156463,3883,4,644.5,34,2,19,36.05454119850187,0.6176470588235294,45.714285714285715,1017.1428571428575,29.91596638655463,0
3907,4,1,1,36,0.02702702702702703,0.02702702702702703,0.972972972972973,37,1050,600,450,0.5714285714285714,15,6,9,372.4994013176317,0.7981106106106106,0.05318805909647817,0.20921296943181095,129701.96926708249,2262.7811803412187,131964.75044742372,3884,0,628.0540540540541,35,2,17,35.855418891792596,0.6193452380952381,45.34143518518518,1018.6342592592594,29.10383597883598,0
3908,4,3,2,37,0.07692307692307693,0.05128205128205128,0.9487179487179487,39,1150,800,350,0.6956521739130435,15,8,7,353.7399154263436,0.8108412055780477,0.05329278806558846,0.20140457937026518,130234.60493853886,1413.8356273084114,131648.44056584727,3885,0,596.7692307692307,37,2,19,35.792311204210975,0.620777027027027,44.819078947368425,1020.723684210527,27.587126600284513,0
3909,4,1,1,37,0.02631578947368421,0.02631578947368421,0.9736842105263158,38,850,600,250,0.7058823529411765,11,6,5,362.09021732930546,0.8013276434329066,0.05840821566110366,0.20569902565647882,130147.6534600479,1825.038425249576,131972.69188529748,3886,0,613.4473684210526,36,2,19,35.66751278372513,0.6218171296296295,44.90427927927928,1020.382882882883,28.343968968968973,0
3910,4,2,1,38,0.05128205128205128,0.02564102564102564,0.9743589743589743,39,500,400,100,0.8,6,4,2,352.5935622311433,0.8103351327035538,0.0657581355361152,0.20212311476470973,130498.99798525359,1402.7227662472112,131901.7207515008,3887,0,598.6666666666666,35,4,14,35.55354176106329,0.6273809523809524,44.560185185185176,1021.7592592592578,29.19312169312165,0
3911,4,2,2,38,0.05,0.05,0.95,40,1050,500,550,0.47619047619047616,16,5,11,343.1428008580224,0.818616452991453,0.06059004843681226,0.19828938950345268,130809.21292914537,977.2479405080791,131786.46086965344,3888,0,584.65,36,4,16,35.48111147805666,0.6284722222222222,44.25675675675676,1022.9729729729731,28.41591591591592,0
3912,4,1,1,38,0.02564102564102564,0.02564102564102564,0.9743589743589743,39,800,500,300,0.625,11,5,6,349.5650143101324,0.8168578497525866,0.06465240843423481,0.20177047886731803,130765.21675936632,1342.1889735510852,132107.4057329174,3889,0,594.3846153846154,35,4,16,35.3613830108257,0.6300595238095239,44.29976851851851,1022.8009259259251,29.222883597883573,0
3913,4,0,1,37,0.0,0.02631578947368421,0.9736842105263158,38,1100,900,200,0.8181818181818182,13,9,4,356.5590566505195,0.80891417733523,0.07448633809462502,0.2053981044648766,130688.28124999991,1719.6180555555422,132407.89930555545,3890,2,611.0263157894736,34,4,16,35.260459114371095,0.6314338235294118,44.37499999999999,1022.4999999999993,30.073529411764685,0
3914,4,0,0,37,0.0,0.0,1.0,37,1250,800,450,0.64,17,8,9,364.52967694411734,0.8011761761761762,0.07453908676402543,0.2099896308030196,130688.2812499999,2127.951388888875,132816.23263888876,3891,3,628.4054054054054,34,3,16,35.056710133116006,0.6314338235294118,44.37499999999999,1022.4999999999992,30.07352941176468,0
3915,4,0,1,36,0.0,0.02702702702702703,0.972972972972973,37,750,600,150,0.8,9,6,3,362.17773806365653,0.8019269269269269,0.07917570167202426,0.20905059903778755,130765.21675936617,2072.0500846621812,132837.26684402835,3892,4,629.4054054054054,35,2,17,35.03887537248689,0.6300595238095239,44.299768518518505,1022.8009259259239,29.22288359788354,0
3916,4,0,0,36,0.0,0.0,1.0,36,800,600,200,0.75,10,6,4,363.6557024160018,0.799239417989418,0.08662450858679982,0.20998184107246537,130779.59183673456,2311.748866213136,133091.3407029477,3893,5,642.0833333333334,34,2,17,34.98651846679081,0.6323529411764707,44.28571428571428,1022.8571428571418,30.084033613445346,0
3917,4,0,1,35,0.0,0.027777777777777776,0.9722222222222222,36,900,700,200,0.7777777777777778,11,7,4,362.448743822912,0.7990079365079366,0.0942156824732141,0.2101127343658511,130931.84700963706,2291.2166950113183,133223.06370464838,3894,6,643.0833333333334,34,2,19,34.86317901593578,0.6338848039215688,44.13690476190475,1023.4523809523799,30.101540616246467,0
3918,4,0,0,35,0.0,0.0,1.0,35,950,700,250,0.7368421052631579,12,7,5,367.7078468691585,0.7948879551820728,0.10586725527437069,0.21275071472699936,130857.49959450676,2623.46588451556,133480.96547902233,3895,7,661.0571428571428,33,2,19,34.80394358605823,0.6354166666666667,44.209558823529406,1023.1617647058811,31.004901960784274,0
3919,4,0,0,35,0.0,0.0,1.0,35,950,700,250,0.7368421052631579,12,7,5,369.22239786102904,0.7943277310924369,0.1060217885789545,0.2143234669446263,130982.91710219612,2672.3653462610373,133655.28244845715,3896,8,662.0571428571428,33,2,19,34.63812901552336,0.636679292929293,44.08700980392156,1023.6519607843125,31.019756387403408,0
3920,4,1,2,34,0.027777777777777776,0.05555555555555555,0.9444444444444444,36,500,200,300,0.4,8,2,6,360.9671696239313,0.8014219576719577,0.09468714095761821,0.21091951316722168,131236.62308673462,2274.4224773242518,133511.04556405888,3897,0,644.6388888888889,34,2,20,34.59272491382982,0.6369485294117647,43.83928571428571,1024.6428571428567,30.136554621848724,0
3921,4,0,0,34,0.0,0.0,1.0,34,700,300,400,0.42857142857142855,11,3,8,377.2817349979535,0.7975341651812241,0.10262550616101351,0.21875863690224703,130940.15438475674,3080.265725436188,134020.42011019294,3898,10,652.0882352941177,32,2,21,34.47523439427585,0.638671875,44.12878787878788,1023.4848484848491,31.983901515151533,0
3922,4,0,1,33,0.0,0.029411764705882353,0.9705882352941176,34,1300,1000,300,0.7692307692307693,16,10,6,378.34365016306623,0.7961229946524064,0.1062891075325727,0.22066872996211045,131166.40082963466,3125.194973727158,134291.59580336182,3899,11,653.0882352941177,32,2,21,34.21874358026212,0.6409505208333335,43.90782828282828,1024.3686868686864,32.01152146464645,0
3923,4,1,0,34,0.029411764705882353,0.0,1.0,34,950,500,450,0.5263157894736842,14,5,9,381.3248417398936,0.80239898989899,0.10379390820417722,0.22180018901202092,131061.33355034718,3195.5877329959912,134256.92128334317,3900,0,639.7058823529412,31,3,21,34.2488979315022,0.64247311827957,44.010416666666664,1023.9583333333329,33.03091397849461,7
3924,4,0,0,34,0.0,0.0,1.0,34,700,400,300,0.5714285714285714,10,4,6,380.9147449672217,0.8013963161021985,0.09999252084813626,0.2217538467185193,131094.6676466199,3187.178378634973,134281.84602525487,3901,1,640.7058823529412,31,3,22,34.22560394151304,0.6428091397849462,43.97786458333333,1024.0885416666658,33.0351142473118,0
3925,4,0,0,34,0.0,0.0,1.0,34,1200,800,400,0.6666666666666666,16,8,8,379.3686800598675,0.7998737373737375,0.10133044323193063,0.22181511976754498,131261.40170627166,3159.292941623259,134420.6946478949,3902,2,641.7058823529412,31,3,22,34.09625158831004,0.644489247311828,43.815104166666664,1024.739583333333,33.05611559139784,0
3926,4,0,0,34,0.0,0.0,1.0,34,1250,1000,250,0.8,15,10,5,380.13824216060044,0.799539512774807,0.09884483545789924,0.22246446370710848,131295.7721948016,3182.108809050107,134477.8810038517,3903,3,642.7058823529412,32,2,22,34.04172313252023,0.6422526041666666,43.78156565656566,1024.8737373737376,32.0273042929293,0
3927,4,0,1,33,0.0,0.029411764705882353,0.9705882352941176,34,1100,900,200,0.8181818181818182,13,9,4,377.7513384889948,0.7997251931075461,0.09803921568627483,0.22125435540069682,131328.12499999985,3121.8789855626833,134450.00398556254,3904,4,643.7058823529412,31,3,22,34.070121951219534,0.6451612903225807,43.74999999999999,1024.9999999999989,33.06451612903222,0
3928,4,0,0,33,0.0,0.0,1.0,33,1000,900,100,0.9,11,9,2,386.83950854580866,0.7930082070707072,0.10941884230338417,0.22677494049003336,131361.4930046928,3563.1630791557977,134924.6560838486,3905,5,663.4545454545455,31,2,22,33.80342626698844,0.6454973118279571,43.71744791666666,1025.1302083333323,33.06871639784943,0
3929,4,0,0,33,0.0,0.0,1.0,33,850,600,250,0.7058823529411765,11,6,5,385.48591584782076,0.7938762626262627,0.11440885040885052,0.22637595729318316,131428.2417297362,3532.7472262912192,134960.98895602743,3906,6,664.4545454545455,31,2,22,33.770502645502646,0.6461693548387097,43.65234374999999,1025.390624999999,33.07711693548384,0
3930,4,0,0,33,0.0,0.0,1.0,33,700,500,200,0.7142857142857143,9,5,4,385.61904543275,0.7919034090909092,0.11444049432876247,0.22665191058420434,131461.6224500867,3538.821072048592,135000.4435221353,3907,7,665.4545454545455,31,2,22,33.7332825461317,0.6465053763440862,43.61979166666666,1025.5208333333323,33.081317204301044,0
3931,4,0,0,33,0.0,0.0,1.0,33,950,700,250,0.7368421052631579,12,7,5,385.8633957701783,0.791824494949495,0.1210275810631054,0.227989151833624,131661.99578179244,3560.7089572482605,135222.7047390407,3908,8,666.4545454545455,31,2,19,33.52416899264147,0.648521505376344,43.424479166666664,1026.3020833333328,33.10651881720428,0
3932,4,0,0,33,0.0,0.0,1.0,33,700,500,200,0.7142857142857143,9,5,4,384.3220353162461,0.7922190656565657,0.11789124117891259,0.22747709657907525,131728.82080078113,3525.2577039930416,135254.07850477417,3909,9,667.4545454545455,31,2,19,33.49611026551666,0.6491935483870969,43.35937499999999,1026.562499999999,33.11491935483868,0
3933,4,0,0,33,0.0,0.0,1.0,33,700,500,200,0.7142857142857143,9,5,4,384.40252064918064,0.7935606060606061,0.11355856011618659,0.2281251076267935,131829.0901184081,3535.0869072808023,135364.1770256889,3910,10,668.4545454545455,31,2,20,33.39263450403618,0.650201612903226,43.26171874999999,1026.953124999999,33.12752016129029,0
3934,4,0,0,33,0.0,0.0,1.0,33,600,500,100,0.8333333333333334,7,5,2,383.0867509022586,0.7937184343434344,0.11411362964158012,0.22774464038190786,131895.95752292202,3505.5187649196973,135401.4762878417,3911,11,669.4545454545455,31,2,21,33.358817129336195,0.6508736559139785,43.19661458333333,1027.213541666666,33.135920698924714,0
3935,4,0,0,33,0.0,0.0,1.0,33,600,400,200,0.6666666666666666,8,4,4,384.0583691152588,0.7945075757575758,0.11488266697392158,0.22852341872695242,131929.39758300773,3533.717854817695,135463.1154378254,3912,12,670.4545454545455,31,2,21,33.30006337135615,0.651209677419355,43.16406249999999,1027.3437499999993,33.140120967741915,0
3936,4,0,0,33,0.0,0.0,1.0,33,750,500,250,0.6666666666666666,10,5,5,382.7569959627128,0.7933238636363638,0.11335236867151788,0.2289582757667865,132130.12695312512,3514.746093750015,135644.87304687515,3913,13,671.4545454545455,31,2,21,33.1306990881459,0.6532258064516128,42.96875000000001,1028.125000000001,33.16532258064519,0
3937,4,0,0,33,0.0,0.0,1.0,33,500,300,200,0.6,7,3,4,383.32440517361954,0.7922190656565657,0.11485757921113104,0.22950059345383403,132163.5966830783,3532.3064168294227,135695.90309990774,3914,14,672.4545454545455,31,2,21,33.0823150141404,0.6535618279569892,42.936197916666664,1028.255208333333,33.16952284946235,0
3938,4,0,0,33,0.0,0.0,1.0,33,750,500,250,0.6666666666666666,10,5,5,383.70250706564184,0.7908775252525253,0.11231525582322921,0.23074712411207787,132331.0089111329,3555.147976345502,135886.1568874784,3915,15,673.4545454545455,31,2,22,32.90358980848731,0.6552419354838709,42.77343750000001,1028.9062500000007,33.190524193548406,0
3939,4,0,0,33,0.0,0.0,1.0,33,600,600,0,1.0,6,6,0,384.1103901095413,0.7903251262626263,0.11302104355120823,0.2316155407447927,132432.58794369295,3573.76355786368,136006.35150155664,3916,16,674.4545454545455,30,3,22,32.790600243753815,0.6590277777777778,42.6747311827957,1029.3010752688176,34.31003584229392,0
3940,4,0,0,33,0.0,0.0,1.0,33,1400,1200,200,0.8571428571428571,16,12,4,382.3257856069889,0.7882733585858587,0.11598432451884122,0.2316017782692772,132605.57804731763,3539.7063605619164,136145.28440787955,3917,17,675.4545454545455,30,3,22,32.66208839009962,0.6607638888888889,42.50672043010753,1029.97311827957,34.33243727598566,0
3941,4,0,0,33,0.0,0.0,1.0,33,900,600,300,0.6666666666666666,12,6,6,382.63085162159894,0.7892992424242425,0.11766240542655892,0.2324285347489047,132709.4263065094,3555.7441611747035,136265.1704676841,3918,18,676.4545454545455,30,3,20,32.54956952778504,0.6618055555555555,42.405913978494624,1030.3763440860214,34.34587813620071,0
3942,4,1,1,33,0.029411764705882353,0.029411764705882353,0.9705882352941176,34,550,100,450,0.18181818181818182,10,1,9,371.4778800449037,0.7936348781937018,0.11063011420170166,0.2274225475823592,133001.71746148012,3081.43920898438,136083.1566704645,3919,0,657.5294117647059,31,3,20,32.542813262644096,0.6619623655913978,42.122395833333336,1031.5104166666672,33.27452956989249,0
3943,4,0,0,33,0.0,0.0,1.0,33,850,700,150,0.8235294117647058,10,7,3,384.4090234561584,0.7879577020202021,0.11973450278535025,0.2343733871151618,132847.95388195172,3613.5904439819665,136461.54432593368,3920,20,678.4545454545455,30,3,20,32.36418948283356,0.6631944444444444,42.27150537634409,1030.913978494624,34.36379928315413,0
3944,4,0,0,33,0.0,0.0,1.0,33,1250,1000,250,0.8,15,10,5,383.41135845714496,0.7855902777777778,0.12356753656438246,0.23536289820084202,133102.46997409387,3606.5997653537233,136709.0697394476,3921,21,679.4545454545455,31,2,21,32.13367507886435,0.662970430107527,42.02473958333333,1031.9010416666658,33.28713037634406,0
3945,4,0,0,33,0.0,0.0,1.0,33,1000,600,400,0.6,14,6,8,384.8946221122799,0.7846433080808082,0.11800100156350979,0.23669974162017393,133169.6595085991,3651.257154676645,136820.91666327577,3922,22,680.4545454545455,31,2,21,32.02780055506497,0.6636424731182796,41.959635416666664,1032.161458333333,33.29553091397848,0
3946,4,0,0,33,0.0,0.0,1.0,33,650,400,250,0.6153846153846154,9,4,5,385.7770496608141,0.7820391414141414,0.11592408768048656,0.23810099461944892,133304.08944023986,3685.1316663954053,136989.22110663526,3923,23,681.4545454545455,31,2,21,31.86979889042997,0.6649865591397849,41.829427083333336,1032.682291666667,33.31233198924732,0
3947,4,0,0,33,0.0,0.0,1.0,33,550,500,50,0.9090909090909091,6,5,1,383.88767589849635,0.7818813131313131,0.11971510950717001,0.23779459080831913,133438.5871887207,3645.085822211373,137083.67301093208,3924,24,682.4545454545455,31,2,21,31.783370090317156,0.6663306451612903,41.69921875,1033.203125,33.32913306451613,0
3948,4,0,0,33,0.0,0.0,1.0,33,1150,1000,150,0.8695652173913043,13,10,3,384.1792228329835,0.7827493686868687,0.1157984736193034,0.23886195657303783,133576.40921277035,3663.4604545890625,137239.86966735942,3925,25,683.4545454545455,30,3,21,31.637357517444634,0.6704861111111111,41.56586021505377,1033.7365591397856,34.45788530465952,0
3949,4,0,0,33,0.0,0.0,1.0,33,1000,600,400,0.6,14,6,8,383.24672289278584,0.7829861111111112,0.11747052012193726,0.23895464229636104,133680.63685108107,3646.5331974794863,137327.17004856057,3926,26,684.4545454545455,30,3,22,31.556786673598488,0.6715277777777777,41.465053763440864,1034.139784946237,34.47132616487456,0
3950,4,0,0,33,0.0,0.0,1.0,33,700,500,200,0.7142857142857143,9,5,4,381.9407976538945,0.7821969696969697,0.11762065095398411,0.23836451240443784,133715.3884300208,3614.272423112497,137329.6608531333,3927,27,685.4545454545455,30,3,20,31.555663850985482,0.671875,41.431451612903224,1034.274193548387,34.475806451612904,0
3951,4,1,1,33,0.029411764705882353,0.029411764705882353,0.9705882352941176,34,850,600,250,0.7058823529411765,11,6,5,370.65074154848037,0.7844251336898396,0.10313132327827468,0.23266422505470472,133929.26263901652,3128.196102438541,137057.45874145508,3928,0,666.2647058823529,32,2,20,31.633223550459462,0.6686197916666666,41.22474747474748,1035.1010101010108,32.34690656565659,0
3952,4,0,0,33,0.0,0.0,1.0,33,900,400,500,0.4444444444444444,14,4,10,379.21122424090765,0.7803030303030304,0.11523386863094953,0.23769485885384345,133876.17323133687,3553.4695095486227,137429.6427408855,3929,29,687.4545454545455,31,2,20,31.464938768662975,0.6706989247311828,41.27604166666667,1034.895833333334,33.383736559139805,0
3953,4,0,0,33,0.0,0.0,1.0,33,650,300,350,0.46153846153846156,10,3,7,378.24532709334477,0.7805397727272728,0.11316383147369069,0.2379594019815094,134010.95920138893,3537.8038194444507,137548.76302083337,3930,30,688.4545454545455,31,2,21,31.354795439302475,0.6720430107526882,41.145833333333336,1035.416666666667,33.400537634408614,0
3954,4,0,1,32,0.0,0.030303030303030304,0.9696969696969697,33,450,200,250,0.4444444444444444,7,2,5,376.6019176316081,0.7804608585858587,0.11197604105940573,0.23714291772954707,134044.6662902832,3496.2956746419277,137540.96196492514,3931,31,689.4545454545455,31,2,21,31.363557776939523,0.6723790322580645,41.11328125,1035.546875,33.40473790322581,0
3955,4,0,0,32,0.0,0.0,1.0,32,650,500,150,0.7692307692307693,8,5,3,387.5041667790087,0.770497311827957,0.12454145565510943,0.24320860540873238,133923.9927484391,3979.2210443403806,137903.21379277948,3932,32,710.65625,30,2,21,31.2023871358698,0.6739583333333332,41.229838709677416,1035.0806451612902,34.50268817204301,0
3956,4,0,1,31,0.0,0.03125,0.96875,32,450,200,250,0.4444444444444444,7,2,5,386.039792729718,0.7706233198924732,0.12307389937106916,0.2424183532544437,133943.5577392578,3941.5086534288193,137885.06639268663,3933,33,711.65625,31,1,21,31.220649895178205,0.6713709677419355,41.2109375,1035.15625,33.39213709677419,0
3957,4,0,0,31,0.0,0.0,1.0,31,750,500,250,0.6666666666666666,10,5,5,397.0437523484974,0.7689068100358423,0.12642613829194427,0.24872578106843635,133854.43990996078,4429.213818071469,138283.65372803225,3934,34,721.0967741935484,30,1,21,31.02540373208641,0.6732638888888889,41.297043010752695,1034.81182795699,34.49372759856634,0
3958,4,1,1,31,0.03125,0.03125,0.96875,32,900,700,200,0.7777777777777778,11,7,4,384.73347224221476,0.7744875672043011,0.11870916059311387,0.2433790915821576,134213.26531304247,3927.2671169704768,138140.53243001294,3935,0,699.53125,31,1,21,30.984020273100434,0.6740591397849462,40.95052083333333,1036.197916666666,33.42573924731181,0
3959,4,0,0,31,0.0,0.0,1.0,31,1000,700,300,0.7,13,7,6,394.74332107224416,0.7661290322580645,0.12439406243982476,0.2489273348758359,134097.9538819517,4386.854332870854,138484.80821482255,3936,36,723.0967741935484,30,1,21,30.840416558525828,0.6756944444444444,41.06182795698925,1035.7526881720432,34.52508960573478,0
3960,4,0,0,31,0.0,0.0,1.0,31,900,600,300,0.6666666666666666,12,6,6,392.3382814754793,0.7658602150537634,0.12191681630022178,0.24764546562911682,134132.75965790838,4325.083282749442,138457.8429406578,3937,37,724.0967741935484,30,1,21,30.86777172267636,0.6760416666666667,41.02822580645161,1035.887096774193,34.5295698924731,0
3961,4,0,0,31,0.0,0.0,1.0,31,950,600,350,0.631578947368421,13,6,7,392.5025359960031,0.7625448028673835,0.12330864817371667,0.2484560387954995,134237.20408428722,4337.6886056191515,138574.89268990638,3938,38,725.0967741935484,30,1,21,30.758754863813234,0.6770833333333333,40.92741935483871,1036.2903225806454,34.543010752688176,0
3962,4,0,0,31,0.0,0.0,1.0,31,350,200,150,0.5714285714285714,5,2,3,392.6434254322365,0.7620071684587814,0.12394526461987687,0.24878171351750017,134272.02792591637,4344.205796912947,138616.23372282932,3939,39,726.0967741935484,30,1,21,30.72018328794364,0.6774305555555555,40.89381720430108,1036.4247311827962,34.54749103942654,0
3963,4,0,0,31,0.0,0.0,1.0,31,1050,800,250,0.7619047619047619,13,8,5,391.06308232562736,0.7603942652329749,0.12118728411685509,0.24848934242667964,134376.52654931214,4309.939732917109,138686.46628222926,3940,40,727.0967741935484,30,1,22,30.656382335148216,0.6784722222222221,40.793010752688176,1036.827956989248,34.560931899641595,0
3964,4,0,0,31,0.0,0.0,1.0,31,800,600,200,0.75,10,6,4,393.9717219067219,0.7579749103942652,0.12554648120438983,0.2512953512128995,134515.92127702644,4399.093825875851,138915.01510290228,3941,41,728.0967741935484,30,1,22,30.441284443292734,0.679861111111111,40.65860215053765,1037.3655913978512,34.578853046595036,0
3965,4,0,0,31,0.0,0.0,1.0,31,1250,1100,150,0.88,14,11,3,390.5785736171451,0.757258064516129,0.09889278418118974,0.23901913667766933,132986.55372008332,4188.344208868084,137174.8979289514,3942,42,729.0967741935484,30,1,20,32.0655242811224,0.6645833333333333,42.13709677419355,1031.4516129032263,34.38172043010754,4
3966,4,0,0,31,0.0,0.0,1.0,31,600,400,200,0.6666666666666666,8,4,4,385.71929725730405,0.7568996415770609,0.08662122432623587,0.22930968621423295,131895.95752292217,3974.9632093641544,135870.92073228632,3943,43,730.0967741935484,31,0,19,33.29121244771199,0.6508736559139785,43.196614583333336,1027.2135416666672,33.13592069892475,3
3967,4,0,0,31,0.0,0.0,1.0,31,1200,1100,100,0.9166666666666666,13,11,2,385.9204276429475,0.7539426523297491,0.08683888950192675,0.23023960206997635,132029.7431945802,3990.594991048193,136020.33818562838,3944,44,731.0967741935484,31,0,20,33.15081401241606,0.6522177419354838,43.06640625000001,1027.734375000001,33.15272177419358,0
3968,4,0,0,31,0.0,0.0,1.0,31,1200,800,400,0.6666666666666666,16,8,8,376.2319984969931,0.7561827956989248,0.05082047062964845,0.22210369888800016,131628.58963012695,3704.5774671766485,135333.1670973036,3945,45,732.0967741935484,31,0,15,33.80506386668359,0.6481854838709677,43.45703125,1026.171875,33.102318548387096,6
3969,4,0,0,31,0.0,0.0,1.0,31,850,700,150,0.8235294117647058,10,7,3,375.13624232939515,0.7568100358422939,0.044772638942868426,0.22223510674434863,131762.2396681043,3685.7582939995605,135447.99796210387,3946,46,733.0967741935484,31,0,17,33.698081800887756,0.6495295698924731,43.326822916666664,1026.6927083333328,33.1191196236559,0
3970,4,0,0,31,0.0,0.0,1.0,31,750,600,150,0.8,9,6,3,376.50087568044813,0.7555555555555555,0.04345247589949963,0.22343584698959312,131829.09011840812,3726.7535739474674,135555.8436923556,3947,47,734.0967741935484,31,0,17,33.595499978868176,0.650201612903226,43.26171874999999,1026.9531249999993,33.1275201612903,0
3971,4,0,0,31,0.0,0.0,1.0,31,700,600,100,0.8571428571428571,8,6,2,374.53097524836016,0.7551075268817204,0.03585228922264139,0.22265824142685098,131895.95752292202,3679.8243204752503,135575.78184339727,3948,48,735.0967741935484,31,0,17,33.578532344614864,0.6508736559139785,43.19661458333333,1027.213541666666,33.135920698924714,0
3972,4,0,0,31,0.0,0.0,1.0,31,700,500,200,0.7142857142857143,9,5,4,377.3170336705461,0.7539426523297491,0.030860514723310084,0.225305647790869,132063.20020887576,3765.9389919704804,135829.13920084623,3949,49,736.0967741935484,31,0,18,33.338083776708054,0.6525537634408602,43.033854166666664,1027.8645833333326,33.15692204301073,0
3973,4,1,0,32,0.03125,0.0,1.0,32,1150,1000,150,0.8695652173913043,13,10,3,367.67663969687277,0.766549059139785,0.021500183958793162,0.222076690376911,132495.48037190075,3343.098599632682,135838.57897153342,3950,0,714.0625,32,0,20,33.15014103507482,0.654296875,42.61363636363636,1029.545454545454,32.17329545454544,0
3974,4,0,0,32,0.0,0.0,1.0,32,1000,800,200,0.8,12,8,4,366.4422260284437,0.7658770161290324,0.025035250122609654,0.22171385723204615,132560.4848994998,3315.1518339965046,135875.6367334963,3951,1,715.0625,32,0,20,33.11646844858592,0.6549479166666667,42.55050505050504,1029.7979797979779,32.18118686868681,0
3975,4,1,2,31,0.030303030303030304,0.06060606060606061,0.9393939393939394,33,600,300,300,0.5,9,3,6,359.0199811920976,0.7721748737373738,0.019351863859710106,0.2188460928831826,132839.8032006918,2938.428729334847,135778.23193002664,3952,0,694.3636363636364,33,0,14,33.02672769060074,0.6553030303030305,42.27941176470587,1030.8823529411745,31.238859180035593,0
3976,4,0,0,31,0.0,0.0,1.0,31,950,600,350,0.631578947368421,13,6,7,380.2212309467606,0.7482974910394266,0.03262509685575665,0.23028713145397206,132599.08888075076,3883.3977593315894,136482.48664008235,3953,53,740.0967741935484,31,0,21,32.72281921618207,0.6579301075268817,42.51302083333333,1029.9479166666658,33.224126344085995,0
3977,4,0,0,31,0.0,0.0,1.0,31,650,400,250,0.6153846153846154,9,4,5,379.5406380531577,0.7470430107526882,0.03782598416852112,0.23069774266917734,132733.23059082025,3875.531005859362,136608.76159667963,3954,54,741.0967741935484,31,0,15,32.60519332827897,0.6592741935483872,42.38281249999999,1030.4687499999995,33.240927419354826,0
3978,4,0,0,31,0.0,0.0,1.0,31,1050,800,250,0.7619047619047619,13,8,5,378.6473484472257,0.7477598566308243,0.04094606269050871,0.23056710848524903,132800.32687717004,3856.898328993046,136657.22520616307,3955,55,742.0967741935484,31,0,15,32.560636685194545,0.6599462365591398,42.31770833333333,1030.7291666666658,33.24932795698922,0
3979,4,2,0,33,0.06060606060606061,0.0,1.0,33,450,300,150,0.6666666666666666,6,3,3,359.0113061667669,0.7643623737373738,0.0418037295484206,0.22201807040936716,133377.2636275709,2976.7891255766717,136354.05275314758,3956,0,698.060606060606,33,0,18,32.48741942500097,0.660669191919192,41.758578431372534,1032.965686274508,31.301990493166908,0
3980,4,0,0,33,0.0,0.0,1.0,33,900,400,500,0.4444444444444444,14,4,10,359.0113061667669,0.7643623737373738,0.0418037295484206,0.22201807040936716,133377.2636275709,2976.7891255766717,136354.05275314758,3957,1,699.060606060606,33,0,18,32.48741942500097,0.660669191919192,41.758578431372534,1032.965686274508,31.301990493166908,0
3981,4,0,1,32,0.0,0.030303030303030304,0.9696969696969697,33,800,500,300,0.625,11,5,6,357.0657244293597,0.7653882575757577,0.04497645494086777,0.22100323472389863,133408.91273788913,2927.1500144175156,136336.06275230664,3958,2,700.060606060606,33,0,18,32.50593119810201,0.6609848484848486,41.72794117647058,1033.0882352941167,31.305704099821718,0
3982,4,0,0,32,0.0,0.0,1.0,32,900,700,200,0.7777777777777778,11,7,4,363.9675635050467,0.7628948252688172,0.03163188928265903,0.22546151189718386,133439.60636988576,3313.5376811039732,136753.14405098974,3959,3,639.34375,32,0,18,32.29688582019633,0.6637369791666666,41.698232323232325,1033.2070707070711,32.28772095959597,0
3983,4,0,0,32,0.0,0.0,1.0,32,550,300,250,0.5454545454545454,8,3,5,366.48022892820006,0.762684811827957,0.03251008064516148,0.22721774193548386,133472.22222222213,3382.986111111106,136855.20833333323,3960,4,640.34375,32,0,18,32.19926075268819,0.6640625,41.666666666666664,1033.3333333333328,32.29166666666665,0
3984,4,0,0,32,0.0,0.0,1.0,32,950,700,250,0.7368421052631579,12,7,5,365.73146023695426,0.762600806451613,0.029212454212453887,0.22795591014769093,133668.001033058,3377.318640955019,137045.31967401304,3961,5,641.34375,32,0,19,32.022283272283275,0.666015625,41.477272727272734,1034.0909090909104,32.31534090909095,0
3985,4,0,0,32,0.0,0.0,1.0,32,650,600,50,0.9230769230769231,7,6,1,365.24674054012115,0.76356686827957,0.02883118666829465,0.22785499251821278,133700.64478433336,3366.7449431180694,137067.38972745143,3962,6,642.34375,32,0,16,32.00209579619909,0.6663411458333333,41.44570707070708,1034.2171717171727,32.31928661616165,0
3986,4,0,0,32,0.0,0.0,1.0,32,850,700,150,0.8235294117647058,10,7,3,363.9231193019486,0.7624747983870969,0.02177544855364344,0.22743113016330027,133765.9442435722,3336.1039370982708,137102.04818067045,3963,7,643.34375,32,0,16,31.970889783961926,0.6669921875,41.382575757575765,1034.4696969696977,32.32717803030305,0
3987,4,1,0,33,0.030303030303030304,0.0,1.0,33,500,200,300,0.4,8,2,6,357.4231803005842,0.7754103535353536,-0.02240324390862014,0.21038199853135664,131516.61169982716,2801.417123221859,134318.028823049,3964,0,624.8181818181819,33,0,20,34.40063719633612,0.6420454545454544,43.566176470588246,1025.7352941176484,31.0828877005348,8
3988,4,0,1,32,0.0,0.030303030303030304,0.9696969696969697,33,600,400,200,0.6666666666666666,8,4,4,360.07878400788894,0.7758838383838385,-0.02632969291674825,0.21264455128928533,131642.34459102285,2880.3230728566105,134522.66766387946,3965,1,625.8181818181819,33,0,18,34.205576785287796,0.6433080808080807,43.4436274509804,1026.2254901960796,31.09774212715393,0
3989,4,0,0,32,0.0,0.0,1.0,32,550,500,50,0.9090909090909091,6,5,1,367.0556781065091,0.7670950940860216,-0.012311538461538207,0.21626739554861396,131554.70623214473,3257.5803808284963,134812.28661297323,3966,2,643.9375,32,0,19,34.11512820512822,0.6448567708333333,43.52904040404041,1025.8838383838388,32.05886994949496,0
3990,4,0,0,32,0.0,0.0,1.0,32,850,600,250,0.7058823529411765,11,6,5,366.2434185574252,0.7663810483870969,-0.01294456066945604,0.21597198978212187,131587.0909218448,3238.581203448642,134825.67212529344,3967,3,644.9375,32,0,19,34.10323857576505,0.6451822916666666,43.497474747474755,1026.0101010101018,32.06281565656568,0
3991,4,0,1,31,0.0,0.03125,0.96875,32,600,500,100,0.8333333333333334,7,5,2,364.4319735385692,0.7653309811827957,-0.01433877814691753,0.2150863216374694,131619.47959710757,3193.2693411386786,134812.74893824625,3968,4,645.9375,32,0,19,34.116986587916834,0.6455078125,43.4659090909091,1026.1363636363646,32.066761363636395,0
3992,4,0,0,31,0.0,0.0,1.0,31,1150,800,350,0.6956521739130435,15,8,7,372.5218377180549,0.760573476702509,-0.005501883084984671,0.21972096416304449,131595.18771701396,3604.4162326388937,135199.60394965287,3969,5,663.258064516129,31,0,19,33.934010152284266,0.6478494623655914,43.489583333333336,1026.0416666666672,33.09811827956991,0
3993,4,1,1,31,0.03125,0.03125,0.96875,32,850,600,250,0.7058823529411765,11,6,5,360.9326754685482,0.7700352822580646,-0.008998248740321735,0.21484339285205387,131943.58555568306,3124.5502691051956,135068.13582478827,3970,0,643.5,32,0,19,33.87970587030438,0.6487630208333334,43.150252525252526,1027.3989898989898,32.10621843434343,0
3994,4,0,0,31,0.0,0.0,1.0,31,700,600,100,0.8571428571428571,8,6,2,372.5586198667759,0.7587813620071685,-0.0023555584636523186,0.22129084288472345,131862.52170138885,3625.3038194444403,135487.82552083328,3971,7,665.258064516129,31,0,19,33.662947937795806,0.6505376344086022,43.229166666666664,1027.083333333333,33.131720430107514,0
3995,4,0,0,31,0.0,0.0,1.0,31,700,500,200,0.7142857142857143,9,5,4,373.8728386595991,0.7577956989247312,-0.0026169554177106757,0.22226697996876985,131895.957522922,3662.4632093641417,135558.42073228615,3972,8,666.258064516129,31,0,19,33.595433515020915,0.6508736559139785,43.19661458333333,1027.2135416666658,33.13592069892471,0
3996,4,2,1,32,0.06060606060606061,0.030303030303030304,0.9696969696969697,33,350,200,150,0.5714285714285714,5,2,3,353.44675135158155,0.7760416666666667,0.0031882740761579598,0.21364457588891986,132524.1568747596,2768.0465445982177,135292.2034193578,3973,0,626.8181818181819,33,0,21,33.48756248512259,0.6521464646464648,42.58578431372548,1029.656862745097,31.201723113487787,0
3997,4,0,0,32,0.0,0.0,1.0,32,700,300,400,0.42857142857142855,11,3,8,364.0446491501256,0.7681871639784947,0.00822368421052655,0.21931470326849023,132398.00347222213,3239.7569444444357,135637.76041666657,3974,1,646.875,32,0,21,33.34176788124158,0.6533203125,42.70833333333333,1029.1666666666658,32.16145833333331,0
3998,4,0,0,32,0.0,0.0,1.0,32,1100,900,200,0.8181818181818182,13,9,4,365.59065409950773,0.7669270833333334,0.009737124463519597,0.22100754515800483,132527.98064291905,3290.19822594633,135818.1788688654,3975,2,647.875,32,0,21,33.17111179235644,0.6546223958333334,42.582070707070706,1029.6717171717169,32.17724116161615,0
3999,4,0,0,32,0.0,0.0,1.0,32,950,700,250,0.7368421052631579,12,7,5,364.66444229855915,0.7668430779569894,0.006447682971680191,0.220829091004406,132592.99314164385,3270.3899793388505,135863.3831209827,3976,3,648.875,32,0,21,33.12952065710432,0.6552734375,42.5189393939394,1029.9242424242434,32.185132575757606,0
4000,4,1,1,32,0.030303030303030304,0.030303030303030304,0.9696969696969697,33,450,300,150,0.6666666666666666,6,3,3,356.54757463083473,0.7754892676767677,-0.0007349682774722144,0.21715580378131416,132808.22167255374,2870.489865676653,135678.7115382304,3977,0,630.1818181818181,33,0,17,33.12217631672808,0.6549873737373737,42.31004901960784,1030.759803921568,31.235145573380848,0
4001,4,0,0,32,0.0,0.0,1.0,32,800,600,200,0.75,10,6,4,366.22207311043013,0.7666750672043011,0.001642319000367598,0.22292847000749005,132788.1262913223,3325.9885789715318,136114.11487029382,3978,5,650.875,32,0,17,32.893084650251126,0.6572265625,42.32954545454545,1030.681818181818,32.20880681818181,0
4002,4,1,1,32,0.030303030303030304,0.030303030303030304,0.9696969696969697,33,850,600,250,0.7058823529411765,11,6,5,354.6915871466093,0.7717803030303031,0.00611746247656475,0.21785979980755613,133124.20590938575,2843.6071763264063,135967.81308571217,3979,0,632.1212121212121,33,0,19,32.85276392352453,0.6581439393939394,42.00367647058823,1031.9852941176466,31.272281639928686,0
4003,4,0,0,32,0.0,0.0,1.0,32,750,600,150,0.8,9,6,3,363.1649922741613,0.76356686827957,0.009215479250826109,0.22222433122753737,132983.40292125804,3258.983298898072,136242.3862201561,3980,1,652.6875,32,0,19,32.77558452686988,0.6591796875,42.140151515151516,1031.439393939394,32.23248106060606,0
4004,4,0,0,32,0.0,0.0,1.0,32,750,600,150,0.8,9,6,3,360.02592356746175,0.7642809139784947,-0.01588866471019812,0.22204313747622212,133276.58689164388,3196.605257116642,136473.1921487605,3981,2,653.6875,32,0,22,32.56220958669603,0.662109375,41.856060606060616,1032.5757575757589,32.267992424242465,1
4005,4,0,0,32,0.0,0.0,1.0,32,1050,800,250,0.7619047619047619,13,8,5,372.6039497621183,0.7649109543010754,-0.04521137787056384,0.2229326938216703,132138.24043783802,3447.046060350989,135585.286498189,3982,3,654.6875,32,0,17,33.38347865242129,0.6507161458333333,42.96085858585859,1028.156565656566,32.12989267676769,6
4006,4,0,0,32,0.0,0.0,1.0,32,500,200,300,0.4,8,2,6,373.9078584496737,0.7648689516129032,-0.04609221512770112,0.22390482347162854,132170.69686766676,3483.9324431180753,135654.62931078483,3983,4,655.6875,32,0,17,33.31721717419778,0.6510416666666665,42.92929292929294,1028.28282828283,32.13383838383844,0
4007,4,1,1,32,0.030303030303030304,0.030303030303030304,0.9696969696969697,33,550,500,50,0.9090909090909091,6,5,1,363.71682866462305,0.7761205808080809,-0.052018157281315425,0.21911721141502918,132398.0034722223,3031.076388888894,135429.0798611112,3984,0,636.7878787878788,33,0,17,33.35020242914979,0.6508838383838383,42.708333333333336,1029.1666666666672,31.186868686868703,0
4008,4,0,0,32,0.0,0.0,1.0,32,450,300,150,0.6666666666666666,6,3,3,372.5039269749517,0.7633148521505377,-0.05126503620964762,0.22363960892151313,132268.09007052862,3454.0765929497106,135722.16666347833,3985,6,657.6875,32,0,17,33.2550836708809,0.6520182291666666,42.834595959595966,1028.6616161616168,32.14567550505053,0
4009,4,0,0,32,0.0,0.0,1.0,32,900,500,400,0.5555555555555556,13,5,8,373.45965179740006,0.7631048387096775,-0.0518661064769379,0.22518070129085835,132430.49178655233,3491.489069992855,135921.98085654518,3986,7,658.6875,32,0,18,33.0667832024861,0.6536458333333334,42.676767676767675,1029.2929292929289,32.16540404040403,0
4010,4,0,0,32,0.0,0.0,1.0,32,900,500,400,0.5555555555555556,13,5,8,373.2454879334401,0.7641969086021506,-0.04982983811626185,0.22544027471179795,132495.48037190086,3490.6680440771415,135986.148415978,3987,8,659.6875,32,0,18,33.00680647534953,0.654296875,42.61363636363637,1029.545454545455,32.17329545454547,0
4011,4,0,0,32,0.0,0.0,1.0,32,1050,800,250,0.7619047619047619,13,8,5,373.0223044611505,0.7631888440860216,-0.03918699436136286,0.22608588111397243,132625.50536935017,3494.4543286399494,136119.95969799013,3988,9,660.6875,32,0,17,32.881578409740946,0.6555989583333333,42.487373737373744,1030.0505050505058,32.189078282828305,0
4012,4,1,2,31,0.030303030303030304,0.06060606060606061,0.9393939393939394,33,1050,800,250,0.7619047619047619,13,8,5,364.7478377247213,0.7699652777777778,-0.03796433369712815,0.22252527619855544,132871.38848339583,3092.910328960016,135964.29881235585,3989,0,641.6363636363636,33,0,17,32.84735429295931,0.6556186868686869,42.24877450980392,1031.0049019607845,31.24257278669044,0
4013,4,0,0,31,0.0,0.0,1.0,31,850,800,50,0.9411764705882353,9,8,1,384.476434476994,0.7508064516129033,-0.03445210227967843,0.23286436421998627,132599.0888807508,3996.24498155381,136595.3338623046,3990,11,683.516129032258,31,0,18,32.61325326590815,0.6579301075268817,42.51302083333333,1029.947916666666,33.224126344086,0
4014,4,2,1,32,0.06060606060606061,0.030303030303030304,0.9696969696969697,33,700,400,300,0.5714285714285714,10,4,6,364.23078252663555,0.7676767676767677,-0.03303037499190442,0.22390887959411138,133155.82498317957,3099.8900663206523,136255.71504950023,3991,0,643.030303030303,33,0,18,32.57490303174227,0.6584595959595959,41.97303921568628,1032.1078431372553,31.27599524658349,0
4015,4,0,0,32,0.0,0.0,1.0,32,1100,900,200,0.8181818181818182,13,9,4,376.9636658691909,0.7581905241935485,-0.030163841635050703,0.23107052616782894,133048.52701573828,3630.892096469759,136679.41911220804,3992,1,664.125,32,0,18,32.354261004365036,0.6598307291666666,42.07702020202021,1031.6919191919199,32.240372474747495,0
4016,4,0,0,32,0.0,0.0,1.0,32,850,400,450,0.47058823529411764,13,4,9,380.28309997701695,0.7561323924731184,-0.026998715439197074,0.2337168465573036,133146.24304917874,3726.653211407013,136872.89626058575,3993,2,665.125,32,0,18,32.170347035315245,0.6608072916666666,41.98232323232324,1032.0707070707076,32.25220959595961,0
4017,4,0,0,32,0.0,0.0,1.0,32,650,400,250,0.6153846153846154,9,4,5,379.5654895737841,0.7552083333333334,-0.02849871606749832,0.23409401008555122,133276.5868916438,3717.438590449961,136994.02548209374,3994,3,666.125,32,0,18,32.05780753240402,0.662109375,41.85606060606061,1032.5757575757582,32.26799242424244,0
4018,4,0,0,32,0.0,0.0,1.0,32,800,600,200,0.75,10,6,4,383.05216970247625,0.7551243279569894,-0.03176955990220076,0.23665911995213426,133341.7827262525,3815.3718370574466,137157.15456330994,3995,4,667.125,32,0,18,31.90225142624285,0.6627604166666666,41.792929292929294,1032.8282828282834,32.275883838383855,0
4019,4,0,0,32,0.0,0.0,1.0,32,550,100,450,0.18181818181818182,10,1,9,386.6415192507803,0.7555443548387097,-0.033014112903225756,0.23971774193548398,133472.22222222228,3921.1805555555666,137393.40277777784,3996,5,668.125,32,0,18,31.67842741935484,0.6640625,41.66666666666667,1033.333333333334,32.291666666666686,0
4020,4,0,0,32,0.0,0.0,1.0,32,1100,900,200,0.8181818181818182,13,9,4,385.7227992872412,0.7544102822580646,-0.03004698270256223,0.23937228440029068,133506.94670265372,3899.3346412880396,137406.28134394175,3997,6,669.125,30,2,18,31.66726275631855,0.6697916666666666,41.633064516129046,1033.4677419354857,34.448924731182856,0
4021,4,0,0,32,0.0,0.0,1.0,32,600,400,200,0.6666666666666666,8,4,4,388.10202954139993,0.7526041666666667,-0.031477509100364176,0.24152757372430844,133611.14724245598,3970.951482830413,137582.0987252864,3998,7,670.125,30,2,18,31.501072542901706,0.6708333333333332,41.53225806451614,1033.8709677419372,34.462365591397905,0
4022,4,0,0,32,0.0,0.0,1.0,32,1050,800,250,0.7619047619047619,13,8,5,388.93741351375786,0.7497899865591399,-0.03338501753474432,0.24364761160638115,133854.43990996084,4012.199929182594,137866.63983914343,3999,8,671.125,30,2,16,31.235117114776834,0.6732638888888888,41.2970430107527,1034.8118279569906,34.49372759856635,0
4023,4,0,0,32,0.0,0.0,1.0,32,950,600,350,0.631578947368421,13,6,7,385.71575491475784,0.7481518817204301,-0.029772012578616724,0.24221486979244314,133943.55773925805,3932.828097873293,137876.38583713133,4000,9,672.125,31,1,17,31.22903563941301,0.6713709677419353,41.210937500000014,1035.1562500000018,33.39213709677425,0
4024,4,0,0,32,0.0,0.0,1.0,32,750,700,50,0.9333333333333333,8,7,1,387.6108931118312,0.7483618951612904,-0.02532456305796571,0.2440751728359775,134044.66629028335,3991.434563530831,138036.1008538142,4001,10,673.125,31,1,17,31.07855002305208,0.6723790322580644,41.11328125000001,1035.5468750000011,33.40473790322584,0
4025,4,0,0,32,0.0,0.0,1.0,32,800,500,300,0.625,11,5,6,386.60252195661883,0.747983870967742,-0.024178086497359752,0.24366374482115277,134078.3776177301,3967.007785373274,138045.38540310337,4002,11,674.125,31,1,17,31.07084485793311,0.6727150537634408,41.08072916666667,1035.677083333334,33.40893817204303,0
4026,4,0,0,32,0.0,0.0,1.0,32,700,600,100,0.8571428571428571,8,6,2,388.3698493831895,0.7476898521505377,-0.029286320221189044,0.24545344650850193,134179.5370313857,4022.257317437076,138201.79434882276,4003,12,675.125,31,1,17,30.9236364207616,0.6737231182795698,40.98307291666667,1036.067708333334,33.421538978494645,0
4027,4,0,0,32,0.0,0.0,1.0,32,950,800,150,0.8421052631578947,11,8,3,405.29844070591616,0.7476898521505377,-0.03574548862625504,0.2367701135794252,131228.04641723644,4237.304517957915,135465.35093519435,4004,13,676.125,31,1,17,33.46584169949592,0.6441532258064515,43.84765625000001,1024.609375000001,33.051915322580676,6
4028,4,0,0,32,0.0,0.0,1.0,32,850,700,150,0.8235294117647058,10,7,3,406.1520676688695,0.7478578629032259,-0.03560196950444683,0.23747524313179827,131261.40170627175,4262.417941623274,135523.81964789503,4005,14,677.125,31,1,17,33.41010165184245,0.644489247311828,43.81510416666667,1024.7395833333337,33.05611559139786,0
4029,4,0,0,32,0.0,0.0,1.0,32,850,500,350,0.5882352941176471,12,5,7,406.1520676688695,0.7478578629032259,-0.03560196950444683,0.23747524313179827,131261.40170627175,4262.417941623274,135523.81964789503,4006,15,678.125,31,1,17,33.41010165184245,0.644489247311828,43.81510416666667,1024.7395833333337,33.05611559139786,0
4030,4,1,2,31,0.030303030303030304,0.06060606060606061,0.9393939393939394,33,1150,800,350,0.6956521739130435,15,8,7,398.02795650991334,0.758917297979798,-0.0373872916037139,0.23411883350688112,131489.9488094328,3867.335125242336,135357.28393467513,4007,0,658.5454545454545,32,1,17,33.386423324715835,0.6442057291666666,43.59217171717172,1025.6313131313138,32.05097853535356,0
4031,4,0,1,30,0.0,0.03225806451612903,0.967741935483871,31,400,300,100,0.75,5,3,2,418.07234725580565,0.7411290322580645,-0.025035983405299778,0.24355590872241897,131121.55306971906,4763.659093536828,135885.21216325587,4008,29,701.516129032258,30,1,17,33.24693788276466,0.6458333333333334,43.95161290322581,1024.1935483870968,34.13978494623656,0
4032,4,0,0,30,0.0,0.0,1.0,30,900,700,200,0.7777777777777778,11,7,4,406.8179469692275,0.7328544061302682,0.012475940507436611,0.23699944617014634,131121.55306971903,4668.520204647939,135790.07327436697,4009,30,724.1666666666666,30,0,19,33.535104986876654,0.6458333333333334,43.95161290322581,1024.1935483870966,34.13978494623655,7
4033,4,1,0,31,0.03225806451612903,0.0,1.0,31,1050,600,450,0.5714285714285714,15,6,9,396.22597651785446,0.7406810035842294,0.01901261169909385,0.23396638288583274,131638.287753642,4231.864413516009,135870.15216715803,4010,0,701.7741935483871,30,1,19,33.28230735647238,0.6510416666666666,43.44758064516129,1026.2096774193546,34.206989247311824,0
4034,4,1,1,31,0.03125,0.03125,0.96875,32,750,500,250,0.6666666666666666,10,5,5,387.0355704348272,0.753822244623656,0.009201895043732033,0.23009220913039566,131895.957522922,3809.6854315863634,135705.64295450837,4011,0,680.8125,31,1,19,33.25741010689991,0.6508736559139785,43.19661458333333,1027.2135416666658,33.13592069892471,0
4035,4,0,0,31,0.0,0.0,1.0,31,550,300,250,0.5454545454545454,8,3,5,397.06039934900446,0.7410394265232975,0.01723752053342542,0.23530988290357208,131776.25529324202,4264.626510290206,136040.88180353222,4012,2,703.7741935483871,30,1,20,33.121154601387595,0.6524305555555556,43.31317204301075,1026.7473118279572,34.224910394265244,0
4036,4,0,0,31,0.0,0.0,1.0,31,600,400,200,0.6666666666666666,8,4,4,397.8166910627168,0.7402329749103943,0.016496272720365246,0.2364008672707062,131879.77837033186,4292.795409873973,136172.57378020583,4013,3,704.7741935483871,30,1,21,32.996924888772575,0.6534722222222222,43.21236559139785,1027.1505376344087,34.23835125448029,0
4037,4,0,0,31,0.0,0.0,1.0,31,750,400,350,0.5333333333333333,11,4,7,396.6207100317888,0.738978494623656,0.018095575699262234,0.23611905821518628,131948.81633714866,4266.726644698789,136215.54298184745,4014,4,705.7741935483871,30,1,21,32.9577664399093,0.6541666666666668,43.14516129032257,1027.4193548387084,34.24731182795695,0
4038,4,0,0,31,0.0,0.0,1.0,31,500,300,200,0.6,7,3,4,379.856454387907,0.7384408602150537,0.03479521565784749,0.21495923054668287,129996.88042534738,3676.0308159722435,133672.9112413196,4015,5,706.7741935483871,31,0,21,35.36772216547497,0.6317204301075268,45.05208333333334,1019.7916666666679,32.89650537634412,7
4039,4,0,0,31,0.0,0.0,1.0,31,1450,1200,250,0.8275862068965517,17,12,5,383.4083141858938,0.7381720430107527,0.03872449546608947,0.217894920832114,130162.9151238337,3781.1087714301466,133944.02389526385,4016,6,707.7741935483871,31,0,22,35.108167453532396,0.6334005376344085,44.88932291666668,1020.4427083333346,32.91750672043015,0
4040,4,2,2,31,0.06060606060606061,0.06060606060606061,0.9393939393939394,33,800,500,300,0.625,11,5,6,364.95508436081326,0.7570233585858587,0.02882118293330982,0.2101995926851969,130681.82615294371,2938.637524587208,133620.46367753093,4017,0,665.8181818181819,32,1,18,35.052379188276944,0.6360677083333333,44.38131313131314,1022.4747474747486,31.952335858585894,0
4041,4,0,0,31,0.0,0.0,1.0,31,750,500,250,0.6666666666666666,10,5,5,382.8477217881588,0.7387096774193549,0.046869095186130805,0.21851946975391756,130331.20022907273,3779.4006171233714,134110.6008461961,4018,8,709.7741935483871,30,1,22,34.951296564433335,0.6378472222222221,44.7244623655914,1021.1021505376344,34.03673835125448,0
4042,4,1,1,31,0.03125,0.03125,0.96875,32,600,200,400,0.3333333333333333,10,2,8,372.82267257297406,0.7486139112903226,0.03685652395514771,0.2138824805813379,130528.56445312512,3332.80164930557,133861.36610243068,4019,0,688.5625,31,1,19,35.0067957866123,0.6370967741935483,44.53125000000001,1021.8750000000009,32.96370967741938,0
4043,4,1,1,31,0.03125,0.03125,0.96875,32,900,600,300,0.6666666666666666,12,6,6,369.53420606250296,0.7513440860215055,0.03430615688271965,0.21290917976587212,130694.93823581276,3259.250047471793,133954.18828328454,4020,0,689.53125,31,1,19,34.922030858695194,0.63877688172043,44.368489583333336,1022.5260416666671,32.98471102150539,0
4044,4,1,1,31,0.03125,0.03125,0.96875,32,1250,900,350,0.72,16,9,7,371.5678460656664,0.7519741263440861,0.029467468805703945,0.21426533502200779,130728.22570800794,3314.8810492621665,134043.1067572701,4021,0,690.5,31,1,19,34.8362829980477,0.6391129032258064,44.33593750000001,1022.656250000001,32.98891129032261,0
4045,4,1,0,32,0.03125,0.0,1.0,32,950,600,350,0.631578947368421,13,6,7,371.9208282345628,0.7513020833333334,0.03328562340966901,0.21558242698552085,130928.03955078126,3338.972981770834,134267.0125325521,4022,0,691.46875,31,1,20,34.62468193384224,0.6411290322580645,44.140625,1023.4375000000001,33.01411290322581,0
4046,4,0,0,32,0.0,0.0,1.0,32,950,800,150,0.8421052631578947,11,8,3,375.0327283038514,0.752898185483871,0.03582782299084464,0.2181403384157903,131061.33355034716,3430.457899305551,134491.79144965272,4023,1,692.46875,31,1,20,34.409969481180056,0.64247311827957,44.010416666666664,1023.9583333333328,33.03091397849461,0
4047,4,1,1,32,0.030303030303030304,0.030303030303030304,0.9696969696969697,33,850,700,150,0.8235294117647058,10,7,3,365.251794899158,0.7618371212121213,0.029441067490568962,0.2144764878073799,131425.20732897162,3000.6585743801816,134425.8659033518,4024,0,672.4545454545455,32,1,20,34.29226696219679,0.6435546875,43.65530303030304,1025.3787878787887,32.043087121212146,0
4048,4,1,0,33,0.030303030303030304,0.0,1.0,33,700,300,400,0.42857142857142855,11,3,8,365.40606863905293,0.7589962121212122,0.04273379953379908,0.2152954537847938,131554.70623214467,3014.1776030507026,134568.8838351954,4025,0,673.4242424242424,32,1,16,34.15743589743588,0.6448567708333334,43.5290404040404,1025.8838383838383,32.05886994949495,0
4049,4,1,1,33,0.029411764705882353,0.029411764705882353,0.9705882352941176,34,650,600,50,0.9230769230769231,7,6,1,357.486017796838,0.7703505644682116,0.03442429603420316,0.21198693157251974,131799.59518274217,2623.302485822758,134422.89766856492,4026,0,654.5882352941177,33,1,16,34.113433385049944,0.6448863636363636,43.29044117647059,1026.8382352941173,31.116310160427798,0
4050,4,0,1,32,0.0,0.030303030303030304,0.9696969696969697,33,700,300,400,0.42857142857142855,11,3,8,369.48492066080456,0.7584438131313131,0.005174306740730161,0.21623529681499706,131296.7236910082,3102.4319071991417,134399.15559820735,4027,2,675.4242424242424,33,0,16,34.31371816333851,0.6398358585858586,43.780637254901954,1024.8774509803916,31.05689245395126,3
4051,4,0,1,31,0.0,0.03125,0.96875,32,1100,800,300,0.7272727272727273,14,8,6,377.8868311892544,0.7475638440860216,0.021346722523410966,0.22096034019682875,131263.4233751656,3520.5438220589494,134783.96719722456,4028,6,697.46875,32,0,17,34.132166913093485,0.6419270833333335,43.8131313131313,1024.7474747474732,32.02335858585854,0
4052,4,1,2,30,0.03125,0.0625,0.9375,32,1150,900,250,0.782608695652174,14,9,5,377.026751786548,0.7498319892473119,0.01980731346958886,0.221578240087579,131457.5760764207,3512.604581165181,134970.18065758588,4029,0,698.25,32,0,18,33.95766642042191,0.6438802083333334,43.62373737373737,1025.50505050505,32.04703282828281,0
4053,4,0,0,30,0.0,0.0,1.0,30,650,400,250,0.6153846153846154,9,4,5,388.8047073005946,0.7349616858237548,-0.012191924488725636,0.22813863902222578,131397.01844143827,4217.555859058843,135614.5743004971,1787,20,611.5,30,0,18,33.7170621394861,0.6486111111111111,43.68279569892473,1025.2688172043006,34.175627240143356,0
4054,4,0,0,30,0.0,0.0,1.0,30,700,400,300,0.5714285714285714,10,4,6,389.19194735419916,0.7343390804597701,-0.014763839734347028,0.2285716217371198,131431.4719367846,4230.414101341193,135661.88603812578,1788,21,612.5,30,0,18,33.67222659151484,0.6489583333333333,43.649193548387096,1025.4032258064515,34.18010752688171,0
4055,4,1,1,30,0.03225806451612903,0.03225806451612903,0.967741935483871,31,550,400,150,0.7272727272727273,7,4,3,378.39129066028704,0.7437275985663082,-0.023305674211551164,0.22396673690433216,131728.82080078125,3769.007703993055,135497.8285047743,1789,0,593.7096774193549,31,0,16,33.64831726703873,0.6491935483870968,43.359375,1026.5625,33.11491935483871,0
4056,4,0,0,30,0.0,0.0,1.0,30,550,400,150,0.7272727272727273,7,4,3,388.3128785549264,0.7333812260536399,-0.018271119842829364,0.22929379951793205,131638.28775364193,4223.368489131672,135861.6562427736,1790,23,614.5,30,0,18,33.485319799170476,0.6510416666666667,43.44758064516128,1026.209677419354,34.206989247311796,0
4057,4,0,1,29,0.0,0.03333333333333333,0.9666666666666667,30,500,400,100,0.8,6,4,2,389.5380939050013,0.7325670498084291,-0.013258270053242871,0.23064278769351923,131741.75663371477,4263.686553358751,136005.4431870735,1791,24,615.5,30,0,18,33.349153356026875,0.6520833333333333,43.34677419354838,1026.6129032258054,34.220430107526845,0
4058,4,0,0,29,0.0,0.0,1.0,29,500,300,200,0.6,7,3,4,397.9017357297493,0.721572249589491,-0.0019605737945973534,0.23458101531010825,131577.3750964505,4670.973186728379,136248.34828317887,1792,56,636.8965517241379,29,0,18,33.301041243626194,0.6533764367816093,43.506944444444436,1025.9722222222213,35.37835249042142,0
4059,4,0,0,29,0.0,0.0,1.0,29,800,600,200,0.75,10,6,4,399.23386941721725,0.7209564860426929,0.0025197144323643172,0.23602706359945858,131684.26890432078,4714.564043209849,136398.83294753064,1793,57,637.8965517241379,29,0,18,33.158547586829044,0.6544540229885059,43.402777777777764,1026.3888888888873,35.392720306513354,0
4060,4,0,0,29,0.0,0.0,1.0,29,850,700,150,0.8235294117647058,10,7,3,398.3235352498707,0.7184934318555009,0.0008394504397786218,0.23637273030798903,131826.86149691354,4701.94830246913,136528.80979938267,1794,58,638.8965517241379,29,0,19,33.03748534848076,0.6558908045977012,43.263888888888886,1026.9444444444441,35.411877394636,0
4061,4,1,1,29,0.03333333333333333,0.03333333333333333,0.9666666666666667,30,400,200,200,0.5,6,2,4,387.35163319747204,0.7284961685823755,-0.006891591473780823,0.23123168923193343,132052.40716050976,4230.143116256192,136282.55027676595,1795,0,618.5666666666667,30,0,19,33.09113595745608,0.6552083333333334,43.044354838709666,1027.82258064516,34.260752688172005,0
4062,4,0,0,29,0.0,0.0,1.0,29,650,400,250,0.6153846153846154,9,4,5,396.5044085760484,0.7191091954022988,-0.0025180107714906086,0.23551406437107447,131862.52170138888,4656.814236111107,136519.33593749997,1796,60,640.8965517241379,29,0,19,33.04808992562542,0.65625,43.229166666666664,1027.0833333333333,35.416666666666664,0
4063,4,0,0,29,0.0,0.0,1.0,29,450,300,150,0.6666666666666666,6,3,3,399.3170104535738,0.7194170771756978,-0.011464736613987947,0.23807788560402862,132005.21074459888,4742.385223765448,136747.59596836433,1797,61,641.8965517241379,29,0,19,32.8314355543542,0.6576867816091954,43.090277777777786,1027.6388888888898,35.435823754789304,0
4064,4,0,0,29,0.0,0.0,1.0,29,450,300,150,0.6666666666666666,6,3,3,400.4017531044558,0.7199302134646962,-0.010344827586207028,0.238949433304272,132040.89506172843,4773.88117283951,136814.77623456795,1798,62,642.8965517241379,29,0,19,32.767454954954964,0.6580459770114943,43.05555555555556,1027.777777777778,35.44061302681993,0
4065,4,0,0,29,0.0,0.0,1.0,29,500,300,200,0.6,7,3,4,399.2501935221142,0.7205459770114943,-0.011460090003633683,0.23871162620764858,132112.2781635803,4749.170524691364,136861.4486882717,1799,63,643.8965517241379,29,0,19,32.72482662343511,0.6587643678160919,42.986111111111114,1028.0555555555559,35.45019157088124,0
4066,4,0,0,29,0.0,0.0,1.0,29,400,200,200,0.5,6,2,4,398.12768314718664,0.7202380952380952,-0.012571354074515373,0.23894113625511065,132255.1022376544,4730.883487654334,136985.98572530874,1800,64,644.8965517241379,29,0,19,32.60925825906922,0.6602011494252873,42.84722222222223,1028.6111111111118,35.469348659003856,0
4067,4,0,0,29,0.0,0.0,1.0,29,550,300,250,0.5454545454545454,8,3,5,400.1234436882197,0.7209564860426929,-0.015081552096521955,0.24059370704889071,132326.54320987666,4789.390432098781,137115.93364197545,1801,65,645.8965517241379,29,0,19,32.485713642908564,0.6609195402298851,42.777777777777786,1028.8888888888898,35.47892720306517,0
4068,4,0,0,29,0.0,0.0,1.0,29,450,400,50,0.8888888888888888,5,4,1,390.90094849150597,0.7211617405582923,-0.04070004070004085,0.22705523178336415,131008.0078125,4442.230902777777,135450.23871527778,1802,66,646.8965517241379,29,0,22,34.05787884954551,0.6476293103448276,44.0625,1023.75,35.30172413793103,4
4069,4,0,0,29,0.0,0.0,1.0,29,900,600,300,0.6666666666666666,12,6,6,390.2785676968903,0.7222906403940886,-0.04571524729705112,0.22795605652414552,131221.3758680555,4442.5781249999945,135663.9539930555,1803,67,647.8965517241379,29,0,22,33.857343771180695,0.6497844827586208,43.854166666666664,1024.583333333333,35.330459770114935,0
4070,4,0,1,28,0.0,0.034482758620689655,0.9655172413793104,29,500,300,200,0.6,7,3,4,392.2929473197171,0.7225985221674877,-0.051583964115503256,0.22977158343012,131328.125,4503.819444444445,135831.94444444444,1804,68,648.8965517241379,29,0,22,33.697493224932245,0.6508620689655173,43.75,1025.0,35.3448275862069,0
4071,4,1,1,28,0.034482758620689655,0.034482758620689655,0.9655172413793104,29,550,300,250,0.5454545454545454,8,3,5,390.13462576018924,0.7329638752052545,-0.04286414680269901,0.22957324392342607,131506.13667052463,4461.019483024686,135967.15615354932,1805,0,644.7931034482758,29,0,22,33.572415933197924,0.6526580459770115,43.576388888888886,1025.6944444444441,35.36877394636014,0
4072,4,0,0,28,0.0,0.0,1.0,28,900,800,100,0.8888888888888888,10,8,2,401.63977822296846,0.720789241622575,-0.03831678411274819,0.23569913300979461,131401.77037917817,4955.235582639706,136357.00596181786,1806,70,668.8214285714286,28,0,22,33.38325625934229,0.6547619047619048,43.678160919540225,1025.2873563218386,36.61740558292281,0
4073,4,1,1,28,0.034482758620689655,0.034482758620689655,0.9655172413793104,29,800,700,100,0.875,9,7,2,389.74215719345574,0.7363505747126436,-0.04338334079713424,0.23084727772227775,131755.55555555562,4470.138888888894,136225.69444444453,1807,0,646.7241379310345,29,0,19,33.329951298701296,0.6551724137931034,43.333333333333336,1026.6666666666672,35.40229885057473,0
4074,4,1,1,28,0.034482758620689655,0.034482758620689655,0.9655172413793104,29,850,600,250,0.7058823529411765,11,6,5,389.92306287589236,0.7375821018062397,-0.04169834465967348,0.23117090648287658,131791.2061149691,4477.68614969135,136268.89226466045,1808,0,647.6896551724138,29,0,19,33.28923193110599,0.6555316091954023,43.29861111111111,1026.8055555555552,35.40708812260535,0
4075,4,0,0,28,0.0,0.0,1.0,28,850,600,250,0.7058823529411765,11,6,5,401.3976923201648,0.7191358024691358,-0.03043660789252778,0.23784311022553062,131770.30692627828,4978.459423305591,136748.76634958386,1809,73,671.8214285714286,28,0,19,33.01584802686817,0.6584821428571428,43.31896551724138,1026.7241379310349,36.668719211822676,0
4076,4,0,0,28,0.0,0.0,1.0,28,700,600,100,0.8571428571428571,8,6,2,403.18351872270296,0.7201278659611993,-0.029268926373011706,0.23936509898919306,131844.07616594018,5031.47171026558,136875.54787620576,1810,74,672.8214285714286,28,0,19,32.89527373624324,0.6592261904761905,43.24712643678162,1027.0114942528749,36.67898193760267,0
4077,4,0,0,28,0.0,0.0,1.0,28,750,500,250,0.6666666666666666,10,5,5,402.28822925326375,0.718694885361552,-0.03360639360639395,0.2392979067521497,131917.86604901584,5013.80094794558,136931.66699696143,1811,75,673.8214285714286,28,0,19,32.84353146853145,0.659970238095238,43.175287356321846,1027.2988505747137,36.68924466338263,0
4078,4,0,0,28,0.0,0.0,1.0,28,550,300,250,0.5454545454545454,8,3,5,401.680948157768,0.71875,-0.0351850372471092,0.2396350143596761,132028.5895800304,5006.673809287891,137035.2633893183,1812,76,674.8214285714286,28,0,19,32.74704086863321,0.6610863095238095,43.06752873563219,1027.7298850574716,36.70463875205256,0
4079,4,0,0,28,0.0,0.0,1.0,28,300,100,200,0.3333333333333333,5,1,4,403.6462414132973,0.718694885361552,-0.035324893166659876,0.24104217120790747,132065.5077454091,5061.54916435463,137127.05690976372,1813,77,675.8214285714286,28,0,19,32.659176684372376,0.6614583333333333,43.03160919540231,1027.8735632183923,36.70977011494258,0
4080,4,0,0,28,0.0,0.0,1.0,28,500,200,300,0.4,8,2,6,402.8977493920705,0.7197420634920635,-0.03256053015030247,0.24130035082837248,132176.29320666546,5050.7062111904,137226.99941785587,1814,78,676.8214285714286,28,0,19,32.56631037212985,0.6625744047619047,42.92385057471265,1028.3045977011504,36.725164203612515,0
4081,4,0,0,28,0.0,0.0,1.0,28,700,300,400,0.42857142857142855,11,3,8,404.419354903539,0.7195216049382716,-0.027921896513878552,0.24268551230129387,132250.17598510374,5096.906171555035,137347.08215665878,1815,79,677.8214285714286,28,0,19,32.45244913162919,0.6633184523809523,42.85201149425288,1028.5919540229888,36.73542692939246,0
4082,4,0,0,28,0.0,0.0,1.0,28,400,300,100,0.75,5,3,2,404.2523778459019,0.7198522927689593,-0.027335567658148374,0.243060560684677,132324.07940695604,5098.464749306381,137422.54415626242,1816,80,678.8214285714286,28,0,20,32.3819997207094,0.6640625,42.7801724137931,1028.8793103448277,36.74568965517242,0
4083,4,1,0,29,0.034482758620689655,0.0,1.0,29,400,300,100,0.75,5,3,2,392.57810454435963,0.7317323481116584,-0.03543131346947881,0.23785614569452374,132612.5,4612.152777777778,137224.65277777778,1817,0,656.3793103448276,29,0,21,32.391113807982734,0.6637931034482758,42.5,1030.0,35.51724137931034,0
4084,4,0,1,28,0.0,0.034482758620689655,0.9655172413793104,29,250,100,150,0.4,4,1,3,391.8318456579449,0.7314244663382594,-0.03682128195710699,0.2376301552939477,132648.26630015444,4595.163001543227,137243.42930169767,1818,1,657.3793103448276,29,0,17,32.37424722484382,0.6641522988505746,42.465277777777786,1030.1388888888898,35.522030651341026,0
4085,4,0,1,27,0.0,0.03571428571428571,0.9642857142857143,28,950,900,50,0.9473684210526315,10,9,1,405.88083727777183,0.7196869488536155,-0.03093842227008059,0.24475844429780777,132434.97324613552,5150.563565200151,137585.53681133565,1819,83,681.8214285714286,28,0,21,32.22798017867113,0.6651785714285714,42.672413793103445,1029.3103448275858,36.76108374384235,0
4086,4,0,0,27,0.0,0.0,1.0,27,600,400,200,0.6666666666666666,8,4,4,411.83403578513406,0.7145061728395062,-0.028177910530851502,0.24886285533601224,132512.89073572124,5514.663717049301,138027.55445277054,1820,84,694.1111111111111,27,0,21,31.99598328274798,0.6693672839506173,42.59672619047618,1029.6130952380943,38.13381834215164,0
4087,4,0,0,27,0.0,0.0,1.0,27,350,100,250,0.2857142857142857,6,1,5,410.9613978768918,0.7149810066476734,-0.024873305613082985,0.2488419802892359,132589.50992506367,5497.834068523232,138087.3439935869,1821,85,695.1111111111111,27,0,21,31.940982757790316,0.670138888888889,42.52232142857142,1029.9107142857135,38.144841269841244,0
4088,4,1,1,27,0.03571428571428571,0.03571428571428571,0.9642857142857143,28,600,400,200,0.6666666666666666,8,4,4,400.91708435961175,0.7272376543209876,-0.03477875753896398,0.24488356718714324,132916.04994467564,5057.66304168318,137973.71298635882,1822,0,671.25,28,0,18,31.870036226835726,0.6700148809523809,42.20545977011494,1031.1781609195402,36.827791461412154,0
4089,4,0,0,27,0.0,0.0,1.0,27,550,300,250,0.5454545454545454,8,3,5,421.83728083829646,0.7153371320037987,-0.019856235696096736,0.24855950547856534,131557.0192920917,5699.1310586734435,137256.15035076512,1823,87,697.1111111111111,27,0,18,32.70778938207136,0.6597222222222223,43.5267857142857,1025.892857142856,37.996031746031704,3
4090,4,0,0,27,0.0,0.0,1.0,27,550,400,150,0.7272727272727273,7,4,3,421.83728083829646,0.7153371320037987,-0.019856235696096736,0.24855950547856534,131557.0192920917,5699.1310586734435,137256.15035076512,1824,88,698.1111111111111,27,0,18,32.70778938207136,0.6597222222222223,43.5267857142857,1025.892857142856,37.996031746031704,0
4091,4,0,0,27,0.0,0.0,1.0,27,500,300,200,0.6,7,3,4,424.30529338399344,0.714624881291548,-0.01878086645137933,0.23871966670502898,129769.34800612948,5612.3642555980605,135381.71226172755,1825,89,699.1111111111111,27,0,20,34.46719366145756,0.6415895061728396,45.27529761904761,1018.8988095238092,37.736992945326264,4
4092,4,1,0,28,0.03571428571428571,0.0,1.0,28,250,0,250,0.0,5,0,5,409.5700569748403,0.7249779541446207,-0.013125075431468236,0.232701323570825,130152.6064374421,5061.322086801415,135213.9285242435,1826,0,675.1071428571429,28,0,21,34.45126959541913,0.6421130952380952,44.899425287356316,1020.4022988505739,36.44293924466335,0
4093,4,1,1,28,0.034482758620689655,0.034482758620689655,0.9655172413793104,29,800,400,400,0.5,12,4,8,396.8729680230664,0.736863711001642,-0.02166014205677591,0.2271595859774049,130439.87509645055,4553.612075617272,134993.4871720678,1827,0,652.7931034482758,29,0,21,34.482636528438704,0.641882183908046,44.61805555555555,1021.5277777777771,35.225095785440594,0
4094,4,0,0,28,0.0,0.0,1.0,28,650,300,350,0.46153846153846156,10,3,7,409.3294460641399,0.7242614638447972,-0.007725947521866061,0.233222591362126,130262.58680555545,5064.062499999982,135326.64930555542,1828,2,677.1071428571429,28,0,21,34.34523809523809,0.6432291666666667,44.79166666666666,1020.8333333333325,36.4583333333333,0
4095,4,2,1,29,0.06666666666666667,0.03333333333333333,0.9666666666666667,30,900,700,200,0.7777777777777778,11,7,4,388.28806406404635,0.7496168582375479,-0.002441585718036432,0.22579988336182488,131052.73189097013,4177.242311249864,135229.97420221998,1829,0,632.9,30,0,20,34.079373413844394,0.6451388888888889,44.01881720430108,1023.9247311827963,34.130824372759875,0
4096,4,0,0,29,0.0,0.0,1.0,29,800,600,200,0.75,10,6,4,398.5208177312369,0.7347085385878489,0.011508287370356474,0.2314812409375057,131008.0078125,4641.883680555556,135649.89149305556,1830,1,655.7241379310345,29,0,21,33.862857821191156,0.6476293103448276,44.0625,1023.75,35.30172413793103,0
4097,4,2,2,29,0.06451612903225806,0.06451612903225806,0.935483870967742,31,800,500,300,0.625,11,5,6,375.4902213404104,0.7586917562724015,-0.0013099721630918104,0.22147177725766745,131595.18771701396,3682.541232638894,135277.72894965287,1831,0,614.3548387096774,31,0,19,33.857868020304565,0.6478494623655914,43.489583333333336,1026.0416666666672,33.09811827956991,0
4098,4,0,0,29,0.0,0.0,1.0,29,550,500,50,0.9090909090909091,6,5,1,399.8898941347978,0.7357348111658456,0.010656097811761134,0.2337866591859381,131256.95408950624,4697.665895061739,135954.61998456798,1832,3,657.7241379310345,29,0,21,33.57504292039397,0.6501436781609196,43.81944444444445,1024.7222222222229,35.33524904214561,0
4099,4,0,0,29,0.0,0.0,1.0,29,550,200,350,0.36363636363636365,9,2,7,400.18333053057444,0.7376847290640394,0.009248965330393766,0.23482935977557243,131399.3152006173,4716.763117283954,136116.07831790127,1833,4,658.7241379310345,29,0,21,33.42307865980312,0.6515804597701149,43.68055555555556,1025.2777777777778,35.3544061302682,0
4100,4,0,0,29,0.0,0.0,1.0,29,700,600,100,0.8571428571428571,8,6,2,399.7058943520804,0.7352216748768473,0.012887259823033403,0.23520542070040773,131506.13667052484,4712.755594135825,136218.89226466065,1834,5,659.7241379310345,29,0,21,33.326986007673206,0.6526580459770115,43.5763888888889,1025.6944444444457,35.3687739463602,0
4101,4,0,1,28,0.0,0.034482758620689655,0.9655172413793104,29,900,700,200,0.7777777777777778,11,7,4,401.1055256054023,0.7331691297208538,0.01036163022982306,0.2366907047262551,131613.00154320995,4758.140432098778,136371.1419753087,1835,6,660.7241379310345,29,0,20,33.18275130842809,0.6537356321839081,43.47222222222223,1026.1111111111118,35.38314176245213,0
4102,4,0,0,28,0.0,0.0,1.0,28,600,400,200,0.6666666666666666,8,4,4,407.952985115615,0.7261904761904762,-0.004641856742697126,0.24032873875622854,131549.12306777644,5133.171488968161,136682.2945567446,1836,7,645.4285714285714,28,0,21,33.071895424836605,0.65625,43.53448275862069,1025.8620689655172,36.637931034482754,0
4103,4,0,0,28,0.0,0.0,1.0,28,650,400,250,0.6153846153846154,9,4,5,420.71778956345975,0.7251432980599647,-0.03253476344756834,0.23836197830095776,130042.67251701024,5342.253146056292,135384.92566306653,1837,8,646.4285714285714,28,0,20,34.279182513969104,0.6409970238095237,45.00718390804598,1019.9712643678167,36.42754515599346,3
4104,4,0,0,28,0.0,0.0,1.0,28,700,400,300,0.5714285714285714,10,4,6,420.57476679872724,0.7235449735449735,-0.03733354789395349,0.23895375950436504,130152.60643744233,5347.780420134777,135500.3868575771,1838,9,647.4285714285714,28,0,20,34.170538815357176,0.6421130952380952,44.89942528735633,1020.4022988505758,36.44293924466342,0
4105,4,1,0,29,0.034482758620689655,0.0,1.0,29,900,700,200,0.7777777777777778,11,7,4,410.23400162672493,0.736247947454844,-0.007786903310168514,0.22032476014140134,127926.41293846621,4701.23757266483,132627.65051113104,1839,0,626.0689655172414,28,1,20,36.7153103252379,0.6194196428571428,47.09051724137932,1011.6379310344835,36.12992610837441,6
4106,4,2,1,30,0.06451612903225806,0.03225806451612903,0.967741935483871,31,850,700,150,0.8235294117647058,10,7,3,384.1160119344617,0.7592293906810036,-0.012139846794073206,0.20962743790324673,128566.75347222234,3677.0955129475687,132243.8489851699,1840,0,586.6129032258065,29,2,21,36.719391947411665,0.6228448275862069,46.45833333333334,1014.1666666666677,34.971264367816126,0
4107,4,3,1,32,0.09090909090909091,0.030303030303030304,0.9696969696969697,33,750,500,250,0.6666666666666666,10,5,5,363.6072693857144,0.7851957070707072,-0.00923801871669161,0.2014678461386995,129168.29639010977,2793.306308322507,131961.60269843228,1841,0,551.969696969697,31,2,23,36.625384270526446,0.6233198924731183,45.86588541666668,1016.5364583333348,32.791498655914026,0
4108,4,0,0,32,0.0,0.0,1.0,32,1050,600,450,0.5714285714285714,15,6,9,372.0932452471302,0.7730174731182796,7.024328969995608e-05,0.20616419148747606,129167.22896071812,3212.45068071455,132379.67964143265,1842,1,570.21875,30,2,23,36.41081581383049,0.6260416666666666,45.866935483870975,1016.532258064517,33.884408602150565,0
4109,4,0,0,32,0.0,0.0,1.0,32,650,400,250,0.6153846153846154,9,4,5,373.17116120264353,0.771421370967742,0.0036300713624948244,0.207478778605467,129303.89577191017,3250.4969866458737,132554.39275855606,1843,2,571.21875,30,2,23,36.243998061759385,0.6274305555555555,45.73252688172044,1017.0698924731194,33.90232974910398,0
4110,4,1,1,32,0.030303030303030304,0.030303030303030304,0.9696969696969697,33,1300,1100,200,0.8461538461538461,15,11,4,361.81884589045444,0.7797506313131314,-0.01303406136547669,0.20285198521213219,129631.97708129883,2780.658467610677,132412.63554890951,1844,0,554.8787878787879,31,2,19,36.19861590589441,0.6280241935483871,45.41015625,1018.359375,32.85030241935484,0
4111,4,2,2,32,0.058823529411764705,0.058823529411764705,0.9411764705882353,34,650,400,250,0.6153846153846154,9,4,5,351.18021603659446,0.7912210338680927,-0.0076214960417739785,0.19877243202015232,130004.92814827575,2331.031750586686,132335.95989886243,1845,0,539.5,32,2,20,36.09064834303166,0.6292317708333333,45.044191919191924,1019.8232323232328,31.869476010101025,0
4112,4,2,2,32,0.058823529411764705,0.058823529411764705,0.9411764705882353,34,850,700,150,0.8235294117647058,10,7,3,351.18021603659446,0.7918523469994059,-0.010745836034054213,0.19877243202015232,130004.92814827575,2331.031750586686,132335.95989886243,1846,0,540.3235294117648,32,2,20,36.09064834303166,0.6292317708333333,45.044191919191924,1019.8232323232328,31.869476010101025,0
4113,4,1,1,32,0.030303030303030304,0.030303030303030304,0.9696969696969697,33,1050,700,350,0.6666666666666666,14,7,7,378.70028545787375,0.7827493686868687,-0.021169920748303372,0.21339720189192082,129830.95169067393,3233.4036933051357,133064.35538397907,1847,0,557.6666666666666,31,2,19,35.5661226097696,0.630040322580645,45.21484375000001,1019.1406250000008,32.87550403225809,3
4114,4,3,1,34,0.08571428571428572,0.02857142857142857,0.9714285714285714,35,900,700,200,0.7777777777777778,11,7,4,360.2371233527726,0.7962885154061624,-0.017082533589251492,0.2062456497437304,130450.30757401003,2398.6087081891606,132848.9162821992,1848,0,526.6571428571428,33,2,21,35.40766954574535,0.6313131313131313,44.6078431372549,1021.5686274509808,30.956625074272146,0
4115,4,0,1,33,0.0,0.029411764705882353,0.9705882352941176,34,750,500,250,0.6666666666666666,10,5,5,379.6891925952624,0.7879159239453357,0.07500816255248721,0.20023500170425446,127190.50301445863,2861.515458461562,130052.0184729202,1849,1,543.1470588235294,31,3,18,38.24397078438966,0.6031586021505376,47.81901041666667,1008.723958333334,32.53948252688174,8
4116,4,3,2,34,0.08333333333333333,0.05555555555555555,0.9444444444444444,36,1150,900,250,0.782608695652174,14,9,5,355.9753372263752,0.8052248677248678,0.05742715570636037,0.19074730407740595,127834.51677239535,1901.187043444842,129735.70381584018,1850,0,513.8333333333334,33,3,18,38.18165293262238,0.6047979797979797,47.18137254901961,1011.2745098039226,30.64468211527038,0
4117,4,4,4,34,0.10526315789473684,0.10526315789473684,0.8947368421052632,38,700,400,300,0.5714285714285714,10,4,6,340.51448987162803,0.8175972024656235,0.05020205907822528,0.18441725342552534,128261.74554183819,1134.996570644721,129396.74211248291,1851,0,487.6842105263158,35,3,18,38.13604509445461,0.6047619047619047,46.75925925925926,1012.9629629629634,28.941798941798954,0
4118,4,1,2,33,0.02857142857142857,0.05714285714285714,0.9428571428571428,35,1200,800,400,0.6666666666666666,16,8,8,374.10121733257745,0.7986694677871148,0.013226293066079142,0.19846876558938223,127432.05925905904,2534.497699202227,129966.55695826127,1852,0,530.4571428571429,33,2,16,38.13658109802968,0.6006944444444444,47.5796568627451,1009.6813725490197,30.596405228758172,8
4119,4,4,2,35,0.10810810810810811,0.05405405405405406,0.9459459459459459,37,700,400,300,0.5714285714285714,10,4,6,366.0959732815882,0.8156906906906907,0.042490896793262234,0.19812652208949771,128232.4369454089,1989.0757619598724,130221.51270736878,1853,0,502.6216216216216,35,2,19,37.518212204319504,0.6044642857142857,46.78819444444444,1012.847222222222,28.938492063492056,0
4120,4,2,2,35,0.05405405405405406,0.05405405405405406,0.9459459459459459,37,1250,700,550,0.56,18,7,11,360.55545130418454,0.8194444444444444,0.060496112550907144,0.19642199959108572,128496.33487654323,1866.010802469137,130362.34567901237,1854,0,503.56756756756755,35,2,15,37.388698630136986,0.6071428571428572,46.52777777777778,1013.888888888889,28.968253968253972,0
4121,4,1,2,34,0.027777777777777776,0.05555555555555555,0.9444444444444444,36,800,600,200,0.75,10,6,4,368.1838102012647,0.8131944444444446,0.06294447706661455,0.20032492932036883,128446.04768990948,2258.3510487528547,130704.39873866233,1855,0,518.1388888888889,34,2,15,37.24677040516736,0.6087622549019607,46.57738095238096,1013.6904761904776,29.814425770308166,0
4122,4,1,0,35,0.02857142857142857,0.0,1.0,35,900,600,300,0.6666666666666666,12,6,6,378.18605446330037,0.8081232492997198,0.06272383485002875,0.20597322110433725,128485.98082768645,2718.321228613996,131204.30205630045,1856,0,533.7142857142857,33,2,17,36.9524104516701,0.6114267676767677,46.53799019607843,1013.8480392156861,30.72266785502079,0
4123,4,4,1,38,0.10256410256410256,0.02564102564102564,0.9743589743589743,39,1150,800,350,0.6956521739130435,15,8,7,345.62517815980476,0.8387314439946019,0.08112892313215414,0.1934375997115001,129563.941849896,1156.1120969913693,130720.05394688738,1857,0,479.87179487179486,37,2,17,36.6800170525938,0.6140202702702704,45.47697368421052,1018.0921052631569,27.516002844950187,0
4124,4,0,0,38,0.0,0.0,1.0,38,1200,800,400,0.6666666666666666,16,8,8,358.319241705289,0.8296882408724514,0.0985226836168056,0.2007386978624058,129602.41280131515,1687.8076556286392,131290.2204569438,1858,1,493.5,36,2,17,36.31778551942786,0.6163194444444443,45.43918918918921,1018.2432432432458,28.284534534534608,0
4125,4,1,0,39,0.02564102564102564,0.0,1.0,39,1000,600,400,0.6,14,6,8,348.3940208579005,0.8338394062078273,0.09768850207654256,0.19680240619299888,129927.0027797016,1253.158183287181,131180.16096298877,1859,0,481.8205128205128,37,2,18,36.240768624076864,0.6176801801801801,45.120614035087726,1019.5175438596503,27.554528212422984,0
4126,4,0,1,38,0.0,0.02564102564102564,0.9743589743589743,39,800,400,400,0.5,12,4,8,351.48294600531824,0.8332208726945569,0.09836228287841164,0.19883159354315474,129982.903393352,1337.3547630040207,131320.25815635602,1860,1,482.8205128205128,37,2,18,36.10528673835125,0.6182432432432431,45.06578947368422,1019.7368421052647,27.56045519203418,0
4127,4,0,0,38,0.0,0.0,1.0,38,1000,700,300,0.7,13,7,6,358.7871509248235,0.8276434329065908,0.10290569569843,0.202626330463034,129917.93894823908,1722.5774338527985,131640.51638209188,1861,2,496.42105263157896,36,2,18,35.98507861114178,0.6195023148148147,45.12950450450452,1019.4819819819844,28.31894394394401,0
4128,4,1,0,39,0.02564102564102564,0.0,1.0,39,900,600,300,0.6666666666666666,12,6,6,355.83106812654194,0.8359199280251912,0.10112813536461651,0.2028950130539253,130292.12648158852,1473.3103821218158,131765.43686371035,1862,0,484.6666666666667,35,4,20,35.680596493216946,0.625297619047619,44.762731481481474,1020.949074074073,29.169973544973516,0
4129,4,1,0,40,0.025,0.0,1.0,40,550,300,250,0.5454545454545454,8,3,5,349.3756904798203,0.8428685897435897,0.10456598369684977,0.2009906538767941,130636.47050766986,1128.241417092772,131764.71192476264,1863,0,473.525,36,4,17,35.49653007270326,0.6267361111111112,44.42567567567568,1022.2972972972975,28.39714714714715,0
4130,4,0,0,40,0.0,0.0,1.0,40,950,700,250,0.7368421052631579,12,7,5,355.08767817217864,0.8409455128205128,0.1055096873623953,0.20519188731018273,130809.2129291455,1289.7479405080933,132098.9608696536,1864,1,474.525,36,4,17,35.17562931161016,0.6284722222222221,44.256756756756765,1022.9729729729742,28.41591591591595,0
4131,4,0,0,40,0.0,0.0,1.0,40,1450,1000,450,0.6896551724137931,19,10,9,355.1457738752774,0.8410523504273504,0.11023552718467955,0.20553213384909388,130866.8190995051,1295.3595487379494,132162.17864824305,1865,2,475.525,36,4,19,35.11583755227823,0.6290509259259258,44.20045045045046,1023.1981981981997,28.422172172172214,0
4132,4,0,0,40,0.0,0.0,1.0,40,850,500,350,0.5882352941176471,12,5,7,356.82452715854964,0.8393162393162393,0.11536641725352137,0.2068125830878127,130924.43795146521,1343.4101331061063,132267.8480845713,1866,3,476.525,36,4,19,35.01457966549297,0.6296296296296295,44.14414414414416,1023.4234234234252,28.42842842842848,0
4133,4,0,0,40,0.0,0.0,1.0,40,850,500,350,0.5882352941176471,12,5,7,353.753957201584,0.8391292735042735,0.10506134969325154,0.19883412077192497,129731.44531250013,1179.2238289810234,130910.66914148115,1867,4,477.525,35,5,17,36.30282890252215,0.6196428571428572,45.31250000000001,1018.750000000001,29.107142857142886,5
4134,4,0,1,39,0.0,0.025,0.975,40,1300,1100,200,0.8461538461538461,15,11,4,350.0013059793538,0.837900641025641,0.10447189097103915,0.19716964166015438,129819.89354263128,1087.4264564043333,130907.31999903562,1868,5,478.525,35,5,17,36.30856047700171,0.6205357142857142,45.22569444444445,1019.0972222222231,29.117063492063515,0
4135,4,2,0,41,0.04878048780487805,0.0,1.0,41,1150,800,350,0.6956521739130435,15,8,7,343.63265035299605,0.8424288617886179,0.13010102531550216,0.19622549580610654,130348.8201038879,758.4221045369931,131107.2422084249,1869,0,467.4634146341463,36,5,19,35.93451330686663,0.6238425925925926,44.70720720720722,1021.171171171173,28.365865865865917,0
4136,4,0,0,41,0.0,0.0,1.0,41,1200,800,400,0.6666666666666666,16,8,8,342.6504775435547,0.8414634146341463,0.1333989331956804,0.196245273502218,130463.84222059918,740.6995678110721,131204.54178841025,1870,1,468.4634146341463,36,5,20,35.84311618165784,0.625,44.594594594594604,1021.6216216216233,28.378378378378425,0
4137,4,1,0,42,0.023809523809523808,0.0,1.0,42,650,500,150,0.7692307692307693,8,5,3,335.91665220115954,0.8458430120015485,0.13862002777097082,0.1939004041913625,130766.77439212071,385.34741458910634,131152.12180670982,1871,0,458.2857142857143,37,5,18,35.708797884505415,0.6261261261261261,44.29824561403509,1022.8070175438602,27.643432906590817,0
4138,4,0,0,42,0.0,0.0,1.0,42,950,400,550,0.42105263157894735,15,4,11,335.91665220115954,0.8458430120015485,0.13862002777097082,0.1939004041913625,130766.77439212071,385.34741458910634,131152.12180670982,1872,1,459.2857142857143,37,5,18,35.708797884505415,0.6261261261261261,44.29824561403509,1022.8070175438602,27.643432906590817,0
4139,4,0,0,42,0.0,0.0,1.0,42,700,400,300,0.5714285714285714,10,4,6,348.3507626229916,0.8468108788230739,0.11981020166073542,0.19833987998212516,130235.32238476138,673.5147746365549,130908.83715939794,1873,2,460.2857142857143,38,4,20,35.929104737980595,0.6189692982456141,44.81837606837606,1020.7264957264949,26.861223571749868,3
4140,4,0,0,42,0.0,0.0,1.0,42,1650,1300,350,0.7878787878787878,20,13,7,345.29350700089833,0.8463995354239257,0.1209953224445981,0.19744683963863507,130402.5412266273,605.4330099628245,131007.97423659013,1874,3,461.2857142857143,37,5,21,35.837694578636615,0.6224662162162162,44.65460526315789,1021.3815789473675,27.60490753911804,0
4141,4,0,0,42,0.0,0.0,1.0,42,1050,800,250,0.7619047619047619,13,8,5,345.0724749390569,0.8458672086720868,0.1188994004814552,0.19760542403240264,130458.54403518383,603.5305334333586,131062.07456861719,1875,4,462.2857142857143,37,5,21,35.78662212443204,0.6230292792792793,44.59978070175438,1021.6008771929819,27.61083451872924,0
4142,4,0,1,41,0.0,0.023809523809523808,0.9761904761904762,42,1400,1100,300,0.7857142857142857,17,11,6,348.8444619350267,0.8447541618273325,0.11684572981644115,0.20034376030168724,130570.58572108728,709.7651440827974,131280.35086517007,1876,5,463.2857142857143,37,5,15,35.5768113221042,0.6241554054054053,44.49013157894737,1022.0394736842107,27.62268847795164,0
4143,4,1,1,41,0.023809523809523808,0.023809523809523808,0.9761904761904762,42,950,700,250,0.7368421052631579,12,7,5,346.2702262837512,0.8445363917924894,0.11834624166181662,0.19980981773443965,130753.8343400725,655.2319608810179,131409.0663009535,1877,0,463.92857142857144,38,4,16,35.457145095581325,0.6241776315789472,44.310897435897445,1022.7564102564118,26.91464237516873,0
4144,4,1,1,41,0.023809523809523808,0.023809523809523808,0.9761904761904762,42,750,400,350,0.5333333333333333,11,4,7,346.42331078322354,0.8432539682539683,0.11703365556749001,0.20032304493116862,130835.79881656823,664.9141190006771,131500.7129355689,1878,0,464.9047619047619,38,4,18,35.3703268588137,0.6249999999999998,44.23076923076924,1023.0769230769245,26.92307692307696,0
4145,4,0,1,40,0.0,0.024390243902439025,0.975609756097561,41,1500,1100,400,0.7333333333333333,19,11,8,354.6194749183368,0.8362804878048781,0.13242284785432257,0.20544156172643294,130906.99932912037,1084.4342730455369,131991.4336021659,1879,8,477.2439024390244,37,4,19,35.08864155862709,0.6275337837837839,44.16118421052631,1023.3552631578937,27.658250355618748,0
4146,4,0,0,40,0.0,0.0,1.0,40,900,600,300,0.6666666666666666,12,6,6,362.05552327210364,0.8299412393162393,0.13723579920739826,0.20921834436410858,130809.21292914523,1472.0396071747307,132281.25253631995,1880,9,489.925,36,4,19,34.99743138118305,0.6284722222222223,44.25675675675675,1022.9729729729719,28.415915915915885,0
4147,4,1,0,41,0.024390243902439025,0.0,1.0,41,1300,1100,200,0.8461538461538461,15,11,4,354.8594957769511,0.8339430894308943,0.14006506153693565,0.20693491944745793,131159.5935768697,1108.6454485995564,132268.23902546926,1881,0,478.9512195121951,37,4,20,34.82703560979092,0.6300675675675675,43.91447368421052,1024.342105263157,27.68492176386911,0
4148,4,0,0,41,0.0,0.0,1.0,41,1150,800,350,0.6956521739130435,15,8,7,352.6396211560538,0.8328760162601626,0.14145985512810344,0.20639852872178308,131300.74929003208,1060.3692974285814,132361.11858746066,1882,1,479.9512195121951,38,3,20,34.741260988915506,0.6296600877192983,43.7767094017094,1024.893162393162,26.970872694556892,0
4149,4,1,1,41,0.023809523809523808,0.023809523809523808,0.9761904761904762,42,1200,1000,200,0.8333333333333334,14,10,4,345.0189836661343,0.8384146341463414,0.1342368481331604,0.20312476980470007,131524.88175448202,675.7219130850851,132200.6036675671,1883,0,469.5,37,5,20,34.71038214858362,0.6337274774774775,43.55811403508771,1025.7675438596482,27.723447131341842,0
4150,4,1,1,41,0.023809523809523808,0.023809523809523808,0.9761904761904762,42,1050,600,450,0.5714285714285714,15,6,9,343.9371442277022,0.8389711575687185,0.13043588882443347,0.20293592658782073,131609.25116381957,653.0619998460967,132262.31316366568,1884,0,470.4761904761905,37,5,17,34.653059770606255,0.6345720720720721,43.47587719298245,1026.0964912280697,27.73233760075864,0
4151,4,0,0,41,0.0,0.0,1.0,41,1100,800,300,0.7272727272727273,14,8,6,350.9125729098657,0.8314532520325203,0.13470309856742113,0.20709296401261,131616.8533398264,1037.2017287557906,132654.05506858218,1885,4,482.9512195121951,36,5,18,34.466454492244665,0.6365740740740741,43.46846846846847,1026.1261261261268,28.503503503503524,0
4152,4,0,0,41,0.0,0.0,1.0,41,850,600,250,0.7058823529411765,11,6,5,352.7666455314102,0.8310467479674797,0.13899281191626933,0.2085029317362694,131674.6370525932,1090.0840029218537,132764.72105551505,1886,5,483.9512195121951,36,5,18,34.360599078341025,0.6371527777777777,43.41216216216217,1026.351351351352,28.509759759759774,0
4153,4,2,1,42,0.046511627906976744,0.023255813953488372,0.9767441860465116,43,850,700,150,0.8235294117647058,10,7,3,340.7106901058596,0.8427464008859358,0.14718777855884957,0.20436272982237458,132233.12428090078,410.6478057199231,132643.7720866207,1887,0,462.3953488372093,38,5,20,34.107847719954286,0.6389802631578947,42.868589743589745,1028.5256410256413,27.06646423751688,0
4154,4,1,1,42,0.023255813953488372,0.023255813953488372,0.9767441860465116,43,1200,800,400,0.6666666666666666,16,8,8,344.06008211829896,0.844407530454042,0.1451411960132889,0.20712416943521586,132370.51647308056,508.6821535539425,132879.1986266345,1888,0,463.2325581395349,38,5,20,33.88358250276854,0.6403508771929824,42.73504273504273,1029.0598290598289,27.080521817363916,0
4155,4,0,0,42,0.0,0.0,1.0,42,1100,800,300,0.7272727272727273,14,8,6,354.49631815163076,0.8400358110723964,0.1451052842452032,0.2126315298969312,132233.1242809006,975.2311390532413,133208.35541995385,1889,2,475.26190476190476,38,4,20,33.75337592188636,0.6389802631578948,42.86858974358974,1028.52564102564,27.06646423751684,0
4156,4,0,1,41,0.0,0.023809523809523808,0.9761904761904762,42,1050,700,350,0.6666666666666666,14,7,7,352.5709321575502,0.8396486643437863,0.14411027568922274,0.21240248839735382,132398.0034722224,936.1429569362454,133334.14642915863,1890,3,476.26190476190476,36,6,20,33.636977058029686,0.6443865740740741,42.70833333333334,1029.166666666668,28.587962962963005,0
4157,4,0,0,41,0.0,0.0,1.0,41,950,700,250,0.7368421052631579,12,7,5,360.1261485174135,0.8368394308943089,0.13676633899559887,0.2174692526179494,132487.35592689048,1342.4322434413598,133829.78817033183,1891,4,487.390243902439,35,6,22,33.35265598650927,0.6473214285714286,42.62152777777778,1029.5138888888891,29.41468253968255,0
4158,4,0,0,41,0.0,0.0,1.0,41,950,800,150,0.8421052631578947,11,8,3,360.0572730550645,0.8361280487804879,0.13371050770521187,0.2179448718125146,132576.73852237655,1347.0437885802464,133923.7823109568,1892,5,488.390243902439,35,6,23,33.26449763991907,0.6482142857142856,42.53472222222222,1029.861111111111,29.424603174603174,0
4159,4,0,0,41,0.0,0.0,1.0,41,1200,800,400,0.6666666666666666,16,8,8,363.214595474596,0.835619918699187,0.13989731000432903,0.22055500197236366,132695.9622020746,1439.4220464677483,134135.38424854234,1893,6,489.390243902439,35,6,17,33.06326293716768,0.6494047619047618,42.418981481481474,1030.3240740740728,29.43783068783065,0
4160,4,0,0,41,0.0,0.0,1.0,41,1500,1200,300,0.8,18,12,6,360.19033823475434,0.835010162601626,0.13869286201603237,0.2191796526279571,132774.9370992616,1364.849900576265,134139.78699983784,1894,7,490.390243902439,36,5,17,33.06176245629371,0.6481481481481481,42.34234234234235,1030.630630630632,28.628628628628665,0
4161,4,0,0,41,0.0,0.0,1.0,41,750,600,150,0.8,9,6,3,359.3877039075499,0.8339430894308943,0.13809859999200746,0.21920016184367902,132861.99787202754,1349.7936703595615,134211.7915423871,1895,8,491.390243902439,36,5,17,32.99494811578373,0.6490162037037037,42.25788288288289,1030.9684684684694,28.638013013013037,0
4162,4,0,0,41,0.0,0.0,1.0,41,850,500,350,0.5882352941176471,12,5,7,361.4426428350776,0.8332825203252032,0.14105220545544594,0.22096740474523643,132949.08717839463,1410.6938864540193,134359.78106484865,1896,9,492.390243902439,36,5,17,32.85447150032756,0.6498842592592593,42.17342342342342,1031.3063063063064,28.6473973973974,0
4163,4,0,0,41,0.0,0.0,1.0,41,850,600,250,0.7058823529411765,11,6,5,361.2966627275551,0.833130081300813,0.14412755517474474,0.22225806782287028,133181.46482631267,1423.6037557827972,134605.06858209547,1897,10,493.390243902439,36,5,17,32.62487271801586,0.6521990740740742,41.94819819819819,1032.2072072072062,28.672422422422397,0
4164,4,0,2,39,0.0,0.04878048780487805,0.9512195121951219,41,850,700,150,0.8235294117647058,10,7,3,361.5635353970111,0.8329268292682926,0.14714498186762137,0.2225958985214505,133210.52629910305,1432.8137681600342,134643.34006726308,1898,11,494.390243902439,36,5,17,32.58881495218355,0.652488425925926,41.920045045045036,1032.3198198198188,28.675550550550522,0
4165,4,0,1,38,0.0,0.02564102564102564,0.9743589743589743,39,1150,1000,150,0.8695652173913043,13,10,3,376.6630391217842,0.8196693657219973,0.15451978133015576,0.22963296984652493,132845.0671537422,2207.565345293199,135052.6324990354,1899,28,520.1794871794872,35,4,17,32.56673122263388,0.6508928571428572,42.27430555555555,1030.902777777777,29.454365079365054,0
4166,4,0,0,38,0.0,0.0,1.0,38,1300,800,500,0.6153846153846154,18,8,10,385.05873288665816,0.8130334281650071,0.1519420663488662,0.23406379156368765,132735.14739229012,2622.1655328798006,135357.3129251699,1900,29,533.7631578947369,34,4,17,32.46110597658656,0.6519607843137256,42.38095238095237,1030.4761904761895,30.30812324929969,0
4167,4,0,0,38,0.0,0.0,1.0,38,1400,1000,400,0.7142857142857143,18,10,8,382.84264744138494,0.8105737316263633,0.15294628699186497,0.23405545905326153,132949.91673752826,2579.779620181398,135529.69635770965,1901,30,534.7631578947369,34,4,17,32.30188733695025,0.6541053921568627,42.172619047619044,1031.3095238095232,30.33263305322127,0
4168,4,0,0,38,0.0,0.0,1.0,38,350,200,150,0.5714285714285714,5,2,3,400.7109755554606,0.8105737316263633,0.16300564033357556,0.2303406628192953,130605.83457986468,2905.3602730113853,133511.19485287607,1902,31,535.7631578947369,30,8,17,34.21570238877932,0.640625,44.45564516129032,1022.1774193548383,34.072580645161274,8
4169,4,0,0,38,0.0,0.0,1.0,38,800,400,400,0.5,12,4,8,403.1425122676611,0.8116998577524893,0.1718833744238395,0.23287408649814298,130794.81336805549,2945.789930555546,133740.60329861104,1903,32,536.7631578947369,31,7,18,33.96130346232178,0.6397849462365592,44.27083333333333,1022.9166666666661,32.99731182795697,0
4170,4,1,1,38,0.02564102564102564,0.02564102564102564,0.9743589743589743,39,1200,900,300,0.75,15,9,6,392.7535281671539,0.8214125056230319,0.16564035063496596,0.22872761218765883,131108.39468293442,2498.656916810836,133607.05159974526,1904,0,523.974358974359,33,6,18,33.90857464799967,0.6379419191919192,43.96446078431372,1024.1421568627447,31.034610814022567,0
4171,4,0,0,38,0.0,0.0,1.0,38,850,500,350,0.5882352941176471,12,5,7,392.93674360622765,0.8110775248933144,0.16933171662056457,0.22460458307368325,130387.71896626303,2646.8251393694763,133034.5441056325,1905,34,538.7631578947369,33,5,19,34.63622910167186,0.6306818181818181,44.669117647058826,1021.3235294117652,30.94919786096258,2
4172,4,1,1,38,0.02564102564102564,0.02564102564102564,0.9743589743589743,39,1150,800,350,0.6956521739130435,15,8,7,384.124118499212,0.8192195231668916,0.1621632917476441,0.2212771330509544,130688.28124999987,2240.1041666666506,132928.3854166665,1906,0,525.9230769230769,34,5,17,34.55582722086389,0.6314338235294118,44.37499999999999,1022.499999999999,30.073529411764675,0
4173,4,0,0,38,0.0,0.0,1.0,38,1000,800,200,0.8,12,8,4,393.200259935936,0.8116702228544334,0.16935504228196363,0.22584643029378146,130575.52984429066,2668.4664552095323,133243.9962995002,1907,36,540.7631578947369,33,5,17,34.43844924060751,0.6325757575757576,44.48529411764706,1022.0588235294118,30.971479500891267,0
4174,4,0,0,38,0.0,0.0,1.0,38,1250,1000,250,0.8,15,10,5,397.9266741088622,0.8123221906116643,0.17209870795018034,0.22958952701606694,130749.15143140598,2805.714994331077,133554.86642573704,1908,37,541.7631578947369,34,4,18,34.14110697241299,0.6320465686274509,44.3154761904762,1022.7380952380959,30.080532212885174,0
4175,4,0,0,38,0.0,0.0,1.0,38,1150,900,250,0.782608695652174,14,9,5,396.7283472503686,0.8102181128496918,0.17388136464940818,0.22980302378464756,130901.38888888896,2786.4583333333417,133687.8472222223,1909,38,542.7631578947369,34,4,18,34.01703311617807,0.633578431372549,44.16666666666667,1023.3333333333339,30.098039215686292,0
4176,4,0,0,38,0.0,0.0,1.0,38,950,600,350,0.631578947368421,13,6,7,397.61666588746084,0.8081140350877193,0.17687797234684566,0.23086466643931625,130992.77388038542,2816.9820011337783,133809.7558815192,1910,39,543.7631578947369,34,4,18,33.90147110129084,0.6344975490196079,44.07738095238095,1023.6904761904757,30.10854341736693,0
4177,4,0,0,38,0.0,0.0,1.0,38,1150,900,250,0.782608695652174,14,9,5,397.02431550438394,0.8088252726410621,0.17565881230272318,0.23143612537938493,131145.15306122453,2813.5629251700716,133958.71598639459,1911,40,544.7631578947369,34,4,18,33.76191306369131,0.6360294117647058,43.92857142857143,1024.2857142857147,30.126050420168077,0
4178,4,2,1,39,0.05,0.025,0.975,40,1200,900,300,0.75,15,9,6,383.21417638852137,0.8208867521367521,0.17637327616177956,0.22789490889431796,131908.37762188225,2110.0871598639606,134018.4647817462,1912,0,518.475,34,6,17,33.342990690307886,0.643688725490196,43.18452380952382,1027.261904761906,30.213585434173705,0
4179,4,0,0,39,0.0,0.0,1.0,39,650,400,250,0.6153846153846154,9,4,5,390.26922752572085,0.8120220422852003,0.175782550782551,0.23115946553446573,131755.55555555577,2484.027777777811,134239.58333333358,1913,1,532.7692307692307,34,5,17,33.31642316017317,0.6421568627450979,43.33333333333335,1026.6666666666686,30.196078431372605,0
4180,4,0,0,39,0.0,0.0,1.0,39,800,600,200,0.75,10,6,4,390.6719462992129,0.811965811965812,0.18155879127248098,0.2319564267531529,131847.23816609988,2501.8034297052327,134349.04159580512,1914,2,533.7692307692307,34,5,18,33.21331285499016,0.6430759803921567,43.24404761904763,1027.0238095238105,30.20658263305325,0
4181,4,0,0,39,0.0,0.0,1.0,39,950,600,350,0.631578947368421,13,6,7,388.6713869221157,0.8117408906882592,0.18419675562532722,0.22145230185097292,130262.58680555552,2327.0160147392244,132589.60282029473,1915,3,534.7692307692307,33,6,18,34.87244897959182,0.629419191919192,44.791666666666664,1020.833333333333,30.934343434343425,5
4182,4,1,0,40,0.025,0.0,1.0,40,950,500,450,0.5263157894736842,14,5,9,379.77612276522945,0.8183760683760684,0.18312768847634153,0.21870549338383544,130676.44702717756,1925.5588777434737,132602.00590492104,1916,0,522.375,35,5,18,34.67898649158554,0.6291666666666667,44.38657407407407,1022.4537037037031,29.212962962962948,0
4183,4,1,1,40,0.024390243902439025,0.024390243902439025,0.975609756097561,41,900,600,300,0.6666666666666666,12,6,6,374.3945641830736,0.8244410569105691,0.1808549467536924,0.21699603311835297,130924.4379514651,1603.4795775505347,132527.91752901563,1917,0,510.609756097561,36,5,18,34.565039979460096,0.6296296296296295,44.14414414414415,1023.4234234234243,28.428428428428454,0
4184,4,1,0,41,0.024390243902439025,0.0,1.0,41,800,400,400,0.5,12,4,8,384.8071409135731,0.8245426829268293,0.1906403114398405,0.2195935361021767,130323.35778061219,1838.739349526023,132162.09713013822,1918,0,511.5853658536585,34,7,17,34.90925342971513,0.6277573529411764,44.732142857142854,1021.0714285714282,30.031512605042007,2
4185,4,0,0,41,0.0,0.0,1.0,41,950,400,550,0.42105263157894735,15,4,11,384.934606962579,0.8240853658536585,0.18312581727215882,0.22018259518259525,130414.54081632657,1840.2140022675796,132254.75481859414,1919,1,512.5853658536586,34,7,19,34.813277000777006,0.6286764705882353,44.642857142857146,1021.4285714285717,30.042016806722696,0
4186,4,0,0,41,0.0,0.0,1.0,41,850,600,250,0.7058823529411765,11,6,5,384.2528947037547,0.8245426829268293,0.18438129335421793,0.22043981854057504,130528.56445312499,1831.195746527777,132359.76019965275,1920,2,513.5853658536586,35,6,16,34.714789330615034,0.6276785714285715,44.53125,1021.8749999999999,29.19642857142857,0
4187,4,0,0,41,0.0,0.0,1.0,41,950,600,350,0.631578947368421,13,6,7,384.6390035001137,0.823729674796748,0.1881391044941032,0.2208298050003902,130558.1342699759,1843.5501328875057,132401.6844028634,1921,3,514.5853658536586,35,6,16,34.67487731219328,0.6279761904761905,44.50231481481481,1021.99074074074,29.199735449735428,0
4188,4,0,0,41,0.0,0.0,1.0,41,1100,1000,100,0.9090909090909091,12,10,2,386.7359581616901,0.8224085365853658,0.19463596877562872,0.22254323898646292,130646.86381440742,1905.1680116169275,132552.03182602435,1922,4,515.5853658536586,35,6,16,34.531137967470485,0.6288690476190477,44.41550925925925,1022.3379629629617,29.209656084656046,0
4189,4,0,0,41,0.0,0.0,1.0,41,950,600,350,0.631578947368421,13,6,7,386.4245750473451,0.8214430894308943,0.19578450453434937,0.22270457407327418,130706.03358892743,1901.6046971450555,132607.63828607247,1923,5,516.5853658536586,35,6,16,34.47898981324278,0.6294642857142857,44.357638888888886,1022.5694444444441,29.21626984126983,0
4190,4,0,0,41,0.0,0.0,1.0,41,900,500,400,0.5555555555555556,13,5,8,391.5034867055359,0.8212906504065041,0.19999889661868786,0.22684625356817503,130913.23329260979,2050.5974579904027,132963.8307506002,1924,6,517.5853658536586,35,6,17,34.138675262007084,0.631547619047619,44.155092592592595,1023.3796296296301,29.239417989418005,0
4191,4,0,0,41,0.0,0.0,1.0,41,1250,800,450,0.64,17,8,9,392.48672834216165,0.8215955284552846,0.20804773274954047,0.22811679362120654,131031.70680084027,2085.641182270239,133117.34798311052,1925,7,518.5853658536586,35,6,17,33.99323611425126,0.6327380952380952,44.039351851851855,1023.8425925925932,29.25264550264552,0
4192,4,1,0,42,0.023809523809523808,0.0,1.0,42,1150,800,350,0.6956521739130435,15,8,7,383.9332392543385,0.8246951219512195,0.21785941910224915,0.22561470126968458,131453.76778162262,1694.8988692472515,133148.66665086988,1926,0,507.2142857142857,33,9,18,33.7844566602932,0.6414141414141413,43.62745098039217,1025.4901960784327,31.075460487225236,0
4193,4,0,0,42,0.0,0.0,1.0,42,1150,900,250,0.782608695652174,14,9,5,383.0954067307561,0.8242595818815331,0.217829695490668,0.22567851159346683,131548.03929077773,1679.0899233468103,133227.12921412455,1927,1,508.2142857142857,33,9,19,33.71050352407122,0.6423611111111109,43.535539215686285,1025.8578431372562,31.086601307189582,0
4194,4,0,0,42,0.0,0.0,1.0,42,1200,900,300,0.75,15,9,6,382.82823955709443,0.8242353852109949,0.2131597802722709,0.22607924386820258,131642.34459102285,1679.2814061899448,133321.6259972128,1928,2,509.2142857142857,33,9,17,33.62192500597087,0.6433080808080807,43.4436274509804,1026.2254901960796,31.09774212715393,0
4195,4,0,0,42,0.0,0.0,1.0,42,900,700,200,0.7777777777777778,11,7,4,381.28221899291066,0.8241869918699187,0.2139787146950467,0.22553812615004407,131705.2335640141,1643.3727412533935,133348.60630526752,1929,3,510.2142857142857,33,9,17,33.59797835084368,0.6439393939393938,43.382352941176485,1026.4705882352962,31.105169340463522,0
4196,4,0,0,42,0.0,0.0,1.0,42,850,500,350,0.5882352941176471,12,5,7,381.81264779217975,0.8236304684475416,0.21390485285674465,0.2260384841381692,131736.68368235795,1659.746401624403,133396.43008398236,1930,4,511.2142857142857,33,9,17,33.55255958776014,0.6442550505050504,43.351715686274524,1026.5931372549037,31.108882947118293,0
4197,4,0,0,42,0.0,0.0,1.0,42,1050,700,350,0.6666666666666666,14,7,7,384.00100250055493,0.823170731707317,0.22005909762472964,0.22789861196562713,131831.056564783,1724.651576316825,133555.70814109984,1931,5,512.2142857142857,33,9,17,33.40095465393794,0.6452020202020201,43.25980392156864,1026.9607843137273,31.120023767082646,0
4198,4,0,0,42,0.0,0.0,1.0,42,900,600,300,0.6666666666666666,12,6,6,393.4546746373826,0.823170731707317,0.220355810987521,0.22920871730521397,131120.5970963006,1919.2188529956156,133039.8159492962,1932,6,513.2142857142857,35,7,17,33.8782395374242,0.6336309523809524,43.9525462962963,1024.189814814815,29.262566137566143,2
4199,4,0,0,42,0.0,0.0,1.0,42,1750,1300,450,0.7428571428571429,22,13,9,393.84797191927373,0.8223722415795587,0.2141182074676633,0.2298162283867628,131183.87972009167,1933.300995252004,133117.18071534368,1933,7,514.2142857142857,36,6,17,33.80395551647063,0.6322337962962963,43.890765765765764,1024.4369369369367,28.456581581581574,0
4200,4,1,0,43,0.023255813953488372,0.0,1.0,43,950,600,350,0.631578947368421,13,6,7,386.52466832564784,0.8263658176448874,0.2193421458483269,0.22732431125912517,131485.18786344214,1564.7707657434973,133049.95862918565,1934,0,503.2325581395349,33,10,18,33.686198072250754,0.6417297979797979,43.59681372549021,1025.612745098041,31.079174093880027,0
4201,4,0,0,43,0.0,0.0,1.0,43,1000,600,400,0.6,14,6,8,386.4647165375573,0.8264581026208933,0.22055513878469624,0.2274760673290685,131516.61169982693,1565.3060121107192,133081.91771193765,1935,1,504.2325581395349,33,10,18,33.65591397849462,0.6420454545454546,43.56617647058823,1025.7352941176466,31.082887700534744,0
4202,4,1,2,42,0.022727272727272728,0.045454545454545456,0.9545454545454546,44,1300,800,500,0.6153846153846154,18,8,10,373.73989314814924,0.830404334038055,0.21304416872432208,0.22181900146511893,131832.8045294282,1054.2356556498687,132887.04018507805,1936,0,493.75,35,9,15,33.66263289379767,0.6407738095238094,43.258101851851855,1026.9675925925928,29.341931216931226,0
4203,4,0,1,41,0.0,0.023809523809523808,0.9761904761904762,42,1400,900,500,0.6428571428571429,19,9,10,385.9867810760666,0.8186217576461479,0.2254560915275199,0.22862293956043966,131755.55555555568,1771.1805555555748,133526.73611111124,1937,11,518.2142857142857,34,8,15,33.42633928571429,0.642156862745098,43.33333333333334,1026.6666666666679,30.196078431372584,0
4204,4,0,1,40,0.0,0.024390243902439025,0.975609756097561,41,1250,800,450,0.64,17,8,9,384.48111185283545,0.8169715447154472,0.22510689279943707,0.22873018423631156,131921.96609224967,1944.3008401920456,133866.2669324417,1938,12,526.5853658536586,35,6,17,33.29671774072405,0.6416666666666666,43.1712962962963,1027.314814814815,29.35185185185186,0
4205,4,0,0,40,0.0,0.0,1.0,40,1250,900,350,0.72,16,9,7,387.70321000840875,0.8146100427350428,0.2279951582029056,0.23155293934664933,132070.6356765474,2240.8418799296915,134311.47755647707,1939,13,525.05,35,5,18,33.063679953458696,0.643154761904762,43.02662037037037,1027.8935185185178,29.368386243386222,0
4206,4,1,0,41,0.024390243902439025,0.0,1.0,41,1250,1000,250,0.8,15,10,5,378.92787860115914,0.8176829268292682,0.22704196869026205,0.22867498106848624,132462.98408644518,1840.4044168182822,134303.38850326347,1940,0,513.219512195122,32,9,20,32.89331125557053,0.6539713541666667,42.645202020202014,1029.4191919191912,32.169349747474726,0
4207,4,1,1,41,0.023809523809523808,0.023809523809523808,0.9761904761904762,42,950,700,250,0.7368421052631579,12,7,5,368.8985637242239,0.8248886953155246,0.2144952403603848,0.2242999293099782,132745.06987997398,1393.893124038825,134138.9630040128,1941,0,501.9761904761905,33,9,15,32.86743865699449,0.6543560606060608,42.37132352941176,1030.5147058823525,31.227718360071286,0
4208,4,0,0,41,0.0,0.0,1.0,41,1200,900,300,0.75,15,9,6,377.1125303276148,0.8167682926829268,0.22149414532507872,0.22876290966119012,132658.02158261903,1805.4004374553529,134463.4220200744,1942,2,515.219512195122,32,9,15,32.74349389222536,0.6559244791666667,42.455808080808076,1030.176767676767,32.19302398989897,0
4209,4,0,0,41,0.0,0.0,1.0,41,1150,900,250,0.782608695652174,14,9,5,377.33522370348055,0.8172764227642276,0.22509658393166077,0.2296933207376219,132788.12629132217,1821.1274678604054,134609.25375918258,1943,3,516.219512195122,32,9,16,32.60673159377679,0.6572265625,42.329545454545446,1030.681818181817,32.208806818181785,0
4210,4,0,0,41,0.0,0.0,1.0,41,1000,500,500,0.5,15,5,10,372.74909797806635,0.8172256097560976,0.2200397711131854,0.22759875982492372,132902.97752066504,1707.8929978854158,134610.87051855045,1944,4,517.219512195122,33,8,16,32.60934157356787,0.6559343434343434,42.218137254901954,1031.1274509803914,31.246286393345194,0
4211,4,0,0,41,0.0,0.0,1.0,41,700,400,300,0.5714285714285714,10,4,6,373.04238531712184,0.8174288617886178,0.219674487619401,0.22816313334512336,132966.16685890043,1720.403210303728,134686.57006920414,1945,5,518.219512195122,33,8,16,32.53822084917617,0.6565656565656566,42.15686274509804,1031.3725490196077,31.25371360665478,0
4212,4,0,0,41,0.0,0.0,1.0,41,1050,800,250,0.7619047619047619,13,8,5,369.2539769584977,0.8169715447154472,0.21300306461008578,0.22649145210893812,133072.72002551006,1627.5262188208512,134700.24624433092,1946,6,519.219512195122,34,7,17,32.52879696934734,0.6553308823529412,42.05357142857142,1031.7857142857133,30.346638655462158,0
4213,4,0,0,41,0.0,0.0,1.0,41,600,400,200,0.6666666666666666,8,4,4,371.4762521080074,0.8164126016260163,0.2150838218037896,0.22828764576478988,133143.5282305598,1691.9317719050046,134835.46000246482,1947,7,520.219512195122,35,6,17,32.400307465141495,0.6538690476190476,41.9849537037037,1032.060185185185,29.487433862433857,0
4214,4,1,1,41,0.023809523809523808,0.023809523809523808,0.9761904761904762,42,950,700,250,0.7368421052631579,12,7,5,363.2746393662262,0.8220334881920248,0.2110218813939586,0.22541723690766344,133502.9779620182,1300.4596877974523,134803.43764981563,1948,0,508.8095238095238,34,8,17,32.25122873708866,0.6596200980392157,41.636904761904766,1033.4523809523814,30.395658263305336,0
4215,4,0,1,40,0.0,0.024390243902439025,0.975609756097561,41,1250,800,450,0.64,17,8,9,371.72742625868995,0.8130589430894309,0.21265955085538657,0.23066231503586054,133502.9779620182,1725.3436791383301,135228.32164115654,1949,9,522.219512195122,34,7,18,32.03283991859617,0.6596200980392156,41.636904761904766,1033.4523809523814,30.395658263305336,0
4216,4,0,0,40,0.0,0.0,1.0,40,1200,800,400,0.6666666666666666,16,8,8,377.7428533034,0.8083867521367522,0.20541895373585728,0.23401182869114878,133442.32420535415,2081.376859353573,135523.7010647077,1950,10,533.875,35,5,18,31.938337814121944,0.6568452380952381,41.695601851851855,1033.217592592593,29.52050264550266,0
4217,4,1,0,41,0.024390243902439025,0.0,1.0,41,800,400,400,0.5,12,4,8,373.3705688932928,0.811839430894309,0.2260271730234078,0.23374880153403657,133831.25964506195,1793.7340588563366,135624.99370391827,1951,0,521.829268292683,35,6,15,31.66107382550336,0.6607142857142856,41.31944444444446,1034.722222222224,29.563492063492113,0
4218,4,0,1,40,0.0,0.024390243902439025,0.975609756097561,41,850,500,350,0.5882352941176471,12,5,7,372.3866538007978,0.8114329268292683,0.22531108335015326,0.23351202372277263,133891.14610125188,1771.855174039799,135663.0012752917,1952,1,522.829268292683,35,6,15,31.626500410049943,0.6613095238095237,41.26157407407408,1034.953703703705,29.57010582010586,0
4219,4,0,0,40,0.0,0.0,1.0,40,1050,900,150,0.8571428571428571,12,9,3,373.8730167726679,0.8104700854700855,0.2322434607645869,0.2352087206785014,134010.95920138905,2020.6163194444634,136031.57552083352,1953,2,534.075,35,5,17,31.46797451374916,0.6624999999999999,41.14583333333334,1035.416666666668,29.583333333333375,0
4220,4,0,0,40,0.0,0.0,1.0,40,900,600,300,0.6666666666666666,12,6,6,371.80798650085524,0.8095619658119658,0.22625167635225707,0.2342913988175815,134070.8858453363,1969.7252229081205,136040.61106824444,1954,3,535.075,35,5,17,31.46140664580539,0.663095238095238,41.087962962962976,1035.64814814815,29.589947089947145,0
4221,4,0,0,40,0.0,0.0,1.0,40,850,400,450,0.47058823529411764,13,4,9,373.0309840660588,0.809508547008547,0.2290201005025123,0.23641135614377623,134280.734592014,2018.1749131944543,136298.90950520846,1955,4,536.075,35,5,17,31.219639865996648,0.6651785714285714,40.88541666666667,1036.4583333333342,29.613095238095262,0
4222,4,0,0,40,0.0,0.0,1.0,40,1200,1000,200,0.8333333333333334,14,10,4,371.5959821428573,0.8085737179487179,0.22812500000000036,0.23647017045454546,134430.7270233196,1990.7836076817555,136421.51063100135,1956,5,537.075,35,5,17,31.106770833333336,0.6666666666666666,40.74074074074074,1037.037037037037,29.629629629629626,0
4223,4,0,0,40,0.0,0.0,1.0,40,850,500,350,0.5882352941176471,12,5,7,369.7224568670369,0.8080395299145299,0.2301991520696196,0.2358592441921176,134520.76266986024,1947.0693747856617,136467.8320446459,1957,6,538.075,35,5,17,31.065328758972065,0.6675595238095238,40.65393518518518,1037.3842592592591,29.639550264550262,0
4224,4,0,0,40,0.0,0.0,1.0,40,1250,900,350,0.72,16,9,7,374.42158603066866,0.8072115384615385,0.23257054370268393,0.23966280374562188,134643.431122449,2082.6847548754577,136726.11587732445,1958,7,539.075,34,6,17,30.820811348168544,0.6709558823529411,40.535714285714285,1037.857142857143,30.525210084033613,0
4225,4,0,0,40,0.0,0.0,1.0,40,950,700,250,0.7368421052631579,12,7,5,372.74330753224865,0.805715811965812,0.22972887767969752,0.239605001592027,134797.9184382087,2049.004393424046,136846.92283163275,1959,8,540.075,34,6,16,30.710000382131522,0.6724877450980392,40.386904761904766,1038.4523809523816,30.542717086834756,0
4226,4,0,0,40,0.0,0.0,1.0,40,1500,1200,300,0.8,18,12,6,370.01578449496844,0.8050747863247864,0.22766445106578037,0.23846068947585622,134890.65334467115,1982.3341836734626,136872.98752834462,1960,9,541.075,34,6,16,30.688221025288392,0.6734068627450981,40.297619047619044,1038.8095238095234,30.553221288515395,0
4227,4,0,0,40,0.0,0.0,1.0,40,800,400,400,0.5,12,4,8,373.6673442285626,0.8048878205128205,0.24430307198532852,0.24040368075589802,134828.82653061216,2078.2667233560014,136907.09325396817,1961,10,542.075,34,6,14,30.65513716949413,0.6727941176470589,40.357142857142854,1038.5714285714278,30.546218487394935,1
4228,4,0,0,40,0.0,0.0,1.0,40,900,700,200,0.7777777777777778,11,7,4,374.7716878384606,0.8048344017094017,0.24845594133150017,0.24173189355256777,134921.57206632633,2112.9570578231055,137034.52912414944,1962,11,543.075,34,6,16,30.533831786409994,0.6737132352941178,40.26785714285713,1038.9285714285697,30.55672268907558,0
4229,4,0,0,40,0.0,0.0,1.0,40,1250,1100,150,0.88,14,11,3,374.1506834124762,0.8038194444444444,0.24953910454597494,0.24257297091619556,135107.1588010204,2110.087159863948,137217.24596088435,1963,12,544.075,34,6,16,30.36470857666323,0.6755514705882353,40.089285714285715,1039.642857142857,30.577731092436974,0
4230,4,0,0,40,0.0,0.0,1.0,40,800,500,300,0.625,11,5,6,374.656626197407,0.8034188034188035,0.2505209525990386,0.24310928478515237,135138.10232426293,2126.077097505656,137264.17942176858,1964,13,545.075,34,6,16,30.320681627356684,0.6758578431372548,40.0595238095238,1039.761904761904,30.581232492997174,0
4231,4,0,1,39,0.0,0.025,0.975,40,1250,900,350,0.72,16,9,7,372.0913711907605,0.8023504273504274,0.24503318837262533,0.24227529072018372,135261.91184807254,2065.95804988662,137327.86989795917,1965,14,546.075,34,6,16,30.263885709925994,0.6770833333333333,39.94047619047619,1040.2380952380952,30.595238095238095,0
4232,4,0,0,39,0.0,0.0,1.0,39,1150,900,250,0.782608695652174,14,9,5,375.041680801307,0.7978520017993702,0.23794730990704016,0.24482743329979265,135354.80619331062,2352.7388038548715,137707.5449971655,1966,15,557.5128205128206,34,5,17,30.094525797963616,0.6780024509803921,39.851190476190474,1040.5952380952378,30.60574229691876,0
4233,4,0,0,39,0.0,0.0,1.0,39,650,600,50,0.9230769230769231,7,6,1,376.7533892215396,0.7971210076473235,0.241780030386757,0.24615681080528384,135385.7780612244,2401.4101473922856,137787.1882086167,1967,16,558.5128205128206,34,5,17,30.019112712575314,0.6783088235294117,39.82142857142857,1040.714285714285,30.609243697478973,0
4234,4,0,0,39,0.0,0.0,1.0,39,950,600,350,0.631578947368421,13,6,7,380.35559504378034,0.795940170940171,0.24820817686943197,0.24958517553247928,135540.69054705222,2510.732001133794,138051.422548186,1968,17,559.5128205128206,34,5,18,29.77092145878587,0.6798406862745099,39.67261904761905,1041.3095238095243,30.626750700280127,0
4235,4,0,0,39,0.0,0.0,1.0,39,1500,1200,300,0.8,18,12,6,382.8672709118071,0.7949842555105713,0.25608457949984476,0.25256170710342074,135729.43887266907,2593.303856469044,138322.74272913812,1969,18,560.5128205128206,33,6,19,29.51740072131404,0.6840277777777779,39.491421568627445,1042.0343137254895,31.576797385620893,0
4236,4,0,0,39,0.0,0.0,1.0,39,700,600,100,0.8571428571428571,8,6,2,382.8672709118071,0.7947031039136303,0.25608457949984476,0.25256170710342074,135729.43887266907,2593.271968713942,138322.710841383,1970,19,561.5128205128206,33,6,19,29.51740072131404,0.6840277777777779,39.491421568627445,1042.0343137254895,31.576797385620893,0
4237,4,0,0,39,0.0,0.0,1.0,39,850,700,150,0.8235294117647058,10,7,3,384.3888637652894,0.7941970310391363,0.25946161082567554,0.25379215042391445,135761.36582083802,2637.0314302191323,138398.39725105715,1971,20,562.5128205128206,33,6,19,29.445947005330822,0.6843434343434345,39.46078431372548,1042.156862745097,31.580510992275666,0
4238,4,0,0,39,0.0,0.0,1.0,39,1150,900,250,0.782608695652174,14,9,5,382.92716462049555,0.7933535762483132,0.25473421476243074,0.2532798182163244,135825.23098087258,2602.2341166858732,138427.46509755845,1972,21,563.5128205128206,33,6,19,29.420409122972025,0.6849747474747476,39.39950980392156,1042.4019607843125,31.587938205585225,0
4239,4,0,0,39,0.0,0.0,1.0,39,850,700,150,0.8235294117647058,10,7,3,378.31818149697574,0.7926788124156545,0.24117987275882058,0.2515815906954885,136016.9165705496,2491.5345059592228,138508.45107650882,1973,22,564.5128205128206,33,6,17,29.34974154135339,0.686868686868687,39.21568627450979,1043.1372549019593,31.610219845513917,0
4240,4,0,0,39,0.0,0.0,1.0,39,900,800,100,0.8888888888888888,10,8,2,374.4696166400425,0.7911043634727846,0.23777464908912505,0.2495080261648177,136086.1695842979,2392.0271508487685,138478.19673514666,1974,23,565.5128205128206,35,4,17,29.38123960066556,0.6830357142857142,39.14930555555556,1043.402777777778,29.811507936507944,0
4241,4,0,0,39,0.0,0.0,1.0,39,850,400,450,0.47058823529411764,13,4,9,372.8693565911672,0.7884615384615384,0.23232702257092486,0.24950160211070674,136237.16670953357,2359.7329389574684,138596.89964849103,1975,24,566.5128205128206,35,4,17,29.272912047302285,0.6845238095238095,39.004629629629626,1043.981481481481,29.828042328042315,0
4242,4,0,0,39,0.0,0.0,1.0,39,1100,900,200,0.8181818181818182,13,9,4,372.3525336254446,0.785425101214575,0.22900529181685725,0.25065073236665847,136448.70334201393,2361.4040798611163,138810.10742187506,1976,25,567.5128205128206,35,4,18,29.076312728481227,0.6866071428571427,38.802083333333336,1044.791666666667,29.851190476190485,0
4243,4,0,0,39,0.0,0.0,1.0,39,1100,900,200,0.8181818181818182,13,9,4,375.61556548079045,0.7827260458839407,0.23256342122595486,0.2539341158250373,136599.9014060356,2461.8098422496514,139061.71124828525,1977,26,568.5128205128206,35,4,19,28.840972837319168,0.6880952380952381,38.657407407407405,1045.37037037037,29.867724867724856,0
4244,4,0,0,39,0.0,0.0,1.0,39,1000,700,300,0.7,13,7,6,375.61556548079045,0.7819950517318939,0.23256342122595486,0.2539341158250373,136599.9014060356,2461.8098422496514,139061.71124828525,1978,27,569.5128205128206,35,4,19,28.840972837319168,0.6880952380952381,38.657407407407405,1045.37037037037,29.867724867724856,0
4245,4,0,0,39,0.0,0.0,1.0,39,1600,1200,400,0.75,20,12,8,375.6193784915024,0.7815452091767882,0.23502334227292732,0.2545927295326876,136690.660432206,2468.7321834276463,139159.39261563364,1979,28,570.5128205128206,35,4,19,28.750807046670367,0.6889880952380952,38.570601851851855,1045.717592592593,29.877645502645517,0
4246,4,0,0,39,0.0,0.0,1.0,39,700,400,300,0.5714285714285714,10,4,6,374.7702729892955,0.7804768331084121,0.23403783408336087,0.2544614851996872,136752.04790249444,2450.1238138323833,139202.17171632682,1980,29,571.5128205128206,34,5,19,28.712108278321566,0.6917892156862744,38.511904761904766,1045.9523809523816,30.763305322128872,0
4247,4,0,0,39,0.0,0.0,1.0,39,1050,800,250,0.7619047619047619,13,8,5,372.165688269643,0.7805330634278003,0.22474617105489592,0.25381757684859835,136907.7398667801,2390.472647392297,139298.2125141724,1981,30,572.5128205128206,34,5,20,28.625867364349908,0.6933210784313726,38.36309523809524,1046.5476190476195,30.780812324929986,0
4248,4,0,0,39,0.0,0.0,1.0,39,1200,800,400,0.6666666666666666,16,8,8,374.9261690682711,0.7796896086369771,0.23025891807877463,0.25615585117461614,136970.0414540817,2470.730583900232,139440.77203798192,1982,31,573.5128205128206,34,5,16,28.491887486258005,0.6939338235294118,38.30357142857143,1046.7857142857147,30.787815126050432,0
4249,4,0,0,39,0.0,0.0,1.0,39,800,400,400,0.5,12,4,8,374.71738259628955,0.7793522267206479,0.23015706439990224,0.2566989172365235,137063.52040816325,2472.016723356012,139535.53713151926,1983,32,574.5128205128206,34,5,16,28.404719948461427,0.6948529411764706,38.214285714285715,1047.142857142857,30.798319327731093,0
4250,4,0,0,39,0.0,0.0,1.0,39,750,500,250,0.6666666666666666,10,5,5,375.6908804726941,0.7771030139451193,0.22719947779613658,0.25805652281648994,137157.03125,2505.729166666667,139662.76041666666,1984,33,575.5128205128206,34,5,16,28.286595067621324,0.6957720588235294,38.125,1047.5,30.808823529411764,0
4251,4,0,0,39,0.0,0.0,1.0,39,1600,1200,400,0.75,20,12,8,374.38503748967094,0.7749662618083671,0.21955637880217593,0.2583139396598013,137312.95351473935,2481.5830498866335,139794.53656462597,1985,34,576.5128205128206,34,5,17,28.16641110101469,0.6973039215686274,37.97619047619048,1048.095238095239,30.82633053221291,0
4252,4,0,0,39,0.0,0.0,1.0,39,1000,800,200,0.8,12,8,4,376.89471010335114,0.7738978857399911,0.22322775263951722,0.26051293698352535,137375.34722222228,2555.208333333345,139930.55555555562,1986,35,577.5128205128206,34,5,18,28.038884472708016,0.6979166666666666,37.91666666666667,1048.333333333334,30.83333333333335,0
4253,4,0,0,39,0.0,0.0,1.0,39,1200,800,400,0.6666666666666666,16,8,8,380.0381967632568,0.7722672064777328,0.22477849560952956,0.2634679495693856,137478.501224387,2649.4163398062447,140127.91756419325,1987,36,578.5128205128206,35,4,18,27.854380495162424,0.6967261904761904,37.81828703703704,1048.726851851852,29.963624338624342,0
4254,4,0,0,39,0.0,0.0,1.0,39,950,800,150,0.8421052631578947,11,8,3,381.3129345820564,0.7717049032838507,0.22468362488223437,0.26481525870629735,137539.19813368065,2689.095052083345,140228.293185764,1988,37,579.5128205128206,35,4,19,27.76088215822576,0.6973214285714284,37.76041666666667,1048.9583333333342,29.97023809523812,0
4255,4,0,0,39,0.0,0.0,1.0,39,900,500,400,0.5555555555555556,13,5,8,382.6823019892507,0.7708052181736392,0.22963226934107173,0.26646680106256126,137630.2686149692,2733.73360339507,140364.00221836424,1989,38,580.5128205128206,35,4,19,27.63484447385838,0.6982142857142857,37.673611111111114,1049.3055555555559,29.980158730158738,0
4256,4,0,0,39,0.0,0.0,1.0,39,1250,1000,250,0.8,15,10,5,383.8643827969198,0.7701866846603689,0.2346261296415686,0.26776017101557464,137690.99901406036,2770.934070644719,140461.9330847051,1990,39,581.5128205128206,35,4,19,27.54374356712248,0.6988095238095238,37.61574074074074,1049.5370370370372,29.98677248677249,0
4257,4,0,0,39,0.0,0.0,1.0,39,1350,700,650,0.5185185185185185,20,7,13,385.5728702119779,0.7687246963562754,0.2369648396949764,0.27065889193995596,137909.02424848612,2834.9028288769487,140743.92707736307,1991,40,582.5128205128206,33,6,20,27.283256523937307,0.7054924242424242,37.408088235294116,1050.3676470588234,31.829322638146163,0
4258,4,0,0,39,0.0,0.0,1.0,39,650,500,150,0.7692307692307693,8,5,3,385.5728702119779,0.7687246963562754,0.2369648396949764,0.27065889193995596,137909.02424848612,2834.795661524411,140743.81991001053,1992,41,583.5128205128206,33,6,20,27.283256523937307,0.7054924242424242,37.408088235294116,1050.3676470588234,31.829322638146163,0
4259,4,0,0,39,0.0,0.0,1.0,39,1400,1100,300,0.7857142857142857,17,11,6,384.3142990545028,0.7675438596491229,0.22892106726956296,0.2705345484477262,138005.58228806223,2807.503724529021,140813.08601259126,1993,42,584.5128205128206,33,6,20,27.22086151932198,0.7064393939393939,37.31617647058823,1050.7352941176466,31.840463458110502,0
4260,4,0,0,39,0.0,0.0,1.0,39,1100,800,300,0.7272727272727273,14,8,6,387.0203741638265,0.7665879442195231,0.2312566345219409,0.272695128057092,138037.77581038536,2884.68632857554,140922.4621389609,1994,43,585.5128205128206,33,6,20,27.117954324586982,0.7067550505050505,37.28553921568627,1050.8578431372543,31.844177064765283,0
4261,4,0,0,39,0.0,0.0,1.0,39,1100,800,300,0.7272727272727273,14,8,6,390.030012600245,0.7658007197480882,0.2335916570991199,0.27507379836017276,138069.97308727406,2970.286668588995,141040.25975586305,1995,44,586.5128205128206,33,6,16,27.007054570895512,0.7070707070707071,37.25490196078431,1050.9803921568623,31.84789067142007,0
4262,4,0,0,39,0.0,0.0,1.0,39,800,400,400,0.5,12,4,8,388.16133557728546,0.7641138101664418,0.23399154665184052,0.2742708349738017,138134.3789047481,2923.685000961157,141058.06390570925,1996,45,587.5128205128206,33,6,16,26.99250019429548,0.7077020202020202,37.19362745098039,1051.2254901960778,31.85531788472963,0
4263,4,0,0,39,0.0,0.0,1.0,39,1000,800,200,0.8,12,8,4,386.1985117756617,0.7624269005847953,0.22605453274295084,0.2739136882693163,138263.23559448274,2879.411163975378,141142.6467584581,1997,46,588.5128205128206,33,6,17,26.91680261011419,0.7089646464646464,37.07107843137254,1051.7156862745087,31.87017231134875,0
4264,4,0,0,39,0.0,0.0,1.0,39,800,600,200,0.75,10,6,4,380.6022080440357,0.7623144399460189,0.17852125043905853,0.25258146533831455,135943.8775510204,2577.183348829726,138521.06089985013,1998,47,589.5128205128206,34,5,18,29.362871004566202,0.6838235294117647,39.285714285714285,1042.857142857143,30.672268907563026,5
4265,4,0,0,39,0.0,0.0,1.0,39,650,300,350,0.46153846153846156,10,3,7,380.04096592104105,0.7606837606837608,0.17814997205616878,0.25287008233607333,136037.00573979603,2539.9270124716672,138576.9327522677,1999,48,590.5128205128206,34,5,18,29.28482445129142,0.6847426470588235,39.19642857142858,1043.2142857142865,30.68277310924372,0
4266,4,0,0,39,0.0,0.0,1.0,39,550,400,150,0.7272727272727273,7,4,3,377.87322946199157,0.7600652271704904,0.17827863608056616,0.25220450851656384,136146.55838745285,2489.2279396004783,138635.78632705333,2000,49,591.5128205128206,35,4,18,29.232398987098453,0.6836309523809524,39.09143518518518,1043.6342592592591,29.81812169312169,0
4267,4,0,0,39,0.0,0.0,1.0,39,1100,600,500,0.5454545454545454,16,6,10,375.41801662725356,0.7592217723796671,0.17335834896810498,0.2512070111259516,136237.1667095337,2429.1773834019295,138666.34409293561,2001,50,592.5128205128206,35,4,18,29.206393200295643,0.6845238095238095,39.00462962962963,1043.981481481482,29.828042328042343,0
4268,4,0,0,39,0.0,0.0,1.0,39,600,500,100,0.8333333333333334,7,5,2,378.0895499122543,0.7596716149347729,0.17178520880582537,0.2534267399188973,136297.58900248632,2506.538816015091,138804.1278185014,2002,51,593.5128205128206,35,4,18,29.07660902977907,0.6851190476190476,38.94675925925926,1044.212962962963,29.834656084656086,0
4269,4,0,0,39,0.0,0.0,1.0,39,800,400,400,0.5,12,4,8,370.7620905975991,0.7586032388663968,0.16386737224224768,0.2495801187042898,136448.70334201382,2318.001302083325,138766.70464409713,2003,52,594.5128205128206,35,4,18,29.11785476902625,0.6866071428571429,38.80208333333333,1044.791666666666,29.85119047619046,0
4270,4,0,0,39,0.0,0.0,1.0,39,650,400,250,0.6153846153846154,9,4,5,370.7620905975991,0.7586032388663968,0.16386737224224768,0.2495801187042898,136448.70334201382,2318.001302083325,138766.70464409713,2004,53,595.5128205128206,35,4,18,29.11785476902625,0.6866071428571429,38.80208333333333,1044.791666666666,29.85119047619046,0
4271,4,0,0,39,0.0,0.0,1.0,39,1050,900,150,0.8571428571428571,12,9,3,368.94309848812344,0.7585470085470086,0.16556516999386828,0.24942320849885707,136599.9014060356,2279.5181755829863,138879.4195816186,2005,54,596.5128205128206,35,4,18,29.015352819604367,0.6880952380952381,38.657407407407405,1045.37037037037,29.867724867724856,0
4272,4,0,0,39,0.0,0.0,1.0,39,1300,1000,300,0.7692307692307693,16,10,6,365.7048127203665,0.7550607287449393,0.16841711066096954,0.24851429303508807,136781.44959919405,2204.3268818587,138985.77648105274,2006,55,597.5128205128206,35,4,19,28.920022866415852,0.6898809523809524,38.48379629629629,1046.0648148148146,29.88756613756613,0
4273,4,0,0,39,0.0,0.0,1.0,39,1150,800,350,0.6956521739130435,15,8,7,331.4945346577513,0.7547795771479983,0.10820401579620653,0.21283980567858418,134755.32119957806,1138.0019193524195,135893.32311893048,2007,56,598.5128205128206,36,3,18,31.82325560375994,0.6678240740740741,40.42792792792793,1038.288288288289,28.841341341341362,6
4274,4,0,0,39,0.0,0.0,1.0,39,1200,800,400,0.6666666666666666,16,8,8,336.89361597515915,0.7555105713000451,0.11979891789147179,0.21753095833469555,134960.0164987626,1293.4335940670726,136253.45009282968,2008,57,599.5128205128206,36,3,15,31.479399226906555,0.6698495370370369,40.23085585585587,1039.0765765765789,28.863238238238303,0
4275,4,0,0,39,0.0,0.0,1.0,39,1050,700,350,0.6666666666666666,14,7,7,335.74538415097487,0.75472334682861,0.12316691107852251,0.21766863669113798,135106.3225387552,1272.2648323999902,136378.58737115518,2009,58,600.5128205128206,36,3,16,31.363734835355295,0.6712962962962962,40.0900900900901,1039.6396396396412,28.878878878878922,0
4276,4,0,0,39,0.0,0.0,1.0,39,1000,900,100,0.9,11,9,2,338.93150894542373,0.7547795771479983,0.12346008079630155,0.22026970338571364,135194.14420755222,1364.3110593701886,136558.45526692242,2010,59,601.5128205128206,36,3,17,31.193602237863196,0.6721643518518519,40.005630630630634,1039.9774774774783,28.888263263263283,0
4277,4,0,0,39,0.0,0.0,1.0,39,1000,800,200,0.8,12,8,4,337.6210099970345,0.7543859649122807,0.12376320085284975,0.21959631326286005,135223.42443795162,1330.8538267997899,136554.2782647514,2011,60,602.5128205128206,36,3,17,31.19857080987441,0.6724537037037036,39.977477477477485,1040.0900900900913,28.891391391391423,0
4278,4,0,0,39,0.0,0.0,1.0,39,1450,1200,250,0.8275862068965517,17,12,5,339.0301437379358,0.7526990553306343,0.1231268731268731,0.22123153447306002,135340.57706355012,1376.9070590861247,136717.48412263626,2012,61,603.5128205128206,36,3,17,31.045499639249634,0.673611111111111,39.86486486486487,1040.5405405405413,28.903903903903924,0
4279,4,1,0,40,0.025,0.0,1.0,40,750,600,150,0.8,9,6,3,333.1199999999998,0.7546474358974359,0.12760000000000016,0.21915789473684225,135633.68055555574,1036.7753733463392,136670.45592890208,2013,0,589.4,36,4,18,30.90833333333333,0.6765046296296295,39.58333333333334,1041.666666666668,28.935185185185226,0
4280,4,0,0,40,0.0,0.0,1.0,40,650,400,250,0.6153846153846154,9,4,5,331.19467608130054,0.7551282051282051,0.12746973627323843,0.2182487993663956,135692.3392987583,988.1160721532439,136680.45537091154,2014,1,590.4,36,4,18,30.9003008358553,0.6770833333333334,39.52702702702703,1041.8918918918926,28.94144144144146,0
4281,4,0,0,40,0.0,0.0,1.0,40,500,300,200,0.6,7,3,4,331.19467608130054,0.7551282051282051,0.12746973627323843,0.2182487993663956,135692.3392987583,988.1160721532439,136680.45537091154,2015,2,591.4,36,4,18,30.9003008358553,0.6770833333333334,39.52702702702703,1041.8918918918926,28.94144144144146,0
4282,4,0,0,40,0.0,0.0,1.0,40,750,400,350,0.5333333333333333,11,4,7,332.6754249993835,0.7539529914529914,0.1294079515989628,0.21994598098530688,135809.69482996516,1036.1095893190532,136845.80441928422,2016,3,592.4,36,4,19,30.74537237107461,0.6782407407407407,39.414414414414416,1042.3423423423428,28.953953953953967,0
4283,4,0,0,40,0.0,0.0,1.0,40,950,700,250,0.7368421052631579,12,7,5,331.69502890156946,0.7539529914529914,0.1268144508046225,0.21983996224764735,135897.74476757168,1015.3212756675637,136913.06604323923,2017,4,593.4,36,4,13,30.683659142455994,0.6791087962962963,39.32995495495496,1042.6801801801805,28.963338338338346,0
4284,4,0,0,40,0.0,0.0,1.0,40,1050,900,150,0.8571428571428571,12,9,3,329.67858443289674,0.7544604700854701,0.11703195854027215,0.21904469505146995,135985.82323877935,966.3227416605829,136952.14598043993,2018,5,594.4,36,4,13,30.648977902540835,0.6799768518518519,39.2454954954955,1043.0180180180182,28.97272272272273,0
4285,4,0,0,40,0.0,0.0,1.0,40,1100,600,500,0.5454545454545454,16,6,10,330.13671620734914,0.7534188034188034,0.11464382083108493,0.21989336273623933,136073.9302435881,984.6000984092086,137058.5303419973,2019,6,595.4,36,4,13,30.54978413383702,0.6808449074074074,39.16103603603603,1043.3558558558552,28.98210710710709,0
4286,4,0,0,40,0.0,0.0,1.0,40,800,300,500,0.375,13,3,10,330.5037959453984,0.7519230769230769,0.12150372288766609,0.2205024245519081,136132.68409879456,998.4737693774641,137131.157868172,2020,7,596.4,36,4,13,30.48204201287724,0.6814236111111113,39.10472972972972,1043.5810810810797,28.988363363363323,0
4287,4,0,0,40,0.0,0.0,1.0,40,700,500,200,0.7142857142857143,9,5,4,332.1600000000001,0.753258547008547,0.14659999999999984,0.21852631578947349,135633.6805555554,1038.430322214082,136672.11087776948,2021,8,597.4,35,5,20,30.933333333333316,0.6785714285714286,39.58333333333332,1041.6666666666654,29.761904761904724,4
4288,4,0,0,40,0.0,0.0,1.0,40,700,200,500,0.2857142857142857,12,2,10,330.83163104245716,0.752323717948718,0.14542652449183624,0.2182034559908601,135724.1180796681,980.3662712191232,136704.4843508872,2022,9,598.4,35,5,20,30.878248917027665,0.6794642857142857,39.49652777777777,1042.013888888888,29.77182539682537,0
4289,4,0,0,40,0.0,0.0,1.0,40,900,500,400,0.5555555555555556,13,5,8,332.50240132180727,0.7524305555555556,0.14856730342070157,0.2194905880866241,135754.2706189986,1027.7241941015006,136781.9948131001,2023,10,599.4,35,5,20,30.804827484081134,0.6797619047619048,39.46759259259259,1042.1296296296293,29.77513227513227,0
4290,4,0,0,40,0.0,0.0,1.0,40,850,500,350,0.5882352941176471,12,5,7,334.6147415046895,0.752857905982906,0.14553730017761968,0.2216330581966356,135874.91426611805,1093.1498628257955,136968.06412894384,2024,11,600.4,35,5,15,30.630180580224973,0.680952380952381,39.351851851851855,1042.5925925925933,29.78835978835981,0
4291,4,0,0,40,0.0,0.0,1.0,40,1050,600,450,0.5714285714285714,15,6,9,333.35566708867776,0.7534455128205129,0.13360883070778784,0.22192525724795725,136055.98020619,1071.0064086076814,137126.98661479767,2025,12,601.4,35,5,16,30.483599585829452,0.6827380952380953,39.17824074074074,1043.2870370370372,29.808201058201064,0
4292,4,0,0,40,0.0,0.0,1.0,40,1100,700,400,0.6363636363636364,15,7,8,334.77954271098497,0.7524038461538461,0.13857285429141708,0.2236327345309381,136176.75781250015,1117.838541666681,137294.59635416683,2026,13,602.4,35,5,17,30.32684630738524,0.6839285714285713,39.06250000000001,1043.7500000000011,29.821428571428605,0
4293,4,0,0,40,0.0,0.0,1.0,40,1450,1300,150,0.896551724137931,16,13,3,331.49599133589527,0.7522702991452992,0.13828826332705302,0.22238574942927766,136327.80517243233,1038.4241844564517,137366.22935688877,2027,14,603.4,35,5,17,30.26305460120432,0.6854166666666666,38.917824074074076,1044.3287037037042,29.837962962962976,0
4294,4,0,0,40,0.0,0.0,1.0,40,950,600,350,0.631578947368421,13,6,7,330.02387370042345,0.7510149572649573,0.13497304582210257,0.22164890865832218,136367.82633562628,1000.9276590780078,137368.75399470428,2028,15,604.4,36,4,17,30.261904761904763,0.6837384259259259,38.87950450450451,1044.4819819819827,29.013388388388407,0
4295,4,0,0,40,0.0,0.0,1.0,40,1250,900,350,0.72,16,9,7,329.73150322077794,0.7514957264957265,0.13496874663217984,0.2221916207977925,136485.47354364523,1000.7120718691879,137486.18561551443,2029,16,605.4,36,4,17,30.153213349139627,0.6848958333333333,38.7668918918919,1044.932432432434,29.025900900900947,0
4296,4,0,0,40,0.0,0.0,1.0,40,1000,500,500,0.5,15,5,10,330.71877204636206,0.7504273504273504,0.14231354243155359,0.22344025895945915,136577.61432604262,1033.7561797860872,137611.3705058287,2030,17,606.4,37,3,18,30.03634305395294,0.6838400900900901,38.67872807017544,1045.2850877192982,28.250948316737787,0
4297,4,0,0,40,0.0,0.0,1.0,40,1000,400,600,0.4,16,4,12,327.76254992560087,0.7489049145299145,0.14110619469026542,0.22311547073248753,136841.9924554185,970.4863634442235,137812.47881886273,2031,18,607.4,35,5,18,29.85250737463126,0.6904761904761904,38.42592592592593,1046.2962962962972,29.89417989417992,0
4298,4,0,1,39,0.0,0.025,0.975,40,1350,900,450,0.6666666666666666,18,9,9,326.02319076563305,0.7486378205128205,0.13470809376382098,0.22270043332963657,136963.11835562426,930.6305727023432,137893.74892832662,2032,19,608.4,35,5,16,29.778490343505826,0.6916666666666667,38.31018518518519,1046.7592592592603,29.907407407407437,0
4299,4,0,0,39,0.0,0.0,1.0,39,1050,700,350,0.6666666666666666,14,7,7,329.82006611979455,0.7461201079622133,0.12868617075552846,0.22574066004074655,137032.35721371887,1239.2042233560123,138271.56143707488,2033,20,608.6923076923077,34,5,16,29.610811066894076,0.694546568627451,38.24404761904762,1047.0238095238099,30.79481792717088,0
4300,4,0,0,39,0.0,0.0,1.0,39,800,400,400,0.5,12,4,8,329.4897816460123,0.7457264957264957,0.1339371315504969,0.22632166968799883,137157.03125000012,1238.3680555555711,138395.39930555568,2034,21,609.6923076923077,34,5,17,29.496486343145055,0.6957720588235293,38.12500000000001,1047.500000000001,30.808823529411793,0
4301,4,0,0,39,0.0,0.0,1.0,39,750,500,250,0.6666666666666666,10,5,5,328.5123327974715,0.7450517318938372,0.14118586102226205,0.22625708554642768,137250.57397959195,1217.7012471655466,138468.27522675748,2035,22,610.6923076923077,34,5,18,29.42986442475194,0.6966911764705881,38.03571428571429,1047.8571428571438,30.819327731092464,0
4302,4,0,0,39,0.0,0.0,1.0,39,850,700,150,0.8235294117647058,10,7,3,327.13654191500433,0.7438708951866847,0.14272193829263702,0.2259166471813031,137344.14859693885,1186.0579648526184,138530.20656179148,2036,23,611.6923076923077,34,5,18,29.373698656066622,0.697610294117647,37.94642857142858,1048.2142857142862,30.829831932773125,0
4303,4,0,0,39,0.0,0.0,1.0,39,1000,700,300,0.7,13,7,6,327.57382026578074,0.7419028340080972,0.13916253289550262,0.2268294189387578,137437.75510204092,1204.2020975056776,138641.9571995466,2037,24,612.6923076923077,34,5,18,29.2700291401756,0.6985294117647058,37.85714285714286,1048.5714285714294,30.840336134453803,0
4304,4,0,0,39,0.0,0.0,1.0,39,1000,700,300,0.7,13,7,6,326.8716155539894,0.741846603688709,0.13556855554585412,0.22675109708902724,137500.17715419497,1188.981009070287,138689.15816326527,2038,25,613.6923076923077,34,5,18,29.226967461218322,0.6991421568627452,37.797619047619044,1048.8095238095234,30.847338935574218,0
4305,4,0,0,39,0.0,0.0,1.0,39,1000,800,200,0.8,12,8,4,327.03527170472245,0.7396536212325686,0.13654093654093646,0.22751916638551875,137599.9084388932,1200.004688571676,138799.91312746488,2039,26,614.6923076923077,35,4,18,29.12449439235155,0.6979166666666666,37.7025462962963,1049.189814814815,29.97685185185186,0
4306,4,0,0,39,0.0,0.0,1.0,39,850,400,450,0.47058823529411764,13,4,9,328.77194275083343,0.737910481331534,0.14007923407065048,0.2293528822183959,137694.28211995785,1254.003327651982,138948.28544760981,2040,27,615.6923076923077,36,3,18,28.98605150214592,0.6967592592592593,37.612612612612615,1049.54954954955,29.154154154154167,0
4307,4,0,0,39,0.0,0.0,1.0,39,800,500,300,0.625,11,5,6,333.2073570168808,0.7358299595141701,0.1471306471306475,0.23324514991181666,137812.50000000012,1384.0785041798708,139196.57850417998,2041,28,616.6923076923077,35,4,19,28.75330687830688,0.7,37.50000000000001,1050.000000000001,30.000000000000025,0
4308,4,0,0,39,0.0,0.0,1.0,39,950,600,350,0.631578947368421,13,6,7,331.2156273478587,0.7356612685560054,0.1441491841491842,0.23246572453068978,137903.6609037424,1335.1695119598885,139238.83041570228,2042,29,617.6923076923077,35,4,20,28.7159090909091,0.7008928571428571,37.41319444444445,1050.347222222223,30.00992063492066,0
4309,4,0,0,39,0.0,0.0,1.0,39,750,500,250,0.6666666666666666,10,5,5,332.0021107814252,0.7348178137651822,0.14288820919507184,0.23384384513456621,138025.25566111534,1364.9352441272272,139390.19090524258,2043,30,618.6923076923077,35,4,21,28.57567371590117,0.7020833333333333,37.2974537037037,1050.8101851851848,30.023148148148135,0
4310,4,0,0,39,0.0,0.0,1.0,39,950,600,350,0.631578947368421,13,6,7,330.3977084279242,0.7324561403508772,0.140998828725851,0.2339566002391031,138207.74826656817,1332.7046628515154,139540.4529294197,2044,31,619.6923076923077,35,4,16,28.438474591817997,0.7038690476190477,37.123842592592595,1051.5046296296305,30.042989417989443,0
4311,4,0,0,39,0.0,0.0,1.0,39,1150,900,250,0.782608695652174,14,9,5,329.0465344692034,0.7316689158794423,0.14118215617466,0.23312872070359789,138226.6620505641,1296.6008237967733,139523.26287436087,2045,32,620.6923076923077,36,3,16,28.45541514956807,0.7019675925925926,37.10585585585586,1051.5765765765768,29.210460460460467,0
4312,4,0,0,39,0.0,0.0,1.0,39,650,300,350,0.46153846153846156,10,3,7,327.196209432979,0.7311628430049483,0.13493311812549602,0.23242127698201198,138315.49190660255,1251.2609315396514,139566.7528381422,2046,33,621.6923076923077,36,3,16,28.416836170288693,0.7028356481481481,37.0213963963964,1051.9144144144145,29.219844844844847,0
4313,4,0,0,39,0.0,0.0,1.0,39,1050,700,350,0.6666666666666666,14,7,7,325.551441802997,0.7309941520467836,0.13019439985732073,0.2320578355186126,138433.97610025582,1213.4761027919947,139647.4522030478,2047,34,622.6923076923077,36,3,16,28.34381130729444,0.7039930555555556,36.90878378378379,1052.3648648648661,29.232357357357394,0
4314,4,0,0,39,0.0,0.0,1.0,39,1600,1500,100,0.9375,17,15,2,327.1402670937116,0.729757085020243,0.12087755381873033,0.23420838417505382,138582.15267632497,1267.1604881908954,139849.31316451586,2048,35,623.6923076923077,36,3,19,28.15663992869874,0.7054398148148149,36.76801801801802,1052.927927927928,29.247997997998002,0
4315,4,0,0,39,0.0,0.0,1.0,39,600,200,400,0.3333333333333333,10,2,8,324.2469746157698,0.7282388663967612,0.11614940543741037,0.23294978498893337,138700.75100438288,1194.659778021277,139895.41078240416,2049,36,624.6923076923077,36,3,19,28.116536597534033,0.7065972222222222,36.65540540540541,1053.3783783783792,29.260510510510535,0
4316,4,0,0,39,0.0,0.0,1.0,39,1250,900,350,0.72,16,9,7,325.116261268017,0.7277890238416554,0.1214776815931029,0.23418882653462927,138789.73303962743,1224.5598216459662,140014.2928612734,2050,37,625.6923076923077,36,3,20,28.006439029603513,0.7074652777777779,36.570945945945944,1053.716216216216,29.26989489489489,0
4317,4,0,0,39,0.0,0.0,1.0,39,1000,700,300,0.7,13,7,6,328.491158276385,0.7252024291497976,0.13131338027204786,0.237870279577865,138967.78271092044,1329.937581162254,140297.7202920827,2051,38,626.6923076923077,36,3,20,27.743066680907127,0.7092013888888888,36.40202702702703,1054.3918918918923,29.288663663663677,0
4318,4,0,0,39,0.0,0.0,1.0,39,450,300,150,0.6666666666666666,6,3,3,324.9706890529735,0.7247525865946919,0.1315587378935794,0.21953260085805681,136573.74223886052,1076.4926243811433,137650.23486324167,2052,39,627.6923076923077,36,3,18,30.190377433024484,0.6857638888888888,38.682432432432435,1045.2702702702707,29.035285285285298,4
4319,4,0,0,39,0.0,0.0,1.0,39,1050,800,250,0.7619047619047619,13,8,5,323.579283791442,0.7239091318038686,0.1324615992288083,0.21877541816722212,136603.17147806604,1040.3912781024424,137643.56275616848,2053,40,628.6923076923077,36,3,18,30.197673166002357,0.6860532407407407,38.65427927927929,1045.3828828828841,29.038413413413448,0
4320,4,0,0,39,0.0,0.0,1.0,39,700,400,300,0.5714285714285714,10,4,6,326.8060510681757,0.7224471434997751,0.1342667384670615,0.22132707397286755,136662.0394676772,1132.3962898709574,137794.43575754817,2054,41,629.6923076923077,36,3,18,30.055196553581045,0.6866319444444444,38.597972972972975,1045.6081081081086,29.044669669669684,0
4321,4,0,0,39,0.0,0.0,1.0,39,750,600,150,0.8,9,6,3,326.8060510681757,0.7224471434997751,0.1342667384670615,0.22132707397286755,136662.0394676772,1132.3962898709574,137794.43575754817,2055,42,630.6923076923077,36,3,18,30.055196553581045,0.6866319444444444,38.597972972972975,1045.6081081081086,29.044669669669684,0
4322,4,0,0,39,0.0,0.0,1.0,39,1300,1000,300,0.7692307692307693,16,10,6,328.52019776580704,0.7224471434997751,0.1418398608926057,0.22342259423457903,136809.26492370758,1188.9213537862279,137998.1862774938,2056,43,631.6923076923077,36,3,19,29.86499820595622,0.6880787037037037,38.45720720720721,1046.1711711711719,29.060310310310328,0
4323,4,0,0,39,0.0,0.0,1.0,39,800,500,300,0.625,11,5,6,328.32865791089125,0.7216599190283401,0.14457884525692077,0.2234799678131937,136838.71952611412,1185.614626450794,138024.3341525649,2057,44,632.6923076923077,36,3,20,29.840930290962582,0.6883680555555556,38.42905405405406,1046.283783783785,29.063438438438475,0
4324,4,1,0,40,0.025,0.0,1.0,40,1000,500,500,0.5,15,5,10,320.76034836381814,0.7263354700854701,0.14618927973199347,0.22010796318758546,137122.57617728526,796.6970606340353,137919.2732379193,2058,0,617.85,37,3,18,29.759038246789512,0.6891891891891893,38.1578947368421,1047.368421052631,28.30725462304408,0
4325,4,0,0,40,0.0,0.0,1.0,40,1050,800,250,0.7619047619047619,13,8,5,320.21949552842057,0.7264690170940171,0.1425860986077674,0.21991781745384617,137151.2884373076,783.7032788935032,137934.99171620113,2059,1,618.85,37,3,18,29.7449099759238,0.6894707207207207,38.13048245614035,1047.4780701754382,28.310218112849682,0
4326,4,0,0,40,0.0,0.0,1.0,40,800,400,400,0.5,12,4,8,322.9746495772711,0.7259348290598291,0.14192130598576824,0.22235920398850145,137237.44325176967,864.8430286241805,138102.28628039386,2060,2,619.85,37,3,18,29.587868006139242,0.6903153153153154,38.04824561403508,1047.8070175438588,28.319108582266455,0
4327,4,0,0,40,0.0,0.0,1.0,40,900,600,300,0.6666666666666666,12,6,6,332.6255022814136,0.7263087606837607,0.14184674289310806,0.22472848428410439,136577.6143260425,1085.8395131194056,137663.4538391619,2061,3,620.85,37,3,17,29.98651613692786,0.6838400900900901,38.67872807017543,1045.2850877192973,28.250948316737766,2
4328,4,0,0,40,0.0,0.0,1.0,40,1250,900,350,0.72,16,9,7,333.4867700512691,0.7254006410256411,0.14033864541832664,0.226230214278023,136720.92013888885,1118.9236111111065,137839.84374999994,2062,4,621.85,37,3,17,29.82237715803452,0.6852477477477478,38.541666666666664,1045.833333333333,28.265765765765757,0
4329,4,0,0,40,0.0,0.0,1.0,40,800,700,100,0.875,9,7,2,333.5803348144637,0.7239850427350427,0.13929769392033586,0.2266635608354684,136778.26350415483,1125.3077870113584,137903.57129116618,2063,5,622.85,37,3,17,29.763277428371765,0.685810810810811,38.48684210526314,1046.052631578945,28.271692745376892,0
4330,4,0,1,39,0.0,0.025,0.975,40,850,600,250,0.7058823529411765,11,6,5,333.18055880996167,0.723530982905983,0.1446059939222475,0.22694804230717067,136864.30109504826,1120.1048639965902,137984.40595904485,2064,6,623.85,37,3,18,29.68875528310456,0.6866554054054055,38.40460526315788,1046.3815789473665,28.28058321479369,0
4331,4,0,0,39,0.0,0.0,1.0,39,1250,1000,250,0.8,15,10,5,336.7687050789011,0.7176113360323887,0.14429080069553657,0.22903230382013118,136809.26492370747,1414.6157982306572,138223.88072193813,2065,7,637.1025641025641,36,3,18,29.649264442052377,0.6880787037037037,38.457207207207205,1046.171171171171,29.060310310310303,0
4332,4,0,0,39,0.0,0.0,1.0,39,850,300,550,0.35294117647058826,14,3,11,337.9589161446604,0.7177237966711651,0.14323321964303437,0.23022831736189045,136868.17729892055,1451.1641709276837,138319.34146984824,2066,8,638.1025641025641,36,3,18,29.55992610130577,0.6886574074074074,38.4009009009009,1046.3963963963965,29.06656656656657,0
4333,4,0,1,38,0.0,0.02564102564102564,0.9743589743589743,39,650,400,250,0.6153846153846154,9,4,5,337.11372052074785,0.7174426450742241,0.13964191409580384,0.2298457670432364,136897.63824212734,1430.0144316614,138327.65267378875,2067,9,639.1025641025641,36,3,18,29.552934108110033,0.6889467592592593,38.37274774774775,1046.5090090090098,29.069694694694718,0
4334,4,0,0,38,0.0,0.0,1.0,38,950,600,350,0.631578947368421,13,6,7,339.27493418239766,0.7195353247984827,0.12641008626410088,0.23135173113704674,136902.54870756174,1689.5206404321023,138592.06934799385,2068,10,630.3421052631579,35,3,19,29.491539482415405,0.6910714285714286,38.36805555555556,1046.5277777777778,29.900793650793652,0
4335,4,0,0,38,0.0,0.0,1.0,38,450,100,350,0.2222222222222222,8,1,7,339.3327348863616,0.7179943100995733,0.12133662329197636,0.23179193763687703,136963.1183556241,1695.213906035661,138658.33226165976,2069,11,631.3421052631579,35,3,14,29.430193129883545,0.6916666666666667,38.31018518518518,1046.7592592592587,29.90740740740739,0
4336,4,0,0,38,0.0,0.0,1.0,38,850,400,450,0.47058823529411764,13,4,9,342.4841564146021,0.7163051209103841,0.1293920235443291,0.23496126849095778,137114.60108292598,1791.9156968021111,138906.5167797281,2070,12,632.3421052631579,35,3,15,29.198092791100304,0.693154761904762,38.16550925925925,1047.337962962962,29.92394179894177,0
4337,4,0,0,38,0.0,0.0,1.0,38,1150,900,250,0.782608695652174,14,9,5,340.0936461545253,0.7157124229492651,0.11737022330486524,0.23413443183550692,137235.84754640344,1734.6079550325794,138970.45550143602,2071,13,633.3421052631579,35,3,16,29.141007584962626,0.6943452380952381,38.04976851851852,1047.8009259259259,29.93716931216931,0
4338,4,0,0,38,0.0,0.0,1.0,38,650,500,150,0.7692307692307693,8,5,3,340.0936461545253,0.7158605974395448,0.11737022330486524,0.23413443183550692,137235.84754640344,1734.6079550325794,138970.45550143602,2072,14,634.3421052631579,35,3,16,29.141007584962626,0.6943452380952381,38.04976851851852,1047.8009259259259,29.93716931216931,0
4339,4,0,0,38,0.0,0.0,1.0,38,750,300,450,0.4,12,3,9,336.1846317248066,0.7158605974395448,0.06933092097991178,0.23023939161349924,137053.99794506596,1615.0895651148771,138669.08751018083,2073,15,635.3421052631579,35,3,16,29.422851958291886,0.6925595238095238,38.223379629629626,1047.106481481481,29.91732804232803,2
4340,4,0,0,38,0.0,0.0,1.0,38,1150,900,250,0.782608695652174,14,9,5,336.72207875802826,0.715801327643433,0.07132591745974226,0.23132856548058958,137162.9293989938,1637.1573431539887,138800.08674214777,2074,16,636.3421052631579,36,2,17,29.30127033612843,0.6915509259259258,38.11936936936938,1047.5225225225242,29.097847847847895,0
4341,4,0,0,38,0.0,0.0,1.0,38,1050,700,350,0.6666666666666666,14,7,7,337.0148066576679,0.7130749170222854,0.06920475878135335,0.23271022406302494,137339.93283824384,1657.1181823715838,138997.0510206154,2075,17,637.3421052631579,36,2,17,29.1189926228334,0.693287037037037,37.95045045045046,1048.1981981981999,29.116616616616664,0
4342,4,0,0,38,0.0,0.0,1.0,38,1050,700,350,0.6666666666666666,14,7,7,334.6737801947594,0.7123340445708867,0.06772691044548318,0.23168383400694476,137428.4773582706,1598.7416047804788,139027.2189630511,2076,18,638.3421052631579,36,2,17,29.09305301972577,0.6941550925925926,37.865990990991,1048.5360360360376,29.126001001001043,0
4343,4,0,0,38,0.0,0.0,1.0,38,1000,700,300,0.7,13,7,6,338.2535838716312,0.7114746325272641,0.06750449238836853,0.2347610939031577,137517.05041189856,1703.1270290561051,139220.17744095466,2077,19,639.3421052631579,36,2,17,28.911897859852555,0.6950231481481481,37.78153153153154,1048.8738738738753,29.135385385385423,0
4344,4,0,0,38,0.0,0.0,1.0,38,350,200,150,0.5714285714285714,5,2,3,343.9840769530544,0.7114746325272641,0.04748283752860405,0.23433284773077598,136868.17729892067,1816.094726483255,138684.27202540392,2078,20,640.3421052631579,36,2,22,29.402308437365466,0.6886574074074074,38.40090090090091,1046.3963963963974,29.066566566566596,2
4345,4,0,0,38,0.0,0.0,1.0,38,850,800,50,0.9411764705882353,9,8,1,344.8184683501332,0.7111190137505927,0.0409828638736931,0.2352968314865005,136927.10235573415,1842.9987419852325,138770.1010977194,2079,21,641.3421052631579,36,2,22,29.322232981852085,0.6892361111111112,38.3445945945946,1046.621621621622,29.07282282282283,0
4346,4,0,0,38,0.0,0.0,1.0,38,450,200,250,0.4444444444444444,7,2,5,340.36212405557114,0.7111782835467046,0.04390870702244931,0.23304028199327712,137044.99051416296,1728.984812515231,138773.9753266782,2080,22,642.3421052631579,36,2,18,29.322390119739012,0.6903935185185185,38.23198198198199,1047.0720720720733,29.08533533533537,0
4347,4,0,0,38,0.0,0.0,1.0,38,950,700,250,0.7368421052631579,12,7,5,342.41785970571766,0.7099928876244666,0.04390114180312099,0.23524157540491772,137162.9293989936,1793.4073431539723,138956.33674214757,2081,23,643.3421052631579,36,2,19,29.152108865476954,0.6915509259259259,38.11936936936937,1047.5225225225229,29.09784784784786,0
4348,4,0,0,38,0.0,0.0,1.0,38,850,500,350,0.5882352941176471,12,5,7,343.0753809971986,0.7094001896633476,0.04201362175860979,0.2360927030175989,137221.91786380985,1815.492350458579,139037.41021426843,2082,24,644.3421052631579,36,2,20,29.076651619375195,0.6921296296296295,38.06306306306307,1047.7477477477485,29.104104104104124,0
4349,4,0,1,37,0.0,0.02631578947368421,0.9736842105263158,38,750,400,350,0.5333333333333333,11,4,7,344.6556643175725,0.7098447131341868,0.04138408891654155,0.23738126990932742,137251.41685181812,1860.895650718293,139112.31250253643,2083,25,645.3421052631579,36,2,20,29.006134694608615,0.6924189814814814,38.03490990990991,1047.860360360361,29.10723223223225,0
4350,4,0,0,37,0.0,0.0,1.0,37,1250,1000,250,0.8,15,10,5,343.4458041503939,0.708958958958959,0.04533565823888397,0.21853589481037833,134427.29768990923,1834.8427854219249,136262.14047533117,2084,26,657.4324324324324,34,3,22,31.840010714422377,0.6688112745098039,40.74404761904761,1037.023809523809,30.500700280112028,4
4351,4,0,0,37,0.0,0.0,1.0,37,600,400,200,0.6666666666666666,8,4,4,350.20442503580165,0.709522022022022,0.04826011383388429,0.22511666909265277,134797.9184382087,2041.3655045351575,136839.28394274384,2085,27,658.4324324324324,34,3,18,31.295139286942565,0.6724877450980392,40.386904761904766,1038.4523809523816,30.542717086834756,3
4352,4,0,1,36,0.0,0.02702702702702703,0.972972972972973,37,650,500,150,0.7692307692307693,8,5,3,350.3882611729529,0.7098348348348348,0.04324448216265764,0.22581151898044216,134890.65334467115,2052.8202947845734,136943.47363945574,2086,28,659.4324324324324,34,3,19,31.19795247918098,0.6734068627450981,40.297619047619044,1038.8095238095234,30.553221288515395,0
4353,4,0,0,36,0.0,0.0,1.0,36,1050,800,250,0.7619047619047619,13,8,5,359.71937881784555,0.7063161375661376,0.04366898413426035,0.23182505905203252,134890.65334467115,2504.5564058956847,137395.20975056684,2087,29,663.9444444444445,34,2,20,30.95562113224844,0.6734068627450981,40.297619047619044,1038.8095238095234,30.553221288515395,0
4354,4,0,0,36,0.0,0.0,1.0,36,850,700,150,0.8235294117647058,10,7,3,360.35894185892414,0.7065806878306878,0.037005218276696006,0.23303211573543756,135014.34948979583,2530.7256235827567,137545.07511337858,2088,30,664.9444444444445,34,2,20,30.815673921344032,0.6746323529411765,40.17857142857142,1039.2857142857138,30.567226890756288,0
4355,4,1,0,37,0.02702702702702703,0.0,1.0,37,750,400,350,0.5333333333333333,11,4,7,351.30996128183335,0.7144644644644644,0.035544945323563226,0.2290011052909642,135302.33417191767,2106.6115558556025,137408.94572777327,2089,0,647.9459459459459,35,2,22,30.76410520265509,0.6752976190476192,39.90162037037036,1040.393518518517,29.72552910052906,0
4356,4,0,0,37,0.0,0.0,1.0,37,650,500,150,0.7692307692307693,8,5,3,350.2232736658334,0.7144019019019019,0.0332742085801041,0.22848383383569207,135332.43982553127,2079.3140217763735,137411.75384730764,2090,1,648.9459459459459,35,2,22,30.762421208750457,0.6755952380952381,39.87268518518517,1040.509259259257,29.728835978835917,0
4357,4,0,0,37,0.0,0.0,1.0,37,750,400,350,0.5333333333333333,11,4,7,349.6267144539712,0.7140265265265265,0.03284601327305947,0.22847699246875766,135392.661179698,2067.378257887493,137460.0394375855,2091,2,649.9459459459459,35,2,23,30.718045670225386,0.6761904761904762,39.8148148148148,1040.740740740739,29.735449735449688,0
4358,4,0,0,37,0.0,0.0,1.0,37,400,100,300,0.25,7,1,6,349.6267144539712,0.7136511511511512,0.03284601327305947,0.22847699246875766,135392.661179698,2067.378257887493,137460.0394375855,2092,3,650.9459459459459,35,2,23,30.718045670225386,0.6761904761904762,39.8148148148148,1040.740740740739,29.735449735449688,0
4359,4,0,0,37,0.0,0.0,1.0,37,900,400,500,0.4444444444444444,14,4,10,351.55747594237835,0.7126501501501501,0.026576276075942484,0.23012430412123347,135452.8959297837,2123.8956404320675,137576.79157021578,2093,4,651.9459459459459,35,2,23,30.607905270180108,0.6767857142857144,39.75694444444443,1040.9722222222204,29.742063492063437,0
4360,4,0,0,37,0.0,0.0,1.0,37,800,400,400,0.5,12,4,8,353.28000000000014,0.711086086086086,0.03308108108108132,0.23242105263157897,135633.68055555547,2183.5744598765336,137817.25501543202,2094,5,652.9459459459459,33,4,24,30.38333333333334,0.6830808080808082,39.58333333333333,1041.666666666666,31.565656565656546,0
4361,4,0,0,37,0.0,0.0,1.0,37,850,600,250,0.7058823529411765,11,6,5,352.8686651060449,0.7112112112112112,0.03435757564197961,0.23256506904896068,135697.51567906578,2176.680243175704,137874.1959222415,2095,6,653.9459459459459,33,4,24,30.33060848427821,0.6837121212121212,39.52205882352941,1041.9117647058824,31.573083778966133,0
4362,4,0,0,37,0.0,0.0,1.0,37,1050,600,450,0.5714285714285714,15,6,9,352.8686651060449,0.7112112112112112,0.03435757564197961,0.23256506904896068,135697.51567906578,2176.680243175704,137874.1959222415,2096,7,654.9459459459459,33,4,24,30.33060848427821,0.6837121212121212,39.52205882352941,1041.9117647058824,31.573083778966133,0
4363,4,0,0,37,0.0,0.0,1.0,37,850,700,150,0.8235294117647058,10,7,3,354.6568534181025,0.7104604604604604,0.0354173552668382,0.23416163675990254,135761.36582083817,2229.7397635524812,137991.10558439064,2097,8,655.9459459459459,33,4,24,30.220582470994046,0.6843434343434343,39.46078431372549,1042.1568627450981,31.580510992275702,0
4364,4,0,0,37,0.0,0.0,1.0,37,750,400,350,0.5333333333333333,11,4,7,371.87349033512777,0.7104604604604604,0.05525028773044882,0.23414159873528423,134040.9208488727,2569.253016760982,136610.17386563367,2098,9,656.9459459459459,35,2,19,31.48972188070489,0.662797619047619,41.11689814814815,1035.532407407408,29.58664021164023,3
4365,4,0,0,37,0.0,0.0,1.0,37,1300,1000,300,0.7692307692307693,16,10,6,372.8380366551219,0.70995995995996,0.05861792102578356,0.23609559973196342,134250.74615269207,2610.75692301098,136861.50307570305,2099,10,657.9459459459459,35,2,19,31.25465341374433,0.6648809523809524,40.914351851851855,1036.3425925925928,29.609788359788368,0
4366,4,0,0,37,0.0,0.0,1.0,37,1150,900,250,0.782608695652174,14,9,5,369.0318158102401,0.711086086086086,0.06556724172263384,0.23445297915093127,134370.720003858,2517.4141589506103,136888.13416280862,2100,11,658.9459459459459,35,2,19,31.23325519089083,0.6660714285714285,40.79861111111111,1036.8055555555552,29.623015873015863,0
4367,4,0,0,37,0.0,0.0,1.0,37,1250,700,550,0.56,18,7,11,372.70197415000774,0.7103353353353353,0.06219745021218137,0.23736903982645483,134460.73555652009,2622.756317515437,137083.49187403554,2101,12,659.9459459459459,35,2,19,31.048083361232006,0.6669642857142857,40.71180555555556,1037.1527777777778,29.63293650793651,0
4368,4,0,0,37,0.0,0.0,1.0,37,1100,500,600,0.45454545454545453,17,5,12,354.5348593084665,0.7108358358358359,0.06678372107606445,0.20932126624924507,131633.36167800435,1933.78335419814,133567.1450322025,2102,13,660.9459459459459,34,3,17,34.35687354988399,0.6409313725490197,43.45238095238094,1026.1904761904748,30.182072829131613,5
4369,4,0,1,36,0.0,0.02702702702702703,0.972972972972973,37,750,400,350,0.5333333333333333,11,4,7,357.2593992858645,0.7113363363363363,0.07094398746572694,0.21177747895811538,131786.11288265296,2016.3655045351377,133802.4783871881,2103,14,661.9459459459459,34,3,17,34.13285024154589,0.6424632352941178,43.30357142857142,1026.7857142857135,30.199579831932752,0
4370,4,0,0,36,0.0,0.0,1.0,36,1150,1000,150,0.8695652173913043,13,10,3,366.78224681607253,0.7033399470899472,0.07407407407407396,0.21696102396408362,131705.23356401385,2461.4282968089205,134166.66186082276,2104,46,680.9444444444445,33,3,17,33.97007322508755,0.6439393939393939,43.38235294117647,1026.4705882352941,31.10516934046346,0
4371,4,0,0,36,0.0,0.0,1.0,36,750,500,250,0.6666666666666666,10,5,5,368.0239021276904,0.7037698412698413,0.08078065534205936,0.21823582986043283,131799.59518274214,2501.080263600536,134300.67544634268,2105,47,681.9444444444445,33,3,17,33.8429158212993,0.6448863636363636,43.29044117647059,1026.838235294117,31.11631016042779,0
4372,4,0,0,36,0.0,0.0,1.0,36,900,600,300,0.6666666666666666,12,6,6,366.02780269863615,0.7029100529100529,0.07529457765053671,0.21777225479224027,131925.46323829767,2457.677485822753,134383.14072412043,2106,48,682.9444444444445,33,3,17,33.76712294723449,0.6461489898989898,43.16789215686274,1027.3284313725483,31.131164587046918,0
4373,4,0,0,36,0.0,0.0,1.0,36,700,600,100,0.8571428571428571,8,6,2,365.8333667181399,0.7030092592592593,0.07437446988973706,0.21783714109125604,131956.93963860048,2454.8502979623136,134411.7899365628,2107,49,683.9444444444445,33,3,18,33.74035861959286,0.6464646464646465,43.13725490196078,1027.4509803921565,31.13487819370171,0
4374,4,0,0,36,0.0,0.0,1.0,36,850,800,50,0.9411764705882353,9,8,1,367.0586771167395,0.7030753968253969,0.07929220658769887,0.21892987669281486,132019.9037029027,2491.8102412533535,134511.71394415604,2108,50,684.9444444444445,33,3,18,33.64536131647983,0.6470959595959596,43.07598039215686,1027.6960784313721,31.14230540701128,0
4375,4,0,0,36,0.0,0.0,1.0,36,750,400,350,0.5333333333333333,11,4,7,368.32698780869504,0.7037037037037037,0.07945921246076226,0.2202348610639446,132114.37795859764,2532.258175941946,134646.63613453959,2109,51,685.9444444444445,33,3,18,33.51747824532124,0.6480429292929293,42.98406862745098,1028.063725490196,31.153446226975635,0
4376,4,0,0,36,0.0,0.0,1.0,36,800,500,300,0.625,11,5,6,367.47992060831103,0.7042989417989418,0.08032084640951354,0.220094504912515,132177.3795685552,2514.5065900134396,134691.88615856864,2110,52,686.9444444444445,33,3,19,33.47572299686173,0.6486742424242424,42.92279411764705,1028.3088235294103,31.16087344028516,0
4377,4,0,0,36,0.0,0.0,1.0,36,1300,1200,100,0.9230769230769231,14,12,2,370.6034385120891,0.7043320105820107,0.08404795934572085,0.22289301359222763,132334.9492983467,2608.757449058047,134943.70674740477,2111,53,687.9444444444445,33,3,19,33.236561060822616,0.6502525252525253,42.76960784313725,1028.9215686274504,31.179441473559102,0
4378,4,0,0,36,0.0,0.0,1.0,36,600,400,200,0.6666666666666666,8,4,4,391.35149465451843,0.7052910052910053,0.1005201266395297,0.22710712721289747,130972.46334876529,3051.2538580246755,134023.71720678997,2112,54,688.9444444444445,35,1,14,34.08242876526458,0.6321428571428572,44.097222222222214,1023.6111111111101,29.246031746031715,8
4379,4,1,0,37,0.02702702702702703,0.0,1.0,37,1100,1000,100,0.9090909090909091,12,10,2,384.6916517945667,0.7188438438438438,0.10107668644254009,0.22531939605110338,131328.125,2705.1311728395053,134033.2561728395,2113,0,671.2972972972973,34,3,17,33.892276422764226,0.6378676470588236,43.75,1025.0,30.147058823529413,0
4380,4,0,0,37,0.0,0.0,1.0,37,650,400,250,0.6153846153846154,9,4,5,384.6916517945667,0.7189064064064064,0.10107668644254009,0.22531939605110338,131328.125,2704.166666666666,134032.29166666666,2114,1,672.2972972972973,34,3,17,33.892276422764226,0.6378676470588236,43.75,1025.0,30.147058823529413,0
4381,4,0,0,37,0.0,0.0,1.0,37,500,300,200,0.6,7,3,4,383.228548576356,0.7203453453453453,0.09569588162576337,0.2251794486655341,131450.17715419497,2675.0921201814035,134125.26927437636,2115,2,673.2972972972973,34,3,17,33.806158579057346,0.639093137254902,43.63095238095238,1025.4761904761904,30.161064425770306,0
4382,4,0,0,37,0.0,0.0,1.0,37,1050,800,250,0.7619047619047619,13,8,5,384.9116635692262,0.7217217217217217,0.09449110284570983,0.22689252507794738,131572.28599773237,2728.741496598634,134301.027494331,2116,3,674.2972972972973,34,3,15,33.63937881952502,0.6403186274509804,43.51190476190476,1025.9523809523805,30.17507002801119,0
4383,4,1,0,38,0.02631578947368421,0.0,1.0,38,550,200,350,0.36363636363636365,9,2,7,375.38602280202036,0.7369013750592698,0.09830236020570982,0.22279599868376768,131832.8045294282,2297.6384334276468,134130.44296285583,2117,0,657.5263157894736,35,3,16,33.62036984860438,0.6407738095238095,43.258101851851855,1026.9675925925928,29.341931216931226,0
4384,4,1,1,38,0.02564102564102564,0.02564102564102564,0.9743589743589743,39,1300,900,400,0.6923076923076923,17,9,8,364.78343903950963,0.739484930274404,0.09149567033929684,0.21858283236934414,132195.261139518,1844.5283966398933,134039.78953615788,2118,0,641.6410256410256,36,3,17,33.52702036793692,0.642361111111111,42.90540540540541,1028.3783783783792,28.56606606606609,0
4385,4,0,0,38,0.0,0.0,1.0,38,800,600,200,0.75,10,6,4,372.58608902575907,0.7283665244191561,0.10060803963517628,0.2225243481262787,132070.63567654742,2241.536324374133,134312.17200092156,2119,1,659.3947368421053,35,3,17,33.45214972037683,0.643154761904762,43.02662037037037,1027.893518518518,29.36838624338623,0
4386,4,0,0,38,0.0,0.0,1.0,38,1200,800,400,0.6666666666666666,16,8,8,370.8005341813691,0.7288110478899953,0.10133281995083365,0.22215527621048295,132189.63162562152,2203.1972040037645,134392.82882962527,2120,2,660.3947368421053,35,3,18,33.37800131307448,0.6443452380952381,42.910879629629626,1028.356481481481,29.381613756613746,0
4387,4,0,0,38,0.0,0.0,1.0,38,1000,900,100,0.9,11,9,2,368.3622224387306,0.728959222380275,0.10650050322657023,0.2215656398836478,132338.45191400888,2149.697252229078,134488.14916623797,2121,3,661.3947368421053,35,3,20,33.29068241469817,0.6458333333333334,42.7662037037037,1028.935185185185,29.39814814814814,0
4388,4,0,0,38,0.0,0.0,1.0,38,500,300,200,0.6,7,3,4,368.43998166102773,0.7278923660502608,0.10604070912672303,0.22179213125286376,132369.0307706355,2154.0086539241897,134523.03942455968,2122,4,662.3947368421053,36,2,20,33.25787006638944,0.6440972222222223,42.736486486486484,1029.054054054054,28.584834834834833,0
4389,4,0,0,38,0.0,0.0,1.0,38,1100,800,300,0.7272727272727273,14,8,6,369.7199614409191,0.7278627311522048,0.10822131768269583,0.22343945495777298,132517.14677640607,2198.8500496868296,134715.9968260929,2123,5,663.3947368421053,35,3,21,33.07572691846523,0.6476190476190475,42.592592592592595,1029.62962962963,29.41798941798943,0
4390,4,0,0,38,0.0,0.0,1.0,38,1000,600,400,0.6,14,6,8,367.2390112163952,0.7273589378852536,0.10681960723389272,0.22260670878703584,132629.89921932077,2141.3746094067133,134771.27382872748,2124,6,664.3947368421053,36,2,16,33.02608323311833,0.6467013888888888,42.48310810810811,1030.0675675675684,28.61298798798801,0
4391,4,0,0,38,0.0,0.0,1.0,38,700,400,300,0.5714285714285714,10,4,6,368.0055843096349,0.7281590801327643,0.10444618323245813,0.22324370591939938,132658.90045450864,2163.843235127037,134822.74368963568,2125,7,665.3947368421053,36,2,16,32.97715347616967,0.6469907407407407,42.454954954954964,1030.180180180181,28.61611611611614,0
4392,4,0,0,38,0.0,0.0,1.0,38,1250,900,350,0.72,16,9,7,367.7753987354753,0.7290184921763869,0.10109713812554966,0.2239686110862147,132803.95418645005,2168.4054409138944,134972.35962736394,2126,8,666.3947368421053,36,2,16,32.83713900724716,0.6484375,42.31418918918919,1030.7432432432438,28.631756756756772,0
4393,4,0,1,37,0.0,0.02631578947368421,0.9736842105263158,38,800,600,200,0.75,10,6,4,367.50613838063026,0.7285146989094358,0.09851316076952266,0.22397810857099137,132832.97444403867,2163.3866975083233,134996.361141547,2127,9,667.3947368421053,36,2,16,32.814889665719896,0.6487268518518519,42.28603603603604,1030.8558558558561,28.634884884884894,0
4394,4,0,0,37,0.0,0.0,1.0,37,850,600,250,0.7058823529411765,11,6,5,375.6874768419292,0.7272272272272272,0.11451883149996367,0.2284918916530424,132755.59413580256,2574.9228395061796,135330.51697530874,2128,10,683.3513513513514,35,2,16,32.68194070080863,0.6499999999999999,42.361111111111114,1030.555555555556,29.44444444444446,0
4395,4,0,0,37,0.0,0.0,1.0,37,750,400,350,0.5333333333333333,11,4,7,378.6024842278367,0.7289164164164164,0.11636063544460518,0.23099937873298432,132874.89819101518,2661.353309327854,135536.25150034303,2129,11,684.3513513513514,35,2,17,32.48671606046999,0.6511904761904761,42.245370370370374,1031.0185185185192,29.457671957671977,0
4396,4,2,2,37,0.05128205128205128,0.05128205128205128,0.9487179487179487,39,900,700,200,0.7777777777777778,11,7,4,362.8499691220288,0.7417903733693207,0.10662529261255393,0.22428128012660845,133358.94217451525,1877.8576100338596,135236.7997845491,2130,0,650.2051282051282,37,2,18,32.40667020523708,0.652027027027027,41.776315789473685,1032.8947368421054,27.916073968705554,0
4397,4,0,0,37,0.0,0.0,1.0,37,500,400,100,0.8,6,4,2,375.8991053884416,0.7313563563563563,0.1321355226740799,0.22034006462113984,131357.78523930453,2475.4547914523073,133833.24003075683,2131,13,686.3513513513514,35,2,17,34.08756256821345,0.6360119047619048,43.7210648148148,1025.1157407407393,29.289021164021122,4
4398,4,0,0,37,0.0,0.0,1.0,37,750,400,350,0.5333333333333333,11,4,7,374.3463178016477,0.7314814814814815,0.13661443861195544,0.22011166038755156,131476.4596863212,2443.5457122342295,133920.00539855543,2132,14,687.3513513513514,35,2,18,34.00728379039235,0.637202380952381,43.605324074074076,1025.5787037037042,29.30224867724869,0
4399,4,0,0,37,0.0,0.0,1.0,37,750,600,150,0.8,9,6,3,376.60336519879434,0.7298548548548548,0.13143092330909623,0.22212833216815103,131595.1877170138,2511.83810763888,134107.02582465266,2133,15,688.3513513513514,35,2,16,33.829314720812185,0.6383928571428572,43.48958333333333,1026.0416666666658,29.315476190476165,0
4400,4,0,0,37,0.0,0.0,1.0,37,1050,800,250,0.7619047619047619,13,8,5,379.3221913054728,0.7288538538538538,0.1322425391445352,0.22408060428418558,131654.57182623877,2587.900136102522,134242.47196234128,2134,16,689.3513513513514,35,2,17,33.699508477124915,0.6389880952380953,43.431712962962955,1026.2731481481474,29.322089947089925,0
4401,4,0,0,37,0.0,0.0,1.0,37,900,700,200,0.7777777777777778,11,7,4,378.04662065998906,0.7296046046046046,0.12427739499562707,0.22367548223038308,131713.9693313828,2558.8041998885387,134272.77353127135,2135,17,690.3513513513514,35,2,17,33.67217743450972,0.6395833333333334,43.37384259259259,1026.504629629629,29.328703703703688,0
4402,4,1,1,37,0.02631578947368421,0.02631578947368421,0.9736842105263158,38,900,700,200,0.7777777777777778,11,7,4,368.65408325878417,0.7410798956851589,0.1185522423347729,0.22005924250509648,132050.5402995902,2136.194175594521,134186.73447518473,2136,0,673.1578947368421,36,2,18,33.573463350498514,0.6409143518518519,43.046171171171174,1027.815315315316,28.550425425425445,0
4403,4,0,0,37,0.0,0.0,1.0,37,1100,900,200,0.8181818181818182,13,9,4,376.5850298164427,0.7296671671671672,0.12240722019901851,0.2240327563438836,131921.96609224952,2535.9675068587003,134457.93359910822,2137,19,692.3513513513514,35,2,18,33.499511792098545,0.6416666666666667,43.17129629629629,1027.3148148148139,29.351851851851826,0
4404,4,0,0,37,0.0,0.0,1.0,37,1100,900,200,0.8181818181818182,13,9,4,372.1534831241565,0.726539039039039,0.12331043044846224,0.2224405946910335,132100.3796403464,2432.3232810356635,134532.70292138206,2138,20,693.3513513513514,35,2,18,33.43325452225473,0.6434523809523809,42.99768518518518,1028.0092592592594,29.371693121693124,0
4405,4,1,0,38,0.02631578947368421,0.0,1.0,38,1050,600,450,0.5714285714285714,15,6,9,364.2373058199095,0.7299371740161213,0.1362463988452638,0.22030042895171545,132546.94097490137,2056.043033050407,134602.98400795177,2139,0,676.078947368421,35,3,19,33.1868654228017,0.6479166666666667,42.563657407407405,1029.74537037037,29.421296296296287,0
4406,4,0,0,38,0.0,0.0,1.0,38,750,400,350,0.5333333333333333,11,4,7,363.09794777385673,0.7304113323850167,0.13914459300853754,0.2202665799890746,132658.9004545087,2033.634901793705,134692.5353563024,2140,1,677.078947368421,36,2,17,33.10354722343681,0.6469907407407407,42.454954954954964,1030.1801801801814,28.61611611611615,0
4407,4,0,0,38,0.0,0.0,1.0,38,1000,600,400,0.6,14,6,8,361.09387107486566,0.7284257942152679,0.14180503712565162,0.2195594693824651,132745.92318247317,1986.7478542732106,134732.67103674638,2141,2,678.078947368421,36,2,17,33.06765198703238,0.6478587962962963,42.370495495495504,1030.5180180180193,28.625500500500536,0
4408,4,0,0,38,0.0,0.0,1.0,38,1200,700,500,0.5833333333333334,17,7,10,360.0820571193435,0.727151493598862,0.1358844358602933,0.21979408766564743,132891.02447041642,1970.3346928009182,134861.35916321733,2142,3,679.078947368421,36,2,18,32.947884811416934,0.6493055555555556,42.22972972972973,1031.0810810810815,28.64114114114115,0
4409,4,1,0,39,0.02564102564102564,0.0,1.0,39,850,500,350,0.5882352941176471,12,5,7,351.58887389059214,0.7370670265407108,0.13476927434862462,0.21633056593503483,133189.11227493064,1565.5619998460961,134754.67427477674,2143,0,662.6410256410256,37,2,19,32.86771475107996,0.6503378378378378,41.940789473684205,1032.2368421052624,27.898293029871958,0
4410,4,0,0,39,0.0,0.0,1.0,39,950,700,250,0.7368421052631579,12,7,5,352.2408197673289,0.7375730994152047,0.13421572231981171,0.21689648908498355,133217.40974386342,1584.921923091713,134802.33166695514,2144,1,663.6410256410256,37,2,19,32.82251283412994,0.6506193693693694,41.91337719298245,1032.3464912280697,27.90125651967756,0
4411,4,0,1,38,0.0,0.02564102564102564,0.9743589743589743,39,800,500,300,0.625,11,5,6,354.14218585602185,0.7378542510121457,0.1304866295310123,0.2185656033022291,133302.32018505692,1641.5950100030766,134943.91519506,2145,2,664.6410256410256,37,2,19,32.688291923267506,0.651463963963964,41.83114035087719,1032.6754385964912,27.910146989094358,0
4412,4,0,0,38,0.0,0.0,1.0,38,750,400,350,0.5333333333333333,11,4,7,360.2602516706087,0.7347083926031295,0.13210141640782425,0.22179353438982352,133210.52629910325,1998.091545937841,135208.6178450411,2146,3,682.421052631579,36,2,19,32.622450092723895,0.6524884259259258,41.92004504504505,1032.3198198198206,28.67555055055057,0
4413,4,0,0,38,0.0,0.0,1.0,38,1500,1100,400,0.7333333333333333,19,11,8,362.84997805905357,0.73316737790422,0.13504411781579506,0.22461441961631276,133414.04537983923,2081.8566877688413,135495.90206760805,2147,4,683.421052631579,36,2,19,32.35139161398155,0.654513888888889,41.72297297297297,1033.1081081081074,28.69744744744743,0
4414,4,0,0,38,0.0,0.0,1.0,38,1000,600,400,0.6,14,6,8,361.6491034253679,0.7315967283072546,0.13034212648312393,0.2244085680368562,133502.97796201808,2056.2718201171338,135559.24978213522,2148,5,684.421052631579,34,4,20,32.29322658679876,0.6596200980392157,41.63690476190476,1033.4523809523805,30.395658263305307,0
4415,4,0,0,38,0.0,0.0,1.0,38,900,600,300,0.6666666666666666,12,6,6,361.73976333443704,0.730766951161688,0.13282125867345362,0.22521217523724615,133626.0363520408,2067.5701530612173,135693.606505102,2149,6,685.421052631579,34,4,20,32.16753022452504,0.6608455882352942,41.51785714285714,1033.928571428571,30.409663865546207,0
4416,4,0,0,38,0.0,0.0,1.0,38,1600,1300,300,0.8125,19,13,6,367.0435853652184,0.7290777619724989,0.13519388669556998,0.22985178991314678,133841.52494331056,2225.134637188196,136066.65958049876,2150,7,686.421052631579,34,4,18,31.814455821445005,0.6629901960784315,41.3095238095238,1034.761904761904,30.43417366946776,0
4417,4,1,1,38,0.02564102564102564,0.02564102564102564,0.9743589743589743,39,1150,900,250,0.782608695652174,14,9,5,358.53505347241486,0.7388663967611336,0.1313113946104556,0.22592758158247644,134070.88584533596,1813.8224451302985,135884.70829046625,2151,0,669.7948717948718,35,4,19,31.805058858590364,0.6630952380952382,41.087962962962955,1035.6481481481471,29.58994708994706,0
4418,4,0,0,38,0.0,0.0,1.0,38,1200,900,300,0.75,15,9,6,368.94978672663876,0.7270625889046942,0.13544509048226971,0.23240363466582376,134057.18714569142,2292.0741213151746,136349.2612670066,2152,9,688.421052631579,34,4,19,31.549124420431475,0.6651348039215687,41.10119047619047,1035.5952380952367,30.458683473389314,0
4419,4,0,0,38,0.0,0.0,1.0,38,1000,600,400,0.6,14,6,8,368.7370556474517,0.7282183499288762,0.13323728315201389,0.2327360118508245,134130.82588520227,2291.801161694093,136422.62704689638,2153,10,689.421052631579,35,3,19,31.480912476722526,0.6636904761904763,41.03009259259259,1035.879629629629,29.59656084656083,0
4420,4,0,0,38,0.0,0.0,1.0,38,1000,800,200,0.8,12,8,4,369.40207588909317,0.7273293029871978,0.1329721880933763,0.2337283947303921,134220.76106234986,2316.285552769192,136537.04661511906,2154,11,690.421052631579,35,3,19,31.373678282884693,0.6645833333333333,40.94328703703703,1036.226851851851,29.60648148148146,0
4421,4,0,0,38,0.0,0.0,1.0,38,1050,800,250,0.7619047619047619,13,8,5,369.1522941339865,0.7278627311522048,0.12898704046548537,0.23395320551803603,134280.73459201385,2314.0082465277724,136594.74283854163,2155,12,691.421052631579,35,3,19,31.320142378559463,0.6651785714285714,40.885416666666664,1036.458333333333,29.61309523809523,0
4422,4,1,0,39,0.02564102564102564,0.0,1.0,39,1500,1300,200,0.8666666666666667,17,13,4,348.00534036689356,0.7387539361223572,0.10179346278931378,0.21386379187123244,133143.52823055943,1467.2030392660724,134610.7312698255,2156,0,674.6666666666666,35,4,16,33.00589230309148,0.6538690476190478,41.98495370370368,1032.060185185182,29.48743386243377,3
4423,4,0,0,39,0.0,0.0,1.0,39,950,600,350,0.631578947368421,13,6,7,360.4316667687549,0.7377980206927576,0.07372393829467616,0.21031731062189601,131183.87972009153,1656.5648841408797,132840.4446042324,2157,1,675.6666666666666,36,3,19,34.65977794877433,0.6322337962962965,43.89076576576576,1024.4369369369356,28.456581581581545,7
4424,4,0,0,39,0.0,0.0,1.0,39,1250,1000,250,0.8,15,10,5,341.79131146949305,0.7386414754835807,0.044033874676516094,0.201197938774899,131519.83486969463,1190.4673688728158,132710.30223856744,2158,2,676.6666666666666,38,1,20,34.79824150262125,0.6318530701754386,43.56303418803419,1025.747863247863,26.993364822312184,7
4425,4,0,0,39,0.0,0.0,1.0,39,450,200,250,0.4444444444444444,7,2,5,339.2382928742902,0.7397660818713451,0.04866562009419195,0.20012558751625797,131602.03904594915,1128.8902129446856,132730.92925889383,2159,3,677.6666666666666,38,1,14,34.78086387616271,0.6326754385964912,43.482905982905976,1026.0683760683748,27.00179937022039,0
4426,4,1,0,40,0.025,0.0,1.0,40,950,700,250,0.7368421052631579,12,7,5,331.9479164195318,0.7460202991452991,0.05628485954771345,0.19730792066383365,131889.27001953122,756.073676215277,132645.3436957465,2160,0,661.7,39,1,15,34.678806240070315,0.6338141025641026,43.203125,1027.1874999999998,26.33814102564102,0
4427,4,1,2,39,0.024390243902439025,0.04878048780487805,0.9512195121951219,41,800,600,200,0.75,10,6,4,328.63134029297174,0.7563008130081301,0.05504379250573166,0.19661521405937293,132136.65729930927,484.84935802101654,132621.5066573303,2161,0,646.5365853658536,40,1,16,34.51533722117888,0.6346354166666668,42.96239837398374,1028.150406504065,25.703760162601622,0
4428,4,1,0,40,0.025,0.0,1.0,40,900,700,200,0.7777777777777778,11,7,4,329.5802243429144,0.744150641025641,0.06182504305541503,0.19728844114547642,132156.90239800338,711.2603081597126,132868.1627061631,2162,0,663.55,39,1,17,34.470608347685136,0.6364850427350428,42.94270833333333,1028.2291666666658,26.364850427350405,0
4429,4,1,1,40,0.024390243902439025,0.024390243902439025,0.975609756097561,41,700,500,200,0.7142857142857143,9,5,4,323.30639495053964,0.7491361788617886,0.0689572147449018,0.19517841363819802,132476.45767235098,366.09718917309755,132842.55486152408,2163,0,648.3414634146342,40,1,18,34.31124547548535,0.6380208333333335,42.632113821138205,1029.471544715446,25.736788617886152,0
4430,4,0,0,40,0.0,0.0,1.0,40,1500,1100,400,0.7333333333333333,19,11,8,326.4367338130105,0.7430555555555556,0.08275844628767981,0.19750021728735734,132558.8595920138,654.4162326388787,133213.27582465266,2164,1,665.05,39,1,19,34.148037628970265,0.6404914529914532,42.55208333333333,1029.7916666666658,26.40491452991451,0
4431,4,0,0,40,0.0,0.0,1.0,40,1500,1200,300,0.8,18,12,6,323.6653499486533,0.7425480769230769,0.08015114750783536,0.19652387822849166,132692.98095703125,589.6240234374997,133282.60498046875,2165,2,666.05,39,1,15,34.08496360327571,0.6418269230769231,42.421875,1030.3125,26.41826923076923,0
4432,4,0,0,40,0.0,0.0,1.0,40,1000,800,200,0.8,12,8,4,324.70041039811383,0.7430822649572649,0.08033097524001986,0.19771757297780537,132800.3268771702,624.0641276041708,133424.39100477437,2166,3,667.05,39,1,16,33.950753747684004,0.6428952991452992,42.317708333333336,1030.7291666666672,26.428952991453006,0
4433,4,0,0,40,0.0,0.0,1.0,40,1150,900,250,0.782608695652174,14,9,5,323.10125004690207,0.7426282051282052,0.08329460497070151,0.19716745825920062,132880.86480034713,586.7947048611011,133467.65950520823,2167,4,668.05,39,1,16,33.9113120495723,0.6436965811965812,42.23958333333333,1031.0416666666658,26.43696581196579,0
4434,4,0,1,39,0.0,0.025,0.975,40,950,700,250,0.7368421052631579,12,7,5,321.7551160794463,0.741693376068376,0.08241844258155773,0.1967694505437057,132961.4271375867,556.2038845486011,133517.6310221353,2168,5,669.05,39,1,17,33.865371342961986,0.6444978632478633,42.16145833333333,1031.3541666666658,26.444978632478612,0
4435,4,0,1,38,0.0,0.02564102564102564,0.9743589743589743,39,1150,800,350,0.6956521739130435,15,8,7,329.4437129040463,0.7316689158794423,0.08736332047562878,0.20125257702214291,132920.79863393982,957.9842848272585,133878.78291876707,2169,6,687.0512820512821,38,1,18,33.7078239397707,0.6458333333333333,42.20085470085471,1031.1965811965827,27.136752136752175,0
4436,4,0,0,38,0.0,0.0,1.0,38,900,600,300,0.6666666666666666,12,6,6,335.86747441706666,0.7211059743954481,0.08634780953660459,0.2047876779811454,132849.77709487543,1323.983821945223,134173.76091682067,2170,7,705.8947368421053,37,1,18,33.61341558533645,0.6469594594594594,42.26973684210527,1030.9210526315796,27.862731152204855,0
4437,4,0,0,38,0.0,0.0,1.0,38,1100,900,200,0.8181818181818182,13,9,4,333.3149623461827,0.7224099099099099,0.08633347135646874,0.20384658880547432,132962.84072983998,1263.7008502616222,134226.5415801016,2171,8,706.8947368421053,37,1,18,33.56589765397972,0.6480855855855856,42.16008771929825,1031.3596491228072,27.874585111427223,0
4438,4,0,0,38,0.0,0.0,1.0,38,1050,700,350,0.6666666666666666,14,7,7,332.41068883234385,0.7216097676623993,0.08659564825745703,0.20344745282016002,132991.11415291246,1241.533572830107,134232.64772574257,2172,9,707.8947368421053,37,1,18,33.560889940115516,0.648367117117117,42.13267543859649,1031.4692982456143,27.877548601232817,0
4439,4,0,0,38,0.0,0.0,1.0,38,650,400,250,0.6153846153846154,9,4,5,342.8907749839742,0.7195056899004267,0.09040366601522987,0.20442572157441544,132003.33275623288,1452.5450138504357,133455.87777008332,2173,10,708.8947368421053,37,1,16,34.28297055057619,0.6385135135135134,43.092105263157904,1027.63157894737,27.773826458037025,4
4440,4,1,2,37,0.02564102564102564,0.05128205128205128,0.9487179487179487,39,650,400,250,0.6153846153846154,9,4,5,333.8506958222699,0.7266081871345029,0.08333067016074902,0.20039367203097389,132260.59701219984,1031.058468478367,133291.6554806782,2174,0,691.6923076923077,38,1,16,34.256638623459345,0.6392543859649121,42.841880341880355,1028.6324786324808,27.069275753486338,0
4441,4,0,0,37,0.0,0.0,1.0,37,750,500,250,0.6666666666666666,10,5,5,347.9669942354747,0.7119619619619619,0.0974820974820978,0.2075520777381011,132021.60564280517,1787.832257933635,133809.4379007388,2175,12,729.1351351351351,36,1,16,34.134158813645996,0.6406249999999998,43.07432432432434,1027.7027027027043,28.54729729729734,0
4442,4,0,0,37,0.0,0.0,1.0,37,900,700,200,0.7777777777777778,11,7,4,347.9669942354747,0.7119619619619619,0.0974820974820978,0.2075520777381011,132021.60564280517,1787.832257933635,133809.4379007388,2176,13,730.1351351351351,36,1,16,34.134158813645996,0.6406249999999998,43.07432432432434,1027.7027027027043,28.54729729729734,0
4443,4,0,0,37,0.0,0.0,1.0,37,800,700,100,0.875,9,7,2,349.80331562234164,0.7111486486486487,0.09768804949527787,0.20928599420917324,132137.36329234662,1844.4175594513645,133981.780851798,2177,14,731.1351351351351,36,1,18,33.97042716319826,0.6417824074074073,42.96171171171172,1028.1531531531548,28.559809809809856,0
4444,4,0,0,37,0.0,0.0,1.0,37,1150,900,250,0.782608695652174,14,9,5,346.70174724957894,0.7122122122122122,0.10062360959909156,0.2083859975573787,132311.0948786626,1774.4975549874398,134085.59243365005,2178,15,732.1351351351351,36,1,18,33.87537397840047,0.6435185185185184,42.7927927927928,1028.8288288288302,28.578578578578615,0
4445,4,0,0,37,0.0,0.0,1.0,37,700,500,200,0.7142857142857143,9,5,4,347.1269861731026,0.7117117117117117,0.10094467415544206,0.20896221341566634,132369.0307706357,1789.7725428131075,134158.8033134488,2179,16,733.1351351351351,36,1,18,33.80617567666157,0.6440972222222221,42.7364864864865,1029.0540540540558,28.584834834834883,0
4446,4,0,0,37,0.0,0.0,1.0,37,1300,1000,300,0.7692307692307693,16,10,6,347.43611624187815,0.7123998998998999,0.10101300560419357,0.2096496927525133,132459.2704790247,1804.2332398932037,134263.5037189179,2180,17,734.1351351351351,34,3,19,33.707499710882395,0.6492034313725491,42.64880952380951,1029.40476190476,30.27661064425765,0
4447,4,0,0,37,0.0,0.0,1.0,37,500,400,100,0.8,6,4,2,350.12792760225324,0.7129004004004004,0.10157712342936076,0.21161820026777686,132520.55165816317,1879.8292233559964,134400.38088151917,2181,18,735.1351351351351,34,3,19,33.576617720738426,0.6498161764705883,42.58928571428571,1029.6428571428564,30.28361344537813,0
4448,4,1,2,36,0.02631578947368421,0.05263157894736842,0.9473684210526316,38,900,700,200,0.7777777777777778,11,7,4,340.1591958501549,0.7229137031768611,0.09995746246349779,0.2076331731469345,132891.02447041633,1440.8208039120125,134331.84527432834,2182,0,716.7631578947369,36,2,15,33.46143694480849,0.6493055555555556,42.229729729729726,1031.0810810810808,28.641141141141134,0
4449,4,0,0,36,0.0,0.0,1.0,36,850,500,350,0.5882352941176471,12,5,7,356.37975573986375,0.705191798941799,0.11726646887321968,0.21574816423411897,132581.84700963704,2249.8972505668794,134831.74426020394,2183,66,757.0555555555555,34,2,20,33.354043848495344,0.6504289215686274,42.5297619047619,1029.8809523809514,30.29061624649857,0
4450,4,1,0,37,0.02702702702702703,0.0,1.0,37,650,500,150,0.7692307692307693,8,5,3,343.91633749764645,0.7210335335335335,0.10782351747961672,0.21305629041231738,133442.32420535426,1778.5990815758084,135220.92328693008,2184,0,737.5675675675676,35,2,21,32.81209159478735,0.656845238095238,41.69560185185186,1033.217592592594,29.520502645502685,2
4451,4,0,0,37,0.0,0.0,1.0,37,700,300,400,0.42857142857142855,11,3,8,342.9307123999045,0.7193443443443444,0.10093165711942409,0.2133453901036576,133598.88624567486,1763.0389451721646,135361.92519084702,2185,1,738.5675675675676,33,4,22,32.68087166113482,0.6628787878787877,41.54411764705883,1033.8235294117658,31.327985739750478,0
4452,4,0,0,37,0.0,0.0,1.0,37,1000,600,400,0.6,14,6,8,341.5231983643218,0.7170295295295295,0.10549559916648499,0.21351342401337864,133779.9390589572,1737.7905328798508,135517.72959183707,2186,2,739.5675675675676,34,3,17,32.536200613732255,0.6623774509803919,41.369047619047635,1034.523809523812,30.42717086834741,0
4453,4,0,1,36,0.0,0.02702702702702703,0.972972972972973,37,1000,700,300,0.7,13,7,6,341.5231983643218,0.7168418418418419,0.10549559916648499,0.21351342401337864,133779.9390589572,1737.7905328798508,135517.72959183707,2187,3,740.5675675675676,34,3,17,32.536200613732255,0.6623774509803919,41.369047619047635,1034.523809523812,30.42717086834741,0
4454,4,0,1,35,0.0,0.027777777777777776,0.9722222222222222,36,1000,800,200,0.8,12,8,4,337.24783915221605,0.7183531746031746,0.10315813739050261,0.2072528588366857,133143.5282305598,1780.4734385716717,134924.00166913148,2188,4,735.0833333333334,35,1,19,33.28345202048522,0.6538690476190476,41.9849537037037,1032.060185185185,29.487433862433857,3
4455,4,0,0,35,0.0,0.0,1.0,35,700,400,300,0.5714285714285714,10,4,6,345.39133596533685,0.7037114845938375,0.10178880553952707,0.21150642587559304,133011.3112953514,2188.1909013605355,135199.50219671192,2189,72,756.9714285714285,34,1,19,33.20590498172726,0.654718137254902,42.113095238095234,1031.5476190476184,30.339635854341715,0
4456,4,0,0,35,0.0,0.0,1.0,35,1500,1300,200,0.8666666666666667,17,13,4,343.4802652256549,0.7009103641456582,0.09724368584938281,0.2113780965061498,133195.58000283435,2150.010629251687,135345.59063208604,2190,73,757.9714285714285,34,1,19,33.07048398877484,0.6565563725490196,41.9345238095238,1032.261904761904,30.360644257703058,0
4457,4,0,0,35,0.0,0.0,1.0,35,900,600,300,0.6666666666666666,12,6,6,345.8165362534356,0.6994397759103641,0.09116901083698425,0.21334371518224043,133287.76218820864,2218.622448979591,135506.38463718822,2191,74,758.9714285714285,34,1,20,32.91781953731457,0.6574754901960784,41.845238095238095,1032.6190476190477,30.371148459383758,0
4458,4,0,0,35,0.0,0.0,1.0,35,1000,800,200,0.8,12,8,4,346.0224556552674,0.6992997198879551,0.09073305670816034,0.21382413285363952,133349.23469387754,2228.3659297052136,135577.60062358275,2192,75,759.9714285714285,34,1,21,32.85092016290149,0.6580882352941178,41.785714285714285,1032.8571428571427,30.378151260504197,0
4459,4,0,0,35,0.0,0.0,1.0,35,300,100,200,0.3333333333333333,5,1,4,346.84056941652887,0.6994397759103641,0.08868402857801372,0.21468491165453873,133410.7213718819,2254.4501133786666,135665.17148526057,2193,76,760.9714285714285,34,1,21,32.76820696012906,0.6587009803921569,41.72619047619047,1033.0952380952367,30.385154061624608,0
4460,4,0,0,35,0.0,0.0,1.0,35,1000,800,200,0.8,12,8,4,346.137084863685,0.6964285714285714,0.0903730999539385,0.21531908631491706,133595.26643990938,2248.455215419508,135843.72165532887,2194,77,761.9714285714285,34,1,21,32.60162367572548,0.6605392156862745,41.54761904761905,1033.8095238095243,30.40616246498601,0
4461,4,0,0,35,0.0,0.0,1.0,35,450,200,250,0.4444444444444444,7,2,5,344.20293792976423,0.6963585434173669,0.0917798756619852,0.21447250493959352,133656.80980725627,2201.0133219954705,135857.82312925174,2195,78,762.9714285714285,34,1,21,32.590039527208546,0.6611519607843137,41.48809523809524,1034.0476190476193,30.41316526610645,0
4462,4,0,0,35,0.0,0.0,1.0,35,850,700,150,0.8235294117647058,10,7,3,343.8295332181853,0.6937675070028011,0.09446426516284978,0.21477604702608286,133749.15143140592,2197.3816609977357,135946.53309240364,2196,79,763.9714285714285,34,1,17,32.50733686269997,0.6620710784313726,41.398809523809526,1034.4047619047622,30.42366946778712,0
4463,4,0,0,35,0.0,0.0,1.0,35,750,600,150,0.8,9,6,3,341.28891896867816,0.694047619047619,0.0801472279733153,0.21408123098944365,133903.12500000012,2139.930555555571,136043.05555555568,2197,80,764.9714285714285,34,1,19,32.41914922168546,0.6636029411764706,41.25000000000001,1035.000000000001,30.44117647058826,0
4464,4,0,0,35,0.0,0.0,1.0,35,900,800,100,0.8888888888888888,10,8,2,345.3265848206918,0.6923669467787115,0.07925482980680765,0.21697687728329026,133964.73922902506,2252.317176870761,136217.05640589583,2198,81,765.9714285714285,34,1,19,32.25309529285495,0.6642156862745097,41.1904761904762,1035.238095238096,30.44817927170871,0
4465,4,0,0,35,0.0,0.0,1.0,35,1050,900,150,0.8571428571428571,12,9,3,345.5482165010888,0.6928571428571428,0.07685408761641987,0.21729810838105357,133995.55165816337,2260.3847789115775,136255.93643707494,2199,82,766.9714285714285,34,1,19,32.21656893181557,0.6645220588235293,41.16071428571429,1035.3571428571436,30.451680672268928,0
4466,4,0,0,35,0.0,0.0,1.0,35,700,400,300,0.5714285714285714,10,4,6,346.2863659199453,0.6932072829131652,0.0824002758937814,0.21812781297158604,134057.18714569154,2284.4352324263004,136341.62237811784,2200,83,767.9714285714285,34,1,20,32.13587768709049,0.6651348039215685,41.101190476190474,1035.5952380952376,30.458683473389343,0
4467,4,0,0,35,0.0,0.0,1.0,35,500,200,300,0.4,8,2,6,344.5369269388294,0.6925070028011204,0.07931034482758625,0.21720806263534898,134088.01020408174,2239.6541950113487,136327.6643990931,2201,84,768.9714285714285,34,1,20,32.15038314176245,0.6654411764705882,41.07142857142858,1035.7142857142865,30.462184873949603,0
4468,4,0,0,35,0.0,0.0,1.0,35,450,200,250,0.4444444444444444,7,2,5,344.72045870389854,0.6927170868347339,0.07668084128261121,0.21750636049185085,134118.83680555565,2246.701388888899,136365.53819444455,2202,85,769.9714285714285,34,1,20,32.11484312148028,0.6657475490196079,41.04166666666667,1035.8333333333342,30.465686274509828,0
4469,4,0,0,35,0.0,0.0,1.0,35,550,400,150,0.7272727272727273,7,4,3,344.72045870389854,0.6927170868347339,0.07668084128261121,0.21750636049185085,134118.83680555565,2246.701388888899,136365.53819444455,2203,86,770.9714285714285,34,1,20,32.11484312148028,0.6657475490196079,41.04166666666667,1035.8333333333342,30.465686274509828,0
4470,4,0,0,35,0.0,0.0,1.0,35,650,200,450,0.3076923076923077,11,2,9,345.05872412567203,0.6920168067226891,0.08360335516488582,0.21808613479053926,134180.50063775515,2260.030470521551,136440.5311082767,2204,87,771.9714285714285,34,1,20,32.04450572599486,0.666360294117647,40.98214285714286,1036.0714285714291,30.472689075630267,0
4471,4,0,0,35,0.0,0.0,1.0,35,1200,800,400,0.6666666666666666,16,8,8,344.6507418649029,0.6910364145658263,0.08158952566900224,0.21856329274710198,134303.87081916106,2257.585742630392,136561.45656179145,2205,88,772.9714285714285,34,1,20,31.93192259101872,0.6675857843137254,40.86309523809524,1036.5476190476195,30.48669467787116,0
4472,4,0,0,35,0.0,0.0,1.0,35,850,600,250,0.7058823529411765,11,6,5,344.09154766415395,0.6917366946778711,0.0759040293881299,0.21894678390814068,134427.29768990935,2251.0593820861714,136678.35707199553,2206,89,773.9714285714285,34,1,20,31.82326942945701,0.6688112745098038,40.74404761904762,1037.0238095238099,30.500700280112056,0
4473,4,0,0,35,0.0,0.0,1.0,35,450,300,150,0.6666666666666666,6,3,3,344.29632525454304,0.6918067226890756,0.07598641733224976,0.21927785150006815,134460.73555652009,2258.867428626547,136719.60298514663,2207,90,774.9714285714285,35,0,20,31.7846083026448,0.6669642857142857,40.71180555555556,1037.1527777777778,29.63293650793651,0
4474,4,0,0,35,0.0,0.0,1.0,35,700,400,300,0.5714285714285714,10,4,6,346.2382653766954,0.6918067226890756,0.07214401107777557,0.2121994913546282,133042.01388888893,2212.877363040128,135254.89125192908,2208,91,775.9714285714285,34,1,20,33.15327140549274,0.6550245098039216,42.083333333333336,1031.666666666667,30.34313725490197,2
4475,4,0,0,35,0.0,0.0,1.0,35,1100,700,400,0.6363636363636364,15,7,8,344.31127766935526,0.6922268907563025,0.07081891580161481,0.211714806907327,133164.85969387757,2170.0325963718838,135334.89229024947,2209,92,776.9714285714285,34,1,20,33.07982506728182,0.65625,41.964285714285715,1032.1428571428573,30.35714285714286,0
4476,4,0,0,35,0.0,0.0,1.0,35,550,200,350,0.36363636363636365,9,2,7,343.0934760191542,0.6896358543417367,0.07144010146431468,0.21148896357598607,133257.03125,2143.923611111111,135400.95486111112,2210,93,777.9714285714285,34,1,21,33.01889965025558,0.6571691176470589,41.875,1032.5,30.36764705882353,0
4477,4,0,0,35,0.0,0.0,1.0,35,650,400,250,0.6153846153846154,9,4,5,343.4185995250142,0.6891456582633053,0.07136929460580888,0.2122150832962267,133349.23469387754,2158.9214852607683,135508.1561791383,2211,94,778.9714285714285,34,1,21,32.9181554479791,0.6580882352941178,41.785714285714285,1032.8571428571427,30.378151260504197,0
4478,4,0,0,35,0.0,0.0,1.0,35,700,700,0,1.0,7,7,0,343.06711758584817,0.6892857142857143,0.07235023041474653,0.2127016129032258,133472.22222222216,2157.986111111106,135630.20833333326,2212,95,779.9714285714285,34,1,21,32.80409946236559,0.6593137254901962,41.666666666666664,1033.333333333333,30.39215686274509,0
4479,4,0,0,35,0.0,0.0,1.0,35,900,700,200,0.7777777777777778,11,7,4,342.8342530022768,0.6878151260504202,0.0744528910389306,0.21291037085592043,133533.73724489796,2155.9878117913768,135689.72505668935,2213,96,780.9714285714285,34,1,21,32.74855064117332,0.6599264705882353,41.607142857142854,1033.5714285714284,30.399159663865543,0
4480,4,0,0,35,0.0,0.0,1.0,35,600,500,100,0.8333333333333334,7,5,2,343.5380240475716,0.6880952380952381,0.07425149700598843,0.21370230664964987,133595.26643990935,2179.0107709750637,135774.2772108844,2214,97,781.9714285714285,34,1,21,32.66879702134194,0.6605392156862745,41.54761904761905,1033.809523809524,30.406162464986004,0
4481,4,1,0,36,0.027777777777777776,0.0,1.0,36,900,500,400,0.5555555555555556,13,5,8,333.3886619515888,0.7031415343915345,0.07439078917952169,0.20973944935435407,134010.95920138893,1735.546875000005,135746.50607638893,2215,0,761.2222222222222,35,1,16,32.51592890677397,0.6624999999999999,41.145833333333336,1035.416666666667,29.583333333333343,0
4482,4,0,0,36,0.0,0.0,1.0,36,1100,800,300,0.7272727272727273,14,8,6,331.98918741553297,0.701223544973545,0.08112303183827585,0.20919994711226692,134070.88584533616,1702.016889574773,135772.90273491092,2216,1,762.2222222222222,35,1,16,32.49236328416033,0.663095238095238,41.08796296296297,1035.648148148149,29.589947089947113,0
4483,4,0,1,35,0.0,0.027777777777777776,0.9722222222222222,36,500,300,200,0.6,7,3,4,343.3394134038504,0.701223544973545,0.13102093910232138,0.19240128402083262,129613.56122470838,1700.2888160150742,131313.85004072345,2217,2,763.2222222222222,35,1,16,36.68778889141472,0.618452380952381,45.42824074074073,1018.287037037036,29.093915343915317,8
4484,4,2,0,37,0.05405405405405406,0.0,1.0,37,1050,800,250,0.7619047619047619,13,8,5,334.1498179904389,0.7317942942942943,0.14548057991766616,0.18968655081412142,130118.92804967133,1295.8432249817436,131414.7712746531,2218,0,736.3513513513514,36,1,20,36.40935430463577,0.6215277777777778,44.932432432432435,1020.2702702702707,28.34084084084085,0
4485,4,0,0,37,0.0,0.0,1.0,37,600,400,200,0.6666666666666666,8,4,4,335.32893705935413,0.7319194194194194,0.1474765429742253,0.19063681478242595,130176.38204082471,1330.3815639964375,131506.76360482114,2219,1,737.3513513513514,36,1,20,36.32108438166701,0.6221064814814814,44.87612612612613,1020.4954954954964,28.34709709709712,0
4486,4,0,0,37,0.0,0.0,1.0,37,800,600,200,0.75,10,6,4,334.6938775510202,0.7299174174174174,0.15135135135135114,0.1906976744186047,130262.58680555565,1319.6180555555643,131582.2048611112,2220,2,738.3513513513514,36,1,20,36.25,0.622974537037037,44.79166666666667,1020.8333333333342,28.356481481481506,0
4487,4,0,0,37,0.0,0.0,1.0,37,600,300,300,0.5,9,3,6,333.3204673031257,0.7293543543543544,0.1454104296997063,0.19020395618034783,130321.66950660163,1287.7759559328008,131609.44546253444,2221,3,739.3513513513514,35,2,20,36.225251265774965,0.6255952380952381,44.733796296296305,1021.0648148148158,29.173280423280453,0
4488,4,0,0,37,0.0,0.0,1.0,37,1250,800,450,0.64,17,8,9,332.8863601177108,0.7282907907907907,0.15052097526324326,0.190680590574889,130469.43486636262,1286.2990558556594,131755.73392221826,2222,4,740.3513513513514,35,2,22,36.08684056493336,0.6270833333333332,44.58912037037039,1021.643518518521,29.189814814814884,0
4489,4,0,0,37,0.0,0.0,1.0,37,1150,1000,150,0.8695652173913043,13,10,3,334.57828738291636,0.7287912912912913,0.15805593887785707,0.19252964250510118,130646.86381440777,1342.320789394748,131989.1846038025,2223,5,741.3513513513514,35,2,18,35.8642071398921,0.6288690476190475,44.415509259259274,1022.3379629629645,29.209656084656128,0
4490,4,0,0,37,0.0,0.0,1.0,37,700,400,300,0.5714285714285714,10,4,6,332.9622594192912,0.7289164164164164,0.16071215527921767,0.19189312211150958,130706.03358892768,1304.0352527006394,132010.06884162832,2224,6,742.3513513513514,35,2,18,35.84571307300508,0.6294642857142856,44.3576388888889,1022.5694444444462,29.21626984126989,0
4491,4,1,1,37,0.02631578947368421,0.02631578947368421,0.9736842105263158,38,800,700,100,0.875,9,7,2,325.9760714459732,0.7397463252726411,0.15172611431780414,0.18935772942590087,131010.89000740628,941.2830482509801,131952.17305565727,2225,0,723.7894736842105,36,2,19,35.71664283357167,0.6304976851851851,44.0596846846847,1023.7612612612631,28.437812812812865,0
4492,4,0,1,36,0.0,0.02702702702702703,0.972972972972973,37,950,600,350,0.631578947368421,13,6,7,333.2013404094438,0.7272897897897898,0.15920909032547992,0.19291637528224573,130883.62328800153,1322.1197434413605,132205.7430314429,2226,8,744.3513513513514,35,2,19,35.66020529351884,0.6312499999999999,44.18402777777778,1023.2638888888888,29.236111111111107,0
4493,4,0,0,36,0.0,0.0,1.0,36,750,600,150,0.8,9,6,3,340.23101285979686,0.7146164021164022,0.16223645065321368,0.19614660405809772,130718.71456916106,1694.9121315192738,132413.62670068032,2227,9,765.8055555555555,34,2,19,35.647070236709325,0.6317401960784313,44.345238095238095,1022.6190476190482,30.077030812324946,0
4494,4,0,0,36,0.0,0.0,1.0,36,1050,900,150,0.8571428571428571,12,9,3,339.1483000960078,0.7155753968253968,0.16193200180983713,0.19629492520708341,130870.93431122461,1676.9309807256334,132547.86529195023,2228,10,766.8055555555555,34,2,20,35.5208939305798,0.6332720588235293,44.19642857142858,1023.2142857142867,30.094537815126078,0
4495,4,0,0,36,0.0,0.0,1.0,36,900,400,500,0.4444444444444444,14,4,10,342.7575647538839,0.7150132275132276,0.1681721847458062,0.19885489485518862,130962.30867346938,1777.6643990929645,132739.97307256234,2229,11,767.8055555555555,34,2,21,35.336221601922915,0.6341911764705883,44.107142857142854,1023.5714285714286,30.10504201680672,0
4496,4,0,0,36,0.0,0.0,1.0,36,850,500,350,0.5882352941176471,12,5,7,344.287018915463,0.714186507936508,0.16649549793951635,0.20021721769384015,131053.7149234693,1824.018565759628,132877.73348922894,2230,12,768.8055555555555,34,2,21,35.20472425686936,0.635110294117647,44.01785714285714,1023.9285714285708,30.115546218487374,0
4497,4,2,2,36,0.05263157894736842,0.05263157894736842,0.9473684210526316,38,600,400,200,0.6666666666666666,8,4,4,325.635872193127,0.7347083926031295,0.14445946883017768,0.19159505968572355,131501.32395909424,964.3096643941233,132465.63362348836,2231,0,729.2894736842105,36,2,21,35.231161250182964,0.6354166666666666,43.58108108108108,1025.6756756756758,28.490990990990994,0
4498,4,0,0,36,0.0,0.0,1.0,36,1350,1000,350,0.7407407407407407,17,10,7,341.8860815909124,0.712962962962963,0.1655243184634454,0.19992903466946804,131267.12018140568,1775.6802721088163,133042.8004535145,2232,14,770.8055555555555,34,2,22,35.05072800495662,0.6372549019607844,43.809523809523796,1024.761904761903,30.140056022408913,0
4499,4,0,0,36,0.0,0.0,1.0,36,650,500,150,0.7692307692307693,8,5,3,339.156038933924,0.714186507936508,0.1579794577994562,0.19880685168550144,131358.63272392272,1710.2147108843387,133068.84743480707,2233,15,771.8055555555555,34,2,22,35.0283552045833,0.6381740196078433,43.72023809523809,1025.1190476190461,30.150560224089592,0
4500,4,1,1,36,0.02702702702702703,0.02702702702702703,0.972972972972973,37,1000,700,300,0.7,13,7,6,331.14386395860396,0.7269769769769769,0.1475176959047928,0.19546747655505856,131624.8780971363,1317.354145233176,132942.23224236947,2234,0,751.918918918919,35,2,17,34.96550492518233,0.6386904761904763,43.46064814814814,1026.157407407406,29.31878306878303,0
4501,4,0,0,36,0.0,0.0,1.0,36,850,800,50,0.9411764705882353,9,8,1,336.40043916481113,0.7152116402116403,0.1533903332301667,0.19797993059043772,131511.22448979566,1648.0867346938444,133159.3112244895,2235,17,773.8055555555555,34,2,23,34.94516016713091,0.6397058823529413,43.571428571428555,1025.7142857142835,30.16806722689069,0
4502,4,1,1,36,0.02702702702702703,0.02702702702702703,0.972972972972973,37,800,500,300,0.625,11,5,6,328.316511412766,0.7247247247247247,0.14667897522141704,0.19455549584119183,131773.3802324457,1252.675298996883,133026.05553144257,2236,0,753.8648648648649,35,2,17,34.88861176868448,0.6401785714285715,43.31597222222221,1026.7361111111088,29.335317460317395,0
4503,4,0,0,36,0.0,0.0,1.0,36,550,400,150,0.7272727272727273,7,4,3,336.084858593533,0.7153108465608466,0.1517222931250084,0.19826936319080457,131602.82206632625,1645.9431689342052,133248.76523526045,2237,19,775.8055555555555,34,2,17,34.860966082685536,0.6406250000000002,43.48214285714284,1026.0714285714262,30.17857142857136,0
4504,4,0,0,36,0.0,0.0,1.0,36,950,700,250,0.7368421052631579,12,7,5,338.3190417547834,0.7161044973544974,0.1527616691151834,0.20006768024758156,131694.4515306121,1710.948129251678,133405.3996598638,2238,20,776.8055555555555,34,2,18,34.711348874970994,0.641544117647059,43.39285714285713,1026.4285714285702,30.189075630252063,0
4505,4,0,0,36,0.0,0.0,1.0,36,400,200,200,0.5,6,2,4,336.9568902652263,0.7152116402116403,0.15400994755627728,0.1994220497431052,131725.00177154175,1677.1293934240127,133402.13116496577,2239,21,777.8055555555555,34,2,18,34.7155379025088,0.6418504901960785,43.36309523809523,1026.5476190476174,30.192577030812277,0
4506,4,0,0,36,0.0,0.0,1.0,36,550,300,250,0.5454545454545454,8,3,5,338.55045117220465,0.7147156084656086,0.15638528138528174,0.20052603646353628,131755.55555555533,1721.1805555555313,133476.73611111086,2240,22,778.8055555555555,34,2,18,34.64387175324675,0.6421568627450982,43.33333333333332,1026.666666666665,30.1960784313725,0
4507,4,0,0,36,0.0,0.0,1.0,36,1150,900,250,0.782608695652174,14,9,5,338.8964544714206,0.7156415343915344,0.1546128882707467,0.20137731468177766,131877.80612244867,1738.5841836734282,133616.3903061221,2241,23,779.8055555555555,34,2,21,34.51190890125173,0.6433823529411766,43.214285714285694,1027.1428571428546,30.21008403361337,0
4508,4,0,0,36,0.0,0.0,1.0,36,1100,900,200,0.8181818181818182,13,9,4,337.7718294579904,0.7157738095238095,0.15104005766656403,0.2013567977818624,132000.11337868456,1717.1839569160697,133717.29733560063,2242,24,780.8055555555555,34,2,21,34.41771895273399,0.644607843137255,43.09523809523808,1027.6190476190457,30.224089635854284,0
4509,4,1,0,37,0.02702702702702703,0.0,1.0,37,700,500,200,0.7142857142857143,9,5,4,329.6340090045016,0.724974974974975,0.1488725790382881,0.19533622537601392,131773.3802324457,1287.3975212191056,133060.7777536648,2243,0,760.6756756756756,35,2,20,34.854793709841054,0.6401785714285715,43.31597222222221,1026.7361111111088,29.335317460317395,2
4510,4,0,1,36,0.0,0.02702702702702703,0.972972972972973,37,650,300,350,0.46153846153846156,10,3,7,317.9872595940062,0.7256006006006006,0.09260803453180899,0.18062987632608005,130144.46159122098,876.8561385459624,131021.31772976695,2244,1,761.6756756756756,35,2,20,36.79578796128249,0.6238095238095237,44.90740740740741,1020.3703703703715,29.153439153439184,8
4511,4,3,2,37,0.07692307692307693,0.05128205128205128,0.9487179487179487,39,750,400,350,0.5333333333333333,11,4,7,300.9871989304889,0.750787224471435,0.0889365504915105,0.17336044657361405,130682.67549871127,66.76248941983431,130749.4379881311,2245,0,723.5128205128206,37,2,13,36.686662198391424,0.6252815315315314,44.380482456140356,1022.4780701754396,27.634542437174044,0
4512,4,0,0,37,0.0,0.0,1.0,37,900,600,300,0.6666666666666666,12,6,6,317.58371256793964,0.7248498498498498,0.10290294826377289,0.18191508311727492,130469.4348663625,886.993500300091,131356.42836666259,2246,1,763.6216216216217,35,2,21,36.47768683206829,0.6270833333333332,44.58912037037038,1021.6435185185201,29.18981481481486,0
4513,4,1,0,38,0.02631578947368421,0.0,1.0,38,1050,1000,50,0.9523809523809523,11,10,1,306.3571618745357,0.7355974395448079,0.09295542102366516,0.17716453314004865,130838.01442912544,416.63255316131057,131254.64698228674,2247,0,744.5,36,2,17,36.3928636947349,0.628761574074074,44.228603603603624,1023.0855855855885,28.419044044044128,0
4514,4,1,0,39,0.02564102564102564,0.0,1.0,39,900,800,100,0.8888888888888888,10,8,2,308.87654779947957,0.741340530814215,0.11488276429452937,0.18117915444950666,131384.3261869038,316.307421514332,131700.63360841814,2248,0,726.3846153846154,37,2,19,35.778520499108744,0.6323198198198197,43.6951754385965,1025.2192982456152,27.708629682313923,0
4515,4,1,1,39,0.025,0.025,0.975,40,1250,900,350,0.72,16,9,7,304.8476237730814,0.7535523504273505,0.11341228526808944,0.17996689774680086,131629.4461451714,25.384775184466633,131654.83092035586,2249,0,709.2,38,2,16,35.63551969460353,0.6329495614035088,43.456196581196586,1026.1752136752143,27.00461088618985,0
4516,4,0,0,39,0.0,0.0,1.0,39,950,700,250,0.7368421052631579,12,7,5,316.2351908992451,0.7398223121907332,0.1216236210893189,0.18659072613084074,131609.25116381957,523.8953331794322,132133.146496999,2250,2,728.3846153846154,37,2,16,35.3636816983686,0.6345720720720721,43.47587719298245,1026.0964912280697,27.73233760075864,0
4517,4,0,1,38,0.0,0.02564102564102564,0.9743589743589743,39,750,400,350,0.5333333333333333,11,4,7,319.99274447849314,0.7404408457040036,0.0766288444151999,0.18635786443322191,131109.1992201766,590.7984969683591,131699.99771714496,2251,3,729.3846153846154,38,1,18,35.77069858821895,0.6277412280701755,43.96367521367521,1024.145299145298,26.951192082770998,3
4518,4,0,0,38,0.0,0.0,1.0,38,1350,1200,150,0.8888888888888888,15,12,3,324.06521207048826,0.7300260787102892,0.08676968682548036,0.18856355236923916,131075.36844269384,895.3934143197864,131970.76185701363,2252,4,749.4736842105264,37,1,18,35.700534496912596,0.629222972972973,43.99671052631579,1024.0131578947362,27.67603129445233,0
4519,4,0,0,38,0.0,0.0,1.0,38,1150,800,350,0.6956521739130435,15,8,7,322.7606661783599,0.7293444760550024,0.08851367339350347,0.18821661319839172,131159.59357686967,866.6315597106671,132026.22513658032,2253,5,750.4736842105264,37,1,18,35.64904017697854,0.6300675675675675,43.91447368421052,1024.3421052631568,27.684921763869102,0
4520,4,0,0,38,0.0,0.0,1.0,38,750,600,150,0.8,9,6,3,333.0028841161955,0.7287221431958274,0.13785339927659224,0.18427484972376218,129117.79495854494,999.4278287550003,130117.22278729994,2254,6,751.4736842105264,37,1,17,37.45448538137878,0.6095157657657657,45.915570175438596,1016.3377192982457,27.468587008060695,5
4521,4,2,1,39,0.05,0.025,0.975,40,900,600,300,0.6666666666666666,12,6,6,319.0334923195311,0.7533119658119658,0.13401794145420198,0.1787600361726896,129609.0282914201,269.9512379833277,129878.97952940343,2255,0,714.85,38,2,16,37.31114258734655,0.6126644736842106,45.43269230769231,1018.2692307692306,26.796558704453435,0
4522,4,1,1,39,0.025,0.025,0.975,40,600,600,0,1.0,6,6,0,322.3229558469353,0.7497061965811965,0.1427312775330396,0.180979214431371,129690.63321827735,360.453648915172,130051.08686719251,2256,0,715.825,38,2,16,37.14469267883364,0.6134868421052633,45.352564102564095,1018.5897435897427,26.80499325236165,0
4523,4,0,0,39,0.0,0.0,1.0,39,700,500,200,0.7142857142857143,9,5,4,327.8639390850394,0.7414529914529915,0.13882101531503954,0.18375814135683524,129619.76431450053,699.5293022853098,130319.29361678584,2257,2,735.1794871794872,37,2,17,37.075459423567,0.6145833333333333,45.422149122807014,1018.3114035087713,27.521929824561386,0
4524,4,1,0,40,0.025,0.0,1.0,40,1000,700,300,0.7,13,7,6,322.09986433035687,0.7473824786324786,0.13919662509170938,0.1817359435586005,129881.14458917743,366.93981024910227,130248.08439942653,2258,0,717.775,38,2,18,36.95738566886769,0.6154057017543859,45.16559829059829,1019.3376068376068,26.82467386414755,0
4525,4,2,0,42,0.047619047619047616,0.0,1.0,42,1200,900,300,0.75,15,9,6,313.90024914699444,0.7646389856755711,0.15287389815691688,0.17946308704876276,130395.54172092021,-213.20209379165811,130182.33962712856,2259,0,684.547619047619,39,3,20,36.64637514873362,0.6188568376068376,44.661458333333336,1021.3541666666673,26.188568376068392,0
4526,4,2,1,43,0.045454545454545456,0.022727272727272728,0.9772727272727273,44,1000,800,200,0.8,12,8,4,302.61989921355996,0.7781227977448908,0.15523031360727724,0.17515272954481798,130870.93431122445,-879.1702097505702,129991.76410147388,2260,0,654.3863636363636,41,3,16,36.455303471010275,0.6204268292682926,44.19642857142857,1023.2142857142853,24.95644599303135,0
4527,4,0,0,43,0.0,0.0,1.0,43,800,500,300,0.625,11,5,6,309.8417122612359,0.7740863787375415,0.15087287268325444,0.17916005269005525,130833.79937743742,-492.4463158503508,130341.35306158707,2261,1,670.6046511627907,40,3,16,36.307986490513564,0.6216145833333333,44.232723577235774,1023.0691056910573,25.57672764227643,0
4528,4,1,2,42,0.022727272727272728,0.045454545454545456,0.9545454545454546,44,950,700,250,0.7368421052631579,12,7,5,304.4320597529445,0.7851039464411558,0.15046224961479182,0.1774850941247404,131150.23389274688,-814.7328317901306,130335.50106095675,2262,0,656.3409090909091,41,3,17,36.12782485875706,0.6232215447154472,43.92361111111111,1024.3055555555552,24.983062330623298,0
4529,4,2,1,43,0.045454545454545456,0.022727272727272728,0.9772727272727273,44,1050,500,550,0.47619047619047616,16,5,11,306.18272259854615,0.7871740662438337,0.16318506107447805,0.1800696990946694,131484.42147531235,-748.2278074072169,130736.19366790513,2263,0,656.2045454545455,40,4,20,35.74696128947022,0.6281249999999999,43.59756097560976,1025.6097560975613,25.640243902439032,0
4530,4,1,2,42,0.022727272727272728,0.045454545454545456,0.9545454545454546,44,1300,900,400,0.6923076923076923,17,9,8,302.52871284582767,0.7867996828752643,0.15589341086973652,0.1792140612044347,131760.6481973579,-827.7241394242657,130932.92405793363,2264,0,657.0,41,3,13,35.56331932231777,0.6293191056910568,43.32837301587303,1026.6865079365098,25.041134339914873,0
4531,4,1,1,42,0.023255813953488372,0.023255813953488372,0.9767441860465116,43,950,800,150,0.8421052631578947,11,8,3,308.66072644560154,0.7741786637135474,0.14658019265570377,0.18235837893088228,131658.81406092533,-472.41896179767696,131186.39509912767,2265,0,673.2325581395348,41,2,13,35.50819639117127,0.6283028455284553,43.42757936507937,1026.2896825396829,25.031455671699582,0
4532,4,1,1,42,0.023255813953488372,0.023255813953488372,0.9767441860465116,43,750,500,250,0.6666666666666666,10,5,5,311.0741181749488,0.7739940937615356,0.1547091450094833,0.18415303059922028,131735.18597253718,-404.11863819602263,131331.06733434115,2266,0,674.2093023255813,41,2,14,35.36955611390282,0.6290650406504066,43.3531746031746,1026.5873015873017,25.038714672861015,0
4533,4,0,1,41,0.0,0.023809523809523808,0.9761904761904762,42,1100,700,400,0.6363636363636364,15,7,8,313.56642154988435,0.7681233062330624,0.14138642984416094,0.1856769044839938,131745.12215777658,-137.83069766671775,131607.29146010987,2267,4,691.2619047619048,40,2,14,35.29560978024155,0.6307291666666666,43.34349593495936,1026.6260162601636,25.665650406504092,0
4534,4,0,0,41,0.0,0.0,1.0,41,1100,900,200,0.8181818181818182,13,9,4,322.88012812936375,0.7571646341463415,0.14541061366764696,0.1907083346720919,131648.63281250012,301.34548611112587,131949.97829861124,2268,5,709.0,39,2,14,35.15360671268102,0.6314102564102564,43.43750000000001,1026.250000000001,26.314102564102587,0
4535,4,0,0,41,0.0,0.0,1.0,41,900,700,200,0.7777777777777778,11,7,4,321.36965193684875,0.7577743902439025,0.14265384662979042,0.1902160912815404,131728.8208007814,266.72905815973786,131995.54985894114,2269,6,710.0,39,2,14,35.11172416708947,0.6322115384615383,43.35937500000001,1026.5625000000011,26.322115384615415,0
4536,4,0,0,41,0.0,0.0,1.0,41,900,500,400,0.5555555555555556,13,5,8,318.57773535377606,0.7577743902439025,0.13852471181912618,0.1892274982282071,131862.52170138914,201.69270833335753,132064.21440972248,2270,7,711.0,39,2,14,35.049019607843135,0.6335470085470085,43.22916666666668,1027.0833333333353,26.335470085470135,0
4537,4,1,2,40,0.023809523809523808,0.047619047619047616,0.9523809523809523,42,1000,400,600,0.4,16,4,12,311.55095934060535,0.767687766163376,0.13673119737170336,0.18639627768473752,132136.65729930953,-166.53953086784244,131970.11776844168,2271,0,695.047619047619,40,2,15,34.954367236664375,0.6346354166666666,42.96239837398375,1028.1504065040672,25.70376016260168,0
4538,4,0,0,40,0.0,0.0,1.0,40,800,600,200,0.75,10,6,4,324.8669573535707,0.7510950854700855,0.1416684007907607,0.19261544275910972,131793.94866544308,563.0998201110369,132357.0484855541,2272,9,730.5,38,2,15,34.95647348524258,0.6345942982456141,43.29594017094017,1026.8162393162395,27.0214799820063,0
4539,4,0,0,40,0.0,0.0,1.0,40,600,300,300,0.5,9,3,6,324.8502607811022,0.7520032051282052,0.148588143525741,0.19316235358134168,131903.6740836619,569.7885848126047,132473.4626684745,2273,10,731.5,38,2,16,34.846593863754556,0.6356907894736843,43.189102564102555,1027.2435897435885,27.03272604588391,0
4540,4,2,0,42,0.047619047619047616,0.0,1.0,42,1050,700,350,0.6666666666666666,14,7,7,330.68706231100276,0.7735433604336044,0.1794793283677738,0.18666977614190602,129899.73855054866,191.23258724965535,130090.97113779832,2274,0,697.6190476190476,40,2,15,36.71971056391852,0.6122395833333333,45.14735772357724,1019.4105691056915,25.485264227642286,7
4541,4,2,1,43,0.045454545454545456,0.022727272727272728,0.9772727272727273,44,1000,700,300,0.7,13,7,6,323.5325892178665,0.7909399224806202,0.17748785282445012,0.18484344432936842,130368.9453125,-362.7613203532949,130006.1839921467,2275,0,666.8636363636364,39,5,16,36.42730858153134,0.6185897435897436,44.6875,1021.25,26.185897435897434,0
4542,4,0,0,43,0.0,0.0,1.0,43,800,600,200,0.75,10,6,4,331.02873802582275,0.7818383167220376,0.18585666824869462,0.18860939724727077,130262.58680555527,24.131944444409413,130286.71874999968,2276,1,683.3720930232558,38,5,16,36.34353741496598,0.6192434210526316,44.79166666666665,1020.8333333333311,26.86403508771924,0
4543,4,0,0,43,0.0,0.0,1.0,43,1300,1200,100,0.9230769230769231,14,12,2,330.00032707439067,0.7811923218899963,0.18371071110527137,0.18841954158763566,130344.39718934885,2.73874095986136,130347.13593030871,2277,2,684.3720930232558,38,5,16,36.28701088093742,0.6200657894736844,44.711538461538446,1021.153846153844,26.872469635627475,0
4544,4,0,0,43,0.0,0.0,1.0,43,1200,700,500,0.5833333333333334,17,7,10,328.5529141573682,0.7800849021779254,0.18889183959937794,0.1882270433443613,130475.3472222221,-26.388888888898975,130448.9583333332,2278,3,685.3720930232558,39,4,17,36.19154431756391,0.6196581196581197,44.58333333333333,1021.6666666666656,26.19658119658117,0
4545,4,1,1,43,0.022727272727272728,0.022727272727272728,0.9772727272727273,44,950,700,250,0.7368421052631579,12,7,5,322.3394295358897,0.7857205778717407,0.18575926210329485,0.18588548306129815,130729.84959556126,-372.1229716108395,130357.72662395042,2279,0,670.7727272727273,40,4,12,36.09323760310048,0.6205729166666668,44.33434959349592,1022.6626016260143,25.566565040650357,0
4546,4,0,0,43,0.0,0.0,1.0,43,900,600,300,0.6666666666666666,12,6,6,329.7234562690393,0.780454042081949,0.18784763448581443,0.18954752644218403,130608.41064453115,12.931315104151736,130621.3419596353,2280,5,687.3720930232558,39,4,12,36.027145113624776,0.6209935897435899,44.45312499999999,1022.1874999999992,26.209935897435876,0
4547,4,0,1,42,0.0,0.023255813953488372,0.9767441860465116,43,1150,800,350,0.6956521739130435,15,8,7,333.8976051105935,0.7785622000738279,0.19106762636274754,0.1927419508865909,130768.17626953097,132.63617621524898,130900.81244574623,2281,6,688.3720930232558,39,4,13,35.75900889432052,0.622596153846154,44.296874999999986,1022.8124999999978,26.225961538461483,0
4548,4,0,0,42,0.0,0.0,1.0,42,750,400,350,0.5333333333333333,11,4,7,343.83933094816973,0.7688734030197445,0.19584820028962602,0.19784717726055517,130644.58832137097,584.1495680838414,131228.73788945482,2282,8,705.6190476190476,38,4,13,35.62981154422265,0.6230811403508772,44.41773504273503,1022.3290598290583,26.903396311291008,0
4549,4,0,0,42,0.0,0.0,1.0,42,800,500,300,0.625,11,5,6,344.11752217474685,0.7688008130081301,0.19566385150258192,0.19870815182756474,130781.15297866885,600.8172620351963,131381.97024070405,2283,9,706.6190476190476,38,4,13,35.48455887473018,0.624451754385965,44.28418803418803,1022.8632478632466,26.917453891138067,0
4550,4,0,0,42,0.0,0.0,1.0,42,700,500,200,0.7142857142857143,9,5,4,341.3569927813246,0.769696089818041,0.1915712346327232,0.1973831617650541,130833.79937743724,532.206461927413,131366.00583936466,2284,10,707.6190476190476,40,2,13,35.50192874408133,0.6216145833333333,44.23272357723577,1023.0691056910558,25.576727642276396,0
4551,4,0,0,42,0.0,0.0,1.0,42,1100,700,400,0.6363636363636364,15,7,8,343.19263495051695,0.7709301200154859,0.19370059381973648,0.19911498958649793,130963.7946989225,589.1619571683451,131552.95665609086,2285,11,708.6190476190476,40,2,13,35.32358684140852,0.6229166666666668,44.105691056910565,1023.577235772357,25.589430894308926,0
4552,4,0,0,42,0.0,0.0,1.0,42,850,600,250,0.7058823529411765,11,6,5,341.41386364597537,0.7703977932636469,0.19013345435464002,0.19821682123953346,130989.80150910486,544.3468462885676,131534.14835539344,2286,12,709.6190476190476,40,2,13,35.34283066944638,0.6231770833333334,44.08028455284552,1023.6788617886165,25.591971544715413,0
4553,4,0,0,42,0.0,0.0,1.0,42,1200,900,300,0.75,15,9,6,338.8560267723658,0.7719463801780875,0.18772884687161895,0.19753209333942587,131145.8965913972,487.9154892920773,131633.81208068927,2287,13,710.6190476190476,40,2,13,35.250686245328566,0.6247395833333333,43.92784552845528,1024.2886178861781,25.607215447154452,0
4554,4,0,1,41,0.0,0.023809523809523808,0.9761904761904762,42,1000,600,400,0.6,14,6,8,337.353552532124,0.7718253968253969,0.18416477702192036,0.19678957231040559,131171.9214753123,450.2627404322767,131622.18421574458,2288,14,711.6190476190476,40,2,13,35.26289682539683,0.625,43.90243902439024,1024.3902439024387,25.609756097560968,0
4555,4,0,0,41,0.0,0.0,1.0,41,1250,1000,250,0.8,15,10,5,341.5268483108574,0.7617886178861789,0.18803779210374238,0.19906541194076208,131141.34250216998,757.6578776041481,131899.00037977414,2289,15,729.3658536585366,39,2,13,35.18689192853995,0.6263354700854702,43.93229166666666,1024.270833333332,26.263354700854663,0
4556,4,0,0,41,0.0,0.0,1.0,41,1250,1000,250,0.8,15,10,5,345.9019495798016,0.7613313008130081,0.1949719616220167,0.2020500263999744,131223.97898902756,878.1260327847052,132102.10502181225,2290,16,730.3658536585366,40,1,13,34.99140382199299,0.6255208333333334,43.851626016260155,1024.5934959349584,25.614837398373957,0
4557,4,0,0,41,0.0,0.0,1.0,41,1000,400,600,0.4,16,4,12,346.01126770201506,0.7608739837398374,0.19896033249024492,0.2028086813439726,131355.50356353627,890.1794843085868,132245.68304784485,2291,17,731.3658536585366,38,3,13,34.85582768803194,0.6302083333333335,43.72329059829059,1025.1068376068365,26.9764957264957,0
4558,4,0,0,41,0.0,0.0,1.0,41,1200,900,300,0.75,15,9,6,346.80513938623596,0.760060975609756,0.20215783671295373,0.20383860282134278,131461.62245008672,918.3132595486077,132379.93570963532,2292,18,732.3658536585366,39,2,13,34.72839427797529,0.6295405982905983,43.619791666666664,1025.5208333333328,26.29540598290597,0
4559,4,0,0,41,0.0,0.0,1.0,41,650,600,50,0.9230769230769231,7,6,1,346.77545482561624,0.7578252032520325,0.20498900358621852,0.20424908367958522,131541.7534722221,923.090277777774,132464.84374999988,2293,19,733.3658536585366,39,2,13,34.64832114811807,0.6303418803418804,43.541666666666664,1025.8333333333326,26.303418803418783,0
4560,4,0,0,41,0.0,0.0,1.0,41,1300,1200,100,0.9230769230769231,14,12,2,347.2769295768193,0.7569105691056911,0.20981749403364924,0.20511824401623643,131648.6328125,943.7065972222236,132592.33940972222,2294,20,734.3658536585366,39,2,13,34.52767627554473,0.6314102564102565,43.4375,1026.25,26.314102564102566,0
4561,4,0,0,41,0.0,0.0,1.0,41,1300,700,600,0.5384615384615384,19,7,12,349.4206904199091,0.754979674796748,0.20834384850239207,0.20725566583390284,131809.033203125,1011.360677083333,132820.39388020834,2295,21,735.3658536585366,39,2,13,34.31096571312639,0.6330128205128206,43.28125,1026.875,26.330128205128204,0
4562,4,0,0,41,0.0,0.0,1.0,41,1000,600,400,0.6,14,6,8,347.08582549645735,0.7551829268292682,0.20562897445220285,0.20630580622185452,131889.27001953125,955.3792317708342,132844.6492513021,2296,22,736.3658536585366,39,2,13,34.29006946557144,0.6338141025641026,43.203125,1027.1875,26.338141025641026,0
4563,4,0,0,41,0.0,0.0,1.0,41,1300,1000,300,0.7692307692307693,16,10,6,347.13657228301355,0.7566056910569106,0.1983630514572896,0.20725733719423836,132058.3037956904,968.4533842289657,133026.75717991934,2297,23,737.3658536585366,40,1,15,34.118548546569116,0.6338541666666667,43.03861788617886,1027.8455284552845,25.696138211382113,0
4564,4,0,0,41,0.0,0.0,1.0,41,1000,600,400,0.6,14,6,8,349.79534128013256,0.755030487804878,0.20379832256820607,0.2097114249854823,132215.03404058426,1049.6405909180985,133264.67463150236,2298,24,738.3658536585366,40,1,16,33.89245718050066,0.6354166666666667,42.886178861788615,1028.4552845528451,25.711382113821127,0
4565,4,0,0,41,0.0,0.0,1.0,41,650,400,250,0.6153846153846154,9,4,5,348.0987787756417,0.7550813008130082,0.20699177353362197,0.20898314583434413,132267.29811124314,1008.4169888954857,133275.71510013862,2299,25,739.3658536585366,40,1,16,33.88349634459593,0.6359375,42.83536585365853,1028.6585365853646,25.716463414634113,0
4566,4,0,0,41,0.0,0.0,1.0,41,550,300,250,0.5454545454545454,8,3,5,346.8067428745617,0.7547256097560976,0.20476723878349867,0.2086404201785465,132345.71358194528,979.6771721528181,133325.3907540981,2300,26,740.3658536585366,40,1,16,33.83786008230452,0.63671875,42.75914634146341,1028.9634146341464,25.72408536585366,0
4567,4,0,0,41,0.0,0.0,1.0,41,1450,1200,250,0.8275862068965517,17,12,5,343.911506628026,0.7564532520325203,0.20290698704434385,0.20779154792315283,132507.98000447443,914.224464409391,133422.20446888384,2301,27,741.3658536585366,38,3,16,33.7492649856456,0.6417214912280702,42.60149572649573,1029.5940170940173,27.094579397210982,0
4568,4,0,0,41,0.0,0.0,1.0,41,550,400,150,0.7272727272727273,7,4,3,343.52848914046024,0.7569105691056911,0.19883185966119887,0.20771189324565587,132535.48127145882,905.9427277375964,133441.4239991964,2302,28,742.3658536585366,38,3,16,33.73149685273571,0.6419956140350876,42.574786324786324,1029.7008547008545,27.09739091318038,0
4569,4,0,0,41,0.0,0.0,1.0,41,1350,1000,350,0.7407407407407407,17,10,7,340.2838076764004,0.7557418699186992,0.19597162690133896,0.20680764492998618,132728.07004026952,833.0426117685715,133561.1126520381,2303,29,743.3658536585366,38,3,13,33.62169517884915,0.6439144736842106,42.38782051282051,1030.4487179487176,27.117071524966253,0
4570,4,0,0,41,0.0,0.0,1.0,41,1250,900,350,0.72,16,9,7,339.887549194327,0.755640243902439,0.19539497633782354,0.20702241632745366,132810.65088757392,828.1373274161718,133638.78821499008,2304,30,744.3658536585366,38,3,13,33.54905161691542,0.6447368421052632,42.30769230769231,1030.7692307692305,27.125506072874487,0
4571,4,1,0,42,0.023809523809523808,0.0,1.0,42,1200,900,300,0.75,15,9,6,334.95237329984076,0.7620257452574526,0.19719514774016167,0.20587519321680056,133149.50086805565,519.7482638888988,133669.24913194455,2305,0,727.6190476190476,39,3,14,33.3366976180864,0.6463675213675213,41.97916666666667,1032.0833333333342,26.463675213675234,0
4572,4,1,0,43,0.023255813953488372,0.0,1.0,43,800,600,200,0.75,10,6,4,328.9825953048355,0.7710409745293466,0.19443495273126898,0.20354698543726968,133395.34837372432,176.94958191608907,133572.29795564042,2306,0,711.6744186046511,41,2,16,33.24480217036398,0.6455792682926829,41.74107142857142,1033.035714285713,25.195993031358856,0
4573,4,0,0,43,0.0,0.0,1.0,43,750,500,250,0.6666666666666666,10,5,5,328.25680249910806,0.7699796973052787,0.1950972993985962,0.20380779495823748,133524.7341612136,166.1026023350579,133690.83676354866,2307,1,712.6744186046511,40,3,17,33.13421828908554,0.6484375,41.61585365853659,1033.5365853658539,25.838414634146346,0
4574,4,0,0,43,0.0,0.0,1.0,43,1650,1200,450,0.7272727272727273,21,12,9,327.52835772156783,0.7697951273532668,0.18523435425679824,0.20405427809515247,133651.68065200618,154.94309413580663,133806.623746142,2308,2,713.6744186046511,41,2,18,33.02622005820462,0.648119918699187,41.49305555555556,1034.0277777777778,25.22018970189702,0
4575,4,1,1,43,0.022727272727272728,0.022727272727272728,0.9772727272727273,44,1050,800,250,0.7619047619047619,13,8,5,321.96022432618577,0.7749075052854123,0.18113527865002133,0.202204648822848,133948.2596166848,-174.79765714199314,133773.46195954282,2309,0,698.4318181818181,42,2,15,32.87427064807013,0.6495535714285714,41.20639534883721,1035.174418604652,24.647009966777425,0
4576,4,0,0,43,0.0,0.0,1.0,43,1450,1100,350,0.7586206896551724,18,11,7,326.17256805297825,0.7684108527131782,0.17725619273394577,0.20485017898353725,133948.2596166848,138.04956508022957,134086.30918176504,2310,4,715.6744186046511,42,1,15,32.765257886361496,0.6495535714285714,41.20639534883721,1035.174418604652,24.647009966777425,0
4577,4,0,1,42,0.0,0.023255813953488372,0.9767441860465116,43,1300,800,500,0.6153846153846154,18,8,10,322.98783094365126,0.7674880029531193,0.17275187996100771,0.2035432745946787,134073.67345712418,60.83299531280005,134134.506452437,2311,5,716.6744186046511,42,1,15,32.722640656187636,0.6507936507936507,41.085271317829466,1035.6589147286838,24.658545588778185,0
4578,4,0,1,41,0.0,0.023809523809523808,0.9761904761904762,42,1250,900,350,0.72,16,9,7,329.05730351842413,0.7578397212543554,0.17798976268031663,0.20715923607510928,134036.64040847824,421.14709309649925,134457.78750157473,2312,7,734.6190476190476,41,1,15,32.60243022290349,0.651930894308943,41.12103174603175,1035.5158730158732,25.256484707704224,0
4579,4,0,0,41,0.0,0.0,1.0,41,950,600,350,0.631578947368421,13,6,7,332.6609717676739,0.7513211382113821,0.18034129104541918,0.2092067889116705,133997.80636525876,715.1680960407127,134712.97446129948,2313,39,753.3658536585366,40,1,15,32.547891310037954,0.653125,41.15853658536585,1035.3658536585363,25.884146341463406,0
4580,4,0,0,41,0.0,0.0,1.0,41,900,500,400,0.5555555555555556,13,5,8,330.6281578487888,0.7517276422764227,0.17408451888906318,0.20829374410280663,134062.3240760424,664.9558492378435,134727.27992528025,2314,40,754.3658536585366,41,0,16,32.53614251045759,0.6521849593495934,41.09623015873016,1035.615079365079,25.258904374758025,0
4581,4,0,0,41,0.0,0.0,1.0,41,1150,800,350,0.6956521739130435,15,8,7,331.68694601035065,0.7519817073170731,0.1688684663986213,0.2099879901832803,134242.17864229032,705.2756519274453,134947.45429421778,2315,41,755.3658536585366,41,0,18,32.32936052077351,0.6539634146341463,40.92261904761905,1036.3095238095243,25.275842044134738,0
4582,4,0,0,41,0.0,0.0,1.0,41,900,600,300,0.6666666666666666,12,6,6,331.68694601035065,0.7519817073170731,0.1688684663986213,0.2099879901832803,134242.17864229032,705.2756519274453,134947.45429421778,2316,42,756.3658536585366,41,0,18,32.32936052077351,0.6539634146341463,40.92261904761905,1036.3095238095243,25.275842044134738,0
4583,4,2,2,41,0.046511627906976744,0.046511627906976744,0.9534883720930233,43,800,400,400,0.5,12,4,8,323.7137340553456,0.762781469176818,0.16259728826671815,0.20711739277999797,134627.9872626133,116.8943098072483,134744.88157242053,2317,0,722.1395348837209,41,2,18,32.151861676703945,0.6577743902439025,40.550595238095234,1037.7976190476184,25.31213704994191,0
4584,4,0,0,41,0.0,0.0,1.0,41,800,600,200,0.75,10,6,4,335.0992102984151,0.750660569105691,0.16877152698048214,0.21304482640140127,134396.43565759642,807.2278911564665,135203.6635487529,2318,44,758.3658536585366,41,0,18,32.087160352085725,0.6554878048780487,40.773809523809526,1036.9047619047622,25.290360046457614,0
4585,4,0,0,41,0.0,0.0,1.0,41,950,700,250,0.7368421052631579,12,7,5,336.8773128873983,0.7507113821138212,0.1726753668569878,0.214326144346438,134422.15377180968,856.7547910367866,135278.90856284648,2319,45,759.3658536585366,41,0,18,32.01543017953377,0.6557418699186992,40.74900793650794,1037.0039682539687,25.29277971351143,0
4586,4,0,0,41,0.0,0.0,1.0,41,900,600,300,0.6666666666666666,12,6,6,336.48356006015206,0.74994918699187,0.16477234295150645,0.2146802066838932,134525.05083341213,853.0936043398875,135378.14443775202,2320,46,760.3658536585366,41,0,18,31.92309378088044,0.6567581300813008,40.64980158730159,1037.400793650794,25.30245838172668,0
4587,4,0,0,41,0.0,0.0,1.0,41,1200,800,400,0.6666666666666666,16,8,8,333.6704322556949,0.7488821138211382,0.15713381803421567,0.21396380825435812,134708.98321311723,789.6833919641305,135498.66660508135,2321,47,761.3658536585366,40,1,18,31.812897699461583,0.66015625,40.47256097560976,1038.1097560975613,25.952743902439032,0
4588,4,0,0,41,0.0,0.0,1.0,41,1200,800,400,0.6666666666666666,16,8,8,335.7578206729994,0.7466463414634147,0.15390303536287187,0.21687452409231942,134972.85970858936,863.6386451516815,135836.49835374104,2322,48,762.3658536585366,40,1,14,31.496128769356137,0.6627604166666667,40.21849593495934,1039.1260162601616,25.97815040650404,0
4589,4,0,0,41,0.0,0.0,1.0,41,950,700,250,0.7368421052631579,12,7,5,334.8232122387357,0.7464939024390244,0.1557408515721681,0.21690352362191442,135078.48260170867,845.4822898076551,135923.96489151634,2323,49,763.3658536585366,40,1,14,31.41537947665134,0.6638020833333333,40.11686991869919,1039.5325203252034,25.988313008130085,0
4590,4,0,0,41,0.0,0.0,1.0,41,1200,900,300,0.75,15,9,6,333.7616129924734,0.7468495934959349,0.14956394067018985,0.21684968798425253,135184.1468062164,823.8557778108129,136008.0025840272,2324,50,764.3658536585366,40,1,15,31.337950747581345,0.6648437500000002,40.01524390243902,1039.9390243902428,25.99847560975607,0
4591,4,0,0,41,0.0,0.0,1.0,41,1150,800,350,0.6956521739130435,15,8,7,336.8894577026373,0.7455284552845528,0.15248666158536683,0.22000944176498724,135369.15856963425,920.8884840372625,136290.0470536715,2325,51,765.3658536585366,40,1,17,31.07279459635417,0.6666666666666667,39.83739837398373,1040.6504065040633,26.016260162601583,0
4592,4,0,0,41,0.0,0.0,1.0,41,550,100,450,0.18181818181818182,10,1,9,335.42595044240005,0.7453252032520326,0.15401982942786163,0.21921487929040315,135395.59914939836,883.0395060810229,136278.6386554794,2326,52,766.3658536585366,40,1,17,31.08461087784395,0.6669270833333334,39.81199186991869,1040.752032520324,26.018800813008102,0
4593,4,0,0,41,0.0,0.0,1.0,41,750,400,350,0.5333333333333333,11,4,7,333.8741654051149,0.7436483739837398,0.15998419062675584,0.2186833088497439,135474.9363804612,846.3162634674956,136321.25264392872,2327,53,767.3658536585366,40,1,17,31.046222178836377,0.6677083333333333,39.73577235772357,1041.0569105691045,26.02642276422761,0
4594,4,0,0,41,0.0,0.0,1.0,41,1050,700,350,0.6666666666666666,14,7,7,330.8791128441397,0.7439024390243902,0.15894840580262115,0.21704144623566282,135527.8407776455,768.6663444378253,136296.50712208333,2328,54,768.3658536585366,40,1,17,31.07167837855423,0.6682291666666667,39.68495934959349,1041.2601626016253,26.031504065040632,0
4595,4,0,0,41,0.0,0.0,1.0,41,1150,700,450,0.6086956521739131,16,7,9,332.73214206953287,0.7424288617886179,0.1647132736328829,0.21874097011357538,135607.21673813523,824.1759410734221,136431.39267920866,2329,55,769.3658536585366,40,1,17,30.94468566038962,0.6690104166666667,39.60873983739837,1041.5650406504055,26.039126016260138,0
4596,4,0,0,41,0.0,0.0,1.0,41,750,300,450,0.4,12,3,9,331.8495267761494,0.7422764227642277,0.16964157242812306,0.21848763115788478,135660.80864800344,803.7976123437361,136464.60626034718,2330,56,770.3658536585366,39,2,18,30.914512715395123,0.671207264957265,39.557291666666664,1041.7708333333333,26.712072649572647,0
4597,4,0,0,41,0.0,0.0,1.0,41,1300,1100,200,0.8461538461538461,15,11,4,332.41338427005746,0.7403963414634146,0.16555920106472688,0.21969143480886383,135796.4898003474,828.1141493055762,136624.60394965296,2331,57,771.3658536585366,39,2,18,30.7652908255047,0.672542735042735,39.42708333333334,1042.291666666668,26.72542735042739,0
4598,4,0,0,41,0.0,0.0,1.0,41,950,600,350,0.631578947368421,13,6,7,332.41338427005746,0.7403963414634146,0.16555920106472688,0.21969143480886383,135796.4898003474,828.1141493055762,136624.60394965296,2332,58,772.3658536585366,39,2,18,30.7652908255047,0.672542735042735,39.42708333333334,1042.291666666668,26.72542735042739,0
4599,4,0,0,41,0.0,0.0,1.0,41,950,700,250,0.7368421052631579,12,7,5,332.3256662455807,0.7402439024390244,0.15928720438283506,0.21996794099112238,135850.78125,829.3402777777785,136680.12152777778,2333,59,773.3658536585366,39,2,18,30.71376232347455,0.6730769230769231,39.375,1042.5,26.73076923076923,0
4600,4,0,0,41,0.0,0.0,1.0,41,1600,1400,200,0.875,18,14,4,351.6297077366913,0.7402439024390244,0.18639518874747418,0.21541298510773385,133026.2877276256,1155.1989349923888,134181.486662618,2334,60,774.3658536585366,40,1,18,33.029997044626136,0.6434895833333334,42.09857723577235,1031.6056910569096,25.79014227642274,5
4601,4,0,0,41,0.0,0.0,1.0,41,1150,800,350,0.6956521739130435,15,8,7,350.0017683956975,0.7401930894308943,0.18589515749430818,0.21517057868200395,133157.36747306504,1121.0628180977023,134278.43029116275,2335,61,775.3658536585366,40,1,18,32.94050315084678,0.6447916666666667,41.97154471544716,1032.113821138212,25.8028455284553,0
4602,4,0,0,41,0.0,0.0,1.0,41,1150,700,450,0.6086956521739131,16,7,9,349.8016158914406,0.7385162601626016,0.1836241391643325,0.2158065706783805,133288.51176754903,1124.9073592107852,134413.4191267598,2336,62,776.3658536585366,40,1,19,32.81419151658302,0.64609375,41.84451219512195,1032.6219512195119,25.815548780487795,0
4603,4,0,0,41,0.0,0.0,1.0,41,1200,1000,200,0.8333333333333334,14,10,4,351.0317977548466,0.7382621951219512,0.1816536791757768,0.21687149912355647,133340.98755907518,1161.3853154537546,134502.37287452893,2337,63,777.3658536585366,40,1,19,32.729836990389984,0.6466145833333334,41.793699186991866,1032.8252032520318,25.820630081300795,0
4604,4,1,0,42,0.023809523809523808,0.0,1.0,42,1450,1100,350,0.7586206896551724,18,11,7,344.7290446611551,0.7458865660085172,0.18729758906081329,0.2145100795148569,133606.8047417536,811.7583298606132,134418.56307161422,2338,0,759.8333333333334,39,3,20,32.626469353484474,0.6509081196581196,41.53645833333334,1033.8541666666679,26.509081196581228,0
4605,4,0,0,42,0.0,0.0,1.0,42,800,400,400,0.5,12,4,8,343.6341827965563,0.7438056523422377,0.18337577754437495,0.21445278447435648,133714.51958550367,789.7759331597467,134504.29551866342,2339,1,760.8333333333334,39,3,17,32.547021351596364,0.6519764957264957,41.43229166666668,1034.2708333333348,26.519764957264996,0
4606,4,0,0,42,0.0,0.0,1.0,42,1000,600,400,0.6,14,6,8,347.27296869697443,0.7441444057297716,0.18195001749818984,0.21735742898973226,133822.2778320314,894.5719401041817,134716.84977213558,2340,2,761.8333333333334,39,3,18,32.34515000503372,0.6530448717948718,41.32812500000001,1034.6875000000011,26.530448717948747,0
4607,4,0,0,42,0.0,0.0,1.0,42,1000,600,400,0.6,14,6,8,348.61248669705657,0.7443863724351529,0.17694587405984263,0.21908176446532532,133971.50262947025,940.8277356401981,134912.33036511045,2341,3,762.8333333333334,40,2,19,32.16129216975885,0.6528645833333332,41.18394308943091,1035.2642276422791,25.88160569105698,0
4608,4,0,0,42,0.0,0.0,1.0,42,1000,700,300,0.7,13,7,6,344.6828705856109,0.7437572590011614,0.17732032465620895,0.21723334162881672,134076.73306439642,842.7906462753887,134919.5237106718,2342,4,763.8333333333334,40,2,19,32.157868053511265,0.6539062499999999,41.08231707317074,1035.670731707319,25.891768292682976,0
4609,4,0,0,42,0.0,0.0,1.0,42,1000,700,300,0.7,13,7,6,360.7626261267164,0.7437572590011614,0.1521167863020898,0.21088382372738254,131251.87119118465,1121.485929446366,132373.357120631,2343,5,764.8333333333334,41,1,19,34.582546713137745,0.6242378048780488,43.82440476190475,1024.7023809523796,24.992740998838528,7
4610,4,2,2,42,0.045454545454545456,0.045454545454545456,0.9545454545454546,44,1100,900,200,0.8181818181818182,13,9,4,347.8754662996988,0.7606589147286822,0.1371455855623116,0.20561589498805805,131675.35942925324,361.4139894238694,132036.7734186771,2344,0,731.0227272727273,39,5,15,34.4853724753882,0.6316773504273505,43.41145833333332,1026.3541666666647,26.316773504273453,0
4611,4,0,0,42,0.0,0.0,1.0,42,1050,700,350,0.6666666666666666,14,7,7,360.8588255693751,0.741869918699187,0.14958896439388236,0.21245023997492102,131524.8817544818,1092.3828726146207,132617.26462709642,2345,7,766.8333333333334,37,5,19,34.30418225547838,0.6337274774774776,43.558114035087705,1025.7675438596464,27.723447131341793,0
4612,4,1,1,42,0.023255813953488372,0.023255813953488372,0.9767441860465116,43,1200,800,400,0.6666666666666666,16,8,8,354.4552744508313,0.7474621631598376,0.15736591348648532,0.2105378919328428,131862.5217013887,747.8732638888685,132610.39496527758,2346,0,749.9767441860465,39,4,16,34.12778904665314,0.6335470085470087,43.22916666666666,1027.0833333333317,26.335470085470043,0
4613,4,1,0,43,0.023255813953488372,0.0,1.0,43,1150,700,450,0.6086956521739131,16,7,9,350.2645977073943,0.7574289405684754,0.15555419363659118,0.20893050308229424,132023.05230034702,648.6002604166474,132671.65256076367,2347,0,739.2093023255813,39,4,17,34.073670518278256,0.6351495726495728,43.07291666666666,1027.7083333333317,26.351495726495685,0
4614,4,0,0,43,0.0,0.0,1.0,43,950,600,350,0.631578947368421,13,6,7,359.40612365328286,0.7571520856404577,0.152650668702907,0.21376510111601058,131913.47321625412,882.6336972867887,132796.10691354092,2348,1,740.2093023255813,41,2,20,33.94927973603734,0.6308434959349594,43.179563492063494,1027.2817460317463,25.055652342237714,1
4615,4,0,0,43,0.0,0.0,1.0,43,850,600,250,0.7058823529411765,11,6,5,359.57181632822056,0.7565983757844222,0.1551525166481813,0.21429487189457463,131989.9189421138,891.970978206092,132881.8899203199,2349,2,741.2093023255813,41,2,20,33.86794426208406,0.6316056910569106,43.10515873015873,1027.5793650793646,25.062911343399136,0
4616,4,0,0,43,0.0,0.0,1.0,43,1450,1100,350,0.7586206896551724,18,11,7,358.48268781195003,0.7560446659283868,0.14945389343572546,0.21436561418322161,132117.37769471182,872.3585325333474,132989.73622724516,2350,3,742.2093023255813,41,2,20,33.76747000546816,0.6328760162601628,42.98115079365078,1028.0753968253941,25.07500967866815,0
4617,4,1,0,44,0.022727272727272728,0.0,1.0,44,1250,800,450,0.64,17,8,9,353.49917374869483,0.7622665609584215,0.15501610676484123,0.21254944785719787,132324.91933719284,555.3499304120637,132880.26926760492,2351,0,726.3181818181819,43,1,21,33.686627550237766,0.6320251937984498,42.779356060606055,1028.8825757575748,23.927501761804066,0
4618,4,0,0,44,0.0,0.0,1.0,44,1350,900,450,0.6666666666666666,18,9,9,356.17695749807467,0.7624207188160677,0.1578027235921977,0.2145748987854249,132398.00347222187,631.5043187557001,133029.50779097757,2352,1,727.3181818181819,39,5,21,33.544197031039126,0.6388888888888891,42.708333333333314,1029.1666666666638,26.388888888888815,0
4619,4,1,1,44,0.022222222222222223,0.022222222222222223,0.9777777777777777,45,1450,1100,350,0.7586206896551724,18,11,7,347.4937495426217,0.7702441077441078,0.15031547428082614,0.2116330631739644,132806.71788391253,229.90087238596107,133036.6187562985,2353,0,712.1333333333333,41,4,18,33.35699390439524,0.6397357723577237,42.31150793650792,1030.753968253966,25.14034068912112,0
4620,4,0,0,44,0.0,0.0,1.0,44,1200,1100,100,0.9166666666666666,13,11,2,352.07220227827486,0.7618261099365751,0.150188974724631,0.21456787412748027,132832.2834486798,553.3109134857017,133385.59436216552,2354,3,729.3181818181819,41,3,18,33.21333766400407,0.6399898373983743,42.28670634920632,1030.85317460317,25.142760356174875,0
4621,4,0,1,43,0.0,0.022727272727272728,0.9772727272727273,44,700,400,300,0.5714285714285714,10,4,6,350.3360054574524,0.7628611698379141,0.15123823848333307,0.21424077133739197,132960.14817964178,516.1454396572967,133476.29361929907,2355,4,730.3181818181819,41,3,19,33.129729383096056,0.6412601626016262,42.16269841269839,1031.3492063492026,25.154858691443966,0
4622,4,0,0,43,0.0,0.0,1.0,43,950,800,150,0.8421052631578947,11,8,3,358.53431544567303,0.755906238464378,0.15069180717866026,0.21902755561873805,132921.47040658645,931.381680051532,133852.85208663798,2356,9,748.2093023255813,40,3,19,32.95719588712591,0.6424479166666668,42.20020325203251,1031.199186991868,25.7799796747967,0
4623,4,0,0,43,0.0,0.0,1.0,43,1500,1100,400,0.7333333333333333,19,11,8,361.5044395747524,0.7551218161683277,0.15511969196869257,0.22177369033247513,133078.7118799162,1021.7090314958167,134100.42091141202,2357,10,749.2093023255813,40,3,19,32.72267638464822,0.6440104166666667,42.04776422764228,1031.808943089432,25.7952235772358,0
4624,4,0,0,43,0.0,0.0,1.0,43,800,500,300,0.625,11,5,6,358.29817542517355,0.7550295311923219,0.15484181237332972,0.22011602973034725,133131.1463600536,940.1293666137949,134071.2757266674,2358,11,750.2093023255813,40,3,19,32.752749056294114,0.64453125,41.9969512195122,1032.0121951219517,25.80030487804879,0
4625,4,0,0,43,0.0,0.0,1.0,43,1100,800,300,0.7272727272727273,14,8,6,358.45623566247104,0.7540605389442598,0.1539598974546783,0.2209900093647276,133262.2777447289,953.738887236458,134216.01663196535,2359,12,751.2093023255813,40,3,19,32.61708497375329,0.6458333333333333,41.869918699187004,1032.5203252032538,25.813008130081347,0
4626,4,0,0,43,0.0,0.0,1.0,43,900,600,300,0.6666666666666666,12,6,6,336.47126902469216,0.7540605389442598,0.15945386722620536,0.19456816860993062,130835.79881656796,211.02723371411352,131046.82605028206,2360,13,752.2093023255813,38,5,15,35.62486946532999,0.625,44.230769230769226,1023.0769230769223,26.923076923076902,6
4627,4,0,0,43,0.0,0.0,1.0,43,800,500,300,0.625,11,5,6,343.8359375,0.7557678110003692,0.13199127906976704,0.20225643382352948,131492.4391847469,451.63646449704413,131944.07564924395,2361,14,753.2093023255813,38,5,20,34.7734375,0.631578947368421,43.58974358974359,1025.6410256410259,26.990553306342786,5
4628,4,0,0,43,0.0,0.0,1.0,43,1100,700,400,0.6363636363636364,15,7,8,341.38855592337603,0.7550295311923219,0.1310531236225012,0.2011050867470095,131547.23340821092,381.7440097888759,131928.9774179998,2362,15,754.2093023255813,38,5,20,34.78094841352497,0.6321271929824561,43.53632478632478,1025.8547008547002,26.996176338281586,0
4629,4,1,0,44,0.022727272727272728,0.0,1.0,44,950,800,150,0.8421052631578947,11,8,3,335.2387662188632,0.7617380197322058,0.13318075799061502,0.1992639827416643,131889.27001953125,42.8792317708338,131932.1492513021,2363,0,738.0454545454545,39,5,16,34.59429824561404,0.6338141025641025,43.203125,1027.1875,26.338141025641026,0
4630,4,0,0,44,0.0,0.0,1.0,44,700,600,100,0.8571428571428571,8,6,2,334.6332435600618,0.7614517265680056,0.13760104338528723,0.19918453115467052,131942.7747938369,30.487738715287605,131973.26253255218,2364,1,739.0454545454545,39,5,16,34.556021663456,0.6343482905982906,43.15104166666667,1027.3958333333342,26.343482905982928,0
4631,4,0,1,43,0.0,0.022727272727272728,0.9772727272727273,44,1000,700,300,0.7,13,7,6,334.8132767447882,0.7599982381959126,0.13335514070361043,0.19971389288779196,132023.05230034713,40.614149305550285,132063.6664496527,2365,2,740.0454545454545,39,5,17,34.47065680113521,0.6351495726495726,43.072916666666664,1027.7083333333328,26.351495726495713,0
4632,4,0,0,43,0.0,0.0,1.0,43,1500,1000,500,0.6666666666666666,20,10,10,340.5708437448383,0.7535529715762274,0.13637595916972156,0.20300491683038238,131996.2904188367,390.8175998263791,132387.10801866307,2366,3,757.8372093023256,39,4,18,34.349657881398876,0.6348824786324787,43.09895833333333,1027.6041666666658,26.348824786324766,0
4633,4,0,0,43,0.0,0.0,1.0,43,850,400,450,0.47058823529411764,13,4,9,342.27120756254817,0.7529992617201919,0.14471855045828308,0.20474041325105152,132130.126953125,444.86762152777794,132574.99457465278,2367,4,758.8372093023256,39,4,18,34.171310368118874,0.6362179487179487,42.96875,1028.125,26.362179487179485,0
4634,4,0,0,43,0.0,0.0,1.0,43,1350,1100,250,0.8148148148148148,16,11,5,340.7204628839894,0.7526762643041712,0.14607307893410515,0.20439087791716332,132237.24500868042,411.1870659722115,132648.43207465264,2368,5,759.8372093023256,39,4,18,34.10345351427993,0.6372863247863249,42.86458333333333,1028.5416666666656,26.372863247863222,0
4635,4,0,0,43,0.0,0.0,1.0,43,1350,1000,350,0.7407407407407407,17,10,7,342.3670568141133,0.7538298265042451,0.13688891399892178,0.2061087235994287,132371.20361328125,463.9078776041662,132835.1114908854,2369,6,760.8372093023256,39,4,18,33.92644751493065,0.6386217948717949,42.734375,1029.0625,26.38621794871795,0
4636,4,0,0,43,0.0,0.0,1.0,43,1000,800,200,0.8,12,8,4,343.3143731628786,0.7533684016242156,0.136329064688671,0.20698086197045198,132426.21678064385,492.77014622285253,132918.9869268667,2370,7,761.8372093023256,37,6,18,33.846787223465064,0.6427364864864865,42.68092105263157,1029.2763157894722,27.81827880512087,0
4637,4,0,0,43,0.0,0.0,1.0,43,950,600,350,0.631578947368421,13,6,7,341.91723962400033,0.7538759689922481,0.1336887268259328,0.20629299778856766,132454.43309479824,457.6908279470398,132912.1239227453,2371,8,762.8372093023256,37,6,18,33.85438858116745,0.6430180180180181,42.653508771929815,1029.3859649122794,27.82124229492647,0
4638,4,1,2,42,0.022727272727272728,0.045454545454545456,0.9545454545454546,44,650,500,150,0.7692307692307693,8,5,3,337.1280548970128,0.7612975687103595,0.1301939972097581,0.2047394811981608,132700.54879830524,147.41558002775957,132847.964378333,2372,0,746.4772727272727,38,6,15,33.73060106456519,0.643640350877193,42.414529914529915,1030.3418803418806,27.114260008996858,0
4639,4,0,0,42,0.0,0.0,1.0,42,1400,1000,400,0.7142857142857143,18,10,8,352.2545610316265,0.7488627564847077,0.15297195969694588,0.213194438162424,132571.90626014545,939.8117289587058,133511.71798910416,2373,10,782.4047619047619,36,6,18,33.47024785857481,0.6461226851851851,42.53941441441442,1029.8423423423437,28.60673173173177,0
4640,4,0,0,42,0.0,0.0,1.0,42,650,400,250,0.6153846153846154,9,4,5,350.2304192346203,0.7494192799070848,0.15670908141909523,0.212741774372833,132708.5151801516,895.7117815096931,133604.22696166128,2374,11,783.4047619047619,37,5,16,33.385100741371375,0.6455518018018017,42.406798245614034,1030.372807017544,27.84791370317686,0
4641,4,0,0,42,0.0,0.0,1.0,42,1150,700,450,0.6086956521739131,16,7,9,347.5810794105004,0.7485965931087882,0.15787647115447934,0.21145078093069866,132765.01092884355,829.321161318869,133594.3320901624,2375,12,784.4047619047619,37,5,16,33.3966157747278,0.6461148648648647,42.35197368421053,1030.5921052631584,27.853840682788064,0
4642,4,0,0,42,0.0,0.0,1.0,42,700,500,200,0.7142857142857143,9,5,4,346.92652511485613,0.7482336430507163,0.15319870304842853,0.21146519525162652,132838.1835438126,817.0178838848783,133655.20142769747,2376,13,785.4047619047619,38,4,16,33.340026600338554,0.6450109649122806,42.28098290598291,1030.8760683760688,27.128317588843917,0
4643,4,0,0,42,0.0,0.0,1.0,42,850,700,150,0.8235294117647058,10,7,3,348.0036355475588,0.7499274099883856,0.15644144544082383,0.2129041253216816,132975.889628534,855.2186061801592,133831.10823471416,2377,14,786.4047619047619,38,4,17,33.17407292314068,0.6463815789473684,42.147435897435905,1031.4102564102575,27.142375168690986,0
4644,4,0,0,42,0.0,0.0,1.0,42,900,500,400,0.5555555555555556,13,5,8,346.16542622463544,0.7488869531552458,0.1539952075259592,0.21240569799730194,133086.1058605451,813.9617119585193,133900.0675725036,2378,15,787.4047619047619,38,4,17,33.11093566645958,0.6474780701754386,42.0405982905983,1031.8376068376078,27.15362123256863,0
4645,4,0,0,42,0.0,0.0,1.0,42,700,500,200,0.7142857142857143,9,5,4,347.9668994251763,0.7488385598141696,0.14998521147589483,0.21382698781470774,133141.23109796204,865.7482741617541,134006.97937212378,2379,16,788.4047619047619,38,4,17,33.009187370600415,0.6480263157894736,41.987179487179496,1032.0512820512834,27.159244264507457,0
4646,4,0,0,42,0.0,0.0,1.0,42,900,500,400,0.5555555555555556,13,5,8,348.2052853356211,0.7484514130855594,0.14773533585619636,0.21460815545175016,133251.51581561842,879.7764171962898,134131.2922328147,2380,17,789.4047619047619,38,4,17,32.89247895971302,0.6491228070175439,41.88034188034188,1032.4786324786328,27.170490328385075,0
4647,4,0,0,42,0.0,0.0,1.0,42,1000,800,200,0.8,12,8,4,351.55840780930976,0.7480642663569493,0.14743684443787775,0.21764211290115415,133417.02849916002,980.7756227628065,134397.80412192282,2381,18,790.4047619047619,38,4,18,32.64003791795932,0.6507675438596492,41.72008547008547,1033.1196581196589,27.18735942420155,0
4648,4,1,0,43,0.023255813953488372,0.0,1.0,43,1050,800,250,0.7619047619047619,13,8,5,343.9145869894962,0.7536913990402362,0.1572374015602469,0.21503208272007227,133783.99032635018,602.0759843271446,134386.06631067733,2382,0,773.0,37,6,16,32.47030118353648,0.6562500000000002,41.365131578947356,1034.5394736842086,27.960526315789423,0
4649,4,0,0,43,0.0,0.0,1.0,43,900,600,300,0.6666666666666666,12,6,6,345.93146801332773,0.75281469176818,0.15554126853925143,0.21729467661435922,133954.19894823368,667.7945377423398,134621.993485976,2383,1,774.0,37,6,16,32.247974261201136,0.6579391891891895,41.20065789473682,1035.1973684210495,27.978307254622962,0
4650,4,0,0,43,0.0,0.0,1.0,43,1600,1400,200,0.875,18,14,4,341.7507437937172,0.7522609819121446,0.15530584729945662,0.21540518272667666,134080.10651800677,564.3952260939027,134644.50174410068,2384,2,775.0,38,5,16,32.23041744034109,0.6573464912280704,41.07905982905981,1035.6837606837576,27.254835807467305,0
4651,4,0,0,43,0.0,0.0,1.0,43,800,400,400,0.5,12,4,8,339.86444235206227,0.7511535622000738,0.1511939647110172,0.21486345253782865,134190.77932098726,521.3348765431658,134712.11419753043,2385,3,776.0,38,5,16,32.16878909740838,0.6584429824561406,40.9722222222222,1036.111111111108,27.266081871344944,0
4652,4,0,0,43,0.0,0.0,1.0,43,1500,1000,500,0.6666666666666666,20,10,10,339.72715335862995,0.7513842746400886,0.14731174755103593,0.2156227442745585,134334.72222222187,527.4305555555177,134862.15277777737,2386,4,777.0,39,4,16,32.02873794212218,0.6581196581196583,40.833333333333314,1036.6666666666638,26.581196581196508,0
4653,4,0,0,43,0.0,0.0,1.0,43,850,600,250,0.7058823529411765,11,6,5,331.498298831167,0.7513842746400886,0.11130506597593715,0.2043414886824955,133257.03125,235.06944444444477,133492.10069444444,2387,5,778.0,39,4,17,33.3182001614205,0.6474358974358976,41.875,1032.5,26.474358974358974,3
4654,4,0,0,43,0.0,0.0,1.0,43,1600,1100,500,0.6875,21,11,10,321.62317377296796,0.7513842746400886,0.09422860166080049,0.19149648332418778,131953.8686049972,-112.11559752791146,131841.7530074693,2388,6,779.0,40,3,15,34.87903890537421,0.6328125,43.14024390243903,1027.4390243902453,25.685975609756134,3
4655,4,1,1,43,0.022727272727272728,0.022727272727272728,0.9772727272727273,44,1050,800,250,0.7619047619047619,13,8,5,318.0360050633649,0.7570251937984497,0.09977257737080603,0.19058814916643094,132198.62768350763,-391.21531533561546,131807.41236817202,2389,0,762.2727272727273,42,2,15,34.72549389113979,0.6321924603174602,42.90213178294574,1028.3914728682173,24.48551125876708,0
4656,4,1,0,44,0.022727272727272728,0.0,1.0,44,950,500,450,0.5263157894736842,14,5,9,318.41418493048457,0.7575096899224807,0.11012636012636046,0.19157168440661843,132348.1454408539,-371.69462847785996,131976.45081237605,2390,0,763.25,42,2,17,34.56579401701354,0.6336805555555556,42.75678294573643,1028.972868217054,24.49935400516795,0
4657,4,0,0,44,0.0,0.0,1.0,44,350,300,50,0.8571428571428571,4,3,1,318.41418493048457,0.7575096899224807,0.11012636012636046,0.19157168440661843,132348.1454408539,-371.69462847785996,131976.45081237605,2391,1,764.25,42,2,17,34.56579401701354,0.6336805555555556,42.75678294573643,1028.972868217054,24.49935400516795,0
4658,4,1,0,45,0.022222222222222223,0.0,1.0,45,1050,600,450,0.5714285714285714,15,6,9,315.0609211147726,0.7671296296296297,0.1145620059262118,0.19148846036390507,132730.03595245944,-636.3717437247269,132093.6642087347,2392,0,748.2444444444444,41,4,14,34.269499534674765,0.6389735772357724,42.38591269841269,1030.4563492063473,25.13308168795969,0
4659,4,0,0,45,0.0,0.0,1.0,45,950,800,150,0.8421052631578947,11,8,3,312.63307777774753,0.7670454545454546,0.11027754274910473,0.19035363756851134,132797.2057437201,-696.6401696112202,132100.56557410886,2393,1,749.2444444444444,42,3,15,34.26483030929774,0.6381448412698414,42.32073643410852,1030.717054263564,24.54088224437057,0
4660,4,0,1,44,0.0,0.022222222222222223,0.9777777777777777,45,1000,500,500,0.5,15,5,10,312.2015399193614,0.7660353535353536,0.11172920712480994,0.19072610722283798,132922.07969022266,-700.3044062857011,132221.77528393696,2394,2,750.2444444444444,42,3,16,34.151044603144776,0.6393849206349207,42.199612403100765,1031.2015503875948,24.552417866371304,0
4661,4,0,0,44,0.0,0.0,1.0,44,1150,900,250,0.782608695652174,14,9,5,319.0705821770193,0.7591613812544046,0.11242902511789055,0.19445527386518474,132832.2834486801,-323.42519762537927,132508.8582510547,2395,3,768.2045454545455,41,3,16,34.063833285214756,0.6399898373983741,42.286706349206334,1030.8531746031722,25.142760356174932,0
4662,4,0,1,43,0.0,0.022727272727272728,0.9772727272727273,44,1000,700,300,0.7,13,7,6,319.0720522270643,0.7583245243128964,0.11410875498635331,0.19458901213284305,132857.85147392255,-321.75453514742753,132536.09693877512,2396,4,769.2045454545455,41,3,16,34.03820246343339,0.6402439024390245,42.261904761904745,1030.9523809523782,25.145180023228736,0
4663,4,0,0,43,0.0,0.0,1.0,43,650,400,250,0.6153846153846154,9,4,5,326.49425177767387,0.7537836840162421,0.12152372478288753,0.19861896864291465,132764.32188388176,69.35758724963642,132833.67947113139,2397,5,787.3255813953489,40,3,17,33.94060414817735,0.6408854166666667,42.352642276422756,1030.5894308943075,25.76473577235769,0
4664,4,0,0,43,0.0,0.0,1.0,43,600,400,200,0.6666666666666666,8,4,4,325.15950489832005,0.7534145441122185,0.11770074248003914,0.19794524001673225,132790.50684942814,35.619092471399085,132826.12594189955,2398,6,788.3255813953489,40,3,17,33.94876092815353,0.6411458333333334,42.32723577235772,1030.6910569105682,25.767276422764205,0
4665,4,0,0,43,0.0,0.0,1.0,43,1150,900,250,0.782608695652174,14,9,5,325.02931252385036,0.7535529715762274,0.11939436312996432,0.19828156196960078,132869.0772378379,37.26896605856115,132906.34620389645,2399,7,789.3255813953489,40,3,17,33.87341876129455,0.6419270833333334,42.2510162601626,1030.9959349593494,25.774898373983735,0
4666,4,0,0,43,0.0,0.0,1.0,43,1550,1200,350,0.7741935483870968,19,12,7,326.131666782933,0.7550295311923219,0.11676490269591433,0.19937253942850638,132947.67086390383,71.68909875075224,133019.3599626546,2400,8,790.3255813953489,40,3,17,33.76630042044409,0.6427083333333332,42.174796747967484,1031.3008130081307,25.78252032520327,0
4667,4,1,1,43,0.022727272727272728,0.022727272727272728,0.9772727272727273,44,1000,800,200,0.8,12,8,4,319.1213387451461,0.7627951021846371,0.10873440285205027,0.19622567424967488,133164.85969387754,-300.8503401360525,132864.00935374148,2401,0,773.3409090909091,41,3,18,33.729815455594014,0.6432926829268293,41.964285714285715,1032.142857142857,25.174216027874564,0
4668,4,0,0,43,0.0,0.0,1.0,43,550,200,350,0.36363636363636365,9,2,7,322.3672007199525,0.7541989664082687,0.10687641870085329,0.1977639993298903,133078.71187991634,-19.957635170836397,133058.7542447455,2402,10,792.3255813953489,40,3,18,33.73223021110345,0.6440104166666666,42.04776422764229,1031.8089430894331,25.795223577235827,0
4669,4,0,0,43,0.0,0.0,1.0,43,750,600,150,0.8,9,6,3,322.147269652417,0.7532761166482096,0.1100123411280105,0.19818593687823174,133183.59116803855,-19.053948542505225,133164.53721949604,2403,11,793.3255813953489,40,3,18,33.63300351153555,0.6450520833333332,41.94613821138213,1032.215447154474,25.805386178861852,0
4670,4,0,0,43,0.0,0.0,1.0,43,1000,800,200,0.8,12,8,4,319.64340680408424,0.7535068290882244,0.10230055592299325,0.19708818590147592,133267.27450239373,-80.39887251194716,133186.87562988178,2404,12,794.3255813953489,41,2,18,33.613966820394566,0.6443089430894308,41.865079365079374,1032.539682539684,25.183894696089855,0
4671,4,0,0,43,0.0,0.0,1.0,43,950,900,50,0.9473684210526315,10,9,1,318.53286655158433,0.7532761166482096,0.10062401276176502,0.19653874380174538,133292.88435571,-108.36709104936557,133184.51726466065,2405,13,795.3255813953489,41,2,18,33.61704214301729,0.6445630081300813,41.840277777777786,1032.6388888888898,25.186314363143655,0
4672,4,0,0,43,0.0,0.0,1.0,43,1500,1100,400,0.7333333333333333,19,11,8,320.20650181986423,0.7541528239202657,0.057833960564830145,0.19223785358366974,132267.29811124355,-109.05504042545834,132158.2430708181,2406,14,796.3255813953489,40,3,16,34.60078706448002,0.6359374999999998,42.83536585365855,1028.658536585368,25.716463414634198,4
4673,4,0,0,43,0.0,0.0,1.0,43,1600,1300,300,0.8125,19,13,6,321.4416228884312,0.7527224067921742,0.06076282010052059,0.19324673338019496,132319.57250974973,-93.39637451250258,132226.17613523724,2407,15,797.3255813953489,40,3,16,34.516577768997756,0.6364583333333332,42.78455284552847,1028.8617886178881,25.7215447154472,0
4674,4,0,0,43,0.0,0.0,1.0,43,800,500,300,0.625,11,5,6,321.3672422197749,0.75281469176818,0.029897040252929052,0.1889998955991823,131484.42147531232,-149.01957746710877,131335.4018978452,2408,16,798.3255813953489,40,3,18,35.35762650284056,0.628125,43.59756097560976,1025.609756097561,25.64024390243903,5
4675,4,0,0,43,0.0,0.0,1.0,43,1050,600,450,0.5714285714285714,15,6,9,320.5190943487683,0.7527224067921742,0.029912836767036044,0.18901640049913346,131588.6707647564,-164.66368398440812,131424.007080772,2409,17,799.3255813953489,40,3,13,35.274489896988904,0.6291666666666667,43.49593495934959,1026.0162601626014,25.650406504065035,0
4676,4,0,0,43,0.0,0.0,1.0,43,1450,800,650,0.5517241379310345,21,8,13,321.829121947922,0.751937984496124,0.023985651892628468,0.19043913068517632,131719.04047070196,-121.7953722982391,131597.2450984037,2410,18,800.3255813953489,40,3,15,35.10976635976634,0.63046875,43.36890243902439,1026.5243902439024,25.663109756097562,0
4677,4,0,0,43,0.0,0.0,1.0,43,800,600,200,0.75,10,6,4,323.589151510905,0.7494924326319675,0.032594038080071996,0.19213818831781473,131849.4747256924,-66.98806927093568,131782.48665642145,2411,19,801.3255813953489,40,3,16,34.93345537304571,0.6317708333333334,43.24186991869919,1027.0325203252034,25.675813008130085,0
4678,4,0,0,43,0.0,0.0,1.0,43,850,600,250,0.7058823529411765,11,6,5,324.4320264765388,0.7495385751199705,0.031092112165358676,0.19290346609557954,131901.66650142102,-41.37500826228438,131860.29149315873,2412,20,802.3255813953489,40,3,17,34.8593523281889,0.6322916666666667,43.1910569105691,1027.235772357723,25.680894308943074,0
4679,4,0,0,43,0.0,0.0,1.0,43,950,600,350,0.631578947368421,13,6,7,327.66108978178613,0.7494001476559615,0.035822048866647194,0.19536019692649859,132006.0810364199,50.65127404320697,132056.7323104631,2413,21,803.3255813953489,40,3,18,34.67147118934599,0.6333333333333334,43.08943089430893,1027.6422764227625,25.691056910569063,0
4680,4,0,0,43,0.0,0.0,1.0,43,600,500,100,0.8333333333333334,7,5,2,332.3962790819847,0.748892580287929,0.04507250774733995,0.19873054132348442,132110.5368828078,182.61017747372046,132293.1470602815,2414,22,804.3255813953489,40,3,19,34.444815144325815,0.6343750000000001,42.98780487804878,1028.0487804878044,25.70121951219511,0
4681,4,1,0,44,0.022727272727272728,0.0,1.0,44,1300,1000,300,0.7692307692307693,16,10,6,324.61690033513,0.7566948555320648,0.051126267611953935,0.1959695590223401,132476.45767235113,-198.8681712274421,132277.58950112367,2415,0,787.0227272727273,40,4,20,34.27751727541954,0.6380208333333333,42.63211382113821,1029.4715447154472,25.73678861788618,0
4682,4,0,0,44,0.0,0.0,1.0,44,1000,800,200,0.8,12,8,4,323.5104309184107,0.7565186751233263,0.06260652708254799,0.19584556194308103,132581.09941998817,-221.72627900059305,132359.37314098756,2416,1,788.0227272727273,40,4,20,34.20108052101836,0.6390625,42.53048780487805,1029.8780487804881,25.746951219512205,0
4683,4,0,0,44,0.0,0.0,1.0,44,800,300,500,0.375,13,3,10,320.9599562252445,0.7572013742071881,0.0593527760589021,0.1947080237136627,132659.60784131466,-284.31561487871096,132375.29222643594,2417,2,789.0227272727273,40,4,16,34.18808161520503,0.63984375,42.454268292682926,1030.182926829268,25.754573170731696,0
4684,4,0,0,44,0.0,0.0,1.0,44,1100,1000,100,0.9090909090909091,12,10,2,318.0212639731344,0.756496652572234,0.055346591469483286,0.19319458330878445,132711.95969867482,-358.95496645514675,132353.00473221968,2418,3,790.0227272727273,40,4,16,34.211337410000986,0.6403645833333333,42.40345528455285,1030.3861788617892,25.759654471544728,0
4685,4,0,1,43,0.0,0.022727272727272728,0.9772727272727273,44,1200,900,300,0.75,15,9,6,321.2028166789979,0.7564085623678647,0.06222159483029066,0.1956732834579626,132816.6943969364,-267.78073154206515,132548.91366539433,2419,4,791.0227272727273,40,4,16,34.02449143908771,0.64140625,42.301829268292686,1030.7926829268297,25.769817073170742,0
4686,4,1,1,43,0.022727272727272728,0.022727272727272728,0.9772727272727273,44,1650,1300,350,0.7878787878787878,20,13,7,323.2919727215666,0.7567609231853418,0.07385708797541302,0.19988812470171896,133369.72867850823,-174.91373671499144,133194.81494179324,2420,0,791.9090909090909,41,3,15,33.417370982200026,0.6453252032520326,41.765873015873005,1032.9365079365064,25.193573364305035,1
4687,4,0,0,43,0.0,0.0,1.0,43,750,500,250,0.6666666666666666,10,5,5,330.4465171430344,0.7484311554078996,0.06782640542025264,0.203721881927987,133262.2777447285,207.21110945863546,133469.48885418713,2421,29,811.3255813953489,40,3,15,33.340100065616795,0.6458333333333335,41.86991869918698,1032.5203252032506,25.813008130081265,0
4688,4,0,0,43,0.0,0.0,1.0,43,1300,900,400,0.6923076923076923,17,9,8,336.06077728630555,0.7465854558877815,0.06553079347940471,0.20806296357445703,133419.72061107805,367.42700277612727,133787.14761385418,2422,30,812.3255813953489,40,3,16,33.037617220801366,0.6473958333333333,41.71747967479675,1033.1300813008131,25.82825203252033,0
4689,4,0,0,43,0.0,0.0,1.0,43,1450,1100,350,0.7586206896551724,18,11,7,337.56647880730355,0.7454780361757105,0.064187776640378,0.21022962560470307,133637.87187705468,422.35382466215856,134060.22570171684,2423,31,813.3255813953489,38,5,16,32.780533168009924,0.6529605263157894,41.50641025641026,1033.97435897436,27.20985155195684,0
4690,4,0,0,43,0.0,0.0,1.0,43,1450,1000,450,0.6896551724137931,19,10,9,338.5840131808263,0.745108896271687,0.07528601481225272,0.21181185940847055,133803.62426035517,460.7536160420932,134264.37787639725,2424,32,814.3255813953489,38,5,15,32.58854812061132,0.6546052631578947,41.346153846153854,1034.6153846153857,27.226720647773305,0
4691,4,0,0,43,0.0,0.0,1.0,43,1150,900,250,0.782608695652174,14,9,5,332.5099415936056,0.7461701734957549,0.07741953600696405,0.20888013903648908,133957.03667534745,308.4092881944685,134265.44596354192,2425,33,815.3255813953489,39,4,15,32.59249010531965,0.6543803418803418,41.19791666666668,1035.208333333335,26.543803418803464,0
4692,4,0,0,43,0.0,0.0,1.0,43,1300,900,400,0.6923076923076923,17,9,8,328.25049073594556,0.746077888519749,0.0797896849250026,0.20696224663205517,134091.86333550364,203.14398871529704,134295.00732421895,2426,34,816.3255813953489,39,4,15,32.56824315263671,0.6557158119658119,41.06770833333334,1035.729166666668,26.55715811965816,0
4693,4,0,0,43,0.0,0.0,1.0,43,1100,700,400,0.6363636363636364,15,7,8,360.2482840083353,0.746077888519749,0.0750375859728456,0.2044393738360474,130107.01844346951,774.1660263401443,130881.18446980965,2427,35,817.3255813953489,40,3,15,35.75576086595611,0.6143229166666667,44.94410569105691,1020.2235772357725,25.50558943089431,8
4694,4,1,0,44,0.022727272727272728,0.0,1.0,44,1550,1300,250,0.8387096774193549,18,13,5,353.1278356453186,0.7562984496124031,0.08256516211061671,0.2019891219891219,130414.5408163263,410.6009070294564,130825.14172335576,2428,0,799.7272727272727,41,3,16,35.625485625485624,0.6158536585365855,44.64285714285713,1021.4285714285696,24.912891986062675,0
4695,4,0,1,43,0.0,0.022727272727272728,0.9772727272727273,44,1100,800,300,0.7272727272727273,14,8,6,333.796020887038,0.7575757575757576,0.035661492978566134,0.19550909794812238,131328.12500000015,-32.63888888887318,131295.48611111127,2429,1,800.7272727272727,42,2,14,35.19647696476966,0.6235119047619047,43.75000000000001,1025.0000000000011,24.404761904761934,2
4696,4,2,1,44,0.044444444444444446,0.022222222222222223,0.9777777777777777,45,1050,600,450,0.5714285714285714,15,6,9,326.00726582370226,0.7616161616161616,0.05452981771652676,0.1929453058176705,131725.712284418,-411.29213989544724,131314.42014452256,2430,0,783.8666666666667,42,3,14,34.995830973507,0.6274801587301587,43.36240310077519,1026.550387596899,24.441675895164263,0
4697,4,0,0,44,0.0,0.0,1.0,44,1150,1000,150,0.8695652173913043,13,10,3,332.1951894673608,0.7535676532769556,0.05367395278185416,0.19647926532818275,131700.84547390477,-49.922536956918975,131650.92293694784,2431,1,802.6818181818181,42,2,14,34.86205513074673,0.6272321428571428,43.38662790697674,1026.4534883720928,24.439368770764116,0
4698,4,1,1,44,0.022222222222222223,0.022222222222222223,0.9777777777777777,45,1100,500,600,0.45454545454545453,17,5,12,326.43892326032665,0.7583333333333334,0.05852179613241559,0.19414525436008903,131911.15702479336,-387.8127869605189,131523.34423783285,2432,0,785.8222222222222,43,2,14,34.798273107177984,0.627906976744186,43.18181818181818,1027.272727272727,23.89006342494714,0
4699,4,0,0,44,0.0,0.0,1.0,44,1150,800,350,0.6956521739130435,15,8,7,328.8570863744565,0.7525766384778013,0.0582528435896994,0.19514151183630948,131825.20300012012,-129.6695661318494,131695.53343398828,2433,3,804.6818181818181,42,2,14,34.822608039252685,0.6284722222222223,43.26550387596899,1026.9379844961236,24.450904392764848,0
4700,4,0,0,44,0.0,0.0,1.0,44,1300,1200,100,0.9230769230769231,14,12,2,323.6803731352097,0.755043164200141,0.06403672713555775,0.19282621779358208,131974.50949462163,-256.48830448892477,131718.0211901327,2434,4,805.6818181818181,42,2,14,34.80545863196279,0.6299603174603174,43.120155038759684,1027.5193798449604,24.464747139165723,0
4701,4,0,0,44,0.0,0.0,1.0,44,1050,800,250,0.7619047619047619,13,8,5,322.5986705158918,0.7542283298097252,0.06315987933634992,0.19268731401084335,132074.09410492147,-278.6145664323169,131795.47953848916,2435,5,806.6818181818181,42,2,14,34.73322021116138,0.630952380952381,43.02325581395348,1027.9069767441852,24.473975636766312,0
4702,4,0,0,44,0.0,0.0,1.0,44,750,500,250,0.6666666666666666,10,5,5,322.05023180664875,0.7538979915433404,0.06044186684028441,0.19286665123770608,132173.71627306036,-286.6848071029487,131887.0314659574,2436,6,807.6818181818181,42,2,14,34.64729394396283,0.6319444444444444,42.92635658914728,1028.2945736434096,24.483204134366897,0
4703,4,0,0,44,0.0,0.0,1.0,44,800,600,200,0.75,10,6,4,322.13171622112446,0.7531712473572939,0.062409540530124596,0.19329723955269826,132248.45754649641,-279.7154805901295,131968.7420659063,2437,7,808.6818181818181,42,2,14,34.57018370230804,0.6326884920634921,42.853682170542626,1028.585271317828,24.490125507567335,0
4704,4,0,0,44,0.0,0.0,1.0,44,750,500,250,0.6666666666666666,10,5,5,323.01824065592666,0.7533254052149402,0.06637922175789557,0.1939571064934001,132273.3759990383,-254.6573598341684,132018.71863920413,2438,8,809.6818181818181,42,2,14,34.52237974127103,0.6329365079365081,42.829457364341074,1028.682170542634,24.492432631967475,0
4705,4,0,0,44,0.0,0.0,1.0,44,1050,600,450,0.5714285714285714,15,6,9,320.38184882028986,0.7527748414376322,0.06171827513290906,0.19275551572932892,132348.14544085378,-319.6112951445413,132028.53414570924,2439,9,810.6818181818181,42,2,14,34.51517719810402,0.6336805555555556,42.756782945736425,1028.972868217053,24.49935400516793,0
4706,4,0,0,44,0.0,0.0,1.0,44,900,600,300,0.6666666666666666,12,6,6,320.77234506384303,0.752422480620155,0.0650533676849463,0.19324577861163222,132398.00347222216,-306.06699942913036,132091.93647279302,2440,10,811.6818181818181,41,3,14,34.45512820512819,0.6356707317073171,42.70833333333333,1029.166666666666,25.10162601626015,0
4707,4,1,1,44,0.022222222222222223,0.022222222222222223,0.9777777777777777,45,700,500,200,0.7142857142857143,9,5,4,315.7088178067239,0.7578703703703704,0.06321972428641587,0.19146037889921744,132647.43447096032,-624.4070556156471,132023.02741534467,2441,0,794.6222222222223,42,3,14,34.33551249490483,0.636656746031746,42.46608527131783,1030.135658914729,24.52703949796974,0
4708,4,0,0,44,0.0,0.0,1.0,44,1200,1000,200,0.8333333333333334,14,10,4,322.12903872498237,0.7530831571529246,0.055044666316342195,0.1948542786693076,132551.1975623583,-260.2820294784566,132290.91553287985,2442,12,813.6818181818181,41,3,14,34.266618497109825,0.6371951219512194,42.55952380952381,1029.761904761905,25.11614401858305,0
4709,4,0,0,44,0.0,0.0,1.0,44,1200,900,300,0.75,15,9,6,322.10868445231625,0.7520260747004933,0.051933043843675586,0.19537246374724593,132653.37616528093,-254.23910304862244,132399.1370622323,2443,13,814.6818181818181,41,3,14,34.16474062660505,0.6382113821138211,42.46031746031746,1030.1587301587304,25.1258226867983,0
4710,4,1,0,45,0.022222222222222223,0.0,1.0,45,750,400,350,0.5333333333333333,11,4,7,317.11959260638395,0.7572811447811448,0.055105598880850426,0.19386007031072627,132947.06152161834,-567.976402409705,132379.08511920864,2444,0,797.5555555555555,42,3,15,33.99926399198223,0.6396329365079365,42.17538759689923,1031.2984496124034,24.554724990771508,0
4711,4,0,0,45,0.0,0.0,1.0,45,850,500,350,0.5882352941176471,12,5,7,314.1994258976167,0.7572811447811448,0.053755023224257625,0.19233196599655727,132997.03222650383,-642.4817656691316,132354.5504608347,2445,1,798.5555555555555,42,3,15,34.02458118052294,0.6401289682539684,42.126937984496124,1031.4922480620155,24.5593392395718,0
4712,4,0,0,45,0.0,0.0,1.0,45,1000,700,300,0.7,13,7,6,313.842036768703,0.7571969696969697,0.046794390182819834,0.1924994243959186,133072.00588906906,-647.2821269755527,132424.7237620935,2446,2,799.5555555555555,42,3,15,33.95884203606311,0.6408730158730158,42.05426356589147,1031.7829457364332,24.56626061277222,0
4713,4,0,0,45,0.0,0.0,1.0,45,950,600,350,0.631578947368421,13,6,7,313.69204050612785,0.7567340067340068,0.04463637501564666,0.1929242272212051,133172.00363559872,-645.0004882519172,132527.0031473468,2447,3,800.5555555555555,42,3,16,33.86277224934285,0.6418650793650793,41.95736434108527,1032.1705426356582,24.575489110372814,0
4714,4,1,0,46,0.021739130434782608,0.0,1.0,46,900,600,300,0.6666666666666666,12,6,6,310.5489073881374,0.7605676328502415,0.05434782608695654,0.1925403225806452,133472.22222222228,-910.069444444434,132562.15277777784,2448,0,784.1304347826087,43,3,18,33.64415322580646,0.6434108527131782,41.66666666666667,1033.333333333334,24.031007751938,0
4715,4,0,0,46,0.0,0.0,1.0,46,1050,800,250,0.7619047619047619,13,8,5,309.7536967320852,0.7588969404186796,0.058977097183103844,0.19243696465003826,133547.32968458944,-926.6441882999663,132620.68549628946,2449,1,785.1304347826087,42,4,18,33.589770632167735,0.6455853174603174,41.59399224806202,1033.6240310077533,24.610095976375078,0
4716,4,0,0,46,0.0,0.0,1.0,46,1150,900,250,0.782608695652174,14,9,5,308.0452776068155,0.7589371980676328,0.05948059144450801,0.19189440498203916,133647.50583085456,-966.103392975181,132681.40243787938,2450,2,786.1304347826087,42,4,18,33.53403304907381,0.6465773809523809,41.497093023255815,1034.011627906977,24.619324473975645,0
4717,4,0,0,46,0.0,0.0,1.0,46,950,600,350,0.631578947368421,13,6,7,306.9833275904966,0.759219001610306,0.0547399166527478,0.19149228844964195,133697.60798817693,-991.4126817799315,132706.19530639698,2451,3,787.1304347826087,42,4,18,33.511547830975346,0.6470734126984127,41.44864341085272,1034.2054263565901,24.623938722775954,0
4718,4,0,0,46,0.0,0.0,1.0,46,1450,1200,250,0.8275862068965517,17,12,5,309.77803859226464,0.7586553945249598,0.049457081553801574,0.19402461431828688,133847.97079690205,-907.3676273962,132940.60316950586,2452,4,788.1304347826087,42,4,14,33.289438773917674,0.6485615079365079,41.303294573643406,1034.7868217054252,24.63778146917679,0
4719,4,1,1,46,0.02127659574468085,0.02127659574468085,0.9787234042553191,47,1300,1000,300,0.7692307692307693,16,10,6,308.33698184212386,0.7631822386679,0.06242172002022661,0.19475788575940137,134158.0757862716,-1126.82076446283,133031.25502180876,2453,0,772.3404255319149,43,4,15,33.01797684338817,0.6501937984496124,41.00378787878787,1035.984848484847,24.09267089499644,0
4720,4,0,0,46,0.0,0.0,1.0,46,1050,700,350,0.6666666666666666,14,7,7,312.89884682585455,0.7581320450885668,0.04765284086980914,0.19759016960515105,134148.94992976668,-804.9896528153549,133343.96027695131,2454,6,790.1304347826087,42,4,16,32.908910921959276,0.6515376984126985,41.012596899224796,1035.9496124030993,24.665466961978556,0
4721,4,0,0,46,0.0,0.0,1.0,46,1350,800,550,0.5925925925925926,19,8,11,325.8285768272218,0.7583132045088568,0.06948859653412898,0.2025605627967832,133572.370200108,-487.4897654888697,133084.88043461915,2455,7,791.1304347826087,42,4,17,33.1493719535058,0.6458333333333335,41.569767441860456,1033.7209302325568,24.61240310077516,4
4722,4,0,1,45,0.0,0.021739130434782608,0.9782608695652174,46,950,700,250,0.7368421052631579,12,7,5,322.33452461034176,0.7573268921095009,0.06655787933977919,0.20079578004185347,133647.50583085424,-584.1589485307658,133063.34688232347,2456,8,792.1304347826087,42,4,17,33.164651860181806,0.6465773809523812,41.4970930232558,1034.0116279069744,24.61932447397558,0
4723,4,0,0,45,0.0,0.0,1.0,45,1150,600,550,0.5217391304347826,17,6,11,329.004015341671,0.7522306397306397,0.06922207290800131,0.20426482907208138,133523.4837569286,-214.04754031243198,133309.43621661616,2457,9,810.4666666666667,41,4,17,33.116161131375186,0.646849593495935,41.61706349206349,1033.5317460317451,25.20809136662793,0
4724,4,0,0,45,0.0,0.0,1.0,45,800,500,300,0.625,11,5,6,328.46451781498337,0.7517676767676769,0.07023066833029423,0.2040710680449798,133549.11821499432,-226.7706561791365,133322.34755881518,2458,10,811.4666666666667,41,4,17,33.10448459545062,0.6471036585365854,41.592261904761905,1033.6309523809523,25.21051103368176,0
4725,4,0,0,45,0.0,0.0,1.0,45,1350,900,450,0.6666666666666666,18,9,9,326.15010958948625,0.7513047138047139,0.06841936928292758,0.20305474564764778,133626.03635204074,-283.5707199546555,133342.4656320861,2459,11,812.4666666666667,41,4,17,33.08745922087891,0.6478658536585367,41.51785714285714,1033.9285714285706,25.217770034843188,0
4726,4,0,0,45,0.0,0.0,1.0,45,1400,1100,300,0.7857142857142857,17,11,6,324.93039396586846,0.7516414141414142,0.06656219685098153,0.20243571406492794,133651.68065200606,-314.5013503086526,133337.1793016974,2460,12,813.4666666666667,41,4,17,33.09337922543094,0.6481199186991871,41.49305555555555,1034.027777777777,25.220189701897,0
4727,4,0,0,45,0.0,0.0,1.0,45,600,200,400,0.3333333333333333,10,2,8,325.39019719476227,0.7506313131313131,0.07126458832933635,0.2030037585730337,133702.97663336154,-298.8724135487689,133404.10421981278,2461,13,814.4666666666667,41,4,15,33.030275779376495,0.6486280487804879,41.44345238095237,1034.2261904761892,25.225029036004614,0
4728,4,0,0,45,0.0,0.0,1.0,45,950,600,350,0.631578947368421,13,6,7,325.85766478936273,0.7505050505050506,0.0724971231300342,0.20371964798701875,133779.93905895686,-281.35629251701806,133498.58276643985,2462,14,815.4666666666667,41,4,15,32.94135980053699,0.649390243902439,41.36904761904761,1034.523809523809,25.23228803716607,0
4729,4,0,0,45,0.0,0.0,1.0,45,1300,1000,300,0.7692307692307693,16,10,6,328.8055131270842,0.7509680134680136,0.0785826838720669,0.20671170692736449,133985.28045477442,-188.98022171832355,133796.3002330561,2463,15,816.4666666666667,41,4,15,32.660182700907114,0.6514227642276423,41.17063492063492,1035.3174603174598,25.25164537359658,0
4730,4,0,0,45,0.0,0.0,1.0,45,1150,800,350,0.6956521739130435,15,8,7,325.9773350661553,0.7505050505050506,0.073956304738797,0.20565132056953025,134113.69879259565,-256.3947743449296,133857.30401825072,2464,16,817.4666666666667,41,4,16,32.60533393991636,0.6526930894308943,41.04662698412698,1035.8134920634914,25.263743708865643,0
4731,4,0,0,45,0.0,0.0,1.0,45,1150,800,350,0.6956521739130435,15,8,7,324.5739721241365,0.7492003367003367,0.07415916778352183,0.20548483107931703,134242.17864229032,-285.69657029477634,133956.48207199556,2465,17,818.4666666666667,41,4,17,32.513641585295815,0.6539634146341463,40.92261904761905,1036.3095238095243,25.275842044134738,0
4732,4,0,1,44,0.0,0.022222222222222223,0.9777777777777777,45,1000,700,300,0.7,13,7,6,324.0867196263821,0.7484848484848485,0.064961190855928,0.20575371932537634,134345.00681059467,-292.1134889140744,134052.8933216806,2466,18,819.4666666666667,41,4,18,32.423843700159495,0.6549796747967479,40.8234126984127,1036.7063492063498,25.285520712349996,0
4733,4,0,1,43,0.0,0.022727272727272728,0.9772727272727273,44,950,600,350,0.631578947368421,13,6,7,328.6662339678456,0.742049859055673,0.07112742240051562,0.20822171899709438,134267.8819936541,25.86382353869365,134293.7458171928,2467,37,838.6818181818181,41,3,18,32.38200360550079,0.6542174796747966,40.89781746031747,1036.4087301587315,25.278261711188573,0
4734,4,0,0,43,0.0,0.0,1.0,43,1050,800,250,0.7619047619047619,13,8,5,336.132432522861,0.7384182355112587,0.06153656684250475,0.21275868494324152,134234.6561756398,424.12430183755936,134658.78047747735,2468,38,854.0232558139535,40,3,18,32.221691020234715,0.6554687499999998,40.9298780487805,1036.2804878048803,25.907012195122007,0
4735,4,0,0,43,0.0,0.0,1.0,43,650,400,250,0.6153846153846154,9,4,5,337.7470175068248,0.738095238095238,0.05846902455097025,0.2140883674053521,134287.31786841535,471.0282198096737,134758.34608822502,2469,39,855.0232558139535,40,3,18,32.12733274504037,0.6559895833333332,40.879065040650424,1036.4837398374013,25.912093495935032,0
4736,4,0,0,43,0.0,0.0,1.0,43,1250,900,350,0.72,16,9,7,337.35983159359927,0.737218530823182,0.059487891490668465,0.21448205351680696,134396.4356575967,467.9917800453841,134864.4274376421,2470,40,856.0232558139535,41,2,19,32.028559127439735,0.6554878048780486,40.77380952380954,1036.9047619047644,25.290360046457668,0
4737,4,0,0,43,0.0,0.0,1.0,43,950,800,150,0.8421052631578947,11,8,3,342.1603056697236,0.7366186784791435,0.05619117097560511,0.21814805829772155,134499.32287729924,604.0658856135251,135103.38876291277,2471,41,857.0232558139535,41,2,19,31.801517470033154,0.6565040650406502,40.674603174603185,1037.3015873015888,25.300038714672898,0
4738,4,0,1,42,0.0,0.023255813953488372,0.9767441860465116,43,750,500,250,0.6666666666666666,10,5,5,341.6457543142495,0.7369878183831672,0.057889340844343495,0.21797374331080607,134525.05083341227,591.9824932287903,135117.03332664107,2472,42,858.0232558139535,41,2,19,31.789212170475924,0.6567581300813007,40.649801587301596,1037.400793650795,25.30245838172671,0
4739,4,0,0,42,0.0,0.0,1.0,42,950,700,250,0.7368421052631579,12,7,5,346.28473734294585,0.7373693379790941,0.04178619238860204,0.22108948614972718,134550.78125000015,918.5763888889031,135469.35763888905,2473,43,823.3809523809524,40,2,19,31.643239625167332,0.6585937499999999,40.62500000000001,1037.5000000000011,25.93750000000003,0
4740,4,0,0,42,0.0,0.0,1.0,42,900,800,100,0.8888888888888888,10,8,2,346.1902248604886,0.7375629113433991,0.04356566678240581,0.2212017621779071,134579.22299409434,918.0022939750709,135497.2252880694,2474,44,824.3809523809524,37,5,20,31.617329775617332,0.6641328828828829,40.59758771929825,1037.609649122807,28.043504030346135,0
4741,4,0,0,42,0.0,0.0,1.0,42,850,400,450,0.47058823529411764,13,4,9,363.5369116598941,0.7375629113433991,0.10278885500560331,0.21833725759455208,132282.13168827636,1251.7020153459275,133533.83370362228,2475,45,825.3809523809524,36,6,19,33.47153804050356,0.6432291666666665,42.82094594594596,1028.716216216218,28.575450450450504,5
4742,4,0,0,42,0.0,0.0,1.0,42,800,500,300,0.625,11,5,6,364.04906498575957,0.7373693379790941,0.09661272185978342,0.21615834846869064,131848.8056674152,1199.8868845423094,133048.6925519575,2476,46,826.3809523809524,38,4,19,33.89528936509588,0.6351425438596492,43.242521367521356,1027.0299145299127,27.027103013945073,5
4743,4,0,0,42,0.0,0.0,1.0,42,800,600,200,0.75,10,6,4,363.20961443744363,0.7370789779326364,0.09338068491386609,0.21581565100133376,131876.23844875433,1179.7435440864788,133055.9819928408,2477,47,827.3809523809524,38,4,19,33.88916337285903,0.6354166666666667,43.21581196581196,1027.136752136751,27.029914529914503,0
4744,4,0,0,42,0.0,0.0,1.0,42,1100,700,400,0.6363636363636364,15,7,8,365.13451730173216,0.7372725512969416,0.10059208213902093,0.21774512845166485,132013.44515897767,1240.533115092374,133253.97827407005,2478,48,828.3809523809524,38,4,19,33.701311640156625,0.6367872807017545,43.08226495726494,1027.6709401709375,27.043972109761512,0
4745,4,0,0,42,0.0,0.0,1.0,42,1300,1000,300,0.7692307692307693,16,10,6,369.79519716917184,0.7366918312040264,0.10509440684004323,0.22132518517139987,132150.7232084155,1373.7405489809337,133524.46375739644,2479,49,829.3809523809524,38,4,19,33.44308499584372,0.6381578947368421,42.94871794871795,1028.2051282051282,27.058029689608635,0
4746,4,0,0,42,0.0,0.0,1.0,42,900,700,200,0.7777777777777778,11,7,4,370.2513216325115,0.7352158343012002,0.10428259805012696,0.22208158712499595,132233.1242809006,1391.897805719909,133625.0220866205,2480,50,830.3809523809524,38,4,19,33.34826529552301,0.6389802631578948,42.86858974358974,1028.52564102564,27.06646423751684,0
4747,4,1,1,42,0.023255813953488372,0.023255813953488372,0.9767441860465116,43,1150,900,250,0.782608695652174,14,9,5,363.2368626466026,0.7423864894795127,0.09491518879512362,0.21946794014578733,132507.9800044743,1026.4593149609052,133534.4393194352,2481,0,812.046511627907,38,5,20,33.25183321227216,0.6417214912280702,42.60149572649572,1029.5940170940162,27.094579397210953,0
4748,4,0,0,42,0.0,0.0,1.0,42,850,700,150,0.8235294117647058,10,7,3,370.2732383746663,0.7365708478513356,0.10073260073260104,0.22306704848425005,132398.00347222213,1404.687499999991,133802.69097222213,2482,52,832.3809523809524,37,5,20,33.181511470985164,0.642454954954955,42.70833333333333,1029.1666666666658,27.815315315315292,0
4749,4,1,1,42,0.023255813953488372,0.023255813953488372,0.9767441860465116,43,700,400,300,0.5714285714285714,10,4,6,360.2355748361347,0.747093023255814,0.10198115801507979,0.2184522900987425,132645.51487508198,956.726660092026,133602.241535174,2483,0,814.0,38,5,15,33.19072806471685,0.643092105263158,42.46794871794871,1030.1282051282035,27.108636977057987,0
4750,4,0,0,42,0.0,0.0,1.0,42,800,600,200,0.75,10,6,4,364.64641309439173,0.7372725512969416,0.10078097266595676,0.2203365391863794,132510.87474030457,1263.9230340104489,133774.79777431503,2484,54,834.3809523809524,37,5,20,33.212637557685476,0.6435810810810811,42.59868421052631,1029.6052631578937,27.827169274537667,0
4751,4,0,0,42,0.0,0.0,1.0,42,650,500,150,0.7692307692307693,8,5,3,369.313729615839,0.7366676345334882,0.10716313782753328,0.22349191678814176,132567.32840874116,1391.786895967993,133959.11530470915,2485,55,835.3809523809524,37,5,20,33.03565090857469,0.6441441441441441,42.54385964912281,1029.8245614035088,27.833096254148888,0
4752,4,0,0,42,0.0,0.0,1.0,42,1250,1000,250,0.8,15,10,5,368.3654262852718,0.7355787843592722,0.10415083249728951,0.2239261498207624,132736.76155163138,1379.126750538643,134115.88830217003,2486,56,836.3809523809524,37,5,15,32.88953323402143,0.6458333333333333,42.37938596491229,1030.4824561403518,27.85087719298248,0
4753,4,0,1,41,0.0,0.023809523809523808,0.9761904761904762,42,850,500,350,0.5882352941176471,12,5,7,370.498277306249,0.7358207510646535,0.10188814943122537,0.225903035229141,132849.77709487543,1444.1227108341122,134293.89980570955,2487,57,837.3809523809524,37,5,16,32.72087499113664,0.6469594594594594,42.26973684210527,1030.9210526315796,27.862731152204855,0
4754,4,0,0,41,0.0,0.0,1.0,41,950,700,250,0.7368421052631579,12,7,5,368.96737120368675,0.7333333333333333,0.09385172869063574,0.22513953221468325,132878.0384950178,1605.5321108418088,134483.5706058596,2488,58,835.609756097561,37,4,16,32.73190736998831,0.6472409909909909,42.242324561403514,1031.0307017543867,27.86569464201045,0
4755,4,0,0,41,0.0,0.0,1.0,41,1650,1200,450,0.7272727272727273,21,12,9,368.03377851248695,0.7319613821138211,0.10001136779881525,0.225324421784278,133003.4394061839,1589.9516719629019,134593.3910781468,2489,59,836.609756097561,38,3,16,32.62989815294321,0.6466557017543859,42.1207264957265,1031.517094017095,27.14518668466039,0
4756,4,0,0,41,0.0,0.0,1.0,41,700,300,400,0.42857142857142855,11,3,8,374.8644735049479,0.7314532520325203,0.11023844759052248,0.23001531671606018,133086.10586054498,1777.8506008473942,134863.95646139237,2490,60,837.609756097561,38,3,16,32.37061675985366,0.6474780701754386,42.04059829059829,1031.837606837607,27.153621232568604,0
4757,4,0,0,41,0.0,0.0,1.0,41,550,200,350,0.36363636363636365,9,2,7,373.0681686663322,0.7315548780487805,0.11317982123920589,0.2292518135697691,133141.23109796192,1734.1510519395179,134875.38214990144,2491,61,838.609756097561,38,3,17,32.361542443064195,0.6480263157894737,41.98717948717949,1032.0512820512824,27.159244264507432,0
4758,4,0,0,41,0.0,0.0,1.0,41,1150,800,350,0.6956521739130435,15,8,7,374.91438320961834,0.7321138211382113,0.11512174931351993,0.23106968108021347,133251.51581561824,1791.5819727518315,135043.09778837007,2492,62,839.609756097561,38,3,17,32.20306463852097,0.6491228070175439,41.880341880341874,1032.4786324786314,27.17049032838504,0
4759,4,0,0,41,0.0,0.0,1.0,41,1100,800,300,0.7272727272727273,14,8,6,373.3546218595237,0.7310975609756097,0.11488384997603851,0.23113567179139513,133417.02849915982,1762.3728449850137,135179.40134414483,2493,63,840.609756097561,38,3,18,32.07708548776283,0.6507675438596492,41.720085470085465,1033.1196581196573,27.187359424201507,0
4760,4,0,0,41,0.0,0.0,1.0,41,1300,900,400,0.6923076923076923,17,9,8,375.1622956128302,0.7302845528455284,0.11066154785434157,0.23331333265420567,133585.55036164954,1823.263761150172,135408.81412279973,2494,64,841.609756097561,37,4,18,31.861211285532455,0.6542792792792793,41.55701754385964,1033.7719298245597,27.939781887150264,0
4761,4,0,0,41,0.0,0.0,1.0,41,950,700,250,0.7368421052631579,12,7,5,374.5736008699479,0.7307418699186992,0.11150712567571097,0.23330442907553528,133642.2324657585,1811.7704485995484,135454.00291435805,2495,65,842.609756097561,37,4,18,31.819547543301514,0.6548423423423424,41.50219298245613,1033.991228070174,27.945708866761457,0
4762,4,0,0,41,0.0,0.0,1.0,41,750,500,250,0.6666666666666666,10,5,5,371.51603520592965,0.7304878048780488,0.10992545629898176,0.23193320715403895,133727.27816491586,1736.3656365419838,135463.64380145783,2496,66,843.609756097561,37,4,14,31.813292872539662,0.6556869369369371,41.41995614035086,1034.3201754385943,27.954599336178227,0
4763,4,0,0,41,0.0,0.0,1.0,41,1000,800,200,0.8,12,8,4,375.9702399034042,0.7304369918699187,0.1200619254258668,0.23543670563824962,133840.71451071466,1864.0251086872674,135704.73961940192,2497,67,844.609756097561,37,4,14,31.58434442442867,0.6568130630630632,41.31030701754385,1034.758771929823,27.966453295400623,0
4764,4,0,0,41,0.0,0.0,1.0,41,1250,800,450,0.64,17,8,9,377.36063915914116,0.729369918699187,0.12253249319909787,0.23703671286104128,133954.19894823397,1909.8084266312576,135864.00737486524,2498,68,845.609756097561,37,4,14,31.434589379656103,0.6579391891891893,41.200657894736835,1035.1973684210518,27.978307254623022,0
4765,4,0,0,41,0.0,0.0,1.0,41,1150,1000,150,0.8695652173913043,13,10,3,378.9323886500123,0.7290650406504064,0.11734689924982877,0.2387602675650009,134067.7314774737,1960.521145929497,136028.25262340318,2499,69,846.609756097561,37,4,14,31.280108523028048,0.6590653153153154,41.091008771929815,1035.6359649122794,27.99016121384539,0
4766,4,0,0,41,0.0,0.0,1.0,41,900,600,300,0.6666666666666666,12,6,6,376.42876877277274,0.7282520325203252,0.11838575673784724,0.23754993844999184,134124.51577648864,1897.665267197569,136022.1810436862,2500,70,847.609756097561,37,4,14,31.288041177093252,0.6596283783783785,41.0361842105263,1035.8552631578925,27.996088193456554,0
4767,4,0,0,41,0.0,0.0,1.0,41,500,300,200,0.6,7,3,4,375.4881660728972,0.7282012195121951,0.11949360814522603,0.23713985247705416,134152.91243459514,1874.5662126808118,136027.47864727594,2501,71,848.609756097561,37,4,14,31.283957804120796,0.6599099099099099,41.008771929824555,1035.964912280701,27.999051683262188,0
4768,4,0,0,41,0.0,0.0,1.0,41,1400,1000,400,0.7142857142857143,18,10,8,380.009352624976,0.7288617886178862,0.11535187067546615,0.24111465904137735,134323.35550361648,2008.8262734687582,136332.18177708524,2502,72,849.609756097561,37,4,15,30.996139200338476,0.6615990990990992,40.844298245614034,1036.6228070175437,28.016832622095773,0
4769,4,0,0,41,0.0,0.0,1.0,41,700,500,200,0.7142857142857143,9,5,4,391.50973603508965,0.7279979674796748,0.11093587380945924,0.24150815266433404,133283.9206271703,2236.3905164930748,135520.31114366336,2503,73,850.609756097561,39,2,18,31.742093715323314,0.6477029914529913,41.84895833333334,1032.604166666668,26.47702991452995,2
4770,4,1,1,41,0.023809523809523808,0.023809523809523808,0.9761904761904762,42,1250,900,350,0.72,16,9,7,389.48167998478743,0.7378048780487805,0.1114868523386201,0.24183862465807676,133527.42735955887,2001.5631884234308,135528.9905479823,2504,0,831.3333333333334,38,4,18,31.549557232444364,0.6518640350877192,41.61324786324787,1033.5470085470095,27.198605488079195,0
4771,4,0,1,40,0.0,0.024390243902439025,0.975609756097561,41,500,400,100,0.8,6,4,2,395.6557283677773,0.7279979674796748,0.11636091756702527,0.2447734159839834,133391.50526258704,2355.422634548635,135746.92789713567,2505,75,852.609756097561,39,2,18,31.526776410876945,0.6487713675213674,41.74479166666668,1033.0208333333353,26.487713675213726,0
4772,4,0,0,40,0.0,0.0,1.0,40,1600,1200,400,0.75,20,12,8,396.7540670416328,0.7239049145299146,0.11277789266880389,0.24580452161176375,133444.62393390687,2588.9394541237625,136033.56338803063,2506,76,858.725,38,2,18,31.444955709509536,0.6510416666666665,41.693376068376075,1033.2264957264965,27.19017094017096,0
4773,4,0,0,40,0.0,0.0,1.0,40,1300,800,500,0.6153846153846154,18,8,10,394.92479654477347,0.7240117521367522,0.11150724479790819,0.2454309212921108,133559.51126379764,2549.1982696320533,136108.7095334297,2507,77,859.725,36,4,18,31.376647782982904,0.6559606481481481,41.58220720720721,1033.6711711711716,28.7130880880881,0
4774,4,0,0,40,0.0,0.0,1.0,40,800,500,300,0.625,11,5,6,393.89927918671896,0.7236912393162394,0.11487583051955141,0.24517893438734015,133617.7198101818,2526.3847039607163,136144.1045141425,2508,78,860.725,36,4,18,31.344624768543728,0.6565393518518519,41.5259009009009,1033.8963963963963,28.719344344344343,0
4775,4,0,0,40,0.0,0.0,1.0,40,1050,700,350,0.6666666666666666,14,7,7,396.6108857160722,0.7234775641025641,0.10952367991290135,0.24764588615242167,133734.17494775177,2608.085915307193,136342.26086305897,2509,79,861.725,36,4,17,31.15745781164942,0.6576967592592593,41.413288288288285,1034.3468468468466,28.73185685685685,0
4776,4,0,0,40,0.0,0.0,1.0,40,1050,800,250,0.7619047619047619,13,8,5,396.5197834278362,0.7247596153846154,0.10510992599042268,0.24817600613998356,133821.54959013063,2612.578372291204,136434.12796242183,2510,80,862.725,36,4,17,31.072005151647073,0.6585648148148149,41.328828828828826,1034.6846846846843,28.74124124124123,0
4777,4,0,0,40,0.0,0.0,1.0,40,1050,700,350,0.6666666666666666,14,7,7,394.46026883356114,0.7252136752136752,0.10466931360818066,0.24786556742220947,133967.23740209788,2568.9504961041957,136536.18789820207,2511,81,863.725,36,4,17,30.978960440915184,0.6600115740740742,41.188063063063055,1035.2477477477464,28.756881881881846,0
4778,4,0,0,40,0.0,0.0,1.0,40,650,400,250,0.6153846153846154,9,4,5,390.91924382621625,0.7242521367521367,0.10421152800435052,0.2460302838454521,134025.53471968576,2478.63213720476,136504.16685689052,2512,82,864.725,36,4,17,31.012098966829793,0.6605902777777779,41.13175675675675,1035.472972972972,28.76313813813811,0
4779,4,0,0,40,0.0,0.0,1.0,40,900,400,500,0.4444444444444444,14,4,10,389.8482986767487,0.7228899572649573,0.10176086956521724,0.24633271619684657,134171.33349565775,2461.293218894563,136632.62671455232,2513,83,865.725,36,4,17,30.8935688405797,0.6620370370370371,40.99099099099099,1036.0360360360355,28.778778778778765,0
4780,4,0,0,40,0.0,0.0,1.0,40,1050,700,350,0.6666666666666666,14,7,7,383.57243286120683,0.7223824786324786,0.0582849440066362,0.23294537421369518,132700.54879830524,2262.23441068274,134962.783208988,2514,84,866.725,38,2,12,32.53426137149178,0.643640350877193,42.414529914529915,1030.3418803418806,27.114260008996858,6
4781,4,0,0,40,0.0,0.0,1.0,40,900,600,300,0.6666666666666666,12,6,6,384.5009582431006,0.7238514957264958,0.056946315680381554,0.23436827202069985,132838.18354381248,2215.2817727737547,135053.46531658623,2515,85,867.725,38,2,12,32.37166200297094,0.6450109649122808,42.2809829059829,1030.876068376068,27.128317588843892,0
4782,4,0,0,40,0.0,0.0,1.0,40,1200,1000,200,0.8333333333333334,14,10,4,380.0020406081011,0.724465811965812,0.05792929292929294,0.23222346926050633,132934.57031250003,2103.0815972222226,135037.65190972225,2516,86,868.725,39,1,13,32.39057239057239,0.6442307692307693,42.1875,1031.2500000000002,26.442307692307697,0
4783,4,0,0,40,0.0,0.0,1.0,40,1250,1000,250,0.8,15,10,5,380.8558691324427,0.7231036324786325,0.046771180450368766,0.2332477224501287,133015.14892578125,2131.9200303819453,135147.0689561632,2517,87,869.725,39,1,14,32.28745918745162,0.6450320512820513,42.109375,1031.5625,26.450320512820515,0
4784,4,0,0,40,0.0,0.0,1.0,40,700,500,200,0.7142857142857143,9,5,4,383.07109046401655,0.7217681623931624,0.04886191581709909,0.23528117130979603,133122.6250542534,2199.0858289930466,135321.71088324644,2518,88,870.725,39,1,14,32.12217371555466,0.6461004273504274,42.00520833333333,1031.979166666666,26.46100427350426,0
4785,4,2,0,42,0.047619047619047616,0.0,1.0,42,1150,900,250,0.782608695652174,14,9,5,370.77173140938453,0.7378290747193186,0.06125717828724997,0.2307368517587529,133610.25646732753,1509.1565504094044,135119.41301773695,2519,0,830.2142857142857,38,4,16,31.949898384485543,0.652686403508772,41.533119658119645,1033.8675213675194,27.207040035987355,0
4786,4,1,2,41,0.023255813953488372,0.046511627906976744,0.9534883720930233,43,950,700,250,0.7368421052631579,12,7,5,363.84876089419953,0.7452473237356958,0.06029285099052539,0.228232404560907,133903.125,1144.0972222222233,135047.22222222222,2520,0,811.8837209302326,39,4,14,31.8354133118626,0.653846153846154,41.25,1035.0,26.53846153846154,0
4787,4,1,0,42,0.023809523809523808,0.0,1.0,42,1300,1000,300,0.7692307692307693,16,10,6,370.94669357709074,0.7386517615176151,0.06241331484049972,0.23171005723957314,133748.36205164698,1522.7025348819886,135271.06458652898,2521,0,832.1666666666666,38,4,15,31.8068753012463,0.6540570175438598,41.39957264957263,1034.4017094017067,27.22109761583439,0
4788,4,0,0,42,0.0,0.0,1.0,42,1300,1100,200,0.8461538461538461,15,11,4,368.1108866105061,0.7393776616337592,0.05999846575762802,0.23023156963573965,133795.33420138885,1450.3038194444405,135245.63802083328,2522,1,833.1666666666666,39,3,15,31.833131964022016,0.6527777777777778,41.354166666666664,1034.583333333333,26.52777777777777,0
4789,4,0,0,42,0.0,0.0,1.0,42,1250,800,450,0.64,17,8,9,367.41425315254355,0.7388453348819203,0.05862280499961714,0.23046894061386813,133903.12499999997,1439.5833333333342,135342.7083333333,2523,2,834.1666666666666,39,3,16,31.74315619967795,0.653846153846154,41.25,1034.9999999999998,26.538461538461533,0
4790,4,0,1,41,0.0,0.023809523809523808,0.9761904761904762,42,1300,900,400,0.6923076923076923,17,9,8,368.1978693542384,0.7378290747193186,0.061565560290050225,0.23221984433529705,134103.04712803234,1475.2912452905132,135578.33837332285,2524,3,835.1666666666666,40,2,17,31.52268118785976,0.6541666666666666,41.056910569105696,1035.772357723578,25.89430894308945,0
4791,4,0,1,40,0.0,0.024390243902439025,0.975609756097561,41,1000,700,300,0.7,13,7,6,371.4047410409943,0.735619918699187,0.07753086177553925,0.23468815466287965,134172.79188368045,1766.4822048611022,135939.27408854154,2525,4,850.439024390244,39,2,17,31.36981366043301,0.6565170940170941,40.98958333333333,1036.0416666666658,26.56517094017092,0
4792,4,0,0,40,0.0,0.0,1.0,40,650,400,250,0.6153846153846154,9,4,5,371.0905566171869,0.7329059829059829,0.0686604473765593,0.2351371319231433,134273.81388569262,1965.548866790825,136239.36275248346,2526,5,845.925,38,2,17,31.276844311582995,0.6592653508771931,40.892094017094,1036.4316239316217,27.274516419253203,0
4793,4,0,0,40,0.0,0.0,1.0,40,1000,700,300,0.7,13,7,6,371.2120439477283,0.7315705128205128,0.060814360770578224,0.23628559413774408,134439.96006145436,1981.146472532679,136421.10653398704,2527,6,846.925,38,2,17,31.107491157583876,0.6609100877192983,40.7318376068376,1037.0726495726487,27.291385515069702,0
4794,4,0,0,40,0.0,0.0,1.0,40,550,400,150,0.7272727272727273,7,4,3,370.1900956789107,0.7317040598290598,0.06271884654994864,0.23617252490421967,134523.0716725107,1959.8217546935393,136482.89342720425,2528,7,847.925,38,2,19,31.050892550635066,0.6617324561403508,40.6517094017094,1037.393162393162,27.299820062977943,0
4795,4,0,0,40,0.0,0.0,1.0,40,1050,800,250,0.7619047619047619,13,8,5,372.6049816967851,0.7315438034188034,0.06133727414677703,0.23828646689681704,134610.82845721874,2031.3416154038864,136642.17007262263,2529,8,848.925,35,5,19,30.900531638040007,0.668452380952381,40.567129629629626,1037.731481481481,29.649470899470888,0
4796,4,0,1,39,0.0,0.025,0.975,40,1050,600,450,0.5714285714285714,15,6,9,391.51925078043666,0.7308226495726495,0.03689516129032233,0.24274193548387096,133472.2222222223,2451.3888888888973,135923.6111111112,2530,9,849.925,38,2,17,31.5524193548387,0.6513157894736842,41.66666666666667,1033.3333333333342,27.192982456140374,7
4797,4,0,0,39,0.0,0.0,1.0,39,450,200,250,0.4444444444444444,7,2,5,398.3785126825117,0.7230094466936573,0.04225501645609908,0.24605424334141496,133330.6296769198,2823.2115891428116,136153.84126606263,2531,12,872.4871794871794,37,2,17,31.517743391018154,0.6517454954954955,41.80372807017544,1032.7850877192982,27.913110478899952,0
4798,4,0,0,39,0.0,0.0,1.0,39,1050,700,350,0.6666666666666666,14,7,7,410.1399874569396,0.7230094466936573,0.03693888462700823,0.23439606537046878,130380.7656035666,2914.668868317517,133295.43447188413,2532,13,873.4871794871794,35,4,18,34.20406467210638,0.6261904761904762,44.67592592592593,1021.2962962962969,29.179894179894195,5
4799,4,1,1,39,0.025,0.025,0.975,40,850,500,350,0.5882352941176471,12,5,7,401.15497000953883,0.7340544871794872,0.03571428571428559,0.23088697162771232,130654.64854570634,2482.5523237919297,133137.20086949828,2533,0,852.625,37,3,15,34.154690404690406,0.625,44.4078947368421,1022.3684210526313,27.631578947368414,0
4800,4,0,0,39,0.0,0.0,1.0,39,850,500,350,0.5882352941176471,12,5,7,408.8468105432336,0.7207602339181287,0.03326723948006194,0.23520350735814197,130636.47050767009,2882.060861537245,133518.53136920734,2534,15,875.4871794871794,36,3,15,33.976600940001475,0.6267361111111109,44.42567567567569,1022.2972972972993,28.397147147147205,0
4801,4,1,1,39,0.025,0.025,0.975,40,550,500,50,0.9090909090909091,6,5,1,367.54361714951216,0.7287660256410257,-0.0006701694188289142,0.21184868810484234,130710.70545744844,1666.157639165706,132376.86309661414,2535,0,854.575,37,3,14,34.956930445349926,0.6255630630630631,44.353070175438596,1022.5877192982456,27.63750592697961,8
4802,4,0,1,38,0.0,0.02564102564102564,0.9743589743589743,39,1000,800,200,0.8,12,8,4,365.12471718708196,0.7186234817813766,0.024849364472006252,0.21076010902977094,130766.77439212053,1749.236303477982,132516.0106955985,2536,1,877.0769230769231,37,2,14,34.96194253859349,0.6261261261261262,44.29824561403508,1022.8070175438586,27.64343290659077,0
4803,4,0,0,38,0.0,0.0,1.0,38,600,300,300,0.5,9,3,6,366.0684012577355,0.7184981033665244,0.016142861280884713,0.21169518939697804,130838.01442912496,1979.1325531612524,132817.1469822862,2537,2,864.7894736842105,36,2,14,34.865620986974854,0.6287615740740742,44.228603603603595,1023.0855855855847,28.419044044044018,0
4804,4,0,0,38,0.0,0.0,1.0,38,900,600,300,0.6666666666666666,12,6,6,370.07843162082236,0.7183795637743007,0.01852731178810707,0.21465493714113892,130953.25213304488,2092.5948330086476,133045.84696605353,2538,3,865.7894736842105,36,2,14,34.64627571790074,0.6299189814814817,44.11599099099097,1023.5360360360335,28.431556556556487,0
4805,4,0,0,38,0.0,0.0,1.0,38,650,500,150,0.7692307692307693,8,5,3,372.0255724513489,0.7179646752015173,0.021325313062658946,0.21610763445081188,131010.89000740575,2147.880270473143,133158.77027787888,2539,4,866.7894736842105,36,2,14,34.53805045282881,0.6304976851851853,44.05968468468467,1023.7612612612588,28.437812812812744,0
4806,4,0,0,38,0.0,0.0,1.0,38,750,600,150,0.8,9,6,3,375.80435697833707,0.718735182550972,0.022207112062729406,0.21895840017411763,131126.20380092927,2255.559740483718,133381.763541413,2540,5,867.7894736842105,36,2,14,34.324491478834524,0.6316550925925927,43.94707207207207,1024.2117117117114,28.450325325325316,0
4807,4,0,0,38,0.0,0.0,1.0,38,1300,900,400,0.6923076923076923,17,9,8,374.13813476530146,0.7186166429587483,0.011103013055222766,0.21864373077902854,131241.5683208545,2220.495115047466,133462.06343590198,2541,6,868.7894736842105,36,2,14,34.25032970656116,0.6328125,43.83445945945945,1024.6621621621612,28.46283783783781,0
4808,4,0,0,38,0.0,0.0,1.0,38,1050,700,350,0.6666666666666666,14,7,7,370.6124416160636,0.7184388335704125,0.01077648960382227,0.21724119095919744,131357.78523930462,2136.594436164601,133494.37967546922,2542,7,869.7894736842105,35,3,14,34.22304862444019,0.6360119047619048,43.72106481481481,1025.11574074074,29.289021164021143,0
4809,4,0,0,38,0.0,0.0,1.0,38,800,700,100,0.875,9,7,2,369.149344336014,0.7178165007112376,0.010743683854185448,0.21722453449573415,131506.13667052472,2109.0808256172922,133615.21749614202,2543,8,870.7894736842105,35,3,14,34.11052809749492,0.6375,43.57638888888889,1025.6944444444448,29.305555555555564,0
4810,4,0,0,38,0.0,0.0,1.0,38,550,300,250,0.5454545454545454,8,3,5,370.6665979540826,0.7163051209103841,0.011407961528185462,0.21862670597890507,131595.18771701396,2155.5881076388932,133750.77582465287,2544,9,871.7894736842105,35,3,14,33.98159898477158,0.6383928571428571,43.489583333333336,1026.0416666666672,29.315476190476204,0
4811,4,2,1,39,0.05,0.025,0.975,40,650,400,250,0.6153846153846154,9,4,5,354.149716799036,0.7381410256410257,0.018951354811179932,0.21145219396650705,132059.6782182978,1353.779528316385,133413.45774661418,2545,0,829.15,37,3,15,33.936953275015995,0.6390765765765766,43.037280701754376,1027.8508771929812,27.77975343764814,0
4812,4,0,0,39,0.0,0.0,1.0,39,950,700,250,0.7368421052631579,12,7,5,365.0622600706047,0.723740440845704,0.012154621622077588,0.2177489010068196,132021.60564280505,1839.2211468225096,133860.82678962755,2546,1,851.4102564102565,36,3,15,33.6949375410914,0.640625,43.07432432432433,1027.7027027027034,28.547297297297316,0
4813,4,0,0,39,0.0,0.0,1.0,39,950,600,350,0.631578947368421,13,6,7,363.72383711825637,0.7243027440395862,0.014400777630754646,0.21711624992664014,132050.5402995902,1805.985842261186,133856.52614185138,2547,2,852.4102564102565,36,3,15,33.700147912786235,0.6409143518518519,43.046171171171174,1027.815315315316,28.550425425425445,0
4814,4,0,0,39,0.0,0.0,1.0,39,1000,600,400,0.6,14,6,8,362.07910860071394,0.7232343679712101,0.018102850468994847,0.21712859480304159,132224.21481870403,1775.1251673971462,133999.33998610117,2548,3,853.4102564102565,36,3,15,33.56737472170517,0.6426504629629629,42.87725225225226,1028.4909909909925,28.569194194194235,0
4815,4,0,0,39,0.0,0.0,1.0,39,1100,600,500,0.5454545454545454,16,6,10,363.1937058486152,0.7215474583895637,0.01727359967675124,0.21863399763139985,132369.0307706357,1815.1197650353295,134184.15053567104,2549,4,854.4102564102565,36,3,16,33.392837601225665,0.6440972222222221,42.7364864864865,1029.0540540540558,28.584834834834883,0
4816,4,1,0,40,0.025,0.0,1.0,40,400,100,300,0.25,7,1,6,354.4476906762804,0.7316239316239316,0.017041946130096797,0.21465681228383646,132595.55975155823,1399.6379895737193,133995.19774113197,2550,0,834.025,37,3,17,33.39000230668228,0.6444256756756757,42.516447368421055,1029.9342105263163,27.836059743954493,0
4817,4,0,0,40,0.0,0.0,1.0,40,800,500,300,0.625,11,5,6,355.4641777512921,0.7316773504273504,0.022195316657796837,0.21559625241919889,132652.03145438991,1430.609057594654,134082.64051198456,2551,1,835.025,37,3,15,33.30705605818697,0.6449887387387387,42.46162280701755,1030.1535087719305,27.84198672356569,0
4818,4,1,1,40,0.024390243902439025,0.024390243902439025,0.975609756097561,41,200,100,100,0.5,3,1,2,352.2467815245273,0.7341463414634146,0.04523336718761839,0.21550002717603228,132975.889628534,1168.0658284023825,134143.95545693638,2552,0,815.6341463414634,38,3,16,33.064662316138396,0.6463815789473684,42.147435897435905,1031.4102564102575,27.142375168690986,0
4819,4,0,0,40,0.0,0.0,1.0,40,800,600,200,0.75,10,6,4,359.0635782390665,0.7229433760683761,0.04173048287598391,0.218930983307633,132849.77709487526,1540.3032663896533,134390.0803612649,2553,1,836.975,37,3,16,33.01558179110829,0.6469594594594594,42.26973684210526,1030.9210526315783,27.86273115220482,0
4820,4,0,0,40,0.0,0.0,1.0,40,1200,1100,100,0.9166666666666666,13,11,2,359.498442615755,0.7232371794871795,0.04398054640161608,0.2200261450674303,132991.1141529123,1562.019683941203,134553.13383685352,2554,2,837.975,37,3,16,32.86238528046491,0.6483671171171171,42.132675438596486,1031.4692982456131,27.877548601232785,0
4821,4,0,0,40,0.0,0.0,1.0,40,1150,800,350,0.6956521739130435,15,8,7,364.9282439847207,0.7237446581196582,0.04804504887377825,0.22419743031228387,133132.52635426272,1716.763811942122,134849.29016620485,2555,3,838.975,37,3,16,32.58030528403455,0.6497747747747749,41.99561403508771,1032.0175438596482,27.89236605026076,0
4822,4,0,1,39,0.0,0.025,0.975,40,1450,1000,450,0.6896551724137931,19,10,9,357.9143005200113,0.7239850427350427,0.04421770512684464,0.22139925313191222,133387.25767784304,1548.2414060095311,134935.49908385257,2556,4,839.975,37,3,17,32.505727452853556,0.6523085585585586,41.748903508771924,1033.0043859649113,27.919037458511117,0
4823,4,0,0,39,0.0,0.0,1.0,39,600,400,200,0.6666666666666666,8,4,4,362.81327526402094,0.7189608636977058,0.06107052982384542,0.2251162027230674,133500.54974848015,1887.1543407586785,135387.70408923883,2557,5,858.3076923076923,37,2,18,32.26558355437667,0.6534346846846848,41.639254385964904,1033.4429824561391,27.93089141773349,0
4824,4,0,0,39,0.0,0.0,1.0,39,850,700,150,0.8235294117647058,10,7,3,361.6322075775726,0.7189046333783177,0.064310640740046,0.22472688337730878,133557.2138181939,1859.7180141966628,135416.93183239058,2558,6,859.3076923076923,37,2,18,32.23929051306531,0.6539977477477478,41.5844298245614,1033.6622807017534,27.936818397344688,0
4825,4,0,0,39,0.0,0.0,1.0,39,800,600,200,0.75,10,6,4,362.0412025769996,0.7203666216824112,0.05886911900274927,0.2253258415246551,133613.88991083775,1874.7466768620884,135488.63658769985,2559,7,860.3076923076923,37,2,18,32.17191200905008,0.654560810810811,41.52960526315788,1033.8815789473667,27.94274537695586,0
4826,4,0,0,39,0.0,0.0,1.0,39,1250,1100,150,0.88,14,11,3,362.75286425022654,0.7208726945569051,0.05377738272893606,0.22646245985919142,133727.27816491597,1901.9906365419974,135629.26880145798,2560,8,861.3076923076923,37,2,15,32.0398909855472,0.655686936936937,41.41995614035087,1034.3201754385952,27.95459933617825,0
4827,4,0,0,39,0.0,0.0,1.0,39,800,500,300,0.625,11,5,6,365.139883494364,0.7205353126405758,0.06059716742209309,0.2284787759053594,133812.3509156664,1972.045244690679,135784.39616035708,2561,9,862.3076923076923,37,2,16,31.89292779426311,0.6565315315315314,41.33771929824562,1034.6491228070179,27.963489805595078,0
4828,4,0,0,39,0.0,0.0,1.0,39,1000,800,200,0.8,12,8,4,365.60255673657,0.7201979307242465,0.06995871360278128,0.22947394518571942,133925.82333025546,1992.724684518312,135918.54801477378,2562,10,863.3076923076923,37,2,16,31.767302259887007,0.6576576576576576,41.228070175438596,1035.0877192982455,27.975343764817445,0
4829,4,0,0,39,0.0,0.0,1.0,39,1750,1500,250,0.8571428571428571,20,15,5,364.68793026187956,0.7195793972109762,0.07525349187604347,0.22978502343718826,134067.7314774738,1978.5767014850667,136046.30817895886,2563,11,864.3076923076923,37,2,16,31.648910358214213,0.6590653153153154,41.09100877192982,1035.6359649122803,27.990161213845415,0
4830,4,0,0,39,0.0,0.0,1.0,39,1150,600,550,0.5217391304347826,17,6,11,366.42926637610316,0.7199730094466937,0.07896393755834907,0.231418697107047,134152.9124345953,2031.51065712527,136184.42309172056,2564,12,865.3076923076923,37,2,16,31.518575359864528,0.6599099099099099,41.00877192982456,1035.9649122807018,27.999051683262213,0
4831,4,0,0,39,0.0,0.0,1.0,39,500,200,300,0.4,8,2,6,369.3830328523396,0.7203666216824112,0.07628008432156141,0.233827129503514,134238.1204433095,2117.056810749468,136355.17725405897,2565,13,866.3076923076923,37,2,17,31.356800867633066,0.6607545045045045,40.9265350877193,1036.293859649123,28.007942152679004,0
4832,4,0,0,39,0.0,0.0,1.0,39,400,100,300,0.25,7,1,6,337.5378798799359,0.7200854700854701,0.06141391700958443,0.20365899405825075,132455.9583865963,1142.1443678918629,133598.10275448815,2566,14,867.3076923076923,36,3,19,33.96555810815739,0.6449652777777777,42.65202702702704,1029.3918918918937,28.59421921921927,5
4833,4,0,0,39,0.0,0.0,1.0,39,950,600,350,0.631578947368421,13,6,7,342.8109987104068,0.7204790823211876,0.0466246655150222,0.19809765345326577,130809.21292914549,1168.567384952537,131977.78031409802,2567,15,868.3076923076923,36,3,16,35.489597093791275,0.6284722222222221,44.256756756756765,1022.972972972974,28.415915915915946,5
4834,4,0,0,39,0.0,0.0,1.0,39,800,500,300,0.625,11,5,6,332.44327207124337,0.7204790823211876,0.049626498017919074,0.17464977532756845,127035.24470416342,646.4024835646221,127681.64718772804,2568,16,869.3076923076923,36,3,15,39.59450402144771,0.5902777777777779,47.97297297297296,1008.1081081081064,28.003003003002956,6
4835,4,1,0,40,0.025,0.0,1.0,40,800,500,300,0.625,11,5,6,323.593045365049,0.7312767094017094,0.0521478223091123,0.17152108052251036,127396.24361582405,244.90768794243235,127641.15130376648,2569,0,848.55,37,3,13,39.448132761304784,0.5920608108108109,47.61513157894736,1009.5394736842101,27.284850640113785,0
4836,4,2,1,41,0.047619047619047616,0.023809523809523808,0.9761904761904762,42,1000,700,300,0.7,13,7,6,317.358228107969,0.7521535036778939,0.08015072668293532,0.171148016689969,128091.80230034712,-269.8025173611204,127821.999782986,2570,0,809.0952380952381,39,3,15,38.89560609178845,0.5956196581196582,46.92708333333333,1012.2916666666657,25.956196581196558,0
4837,4,1,1,41,0.023809523809523808,0.023809523809523808,0.9761904761904762,42,1100,800,300,0.7272727272727273,14,8,6,330.1630872741511,0.7629452187379017,0.05383740000669457,0.1778309457092088,128041.65556423091,54.925660155991125,128096.5812243869,2571,0,794.4047619047619,40,2,17,38.62272818556081,0.5934895833333333,46.97662601626016,1012.093495934959,25.302337398373975,6
4838,4,2,1,42,0.046511627906976744,0.023255813953488372,0.9767441860465116,43,1250,1000,250,0.8,15,10,5,320.92657115651,0.7734403839055002,0.06942319461444368,0.1742172814849625,128355.55555555546,-361.37571055589143,127994.17984499957,2572,0,776.8604651162791,39,4,18,38.536526864035096,0.5982905982905983,46.666666666666664,1013.3333333333326,25.982905982905965,0
4839,4,2,1,43,0.045454545454545456,0.022727272727272728,0.9772727272727273,44,1250,1000,250,0.8,15,10,5,314.6391093901746,0.7868217054263567,0.09339236126917672,0.1723352445014202,128711.08596280315,-700.4917088042898,128010.59425399886,2573,0,760.1590909090909,40,4,15,38.334167918544495,0.6002604166666667,46.3160569105691,1014.7357723577229,25.368394308943074,0
4840,4,0,1,42,0.0,0.023255813953488372,0.9767441860465116,43,1200,900,300,0.75,15,9,6,319.5654680035287,0.7795311923218899,0.09022434290026626,0.17463123049485754,128619.58007812499,-379.5247395833336,128240.05533854166,2574,1,778.8139534883721,39,4,15,38.30226945984803,0.6009615384615385,46.40625,1014.3749999999999,26.009615384615383,0
4841,4,0,0,42,0.0,0.0,1.0,42,950,700,250,0.7368421052631579,12,7,5,328.24169637830755,0.7697686798296555,0.08721461187214619,0.1788182375792271,128496.33487654309,35.57098765430794,128531.9058641974,2575,2,798.2857142857143,38,4,15,38.20776255707762,0.6014254385964912,46.52777777777777,1013.8888888888879,26.681286549707576,0
4842,4,0,0,42,0.0,0.0,1.0,42,1000,800,200,0.8,12,8,4,329.4835375276547,0.7681233062330624,0.08848194849880153,0.17998369995900748,128604.67916757964,74.62492694862976,128679.30409452827,2576,3,799.2857142857143,38,4,16,38.06592760339864,0.6025219298245614,46.42094017094016,1014.3162393162379,26.692532613585207,0
4843,4,1,1,42,0.023255813953488372,0.023255813953488372,0.9767441860465116,43,1300,800,500,0.6153846153846154,18,8,10,321.8920875615031,0.7786544850498338,0.09124370537705784,0.17719514182027618,128910.32036675338,-300.9575737847266,128609.36279296865,2577,0,781.6744186046511,39,4,17,37.94758864157009,0.6038995726495726,46.119791666666664,1015.5208333333326,26.038995726495706,0
4844,4,0,1,41,0.0,0.023809523809523808,0.9761904761904762,42,900,600,300,0.6666666666666666,12,6,6,326.81838885263227,0.7701074332171893,0.09316334405789273,0.17950452779639925,128821.50472094363,20.247324494098706,128841.75204543772,2578,5,801.2857142857143,38,4,17,37.912851680347984,0.6047149122807018,46.20726495726495,1015.1709401709386,26.71502474134049,0
4845,4,1,1,41,0.023809523809523808,0.023809523809523808,0.9761904761904762,42,1050,900,150,0.8571428571428571,12,9,3,321.4861596345071,0.7816250483933411,0.09933645589383322,0.17827868852459008,129201.38888888879,-92.70833333334292,129108.68055555545,2579,0,787.0714285714286,38,4,18,37.66222677595627,0.6085526315789473,45.83333333333333,1016.6666666666658,26.75438596491226,0
4846,4,2,2,41,0.046511627906976744,0.046511627906976744,0.9534883720930233,43,900,600,300,0.6666666666666666,12,6,6,311.5970429077731,0.7993263196751569,0.09730653271114775,0.1743124155888761,129545.80213758672,-526.782226562505,129019.01991102422,2580,0,752.9767441860465,39,4,14,37.56448463453733,0.6103098290598291,45.494791666666664,1018.0208333333327,26.103098290598275,0
4847,4,0,0,41,0.0,0.0,1.0,41,1250,900,350,0.72,16,9,7,326.43425718417456,0.7833333333333333,0.10364933569577062,0.18179213914494458,129368.6579043554,246.07234918438272,129614.73025353978,2581,2,790.7073170731708,37,4,19,37.366619961198545,0.6120495495495495,45.668859649122815,1017.3245614035104,27.495258416311092,0
4848,4,3,3,41,0.06818181818181818,0.06818181818181818,0.9318181818181819,44,850,600,250,0.7058823529411765,11,6,5,310.185365784568,0.8021714235377027,0.12146789073887998,0.17626322907995726,130158.8642363176,-725.3250173507879,129433.53921896682,2582,0,737.7272727272727,40,4,15,36.98025595060254,0.6148437500000001,44.89329268292683,1020.4268292682921,25.5106707317073,0
4849,4,0,0,41,0.0,0.0,1.0,41,1400,1100,300,0.7857142857142857,17,11,6,331.2010813276951,0.7820630081300813,0.12061778818390856,0.1862905840010258,129759.37307633132,395.28893505695737,130154.66201138828,2583,1,792.6341463414634,37,4,15,36.848902281532524,0.6159909909909909,45.285087719298254,1018.8596491228082,27.53674727358941,0
4850,4,0,1,40,0.0,0.024390243902439025,0.975609756097561,41,950,600,350,0.631578947368421,13,6,7,331.56414692455576,0.7819613821138212,0.12306368330464723,0.18702793142055052,129871.11418898132,412.1210372422386,130283.23522622355,2584,2,793.6341463414634,37,4,17,36.72636976477338,0.617117117117117,45.17543859649123,1019.2982456140359,27.54860123281178,0
4851,4,0,1,39,0.0,0.025,0.975,40,1200,1000,200,0.8333333333333334,14,10,4,339.076146481399,0.7708066239316239,0.1253258948298719,0.19135394500932837,129889.23890106335,808.4685191948856,130697.70742025823,2585,3,814.2,36,4,18,36.51656171748417,0.6192129629629629,45.157657657657666,1019.3693693693704,28.315815815815842,0
4852,4,0,0,39,0.0,0.0,1.0,39,1000,800,200,0.8,12,8,4,339.38338047657084,0.7703553756185335,0.1139531920316017,0.1919498132551751,129975.34855379054,1022.2946341612181,130997.64318795175,2586,4,801.3589743589744,36,3,19,36.42140622124057,0.6200810185185184,45.07319819819821,1019.7072072072093,28.325200200200257,0
4853,4,1,1,39,0.025,0.025,0.975,40,550,200,350,0.36363636363636365,9,2,7,332.41088556451325,0.7782051282051282,0.11391395423783401,0.18926072989113496,130234.60493853886,658.280071752855,130892.88501029172,2587,0,782.3,37,3,19,36.33658735274107,0.620777027027027,44.819078947368425,1020.723684210527,27.587126600284513,0
4854,4,2,1,40,0.04878048780487805,0.024390243902439025,0.975609756097561,41,1200,900,300,0.75,15,9,6,324.9719297545691,0.7913617886178862,0.12340723929978381,0.18646409766661406,130535.38795976712,284.06738530938173,130819.4553450765,2588,0,764.170731707317,38,3,16,36.222338386478484,0.6219846491228069,44.524572649572654,1021.9017094017106,26.892150247413436,0
4855,4,0,0,40,0.0,0.0,1.0,40,1250,800,450,0.64,17,8,9,333.36955921088975,0.7825053418803419,0.12503218884120182,0.19131799826634815,130542.57079101264,703.7838565712541,131246.35464758388,2589,1,784.275,37,3,16,36.0005364806867,0.6238738738738738,44.51754385964912,1021.9298245614036,27.619724988146043,0
4856,4,0,0,40,0.0,0.0,1.0,40,1050,600,450,0.5714285714285714,15,6,9,335.1959117078393,0.7817574786324787,0.1357453083109914,0.19306373543394695,130682.67549871116,760.859711642041,131443.5352103532,2590,2,785.275,37,3,17,35.81222073279713,0.6252815315315314,44.38048245614035,1022.4780701754388,27.634542437174023,0
4857,4,0,0,40,0.0,0.0,1.0,40,1350,1100,250,0.8148148148148148,16,11,5,336.79414673821304,0.7811698717948717,0.14094855305466325,0.19468955322599274,130822.85534972277,812.0743882732934,131634.92973799608,2591,3,786.275,37,3,17,35.62968917470526,0.6266891891891893,44.24342105263157,1023.0263157894718,27.649359886201943,0
4858,4,0,0,40,0.0,0.0,1.0,40,1350,900,450,0.6666666666666666,18,9,9,337.1134208525651,0.7794337606837607,0.141809513606171,0.1954420292073191,130935.05333371782,827.9927477685163,131763.04608148633,2592,4,787.275,37,3,17,35.50817798728663,0.6278153153153154,44.13377192982455,1023.4649122806998,27.661213845424317,0
4859,4,0,1,39,0.0,0.025,0.975,40,1600,1300,300,0.8125,19,13,6,336.31696308105165,0.7812232905982905,0.13540796659171228,0.19569246842454432,131075.36844269367,816.5739698753141,131891.94241256898,2593,5,788.275,37,3,18,35.386885640860875,0.6292229729729731,43.99671052631577,1024.0131578947348,27.676031294452294,0
4860,4,3,2,40,0.07142857142857142,0.047619047619047616,0.9523809523809523,42,650,400,250,0.6153846153846154,9,4,5,322.66686814538474,0.8080720092915215,0.1387788946424342,0.1901822851205203,131568.46923828125,90.55718315972251,131659.02642144097,2594,0,742.6666666666666,39,3,18,35.239723999052345,0.6306089743589745,43.515625,1025.9375,26.306089743589745,0
4861,4,0,0,40,0.0,0.0,1.0,40,800,600,200,0.75,10,6,4,339.14327416158335,0.7921474358974359,0.14953728469027538,0.19849544042506662,131300.0289151467,905.9043407586636,132205.93325590534,2595,1,780.8,37,3,21,35.08779554937412,0.6314752252252254,43.77741228070174,1024.8903508771907,27.699739212897047,0
4862,4,1,1,40,0.024390243902439025,0.024390243902439025,0.975609756097561,41,1400,1200,200,0.8571428571428571,16,12,4,330.5669196131096,0.8000508130081301,0.14201952743108937,0.1951502927402527,131629.446145171,502.4681085177551,132131.91425368877,2596,0,762.7317073170732,38,3,18,34.975707096998086,0.6329495614035089,43.456196581196565,1026.1752136752111,27.004610886189766,0
4863,4,1,0,41,0.024390243902439025,0.0,1.0,41,950,600,350,0.631578947368421,13,6,7,330.29786453593005,0.7969512195121952,0.1583869052753355,0.19625980652956898,131876.23844875421,511.68798853090885,132387.92643728512,2597,0,763.7073170731708,38,3,20,34.73428507038346,0.6354166666666669,43.21581196581195,1027.1367521367501,27.02991452991448,0
4864,4,0,0,41,0.0,0.0,1.0,41,750,600,150,0.8,9,6,3,329.2656824039801,0.7970020325203252,0.144799318209488,0.1959293813116751,131931.11257213805,489.10770052594694,132420.220272664,2598,1,764.7073170731708,38,3,19,34.705612174154176,0.6359649122807018,43.16239316239315,1027.350427350426,27.035537561853314,1
4865,4,0,1,40,0.0,0.024390243902439025,0.975609756097561,41,1350,1100,250,0.8148148148148148,16,11,5,327.19488638092827,0.7978658536585366,0.14171743214158083,0.19540297963196188,132068.34781804716,442.4176117685578,132510.7654298157,2599,2,765.7073170731708,38,3,19,34.620881405259325,0.6373355263157896,43.028846153846146,1027.8846153846139,27.049595141700365,0
4866,4,0,0,40,0.0,0.0,1.0,40,1200,1000,200,0.8333333333333334,14,10,4,336.9154932206212,0.7890491452991453,0.15252641126880784,0.20071424583410283,131975.16453379867,892.8955303554677,132868.06006415412,2600,3,785.725,37,3,19,34.46481609931348,0.638231981981982,43.11951754385964,1027.5219298245597,27.770862968231345,0
4867,4,0,0,40,0.0,0.0,1.0,40,1200,1000,200,0.8333333333333334,14,10,4,335.0874175031838,0.7880608974358975,0.154635161083849,0.2000706657117734,132059.6782182978,850.3073060941629,132909.98552439196,2601,4,786.725,37,3,19,34.426783301329905,0.6390765765765767,43.037280701754376,1027.8508771929812,27.77975343764814,0
4868,4,0,0,40,0.0,0.0,1.0,40,800,600,200,0.75,10,6,4,336.1415283343069,0.7884348290598291,0.15710705907442923,0.2012985474277859,132172.40521121875,885.726858264069,133058.13206948282,2602,5,787.725,37,3,19,34.286361697590095,0.6402027027027027,42.92763157894736,1028.2894736842097,27.791607396870532,0
4869,4,0,0,40,0.0,0.0,1.0,40,1000,700,300,0.7,13,7,6,336.39573704387556,0.7892361111111111,0.1611969729268814,0.20205280441393342,132285.18029586025,900.0341451215716,133185.21444098183,2603,6,788.725,37,3,19,34.16648902153059,0.6413288288288288,42.81798245614035,1028.7280701754385,27.80346135609293,0
4870,4,0,0,40,0.0,0.0,1.0,40,1250,800,450,0.64,17,8,9,337.6829671197852,0.7901175213675213,0.15936542669584286,0.2035898627621925,132426.97934420916,943.715154053147,133370.6944982623,2604,7,789.725,36,4,19,33.99092815463167,0.6446759259259258,42.68018018018019,1029.27927927928,28.591091091091112,0
4871,4,1,0,41,0.024390243902439025,0.0,1.0,41,850,600,250,0.7058823529411765,11,6,5,331.04572204617483,0.7923272357723578,0.161193565127141,0.20154338000220498,132793.26331178838,592.1283471837675,133385.39165897216,2605,0,771.439024390244,37,4,18,33.79432624113476,0.6463963963963963,42.32456140350878,1030.701754385966,27.856804172593677,0
4872,4,0,0,41,0.0,0.0,1.0,41,1150,700,450,0.6086956521739131,16,7,9,334.0424812289348,0.7890752032520325,0.16742073235551103,0.20444616922059808,132991.1141529126,684.936350607898,133676.0505035205,2606,1,772.439024390244,37,4,19,33.51881134616067,0.648367117117117,42.1326754385965,1031.4692982456154,27.87754860123285,0
4873,4,0,0,41,0.0,0.0,1.0,41,1150,700,450,0.6086956521739131,16,7,9,333.97882675779385,0.7872967479674797,0.16276400307825423,0.2053391702332538,133160.81781173067,694.5787405740386,133855.3965523047,2607,2,773.439024390244,37,4,19,33.350486029958574,0.6500563063063062,41.96820175438597,1032.1271929824572,27.895329540066413,0
4874,4,1,0,42,0.023809523809523808,0.0,1.0,42,1150,800,350,0.6956521739130435,15,8,7,325.79738738412647,0.7888840495547813,0.17450395800431973,0.20305170073992015,133665.49014034998,309.5734942289513,133975.06363457892,2608,0,756.0,38,4,20,33.057177049970726,0.6532346491228069,41.47970085470086,1034.0811965811972,27.212663067926243,0
4875,4,0,0,42,0.0,0.0,1.0,42,850,600,250,0.7058823529411765,11,6,5,326.8132351389344,0.7880371660859465,0.17451628451421897,0.20414230597517175,133748.36205164727,342.1469793264622,134090.50903097374,2609,1,757.0,38,4,16,32.94816842250224,0.6540570175438596,41.39957264957265,1034.401709401709,27.22109761583445,0
4876,4,0,0,42,0.0,0.0,1.0,42,750,400,350,0.5333333333333333,11,4,7,325.99272749722263,0.7876016260162602,0.1706341012556174,0.2042409805005239,133858.89788333702,327.4054441522457,134186.30332748927,2610,2,758.0,38,4,18,32.85906635005852,0.6551535087719298,41.292735042735046,1034.82905982906,27.232343679712105,0
4877,4,0,0,42,0.0,0.0,1.0,42,1400,1100,300,0.7857142857142857,17,11,6,323.0515136531203,0.7867305458768873,0.16855334787650111,0.20331267989130142,134024.78723792822,259.3820768500208,134284.16931477824,2611,3,759.0,38,4,18,32.7697241711377,0.6567982456140351,41.13247863247863,1035.4700854700852,27.24921277552856,0
4878,4,0,0,42,0.0,0.0,1.0,42,950,600,350,0.631578947368421,13,6,7,322.2187163023234,0.785762679055362,0.16965759075907627,0.20340056466584155,134135.4372123602,244.18967784351537,134379.6268902037,2612,4,760.0,38,4,19,32.68100247524753,0.6578947368421053,41.02564102564102,1035.8974358974351,27.260458839406187,0
4879,4,0,0,42,0.0,0.0,1.0,42,1100,800,300,0.7272727272727273,14,8,6,323.8376022956745,0.7851819589624468,0.16961217476681445,0.2050407795214125,134246.13284388903,294.7891555263093,134540.92199941535,2613,5,761.0,38,4,19,32.528780068728516,0.6589912280701755,40.91880341880341,1036.3247863247846,27.271704903283805,0
4880,4,0,0,42,0.0,0.0,1.0,42,900,600,300,0.6666666666666666,12,6,6,323.3023124356281,0.7856658923732095,0.16317695909532692,0.20501170165035698,134301.49778106494,283.99695923732475,134585.49474030227,2614,6,762.0,38,4,19,32.48750257678829,0.6595394736842106,40.865384615384606,1036.5384615384603,27.27732793522264,0
4881,4,0,0,42,0.0,0.0,1.0,42,1250,800,450,0.64,17,8,9,324.72294841255894,0.7848915989159891,0.1676084525281063,0.2068510750124096,134467.66107823802,332.94707429322585,134800.60815253123,2615,7,763.0,38,4,19,32.285228677379486,0.6611842105263158,40.705128205128204,1037.179487179487,27.294197031039133,0
4882,4,0,0,42,0.0,0.0,1.0,42,1200,1000,200,0.8333333333333334,14,10,4,324.9608069909269,0.7838269454123112,0.16985859417902271,0.20763285246683424,134578.49368105773,346.54718204397227,134925.04086310172,2616,8,764.0,38,4,19,32.168751716090064,0.6622807017543859,40.598290598290596,1037.6068376068372,27.305443094916768,0
4883,4,0,0,42,0.0,0.0,1.0,42,650,500,150,0.7692307692307693,8,5,3,327.44650176009793,0.7833430120015485,0.17069619694696914,0.20953987602750915,134633.92710387893,417.08168967783047,135051.00879355677,2617,9,765.0,38,4,19,32.049104385423085,0.662828947368421,40.54487179487179,1037.820512820512,27.31106612685558,0
4884,4,0,0,42,0.0,0.0,1.0,42,1350,1100,250,0.8148148148148148,16,11,5,331.02157524639813,0.7822783584978706,0.16988602397122698,0.2124747469117895,134744.82819234405,520.6890569069894,135265.51724925105,2618,10,766.0,38,4,19,31.845973108321324,0.6639254385964912,40.43803418803418,1038.247863247862,27.322312190733207,0
4885,4,0,0,42,0.0,0.0,1.0,42,600,300,300,0.5,9,3,6,331.1461667428745,0.7820363917924894,0.17034097589653152,0.21287967862041926,134800.2958579881,527.7202498356244,135328.01610782373,2619,11,767.0,38,4,16,31.78755144032922,0.6644736842105263,40.38461538461538,1038.4615384615379,27.32793522267205,0
4886,4,1,0,43,0.023255813953488372,0.0,1.0,43,1450,1000,450,0.6896551724137931,19,10,9,328.49102012939215,0.7865909929863418,0.1786758419545793,0.2133588714347246,135172.91802300327,280.6179470485929,135453.53597005186,2620,0,750.1395348837209,39,4,18,31.486130588667404,0.6663995726495727,40.02604166666666,1039.8958333333317,26.663995726495685,0
4887,4,0,1,42,0.0,0.023255813953488372,0.9767441860465116,43,900,600,300,0.6666666666666666,12,6,6,327.99915762656167,0.7864525655223329,0.17944991055456172,0.21319945245726485,135199.99999999985,269.0972222222085,135469.09722222207,2621,1,751.1395348837209,39,4,18,31.472021901709407,0.6666666666666667,39.99999999999999,1039.9999999999989,26.666666666666636,0
4888,4,0,0,42,0.0,0.0,1.0,42,950,700,250,0.7368421052631579,12,7,5,324.2275440574154,0.7812862950058072,0.1300037895686128,0.20204688197476242,133660.65673828137,275.80023871529204,133936.45697699665,2622,2,768.8095238095239,39,3,19,33.102586380578224,0.6514423076923077,41.48437500000001,1034.062500000001,26.5144230769231,3
4889,4,0,0,42,0.0,0.0,1.0,42,900,500,400,0.5555555555555556,13,5,8,322.8602400236358,0.7810927216415021,0.13107587682066457,0.20148832955340557,133714.51958550359,234.22037760417663,133948.73996310777,2623,3,769.8095238095239,39,3,18,33.084168429180494,0.6519764957264957,41.43229166666667,1034.2708333333344,26.519764957264986,0
4890,4,0,0,42,0.0,0.0,1.0,42,1050,700,350,0.6666666666666666,14,7,7,323.94824485186655,0.7804636082075106,0.1347631676184866,0.2027115599776801,133813.73443593437,269.7448815189508,134083.4793174533,2624,4,770.8095238095239,40,2,18,32.95701961169499,0.6513020833333333,41.336382113821145,1034.6544715447162,25.866361788617905,0
4891,4,0,0,42,0.0,0.0,1.0,42,1300,900,400,0.6923076923076923,17,9,8,323.51974262725327,0.7792779713511421,0.13729285901320454,0.20287715880024293,133892.60691387398,263.3803456936972,134155.9872595677,2625,5,771.8095238095239,40,2,18,32.88941804137209,0.6520833333333333,41.260162601626014,1034.9593495934957,25.873983739837392,0
4892,4,0,1,41,0.0,0.023809523809523808,0.9761904761904762,42,850,700,150,0.8235294117647058,10,7,3,323.59158615053127,0.777632597754549,0.13676687793295605,0.20350315306800065,133997.80636525873,272.1125404851564,134269.9189057439,2626,6,772.8095238095239,40,2,19,32.78264461457924,0.6531250000000001,41.15853658536585,1035.365853658536,25.8841463414634,0
4893,4,0,0,41,0.0,0.0,1.0,41,1250,1000,250,0.8,15,10,5,320.15850500725514,0.7763719512195122,0.1266487270122627,0.20186024193323615,134091.86333550327,386.13009982636476,134477.99343532964,2627,7,758.780487804878,39,2,19,32.77777079352308,0.6557158119658122,41.06770833333332,1035.729166666665,26.557158119658077,0
4894,4,0,0,41,0.0,0.0,1.0,41,950,700,250,0.7368421052631579,12,7,5,320.15850500725514,0.7770833333333333,0.1266487270122627,0.20186024193323615,134091.86333550327,386.13009982636476,134477.99343532964,2628,8,759.780487804878,39,2,19,32.77777079352308,0.6557158119658122,41.06770833333332,1035.729166666665,26.557158119658077,0
4895,4,0,1,40,0.0,0.024390243902439025,0.975609756097561,41,1150,700,450,0.6086956521739131,16,7,9,320.10724498432256,0.7759654471544716,0.12865749447682528,0.2024225534557567,134199.77349175327,391.6639539930368,134591.4374457463,2629,9,760.780487804878,39,2,19,32.67159696390872,0.6567841880341883,40.96354166666666,1036.1458333333317,26.567841880341838,0
4896,4,0,0,40,0.0,0.0,1.0,40,1150,600,550,0.5217391304347826,17,6,11,329.010521840791,0.7709935897435898,0.13890206185567067,0.20831606147882956,134246.132843889,833.6780444151985,135079.8108883042,2630,10,779.3,38,2,20,32.39475945017182,0.6589912280701755,40.91880341880341,1036.3247863247843,27.271704903283798,0
4897,4,0,0,40,0.0,0.0,1.0,40,1350,900,450,0.6666666666666666,18,9,9,328.9715825685704,0.7694711538461538,0.15096685082872963,0.20925955939106167,134415.7240125867,843.7906901041574,135259.51470269085,2631,11,780.3,39,1,20,32.22679139460909,0.6589209401709402,40.75520833333333,1036.9791666666658,26.58920940170938,0
4898,4,0,1,39,0.0,0.025,0.975,40,900,400,500,0.4444444444444444,14,4,10,330.3228459944528,0.7696047008547009,0.15348533547609478,0.21027456871616185,134442.73003472216,881.9010416666623,135324.63107638882,2632,12,781.3,39,1,20,32.164858711664664,0.6591880341880343,40.729166666666664,1037.083333333333,26.591880341880334,0
4899,4,0,0,39,0.0,0.0,1.0,39,700,500,200,0.7142857142857143,9,5,4,336.6680198339207,0.7615272154745839,0.15895481188568716,0.2142974733460896,134439.96006145433,1252.3270280882336,135692.28708954257,2633,13,801.7179487179487,38,1,20,32.00310772294909,0.6609100877192983,40.7318376068376,1037.0726495726485,27.2913855150697,0
4900,4,0,0,39,0.0,0.0,1.0,39,1100,700,400,0.6363636363636364,15,7,8,336.3126974749722,0.7598403058929375,0.16475217196123526,0.21455954615518888,134523.07167251053,1248.363421360192,135771.43509387074,2634,14,802.7179487179487,38,1,20,31.929497082045998,0.661732456140351,40.65170940170939,1037.3931623931605,27.299820062977908,0
4901,4,0,0,39,0.0,0.0,1.0,39,1450,1200,250,0.8275862068965517,17,12,5,340.37550249898584,0.7583783175888439,0.1656454679907038,0.217996921965859,134664.56626077235,1367.3067355322196,136031.87299630456,2635,15,803.7179487179487,37,2,20,31.683129093598136,0.6649774774774776,40.51535087719297,1037.9385964912267,28.052394499762883,0
4902,4,0,0,39,0.0,0.0,1.0,39,750,500,250,0.6666666666666666,10,5,5,342.18088398086826,0.7582096266306793,0.16843935614401473,0.2193247412760242,134693.02002779683,1417.8753318328531,136110.89535962968,2636,16,804.7179487179487,37,2,20,31.60793193901624,0.6652590090090091,40.48793859649122,1038.0482456140337,28.055357989568478,0
4903,4,0,0,39,0.0,0.0,1.0,39,900,700,200,0.7777777777777778,11,7,4,343.3538245044376,0.7566914080071975,0.16940947120461414,0.22059434993602586,134778.3993632655,1455.3357763927238,136233.7351396582,2637,17,805.7179487179487,37,2,20,31.49243224216825,0.6661036036036037,40.40570175438596,1038.3771929824552,28.064248458985276,0
4904,4,0,0,39,0.0,0.0,1.0,39,1200,900,300,0.75,15,9,6,344.3060485527758,0.75629779577148,0.16306089743589758,0.22155345732961218,134835.3339489073,1484.9242074484368,136320.25815635573,2638,18,806.7179487179487,37,2,18,31.41100084459458,0.6666666666666667,40.35087719298245,1038.5964912280697,28.07017543859648,0
4905,4,0,0,39,0.0,0.0,1.0,39,1250,900,350,0.72,16,9,7,344.37743032910004,0.7552856500224921,0.1635636643022167,0.22264729090444826,135006.20984341338,1498.618324869194,136504.82816828258,2639,19,807.7179487179487,37,2,19,31.239009636350858,0.6683558558558558,40.18640350877193,1039.2543859649124,28.087956377430068,0
4906,4,0,0,39,0.0,0.0,1.0,39,1050,600,450,0.5714285714285714,15,6,9,346.7048144838848,0.7560728744939271,0.16591506342666218,0.22521564798391513,135177.1939442904,1573.316789781458,136750.51073407187,2640,20,808.7179487179487,37,2,19,31.00836496555602,0.670045045045045,40.0219298245614,1039.9122807017534,28.105737316263607,0
4907,4,0,0,39,0.0,0.0,1.0,39,1100,900,200,0.8181818181818182,13,9,4,345.4567028537971,0.7551731893837157,0.16664909506237935,0.22458237330831154,135205.70181450064,1541.543191174211,136747.24500567486,2641,21,809.7179487179487,37,2,19,31.01245387453875,0.6703265765765766,39.99451754385965,1040.0219298245618,28.108700806069237,0
4908,4,0,0,39,0.0,0.0,1.0,39,900,600,300,0.6666666666666666,12,6,6,344.52138684441894,0.7546108861898336,0.1643015077550185,0.22415156897161556,135234.21269044312,1518.2157009849097,136752.42839142802,2642,22,810.7179487179487,37,2,19,31.008415911167333,0.6706081081081081,39.96710526315789,1040.1315789473679,28.111664295874807,0
4909,4,0,0,39,0.0,0.0,1.0,39,1100,900,200,0.8181818181818182,13,9,4,342.60618178375927,0.7536549707602339,0.15955196420900752,0.22379045225806352,135376.81215614435,1476.1865429747775,136852.99869911914,2643,23,811.7179487179487,37,2,19,30.916460330839744,0.6720157657657657,39.83004385964913,1040.6798245614048,28.126481744902833,0
4910,4,0,0,39,0.0,0.0,1.0,39,1400,1100,300,0.7857142857142857,17,11,6,343.13929651439173,0.7525865946918578,0.16262819197356437,0.22504950093063686,135522.41421031492,1500.6131748119003,137023.02738512683,2644,24,812.7179487179487,38,1,19,30.757917778233807,0.6716008771929824,39.690170940170944,1041.2393162393168,27.40103463787676,0
4911,4,0,0,39,0.0,0.0,1.0,39,800,500,300,0.625,11,5,6,343.13929651439173,0.7525865946918578,0.16262819197356437,0.22504950093063686,135522.41421031492,1500.6131748119003,137023.02738512683,2645,25,813.7179487179487,38,1,19,30.757917778233807,0.6716008771929824,39.690170940170944,1041.2393162393168,27.40103463787676,0
4912,4,0,0,39,0.0,0.0,1.0,39,1200,800,400,0.6666666666666666,16,8,8,353.20802889056876,0.7525865946918578,0.12419481752815109,0.22341471706933552,134209.71476800548,1686.0660104995545,135895.78077850502,2646,26,814.7179487179487,37,2,20,31.8042328042328,0.660472972972973,40.95394736842105,1036.1842105263152,28.004978662873384,5
4913,4,0,0,39,0.0,0.0,1.0,39,1250,1000,250,0.8,15,10,5,345.55267316804304,0.7533738191632928,0.08086362838075245,0.20180276113013687,131215.75869498297,1268.8240612496056,132484.5827562326,2647,27,815.7179487179487,37,2,19,35.00865082762559,0.6306306306306306,43.859649122807014,1024.561403508771,27.6908487434803,8
4914,4,0,1,38,0.0,0.02564102564102564,0.9743589743589743,39,1150,1000,150,0.8695652173913043,13,10,3,344.9032143505315,0.7512370670265407,0.08122427940070454,0.20216702899117114,131356.98356718203,1261.1372636627357,132618.12083084477,2648,28,816.7179487179487,36,3,22,34.88273096781278,0.6339699074074074,43.721846846846844,1025.1126126126126,28.47535035035035,0
4915,4,0,0,38,0.0,0.0,1.0,38,1500,1300,200,0.8666666666666667,17,13,4,345.9561489623418,0.7486367946894262,0.08596808011451706,0.2034185425318719,131476.45968632106,1497.0179344564358,132973.4776207775,2649,29,829.3684210526316,35,3,22,34.73519260429599,0.637202380952381,43.60532407407407,1025.578703703703,29.302248677248656,0
4916,4,0,0,38,0.0,0.0,1.0,38,1400,1100,300,0.7857142857142857,17,11,6,347.5791697802058,0.7478662873399715,0.08803099118354285,0.2050092707985044,131595.18771701367,1547.9492187499754,133143.13693576364,2650,30,830.3684210526316,35,3,15,34.57381556683586,0.6383928571428572,43.48958333333332,1026.041666666665,29.31547619047614,0
4917,4,1,0,39,0.02564102564102564,0.0,1.0,39,550,300,250,0.5454545454545454,8,3,5,335.48629459399046,0.7569725596041386,-0.0039808236776304184,0.18991832172968395,130010.85820877586,923.3722154893868,130934.23042426525,2651,0,810.0512820512821,37,2,18,36.48476418306275,0.6185247747747746,45.03837719298246,1019.8464912280708,27.563418681839753,5
4918,4,0,0,39,0.0,0.0,1.0,39,650,300,350,0.46153846153846156,10,3,7,335.8539390371266,0.7569725596041386,-0.00649223604623872,0.19067241627458584,130122.70752779699,940.444776277315,131063.1523040743,2652,1,811.0512820512821,37,2,18,36.36205892889129,0.6196509009009008,44.92872807017544,1020.2850877192981,27.57527264106211,0
4919,4,0,0,39,0.0,0.0,1.0,39,1150,800,350,0.6956521739130435,15,8,7,333.45127886256694,0.7552856500224921,-0.003977829933996313,0.18971665670249227,130206.62607725456,883.5131963681195,131090.13927362268,2653,2,812.0512820512821,37,2,18,36.33836484744306,0.6204954954954955,44.84649122807018,1020.6140350877196,27.584163110478908,0
4920,4,2,2,39,0.04878048780487805,0.04878048780487805,0.9512195121951219,41,800,700,100,0.875,9,7,2,317.0406279853992,0.7764227642276422,0.001849026030509071,0.18238198845537543,130635.03146701379,83.322482638879,130718.35394965266,2654,0,773.390243902439,39,2,13,36.324383533727335,0.6212606837606838,44.42708333333333,1022.2916666666658,26.212606837606817,0
4921,4,0,0,39,0.0,0.0,1.0,39,650,400,250,0.6153846153846154,9,4,5,328.8819578628606,0.7568038686459739,-0.0014642577974475213,0.18819805402029544,130430.54112803942,779.2503462603947,131209.79147429983,2655,4,814.0512820512821,37,2,18,36.22844210676972,0.6227477477477477,44.627192982456144,1021.4912280701756,27.607871028923665,0
4922,4,0,0,39,0.0,0.0,1.0,39,1200,900,300,0.75,15,9,6,332.2240349307049,0.7563540260908682,0.0012544048591682788,0.190798535402902,130570.58572108728,875.7373663050195,131446.3230873923,2656,5,815.0512820512821,37,2,15,36.00147963380181,0.6241554054054053,44.49013157894737,1022.0394736842107,27.62268847795164,0
4923,4,0,0,39,0.0,0.0,1.0,39,1000,600,400,0.6,14,6,8,332.206800882634,0.75629779577148,0.00020897779610917766,0.19134208883450063,130682.67549871124,882.7347116420549,131565.4102103533,2657,6,816.0512820512821,37,2,16,35.888628239499546,0.6252815315315314,44.380482456140356,1022.4780701754394,27.634542437174037,0
4924,4,0,0,39,0.0,0.0,1.0,39,650,400,250,0.6153846153846154,9,4,5,331.1484086252573,0.7563540260908682,-0.0056411905881188495,0.1910093510975743,130738.7384219184,858.7850348184207,131597.52345673682,2658,7,817.0512820512821,37,2,17,35.8590427432901,0.6258445945945945,44.32565789473685,1022.6973684210536,27.640469416785233,0
4925,4,0,0,39,0.0,0.0,1.0,39,750,600,150,0.8,9,6,3,330.93800476037745,0.755791722896986,-0.007938602278224849,0.19102659086663412,130766.7743921209,855.1390812558027,131621.9134733767,2659,8,818.0512820512821,37,2,17,35.83610277301316,0.626126126126126,44.2982456140351,1022.8070175438617,27.643432906590856,0
4926,4,0,1,38,0.0,0.02564102564102564,0.9743589743589743,39,1300,900,400,0.6923076923076923,17,9,8,329.4893059690996,0.7564664867296447,-0.017537208880683997,0.19102193676494283,130935.05333371833,828.3399699907964,131763.39330370913,2660,9,819.0512820512821,37,2,19,35.703253339047215,0.6278153153153152,44.133771929824576,1023.4649122807039,27.661213845424427,0
4927,4,0,0,38,0.0,0.0,1.0,38,900,500,400,0.5555555555555556,13,5,8,336.6032755315188,0.752993124703651,-0.008324116485514788,0.19523849210631639,130953.25213304536,1215.8587218975933,132169.11085494296,2661,10,839.9473684210526,36,2,19,35.50285143213408,0.6299189814814814,44.115990990991,1023.5360360360373,28.431556556556593,0
4928,4,0,0,38,0.0,0.0,1.0,38,600,400,200,0.6666666666666666,8,4,4,336.57739541843375,0.7532598387861545,-0.0023128716081264322,0.195515980942427,131010.89000740617,1219.0608260287422,132229.9508334349,2662,11,840.9473684210526,36,2,19,35.44531221354453,0.6304976851851851,44.05968468468469,1023.7612612612622,28.43781281281284,0
4929,4,0,1,37,0.0,0.02631578947368421,0.9736842105263158,38,600,200,400,0.3333333333333333,10,2,8,336.8458840741786,0.7533191085822665,-0.008083140877598316,0.19596542699209893,131068.54056336741,1229.9796840759684,132298.52024744338,2663,12,841.9473684210526,36,2,19,35.380237545364565,0.6310763888888888,44.00337837837838,1023.9864864864865,28.44406906906907,0
4930,4,0,0,37,0.0,0.0,1.0,37,900,600,300,0.6666666666666666,12,6,6,338.2461324039747,0.7542542542542543,-0.002009240061437545,0.19735112181328815,131179.8740381731,1474.2170085305315,132654.09104670363,2664,13,844.081081081081,35,2,20,35.23201239031371,0.6342261904761903,43.89467592592593,1024.421296296297,29.269179894179914,0
4931,4,0,0,37,0.0,0.0,1.0,37,800,400,400,0.5,12,4,8,337.948378812597,0.7536911911911912,-0.007491734363981095,0.19748231007445044,131239.16437596467,1470.412567515449,132709.57694348012,2665,14,845.081081081081,35,2,20,35.17981192815995,0.6348214285714284,43.836805555555564,1024.652777777779,29.275793650793684,0
4932,4,2,1,38,0.05128205128205128,0.02564102564102564,0.9743589743589743,39,1200,1000,200,0.8333333333333334,14,10,4,324.20301533951556,0.7723796671165093,-0.0025901132147796435,0.1922838023213784,131806.21831957917,746.3946839412181,132552.61300352038,2666,0,802.6923076923077,37,2,15,34.96118081509165,0.6365427927927928,43.28399122807018,1026.86403508772,27.753082029397834,0
4933,4,1,0,39,0.02564102564102564,0.0,1.0,39,900,600,300,0.6666666666666666,12,6,6,324.0210075754385,0.7710301394511921,0.009030457269518344,0.19288925292133774,131946.99931709742,750.7199330563112,132697.71925015372,2667,0,803.6666666666666,37,2,17,34.82435076485236,0.6379504504504505,43.1469298245614,1027.4122807017534,27.767899478425768,0
4934,4,0,0,39,0.0,0.0,1.0,39,1050,800,250,0.7619047619047619,13,8,5,323.94592711111113,0.7709739091318039,0.013779145299145368,0.19356233694497557,132087.85545792934,757.8645592874691,132845.7200172168,2668,1,804.6666666666666,37,2,17,34.68477777777779,0.6393581081081081,43.00986842105263,1027.9605263157891,27.78271692745376,0
4935,4,0,0,39,0.0,0.0,1.0,39,1200,800,400,0.6666666666666666,16,8,8,335.9972969406656,0.7702991452991453,0.029236588003447306,0.19593550237326426,131159.59357686958,1013.8537819328754,132173.44735880246,2669,2,805.6666666666666,37,2,19,35.31006922143723,0.6300675675675678,43.91447368421051,1024.342105263156,27.684921763869085,2
4936,4,0,0,39,0.0,0.0,1.0,39,1200,1100,100,0.9166666666666666,13,11,2,339.4738359911308,0.7690620782726046,0.021896508683713733,0.19868891327545962,131300.0289151465,1114.5848963142053,132414.61381146073,2670,3,806.6666666666666,37,2,19,35.079325808637364,0.6314752252252254,43.77741228070173,1024.8903508771893,27.699739212897008,0
4937,4,0,0,39,0.0,0.0,1.0,39,700,500,200,0.7142857142857143,9,5,4,340.3372583304472,0.7687809266756636,0.0166698207130338,0.19948671022767064,131356.22409058537,1141.0834343259196,132497.3075249113,2671,4,807.6666666666666,37,2,19,35.00051253253467,0.6320382882882885,43.72258771929823,1025.1096491228054,27.705666192508254,0
4938,4,0,0,39,0.0,0.0,1.0,39,1350,1100,250,0.8148148148148148,16,11,5,344.4818810213565,0.7687809266756636,0.013508549749730259,0.20265934057067694,131496.7646295011,1259.650565558603,132756.4151950597,2672,5,808.6666666666666,37,2,19,34.75251229420569,0.633445945945946,43.58552631578946,1025.6578947368398,27.720483641536212,0
4939,4,0,0,39,0.0,0.0,1.0,39,1200,900,300,0.75,15,9,6,346.41654078122605,0.7679937022042286,0.003895879737315866,0.20454967855971562,131637.38031173046,1320.2731850184618,132957.6534967489,2673,6,809.6666666666666,37,2,16,34.561095380560594,0.6348536036036037,43.4484649122807,1026.2061403508767,27.735301090564235,0
4940,4,1,0,40,0.025,0.0,1.0,40,850,500,350,0.5882352941176471,12,5,7,344.4216649350116,0.7749465811965812,0.03126364486952915,0.20539318009980626,132013.44515897796,1093.658115092404,133107.10327407037,2674,0,790.4,38,2,17,34.23346155178986,0.6367872807017544,43.082264957264954,1027.6709401709397,27.043972109761572,0
4941,4,0,0,40,0.0,0.0,1.0,40,1150,900,250,0.782608695652174,14,9,5,342.87801314828334,0.7750267094017094,0.03236486486486512,0.20462074978204017,132040.89506172843,1054.7839506172884,133095.6790123457,2675,1,791.4,38,2,17,34.245495495495504,0.6370614035087719,43.05555555555556,1027.777777777778,27.046783625731003,0
4942,4,0,2,38,0.0,0.05,0.95,40,1100,700,400,0.6363636363636364,15,7,8,338.59397640561946,0.775400641025641,0.034943890274314215,0.20265102169948268,132150.7232084155,949.087771203157,133099.81097961866,2676,2,792.4,38,2,18,34.245116375727356,0.6381578947368421,42.94871794871795,1028.2051282051282,27.058029689608635,0
4943,4,0,0,38,0.0,0.0,1.0,38,950,700,250,0.7368421052631579,12,7,5,355.85248679727977,0.7660917496443812,0.03202206349023151,0.21160928191426265,131905.89871966577,1787.8084165246505,133693.7071361904,2677,3,831.1578947368421,36,2,18,34.04818022363518,0.6394675925925926,43.186936936936945,1027.2522522522536,28.534784784784822,0
4944,4,0,0,38,0.0,0.0,1.0,38,900,600,300,0.6666666666666666,12,6,6,357.84262713454655,0.7664770033191086,0.029130497476567818,0.21327981532349705,131992.67415642014,1846.5210565295192,133839.19521294965,2678,4,832.1578947368421,36,2,18,33.909589041095884,0.6403356481481481,43.102477477477485,1027.5900900900915,28.54416916916921,0
4945,4,1,0,39,0.02564102564102564,0.0,1.0,39,700,500,200,0.7142857142857143,9,5,4,352.8007408699677,0.7738978857399911,0.03948641424659316,0.21190630927285772,132285.18029586028,1534.061922899352,133819.24221875964,2679,0,811.7948717948718,37,2,20,33.74458182334966,0.6413288288288288,42.81798245614035,1028.7280701754387,27.80346135609294,0
4946,4,0,0,39,0.0,0.0,1.0,39,1250,1100,150,0.88,14,11,3,354.343320040496,0.7733355825461089,0.04320501890834372,0.21315113559359078,132341.58587257622,1578.8713835026188,133920.45725607884,2680,1,812.7948717948718,37,2,20,33.64814222790566,0.6418918918918919,42.76315789473684,1028.947368421053,27.809388335704135,0
4947,4,0,0,39,0.0,0.0,1.0,39,1200,1000,200,0.8333333333333334,14,10,4,358.2028407074989,0.7726608187134503,0.04564534056492753,0.21628080201946656,132482.65241468523,1691.1324878808846,134173.7849025661,2681,2,813.7948717948718,37,2,20,33.406890155146094,0.6432995495495495,42.62609649122807,1029.4956140350873,27.82420578473209,0
4948,4,1,1,39,0.025,0.025,0.975,40,1100,800,300,0.7272727272727273,14,8,6,356.3716686329172,0.7823985042735043,0.04321291593241461,0.21690331150168787,132783.12108490395,1464.0284854627835,134247.14957036675,2682,0,794.425,38,2,15,33.151929788189776,0.6444627192982456,42.33440170940171,1030.6623931623933,27.12269455690509,0
4949,4,0,0,39,0.0,0.0,1.0,39,500,400,100,0.8,6,4,2,362.9855037974723,0.772829509671615,0.04784396547725267,0.22048964312765656,132708.51518015156,1834.2534481763616,134542.76862832793,2683,4,815.7948717948718,37,2,15,33.05653843425208,0.6455518018018018,42.406798245614034,1030.3728070175437,27.847913703176857,0
4950,4,0,0,39,0.0,0.0,1.0,39,550,200,350,0.36363636363636365,9,2,7,370.01312365049495,0.772829509671615,-0.0013715686191841936,0.22019763385932598,131934.82069485032,1967.905382747156,133902.72607759747,2684,5,816.7948717948718,36,3,16,33.655321714348354,0.6397569444444444,43.15878378378379,1027.3648648648655,28.53791291291293,3
4951,4,0,0,39,0.0,0.0,1.0,39,350,200,150,0.5714285714285714,5,2,3,377.3956576203468,0.772829509671615,-0.02086621816677736,0.22289090265030564,131645.74361100944,2136.506396599277,133782.25000760873,2685,6,817.7948717948718,36,3,17,33.75786422327079,0.636863425925926,43.4403153153153,1026.2387387387369,28.506631631631578,1
4952,4,1,0,40,0.025,0.0,1.0,40,1300,1000,300,0.7692307692307693,16,10,6,372.9194938205458,0.7810096153846153,-0.019795221843003086,0.2229906361008566,132116.03570329305,1853.7290320098195,133969.76473530286,2686,0,798.325,37,3,18,33.397770904436854,0.6396396396396398,42.98245614035086,1028.0701754385943,27.785680417259307,0
4953,4,0,0,40,0.0,0.0,1.0,40,1250,900,350,0.72,16,9,7,375.71866344662516,0.7819711538461539,-0.020726313545774255,0.22584037278153005,132313.38158135198,1942.5213767697737,134255.90295812176,2687,1,799.325,37,3,18,33.126731855483314,0.6416103603603605,42.790570175438596,1028.8377192982457,27.806424845898533,0
4954,4,0,0,40,0.0,0.0,1.0,40,1000,800,200,0.8,12,8,4,378.94033776452125,0.7815705128205128,-0.017156862745097534,0.2279471877937351,132341.5858725762,2029.9130501692846,134371.49892274546,2688,2,800.325,37,3,18,33.015416311452114,0.6418918918918919,42.76315789473684,1028.9473684210527,27.809388335704128,0
4955,4,0,0,40,0.0,0.0,1.0,40,1000,800,200,0.8,12,8,4,380.4635735078058,0.780448717948718,-0.02063505086970774,0.22955891256995742,132455.95838659615,2078.9454749632573,134534.9038615594,2689,3,801.325,36,4,18,32.86087408379827,0.6449652777777778,42.65202702702703,1029.3918918918926,28.594219219219237,0
4956,4,0,0,40,0.0,0.0,1.0,40,700,400,300,0.5714285714285714,10,4,6,380.5750619499987,0.7791666666666667,-0.017482163773826054,0.23013396051335744,132539.10007165687,2088.2152441135895,134627.31531577045,2690,4,802.325,37,3,18,32.774176516522914,0.6438626126126126,42.57127192982457,1029.7149122807032,27.83013276434333,0
4957,4,0,0,40,0.0,0.0,1.0,40,950,600,350,0.631578947368421,13,6,7,385.3958666762095,0.778792735042735,-0.013056206088992939,0.233574759455246,132623.7941001078,2222.532413819644,134846.32651392743,2691,5,803.325,37,3,18,32.56466893761976,0.6447072072072071,42.4890350877193,1030.0438596491233,27.839023233760088,0
4958,4,0,0,40,0.0,0.0,1.0,40,600,300,300,0.5,9,3,6,389.6193767551882,0.778258547008547,-0.013157054692487957,0.23684624209219063,132736.7615516316,2343.3628616497685,135080.12441328136,2692,6,804.325,37,3,17,32.341987656948284,0.6458333333333333,42.379385964912295,1030.4824561403532,27.85087719298252,0
4959,4,0,0,40,0.0,0.0,1.0,40,1150,600,550,0.5217391304347826,17,6,11,391.0213243546574,0.7773771367521367,-0.01267676767676762,0.2389574759945131,132934.57031250015,2396.050347222237,135330.6206597224,2693,7,805.325,37,3,17,32.10648148148148,0.647804054054054,42.18750000000001,1031.2500000000011,27.871621621621653,0
4960,4,0,0,40,0.0,0.0,1.0,40,1000,700,300,0.7,13,7,6,394.8421313847558,0.7768429487179487,-0.011364119460091526,0.24202407910092313,133047.6700162551,2506.5651209987777,135554.23513725388,2694,8,806.325,37,3,17,31.89399776809437,0.6489301801801801,42.077850877192986,1031.688596491229,27.883475580844028,0
4961,4,0,1,39,0.0,0.025,0.975,40,1150,1000,150,0.8695652173913043,13,10,3,393.9255153738491,0.7761485042735042,-0.0072760599298691275,0.24182863830288953,133104.23790252782,2486.631102839347,135590.86900536716,2695,9,807.325,37,3,17,31.86065508447562,0.6494932432432432,42.02302631578948,1031.907894736843,27.889402560455217,0
4962,4,0,0,39,0.0,0.0,1.0,39,1350,800,550,0.5925925925925926,19,8,11,399.3587634626787,0.7730544309491678,-0.0005090723973675271,0.24586445833864173,133210.52629910313,2839.7582126044936,136050.28451170764,2696,10,826.2820512820513,36,3,17,31.61339587651358,0.6524884259259259,41.92004504504504,1032.3198198198197,28.675550550550547,0
4963,4,1,0,40,0.025,0.0,1.0,40,1150,700,450,0.6086956521739131,16,7,9,390.7184136544646,0.7822115384615385,0.01717595701813357,0.2434224761219656,133651.68065200618,2444.548134142028,136096.22878614822,2697,0,806.6,35,5,18,31.392713230355948,0.6589285714285713,41.49305555555556,1034.0277777777778,29.543650793650794,0
4964,4,0,0,40,0.0,0.0,1.0,40,1750,1600,150,0.9142857142857143,19,16,3,391.20760326111446,0.7796207264957264,0.017416107382550727,0.2449156843945632,133831.25964506168,2471.161265432096,136302.4209104938,2698,1,807.6,35,5,16,31.19966442953021,0.6607142857142857,41.31944444444444,1034.722222222222,29.563492063492056,0
4965,4,0,0,40,0.0,0.0,1.0,40,750,600,150,0.8,9,6,3,392.17524629047136,0.7791666666666667,0.02141538977743007,0.24572101451178002,133861.20119866668,2499.409909765075,136360.61110843174,2699,2,808.6,35,5,16,31.144563434366038,0.6610119047619047,41.29050925925925,1034.8379629629617,29.566798941798904,0
4966,4,0,0,40,0.0,0.0,1.0,40,1400,1000,400,0.7142857142857143,18,10,8,394.65312053881235,0.7772702991452991,0.022915036333146954,0.24807956171606987,133981.00090288484,2575.2040198473806,136556.20492273223,2700,3,809.6,35,5,16,30.960149990683806,0.662202380952381,41.17476851851851,1035.3009259259252,29.580026455026434,0
4967,4,0,0,40,0.0,0.0,1.0,40,900,700,200,0.7777777777777778,11,7,4,393.50727598530364,0.7758547008547009,0.019193127446715863,0.24785567876444198,134054.68813408003,2550.299032140246,136604.98716622026,2701,4,810.6,36,4,16,30.915842032767877,0.6608796296296295,41.1036036036036,1035.5855855855855,28.766266266266264,0
4968,4,0,0,40,0.0,0.0,1.0,40,1000,500,500,0.5,15,5,10,393.0356539571306,0.774866452991453,0.019957069883708378,0.24854440220340607,134200.5027620526,2549.116472891812,136749.61923494443,2702,5,811.6,36,4,16,30.781753794877368,0.6623263888888888,40.96283783783784,1036.1486486486488,28.78190690690691,0
4969,4,0,0,40,0.0,0.0,1.0,40,1250,1000,250,0.8,15,10,5,392.33884829652044,0.7749465811965812,0.020322751322751298,0.24816613898273865,134209.71476800548,2531.136984456746,136740.85175246221,2703,6,812.6,37,3,16,30.790564373897702,0.660472972972973,40.95394736842105,1036.1842105263152,28.004978662873384,0
4970,4,0,0,40,0.0,0.0,1.0,40,800,500,300,0.625,11,5,6,392.33884829652044,0.7749465811965812,0.020322751322751298,0.24816613898273865,134209.71476800548,2531.136984456746,136740.85175246221,2704,7,813.6,37,3,16,30.790564373897702,0.660472972972973,40.95394736842105,1036.1842105263152,28.004978662873384,0
4971,4,0,0,40,0.0,0.0,1.0,40,600,500,100,0.8333333333333334,7,5,2,393.3092137683778,0.7741452991452992,0.017027298698550686,0.24897289881613804,134238.1204433095,2559.4179218605796,136797.5383651701,2705,8,814.6,37,3,16,30.736937008429447,0.6607545045045045,40.9265350877193,1036.293859649123,28.007942152679004,0
4972,4,0,1,39,0.0,0.025,0.975,40,900,800,100,0.8888888888888888,10,8,2,391.9906005434762,0.7735309829059829,0.015061356183222463,0.24852361817152785,134294.94081111494,2528.470899699904,136823.41171081483,2706,9,815.6,37,3,17,30.71412514545647,0.6613175675675675,40.87171052631579,1036.5131578947367,28.01386913229018,0
4973,4,0,0,39,0.0,0.0,1.0,39,800,700,100,0.875,9,7,2,401.4445063756874,0.7686122357174989,0.011559501614930578,0.2538619177431409,134200.5027620526,2974.8109173362573,137175.31367938887,2707,10,836.1025641025641,36,3,17,30.56393326812303,0.6623263888888888,40.96283783783784,1036.1486486486488,28.78190690690691,0
4974,4,0,1,38,0.0,0.02564102564102564,0.9743589743589743,39,1300,1100,200,0.8461538461538461,15,11,4,400.34909176503686,0.7689496176338282,0.013685615337250434,0.2535727936347994,134258.8508060426,2950.081796323357,137208.93260236597,2708,11,837.1025641025641,36,3,17,30.533748053171056,0.6629050925925926,40.906531531531535,1036.3738738738746,28.788163163163183,0
4975,4,0,0,38,0.0,0.0,1.0,38,1050,500,550,0.47619047619047616,16,5,11,402.50415082405556,0.7604907539118065,0.006561309439819363,0.25446448857181814,134190.7793209876,3202.4691358024675,137393.24845679008,2709,12,859.5526315789474,35,3,17,30.546246648793577,0.6642857142857144,40.97222222222222,1036.1111111111109,29.603174603174597,0
4976,4,0,0,38,0.0,0.0,1.0,38,750,600,150,0.8,9,6,3,401.1514860735844,0.7609056424845898,0.00827823327162136,0.2542329481803924,134280.73459201373,3173.383246527759,137454.11783854148,2710,13,860.5526315789474,35,3,17,30.49099664991624,0.6651785714285714,40.88541666666666,1036.458333333332,29.613095238095198,0
4977,4,0,0,38,0.0,0.0,1.0,38,800,600,200,0.75,10,6,4,401.6555939326596,0.7605500237079185,0.009570980364508319,0.25517949010274893,134370.7200038578,3194.150270061707,137564.8702739195,2711,14,861.5526315789474,35,3,17,30.387642330877433,0.6660714285714286,40.7986111111111,1036.8055555555538,29.623015873015824,0
4978,4,0,0,38,0.0,0.0,1.0,38,1350,1000,350,0.7407407407407407,17,10,7,407.3903760561191,0.7605500237079185,0.009325656047340258,0.2475765541315789,132725.77649444877,3214.3613629543925,135940.13785740317,2712,15,862.5526315789474,35,3,17,31.895264704781155,0.649702380952381,42.3900462962963,1030.4398148148152,29.441137566137577,4
4979,4,0,0,38,0.0,0.0,1.0,38,1200,800,400,0.6666666666666666,16,8,8,408.69961076107484,0.7606981981981982,0.007735766544139322,0.24896571364145906,132815.23946544924,3256.307334533607,136071.54679998284,2713,16,863.5526315789474,35,3,17,31.771184220375783,0.6505952380952381,42.30324074074074,1030.787037037037,29.4510582010582,0
4980,4,0,0,38,0.0,0.0,1.0,38,1150,800,350,0.6956521739130435,15,8,7,389.06477319564056,0.7601055002370792,-0.006227908778386082,0.24445861760905274,133964.73922902497,2825.8130830778805,136790.55231210284,2714,17,864.5526315789474,34,4,16,31.121109322293776,0.6642156862745099,41.19047619047619,1035.2380952380954,30.44817927170869,5
4981,4,1,1,38,0.02564102564102564,0.02564102564102564,0.9743589743589743,39,1250,1000,250,0.8,15,10,5,380.3686308236196,0.7718735942420153,-0.0032490149855937123,0.2407257318321148,134229.6751988476,2411.351554256972,136641.02675310458,2715,0,843.3589743589744,36,3,16,31.080652756647122,0.6626157407407407,40.93468468468469,1036.261261261262,28.785035035035055,0
4982,4,0,0,38,0.0,0.0,1.0,38,950,700,250,0.7368421052631579,12,7,5,387.6258723918093,0.7576754385964912,0.0043742062932130565,0.24505839051210992,134190.7793209876,2803.1635802469127,136993.94290123452,2716,19,866.5526315789474,35,3,16,30.931635388739956,0.6642857142857144,40.97222222222222,1036.1111111111109,29.603174603174597,0
4983,4,0,0,38,0.0,0.0,1.0,38,550,300,250,0.5454545454545454,8,3,5,387.6258723918093,0.7576754385964912,0.0043742062932130565,0.24505839051210992,134190.7793209876,2803.1635802469127,136993.94290123452,2717,20,867.5526315789474,35,3,16,30.931635388739956,0.6642857142857144,40.97222222222222,1036.1111111111109,29.603174603174597,0
4984,4,0,0,38,0.0,0.0,1.0,38,850,600,250,0.7058823529411765,11,6,5,390.48508876038494,0.7561936936936937,0.0018249140439035028,0.24747303395960682,134280.73459201376,2886.9249131944252,137167.6595052082,2718,21,868.5526315789474,35,3,16,30.767378559463978,0.6651785714285714,40.88541666666666,1036.4583333333321,29.6130952380952,0
4985,4,1,0,39,0.02564102564102564,0.0,1.0,39,1250,900,350,0.72,16,9,7,385.1187346897689,0.7597840755735493,0.019037818368922155,0.2471040808417184,134730.9630594134,2577.7548707561523,137308.71793016954,2719,0,847.2564102564103,35,4,17,30.455685618729095,0.6696428571428572,40.45138888888888,1038.194444444443,29.662698412698372,0
4986,4,0,0,39,0.0,0.0,1.0,39,650,500,150,0.7692307692307693,8,5,3,385.1940221611835,0.7596716149347729,0.021537089749305682,0.2475616595150528,134791.05045438948,2584.141375171454,137375.19182956094,2720,1,848.2564102564103,35,4,17,30.393632040422045,0.6702380952380953,40.39351851851851,1038.4259259259252,29.66931216931215,0
4987,4,0,0,39,0.0,0.0,1.0,39,1150,800,350,0.6956521739130435,15,8,7,381.3735022448455,0.7581533963112911,0.020567667626491204,0.245920154895814,134911.26543209868,2490.316358024679,137401.58179012337,2721,2,849.2564102564103,35,4,17,30.372660427807475,0.6714285714285715,40.27777777777777,1038.8888888888882,29.682539682539662,0
4988,4,0,0,39,0.0,0.0,1.0,39,750,500,250,0.6666666666666666,10,5,5,384.52457672423986,0.7581533963112911,0.017014058444061897,0.2485706389061879,135001.46182966817,2582.2759934413566,137583.73782310952,2722,3,850.2564102564103,35,4,17,30.200676578683602,0.6723214285714285,40.19097222222222,1039.2361111111109,29.69246031746031,0
4989,4,0,0,39,0.0,0.0,1.0,39,1150,1100,50,0.9565217391304348,12,11,1,386.7341927867425,0.7583220872694557,0.014253897550111416,0.25020699216318043,135031.5339934841,2644.262259945119,137675.79625342923,2723,4,851.2564102564103,35,4,17,30.113214550853762,0.6726190476190477,40.16203703703703,1039.3518518518508,29.695767195767168,0
4990,4,1,1,39,0.025,0.025,0.975,40,1050,800,250,0.7619047619047619,13,8,5,377.24827074824384,0.7673611111111112,0.0173942442929782,0.24677323188436084,135428.4748219503,2218.03158733057,137646.50640928088,2724,0,830.95,36,4,17,29.963666197843402,0.6744791666666667,39.7804054054054,1040.8783783783783,28.913288288288285,0
4991,4,0,0,39,0.0,0.0,1.0,39,750,400,350,0.5333333333333333,11,4,7,384.99224543870565,0.7587156995051733,0.02045234774125615,0.25095687412969714,135302.3341719178,2618.06988918895,137920.40406110676,2725,6,853.2564102564103,35,4,17,29.88803444951236,0.675297619047619,39.90162037037037,1040.3935185185182,29.725529100529094,0
4992,4,0,0,39,0.0,0.0,1.0,39,1200,900,300,0.75,15,9,6,383.42282059608834,0.7567476383265858,0.016231239577543466,0.2511936104342179,135483.0183282963,2589.4562060613703,138072.4745343577,2726,7,854.2564102564103,35,4,17,29.74858717806189,0.6770833333333334,39.72800925925925,1041.0879629629617,29.745370370370335,0
4993,4,0,0,39,0.0,0.0,1.0,39,1350,800,550,0.5925925925925926,19,8,11,384.1356443657153,0.7561853351327036,0.020048082122268607,0.25210094417670453,135545.71621875244,2613.5882081405634,138159.304426893,2727,8,855.2564102564103,36,3,18,29.66750477632385,0.6756365740740742,39.66779279279279,1041.3288288288281,28.925800800800783,0
4994,4,0,0,39,0.0,0.0,1.0,39,850,500,350,0.5882352941176471,12,5,7,385.5932845481974,0.7561291048133154,0.017467394197497876,0.2532646800782478,135575.03449395343,2655.364570651733,138230.39906460515,2728,9,856.2564102564103,36,3,18,29.600318987889263,0.6759259259259259,39.63963963963964,1041.4414414414416,28.928928928928933,0
4995,4,0,0,39,0.0,0.0,1.0,39,1150,1000,150,0.8695652173913043,13,10,3,384.4808474646865,0.7556792622582097,0.020426324675432816,0.25274082147838567,135604.3559395544,2627.4555383085744,138231.81147786297,2729,10,857.2564102564103,36,3,18,29.600046851911912,0.6762152777777779,39.611486486486484,1041.5540540540537,28.932057057057047,0
4996,4,0,0,39,0.0,0.0,1.0,39,800,600,200,0.75,10,6,4,381.15550083720734,0.7546671165092218,0.014431866122908366,0.2511952517565692,135695.69160997737,2544.2382002106942,138239.92981018807,2730,11,858.2564102564103,34,5,18,29.595616240097502,0.6813725490196079,39.523809523809526,1041.9047619047622,30.64425770308124,0
4997,4,0,0,39,0.0,0.0,1.0,39,550,200,350,0.36363636363636365,9,2,7,379.23510171583035,0.7537112010796222,0.014709759055201221,0.2503638069698627,135757.7168367347,2496.818310657599,138254.5351473923,2731,12,859.2564102564103,34,5,19,29.583856903510775,0.6819852941176471,39.464285714285715,1042.1428571428573,30.651260504201687,0
4998,4,0,0,39,0.0,0.0,1.0,39,1050,600,450,0.5714285714285714,15,6,9,380.7601400893674,0.7530926675663518,0.0210703232285967,0.2520269498686765,135850.78125,2545.3125000000005,138396.09375,2732,13,860.2564102564103,34,5,20,29.451438848920876,0.6829044117647058,39.375,1042.5,30.66176470588235,0
4999,4,0,0,39,0.0,0.0,1.0,39,950,800,150,0.8421052631578947,11,8,3,380.1309747779431,0.7498875393612237,0.018278229417239222,0.2527092261763534,136005.95946712015,2540.0155895691587,138545.97505668932,2733,14,861.2564102564103,34,5,16,29.313370235106145,0.6844362745098038,39.226190476190474,1043.0952380952378,30.679271708683466,0
5000,4,0,0,39,0.0,0.0,1.0,39,1250,1000,250,0.8,15,10,5,376.58271909465077,0.7482006297795771,0.020131480441699434,0.25166747568764464,136192.29024943316,2457.5325963718897,138649.82284580506,2734,15,862.2564102564103,34,5,17,29.220603330291965,0.6862745098039216,39.04761904761905,1043.8095238095243,30.700280112044833,0
