period,mktsize,entries,exits,surviv,entryrate,exitrate,survivrate,firms,totresinv,totinninv,totimiinv,costshareinn,firmsres,firmsinn,firmsimi,hindex,div,gini,pcm,cs,totprofits,ts,maxage,minage,avgage,actfirms,inactfirms,profitablefirms,wmc,avgproxopt,price,totoutput,avgoutput,magtechshock
1,32,40,9,31,1.0,0.225,0.775,40,0,0,0,0,0,0,0,367.0318797952642,0.49973290598290593,0.38659554730983325,0.15577179780287218,943173.4437139856,61234.944403863505,1004408.3881178491,0,0,0.0,36,4,31,48.295937693259134,0.4864583333333333,57.20720720720722,7769.36936936938,215.8158158158161,0
2,32,31,17,45,0.5,0.27419354838709675,0.7258064516129032,62,850,800,50,0.9411764705882353,9,8,1,269.4719834074758,0.4997025383395029,0.4606131239956275,0.12550722548177629,975932.7409912533,39347.306277441174,1015280.0472686945,1,0,0.5,52,10,35,46.371491856331915,0.5073924731182795,53.026729559748404,7903.144654088009,151.98355104015403,8
3,32,25,16,54,0.35714285714285715,0.22857142857142856,0.7714285714285715,70,1600,1000,600,0.625,22,10,12,242.49456140687587,0.49642857142857144,0.46544030519349056,0.1187958986158761,993156.9084937589,32567.02978668069,1025723.9382804396,2,0,1.0285714285714285,61,9,36,44.815269067367986,0.5255952380952381,50.85685483870969,7972.58064516131,130.69804336330017,0
4,32,12,4,62,0.18181818181818182,0.06060606060606061,0.9393939393939394,66,2150,1600,550,0.7441860465116279,27,16,11,223.5010555708211,0.49649378399378397,0.38750002722546406,0.11141419513281367,998994.5057553828,29305.265309155704,1028299.7710645385,3,0,1.803030303030303,57,9,42,44.54100182083903,0.5337752525252526,50.12571839080459,7995.977011494245,140.28029844726746,8
5,32,10,7,65,0.1388888888888889,0.09722222222222222,0.9027777777777778,72,2000,1400,600,0.7,26,14,12,253.1526319453649,0.4943719027125717,0.49797775837396085,0.1301562521820108,1009231.7347645425,34697.93397968605,1043929.6687442285,4,0,2.4305555555555554,56,16,36,42.49072254966164,0.5423900462962963,48.848684210526315,8036.842105263155,143.5150375939849,8
6,32,10,6,69,0.13333333333333333,0.08,0.92,75,2700,2300,400,0.8518518518518519,31,23,8,228.93444927609403,0.49334084084084084,0.4691834813947624,0.12049137868568893,1016876.1622299368,28859.596836419667,1045735.7590663565,5,0,3.08,59,16,43,42.12785219107959,0.5511111111111111,47.89930555555555,8067.22222222221,136.73258003766458,0
7,32,7,5,71,0.09210526315789473,0.06578947368421052,0.9342105263157895,76,2150,1300,850,0.6046511627906976,30,13,17,226.37618727845557,0.49302266081871343,0.4625631626553106,0.11861376529099397,1015423.6009385934,28623.544650608143,1044047.1455892015,6,0,3.710526315789474,63,13,45,42.37654520394537,0.548108552631579,48.079427083333364,8061.4583333334,127.95965608465715,8
8,32,9,2,78,0.1125,0.025,0.975,80,2400,1700,700,0.7083333333333334,31,17,14,249.82295343882868,0.4920226793248945,0.5459394236149968,0.13247288361875015,1019301.2863481152,32528.971559896825,1051830.257908012,7,0,4.225,58,22,38,41.29331048311885,0.5489583333333333,47.59887005649719,8076.836158192116,139.25579583089856,8
9,32,9,2,85,0.10344827586206896,0.022988505747126436,0.9770114942528736,87,2850,2300,550,0.8070175438596491,34,23,11,208.23129531733227,0.4920308740978348,0.5045626012235946,0.10987381209509353,1017700.5929185663,22133.422541729848,1039834.0154602962,8,0,4.747126436781609,60,27,43,42.54547814115149,0.5439415708812261,47.797131147540966,8070.491803278656,134.50819672131095,8
10,32,11,5,91,0.11458333333333333,0.052083333333333336,0.9479166666666666,96,3000,2000,1000,0.6666666666666666,40,20,20,210.85658109042737,0.4921440972222222,0.5539289567203971,0.11217684013581852,1020358.9907955264,20829.88165680458,1041188.872452331,9,0,5.15625,64,32,44,42.14314422304016,0.5406901041666667,47.46794871794871,8081.025641025618,126.26602564102528,7
11,32,4,10,85,0.042105263157894736,0.10526315789473684,0.8947368421052632,95,3500,2600,900,0.7428571428571429,44,26,18,206.48927857925293,0.49231989548338934,0.5402156022665883,0.11103768780083288,1023811.5825340115,19781.223015706117,1043592.8055497176,10,0,5.863157894736842,68,27,41,41.81773195671204,0.5471491228070176,47.041062801932355,8094.685990338137,119.03949985791378,0
12,32,3,2,86,0.03409090909090909,0.022727272727272728,0.9772727272727273,88,3250,2200,1050,0.676923076923077,43,22,21,215.24496604514906,0.49085412312783006,0.5261410400299287,0.11623228166438045,1025156.2499999999,23281.944444444434,1048438.1944444443,11,0,6.9772727272727275,58,30,46,41.42661179698216,0.5517282196969697,46.875,8099.999999999999,139.65517241379308,0
13,32,4,4,86,0.044444444444444446,0.044444444444444446,0.9555555555555556,90,2800,2000,800,0.7142857142857143,36,20,16,211.1321447859148,0.490230961298377,0.5252170537884815,0.11564428353379587,1029694.8443417259,22680.33619217356,1052375.1805338995,12,0,7.633333333333334,66,24,45,40.95919899491328,0.55625,46.31529850746269,8117.910447761208,122.9986431478971,0
14,32,6,2,90,0.06521739130434782,0.021739130434782608,0.9782608695652174,92,3200,2100,1100,0.65625,43,21,22,229.8090914615218,0.4902104236343367,0.5701038464981645,0.12355418681160038,1023750.4822530856,25453.43364197525,1049203.9158950609,13,0,8.01086956521739,65,27,39,41.23555822466255,0.5455163043478262,47.04861111111111,8094.444444444438,124.52991452991444,8
15,32,7,3,94,0.07216494845360824,0.030927835051546393,0.9690721649484536,97,3550,2100,1450,0.5915492957746479,50,21,29,222.166285577187,0.49041559278350516,0.5773503826603443,0.12146954892615941,1029123.1483075728,22777.2934521989,1051900.4417597717,14,0,8.371134020618557,65,32,39,40.75127834131972,0.5500429553264605,46.38573232323233,8115.656565656583,124.85625485625512,0
16,32,1,3,92,0.010526315789473684,0.031578947368421054,0.968421052631579,95,3350,2400,950,0.7164179104477612,43,24,19,222.80214643543331,0.48971164613661816,0.5711948006731267,0.1224736647375384,1030831.0592559611,23584.274522907985,1054415.3337788691,15,0,9.347368421052632,66,29,36,40.52010596594391,0.5530701754385965,46.17537313432837,8122.3880597015095,123.06648575305317,0
17,32,1,5,88,0.010752688172043012,0.053763440860215055,0.946236559139785,93,3400,2800,600,0.8235294117647058,40,28,12,248.938437439569,0.4890038179834814,0.6020128574232795,0.13339853223663914,1022691.3872452377,28917.439184747156,1051608.8264299848,16,0,10.086021505376344,64,29,33,40.88581283806627,0.544018817204301,47.1794871794872,8090.256410256445,126.41025641025695,8
18,32,6,2,92,0.06382978723404255,0.02127659574468085,0.9787234042553191,94,3200,2500,700,0.78125,39,25,14,244.7233933432922,0.4893950659650728,0.6061596278780699,0.13371295631300575,1028909.6793552813,28359.653635116614,1057269.332990398,17,0,10.617021276595745,62,32,37,40.20614635630611,0.5498670212765957,46.41203703703704,8114.814814814816,130.884109916368,0
19,32,5,3,94,0.05154639175257732,0.030927835051546393,0.9690721649484536,97,2850,1800,1050,0.631578947368421,39,18,21,252.64251994261963,0.48909561139748,0.6331599122015519,0.1370394274840271,1026589.5336418664,29622.033345200012,1056211.5669870665,18,0,11.092783505154639,52,45,36,40.298630509000624,0.5473582474226804,46.69811320754717,8105.660377358498,155.87808417997113,8
20,32,7,9,92,0.06930693069306931,0.0891089108910891,0.9108910891089109,101,2900,1800,1100,0.6206896551724138,40,18,22,236.00173393025634,0.4900907590759076,0.6224209861314243,0.13024318325583326,1032083.897884381,25614.717892442364,1057698.6157768234,19,0,11.158415841584159,60,41,39,40.02723055200701,0.5527021452145214,46.021174863387984,8127.322404371594,135.45537340619322,0
21,32,2,2,92,0.02127659574468085,0.02127659574468085,0.9787234042553191,94,3100,2400,700,0.7741935483870968,38,24,14,242.5423273313623,0.48834410508655535,0.6064701778862918,0.13450074515648294,1033611.111111113,28238.88888888903,1061850.000000002,20,0,12.170212765957446,57,37,42,39.668715846994544,0.5559618794326241,45.83333333333334,8133.3333333333485,142.69005847953244,0
22,32,2,0,94,0.02127659574468085,0.0,1.0,94,4500,3300,1200,0.7333333333333333,57,33,24,253.5359968081277,0.4880366811561046,0.6155381298386426,0.13779994495275102,1027229.6657518517,28787.939451454924,1056017.6052033068,21,0,12.98936170212766,56,38,38,40.19503546099291,0.5485372340425532,46.61915204678361,8108.187134502895,144.789055973266,8
23,32,5,2,97,0.050505050505050504,0.020202020202020204,0.9797979797979798,99,3900,2700,1200,0.6923076923076923,51,27,24,244.09415965872887,0.48772160379303237,0.6277502282200909,0.1326209233630455,1027115.8909527372,26442.598054847083,1053558.4890075843,22,0,13.282828282828282,55,44,41,40.44864853290264,0.5431397306397306,46.63318452380953,8107.73809523811,147.41341991342017,8
24,32,7,8,96,0.0673076923076923,0.07692307692307693,0.9230769230769231,104,3500,2500,1000,0.7142857142857143,45,25,20,228.43130741387893,0.48860117936270847,0.620493451858178,0.12631048191252944,1032698.9192965149,22880.152859960515,1055579.0721564754,23,0,13.35576923076923,64,40,42,40.14211295443553,0.5487780448717949,45.94551282051282,8129.743589743585,127.02724358974352,0
25,32,5,1,100,0.04950495049504951,0.009900990099009901,0.9900990099009901,101,3900,2900,1000,0.7435897435897436,49,29,20,244.72701539867984,0.4886963696369637,0.6327078462412115,0.1350889662290901,1032155.4607815149,26419.26506890154,1058574.7258504163,24,0,13.910891089108912,63,38,38,39.79660632275981,0.5456889438943895,46.01236979166664,8127.604166666615,129.00958994708913,7
26,32,3,2,101,0.02912621359223301,0.019417475728155338,0.9805825242718447,103,4450,3100,1350,0.6966292134831461,58,31,27,233.6521101002926,0.4880742750174503,0.6233738692468276,0.13015222102544804,1035023.6304012343,23317.09104938272,1058340.721450617,25,0,14.601941747572816,59,44,41,39.71700796359497,0.5486448220064725,45.65972222222222,8138.888888888887,137.94726930320147,0
27,32,3,2,102,0.028846153846153848,0.019230769230769232,0.9807692307692307,104,3750,2600,1150,0.6933333333333334,49,26,23,224.51396625015974,0.4878893608414239,0.6117987357762724,0.12621862276667112,1037916.8680144652,22055.36653517426,1059972.2345496395,26,0,15.182692307692308,64,40,45,39.58621720254197,0.5525841346153846,45.30448717948718,8150.256410256418,127.34775641025654,0
28,32,2,6,98,0.019230769230769232,0.057692307692307696,0.9423076923076923,104,4300,2700,1600,0.627906976744186,59,27,32,235.97261443333397,0.4880955159322878,0.630567752818014,0.12903489175237312,1029164.3974033642,23470.92270739572,1052635.32011076,27,0,16.08653846153846,58,46,40,40.39592760180995,0.5397636217948718,46.380649717514125,8115.819209039548,139.92791739723359,8
29,32,7,6,99,0.06666666666666667,0.05714285714285714,0.9428571428571428,105,3150,2300,850,0.7301587301587301,40,23,17,224.14560764878752,0.4877899877899878,0.616211920529802,0.12280836993819622,1029788.4871083348,22014.513238524603,1051803.0003468595,28,0,16.37142857142857,61,44,44,40.61727373068431,0.54375,46.30376344086021,8118.279569892462,133.08655032610594,8
30,32,6,5,100,0.05714285714285714,0.047619047619047616,0.9523809523809523,105,3000,1800,1200,0.6,42,18,24,213.58192936959603,0.48795405982905987,0.5959719547348421,0.11864617309914562,1034157.7783558788,20175.48271476472,1054333.2610706436,29,0,16.35238095238095,61,44,42,40.33615296501896,0.5498015873015873,45.766129032258064,8135.483870967738,133.36858804865145,0
31,32,2,5,97,0.0196078431372549,0.049019607843137254,0.9509803921568627,102,2950,1900,1050,0.6440677966101694,40,19,21,261.6332891072962,0.48675419012489485,0.6644106269736887,0.14375589586564191,1030691.7195138067,30582.652926410392,1061274.372440217,30,0,17.41176470588235,57,45,34,39.55208038494199,0.5473856209150327,46.19252873563219,8121.839080459773,142.48840492034688,8
32,32,3,0,100,0.03,0.0,1.0,100,3650,2600,1050,0.7123287671232876,47,26,21,256.2020894033096,0.48641203703703706,0.6505902042489236,0.1420122069964049,1033469.9122299396,29305.430169753177,1062775.3423996929,31,0,17.92,59,41,39,39.33933613407108,0.5521875,45.85069444444445,8132.777777777788,137.84369114877606,0
33,32,4,3,101,0.038461538461538464,0.028846153846153848,0.9711538461538461,104,3700,2500,1200,0.6756756756756757,49,25,24,251.26334493667142,0.4863179144884242,0.6536113068169689,0.14035687314834538,1035909.9396725085,27557.23929905205,1063467.1789715607,32,0,18.192307692307693,58,46,37,39.157472939217314,0.5551883012820513,45.55084745762712,8142.372881355937,140.38573933372305,8
34,32,4,2,103,0.0380952380952381,0.01904761904761905,0.9809523809523809,105,2600,1800,800,0.6923076923076923,34,18,16,241.23987628377355,0.48644688644688644,0.6448211815846663,0.13657472576744914,1040107.8330145957,26583.09699164504,1066690.9300062407,33,0,18.39047619047619,63,42,34,38.8850542610916,0.5597222222222222,45.03580729166667,8158.854166666679,129.5056216931219,0
35,32,1,6,98,0.009615384615384616,0.057692307692307696,0.9423076923076923,104,3450,2500,950,0.7246376811594203,44,25,19,235.87532899891926,0.48617399489668905,0.6306582177234747,0.13311539712221454,1039117.9390667184,24770.457149208094,1063888.3962159266,34,0,19.25,56,48,41,39.146049958169,0.5567908653846154,45.157163742690045,8154.970760233895,145.62447786131955,8
36,32,2,4,96,0.02,0.04,0.96,100,3950,2900,1050,0.7341772151898734,50,29,21,228.27528440375127,0.48615109427609426,0.6022893734856358,0.12946354468834642,1040659.3381930463,23561.36127868739,1064220.6994717338,35,0,20.34,58,42,44,39.14647513557172,0.5605208333333334,44.968220338983045,8161.0169491525285,140.70718877849188,0
37,32,3,2,97,0.030303030303030304,0.020202020202020204,0.9797979797979798,99,3750,3000,750,0.8,45,30,15,221.82053087469467,0.48509757438328865,0.5860321427331738,0.12656818526379615,1042548.4764542921,22701.731301938948,1065250.207756231,36,0,21.262626262626263,56,43,47,39.07458118556702,0.5631313131313131,44.73684210526315,8168.421052631566,145.86466165413512,0
38,32,3,2,98,0.03,0.02,0.98,100,3300,2200,1100,0.6666666666666666,44,22,22,239.06705539358552,0.4840088383838384,0.6229795918367336,0.13621262458471756,1042100.6944444461,26526.388888888967,1068627.0833333351,37,0,21.55,64,36,43,38.69047619047617,0.5638541666666667,44.79166666666667,8166.666666666681,127.60416666666688,7
39,32,0,3,95,0.0,0.030612244897959183,0.9693877551020408,98,3300,2400,900,0.7272727272727273,42,24,18,224.04539574024443,0.48341617574865,0.5909678153314242,0.12377615898470794,1032420.0481838661,23361.791653103333,1055781.8398369695,38,1,22.96938775510204,63,35,42,40.288612481578745,0.5507015306122449,45.979817708333336,8128.645833333342,129.02612433862447,8
40,32,5,3,97,0.05,0.03,0.97,100,3550,2500,1050,0.704225352112676,46,25,21,208.35444086982616,0.48254419191919196,0.5686727948120631,0.11664764132306862,1036611.148093362,19646.507232084296,1056257.6553254463,39,0,22.9,64,36,43,40.16138848664191,0.5563541666666667,45.4647435897436,8145.128205128223,127.26762820512849,0
41,32,4,0,101,0.039603960396039604,0.0,1.0,101,3250,2100,1150,0.6461538461538462,44,21,23,201.9702209569867,0.48228547854785475,0.558395425961983,0.1138113996357621,1038651.459923222,18505.33297159812,1057156.79289482,40,0,22.871287128712872,68,33,49,40.068461021903566,0.559302805280528,45.21437198067634,8153.140096618383,119.8991190679174,0
42,32,4,5,100,0.0380952380952381,0.047619047619047616,0.9523809523809523,105,3400,2400,1000,0.7058823529411765,44,24,20,220.2749289733628,0.4831043956043956,0.6024180343364376,0.12338561108726873,1036774.8052337796,21275.099316848507,1058049.904550628,41,0,22.961904761904762,66,39,41,39.83743561554593,0.5564484126984127,45.44465174129353,8145.771144278593,123.42077491331202,8
43,32,2,3,99,0.0196078431372549,0.029411764705882353,0.9705882352941176,102,3250,2100,1150,0.6461538461538462,44,21,23,256.1418672551106,0.48281280333915744,0.6557811554250219,0.13924916871215479,1027305.1021579447,28977.169421487717,1056282.2715794323,42,0,23.774509803921568,54,48,39,40.11946582953385,0.5464665032679739,46.60984848484849,8108.484848484862,150.15712682379373,8
44,32,2,2,99,0.019801980198019802,0.019801980198019802,0.9801980198019802,101,3300,2000,1300,0.6060606060606061,46,20,26,262.0890303618913,0.48269389438943894,0.6514086899070632,0.14419746577941822,1031112.6228015186,30548.661500791393,1061661.28430231,43,0,24.91089108910891,60,41,37,39.487336876093096,0.5469265676567656,46.14071038251367,8123.497267759577,135.3916211293263,8
45,32,5,3,101,0.04807692307692308,0.028846153846153848,0.9711538461538461,104,2900,1800,1100,0.6206896551724138,40,18,22,253.72879011785543,0.4828852377396067,0.6518210620604239,0.14096944601116654,1034205.7385178361,28781.554153414836,1062987.2926712509,44,0,24.798076923076923,56,48,40,39.309439093348665,0.5500801282051282,45.76023391812866,8135.672514619896,145.27986633249813,0
46,32,7,2,106,0.06481481481481481,0.018518518518518517,0.9814814814814815,108,3850,3000,850,0.7792207792207793,47,30,17,250.107278840683,0.4844056478596977,0.6627187115677671,0.13809794892306151,1032245.0752977164,26184.40137588124,1058429.4766735977,45,0,24.72222222222222,61,47,40,39.648652820037924,0.544945987654321,46.00134408602148,8127.956989247265,133.24519654503712,8
47,32,1,4,103,0.009345794392523364,0.037383177570093455,0.9626168224299065,107,3350,2300,1050,0.6865671641791045,44,23,21,261.4872512484038,0.48420325633339206,0.6716851006211992,0.1436558484028714,1030647.9600694423,29150.260416666537,1059798.220486109,46,0,25.925233644859812,59,48,34,39.56131575347149,0.5437110591900312,46.19791666666666,8121.66666666665,137.65536723163814,8
48,32,4,1,106,0.037383177570093455,0.009345794392523364,0.9906542056074766,107,3300,2400,900,0.7272727272727273,42,24,18,248.3468142663939,0.48375139599130074,0.654184782644063,0.13555714936068752,1028591.3261275514,26389.475805164646,1054980.801932716,47,0,26.738317757009344,58,49,40,40.15446928022655,0.5412772585669782,46.451271186440685,8113.559322033913,139.8889538281709,7
49,32,1,1,106,0.009345794392523364,0.009345794392523364,0.9906542056074766,107,4050,3000,1050,0.7407407407407407,51,30,21,244.0595899944316,0.48401222594486565,0.6507111577037754,0.1328064522177489,1027607.3100936502,24709.483755347297,1052316.7938489974,48,0,27.514018691588785,61,46,38,40.38744143905242,0.5426401869158879,46.57258064516128,8109.677419354821,132.94553146483312,8
50,32,4,2,108,0.03636363636363636,0.01818181818181818,0.9818181818181818,110,4200,3100,1100,0.7380952380952381,53,31,22,248.9427336573944,0.48387023908812904,0.6567185424179149,0.13398153867628354,1024086.9867089905,24787.80279486018,1048874.7895038507,49,0,27.363636363636363,70,40,37,40.70896640377328,0.5387310606060607,47.00704225352114,8095.774647887358,115.65392354124796,8
51,32,7,1,114,0.06086956521739131,0.008695652173913044,0.991304347826087,115,4250,3300,950,0.7764705882352941,52,33,19,234.3488895278244,0.48413742690058476,0.6493538293394869,0.12778384753858096,1028260.618662284,20944.346825739492,1049204.9654880236,50,0,26.730434782608697,67,48,40,40.551103289221885,0.5430253623188406,46.492034313725455,8112.2549019607095,121.0784313725479,0
52,32,5,2,117,0.04201680672268908,0.01680672268907563,0.9831932773109243,119,4150,2900,1250,0.6987951807228916,54,29,25,227.5424202946373,0.4844395385272753,0.6510831343285519,0.12545775758529734,1031788.778618993,19005.14318396288,1050793.921802956,51,0,26.554621848739497,78,41,38,40.279220104886015,0.5465686274509804,46.057489451476805,8126.160337552774,104.18154278913812,0
53,32,4,4,117,0.03305785123966942,0.03305785123966942,0.9669421487603306,121,4200,2800,1400,0.6666666666666666,56,28,28,229.6151386190178,0.4846504820936639,0.6518929488983876,0.12864950686348028,1036853.0282823879,19215.430363321604,1056068.4586457096,52,0,27.082644628099175,67,54,42,39.58985236891726,0.5501033057851239,45.43504901960783,8146.078431372522,121.58326016973913,8
54,32,1,7,111,0.00847457627118644,0.059322033898305086,0.940677966101695,118,4650,3300,1350,0.7096774193548387,60,33,27,226.12532432409313,0.48345224298614126,0.6394613170532792,0.1275418331266721,1038943.3673469372,18736.28117913825,1057679.6485260755,53,0,28.24576271186441,69,49,34,39.416413610527144,0.553319209039548,45.17857142857142,8154.285714285701,118.17805383022755,0
55,32,3,3,111,0.02631578947368421,0.02631578947368421,0.9736842105263158,114,3200,2100,1100,0.65625,43,21,22,240.69703782222246,0.48342001759561143,0.6685527812705818,0.13407648684774004,1035023.6304012361,23825.42438271616,1058849.0547839522,54,0,29.67543859649123,59,55,42,39.537827076222975,0.5515350877192983,45.65972222222223,8138.888888888901,137.94726930320172,8
56,32,5,1,115,0.04310344827586207,0.008620689655172414,0.9913793103448276,116,3500,2200,1300,0.6285714285714286,48,22,26,226.500504354142,0.4828898050974513,0.6541472685550183,0.12784949160696335,1039178.4837510876,20374.890136718925,1059553.3738878064,55,0,29.724137931034484,63,53,40,39.3773683314174,0.5549568965517242,45.14973958333334,8155.208333333353,129.44775132275163,0
57,32,2,4,113,0.017094017094017096,0.03418803418803419,0.9658119658119658,117,3900,2800,1100,0.717948717948718,50,28,22,233.67841979364405,0.48224285293250807,0.6679640229463928,0.13297708598394445,1041714.0510215847,21385.218663912157,1063099.2696854968,56,0,30.45299145299145,65,52,42,38.87645357827673,0.557514245014245,44.83901515151517,8165.151515151557,125.61771561771626,0
58,32,5,2,116,0.0423728813559322,0.01694915254237288,0.9830508474576272,118,3850,2700,1150,0.7012987012987013,50,27,23,221.13556562035762,0.4815358056883481,0.6503660930849582,0.1269048407075632,1044333.2185568403,18737.843396339136,1063071.0619531795,57,0,30.76271186440678,60,58,46,38.86883675333646,0.5603813559322034,44.51844262295082,8175.40983606558,136.256830601093,0
59,32,4,1,119,0.03333333333333333,0.008333333333333333,0.9916666666666667,120,3750,2700,1050,0.72,48,27,21,213.39006314963655,0.48164828431372547,0.6438722314763421,0.1235741169557858,1047133.5872933835,16939.58046372788,1064073.1677571114,58,0,30.966666666666665,65,55,50,38.717109321981624,0.5629340277777778,44.176136363636346,8186.363636363598,125.94405594405535,0
60,32,3,5,117,0.02459016393442623,0.040983606557377046,0.9590163934426229,122,3600,2100,1500,0.5833333333333334,51,21,30,238.0480413764539,0.4812158469945355,0.688705056167259,0.13662694917690707,1044370.4475308649,21722.067901234626,1066092.5154320996,59,0,31.31967213114754,59,63,41,38.43209205400018,0.5606215846994536,44.51388888888889,8175.55555555556,138.56873822975527,8
61,32,2,3,116,0.01680672268907563,0.025210084033613446,0.9747899159663865,119,4300,2700,1600,0.627906976744186,59,27,32,223.12862272146327,0.4798016664292836,0.6442162388920638,0.12674145687840546,1041143.8829210112,18361.800130208514,1059505.6830512197,60,0,32.97478991596638,79,40,39,39.21704056284348,0.5582983193277311,44.90885416666668,8162.916666666701,103.3280590717304,8
62,32,1,2,115,0.008547008547008548,0.017094017094017096,0.9829059829059829,117,3800,2600,1200,0.6842105263157895,50,26,24,221.49902685550353,0.479280258375086,0.6379109349498697,0.12649924449843683,1042829.9886621387,18997.165532880215,1061827.1541950188,61,0,34.38461538461539,69,48,37,39.047563534623436,0.5613425925925926,44.70238095238098,8169.5238095238665,118.39889579020097,0
63,32,6,2,119,0.049586776859504134,0.01652892561983471,0.9834710743801653,121,3800,3100,700,0.8157894736842105,45,31,14,233.53281896592043,0.480274334251607,0.6789758200209786,0.1349291038829242,1046426.1612566807,20874.970255591736,1067301.1315122724,62,0,33.33057851239669,62,59,42,38.29025775306567,0.5598312672176309,44.262566137566125,8183.597883597859,131.99351425157838,8
64,32,4,6,117,0.032520325203252036,0.04878048780487805,0.9512195121951219,123,3950,2700,1250,0.6835443037974683,52,27,25,222.520664031882,0.47995246345906084,0.6664215385872461,0.1296950983248579,1049118.1877162578,18140.095155709056,1067258.2828719667,63,0,33.54471544715447,67,56,38,38.23582196697774,0.5625,43.93382352941175,8194.117647058783,122.30026338893707,0
65,32,1,3,115,0.00847457627118644,0.025423728813559324,0.9745762711864406,118,4200,2700,1500,0.6428571428571429,57,27,30,228.56572085024447,0.4795635351779419,0.6647640545162592,0.13376120808517883,1050366.17755841,20215.54050607065,1070581.7180644807,64,0,35.16101694915254,65,53,42,37.92529054248286,0.5648834745762712,43.78156565656565,8198.98989898988,126.13830613830584,0
66,32,1,1,115,0.008620689655172414,0.008620689655172414,0.9913793103448276,116,3750,2900,850,0.7733333333333333,46,29,17,257.41890389141554,0.4788012243878061,0.6962670212965218,0.14856056491037473,1046074.3827160482,26905.86419753079,1072980.246913579,65,0,35.58620689655172,59,57,39,37.72349719355422,0.561242816091954,44.30555555555555,8182.222222222213,138.6817325800375,8
67,32,2,2,115,0.017094017094017096,0.017094017094017096,0.9829059829059829,117,4600,3400,1200,0.7391304347826086,58,34,24,250.5848135960236,0.478435995677375,0.6916167796849617,0.1461241563620182,1049269.6173119426,24586.206293216674,1073855.8236051593,66,0,35.70940170940171,62,55,37,37.49825133436638,0.5646367521367521,43.915343915343904,8194.708994708973,132.17272572111247,0
68,32,4,3,116,0.03361344537815126,0.025210084033613446,0.9747899159663865,119,3750,2700,1050,0.72,48,27,21,249.68968672640875,0.4787156387978921,0.6970121728139458,0.14283267060382543,1043338.4354912749,24552.169421487495,1067890.6049127625,67,0,36.05042016806723,54,65,40,38.26407945808302,0.5553221288515406,44.64015151515151,8171.515151515139,151.32435465768776,8
69,32,7,2,121,0.056910569105691054,0.016260162601626018,0.983739837398374,123,3250,2300,950,0.7076923076923077,42,23,19,232.31874440598233,0.47974976675996267,0.6750286175932891,0.13210203783139848,1041475.2776876757,20540.84576845489,1062016.1234561305,68,0,35.40650406504065,67,56,41,38.941071249874916,0.550220189701897,44.868259803921596,8164.21568627457,121.85396546678462,8
70,32,2,3,120,0.016260162601626018,0.024390243902439025,0.975609756097561,123,3700,2300,1400,0.6216216216216216,51,23,28,241.46953298724821,0.4802051401661558,0.6888496355530813,0.13297428309690618,1031402.1476580483,21510.438983406428,1052912.5866414548,69,0,36.016260162601625,68,55,35,39.97428350576759,0.5405657181571816,46.10507246376809,8124.637681159366,119.47996589940244,7
71,32,6,3,123,0.047619047619047616,0.023809523809523808,0.9761904761904762,126,3500,2300,1200,0.6571428571428571,47,23,24,229.00806557956074,0.4807222222222222,0.6799668420557916,0.12773274887596464,1035436.7028270893,18724.671268902137,1054161.3740959915,70,0,36.07936507936508,64,62,41,39.78321469068917,0.5443121693121693,45.608974358974365,8140.512820512836,127.19551282051306,0
72,32,4,2,125,0.031496062992125984,0.015748031496062992,0.984251968503937,127,4800,3300,1500,0.6875,63,33,30,230.54679037123458,0.4803930758655168,0.6853230707692253,0.13081883590779184,1040819.2203039957,17791.506119555408,1058610.726423551,71,0,36.503937007874015,72,55,35,39.06850266681584,0.5497047244094488,44.948630136986296,8161.643835616428,113.3561643835615,0
73,32,1,5,121,0.007936507936507936,0.03968253968253968,0.9603174603174603,126,4050,3000,1050,0.7407407407407407,51,30,21,226.02795578596803,0.4801640211640212,0.6786820453947509,0.12894603437531948,1042493.3596318272,17876.528599605914,1060369.8882314332,72,0,37.317460317460316,64,62,39,38.974081282437645,0.5515873015873016,44.743589743589766,8168.205128205177,127.62820512820589,0
74,32,3,0,124,0.024193548387096774,0.0,1.0,124,3950,2700,1250,0.6835443037974683,52,27,25,233.18117185656985,0.47885932992394437,0.6829765042705906,0.13402329973481517,1044809.2071281051,19975.96705693333,1064785.1741850385,73,0,37.62903225806452,65,59,37,38.50152090667656,0.5551915322580645,44.460227272727295,8177.272727272775,125.80419580419654,0
75,32,1,2,123,0.008,0.016,0.984,125,4050,2300,1750,0.5679012345679012,58,23,35,255.82602857394866,0.47880913978494627,0.7125809365343481,0.14142708307629465,1032629.0578543255,23784.678172186057,1056413.7360265115,74,0,38.32,68,57,33,39.4549510736075,0.54375,45.95410628019324,8129.468599033815,119.5510088093208,8
76,32,4,1,126,0.031496062992125984,0.007874015748031496,0.9921259842519685,127,3800,2600,1200,0.6842105263157895,50,26,24,232.99740335330057,0.47888545181852266,0.6873159790607442,0.13115179616515862,1038308.7442472093,19184.648257725374,1057493.3925049347,75,0,38.44094488188976,64,63,42,39.320950763294746,0.5469160104986877,45.25641025641027,8151.7948717949,127.37179487179532,8
77,32,6,3,129,0.045454545454545456,0.022727272727272728,0.9772727272727273,132,3600,2400,1200,0.6666666666666666,48,24,24,229.27373854112653,0.47956786375202404,0.6892435315395113,0.1308996796538705,1042735.6377317449,17814.37959456483,1060550.0173263098,76,0,37.92424242424242,66,66,38,38.86089118960617,0.5508996212121212,44.71393034825873,8169.154228855766,123.77506407357221,0
78,32,3,3,129,0.022727272727272728,0.022727272727272728,0.9772727272727273,132,3850,2400,1450,0.6233766233766234,53,24,29,224.0544986572389,0.4787775175418305,0.6800810598120466,0.12886510247620395,1045019.4019274459,16578.259637188734,1061597.6615646346,77,0,38.28787878787879,69,63,40,38.70846434532821,0.5538983585858586,44.43452380952384,8178.095238095304,118.52311939268557,0
79,32,1,4,126,0.007692307692307693,0.03076923076923077,0.9692307692307692,130,4050,2900,1150,0.7160493827160493,52,29,23,213.76348635774264,0.4794362452792685,0.6689196642479178,0.12030598229692434,1038258.6372260846,14338.357206897526,1052596.994432982,78,0,38.97692307692308,72,58,42,39.81720068713123,0.5508814102564102,45.26255707762559,8151.598173516022,113.21664129883364,8
80,32,4,5,125,0.03076923076923077,0.038461538461538464,0.9615384615384616,130,3850,2700,1150,0.7012987012987013,50,27,23,228.9510189829186,0.4789927449811171,0.6946698970321052,0.12687417196596618,1033388.1699176546,17469.0549015075,1050857.2248191622,79,0,39.41538461538462,75,55,39,40.042201488512525,0.5431089743589743,45.86074561403505,8132.456140350778,108.43274853801037,8
81,32,1,1,125,0.007936507936507936,0.007936507936507936,0.9920634920634921,126,4050,2700,1350,0.6666666666666666,54,27,27,237.7641602754326,0.4789179894179894,0.6891136143824306,0.1270808442851455,1021857.2778828011,19342.20751942887,1041199.48540223,80,0,41.007936507936506,68,58,33,41.27389486260453,0.529265873015873,47.282608695652186,8086.956521739157,118.92583120204642,8
82,32,4,1,128,0.031007751937984496,0.007751937984496124,0.9922480620155039,129,3600,2400,1200,0.6666666666666666,48,24,24,253.47251921541806,0.47997163678940563,0.7167155284567464,0.13487241454548807,1020415.6494140641,22329.465060763992,1042745.1144748281,81,0,40.992248062015506,63,66,34,41.059766262782496,0.5265665374677002,47.46093750000001,8081.250000000013,128.27380952380972,8
83,32,7,3,132,0.05185185185185185,0.022222222222222223,0.9777777777777777,135,4500,3200,1300,0.7111111111111111,58,32,26,236.9870548685669,0.4818684355997789,0.6968644187198627,0.12883305604562628,1027298.2259102418,17191.276206034,1044489.5021162758,82,0,39.74074074074074,66,69,42,40.605698040659355,0.533179012345679,46.610696517412904,8108.457711442723,122.85541987034429,8
84,32,9,4,137,0.06382978723404255,0.028368794326241134,0.9716312056737588,141,3600,2300,1300,0.6388888888888888,49,23,26,229.01308471556317,0.4836921648091861,0.7090590726697086,0.12543127170784849,1029677.0681798073,15361.90432894664,1045038.9725087539,83,0,38.8936170212766,70,71,46,40.507826807780525,0.5318410165484633,46.31748826291077,8117.840375586798,115.96914822266854,8
85,32,10,9,138,0.06802721088435375,0.061224489795918366,0.9387755102040817,147,4750,3500,1250,0.7368421052631579,60,35,25,229.30829240177883,0.48545685397446653,0.7220049459969831,0.12772401618660872,1035002.5409333928,13316.933058587685,1048319.4739919805,84,0,37.72108843537415,66,81,39,39.83013937282234,0.5370606575963719,45.66231343283582,8138.805970149254,123.31524197195839,8
86,32,6,6,138,0.041666666666666664,0.041666666666666664,0.9583333333333334,144,4850,4000,850,0.8247422680412371,57,40,17,212.49674288650243,0.48419794904169905,0.7007602803398114,0.12091046388331252,1041680.640760219,10620.748657894404,1052301.3894181133,85,0,39.24305555555556,80,64,39,39.42110612704333,0.5485387731481481,44.84310699588478,8165.02057613171,102.06275720164638,8
87,32,2,3,137,0.014285714285714285,0.02142857142857143,0.9785714285714285,140,4900,3500,1400,0.7142857142857143,63,35,28,209.55877335247223,0.4830389260020555,0.6884843116794874,0.12035829255863488,1044583.3634741546,10880.321662808841,1055463.6851369634,86,0,41.06428571428572,71,69,41,39.13336589094619,0.5517113095238095,44.487847222222236,8176.388888888916,115.16040688575939,0
88,32,3,2,138,0.02142857142857143,0.014285714285714285,0.9857142857142858,140,4950,3700,1250,0.7474747474747475,62,37,25,223.88311004556596,0.48280875299760195,0.70705795398552,0.12666097894952574,1039892.2697522569,13612.863092895715,1053505.1328451526,87,0,41.97142857142857,76,64,36,39.35460334306181,0.5488095238095239,45.06222943722945,8158.008658008685,107.3422191843248,8
89,32,5,1,142,0.03496503496503497,0.006993006993006993,0.993006993006993,143,3900,2600,1300,0.6666666666666666,52,26,26,213.93828546324517,0.4826508585311402,0.7018018761852594,0.12224936926665235,1043003.1414205212,12127.660761657164,1055130.8021821782,88,0,41.10489510489511,65,78,41,39.21893995590444,0.552229020979021,44.68118686868688,8170.202020202044,125.69541569541606,0
90,32,1,3,140,0.006993006993006993,0.02097902097902098,0.9790209790209791,143,5100,3300,1800,0.6470588235294118,69,33,36,229.28235418271953,0.48215223743392754,0.7242013160962233,0.1289253878676208,1037980.196536065,13898.10861136604,1051878.305147431,89,0,42.04895104895105,65,78,39,39.45682034122362,0.5449446386946387,45.29671717171716,8150.505050505028,125.39238539238504,8
91,32,4,2,142,0.027777777777777776,0.013888888888888888,0.9861111111111112,144,5400,4200,1200,0.7777777777777778,66,42,24,230.77708104013104,0.4820419742294742,0.7275749270104681,0.12997133880048847,1038475.8904327684,13731.28694492512,1052207.1773776936,90,0,42.638888888888886,67,77,42,39.3565354859399,0.5423900462962963,45.235906862745104,8152.450980392174,121.67837284167423,8
92,32,2,3,141,0.013888888888888888,0.020833333333333332,0.9791666666666666,144,4400,3000,1400,0.6818181818181818,58,30,28,233.79196735082505,0.4815249854312354,0.7198118981292094,0.13120414409117592,1037366.5001417197,15305.59098639431,1052672.091128114,91,0,43.40277777777778,69,75,38,39.41902625991077,0.5405815972222222,45.372023809523796,8148.095238095209,118.08833678398854,8
93,32,3,6,138,0.020833333333333332,0.041666666666666664,0.9583333333333334,144,4050,2700,1350,0.6666666666666666,54,27,27,232.12565143162755,0.48078744172494176,0.7190451651214702,0.13146920017216338,1040236.9926867665,15443.137914138617,1055680.1306009053,92,0,43.708333333333336,72,72,34,39.1012367787789,0.5435474537037037,45.01997716894977,8159.360730593608,113.32445459157789,0
94,32,2,0,140,0.014285714285714285,0.0,1.0,140,4550,3000,1550,0.6593406593406593,61,30,31,226.57222746679642,0.4800702295306612,0.7058016276971335,0.12361034838745505,1028433.1181468228,14052.876475829482,1042485.9946226523,93,0,45.00714285714286,66,74,40,40.726502933300615,0.5302083333333334,46.47077114427859,8112.9353233830425,122.92326247550065,8
95,32,3,1,142,0.02097902097902098,0.006993006993006993,0.993006993006993,143,4350,2800,1550,0.6436781609195402,59,28,31,222.20728098731828,0.48061328343018483,0.7068691509083584,0.12231158615951811,1031259.0556412829,12880.654149519489,1044139.7097908024,94,0,45.04195804195804,71,72,40,40.48134640224906,0.5328525641025641,46.12268518518516,8124.074074074022,114.42357850808482,0
96,32,0,0,142,0.0,0.0,1.0,142,5100,3600,1500,0.7058823529411765,66,36,30,219.35338126625908,0.48036430759497883,0.7015840193515677,0.12137733083555946,1032924.2883085716,11815.08704650557,1044739.3753550771,95,1,46.33098591549296,73,69,43,40.34441366574328,0.5355780516431925,45.91779279279277,8130.630630630572,111.37850178945989,0
97,32,1,2,141,0.006993006993006993,0.013986013986013986,0.986013986013986,143,4650,3200,1450,0.6881720430107527,61,32,29,212.68180931554352,0.48041629731770574,0.6977301666731401,0.11774177383854643,1033074.9640593462,10693.250502945913,1043768.2145622922,96,0,47.0,78,65,39,40.495001124314555,0.5394813519813519,45.89926160337549,8131.223628691901,104.24645677810129,8
98,32,2,4,139,0.013986013986013986,0.027972027972027972,0.972027972027972,143,4750,3600,1150,0.7578947368421053,59,36,23,231.37720173688078,0.48004079254079257,0.7172774000659445,0.12644182522990777,1028962.5935385391,14265.6971169741,1043228.2906555132,97,0,47.56643356643357,70,73,37,40.53791823353581,0.5324155011655012,46.40551643192488,8115.0234741784,115.92890677397713,8
99,32,5,5,139,0.034722222222222224,0.034722222222222224,0.9652777777777778,144,4050,2800,1250,0.691358024691358,53,28,25,227.51223589020933,0.4805527227402227,0.7149975087194829,0.12553677566349883,1032030.234567897,14109.901234567704,1046140.1358024648,98,0,47.46527777777778,74,70,33,40.24959896459953,0.5358796296296297,46.027777777777764,8127.111111111078,109.82582582582538,0
100,32,2,3,138,0.014184397163120567,0.02127659574468085,0.9787234042553191,141,4500,3000,1500,0.6666666666666666,60,30,30,229.50604922343237,0.48002997298210065,0.7141090786506805,0.1270412049841201,1033038.742923661,14717.728116629867,1047756.4710402909,99,0,48.8936170212766,73,68,37,40.072052794858976,0.5373079196217494,45.903716216216196,8131.081081081034,111.38467234357582,0
101,32,3,2,139,0.02127659574468085,0.014184397163120567,0.9858156028368794,141,4550,3100,1450,0.6813186813186813,60,31,29,224.33141380168854,0.47955082742316785,0.7098083479281363,0.12514181353727352,1035480.8284373777,13708.175641580028,1049189.0040789577,100,0,49.255319148936174,67,74,38,39.896642480078654,0.5410756501182032,45.60355392156862,8140.686274509787,121.50278021656398,0
102,32,4,0,143,0.027972027972027972,0.0,1.0,143,4200,3000,1200,0.7142857142857143,54,30,24,235.1742070042103,0.47996487080994127,0.7251158861909781,0.13188184351132723,1037133.3374424751,15981.402038132957,1053114.7394806081,101,0,48.84615384615385,64,79,42,39.413120790583484,0.5410110722610723,45.400641025641036,8147.179487179512,127.29967948717987,8
103,32,5,5,143,0.033783783783783786,0.033783783783783786,0.9662162162162162,148,4600,3200,1400,0.6956521739130435,60,32,28,243.57671816436618,0.48045271036342463,0.7336602815981743,0.13743428528165672,1039055.6584304845,16417.953454122417,1055473.611884607,102,0,48.16216216216216,66,82,31,38.957608850385384,0.5396255630630631,45.164800995024876,8154.726368159205,123.55646012362432,8
104,32,2,4,141,0.013793103448275862,0.027586206896551724,0.9724137931034482,145,4050,2600,1450,0.6419753086419753,55,26,29,245.13798558662427,0.47934027777777777,0.7310609952111873,0.13900058528767475,1040600.0096116903,17968.118031526472,1058568.1276432169,103,0,49.675862068965515,67,78,33,38.72387073522345,0.5419540229885058,44.97549019607844,8160.78431372551,121.80275095112702,0
105,32,9,0,150,0.06,0.0,1.0,150,5400,4200,1200,0.7777777777777778,66,42,24,247.62724597134985,0.47982196122296794,0.7521162727519695,0.14264724451025607,1045506.2499999972,16379.166666666442,1061885.4166666637,104,0,48.38666666666666,59,91,43,38.04502852485733,0.5488194444444445,44.374999999999986,8179.999999999978,138.6440677966098,8
106,32,1,5,146,0.006622516556291391,0.033112582781456956,0.9668874172185431,151,5000,3500,1500,0.7,65,35,30,294.0125693632523,0.4796909492273731,0.79348699905854,0.16499751740292729,1037361.8366309176,25799.483789447724,1063161.3204203653,105,0,49.05960264900662,51,100,34,37.886230430335914,0.5405629139072847,45.37259615384615,8148.0769230769265,159.76621417797895,8
107,32,2,0,148,0.013513513513513514,0.0,1.0,148,5650,3900,1750,0.6902654867256637,74,39,35,307.0378979038812,0.4799777456027456,0.7826534197557127,0.16838119616754996,1030084.0326003045,28004.967206789835,1058088.9998070942,106,0,50.851351351351354,59,89,37,38.47680750370621,0.5292088963963963,46.26736111111109,8119.444444444411,137.61770244821034,8
108,32,4,3,149,0.02631578947368421,0.019736842105263157,0.9802631578947368,152,4950,3600,1350,0.7272727272727273,63,36,27,262.22784797423736,0.48075966509817586,0.7549672435408925,0.1481345178134154,1039428.7981859455,19163.4353741499,1058592.2335600953,107,0,50.48684210526316,69,83,36,38.43535925579947,0.5369380482456141,45.119047619047635,8156.190476190512,118.2056590752248,8
109,32,7,0,156,0.04487179487179487,0.0,1.0,156,4750,3300,1450,0.6947368421052632,62,33,29,254.98103773718472,0.48135597601323404,0.7554169481710256,0.14620135760901953,1044064.7600263038,17293.343195266643,1061358.1032215704,108,0,50.05769230769231,64,92,40,38.037824132162285,0.5409321581196581,44.55128205128207,8174.358974359016,127.72435897435963,0
110,32,1,4,153,0.006369426751592357,0.025477707006369428,0.9745222929936306,157,5000,3100,1900,0.62,69,31,38,292.54636634898657,0.4815535004627361,0.7972617197893226,0.16789449078015342,1044349.0232289068,24704.102389145977,1069053.1256180527,109,0,50.732484076433124,52,105,38,37.042432751237264,0.5386146496815287,44.51650943396226,8175.471698113205,157.22060957910008,8
111,32,1,2,152,0.006493506493506494,0.012987012987012988,0.987012987012987,154,6100,4400,1700,0.7213114754098361,78,44,34,282.95032754896806,0.4807343391902215,0.7861722186177065,0.16402064587358542,1047442.3856490763,22374.833221615583,1069817.218870692,110,0,52.41558441558441,58,96,37,36.89880623792437,0.5428165584415585,44.138418079096034,8187.570621468904,141.16501071498112,0
112,32,1,5,148,0.006535947712418301,0.032679738562091505,0.9673202614379085,153,4450,2600,1850,0.5842696629213483,63,26,37,288.51987665779484,0.4806017801857585,0.7897141424844192,0.16831956194171696,1049405.1162131524,25504.8469387755,1074909.9631519278,111,0,53.45751633986928,62,91,38,36.509781134999024,0.5450027233115469,43.898809523809526,8195.238095238099,132.1812596006145,0
113,32,2,0,150,0.013333333333333334,0.0,1.0,150,4700,2800,1900,0.5957446808510638,66,28,38,307.72911045014246,0.4799403430275913,0.7936567438441751,0.17412385886351334,1039941.3204067618,29304.043489823773,1069245.3638965855,112,0,54.95333333333333,62,88,30,37.21085457336184,0.5343055555555556,45.05621693121692,8158.201058201044,131.5838880355007,8
114,32,3,1,152,0.0196078431372549,0.006535947712418301,0.9934640522875817,153,5350,4100,1250,0.7663551401869159,66,41,25,299.618133125891,0.48012520066506137,0.7953681825090855,0.17192992006582747,1044307.3654930644,26628.68465172984,1070936.0501447942,113,0,54.8562091503268,53,100,34,36.86700896003221,0.5379901960784313,44.5216049382716,8175.308641975303,154.2511064523642,0
115,32,4,2,154,0.02564102564102564,0.01282051282051282,0.9871794871794872,156,4950,3200,1750,0.6464646464646465,67,32,35,307.2084296469922,0.4806891025641025,0.8029477322196608,0.1755909705955407,1043082.4960963165,27938.74712360276,1071021.2432199193,114,0,54.60897435897436,51,105,35,36.82756681834824,0.5347889957264957,44.67147435897435,8170.512820512808,160.20613373554525,8
116,32,4,4,154,0.02531645569620253,0.02531645569620253,0.9746835443037974,158,4700,2900,1800,0.6170212765957447,65,29,36,295.70337424274084,0.4807539842511221,0.7942660019312855,0.17085214901899115,1046430.748068884,25586.620623065053,1072017.3686919492,115,0,54.29113924050633,58,100,38,36.69974686457254,0.5375791139240507,44.26200564971752,8183.615819209057,141.09682446912169,0
117,32,2,3,153,0.01282051282051282,0.019230769230769232,0.9807692307692307,156,5650,4000,1650,0.7079646017699115,73,40,33,289.063077935942,0.4806658395368073,0.7904947368930026,0.1635967451754855,1040007.72928994,23275.56706114392,1063283.2963510838,116,0,54.94230769230769,64,92,34,37.678358162046635,0.5319177350427351,45.04807692307692,8158.461538461531,127.47596153846142,8
118,32,1,3,151,0.006493506493506494,0.01948051948051948,0.9805194805194806,154,4800,3200,1600,0.6666666666666666,64,32,32,284.2578492500862,0.4805300908242085,0.7833521341316445,0.16155920799150483,1041327.4793388438,23601.101928374712,1064928.5812672186,117,0,56.44805194805195,65,89,35,37.63455827765406,0.533685064935065,44.88636363636364,8163.63636363637,125.5944055944057,0
119,32,1,3,149,0.006578947368421052,0.019736842105263157,0.9802631578947368,152,5850,4100,1750,0.7008547008547008,76,41,35,284.1923285511384,0.4808595111537121,0.7792389069805519,0.16267677216035706,1043543.0481742175,23063.38576079686,1066606.4339350143,118,0,57.30921052631579,58,94,34,37.357270422859784,0.5372121710526316,44.61511299435029,8172.3163841808055,140.90200662380698,0
120,32,1,2,148,0.006666666666666667,0.013333333333333334,0.9866666666666667,150,4800,3200,1600,0.6666666666666666,64,32,32,291.2601293313694,0.48095451155853836,0.7771937639198219,0.16553898489846167,1041327.4793388421,25859.43526170794,1067186.91460055,119,0,58.513333333333335,65,85,35,37.455920564216775,0.5347222222222222,44.88636363636363,8163.636363636357,125.59440559440549,8
121,32,3,4,147,0.019867549668874173,0.026490066225165563,0.9735099337748344,151,5050,3600,1450,0.7128712871287128,65,36,29,283.2725271799593,0.4814937454010302,0.7724451475824967,0.16273243774530255,1044654.3402777808,23934.37500000021,1068588.715277781,120,0,58.33112582781457,59,92,38,37.24096344612039,0.5375965783664459,44.47916666666668,8176.666666666691,138.58757062146933,0
122,32,2,0,149,0.013422818791946308,0.0,1.0,149,4850,3600,1250,0.7422680412371134,61,36,25,281.96451239265457,0.4813017715702279,0.7636570990329392,0.16314883442869518,1046875.1952925721,24386.33079532699,1071261.5260878992,121,0,59.65771812080537,65,84,39,36.995266962835,0.5415967561521253,44.20770202020202,8185.353535353535,125.92851592851594,0
123,32,4,5,148,0.026143790849673203,0.032679738562091505,0.9673202614379085,153,5800,4400,1400,0.7586206896551724,72,44,28,240.88810193336087,0.4816857298474946,0.7475708032803248,0.13826905464614767,1044397.4832731452,13916.585481929436,1058314.0687550746,122,0,59.071895424836605,62,91,41,38.356145914229,0.5406454248366013,44.51058201058201,8175.661375661381,131.86550605905452,8
124,32,5,4,149,0.032679738562091505,0.026143790849673203,0.9738562091503268,153,4500,3100,1400,0.6888888888888889,59,31,28,233.04759551792577,0.48175202098383213,0.7374103489131016,0.13518428143585373,1047650.4669485204,13730.484453116718,1061380.9514016372,123,0,58.91503267973856,65,88,37,38.149620160776315,0.5435049019607843,44.11300505050503,8188.3838383837965,125.97513597513533,0
125,32,0,1,148,0.0,0.006711409395973154,0.9932885906040269,149,4250,2900,1350,0.6823529411764706,56,29,27,255.60011414651532,0.4810769242396759,0.7545505389465113,0.14058006278058363,1031005.9171597651,18655.0460223538,1049660.963182119,124,1,60.0,64,85,37,39.66553556397305,0.5251677852348993,46.15384615384616,8123.076923076937,126.92307692307715,8
126,32,2,4,146,0.013333333333333334,0.02666666666666667,0.9733333333333334,150,5000,3400,1600,0.68,66,34,32,257.54841305769366,0.4810570469798658,0.759858156028369,0.13945593794598593,1026029.2806183092,17850.442594794382,1043879.7232131036,125,0,60.50666666666667,57,93,37,40.245271867612296,0.5201388888888889,46.767241379310335,8103.448275862051,142.16575922565002,8
127,32,2,3,145,0.013513513513513514,0.02027027027027027,0.9797297297297297,148,4700,3400,1300,0.723404255319149,60,34,26,251.13525082174036,0.4813336933872648,0.752245056558156,0.13721629290534518,1028909.6793552829,17379.098079561183,1046288.777434844,126,0,61.4527027027027,62,86,38,40.043549368629265,0.5261120495495495,46.412037037037045,8114.814814814828,130.8841099163682,8
128,32,5,3,147,0.03333333333333333,0.02,0.98,150,3800,2300,1500,0.6052631578947368,53,23,30,234.9255931230185,0.4818400447427293,0.7379167870001353,0.12973737779071157,1032298.930023802,14702.687683219689,1047001.6177070217,127,0,61.04,70,80,38,40.027484164115585,0.5297222222222222,45.994718309859145,8128.169014084484,116.11670020120691,0
129,32,5,2,150,0.03289473684210526,0.013157894736842105,0.9868421052631579,152,5150,3800,1350,0.7378640776699029,65,38,27,227.03492896034692,0.48179443331009647,0.7277683807544235,0.12617853890595832,1034305.6721983398,11414.702962167055,1045720.3751605069,128,0,61.1578947368421,60,92,40,39.97554122730429,0.5322779605263157,45.747950819672155,8136.06557377054,135.60109289617566,8
130,32,2,3,149,0.013157894736842105,0.019736842105263157,0.9802631578947368,152,6300,4500,1800,0.7142857142857143,81,45,36,238.8813768829065,0.48188066399442314,0.7473608854057447,0.13034614260349903,1028482.8078767472,12437.077849199057,1040919.8857259463,129,0,62.05921052631579,65,87,38,40.40815903054447,0.526452850877193,46.464646464646464,8113.131313131313,124.8174048174048,8
131,32,5,7,147,0.032467532467532464,0.045454545454545456,0.9545454545454546,154,5850,4500,1350,0.7692307692307693,72,45,27,225.61028591919214,0.48277947542653427,0.7349441511003758,0.12433369581703306,1031639.0693740678,9899.677081378199,1041538.746455446,130,0,61.75974025974026,72,82,35,40.34712466048512,0.5303030303030303,46.07591324200911,8125.570776255652,112.85514967021739,0
132,32,3,0,150,0.02,0.0,1.0,150,5050,3200,1850,0.6336633663366337,69,32,37,233.80811609782273,0.48125838926174497,0.7398360655737699,0.12965722801788382,1033611.1111111137,13283.333333333476,1046894.4444444472,131,0,64.21333333333334,64,86,38,39.89071038251364,0.5327777777777778,45.83333333333334,8133.333333333354,127.08333333333366,0
133,32,2,1,151,0.013157894736842105,0.006578947368421052,0.993421052631579,152,4200,2500,1700,0.5952380952380952,59,25,34,230.96092929447948,0.4812616184500988,0.7401546599737396,0.12917698487284246,1036302.4551384328,13269.075613784586,1049571.5307522174,132,0,64.35526315789474,62,90,39,39.62475095287596,0.5356359649122807,45.5026455026455,8143.915343915334,131.353473288957,0
134,32,3,3,151,0.01948051948051948,0.01948051948051948,0.9805194805194806,154,4700,2800,1900,0.5957446808510638,66,28,38,240.36455522009163,0.4817096030331324,0.744256528400957,0.13173122976688023,1029876.7451220579,14009.173154555325,1043885.9182766132,133,0,63.642857142857146,67,87,40,40.19467254357363,0.5265151515151515,46.292892156862706,8118.627450980308,121.17354404448221,8
135,32,3,3,151,0.01948051948051948,0.01948051948051948,0.9805194805194806,154,5150,3300,1850,0.6407766990291263,70,33,37,241.1029632036621,0.4822003296268002,0.7448607797861919,0.1338708561065764,1034008.2846747491,13910.49228244356,1047918.7769571927,134,0,64.51298701298701,63,91,42,39.655294299677756,0.5305059523809523,45.78450520833333,8134.895833333322,129.1253306878305,0
136,32,4,2,153,0.025806451612903226,0.012903225806451613,0.9870967741935484,155,5450,3700,1750,0.6788990825688074,72,37,35,241.03007918425956,0.48233836056416707,0.7449081935144646,0.13558040964170137,1038094.1361961454,13592.382369614505,1051686.51856576,135,0,64.7741935483871,69,86,42,39.143285914587835,0.5346102150537635,45.282738095238095,8150.9523809523835,118.12974465148382,0
137,32,6,7,152,0.03773584905660377,0.0440251572327044,0.9559748427672956,159,5000,3300,1700,0.66,67,33,34,232.74808853258503,0.4821371706074357,0.7418023750275613,0.13277724288668477,1042487.4096074427,11727.390381083867,1054214.7999885266,136,0,63.930817610062896,65,94,38,38.803290978791836,0.5385875262054507,44.7443181818182,8168.181818181855,125.66433566433624,0
138,32,3,3,152,0.01935483870967742,0.01935483870967742,0.9806451612903225,155,4850,3100,1750,0.6391752577319587,66,31,35,235.77303232606192,0.48160522273425505,0.7428872043807841,0.13534375345015232,1044422.0615243358,13399.311294765968,1057821.3728191017,137,0,65.5741935483871,65,90,41,38.48375339757846,0.5405241935483871,44.507575757575765,8175.757575757588,125.78088578088597,0
139,32,1,3,150,0.006535947712418301,0.0196078431372549,0.9803921568627451,153,5450,4000,1450,0.7339449541284404,69,40,29,237.64917367090715,0.4807128626304323,0.7408367062775334,0.13708536802760582,1045926.1593036074,13662.697495857898,1059588.8567994654,138,0,66.77124183006536,68,85,39,38.24754467800348,0.5436410675381264,44.32367149758456,8181.642512077346,120.31827223643155,0
140,32,2,3,149,0.013157894736842105,0.019736842105263157,0.9802631578947368,152,5150,3600,1550,0.6990291262135923,67,36,31,254.47569320833762,0.4809357572324852,0.7600049652432961,0.14348097595789291,1038831.3609467477,17321.46614069701,1056152.8270874447,139,0,66.73026315789474,64,88,34,38.708071278826,0.5366639254385965,45.1923076923077,8153.846153846172,127.40384615384643,8
141,32,5,0,154,0.032467532467532464,0.0,1.0,154,4400,2700,1700,0.6136363636363636,61,27,34,243.1201638725771,0.4814204722292958,0.7531055602619892,0.13858727030859164,1042247.3710612357,15478.27032963398,1057725.6413908696,140,0,66.35714285714286,57,97,40,38.56864107616168,0.5402462121212122,44.77370689655172,8167.241379310337,143.28493647912873,0
142,32,0,2,152,0.0,0.012987012987012988,0.987012987012987,154,4450,3100,1350,0.6966292134831461,58,31,27,243.67246422539984,0.48123832866479926,0.7545812606299327,0.1393618301028453,1043274.3963865767,15593.448606156726,1058867.8449927333,141,1,67.35714285714286,57,97,38,38.42576311717546,0.5417343073593073,44.64798850574713,8171.264367816091,143.3555152248437,0
143,32,1,0,153,0.006535947712418301,0.0,1.0,153,5000,3800,1200,0.76,62,38,24,241.38848578130114,0.48087590299277605,0.7514439438321083,0.1390793428423184,1045564.0191595657,14877.42307446781,1060441.4422340335,142,0,67.90196078431373,58,95,41,38.197274213228376,0.5444580610021786,44.36793785310735,8180.225988700573,141.0383791155271,0
144,32,3,6,150,0.019230769230769232,0.038461538461538464,0.9615384615384616,156,5750,3900,1850,0.6782608695652174,76,39,37,231.0842088481121,0.4808829611248966,0.7442802544862821,0.13429527968756153,1048224.0295410175,11495.604112413304,1059719.6336534307,143,0,67.57692307692308,63,93,37,38.128205943448215,0.547275641025641,44.04296875000001,8190.625000000015,130.00992063492086,0
145,32,1,4,147,0.006622516556291391,0.026490066225165563,0.9735099337748344,151,4700,3400,1300,0.723404255319149,60,34,26,227.07115819441668,0.4804359823399558,0.730200474915409,0.13185502162672394,1047971.8347993365,12692.835656603056,1060664.6704559396,144,0,68.33774834437087,73,78,34,38.26241451698664,0.5549806843267109,44.073761261261296,8189.63963963972,112.1868443786263,8
146,32,1,2,146,0.006756756756756757,0.013513513513513514,0.9864864864864865,148,5300,3700,1600,0.6981132075471698,69,37,32,219.89522114173954,0.4798025065882208,0.7176366494295732,0.12670376722990884,1045583.7135560084,11083.772382919677,1056667.485938928,145,0,70.12837837837837,65,83,44,38.744250478483615,0.5492680180180181,44.365530303030276,8180.303030302981,125.8508158508151,8
147,32,4,3,147,0.02666666666666667,0.02,0.98,150,4800,3600,1200,0.75,60,36,24,215.91360010663388,0.48005219985085756,0.7148185296630629,0.12588646743059298,1049221.3595421286,10508.232209503603,1059729.5917516323,146,0,70.1,72,78,41,38.392144024666614,0.5525,43.92123287671233,8194.52054794521,113.81278538812792,0
148,32,1,5,143,0.006756756756756757,0.033783783783783786,0.9662162162162162,148,5250,3800,1450,0.7238095238095238,67,38,29,238.8994013611711,0.47952097505668934,0.7398454124694671,0.13742716958837448,1045073.4905587755,15083.486254584212,1060156.9768133597,147,0,71.31756756756756,62,86,38,38.32230812361178,0.5502533783783784,44.42791005291006,8178.306878306882,131.90817545656262,8
149,32,2,2,143,0.013793103448275862,0.013793103448275862,0.9862068965517241,145,3800,2700,1100,0.7105263157894737,49,27,22,245.14245391622651,0.47910280970625796,0.7437000328078311,0.14272579605559957,1048786.061801451,18620.397764628804,1067406.4595660798,148,0,72.21379310344828,64,81,34,37.698083583708915,0.5523706896551723,43.97435897435899,8192.82051282055,128.0128205128211,8
150,32,0,1,142,0.0,0.006993006993006993,0.993006993006993,143,4250,2900,1350,0.6823529411764706,56,29,27,234.59998454902623,0.47841360517416853,0.7273511501879031,0.1344708603912502,1043962.4192979638,16132.713487413432,1060095.1327853773,149,1,73.93006993006993,63,80,38,38.57126927488213,0.5484411421911422,44.56380208333335,8173.958333333363,129.74537037037084,8
151,32,3,1,144,0.020689655172413793,0.006896551724137931,0.993103448275862,145,5050,3800,1250,0.7524752475247525,63,38,25,222.1867479036665,0.47875558748403574,0.7208398822497588,0.12444338165380255,1036741.6831032217,12020.052596975704,1048761.7357001975,150,0,72.9103448275862,64,81,43,39.79292579534965,0.541882183908046,45.44871794871795,8145.641025641027,127.27564102564105,8
152,32,5,3,146,0.03355704697986577,0.020134228187919462,0.9798657718120806,149,4100,2900,1200,0.7073170731707317,53,29,24,240.03669309022249,0.47947654029868797,0.7437580945426194,0.13571177999680334,1039689.6735229352,16012.734214499793,1055702.407737435,151,0,71.86577181208054,66,83,37,38.96821887452227,0.5394295302013423,45.087064676616926,8157.21393034828,123.59415045982243,8
153,32,2,4,144,0.013513513513513514,0.02702702702702703,0.972972972972973,148,4850,3600,1250,0.7422680412371134,61,36,25,239.5017597061228,0.47895025127167984,0.7385401754402816,0.13501371744555585,1038774.5484141996,15307.66645662678,1054082.2148708263,152,0,73.29054054054055,68,80,33,39.09675316980686,0.5409628378378378,45.19927536231884,8153.623188405804,119.90622335890889,8
154,32,2,3,143,0.0136986301369863,0.02054794520547945,0.9794520547945206,146,4900,3400,1500,0.6938775510204082,64,34,30,236.81876107857312,0.47826720201543066,0.7389385503481265,0.1306048376966258,1031867.5659602036,14773.119713571476,1046640.6856737752,153,0,75.04794520547945,67,79,36,40.03372944062411,0.5319634703196348,46.047794117647044,8126.470588235263,121.29060579455616,8
155,32,4,1,146,0.027210884353741496,0.006802721088435374,0.9931972789115646,147,5350,3700,1650,0.6915887850467289,70,37,33,236.1294632508659,0.4785085266983506,0.7376561897724185,0.1300838991947695,1031524.8058589468,13964.679747485347,1045489.4856064321,154,0,75.40136054421768,68,79,39,40.09441207364686,0.5304705215419501,46.08997584541063,8125.1207729468615,119.48707019039502,8
156,32,2,0,148,0.013513513513513514,0.0,1.0,148,4500,3100,1400,0.6888888888888889,59,31,28,235.72424679473005,0.4786170098670099,0.740529752244433,0.13125658195122142,1034903.8879712131,14690.387899390604,1049594.2758706037,155,0,75.18243243243244,58,90,41,39.6793648038875,0.5333614864864865,45.6744350282486,8138.41807909608,140.31755308786344,0
157,32,3,0,151,0.019867549668874173,0.0,1.0,151,3400,2200,1200,0.6470588235294118,46,22,24,217.92083272580507,0.4790121412803532,0.720856303825882,0.12200042306509366,1036603.469819301,11579.49826989623,1048182.9680891973,156,0,74.66887417218543,67,84,41,39.91885331407479,0.5358719646799117,45.46568627450981,8145.098039215693,121.56862745098049,8
158,32,2,3,150,0.013071895424836602,0.0196078431372549,0.9803921568627451,153,4950,3300,1650,0.6666666666666666,66,33,33,221.39056993262406,0.47931895711500977,0.7297074412568019,0.12501669275423893,1039307.4298469432,10468.572845805256,1049776.0026927486,157,0,74.6797385620915,69,84,36,39.49143409042259,0.5386029411764706,45.13392857142859,8155.714285714321,118.19875776397566,0
159,32,1,4,147,0.006622516556291391,0.026490066225165563,0.9735099337748344,151,4150,2900,1250,0.6987951807228916,54,29,25,224.8886260255069,0.4787435614422369,0.7311137896459552,0.1275934684995898,1040783.1338579264,12462.057792766354,1053245.1916506926,158,0,76.41059602649007,70,81,38,39.21733586439642,0.5402179911699779,44.95305164319251,8161.502347417886,116.59289067739837,0
160,32,4,2,149,0.026490066225165563,0.013245033112582781,0.9867549668874173,151,5050,3500,1550,0.693069306930693,66,35,31,245.23339223848438,0.4788392200147167,0.755381167434729,0.139557656799331,1041725.4218629809,15843.171796904779,1057568.5936598857,159,0,75.35099337748345,67,84,38,38.58018900962558,0.5407008830022075,44.83762254901959,8165.196078431337,121.86859818554234,8
161,32,2,2,149,0.013245033112582781,0.013245033112582781,0.9867549668874173,151,5350,3900,1450,0.7289719626168224,68,39,29,244.10335837689203,0.478416114790287,0.7540341779380708,0.1403372398523146,1044889.3151753835,15462.198193288245,1060351.5133686718,160,0,75.21192052980132,57,94,39,38.21238023285779,0.5437362030905077,44.45043103448275,8177.586206896528,143.46642468239523,0
162,32,3,1,151,0.019736842105263157,0.006578947368421052,0.993421052631579,152,4500,2700,1800,0.6,63,27,36,247.0467528126787,0.4788825592540955,0.7547953831462686,0.14213597593746183,1045121.4735807676,16738.773268586447,1061860.2468493541,161,0,75.02631578947368,61,91,36,38.108072574283455,0.5444764254385965,44.422043010752716,8178.494623655968,134.07368235501588,8
163,32,2,3,150,0.013071895424836602,0.0196078431372549,0.9803921568627451,153,4900,3100,1800,0.6326530612244898,67,31,36,238.26732313949242,0.4792490826740053,0.7468248769440959,0.13781269720784453,1046758.1219143375,14381.65113661048,1061139.773050948,162,0,74.93464052287581,63,90,40,38.12765139463362,0.5466367102396514,44.22200520833335,8184.895833333363,129.91898148148195,0
164,32,2,5,147,0.013157894736842105,0.03289473684210526,0.9671052631578947,152,4800,3300,1500,0.6875,63,33,30,242.9599540035661,0.47883808237481124,0.7525047988379014,0.14206505667816674,1050107.3870013326,15826.808488930077,1065934.1954902627,163,0,75.84868421052632,65,87,39,37.588816329883365,0.549890350877193,43.813131313131336,8197.979797979848,126.12276612276689,0
165,32,2,1,148,0.013422818791946308,0.006711409395973154,0.9932885906040269,149,3900,2800,1100,0.717948717948718,50,28,22,235.27910888905515,0.47865650885785116,0.7385741639750116,0.13383909964672477,1041600.3460207606,15313.360246059156,1056913.7062668197,164,0,77.40939597315436,67,82,37,38.84986391290428,0.5418064876957495,44.85294117647059,8164.705882352936,121.86128182616322,8
166,32,3,0,151,0.019867549668874173,0.0,1.0,151,5500,3700,1800,0.6727272727272727,73,37,36,250.99344884387895,0.47911331861662987,0.7581491708956845,0.13881474415651188,1032764.0624999938,16143.40277777745,1048907.4652777712,165,0,77.33112582781457,69,82,38,39.56069769031022,0.5259381898454747,45.93749999999998,8129.999999999951,117.82608695652102,8
167,32,1,1,151,0.006578947368421052,0.006578947368421052,0.993421052631579,152,4550,2900,1650,0.6373626373626373,62,29,33,250.7040751957458,0.4792084204717091,0.7583223751576353,0.13958814129770042,1034882.3350694502,16939.843750000386,1051822.1788194505,166,0,77.8157894736842,59,93,40,39.30110417093318,0.5279605263157895,45.67708333333336,8138.333333333379,137.9378531073454,0
168,32,5,2,154,0.03205128205128205,0.01282051282051282,0.9871794871794872,156,4400,2800,1600,0.6363636363636364,60,28,32,264.0564977042651,0.47960435621725944,0.7786737080881845,0.143436465657068,1027048.2859773386,18639.754673668747,1045688.0406510073,167,0,76.76282051282051,57,99,33,39.95142777817161,0.5215010683760684,46.641522988505734,8107.47126436779,142.23633797136475,8
169,32,4,2,156,0.02531645569620253,0.012658227848101266,0.9873417721518988,158,5500,3900,1600,0.7090909090909091,71,39,32,241.53453372749215,0.4799981187347147,0.7517119734384714,0.1339418777943369,1033611.1111111138,12830.5555555557,1046441.6666666695,168,0,76.71518987341773,64,94,39,39.694330601092865,0.5328322784810127,45.83333333333334,8133.333333333355,127.08333333333367,8
170,32,4,3,157,0.025,0.01875,0.98125,160,5050,3200,1850,0.6336633663366337,69,32,37,234.6226191534102,0.48090605345911946,0.7484711021505368,0.13115789037920192,1036141.6796613984,11570.454939234394,1047712.1346006328,169,0,76.73125,66,94,41,39.55176767676766,0.53515625,45.522388059701505,8143.283582089583,123.3830845771149,0
171,32,9,2,164,0.05421686746987952,0.012048192771084338,0.9879518072289156,166,4300,2900,1400,0.6744186046511628,57,29,28,218.12850400305746,0.4814203784836315,0.7463425129087766,0.1226266460328073,1037911.3491591213,7779.609975974954,1045690.9591350963,170,0,72.78915662650603,70,96,42,39.74954397081413,0.5343247991967872,45.30516431924884,8150.234741784067,116.43192488262953,8
172,32,2,4,162,0.012048192771084338,0.024096385542168676,0.9759036144578314,166,5450,3900,1550,0.7155963302752294,70,39,31,219.51740925146737,0.4811032006815139,0.7495146750142576,0.12315298722412839,1037263.9053254452,6889.49704142033,1044153.4023668655,171,0,73.20481927710843,64,102,44,39.79536442598193,0.5340110441767068,45.384615384615394,8147.692307692319,127.30769230769249,8
173,32,8,6,164,0.047058823529411764,0.03529411764705882,0.9647058823529412,170,3700,2400,1300,0.6486486486486487,50,24,26,207.03790326995625,0.48170974010906137,0.7397212136550779,0.11791989156082452,1041985.7389061386,5446.108524064661,1047431.8474302032,172,0,71.92941176470588,73,97,43,39.52225485869784,0.5379289215686274,44.80574324324325,8166.216216216238,111.86597556460599,0
174,32,3,2,165,0.017964071856287425,0.011976047904191617,0.9880239520958084,167,4800,3300,1500,0.6875,63,33,30,231.35190153086424,0.48125135271625424,0.7645132314217835,0.13014250048123446,1038108.8385432599,9833.690758595985,1047942.5293018558,173,0,73.76047904191617,65,102,41,39.387960323853186,0.530938123752495,45.28093434343434,8151.010101010093,125.40015540015528,8
175,32,5,5,165,0.029411764705882353,0.029411764705882353,0.9705882352941176,170,4950,3300,1650,0.6666666666666666,66,33,33,224.0312017822938,0.48166333101287856,0.7589496012727253,0.12750042935896513,1041746.2685667471,7726.733699845924,1049473.002266593,174,0,73.3529411764706,71,99,35,39.11857883993877,0.5346200980392157,44.83506944444446,8165.277777777804,115.00391236306766,0
176,32,3,3,165,0.017857142857142856,0.017857142857142856,0.9821428571428571,168,4950,3200,1750,0.6464646464646465,67,32,35,252.78195524371105,0.4814723232107214,0.7846146406284153,0.14037381626028833,1034049.375949603,13727.804614216311,1047777.1805638194,175,0,74.41666666666667,57,111,40,39.353217355469205,0.5239955357142857,45.77945402298853,8135.057471264417,142.7203065134108,8
177,32,2,2,165,0.011976047904191617,0.011976047904191617,0.9880239520958084,167,5800,4000,1800,0.6896551724137931,76,40,36,246.7603305785115,0.48103642113363637,0.7780729450190531,0.138487940630798,1037379.9725651637,11996.844993141709,1049376.8175583053,176,0,75.2994011976048,62,105,41,39.087121212121254,0.5275074850299402,45.370370370370395,8148.148148148195,131.4217443249709,0
178,32,7,8,164,0.040697674418604654,0.046511627906976744,0.9534883720930233,172,6100,4300,1800,0.7049180327868853,79,43,36,231.46282736536685,0.4813136078244707,0.7702008351857603,0.13172562564998253,1041736.1429988741,7724.6386054426985,1049460.7816043168,177,0,74.03488372093024,69,103,40,38.93021859994953,0.5319161821705427,44.836309523809554,8165.238095238157,118.3367839889588,0
179,32,3,1,166,0.017964071856287425,0.005988023952095809,0.9940119760479041,167,5650,4000,1650,0.7079646017699115,73,40,33,234.13645103955514,0.48128441911358005,0.7631230321712057,0.1318171069490577,1038366.1464710305,9573.872882869506,1047940.0193539001,178,0,76.32934131736526,65,102,44,39.2847278152944,0.53000249500998,45.24936868686871,8152.020202020259,125.41569541569629,8
180,32,2,1,167,0.011904761904761904,0.005952380952380952,0.9940476190476191,168,5950,3700,2250,0.6218487394957983,82,37,45,229.74013601394412,0.4808842137154263,0.7604353340612737,0.13033817249728605,1040764.3176020477,8271.067176871116,1049035.3847789187,179,0,76.83928571428571,69,99,44,39.09595804889435,0.5329241071428572,44.95535714285717,8161.428571428626,118.2815734989656,0
181,32,0,3,164,0.0,0.017964071856287425,0.9820359281437125,167,5200,3400,1800,0.6538461538461539,70,34,36,240.92003541406189,0.4805253949931462,0.7712227508728768,0.1314181472018035,1028384.8910274876,10951.704873125618,1039336.5959006132,180,1,77.50898203592814,67,100,37,40.368831822759326,0.5190868263473054,46.4767156862745,8112.7450980392005,121.08574773192836,8
182,32,2,2,164,0.012048192771084338,0.012048192771084338,0.9879518072289156,166,4850,3000,1850,0.6185567010309279,67,30,37,236.25669943209886,0.4807883047340879,0.7660788928307998,0.12955191997896465,1030053.3887896984,10621.402774860318,1040674.7915645586,181,0,78.10843373493977,68,98,42,40.27662085242261,0.5210843373493976,46.271135265700465,8119.323671497545,119.4018186984933,0
183,32,6,2,168,0.03529411764705882,0.011764705882352941,0.9882352941176471,170,5200,3400,1800,0.6538461538461539,70,34,36,220.8348593468516,0.4819403353057199,0.7544054731700953,0.11841026315530857,1022885.873808351,5977.771614069777,1028863.6454224208,182,0,76.58823529411765,77,93,36,41.57175962604976,0.5121936274509804,47.15544871794872,8091.025641025651,105.0782550782552,8
184,32,9,5,172,0.05084745762711865,0.02824858757062147,0.9717514124293786,177,4900,3100,1800,0.6326530612244898,67,31,36,203.72955782750472,0.48316587485019685,0.7448224000837003,0.11112521336045608,1028367.3874231196,1601.7666247872357,1029969.1540479069,183,0,74.44632768361582,70,107,43,41.313898533950606,0.517596516007533,46.47887323943658,8112.676056337942,115.89537223339917,8
185,32,9,3,178,0.049723756906077346,0.016574585635359115,0.9834254143646409,181,5600,3800,1800,0.6785714285714286,74,38,36,209.333190400231,0.48435645590341725,0.7631886039725868,0.11238639480706977,1023295.8815419485,1041.9583213183214,1024337.8398632668,184,0,71.0,67,114,44,41.810843075494155,0.5020142725598526,47.10477941176468,8092.647058823478,120.78577699736535,8
186,32,2,4,176,0.011111111111111112,0.022222222222222223,0.9777777777777777,180,5500,4000,1500,0.7272727272727273,70,40,30,208.90748424854473,0.4847448530933168,0.7616721591872553,0.11305007881902386,1025836.8064588383,1360.9972973753697,1027197.8037562136,185,0,72.12222222222222,61,119,44,41.501268993431076,0.5044560185185185,46.79099462365591,8102.688172043004,132.83095364004924,0
187,32,6,2,180,0.03296703296703297,0.01098901098901099,0.989010989010989,182,6250,4800,1450,0.768,77,48,29,202.6607434613519,0.4854460111711493,0.7491871646831658,0.11097174674505068,1029601.8486457408,-918.0247768542213,1028683.8238688866,186,0,71.53846153846153,75,107,46,41.18579353072545,0.5111607142857143,46.326754385964925,8117.543859649152,108.23391812865536,6
188,32,6,5,181,0.03225806451612903,0.026881720430107527,0.9731182795698925,186,5650,4100,1550,0.7256637168141593,72,41,31,215.74917135547082,0.48619708418095514,0.7693943621732908,0.11735468536529249,1027480.9359611642,1485.632103432879,1028966.5680645971,187,0,70.89247311827957,68,118,44,41.12082489376064,0.511760752688172,46.58816425120772,8109.178743961339,119.25262858766675,7
189,32,6,10,177,0.03208556149732621,0.053475935828877004,0.946524064171123,187,5400,3400,2000,0.6296296296296297,74,34,40,224.88833738647034,0.4868442489410231,0.7815564623785367,0.12343163236084562,1030345.836876416,3542.5524376416893,1033888.3893140577,188,0,70.95187165775401,69,118,39,40.528242831173394,0.5179924242424243,46.235119047619044,8120.476190476181,117.68806073153885,7
190,32,8,2,183,0.043243243243243246,0.010810810810810811,0.9891891891891892,185,6600,5200,1400,0.7878787878787878,80,52,28,217.09926363618564,0.4873726987857423,0.7741516456005877,0.12162535683181838,1036822.7771719769,1418.6922890524434,1038241.4694610293,189,0,70.80540540540541,65,120,41,39.91225690784717,0.522240990990991,45.438762626262644,8145.959595959633,125.32245532245588,0
191,32,5,6,182,0.026595744680851064,0.031914893617021274,0.9680851063829787,188,6250,4700,1550,0.752,78,47,31,212.59684906224012,0.48767872719687483,0.7725822801546973,0.12038842097923433,1040184.5182007637,377.9902025617639,1040562.5084033255,190,0,70.64893617021276,70,118,39,39.60575023495791,0.5251551418439716,45.02640845070426,8159.154929577543,116.55935613682205,0
192,32,3,3,182,0.016216216216216217,0.016216216216216217,0.9837837837837837,185,5650,4400,1250,0.7787610619469026,69,44,25,217.83950384951518,0.48681698002350177,0.7732935389377107,0.12244082457748647,1037851.5625000035,2567.0138888890942,1040418.5763888926,191,0,71.81621621621622,65,120,46,39.76440013633267,0.5198198198198198,45.312500000000014,8150.000000000027,125.3846153846158,8
193,32,6,7,181,0.031914893617021274,0.03723404255319149,0.9627659574468085,188,5250,3700,1550,0.7047619047619048,68,37,31,200.07252825698998,0.48755843004513216,0.7614270887389727,0.11109119255872939,1034014.5896321473,-1474.4173595365455,1032540.1722726108,192,0,71.37765957446808,62,126,45,40.69756097560976,0.5231050531914894,45.78373015873015,8134.920634920621,131.20839733742937,8
194,32,5,2,184,0.026881720430107527,0.010752688172043012,0.989247311827957,186,6400,4400,2000,0.6875,84,44,40,190.8666856260825,0.48798738254383417,0.7469965380048273,0.10725978620210966,1037791.7775628739,-3984.02460931472,1033807.7529535592,193,0,71.06451612903226,70,116,45,40.45883979491907,0.5274977598566308,45.319835680751176,8149.765258215967,116.42521797451381,0
195,32,5,6,183,0.026455026455026454,0.031746031746031744,0.9682539682539683,189,6000,4300,1700,0.7166666666666667,77,43,34,187.6797249166098,0.48797562760328717,0.746557771844407,0.10659739594505413,1041119.3550706798,-4720.601166995289,1036398.7539036846,194,0,70.86243386243386,77,112,42,40.124371760640805,0.5306437389770723,44.911858974358985,8162.820512820534,106.01065601065628,0
196,32,2,3,182,0.010810810810810811,0.016216216216216217,0.9837837837837837,185,5550,3600,1950,0.6486486486486487,75,36,39,193.26790724507617,0.48701160399529964,0.7486541649609644,0.11003859012504112,1041876.8395083157,-2277.728724222578,1039599.110784093,195,0,73.18378378378378,75,110,44,39.887250689297076,0.5321509009009009,44.81907894736844,8165.789473684254,108.87719298245672,0
197,32,2,1,183,0.010869565217391304,0.005434782608695652,0.9945652173913043,184,5900,4000,1900,0.6779661016949152,78,40,38,191.54176114917786,0.486880172447929,0.7445533544618332,0.10972525567114402,1043778.7951299442,-2714.554266128283,1041064.2408638159,196,0,74.11413043478261,70,114,45,39.69402799318359,0.5349298007246377,44.586267605633836,8173.239436619796,116.7605633802828,0
198,32,2,5,180,0.010810810810810811,0.02702702702702703,0.972972972972973,185,6150,4000,2150,0.6504065040650406,83,40,43,201.7060563368122,0.48704465334900116,0.7567273413245266,0.11497109199022734,1042223.9871408887,-1105.4219468366355,1041118.5651940521,197,0,74.56216216216217,68,117,41,39.62855889427819,0.5357545045045045,44.776570048309175,8167.149758454095,120.10514350667786,8
199,32,2,8,174,0.01098901098901099,0.04395604395604396,0.9560439560439561,182,6300,4000,2300,0.6349206349206349,86,40,46,218.9344630589708,0.4868120484487888,0.7708623254474787,0.12098738514777306,1032511.115327667,2510.453327336137,1035021.5686550031,198,0,75.2967032967033,76,106,44,40.406992224944055,0.5248969780219781,45.968614718614695,8129.004329004275,106.96058327637203,8
200,32,7,3,178,0.03867403314917127,0.016574585635359115,0.9834254143646409,181,6200,4400,1800,0.7096774193548387,80,44,36,234.4706671576399,0.4871585328422345,0.7795115376769712,0.1277853201635173,1028098.6992717574,5811.797584430138,1033910.4968561875,199,0,75.15469613259668,65,116,37,40.56844478342984,0.5153660220994476,46.51199494949495,8111.616161616157,124.79409479409472,8
201,32,8,6,180,0.043010752688172046,0.03225806451612903,0.967741935483871,186,5500,3500,2000,0.6363636363636364,75,35,40,219.70808964704412,0.48828223384675,0.7688937978383217,0.1212812216040918,1032162.4231734733,2654.8868401814107,1034817.3100136548,200,0,73.94623655913979,75,111,39,40.43118063425248,0.5193772401433692,46.011513157894726,8127.631578947344,108.36842105263125,0
202,32,1,3,178,0.0055248618784530384,0.016574585635359115,0.9834254143646409,181,6200,4300,1900,0.6935483870967742,81,43,38,230.60751828575107,0.48758824432166975,0.7802026323387716,0.12547111937400443,1027568.3815192739,4992.998866213055,1032561.3803854869,201,0,76.6353591160221,62,119,41,40.73326482677626,0.5183586556169428,46.57738095238095,8109.5238095238055,130.7987711213517,8
203,32,5,6,177,0.0273224043715847,0.03278688524590164,0.9672131147540983,183,4750,3300,1450,0.6947368421052632,62,33,29,218.38975754882753,0.4878537901078885,0.769193512582657,0.12013901560868871,1031071.0069444414,3685.069444444272,1034756.0763888856,202,0,76.19672131147541,69,114,38,40.601918342224025,0.521117941712204,46.14583333333332,8123.3333333333085,117.72946859903345,0
204,32,2,4,175,0.0111731843575419,0.0223463687150838,0.9776536312849162,179,5050,3300,1750,0.6534653465346535,68,33,35,208.53066550244915,0.48775448287406103,0.7513360054400142,0.11253245630307152,1024945.3233507023,1896.5060763892852,1026841.8294270916,203,0,78.68715083798882,79,100,36,41.623152244744,0.5161196461824953,46.90104166666669,8099.16666666673,102.5210970464143,8
205,32,3,2,176,0.016853932584269662,0.011235955056179775,0.9887640449438202,178,5950,4400,1550,0.7394957983193278,75,44,31,238.2427252139735,0.48808626399204386,0.7753383099199782,0.1290225743684029,1026079.3092515741,7341.186184353308,1033420.4954359274,204,0,79.53932584269663,63,115,38,40.72783437238897,0.51375234082397,46.761067708333336,8103.645833333339,128.62929894179905,7
206,32,7,6,177,0.03825136612021858,0.03278688524590164,0.9672131147540983,183,6500,4700,1800,0.7230769230769231,83,47,36,227.68329534664616,0.48855311355311354,0.7713511258230574,0.1256599991899204,1032102.9097860708,3898.518327390664,1036001.4281134615,205,0,78.03825136612022,72,111,42,40.23610877015561,0.518613387978142,46.01883561643834,8127.3972602739295,112.88051750380458,0
207,32,4,1,180,0.022099447513812154,0.0055248618784530384,0.994475138121547,181,6150,4500,1650,0.7317073170731707,78,45,33,220.3757759256956,0.4880537650910579,0.7686850608298128,0.12176672542422194,1032466.5332562253,3156.1226767305616,1035622.6559329558,206,0,79.68508287292818,73,108,42,40.3759835974731,0.5202578268876612,45.974099099099085,8128.828828828798,111.35381957299722,8
208,32,4,4,180,0.021739130434782608,0.021739130434782608,0.9782608695652174,184,5550,3800,1750,0.6846846846846847,73,38,35,230.6877487347895,0.4879486912964283,0.7801329177987335,0.1271729730249844,1031741.4667313175,5252.02324731531,1036993.4899786328,207,0,79.28804347826087,76,108,34,40.20530339353256,0.5209465579710144,46.06331168831168,8125.974025974,106.92071086807896,7
209,32,7,4,183,0.0374331550802139,0.0213903743315508,0.9786096256684492,187,7150,5200,1950,0.7272727272727273,91,52,39,216.99662345369916,0.4879080175569739,0.7713236007849138,0.1213712368341893,1036314.1642745469,425.33489696386096,1036739.4991715108,208,0,78.18716577540107,68,119,40,39.978669869893615,0.5262366310160428,45.501207729468604,8143.961352657016,119.76413753907376,0
210,32,5,3,185,0.026595744680851064,0.015957446808510637,0.9840425531914894,188,5300,3400,1900,0.6415094339622641,72,34,38,202.6878695662614,0.4881267303826753,0.7471608615199921,0.11294628953548105,1035141.3838788103,-937.879640346604,1034203.5042384637,209,0,78.19680851063829,71,117,45,40.489792484310705,0.5302526595744681,45.64525462962961,8139.351851851814,114.63875847678611,8
211,32,6,5,186,0.031413612565445025,0.02617801047120419,0.9738219895287958,191,6300,4500,1800,0.7142857142857143,81,45,36,194.78965853625806,0.48773422430421604,0.7415001703504613,0.11005788699890484,1039484.8167324073,-4003.8214990141114,1035480.9952333932,210,0,77.27748691099477,77,114,36,40.147228334905115,0.5340314136125655,45.11217948717947,8156.410256410212,105.92740592740536,0
212,32,1,4,183,0.0053475935828877,0.0213903743315508,0.9786096256684492,187,5850,4400,1450,0.7521367521367521,73,44,29,192.32764807645688,0.48747077032181396,0.7388547557610841,0.10588210898843822,1031311.2944334314,-3580.064861386576,1027731.2295720448,211,0,79.55614973262033,80,107,40,41.23336879073382,0.527517825311943,46.116255144032905,8124.279835390904,101.5534979423863,8
213,32,3,2,184,0.016129032258064516,0.010752688172043012,0.989247311827957,186,6350,4800,1550,0.7559055118110236,79,48,31,188.75809088653733,0.48704712777293424,0.7341089078261585,0.10460812100131604,1033409.4013762828,-4537.122858403076,1028872.2785178798,212,0,80.80645161290323,83,103,43,41.06100159396247,0.5299059139784946,45.858134920634896,8132.539682539615,97.9824058137303,0
214,32,4,2,186,0.02127659574468085,0.010638297872340425,0.9893617021276596,188,6550,4300,2250,0.6564885496183206,88,43,45,203.87181816549122,0.48739605852011986,0.756112880070676,0.11116784047137158,1028267.1591258852,-2223.060941828264,1026044.0981840569,213,0,79.81914893617021,75,113,44,41.32289864475201,0.5213320035460993,46.49122807017544,8112.280701754389,108.16374269005853,8
215,32,5,4,187,0.02617801047120419,0.020942408376963352,0.9790575916230366,191,6950,5000,1950,0.7194244604316546,89,50,39,199.16820000000044,0.48730940571323594,0.7520659685863875,0.11015940265486716,1032784.7180910798,-4010.4253420584737,1028774.2927490213,214,0,79.49738219895288,81,110,42,40.874791666666624,0.525305410122164,45.934959349593484,8130.081300812981,100.37137408411087,0
216,32,6,5,188,0.031088082901554404,0.025906735751295335,0.9740932642487047,193,5950,4100,1850,0.6890756302521008,78,41,37,196.73362841747192,0.4870826137017847,0.758605932007308,0.10954641919387809,1034905.8836216105,-3829.842088906216,1031076.0415327043,215,0,79.27461139896373,71,122,41,40.67074587102031,0.5273100172711571,45.6741898148148,8138.4259259259015,114.62571726656199,8
217,32,4,3,189,0.020833333333333332,0.015625,0.984375,192,6250,5300,950,0.848,72,53,19,186.36551452475712,0.4869416721204189,0.7460027321266658,0.10168522514708778,1028465.5041443364,-6315.899429835799,1022149.6047145006,216,0,79.921875,73,119,43,41.7417943664057,0.5190972222222222,46.466779279279244,8113.0630630629785,111.13785017894492,8
218,32,7,7,189,0.03571428571428571,0.03571428571428571,0.9642857142857143,196,6400,4700,1700,0.734375,81,47,34,205.85238757579896,0.4874585731728589,0.7724006700594885,0.1140397686152951,1033293.4271918344,-3058.8161892364533,1030234.611002598,217,0,79.02551020408163,79,117,43,40.641118426670765,0.5201955782312926,45.872395833333314,8132.083333333287,102.93776371307958,8
219,32,6,9,186,0.03076923076923077,0.046153846153846156,0.9538461538461538,195,5700,3800,1900,0.6666666666666666,76,38,38,208.2688459697417,0.487281919111816,0.7787733342426904,0.1150771461840152,1032466.5332562233,-1693.8773232695671,1030772.6559329537,218,0,79.1025641025641,73,122,43,40.68353097639361,0.5207799145299146,45.97409909909908,8128.828828828782,111.35381957299701,6
220,32,3,0,189,0.015873015873015872,0.0,1.0,189,6350,4100,2250,0.6456692913385826,86,41,45,216.93357652923643,0.4871770516717325,0.7688564872384644,0.12070406694062595,1034670.410156246,740.9505208330929,1035411.3606770792,219,0,80.15873015873017,71,118,40,40.186571940604196,0.5259038800705467,45.703124999999986,8137.499999999969,114.61267605633759,8
221,32,2,4,187,0.010471204188481676,0.020942408376963352,0.9790575916230366,191,5900,4200,1700,0.711864406779661,76,42,34,212.59955250125338,0.4871922935611279,0.7666381846713164,0.11904405739964714,1036663.3611111058,-21.166666666933452,1036642.1944444388,220,0,80.30890052356021,74,117,41,40.04678889070767,0.5284685863874345,45.458333333333314,8145.333333333291,110.0720720720715,0
222,32,0,1,186,0.0,0.0053475935828877,0.9946524064171123,187,6050,3900,2150,0.6446280991735537,82,39,43,217.6333826161724,0.48666575623406744,0.7686988649666286,0.12247971373314566,1038247.7808641971,1741.4753086419792,1039989.2561728391,221,1,82.78609625668449,74,113,47,39.71998073532885,0.530358734402852,45.263888888888886,8151.555555555552,110.15615615615611,0
223,32,1,3,184,0.0053475935828877,0.016042780748663103,0.983957219251337,187,6500,4500,2000,0.6923076923076923,85,45,40,218.0120587930484,0.48665497479539227,0.7689153231577865,0.12359330791905769,1040534.2148545745,1469.8012850109444,1042004.0161395855,222,0,83.74866310160428,75,112,41,39.42388655989109,0.5328097147950089,44.98355263157896,8160.526315789504,108.80701754386006,0
224,32,3,7,180,0.016042780748663103,0.0374331550802139,0.9625668449197861,187,6050,4200,1850,0.6942148760330579,79,42,37,211.99868844278666,0.48694727157725265,0.762239962235989,0.11547785043879819,1027932.0991274127,134.05136465026135,1028066.1504920629,223,0,83.97860962566845,72,115,37,41.15905721631104,0.5190508021390374,46.53253424657533,8110.958904109561,112.65220700152169,8
225,32,5,6,179,0.02702702702702703,0.032432432432432434,0.9675675675675676,185,6000,4400,1600,0.7333333333333333,76,44,32,212.62207085774358,0.4873408734821778,0.7615234061302969,0.11722263489011242,1031765.4258209106,875.2202954924878,1032640.646116403,224,0,84.83783783783784,77,108,38,40.66104610395303,0.5226914414414414,46.060363247863236,8126.068376068344,105.53335553335512,0
226,32,2,4,177,0.011049723756906077,0.022099447513812154,0.9779005524861879,181,6300,4500,1800,0.7142857142857143,81,45,36,212.53257595265163,0.4873171168405975,0.7503172276074652,0.11576972818186022,1027935.0292198615,1193.9359344125978,1029128.9651542741,225,0,86.45856353591161,78,103,36,41.145155976347795,0.5229627071823204,46.53217299578061,8110.970464135078,103.98680082224459,8
227,32,8,5,180,0.043243243243243246,0.02702702702702703,0.972972972972973,185,6500,4400,2100,0.676923076923077,86,44,42,240.8152981498182,0.48794677830003913,0.7870941619401217,0.1315662193258106,1028882.0555795769,6054.107795078321,1034936.1633746552,226,0,84.8,67,118,41,40.30873706254276,0.5182995495495495,46.41544117647056,8114.705882352878,121.11501316944593,8
228,32,3,3,180,0.01639344262295082,0.01639344262295082,0.9836065573770492,183,5650,3800,1850,0.672566371681416,75,38,37,240.29681111678005,0.4874734782521668,0.7819634966166062,0.13223385606491203,1031175.333213437,7307.628854694078,1038482.9620681311,227,0,86.08743169398907,72,111,36,40.03264759335245,0.5218579234972678,46.132990867579885,8123.744292237385,112.82978183663035,0
229,32,1,3,178,0.0055248618784530384,0.016574585635359115,0.9834254143646409,181,5950,4000,1950,0.6722689075630253,79,40,39,241.19521538565635,0.48729537548598323,0.7821955260835072,0.13330083246184898,1032538.9560967793,7658.691181968705,1040197.647278748,228,0,87.1878453038674,78,103,37,39.83799179902418,0.5245165745856354,45.96518987341772,8129.113924050633,104.21940928270043,0
230,32,1,1,178,0.00558659217877095,0.00558659217877095,0.994413407821229,179,5850,4200,1650,0.717948717948718,75,42,33,246.67560709433712,0.48700254221329486,0.7870457379408864,0.1366999899694148,1033396.6355997062,9332.748491160535,1042729.3840908668,229,0,89.12290502793296,78,101,39,39.590683476877295,0.5257216014897579,45.859704641350206,8132.489451476779,104.26268527534333,0
231,32,5,2,181,0.0273224043715847,0.01092896174863388,0.9890710382513661,183,5350,3500,1850,0.6542056074766355,72,35,37,227.9503645467813,0.48719449948958143,0.7714183614922787,0.1251817582215622,1030522.2061165809,5031.582511565158,1035553.788628146,230,0,88.11475409836065,73,110,36,40.4283261227282,0.5204348816029144,46.21340090090087,8121.171171171101,111.24892015302879,8
232,32,4,3,182,0.021621621621621623,0.016216216216216217,0.9837837837837837,185,5400,3300,2100,0.6111111111111112,75,33,42,220.37086804622442,0.4873678025851939,0.7672131147540995,0.12220566318926972,1033611.1111111094,3155.555555555493,1036766.6666666649,231,0,87.91891891891892,68,117,41,40.23224043715851,0.523704954954955,45.83333333333333,8133.333333333319,119.60784313725469,0
233,32,7,5,184,0.037037037037037035,0.026455026455026454,0.9735449735449735,189,6900,4800,2100,0.6956521739130435,90,48,42,215.66750938577087,0.48773523396750346,0.7748599043196394,0.12372504485815289,1044228.5156250017,341.2326388889787,1044569.7482638907,232,0,86.51851851851852,67,122,39,39.02161909616038,0.5338955026455027,44.53125000000001,8175.000000000014,122.01492537313453,8
234,32,6,4,186,0.031578947368421054,0.021052631578947368,0.9789473684210527,190,5250,3400,1850,0.6476190476190476,71,34,37,209.42771866455453,0.48720644203100344,0.7699002062775266,0.12168788434357398,1048169.2449333876,653.1387481498264,1048822.3836815374,233,0,85.85263157894737,72,118,40,38.689347902845164,0.5375,44.04965753424659,8190.410958904144,113.75570776255755,0
235,32,3,3,186,0.015873015873015872,0.015873015873015872,0.9841269841269842,189,6000,4300,1700,0.7166666666666667,77,43,34,199.0148969360364,0.48666343014747265,0.7561145416356216,0.1129908425693762,1040996.189281503,-2365.2501358667996,1038630.9391456362,234,0,87.11640211640211,76,113,43,39.8506143374878,0.5321318342151675,44.92694805194807,8162.337662337704,107.39917976760137,8
236,32,6,8,184,0.03125,0.041666666666666664,0.9583333333333334,192,5850,4400,1450,0.7521367521367521,73,44,29,204.88837591073946,0.4866167193862711,0.7691445760881921,0.11490202802030562,1037144.2177854924,-1750.2411265433448,1035393.976658949,235,0,86.57291666666667,71,121,42,40.182833276508696,0.5301649305555556,45.39930555555555,8147.222222222211,114.7496087636931,8
237,32,7,4,187,0.03664921465968586,0.020942408376963352,0.9790575916230366,191,6000,3900,2100,0.65,81,39,42,208.80730982618584,0.4870418848167539,0.7728593983195036,0.11680411720146773,1036350.1027284726,-920.504602235088,1035429.5981262375,236,0,87.32984293193718,64,127,42,40.18258191129863,0.5227966841186736,45.49679487179489,8144.1025641026,127.25160256410312,8
238,32,5,5,187,0.026041666666666668,0.026041666666666668,0.9739583333333334,192,6550,4600,1950,0.7022900763358778,85,46,39,199.76309521314244,0.4874711405613729,0.7644404840689789,0.11303429845388463,1039945.1201536353,-3401.468789260991,1036543.6513643743,237,0,86.71875,70,122,42,39.96290594847596,0.5272352430555556,45.05575117370894,8158.2159624413625,116.5459423205909,0
239,32,5,5,187,0.026041666666666668,0.026041666666666668,0.9739583333333334,192,6200,4400,1800,0.7096774193548387,80,44,36,202.8024450191447,0.4874518251890634,0.7665691295263235,0.11606315004854663,1043477.2721128896,-2276.051578719703,1041201.2205341698,238,0,87.43229166666667,67,125,45,39.44405704516827,0.5301649305555556,44.623161764705884,8172.058823529414,121.97102721685694,0
240,32,4,2,189,0.020942408376963352,0.010471204188481676,0.9895287958115183,191,6450,4800,1650,0.7441860465116279,81,48,33,198.89713177607743,0.48762514926058603,0.7594492711647416,0.11502461212526228,1046713.7164834087,-3012.328800154351,1043701.3876832543,239,0,88.38219895287958,71,120,49,39.14018751060584,0.5335405759162304,44.22743055555555,8184.722222222208,115.27777777777757,0
241,32,2,6,185,0.010471204188481676,0.031413612565445025,0.9685863874345549,191,6500,4600,1900,0.7076923076923077,84,46,38,194.25261864227224,0.48750574079177,0.7539215892327347,0.11310337245899069,1048803.5679012341,-3953.4320987654232,1044850.1358024688,240,0,89.10471204188482,74,117,45,38.998815594372715,0.5363765270506109,43.97222222222222,8192.888888888885,110.71471471471466,0
242,32,2,2,185,0.0106951871657754,0.0106951871657754,0.9893048128342246,187,6100,4300,1800,0.7049180327868853,79,43,36,214.64352414447671,0.4869269066375328,0.7751892869573163,0.12270955400767601,1043147.965976326,1280.9911242600647,1044428.957100586,241,0,90.41711229946524,64,123,41,39.18282809263792,0.5334224598930482,44.66346153846152,8170.769230769189,127.66826923076857,8
243,32,2,3,184,0.0106951871657754,0.016042780748663103,0.983957219251337,187,4700,2700,2000,0.574468085106383,67,27,40,207.8606653605099,0.4868202901884116,0.767655897821188,0.1197673357553405,1045578.2582820791,1366.9184905988814,1046945.176772678,242,0,91.16577540106952,70,117,45,39.05257594888276,0.5361519607843137,44.36619718309856,8180.281690140783,116.86116700201119,0
244,32,2,1,185,0.010752688172043012,0.005376344086021506,0.9946236559139785,186,6500,4500,2000,0.6923076923076923,85,45,40,204.58003283599624,0.48658093577448414,0.7615020762863349,0.1145999897405082,1036790.6358506973,-1278.6675347220912,1035511.9683159752,243,0,91.14516129032258,71,115,36,40.23497442455241,0.532258064516129,45.44270833333334,8145.833333333356,114.73004694835713,8
245,32,1,2,184,0.005376344086021506,0.010752688172043012,0.989247311827957,186,5850,4500,1350,0.7692307692307693,72,45,27,221.52746296226627,0.4865234185798702,0.7802177331043221,0.12430965425983462,1037337.106066984,2909.7314687276776,1040246.8375357117,244,0,92.10215053763442,65,121,41,39.7350022727742,0.5288418458781362,45.375631313131315,8147.979797979807,125.35353535353549,8
246,32,2,4,182,0.010752688172043012,0.021505376344086023,0.978494623655914,186,5650,3800,1850,0.672566371681416,75,38,37,235.72899364807097,0.48635026155187444,0.7925875085792717,0.1340525572119021,1041501.699949308,6252.429522361212,1047754.1294716692,245,0,92.6236559139785,70,116,42,38.85075234809278,0.5316420250896057,44.865023474178415,8164.3192488263185,116.63313212609026,8
247,32,0,1,181,0.0,0.005494505494505495,0.9945054945054945,182,6750,5200,1550,0.7703703703703704,83,52,31,242.54338152570477,0.48617962378321494,0.7881127717235947,0.13473074546023228,1034149.0999692035,7015.203941658791,1041164.3039108623,246,1,95.43956043956044,62,120,38,39.60094736385708,0.5248969780219781,45.76719576719576,8135.449735449716,131.2169312169309,8
248,32,2,4,179,0.01092896174863388,0.02185792349726776,0.9781420765027322,183,6300,4600,1700,0.7301587301587301,80,46,34,236.1056893689422,0.48631377729738384,0.7815125260246178,0.13180156286633943,1035699.5240554056,6006.91002123747,1041706.4340766431,247,0,95.8360655737705,68,115,40,39.56961174073855,0.5270947176684881,45.576690821256044,8141.545893719821,119.72861608411502,0
249,32,5,12,172,0.02717391304347826,0.06521739130434782,0.9347826086956522,184,6300,4400,1900,0.6984126984126984,82,44,38,223.15883350181434,0.48604738358279875,0.7759171629727035,0.12808833779026585,1044387.3952686806,3512.8545704313815,1047900.249839112,248,0,95.79347826086956,66,118,40,38.81037140712792,0.5371942934782609,44.51181592039801,8175.621890547258,123.87305894768572,8
250,32,1,2,171,0.005780346820809248,0.011560693641618497,0.9884393063583815,173,5800,3700,2100,0.6379310344827587,79,37,42,227.43726637690264,0.4852998834968858,0.766871350487248,0.13121864545789416,1045982.4684316118,7179.078659650057,1053161.547091262,249,0,100.45664739884393,67,106,42,38.501600163760905,0.5402215799614644,44.31678921568627,8181.862745098031,122.11735440444822,0
251,32,2,3,170,0.011560693641618497,0.017341040462427744,0.9826589595375722,173,5550,3800,1750,0.6846846846846847,73,38,35,223.98702847034932,0.4850366312676435,0.76388981389901,0.13011833871679102,1048100.1103451671,6802.165851131742,1054902.276196299,250,0,101.15606936416185,70,103,36,38.32533199579631,0.5422687861271676,44.05809859154929,8190.140845070403,117.00201207243433,0
252,32,0,2,168,0.0,0.011764705882352941,0.9882352941176471,170,5450,3700,1750,0.6788990825688074,72,37,35,216.6059148695213,0.4849206694512124,0.7485108601913313,0.12147325971554676,1037144.2177854999,5480.314429012724,1042624.5322145126,251,1,103.62352941176471,71,99,39,39.88450392090012,0.537561274509804,45.39930555555558,8147.22222222227,114.74960876369394,8
253,32,8,6,170,0.045454545454545456,0.03409090909090909,0.9659090909090909,176,5150,3800,1350,0.7378640776699029,65,38,27,200.26725909499444,0.4852259199134199,0.7430329540870593,0.11360698748203439,1040735.8295652742,1335.0624057984214,1042070.8919710726,252,0,100.91477272727273,80,96,42,39.851208484604015,0.5408380681818181,44.95884773662551,8161.316872427967,102.01646090534959,8
254,32,3,1,172,0.017341040462427744,0.005780346820809248,0.9942196531791907,173,5550,4100,1450,0.7387387387387387,70,41,29,197.4490681952426,0.48491900793117354,0.7348289868858613,0.11215496361301888,1041143.8829210132,964.5779079864105,1042108.4608289995,253,0,103.44508670520231,79,94,46,39.87210326170181,0.5405828516377649,44.908854166666686,8162.916666666716,103.32805907173058,8
255,32,4,3,173,0.022727272727272728,0.017045454545454544,0.9829545454545454,176,5000,3400,1600,0.68,66,34,32,189.7227301240348,0.48531926406926407,0.728065381941762,0.1087164816728288,1043873.728057491,-590.6852816354199,1043283.0427758556,254,0,102.6534090909091,71,105,46,39.728653355989806,0.5430871212121212,44.5746527777778,8173.611111111162,115.1212832550868,0
256,32,2,2,173,0.011428571428571429,0.011428571428571429,0.9885714285714285,175,5500,4000,1500,0.7272727272727273,70,40,30,184.4307270233189,0.4850465243568692,0.718526984126983,0.10640234251345386,1045971.0743801725,-1918.1588613403037,1044052.9155188323,255,0,103.56571428571428,76,99,49,39.60262345679012,0.5468452380952381,44.31818181818184,8181.818181818239,107.65550239234526,0
257,32,4,3,174,0.022598870056497175,0.01694915254237288,0.9830508474576272,177,5400,3600,1800,0.6666666666666666,72,36,36,182.44509854840982,0.4851039526622154,0.7191100653459561,0.10630467742087382,1049024.0478515672,-2522.1408420136745,1046501.9070095535,256,0,103.2090395480226,79,98,43,39.273720230528006,0.5493173258003766,43.945312500000014,8193.750000000036,103.7183544303802,0
258,32,5,4,175,0.027932960893854747,0.0223463687150838,0.9776536312849162,179,5600,4100,1500,0.7321428571428571,71,41,30,181.0882971692947,0.4848173372669638,0.7195318609536572,0.10698892367893922,1053273.3805020957,-3252.903414226091,1050020.4770878695,257,0,101.68715083798882,70,109,49,38.78099744586764,0.5526070763500931,43.427230046948324,8210.32863849758,117.290409121394,0
259,32,2,1,176,0.011299435028248588,0.005649717514124294,0.9943502824858758,177,6350,4800,1550,0.7559055118110236,79,48,31,207.35711560085497,0.4838934899845917,0.7406994148309347,0.12055776235877307,1048355.6571463005,1726.8010379395719,1050082.4581842402,258,0,103.75706214689265,78,99,39,38.71911433918853,0.5464924670433144,44.026898734177244,8191.139240506407,105.01460564751804,8
260,32,0,0,176,0.0,0.0,1.0,176,6350,4100,2250,0.6456692913385826,86,41,45,209.0998461098133,0.48354978354978356,0.7507521755230511,0.1207859111057866,1046358.5069444474,2208.680555555714,1048567.1875000031,259,1,105.3409090909091,73,103,44,38.92354039375423,0.5430871212121212,44.27083333333334,8183.333333333357,112.10045662100488,8
261,32,1,1,176,0.005649717514124294,0.005649717514124294,0.9943502824858758,177,6200,4600,1600,0.7419354838709677,78,46,32,216.7973635951407,0.48336516649546307,0.7526745415093619,0.12456707980710245,1044711.1234567962,3698.123456790414,1048409.2469135866,260,0,105.74011299435028,74,103,42,38.9324473674675,0.539665725047081,44.47222222222224,8176.888888888936,110.49849849849913,8
262,32,2,4,174,0.011235955056179775,0.02247191011235955,0.9775280898876404,178,6050,4400,1650,0.7272727272727273,77,44,33,207.3016528925616,0.4830845711927887,0.7522114402451481,0.11634276437847875,1037379.9725651607,1360.1165980797396,1038740.0891632405,261,0,106.02808988764045,71,107,37,40.09185606060607,0.5329470973782772,45.37037037037038,8148.1481481481715,114.7626499739179,8
263,32,5,2,177,0.027932960893854747,0.0111731843575419,0.9888268156424581,179,5900,4300,1600,0.7288135593220338,75,43,32,205.74764526148243,0.48347169041491433,0.7531301760197626,0.1169822325915292,1041446.4168310378,1155.0295857991423,1042601.4464168369,262,0,106.07262569832402,77,102,43,39.62259212730321,0.5371275605214152,44.87179487179489,8164.102564102609,106.02730602730661,0
264,32,2,3,176,0.0111731843575419,0.01675977653631285,0.9832402234636871,179,5850,4000,1850,0.6837606837606838,77,40,37,197.50384430103009,0.48337622664406926,0.7367713226312711,0.11158587179118606,1039469.2558736398,-590.1651864453152,1038879.0906871945,263,0,106.77094972067039,83,96,39,40.079992539975954,0.5379422718808193,45.11408730158728,8156.349206349159,98.26926754637542,8
265,32,0,2,174,0.0,0.011363636363636364,0.9886363636363636,176,6000,4400,1600,0.7333333333333333,76,44,32,189.29536165795287,0.4830262445887446,0.7235000596027481,0.10508562342813149,1033950.0277777731,-2055.61111111137,1031894.4166666617,264,1,108.39772727272727,74,102,42,40.97962082718678,0.5333806818181819,45.79166666666665,8134.66666666663,109.92792792792743,8
266,32,3,4,173,0.01694915254237288,0.022598870056497175,0.9774011299435028,177,5850,3900,1950,0.6666666666666666,78,39,39,213.57113469615055,0.4828569059236432,0.757600313919252,0.11881528840443012,1034622.9672532884,2943.1202197967496,1037566.0874730852,265,0,108.36723163841808,66,111,41,40.27803252629008,0.5316619585687382,45.70895522388061,8137.313432835841,123.29262777024002,8
267,32,6,6,173,0.0335195530726257,0.0335195530726257,0.9664804469273743,179,5450,3900,1550,0.7155963302752294,70,39,31,223.11328207165434,0.48307152721109786,0.7651252082583635,0.1263648569679369,1040236.9926867711,5168.137914138868,1045405.1306009099,266,0,106.78212290502793,72,107,40,39.33103419329564,0.5358472998137802,45.01997716894979,8159.360730593646,113.32445459157842,0
268,32,3,1,175,0.017045454545454544,0.005681818181818182,0.9943181818181818,176,5700,3600,2100,0.631578947368421,78,36,42,208.938052270466,0.48327922077922075,0.7495797836227844,0.11641635637244352,1035106.7498077666,2354.6376393694077,1037461.387447136,267,0,106.26136363636364,67,109,44,40.33516020236086,0.5293560606060606,45.64950980392157,8139.215686274513,121.48083113842557,8
269,32,5,0,180,0.027777777777777776,0.0,1.0,180,6100,4400,1700,0.7213114754098361,78,44,34,205.24811675244797,0.4838784140285537,0.7490709107315106,0.11564232012038347,1038607.6219480389,534.4516899146415,1039142.0736379536,268,0,104.86666666666666,72,108,48,39.99043218519557,0.5325810185185185,45.21974885844748,8152.968036529663,113.23566717402309,0
270,32,2,1,181,0.01098901098901099,0.005494505494505495,0.9945054945054945,182,4900,3600,1300,0.7346938775510204,62,36,26,231.8588075229428,0.4838478740412442,0.7827943846758632,0.12911709644880667,1034935.3196885883,6691.773817274457,1041627.0935058628,269,0,104.7032967032967,63,119,37,39.77372114851314,0.5282738095238095,45.67057291666668,8138.541666666692,129.18320105820146,8
271,32,1,2,180,0.005494505494505495,0.01098901098901099,0.989010989010989,182,5350,2800,2550,0.5233644859813084,79,28,51,230.22475145763661,0.4836714275595491,0.7821790397967672,0.12894534386999693,1036741.6831032254,5986.719263642548,1042728.402366868,270,0,105.6923076923077,64,118,38,39.588317384369994,0.5299336080586081,45.44871794871796,8145.641025641056,127.2756410256415,0
272,32,4,6,178,0.021739130434782608,0.03260869565217391,0.967391304347826,184,5050,3800,1250,0.7524752475247525,63,38,25,220.027212092651,0.48400810267680366,0.7734728135310338,0.12418185781798949,1039143.8576454597,3877.985192186973,1043021.8428376467,271,0,104.93478260869566,68,116,37,39.54667969907,0.5324388586956521,45.153985507246404,8155.072463768172,119.92753623188489,0
273,32,5,1,182,0.0273224043715847,0.00546448087431694,0.994535519125683,183,5450,3500,1950,0.6422018348623854,74,35,39,218.31020651928776,0.4835114794131188,0.7715531505209872,0.12491106430466231,1043409.8660420766,3507.404667981581,1046917.2707100582,272,0,105.81967213114754,64,119,39,39.056453299864046,0.5362591074681239,44.631410256410255,8171.794871794864,127.68429487179475,0
274,32,2,2,182,0.010869565217391304,0.010869565217391304,0.9891304347826086,184,5800,4200,1600,0.7241379310344828,74,42,32,220.1341909244594,0.48384290607428526,0.7737230816920344,0.1270051773494693,1045982.4684316117,3451.300881872297,1049433.769313484,273,0,106.02173913043478,67,117,43,38.68832754178899,0.5387228260869565,44.31678921568627,8181.86274509803,122.11735440444821,0
275,32,2,2,182,0.010869565217391304,0.010869565217391304,0.9891304347826086,184,5450,3700,1750,0.6788990825688074,72,37,35,218.39466014236345,0.48405141264750134,0.7731612059299859,0.12711763907552492,1048700.9990301733,3556.139654830293,1052257.1386850036,274,0,106.80978260869566,70,114,40,38.39350525310411,0.5413836050724637,43.98474178403755,8192.488262910787,117.03554661301125,0
276,32,2,3,181,0.010869565217391304,0.016304347826086956,0.9836956521739131,184,6150,4400,1750,0.7154471544715447,79,44,35,215.9987619405049,0.48430941633008634,0.7716351772232402,0.12694886824115298,1051676.545036156,2482.1663379352813,1054158.7113740912,275,0,107.65217391304348,64,120,40,38.08405738217276,0.544044384057971,43.621794871794854,8204.10256410253,128.18910256410203,0
277,32,0,4,177,0.0,0.022099447513812154,0.9779005524861879,181,5800,3800,2000,0.6551724137931034,78,38,40,217.74805688110473,0.4839484857785963,0.7701970837785532,0.12852916277849283,1052991.7159763323,3857.380013149354,1056849.0959894818,276,1,109.77900552486187,64,117,42,37.87546331001167,0.5459829650092081,43.46153846153847,8209.230769230777,128.2692307692309,0
278,32,0,2,175,0.0,0.011299435028248588,0.9887005649717514,177,5800,3900,1900,0.6724137931034483,77,39,38,224.7087604828814,0.48294919534326314,0.7726583963365312,0.13278867270271683,1053338.389882699,6138.872791914913,1059477.2626746139,277,2,113.10734463276836,62,115,42,37.65371933668428,0.5470221280602636,43.41931216931216,8210.582010581986,132.42874210616105,0
279,32,1,0,176,0.005681818181818182,0.0,1.0,176,6050,4500,1550,0.743801652892562,76,45,31,235.84075797744475,0.48248579545454545,0.7787745285083403,0.13611885001754878,1046100.2105971366,8092.613317518854,1054192.8239146555,278,0,114.5,65,111,41,38.27200738637533,0.5404237689393939,44.302398989899004,8182.323232323262,125.88189588189634,8
280,32,4,6,174,0.022222222222222223,0.03333333333333333,0.9666666666666667,180,5150,3900,1250,0.7572815533980582,64,39,25,230.35670908927975,0.4827093678874405,0.777628290811879,0.13422783248558215,1049039.2892573709,7180.647675737064,1056219.936933108,279,0,112.93333333333334,69,111,38,38.04501801592378,0.5429976851851852,43.94345238095239,8193.809523809534,118.75086266390629,0
281,32,0,3,171,0.0,0.017241379310344827,0.9827586206896551,174,5700,4300,1400,0.7543859649122807,71,43,28,250.93508261169688,0.48215926959448985,0.7847598576843704,0.14229762841756977,1040621.7509451819,11725.701008191692,1052347.4519533736,280,1,116.47126436781609,68,106,38,38.573299591546814,0.5342432950191571,44.97282608695653,8160.86956521741,120.01278772378544,8
282,32,3,4,170,0.017241379310344827,0.022988505747126436,0.9770114942528736,174,4800,3400,1400,0.7083333333333334,62,34,28,237.01836144713445,0.48262919961021417,0.7784630289159842,0.13364621777327632,1038850.5773020047,9645.33232410643,1048495.9096261112,281,0,116.46551724137932,67,107,35,39.15048495050298,0.5304717432950192,45.189950980392176,8153.921568627495,121.70032191981335,8
283,32,2,1,171,0.011627906976744186,0.005813953488372093,0.9941860465116279,172,6000,4400,1600,0.7333333333333333,76,44,32,231.21993180629963,0.48220680901219454,0.7712067120525761,0.13179969921461626,1042237.9077422329,7797.235590820315,1050035.1433330532,282,0,117.86046511627907,61,111,38,38.873551774076766,0.5343992248062015,44.774865591397884,8167.204301075335,133.88859509959565,0
284,32,1,1,171,0.005813953488372093,0.005813953488372093,0.9941860465116279,172,6350,4900,1450,0.7716535433070866,78,49,29,234.63422653888858,0.48214518450519067,0.7762847685738159,0.13074735519254563,1035139.4534399351,7825.829003553432,1042965.2824434886,283,0,117.3546511627907,60,112,42,39.67746447353699,0.5223473837209303,45.64549180327869,8139.344262295079,135.65573770491798,8
285,32,3,1,173,0.017241379310344827,0.005747126436781609,0.9942528735632183,174,5850,4400,1450,0.7521367521367521,73,44,29,246.87592716632045,0.4826631120855757,0.7789763408301635,0.13618299232788358,1031941.2071017603,10302.288456875576,1042243.4955586359,284,0,116.72988505747126,70,104,36,39.769040053918715,0.5226293103448276,46.03873239436618,8126.7605633802405,116.09657947686058,8
286,32,7,2,178,0.03888888888888889,0.011111111111111112,0.9888888888888889,180,6600,4400,2200,0.6666666666666666,88,44,44,210.15703252556762,0.4836436995654873,0.7531597163013077,0.11763578343055371,1036554.9480506235,967.8623864025303,1037522.8104370261,285,0,113.7388888888889,71,109,36,40.12255110934275,0.5288194444444445,45.47164351851851,8144.907407407389,114.71700573813223,7
287,32,3,3,178,0.016574585635359115,0.016574585635359115,0.9834254143646409,181,5900,4000,1900,0.6779661016949152,78,40,38,208.16729603827008,0.48333205443012073,0.7519366926886377,0.11739079105560012,1038884.3361943016,1152.3486324161508,1040036.6848267177,286,0,114.01657458563535,73,108,36,39.88141273524102,0.5313651012891345,45.18581081081081,8154.054054054048,111.6993706034801,0
288,32,2,4,176,0.011111111111111112,0.022222222222222223,0.9777777777777777,180,5350,3500,1850,0.6542056074766355,72,35,37,232.52315770108564,0.48319172873991306,0.7761206611662839,0.1321272380210951,1041260.6717514254,7073.443877118922,1048334.1156285442,287,0,115.61666666666666,80,100,34,38.96275478482971,0.5348958333333333,44.89454732510288,8163.374485596697,102.04218106995872,8
289,32,1,2,175,0.005649717514124294,0.011299435028248588,0.9887005649717514,177,6200,4400,1800,0.7096774193548387,80,44,36,232.74567120303473,0.4829585580380072,0.7746065060557852,0.13303857502099414,1043101.751730105,6955.483467896957,1050057.235198002,288,0,117.4180790960452,67,110,32,38.72640188784897,0.5377824858757062,44.669117647058826,8170.588235294128,121.94907813871833,0
290,32,1,5,171,0.005681818181818182,0.028409090909090908,0.9715909090909091,176,6500,4800,1700,0.7384615384615385,82,48,34,235.5779638885749,0.4824337121212121,0.7665813620451891,0.13370219539901237,1040885.7709750565,7341.950113378666,1048227.7210884352,289,0,119.04545454545455,76,100,34,38.931835861532456,0.5340909090909092,44.94047619047619,8161.904761904761,107.39348370927317,8
291,32,3,2,172,0.017241379310344827,0.011494252873563218,0.9885057471264368,174,5400,4000,1400,0.7407407407407407,68,40,28,231.55317008950377,0.4828126038137001,0.7677585810020471,0.13215372434094247,1042624.2644641681,8084.590729783045,1050708.8551939512,290,0,119.3103448275862,64,110,36,38.816649925712,0.5397509578544062,44.7275641025641,8168.7179487179465,127.63621794871791,8
292,32,2,1,173,0.011494252873563218,0.005747126436781609,0.9942528735632183,174,5700,4300,1400,0.7543859649122807,71,43,28,222.30820449240386,0.48276138905499083,0.7575274703471175,0.1280718508371798,1045529.9191154463,5985.975812328858,1051515.894927775,291,0,117.2816091954023,71,103,39,38.68928867885375,0.5421455938697318,44.3721064814815,8180.092592592637,115.21257172665686,0
293,32,2,2,173,0.011428571428571429,0.011428571428571429,0.9885714285714285,175,5650,3800,1850,0.672566371681416,75,38,37,225.7437279719268,0.4826135741652983,0.7603404406941614,0.12867027803401518,1042218.8497995996,6404.873703275227,1048623.7235028748,292,0,117.48,71,104,35,39.01570441962854,0.5401785714285714,44.77719907407408,8167.12962962965,115.02999478351619,8
294,32,2,1,174,0.011428571428571429,0.005714285714285714,0.9942857142857143,175,6450,5100,1350,0.7906976744186046,78,51,27,223.30253339439136,0.4826573617952928,0.7650330094567632,0.12598497191572108,1039031.0061942735,4953.65119170097,1043984.6573859744,293,0,118.39428571428572,71,104,33,39.47735702660763,0.5325,45.167824074074076,8154.629629629633,114.85393844548778,8
295,32,3,2,175,0.01694915254237288,0.011299435028248588,0.9887005649717514,177,5650,3700,1950,0.6548672566371682,76,37,39,220.4322531283418,0.48261615091593907,0.7654505328021082,0.12541463399257988,1041653.0086180373,4872.783933518034,1046525.7925515553,294,0,117.46327683615819,75,102,37,39.222084944850316,0.5353107344632768,44.84649122807018,8164.912280701763,108.8654970760235,0
296,32,3,5,173,0.016853932584269662,0.028089887640449437,0.9719101123595506,178,6250,4600,1650,0.736,79,46,33,217.90806167621943,0.4826540976321971,0.7644449239042035,0.12514740223515491,1044567.9340533043,3673.954759737743,1048241.888813042,295,0,117.74157303370787,68,110,39,38.921959625800085,0.5376872659176031,44.48973429951691,8176.328502415465,120.24012503552154,0
297,32,4,4,173,0.022598870056497175,0.022598870056497175,0.9774011299435028,177,5050,3300,1750,0.6534653465346535,68,33,35,250.439307824007,0.48264691405581234,0.7889771793165525,0.14168068982325016,1039882.673020377,11635.499369880441,1051518.1723902575,296,0,118.00564971751412,68,109,34,38.67879137798307,0.5327212806026365,45.06340579710146,8157.971014492779,119.97016197783499,8
298,32,1,2,172,0.005747126436781609,0.011494252873563218,0.9885057471264368,174,7050,4800,2250,0.6808510638297872,93,48,45,246.4116304253064,0.48172809669346445,0.7821101523755134,0.14023531009021423,1041741.2770834758,9489.433313496249,1051230.710396972,297,0,120.29310344827586,70,104,38,38.54813515792706,0.5349018199233717,44.835680751173726,8165.258215962479,116.64654594232113,0
299,32,5,2,175,0.02824858757062147,0.011299435028248588,0.9887005649717514,177,5000,3300,1700,0.66,67,33,34,229.61483021979979,0.4825679999143982,0.7756933590446222,0.13296004385127105,1047110.7867166478,7686.433102652894,1054797.2198193006,298,0,117.42937853107344,67,110,44,38.30489021956085,0.5404896421845574,44.17892156862745,8186.274509803925,122.18320163886455,8
300,32,3,3,175,0.016853932584269662,0.016853932584269662,0.9831460674157303,178,5100,3400,1700,0.6666666666666666,68,34,34,210.41002091923588,0.48312556867474976,0.7481464060134946,0.12174430899370381,1046870.0277777852,3354.38888888931,1050224.4166666744,299,0,116.92696629213484,74,104,42,38.826220339903365,0.5431296816479401,44.20833333333336,8185.333333333392,110.6126126126134,8
301,32,2,6,171,0.011299435028248588,0.03389830508474576,0.9661016949152542,177,5750,3900,1850,0.6782608695652174,76,39,37,218.38788075072802,0.483032122068139,0.752702271582895,0.12434935833116886,1041898.1579900382,4357.586136305882,1046255.7441263441,300,0,117.03389830508475,83,94,35,39.24356918391806,0.5410193032015066,44.816468253968225,8165.873015872939,98.38401223943299,7
302,32,2,3,170,0.011560693641618497,0.017341040462427744,0.9826589595375722,173,4200,2500,1700,0.5952380952380952,59,25,34,233.87119619432278,0.4822948873056414,0.7728849932987449,0.13152916073968704,1038036.1268641036,9753.350136525914,1047789.4770006295,301,0,119.91329479768787,68,105,43,39.33291844476057,0.5353444123314066,45.289855072463766,8150.7246376811545,119.86359761295816,8
303,32,3,1,172,0.017341040462427744,0.005780346820809248,0.9942196531791907,173,5900,4500,1400,0.7627118644067796,73,45,28,231.64988649634864,0.4821618609132052,0.7730174625822603,0.13183842362596135,1041751.1233085212,7764.30589437254,1049515.4292028937,302,0,119.90751445086705,72,101,39,38.92356839279723,0.5384152215799615,44.83447488584475,8165.2968036529655,113.40690005073563,0
304,32,2,1,173,0.011494252873563218,0.005747126436781609,0.9942528735632183,174,5800,4000,1800,0.6896551724137931,76,40,36,225.43701039890996,0.4818678991429141,0.7668897314499004,0.1294253603453299,1044457.7950361572,6491.888560157628,1050949.6835963149,303,0,120.1896551724138,64,110,41,38.74336176796507,0.5411278735632183,44.50320512820512,8175.89743589741,127.74839743589703,0
305,32,3,1,175,0.017045454545454544,0.005681818181818182,0.9943181818181818,176,5950,4500,1450,0.7563025210084033,74,45,29,232.551889389087,0.48219291125541125,0.7750148892134736,0.13053087249004075,1037420.9761312974,7100.841618240804,1044521.8177495382,304,0,119.69886363636364,68,108,37,39.44376099286578,0.5304214015151515,45.365338164251206,8148.309178743954,119.82807615799933,8
306,32,4,2,177,0.0223463687150838,0.0111731843575419,0.9888268156424581,179,6350,3900,2450,0.6141732283464567,88,39,49,223.5018527186437,0.48229081664678924,0.7711668942325214,0.12697366312661063,1041193.4845678995,4391.734567901101,1045585.2191358006,305,0,118.66480446927375,74,105,37,39.20130759877316,0.5341014897579144,44.90277777777777,8163.111111111098,110.31231231231213,0
307,32,2,7,172,0.0111731843575419,0.03910614525139665,0.9608938547486033,179,6100,4600,1500,0.7540983606557377,76,46,30,226.40566430653803,0.48248828280292094,0.7730019382054489,0.12899857617465604,1042100.69444445,5287.500000000304,1047388.1944444503,306,0,119.25139664804469,73,106,43,39.01360544217691,0.5350325884543762,44.791666666666686,8166.666666666711,111.87214611872206,8
308,32,4,1,175,0.022727272727272728,0.005681818181818182,0.9943181818181818,176,5900,4000,1900,0.6779661016949152,78,40,38,204.43814704808793,0.48220576298701295,0.7459497674577846,0.11519553547974822,1038633.6450879081,1367.267572714527,1040000.9126606226,307,0,118.36931818181819,75,101,43,40.00781151935734,0.5327296401515151,45.21655701754385,8153.070175438568,108.70760233918091,8
309,32,5,3,177,0.027777777777777776,0.016666666666666666,0.9833333333333333,180,5750,4400,1350,0.7652173913043478,71,44,27,251.76312626211356,0.4824203393337472,0.7937785990848287,0.14107673406522003,1036893.2824604016,10460.298878483154,1047353.5813388848,308,0,116.7,61,119,38,39.020976328757506,0.5269675925925925,45.43010752688173,8146.2365591397975,133.5448616252426,8
310,32,3,3,177,0.016666666666666666,0.016666666666666666,0.9833333333333333,180,5400,3900,1500,0.7222222222222222,69,39,30,241.38459310932882,0.48294343575418996,0.7847291877351934,0.13645791261143764,1039653.1643773606,8791.25121161111,1048444.4155889717,309,0,116.87222222222222,65,115,34,38.938442924070735,0.5299189814814815,45.09154040404041,8157.070707070717,125.49339549339564,0
311,32,4,3,178,0.022099447513812154,0.016574585635359115,0.9834254143646409,181,6100,4100,2000,0.6721311475409836,81,41,40,243.8334200729278,0.48255448127685696,0.7855410125178759,0.13683941131085148,1037366.5001417217,8288.92431972782,1045655.4244614495,310,0,116.3646408839779,69,112,37,39.163342781446644,0.525725138121547,45.3720238095238,8148.095238095225,118.08833678398877,8
312,32,3,5,176,0.016574585635359115,0.027624309392265192,0.9723756906077348,181,6500,4300,2200,0.6615384615384615,87,43,44,243.56715431257723,0.4821362799263352,0.7851573828169687,0.13800079415237004,1040353.42517879,7979.184650028061,1048332.609828818,311,0,117.07182320441989,72,109,33,38.79488434993468,0.5284300184162063,45.00570776255707,8159.817351598165,113.33079654997452,0
313,32,2,1,177,0.011235955056179775,0.0056179775280898875,0.9943820224719101,178,5550,3900,1650,0.7027027027027027,72,39,33,246.7470108075105,0.4820702141391058,0.7876892531916533,0.14089894134611583,1042786.8512617126,10310.90769164107,1053097.7589533536,312,0,119.17415730337079,61,117,35,38.40839914445541,0.5302551498127341,44.707661290322605,8169.354838709726,133.92384981491355,0
314,32,5,9,173,0.027472527472527472,0.04945054945054945,0.9505494505494505,182,5750,4300,1450,0.7478260869565218,72,43,29,251.17324343975042,0.48280057879505395,0.791164120432412,0.1471157568718544,1050625.0000000044,10627.777777778003,1061252.7777777824,313,0,117.39010989010988,72,110,36,37.31368563685638,0.5384615384615384,43.750000000000014,8200.000000000035,113.88888888888937,8
315,32,1,0,174,0.005747126436781609,0.0,1.0,174,4900,3100,1800,0.6326530612244898,67,31,36,234.54078103210423,0.4814837884525945,0.7728126278959655,0.13564222558478464,1046723.8662131495,9399.886621315069,1056123.7528344647,314,0,123.316091954023,69,105,37,38.22725157086337,0.540948275862069,44.22619047619047,8184.761904761886,118.61973775017226,8
316,32,1,1,174,0.005714285714285714,0.005714285714285714,0.9942857142857143,175,5850,3900,1950,0.6666666666666666,78,39,39,217.85347768674265,0.481451833607006,0.7628817366496705,0.1256225910711175,1045818.3037977451,4717.0309021577405,1050535.334699903,315,0,123.60571428571428,70,105,38,38.76714392287388,0.5411309523809524,44.33685446009389,8181.220657276977,116.87458081824253,8
317,32,2,2,174,0.011363636363636364,0.011363636363636364,0.9886363636363636,176,5600,3600,2000,0.6428571428571429,76,36,40,207.90166080681547,0.4815909090909091,0.743159958254592,0.1177622236872343,1040270.890081713,2454.8091473942613,1042725.6992291072,316,0,123.7215909090909,78,98,39,39.71465939256041,0.5398910984848485,45.01582278481011,8159.493670886038,104.60889321648766,8
318,32,1,5,170,0.005714285714285714,0.02857142857142857,0.9714285714285714,175,6000,4100,1900,0.6833333333333333,79,41,38,213.3102195307666,0.48139162561576354,0.7546601734094531,0.12019290306201494,1038628.9233838111,3310.0327316009966,1041938.9561154122,317,0,125.31428571428572,70,105,46,39.78235728818763,0.534702380952381,45.21713615023475,8153.051643192511,116.47216633132159,8
319,32,0,0,170,0.0,0.0,1.0,170,6250,4700,1550,0.752,78,47,31,227.15322792587185,0.48108321731059284,0.7649043396650674,0.1257388199107605,1033038.742923663,6681.617005518818,1039720.3599291819,318,1,128.19411764705882,73,97,37,40.131837109670734,0.5294730392156863,45.9037162162162,8131.08108108105,111.38467234357603,8
320,32,6,1,175,0.03409090909090909,0.005681818181818182,0.9943181818181818,176,6050,4700,1350,0.7768595041322314,74,47,27,225.73177365177045,0.48177895021645023,0.7704085527098847,0.1251319049460603,1033493.4447070039,5408.461666237921,1038901.9063732418,319,0,124.78977272727273,71,105,42,40.11077825847705,0.5281723484848485,45.847800925925924,8132.870370370366,114.54747000521643,8
321,32,2,1,176,0.011299435028248588,0.005649717514124294,0.9943502824858758,177,6600,4800,1800,0.7272727272727273,84,48,36,223.20848277391255,0.48181630927923297,0.7644532687266614,0.12127251428923806,1027113.705249828,3852.0983570210374,1030965.803606849,320,0,125.0225988700565,68,109,38,40.97809787681979,0.5220103578154426,46.63345410628018,8107.729468599011,119.23131571469133,8
322,32,1,3,174,0.005649717514124294,0.01694915254237288,0.9830508474576272,177,6450,4700,1750,0.7286821705426356,82,47,35,227.9681389729482,0.4820303137305256,0.7740584339762919,0.1244621081721872,1028664.0532544377,5050.5259697567635,1033714.5792241945,321,0,125.7231638418079,64,113,35,40.66200016854172,0.5195386064030132,46.44230769230769,8113.846153846152,126.77884615384613,8
323,32,5,3,176,0.027932960893854747,0.01675977653631285,0.9832402234636871,179,5550,3800,1750,0.6846846846846847,73,38,35,218.0756802170375,0.4828335216454292,0.7655273015381732,0.12026937963503588,1031870.9765486518,3655.1930214131244,1035526.169570065,322,0,125.24022346368714,72,107,36,40.5092852727988,0.523102886405959,46.04737442922374,8126.484018264822,112.86783358701142,0
324,32,5,2,179,0.027624309392265192,0.011049723756906077,0.988950276243094,181,5450,3900,1550,0.7155963302752294,70,39,31,213.01168911534677,0.4825966850828729,0.7628971152822972,0.11845651735741262,1034496.458163167,2421.967587436099,1036918.4257506031,323,0,124.81767955801105,66,115,41,40.30813716498518,0.5258977900552486,45.7245024875622,8136.815920398032,123.2850897030005,0
325,32,5,1,183,0.02717391304347826,0.005434782608695652,0.9945652173913043,184,6200,4500,1700,0.7258064516129032,79,45,34,208.34373496475405,0.4833064811515007,0.7617984232819544,0.1173364792894839,1038474.2253086442,271.9197530866022,1038746.1450617309,324,0,122.77173913043478,74,110,44,39.92826509658546,0.5300611413043479,45.23611111111112,8152.4444444444625,110.1681681681684,0
326,32,0,1,182,0.0,0.00546448087431694,0.994535519125683,183,5850,4200,1650,0.717948717948718,75,42,33,209.92640249201432,0.4830998919113673,0.7617835561776687,0.1187757861165546,1039920.5680655993,1211.3567462926198,1041131.924811892,325,1,124.4153005464481,77,106,36,39.706870962109306,0.5319330601092895,45.05876068376068,8158.119658119652,105.94960594960587,0
327,32,4,1,185,0.021505376344086023,0.005376344086021506,0.9946236559139785,186,6800,5300,1500,0.7794117647058824,83,53,30,202.41566014160728,0.4836445316284026,0.7582400702216361,0.11532985287138107,1042100.6944444461,-1812.4999999999154,1040288.1944444462,326,0,123.38172043010752,82,104,42,39.62585034013603,0.5348342293906809,44.79166666666667,8166.666666666681,99.59349593495952,0
328,32,2,8,179,0.0106951871657754,0.0427807486631016,0.9572192513368984,187,5750,3500,2250,0.6086956521739131,80,35,45,208.30558216758988,0.48326720717612554,0.7664071753356076,0.12037200435180626,1046473.7034331673,447.2628033441124,1046920.9662365114,327,0,122.33155080213903,73,114,41,38.929482239835636,0.5381016042780749,44.25675675675677,8183.783783783819,112.1066271751208,0
329,32,3,3,179,0.016483516483516484,0.016483516483516484,0.9835164835164835,182,5800,3500,2300,0.603448275862069,81,35,46,216.55075238827345,0.48245274522898834,0.7705967966299894,0.12627333246473693,1049258.7777777768,3243.5555555555543,1052502.3333333323,328,0,124.97802197802197,74,108,39,38.37116281592363,0.5406364468864469,43.916666666666664,8194.66666666666,110.73873873873866,0
330,32,1,0,180,0.005555555555555556,0.0,1.0,180,6850,5200,1650,0.7591240875912408,85,52,33,215.46057352629524,0.4823724912062901,0.7673599650177032,0.12675003268608084,1051960.0592719154,2481.183539496345,1054441.2428114116,329,0,126.27777777777777,63,117,41,38.06255554144979,0.5436342592592592,43.58723958333332,8205.208333333308,130.24140211640173,0
331,32,1,1,180,0.0055248618784530384,0.0055248618784530384,0.994475138121547,181,5850,4500,1350,0.7692307692307693,72,45,27,212.90559769066328,0.48242275424595865,0.765211718415526,0.12597689295670242,1053733.3562901735,2819.146005509542,1056552.5022956831,330,0,126.57458563535911,65,116,43,37.907441574415735,0.5454074585635359,43.37121212121212,8212.121212121205,126.34032634032623,0
332,32,1,3,178,0.0055248618784530384,0.016574585635359115,0.9834254143646409,181,6350,4900,1450,0.7716535433070866,78,49,29,214.98640238878437,0.48223987108655614,0.7644996527666419,0.12512928181978103,1048689.7808641985,2540.808641975345,1051230.5895061737,331,0,127.04972375690608,74,107,36,38.48216061773267,0.5440837937384899,43.986111111111114,8192.44444444445,110.7087087087088,8
333,32,2,0,180,0.011111111111111112,0.0,1.0,180,6250,4100,2150,0.656,84,41,43,228.00900144706057,0.48214036312849157,0.7745222894265236,0.12969319348364897,1041575.6405696947,5247.724347575646,1046823.3649172704,332,0,127.15,80,100,40,39.0384534610215,0.5382523148148148,44.855967078189295,8164.6090534979285,102.0576131687241,8
334,32,2,6,176,0.01098901098901099,0.03296703296703297,0.967032967032967,182,5450,4200,1250,0.7706422018348624,67,42,25,221.46293206531092,0.48248563131159816,0.7711378331431096,0.1269984819505205,1044103.2896001575,4396.035178777605,1048499.3247789352,333,0,126.74175824175825,67,115,38,38.889222035660026,0.5402930402930404,44.546568627450995,8174.509803921598,122.0076090137552,0
335,32,3,4,175,0.01675977653631285,0.0223463687150838,0.9776536312849162,179,5700,4100,1600,0.7192982456140351,73,41,32,222.2871039767011,0.48256413073044174,0.7648993915293996,0.12670524044140807,1042231.5746219597,4834.927679158511,1047066.5023011182,334,0,127.28491620111731,64,115,44,39.10233266356904,0.5386987895716946,44.77564102564103,8167.179487179491,127.61217948717955,8
336,32,1,1,175,0.005681818181818182,0.005681818181818182,0.9943181818181818,176,5050,3400,1650,0.6732673267326733,67,34,33,219.32518046762067,0.48216653138528137,0.758925261792234,0.12582339300510884,1044228.5156250016,5555.121527777879,1049783.6371527796,335,0,129.04545454545453,67,109,42,38.928177030241265,0.5419625946969697,44.53125000000001,8175.000000000013,122.01492537313452,0
337,32,4,4,175,0.0223463687150838,0.0223463687150838,0.9776536312849162,179,5300,3600,1700,0.6792452830188679,70,36,34,213.498460598305,0.4823274328876614,0.7564989941142586,0.12363050392785627,1047117.6580972088,3611.60161381149,1050729.2597110204,336,0,127.75977653631286,72,107,46,38.716323627844694,0.5446345437616387,44.17808219178084,8186.301369863052,113.69863013698684,0
338,32,3,4,174,0.016853932584269662,0.02247191011235955,0.9775280898876404,178,6600,5100,1500,0.7727272727272727,81,51,30,209.9632917517468,0.4824973814511522,0.7500870246933695,0.12266345606590809,1049838.4148247547,1885.505876808339,1051723.9207015631,337,0,129.2134831460674,75,103,43,38.46764808175932,0.5474602059925093,43.845942982456144,8196.929824561412,109.29239766081882,0
339,32,2,1,175,0.011363636363636364,0.005681818181818182,0.9943181818181818,176,6900,5100,1800,0.7391304347826086,87,51,36,207.00612772159266,0.48211174242424243,0.7452311035535744,0.12180349855555508,1052027.8311489758,1455.2415162987418,1053483.0726652746,338,0,128.0909090909091,66,110,44,38.27090785990016,0.5503077651515151,43.578980099502466,8205.472636815875,124.32534298205871,0
340,32,4,1,178,0.0223463687150838,0.00558659217877095,0.994413407821229,179,5750,4000,1750,0.6956521739130435,75,40,35,201.720868084684,0.4819965789969242,0.7436321019680743,0.119936211785132,1055201.5693535162,1021.2353148621164,1056222.8046683783,339,0,126.89944134078212,70,109,49,38.01214484308346,0.5532472067039106,43.19248826291077,8217.840375586798,117.39771965123998,0
341,32,1,5,174,0.00558659217877095,0.027932960893854747,0.9720670391061452,179,5600,4200,1400,0.75,70,42,28,199.74994822623412,0.48154018370891133,0.7412852791884486,0.11922099163771203,1056366.2695992494,801.8215320776922,1057168.091131327,340,0,127.86033519553072,72,107,41,37.9182401288388,0.5544692737430168,43.05079908675796,8222.374429223677,114.19964485032885,0
342,32,3,4,173,0.01694915254237288,0.022598870056497175,0.9774011299435028,177,5600,3900,1700,0.6964285714285714,73,39,34,201.7850646435335,0.4810204802259887,0.7391711713031477,0.12096648693915373,1057697.9753086343,1685.5308641970778,1059383.5061728314,341,0,130.10734463276836,74,103,45,37.70077067127628,0.5562029190207156,42.888888888888864,8227.555555555495,111.18318318318236,0
343,32,1,2,172,0.005747126436781609,0.011494252873563218,0.9885057471264368,174,4950,3500,1450,0.7070707070707071,64,35,29,202.56601426182485,0.48057368834850395,0.7383509380661413,0.11910033194556445,1051795.4171097293,2861.601092554,1054657.0182022832,342,0,132.3505747126437,72,102,43,38.41366132383496,0.5528615900383143,43.60730593607304,8204.566210045616,113.95230847285578,7
344,32,1,2,171,0.005780346820809248,0.011560693641618497,0.9884393063583815,173,5400,3800,1600,0.7037037037037037,70,38,32,202.22687512693076,0.4802910897522068,0.7427830612183561,0.11753606684446916,1048253.6544067163,2397.012174210935,1050650.6665809273,343,0,133.7514450867052,71,102,41,38.86313964880547,0.5453998073217726,44.03935185185183,8190.7407407407,115.36254564423521,8
345,32,1,2,170,0.005813953488372093,0.011627906976744186,0.9883720930232558,172,5300,4000,1300,0.7547169811320755,66,40,26,203.4034536891679,0.48003365973072215,0.7424738052645024,0.11895703268453901,1050163.3390146901,3021.370018667293,1053184.7090333574,344,0,135.22093023255815,73,99,42,38.59523809523807,0.5479651162790697,43.806306306306304,8198.198198198195,112.3040849068246,0
346,32,2,1,171,0.011627906976744186,0.005813953488372093,0.9941860465116279,172,5650,4300,1350,0.7610619469026548,70,43,27,210.5636007535813,0.48028086608640463,0.7517119134117531,0.12104141928915411,1044854.7583861997,3951.6760380623964,1048806.434424262,345,0,136.0639534883721,67,105,39,39.07380210206609,0.5425750968992248,44.454656862745104,8177.450980392174,122.05150717003244,8
347,32,4,3,172,0.022857142857142857,0.017142857142857144,0.9828571428571429,175,6350,4400,1950,0.6929133858267716,83,44,39,218.95099852976278,0.48029009304871373,0.7629427527405606,0.12500609860426673,1042735.6377317411,4311.601816786822,1047047.2395485279,346,0,134.66857142857143,66,109,41,39.12441636215999,0.54,44.713930348258714,8169.154228855736,123.77506407357176,7
348,32,2,3,171,0.011494252873563218,0.017241379310344827,0.9827586206896551,174,6250,4400,1850,0.704,81,44,37,279.3364143777459,0.4800836876840963,0.8000154980340994,0.15707278291761964,1037984.2164781383,16939.357842339516,1054923.574320478,347,0,133.55172413793105,63,111,34,38.18142000553816,0.5311901340996168,45.29622395833334,8150.520833333353,129.37334656084687,8
349,32,6,0,177,0.03389830508474576,0.0,1.0,177,5500,3900,1600,0.7090909090909091,71,39,32,217.3474872346141,0.48080112566341376,0.7579420209317398,0.1205290611028316,1033611.111111112,4030.555555555622,1037641.6666666677,348,0,131.27683615819208,63,114,42,40.30908469945354,0.528189736346516,45.833333333333336,8133.333333333341,129.10052910052923,8
350,32,2,1,178,0.0111731843575419,0.00558659217877095,0.994413407821229,179,6100,4100,2000,0.6721311475409836,81,41,40,212.7976024740031,0.48077778126503884,0.7549811089224001,0.11875479105807271,1035605.5363321799,2174.8750480584413,1037780.4113802384,349,0,130.79888268156424,67,112,43,40.174413937058446,0.5307262569832403,45.588235294117645,8141.176470588235,121.5100965759438,0
351,32,2,2,178,0.011111111111111112,0.011111111111111112,0.9888888888888889,180,6100,4400,1700,0.7213114754098361,78,44,34,211.1933785629465,0.4808051417339127,0.7556594462625315,0.11856762119321342,1037487.7551020422,1722.108843537484,1039209.8639455797,350,0,131.0388888888889,69,111,42,39.97925432445067,0.5325231481481482,45.35714285714286,8148.571428571439,118.09523809523826,0
352,32,4,4,178,0.02197802197802198,0.02197802197802198,0.978021978021978,182,6200,4400,1800,0.7096774193548387,80,44,36,213.98817522171387,0.48113097767793905,0.7623851558277772,0.11866616989567806,1033611.1111111147,1636.1111111112368,1035247.222222226,351,0,129.12637362637363,87,95,44,40.39446721311473,0.5306776556776557,45.83333333333334,8133.333333333362,93.4865900383145,8
353,32,7,3,182,0.03783783783783784,0.016216216216216217,0.9837837837837837,185,6050,4300,1750,0.7107438016528925,78,43,35,200.81919315151939,0.48171513905209556,0.7530907129811584,0.11467782268349397,1042800.0126404894,-1167.1485686281276,1041632.8640718613,352,0,125.97297297297297,72,113,40,39.57925772734892,0.5414977477477477,44.70605022831054,8169.406392694149,113.46397767630762,7
354,32,1,2,181,0.00546448087431694,0.01092896174863388,0.9890710382513661,183,6750,5100,1650,0.7555555555555555,84,51,33,205.72424385633246,0.4814272703616966,0.757246376811594,0.1182914402173914,1044938.2716049398,-356.17283950611545,1044582.0987654338,353,0,128.10382513661202,74,109,39,39.1870471014493,0.543886612021858,44.44444444444445,8177.77777777779,110.51051051051067,0
355,32,2,3,180,0.01092896174863388,0.01639344262295082,0.9836065573770492,183,6250,4500,1750,0.72,80,45,35,207.36731819788355,0.4814960767829621,0.7636024969302031,0.11757832204418114,1040586.3097099768,306.7184795981866,1040893.028189575,354,0,129.0601092896175,72,111,42,39.68882889435987,0.5368283242258651,44.9771689497717,8160.730593607339,113.3434804667686,8
356,32,2,6,176,0.01098901098901099,0.03296703296703297,0.967032967032967,182,5950,4100,1850,0.6890756302521008,78,41,37,214.75500317703506,0.4813143808309554,0.7651954786786261,0.12152898734700382,1039975.0434027739,2317.9687499998618,1042293.0121527738,355,0,130.71978021978023,79,103,36,39.5769492679605,0.5376602564102564,45.05208333333332,8158.333333333302,103.27004219409243,8
357,32,4,2,178,0.022222222222222223,0.011111111111111112,0.9888888888888889,180,5500,3700,1800,0.6727272727272727,73,37,36,205.4602177192771,0.4812765104489965,0.7474977874326174,0.11621907107619964,1039840.5815485407,1229.174455660544,1041069.7560042012,356,0,131.8388888888889,78,102,43,39.83073859522084,0.5376736111111111,45.06856540084388,8157.805907172994,104.5872552201666,8
358,32,3,2,179,0.016574585635359115,0.011049723756906077,0.988950276243094,181,6300,4300,2000,0.6825396825396826,83,43,40,233.55273969524538,0.4812627890321261,0.7839874027719334,0.13021365076159608,1035306.2500000036,5859.722222222448,1041165.9722222261,357,0,132.01657458563537,64,117,37,39.68400218400218,0.5310197974217311,45.625000000000014,8140.000000000028,127.18750000000044,8
359,32,4,4,179,0.02185792349726776,0.02185792349726776,0.9781420765027322,183,5800,3700,2100,0.6379310344827587,79,37,42,224.4089334053118,0.48154861986829195,0.7757252930817218,0.12635008818579288,1038389.7044237305,4204.785205757502,1042594.489629488,358,0,131.44262295081967,70,113,41,39.529582277509036,0.5341530054644809,45.246478873239454,8152.112676056378,116.45875251509112,0
360,32,4,5,178,0.02185792349726776,0.0273224043715847,0.9726775956284153,183,5200,3800,1400,0.7307692307692307,66,38,28,238.41200716228752,0.4820415240497207,0.7905699786124085,0.13748075655305517,1045825.8056640659,8067.4858940974245,1053893.2915581632,359,0,131.54098360655738,63,120,40,38.24059927001107,0.5424066484517305,44.335937500000014,8181.250000000026,129.86111111111154,7
361,32,6,4,180,0.03260869565217391,0.021739130434782608,0.9782608695652174,184,5000,3700,1300,0.74,63,37,26,240.53705654104024,0.48176959590559915,0.7930714865404282,0.13885970406916487,1046167.6729845842,8528.418541620546,1054696.0915262047,360,0,129.5163043478261,66,118,40,38.143481080642864,0.5383265398550725,44.29415422885574,8182.587064676654,123.97859188904022,8
362,32,4,4,180,0.021739130434782608,0.021739130434782608,0.9782608695652174,184,6350,5100,1250,0.8031496062992126,76,51,25,201.6226685619369,0.4814435336976321,0.7535951037474058,0.11427534177154715,1040461.4466903672,-1193.8773164953272,1039267.5693738719,361,0,130.29891304347825,82,102,39,39.85094000689014,0.536911231884058,44.99246987951805,8160.240963855352,99.51513370555307,8
363,32,2,4,178,0.01098901098901099,0.02197802197802198,0.978021978021978,182,5900,3800,2100,0.6440677966101694,80,38,42,226.40898593150598,0.4810550867180701,0.7768278477353308,0.12730404572544057,1037966.2897695013,4700.979019560165,1042667.2687890615,362,0,130.1868131868132,73,109,41,39.53175085663757,0.5326236263736264,45.29842342342343,8150.450450450467,111.65000617055433,8
364,32,5,1,182,0.0273224043715847,0.00546448087431694,0.994535519125683,183,5950,4600,1350,0.773109243697479,73,46,27,227.494196210245,0.48161117116035146,0.7739876736217268,0.12536893901545143,1031631.540357184,4388.037611738648,1036019.5779689227,363,0,128.04918032786884,76,107,39,40.300235304564026,0.5232809653916211,46.07683982683981,8125.54112554108,106.91501480975106,8
365,32,3,3,182,0.016216216216216217,0.016216216216216217,0.9837837837837837,185,6250,4600,1650,0.736,79,46,33,243.81645460405161,0.48196117312965137,0.7983656116704572,0.1348505124362298,1032775.9903513399,7111.55607353032,1039887.5464248703,364,0,127.63783783783784,70,115,34,39.74153529287213,0.5238175675675676,45.93603286384976,8130.046948356797,116.14352783366853,8
366,32,3,0,185,0.016216216216216217,0.0,1.0,185,6400,4600,1800,0.71875,82,46,36,243.31283391702377,0.481668625146886,0.799713117852145,0.13608251935862886,1036295.722415128,7028.809799383027,1043324.5322145111,365,0,128.6,59,126,37,39.31124508265685,0.5265202702702703,45.50347222222224,8143.888888888925,138.03201506591398,0
367,32,4,3,186,0.021164021164021163,0.015873015873015872,0.9841269841269842,189,6500,5000,1500,0.7692307692307693,80,50,30,216.69855900958268,0.4817617452812488,0.7807952994089065,0.12289145944097343,1040642.8713151888,801.1621315190978,1041444.0334467079,366,0,126.85714285714286,69,120,38,39.4437799043062,0.53505291005291,44.97023809523808,8160.95238095235,118.27467218771521,8
368,32,4,3,187,0.021052631578947368,0.015789473684210527,0.9842105263157894,190,6500,4600,1900,0.7076923076923077,84,46,38,217.9678590365217,0.48172282558247476,0.7839674070341152,0.12538627454884693,1045073.4905587758,1058.4862545842288,1046131.9768133601,367,0,126.64736842105263,62,128,39,38.8572599253844,0.5385964912280702,44.42791005291006,8178.306878306885,131.90817545656265,0
369,32,1,4,184,0.005319148936170213,0.02127659574468085,0.9787234042553191,188,6300,4300,2000,0.6825396825396826,83,43,40,203.25285050164342,0.4815992765578185,0.761141762380992,0.11438663795798265,1038247.7808642009,-1694.6358024689416,1036553.1450617319,368,0,128.87234042553192,74,114,43,40.086304817985216,0.528867464539007,45.2638888888889,8151.555555555583,110.15615615615653,8
370,32,6,6,184,0.031578947368421054,0.031578947368421054,0.968421052631579,190,6850,5100,1750,0.7445255474452555,86,51,35,191.57809821640686,0.48163406200686903,0.7470910856476982,0.10879644722683594,1041076.0133909101,-4960.527451170252,1036115.4859397399,369,0,127.48421052631579,82,108,41,40.03034030340302,0.5330592105263158,44.917168674698786,8162.650602409615,99.54451954158067,0
371,32,1,3,182,0.005405405405405406,0.016216216216216217,0.9837837837837837,185,6050,3900,2150,0.6446280991735537,82,39,43,190.137059930126,0.4812059341950646,0.7420912715994676,0.10543964232488834,1033611.1111111139,-3744.4444444443093,1029866.6666666697,370,0,131.62702702702703,68,117,46,41.00068306010927,0.5254504504504505,45.83333333333334,8133.333333333356,119.60784313725523,8
372,32,3,0,185,0.016216216216216217,0.0,1.0,185,5700,3600,2100,0.631578947368421,78,36,42,218.50506170754196,0.48150337837837837,0.7717624104826735,0.12052383267940849,1031917.3611111069,2395.8333333330806,1034313.19444444,371,0,130.91351351351352,69,116,42,40.49254853705221,0.5202702702702703,46.04166666666665,8126.666666666633,117.77777777777729,7
373,32,2,5,182,0.0106951871657754,0.026737967914438502,0.9732620320855615,187,6900,5000,1900,0.7246376811594203,88,50,38,237.47328506438444,0.481847651083894,0.7885931886352864,0.13038731106843438,1030463.5821873447,4641.514400248616,1035105.0965875933,372,0,130.50267379679144,77,110,35,40.194037344980636,0.5206662210338682,46.22061965811967,8120.940170940207,105.46675546675594,7
374,32,5,2,185,0.026737967914438502,0.0106951871657754,0.9893048128342246,187,6650,4700,1950,0.706766917293233,86,47,39,228.75156228883563,0.48200218503823816,0.7824454430511394,0.12770872934639574,1035730.251736112,3334.982638888912,1039065.2343750009,373,0,131.2673796791444,67,120,40,39.75285738655751,0.5262366310160428,45.57291666666667,8141.666666666674,121.51741293532349,0
375,32,4,4,185,0.021164021164021163,0.021164021164021163,0.9788359788359788,189,7250,5500,1750,0.7586206896551724,90,55,35,235.22705460413505,0.482601364028669,0.7887186789086933,0.1327478365509117,1039113.9112085018,3835.540946351557,1042949.4521548534,374,0,130.52380952380952,73,116,32,39.163076299896886,0.5301477072310405,45.157657657657644,8154.954954954923,111.71171171171127,8
376,32,2,4,183,0.0106951871657754,0.0213903743315508,0.9786096256684492,187,6350,4500,1850,0.7086614173228346,82,45,37,245.98295182564559,0.4823699518908247,0.7994445969112121,0.13882589661254774,1039132.1325340846,7371.75785952246,1046503.8903936071,375,0,129.58288770053477,62,125,33,38.88668115659941,0.5301916221033869,45.155423280423285,8155.026455026464,131.53268475849134,8
377,32,5,3,185,0.026595744680851064,0.015957446808510637,0.9840425531914894,188,6250,4400,1850,0.704,81,44,37,239.4065687190867,0.4823311336139872,0.7992361541858894,0.13619625896609885,1041621.4850724081,6024.205129052982,1047645.6902014611,376,0,128.0212765957447,70,118,37,38.7419019416173,0.5311391843971631,44.85035211267606,8164.7887323943805,116.63983903420544,8
378,32,2,3,184,0.0106951871657754,0.016042780748663103,0.983957219251337,187,6850,4800,2050,0.7007299270072993,89,48,41,235.91227786118597,0.48246339102600966,0.7955740511389349,0.1351893841056774,1043885.1718768099,5003.065744594947,1048888.237621405,377,0,129.51871657754012,61,126,37,38.54742210967131,0.5336452762923352,44.573252688172055,8173.655913978521,133.99435924554953,0
379,32,2,5,181,0.010752688172043012,0.026881720430107527,0.9731182795698925,186,6100,4300,1800,0.7049180327868853,79,43,36,256.05838207583184,0.4822489828538216,0.8037481812697411,0.14335862854578138,1036619.5694588947,9787.025956757865,1046406.5954156525,378,0,129.69354838709677,61,125,36,38.94609460946094,0.5232414874551972,45.463709677419345,8145.161290322561,133.52723426758297,8
380,32,7,3,185,0.03723404255319149,0.015957446808510637,0.9840425531914894,188,5800,4200,1600,0.7241379310344828,74,42,32,256.4038442731721,0.4825853576440247,0.8056116195606706,0.14603433095244175,1041980.8817694944,10033.58074896984,1052014.4625184643,379,0,129.15425531914894,70,118,38,38.263074431796404,0.527094414893617,44.80633802816903,8166.197183098625,116.65995975855178,0
381,32,1,2,184,0.005376344086021506,0.010752688172043012,0.989247311827957,186,5750,3900,1850,0.6782608695652174,76,39,37,262.13833109553775,0.4822247650876683,0.8125035631508288,0.14899299878582184,1041339.0177532729,11644.974443701887,1052983.9921969748,380,0,131.53763440860214,66,120,33,38.197406910841636,0.5306339605734767,44.88495024875622,8163.681592039797,123.69214533393631,7
382,32,2,2,184,0.010752688172043012,0.010752688172043012,0.989247311827957,186,6750,5400,1350,0.8,81,54,27,261.0679130614377,0.4820122541896736,0.8120917075947243,0.1498886460178526,1044472.8306309561,10585.668428439381,1055058.4990593954,381,0,132.4247311827957,60,126,35,37.83111660651429,0.5337141577060932,44.50136612021859,8175.956284153027,136.26593806921713,0
383,32,1,3,182,0.005405405405405406,0.016216216216216217,0.9837837837837837,185,5150,3600,1550,0.6990291262135923,67,36,31,255.71675820955193,0.4815792694868782,0.8066555064836312,0.14752311989400885,1045958.968268504,11343.847317166052,1057302.81558567,382,0,133.76756756756757,63,122,35,37.78148672735377,0.5360360360360361,44.31966145833335,8181.770833333361,129.86937830687876,0
384,32,1,3,180,0.00546448087431694,0.01639344262295082,0.9836065573770492,183,6250,4400,1850,0.704,81,44,37,247.28080028990874,0.4809593866970916,0.7944615684775134,0.13928093081525345,1038509.310459785,8510.682679803387,1047019.9931395884,383,0,136.0983606557377,70,113,41,38.931879259045985,0.5293715846994536,45.23180751173709,8152.582159624411,116.46545942320587,8
385,32,2,0,182,0.01098901098901099,0.0,1.0,182,5800,4300,1500,0.7413793103448276,73,43,30,246.79395593293816,0.480878640236375,0.7890319528205278,0.14012239810024907,1041007.2314342477,9182.858560091096,1050190.0899943388,384,0,135.69230769230768,69,113,43,38.6305130972522,0.5322229853479854,44.92559523809526,8162.3809523810105,118.29537612146392,8
386,32,1,3,180,0.00546448087431694,0.01639344262295082,0.9836065573770492,183,6500,4400,2100,0.676923076923077,86,44,42,241.4277084652541,0.4811195180047639,0.785635741243597,0.137742800997657,1042519.1107527826,7238.599988055656,1049757.7107408382,385,0,135.94535519125682,60,123,45,38.57776402640264,0.5338114754098361,44.74043715846994,8168.306010928946,136.13843351548243,0
387,32,3,2,181,0.01639344262295082,0.01092896174863388,0.9890710382513661,183,6450,4700,1750,0.7286821705426356,82,47,35,233.2896696609395,0.4809368682319502,0.7783932398287767,0.13444497147511877,1045637.3438527226,5737.278106508511,1051374.621959231,386,0,136.6120218579235,64,119,42,38.395133316616494,0.5369421675774135,44.358974358974336,8180.512820512774,127.82051282051209,0
388,32,1,1,181,0.005494505494505495,0.005494505494505495,0.9945054945054945,182,6100,4100,2000,0.6721311475409836,81,41,40,238.57720140118832,0.4810778540060308,0.7753480814790752,0.1371646581025332,1044899.3746220955,7357.833708638585,1052257.2083307342,387,0,136.25824175824175,72,110,36,38.35234146704638,0.538003663003663,44.44920091324203,8177.625570776309,113.57813292744873,8
389,32,1,2,180,0.005494505494505495,0.01098901098901099,0.989010989010989,182,5450,3700,1750,0.6788990825688074,72,37,35,234.93388609025487,0.4806610861514176,0.77337916320967,0.13596237509656495,1046934.5527960466,7342.080594108028,1054276.6333901547,388,0,137.24175824175825,73,109,42,38.19085222686919,0.5398923992673993,44.200450450450475,8185.585585585644,112.13130939158417,0
390,32,1,2,179,0.0055248618784530384,0.011049723756906077,0.988950276243094,181,6050,4400,1650,0.7272727272727273,77,44,33,236.93011073462753,0.48086249232658074,0.7755398785944205,0.13791266869467506,1048715.2326917935,7444.443242151712,1056159.6759339452,389,0,138.86187845303868,75,106,36,37.91719087388692,0.5417817679558011,43.983004385964925,8192.543859649153,109.23391812865538,0
391,32,2,2,179,0.011049723756906077,0.011049723756906077,0.988950276243094,181,6400,4300,2100,0.671875,85,43,42,230.18440289104507,0.48067065684468996,0.7692103421040568,0.13498585864874774,1050996.4096303226,5784.596198277278,1056781.0058286,390,0,138.84530386740332,68,113,41,37.80519231901983,0.544371546961326,43.70471014492751,8201.449275362262,120.60954816709209,0
392,32,1,5,175,0.005555555555555556,0.027777777777777776,0.9722222222222222,180,4850,3400,1450,0.7010309278350515,63,34,29,228.71727948434292,0.4805025346575626,0.7667829231453813,0.1348496391080108,1052642.7502625515,7301.517221793047,1059944.2674843445,391,0,138.26666666666668,71,109,39,37.637545358828255,0.5469907407407407,43.504050925925895,8207.870370370301,115.60380803338452,0
393,32,0,0,175,0.0,0.0,1.0,175,5850,4300,1550,0.7350427350427351,74,43,31,234.87340989987362,0.47961412151067323,0.7695928331918691,0.13897017385617577,1053722.085842137,8648.259877709692,1062370.3457198467,392,1,141.53714285714287,68,107,37,37.34508892679958,0.5482738095238096,43.37258454106278,8212.07729468594,120.76584256891088,0
394,32,1,2,174,0.005681818181818182,0.011363636363636364,0.9886363636363636,176,5500,3900,1600,0.7090909090909091,71,39,32,234.38670512156952,0.4795001352813853,0.7699122065430961,0.13944433449476534,1055389.3176020337,8773.844954648159,1064163.1625566818,393,0,141.72727272727272,69,107,44,37.149880738551865,0.5500118371212122,43.16964285714283,8218.571428571373,119.10973084886048,0
395,32,3,3,174,0.01694915254237288,0.01694915254237288,0.9830508474576272,177,6050,4100,1950,0.6776859504132231,80,41,39,229.57893336062506,0.47946627289847626,0.7652589382633748,0.13742066295725822,1057240.9382715982,7094.04938271565,1064334.987654314,394,0,141.42372881355934,74,103,38,37.04299041855771,0.5524952919020716,42.94444444444442,8225.777777777725,111.15915915915843,0
396,32,2,3,173,0.011363636363636364,0.017045454545454544,0.9829545454545454,176,6450,4700,1750,0.7286821705426356,82,47,35,227.68161910963872,0.47905032467532466,0.7682563281062329,0.135468482185417,1055418.9663363444,6409.899818896093,1061828.8661552405,395,0,143.0568181818182,65,111,45,37.318398062229875,0.549124053030303,43.16603535353536,8218.686868686877,126.44133644133656,8
397,32,2,3,172,0.011428571428571429,0.017142857142857144,0.9828571428571429,175,6250,4500,1750,0.72,80,45,35,222.88173811063322,0.4787068965517241,0.7618643252541555,0.13352330587735486,1057493.5838623298,5889.201602415743,1063382.7854647455,396,0,144.71428571428572,70,105,42,37.18374897753427,0.5519047619047619,42.9137323943662,8226.760563380289,117.5251509054327,0
398,32,0,3,169,0.0,0.01744186046511628,0.9825581395348837,172,5200,3600,1600,0.6923076923076923,68,36,32,259.8478492433973,0.47823804909560724,0.7958044649730573,0.15374600073867067,1053719.9483501762,15161.372456731311,1068881.3208069075,397,1,146.5,57,115,39,36.70444339468589,0.5453609496124031,43.3728448275862,8212.068965517225,144.0713853599513,8
399,32,1,3,167,0.0058823529411764705,0.01764705882352941,0.9823529411764705,170,4950,3400,1550,0.6868686868686869,65,34,31,253.57498990827372,0.4776010848126233,0.7882583559312617,0.1509005792720429,1055470.8526234524,14578.202160493624,1070049.0547839461,398,0,147.34117647058824,59,111,38,36.64689513766845,0.5476102941176471,43.15972222222221,8218.888888888856,139.30320150659077,0
400,32,0,2,165,0.0,0.011976047904191617,0.9880239520958084,167,4850,3200,1650,0.6597938144329897,65,32,33,222.40092479356605,0.4771781737729361,0.7526601485312838,0.12981704712584496,1049572.1816945057,8435.164769291949,1058007.3464637976,399,1,150.55089820359282,72,95,41,38.182257135959304,0.5451596806387226,43.87842465753426,8195.890410958935,113.83181126331854,8
401,32,2,1,166,0.011976047904191617,0.005988023952095809,0.9940119760479041,167,5000,3700,1300,0.74,63,37,26,221.8870400514136,0.47698578746122217,0.7559034594047458,0.12420591096526074,1036565.6605512234,7600.097247730078,1044165.7577989536,400,0,149.68263473053892,65,102,39,39.82264473657014,0.530501497005988,45.4703282828283,8144.949494949528,125.30691530691583,8
402,32,2,3,165,0.011904761904761904,0.017857142857142856,0.9821428571428571,168,5750,4100,1650,0.7130434782608696,74,41,33,226.62844067711796,0.4769508601843931,0.7589811948697687,0.12242973733418612,1025288.0901760533,7121.888224283907,1032409.9784003373,401,0,149.3452380952381,63,105,40,41.121822692299446,0.5189732142857143,46.858723958333336,8100.52083333334,128.5796957671959,7
403,32,3,2,166,0.017857142857142856,0.011904761904761904,0.9880952380952381,168,4950,3500,1450,0.7070707070707071,64,35,29,219.87746801075585,0.47743798118049613,0.7515263357719666,0.11986299284237242,1028180.8657273287,6664.761082646147,1034845.6268099749,402,0,149.20238095238096,66,102,41,40.92801287948479,0.5221974206349207,46.501865671641774,8111.940298507425,122.90818634102159,0
404,32,7,4,169,0.04046242774566474,0.023121387283236993,0.976878612716763,173,5550,4100,1450,0.7387387387387387,70,41,29,211.01304670085023,0.4781612671954116,0.749443018678861,0.11826545175559297,1036954.9692521335,3612.2054706958293,1040567.1747228294,403,0,144.67630057803467,70,103,45,40.05061856462272,0.5329961464354528,45.42253521126761,8146.4788732394445,116.37826961770635,7
405,32,6,3,172,0.03428571428571429,0.017142857142857144,0.9828571428571429,175,5150,4200,950,0.8155339805825242,61,42,19,226.73293077323197,0.4787287903667214,0.7679947273026848,0.12649771620359845,1035521.2259472318,6807.352487381133,1042328.5784346128,404,0,142.90285714285713,70,105,39,39.830473856209146,0.5292857142857144,45.59859154929577,8140.845070422528,116.29778672032182,8
406,32,9,5,176,0.049723756906077346,0.027624309392265192,0.9723756906077348,181,5700,3900,1800,0.6842105263157895,75,39,36,219.4728188817101,0.47935722324534474,0.7708130848385115,0.1245437601396554,1040840.7874180764,3787.2523243407563,1044628.0397424172,405,0,138.44198895027625,80,101,39,39.34824534866132,0.5337246777163904,44.94598765432099,8161.7283950617275,102.0216049382716,0
407,32,5,5,176,0.027624309392265192,0.027624309392265192,0.9723756906077348,181,5650,3700,1950,0.6548672566371682,76,37,39,217.98846098758332,0.4793546654389196,0.7637546285099777,0.122416908998516,1037575.9449785386,3385.9166807216457,1040961.8616592602,406,0,137.96132596685084,76,105,40,39.79516397506727,0.5330340699815839,45.34632034632033,8148.917748917718,107.22260195944367,8
408,32,0,2,174,0.0,0.011363636363636364,0.9886363636363636,176,6050,4500,1550,0.743801652892562,76,45,31,191.74987878729272,0.47874797077922077,0.7290721790050807,0.10524642393749652,1030355.1323142649,-1735.9056541750701,1028619.2266600898,407,1,141.66477272727272,77,99,32,41.36801389327434,0.527639678030303,46.23397435897435,8120.512820512805,105.46120546120525,7
409,32,0,1,173,0.0,0.005747126436781609,0.9942528735632183,174,6100,4400,1700,0.7213114754098361,78,44,34,224.7960735932965,0.4787493355923194,0.7628226174939194,0.12312494200331625,1029685.698616067,5393.860416812331,1035079.5590328793,408,2,144.27586206896552,68,106,42,40.61371796397682,0.5249640804597702,46.316425120772934,8117.8743961352375,119.3805058255182,8
410,32,2,5,170,0.011428571428571429,0.02857142857142857,0.9714285714285714,175,5750,3900,1850,0.6782608695652174,76,39,37,221.0947731080051,0.47878762999452656,0.7612056911663421,0.12203159960806717,1032123.2835453643,4889.412638990101,1037012.6961843544,409,0,143.66285714285715,73,102,36,40.40088261375605,0.5279761904761905,46.01632882882881,8127.477477477434,111.33530791064979,0
411,32,8,2,176,0.0449438202247191,0.011235955056179775,0.9887640449438202,178,5700,4100,1600,0.7192982456140351,73,41,32,229.1001032590198,0.4791038479443069,0.7727191228565842,0.12467868777359244,1027639.3694732761,5786.4571318721255,1033425.8266051481,410,0,141.68539325842696,67,111,44,40.76251208897482,0.5205407303370786,46.56862745098038,8109.8039215686,121.04184957565076,8
412,32,6,6,176,0.03296703296703297,0.03296703296703297,0.967032967032967,182,5300,3900,1400,0.7358490566037735,67,39,28,221.8668855708268,0.47929125432578473,0.7702225154576565,0.1220432606966811,1031048.7391553093,4051.114525622906,1035099.8536809322,411,0,139.1153846153846,75,107,39,40.516452045425915,0.5239812271062272,46.148574561403485,8123.245614035026,108.309941520467,0
413,32,2,2,176,0.011235955056179775,0.011235955056179775,0.9887640449438202,178,5300,3300,2000,0.6226415094339622,73,33,40,201.85221259289577,0.47939810406483424,0.7512019516922546,0.10934910882058113,1026179.2323487411,527.3097132945823,1026706.5420620358,412,0,142.80337078651687,65,113,42,41.6368046034318,0.5205992509363295,46.74873737373738,8104.040404040414,124.67754467754483,8
414,32,11,2,185,0.058823529411764705,0.0106951871657754,0.9893048128342246,187,5750,4400,1350,0.7652173913043478,71,44,27,212.7074982460639,0.481458321353957,0.7635679953193233,0.1143483403778647,1023718.5441955018,400.5220887854084,1024119.0662842873,413,0,135.37967914438502,87,100,40,41.6721750354875,0.5203877005347594,47.052556818181806,8094.318181818147,93.03814002089824,8
415,32,3,2,186,0.015957446808510637,0.010638297872340425,0.9893617021276596,188,5900,4100,1800,0.6949152542372882,77,41,36,219.1584522590392,0.48170653657981566,0.7697350533037957,0.11902274664327704,1026981.3859467616,1514.3302085871983,1028495.7161553488,414,0,135.55851063829786,73,115,38,41.0973904507909,0.5236037234042553,46.64977477477479,8107.207207207239,111.05763297544162,0
416,32,7,4,189,0.03626943005181347,0.02072538860103627,0.9792746113989638,193,5900,4200,1700,0.711864406779661,76,42,34,192.88823608119012,0.48273558937823835,0.7471212244296463,0.10681755980316444,1033174.4447544349,-4642.560757430678,1028531.8839970042,415,0,131.79274611398964,96,97,39,40.985487188155915,0.5325453367875648,45.88702749140894,8131.6151202749425,84.70432416953065,8
417,32,2,3,188,0.010471204188481676,0.015706806282722512,0.9842931937172775,191,5750,3800,1950,0.6608695652173913,77,38,39,181.68860513699926,0.48199343253421517,0.7354747837262667,0.10049637273766024,1032800.1000484227,-6420.398087369424,1026379.7019610533,416,0,133.63350785340313,93,98,44,41.3169607158954,0.5315772251308901,45.93306737588655,8130.141843971707,87.42088004270653,8
418,32,5,2,191,0.025906735751295335,0.010362694300518135,0.9896373056994818,193,6200,4500,1700,0.7258064516129032,79,45,34,173.74569123321277,0.4822307228698906,0.727113970780807,0.09699166916923964,1035704.0762756268,-8810.175870887331,1026893.9004047394,417,0,133.0621761658031,80,113,49,41.155626600620025,0.5347582037996546,45.57613168724277,8141.563786008161,101.76954732510201,0
419,32,8,7,192,0.04020100502512563,0.035175879396984924,0.964824120603015,199,6700,4400,2300,0.6567164179104478,90,44,46,162.98076945800807,0.4833151447473056,0.7202667236347751,0.09230863103142127,1040240.6311034985,-12592.156304254111,1027648.4747992444,418,0,129.9748743718593,95,104,43,40.86383995063622,0.5398345896147403,45.01953124999996,8159.374999999864,85.8881578947354,8
420,32,5,2,195,0.025380710659898477,0.01015228426395939,0.9898477157360406,197,6750,4500,2250,0.6666666666666666,90,45,45,166.25957609688223,0.48233493905176283,0.7235600449038373,0.09508651346853218,1043270.7275390667,-11459.250217013634,1031811.477322053,419,0,132.13197969543148,79,118,47,40.40297324630738,0.5431472081218274,44.648437500000014,8171.250000000033,103.43354430379789,0
421,32,2,4,193,0.01015228426395939,0.02030456852791878,0.9796954314720813,197,4900,3200,1700,0.6530612244897959,66,32,34,170.82278628946327,0.482223790531441,0.7289803335130582,0.09827805654440165,1045111.4193973542,-8594.231071121521,1036517.1883262327,420,0,133.0761421319797,81,116,48,40.05743948506386,0.5448392554991539,44.42327235772359,8178.455284552883,100.96858375991214,0
422,32,1,2,192,0.005154639175257732,0.010309278350515464,0.9896907216494846,194,6950,5000,1950,0.7194244604316546,89,50,39,171.11120313648084,0.48146188326834394,0.7256553321934787,0.09895704653579752,1046717.9964839353,-9928.964855405144,1036789.0316285301,421,0,135.6237113402062,82,112,45,39.85034347399417,0.5477341065292096,44.22690763052211,8184.7389558233535,99.81388970516285,0
423,32,1,5,188,0.0051813471502590676,0.025906735751295335,0.9740932642487047,193,6400,4200,2200,0.65625,86,42,44,173.01298534047677,0.48102084232872766,0.7257110400642897,0.10067524411594908,1048616.1572472162,-8715.157631679938,1039900.9996155363,422,0,136.88082901554404,84,109,41,39.56588080421257,0.5507879965457685,43.9950980392157,8192.156862745127,97.52567693744199,0
424,32,1,6,183,0.005291005291005291,0.031746031746031744,0.9682539682539683,189,6200,4200,2000,0.6774193548387096,82,42,40,175.1602881882476,0.48041671357274196,0.724007398804146,0.10259388308168807,1050625.0000000026,-7194.444444444324,1043430.5555555582,423,0,140.35449735449737,88,101,45,39.261517615176174,0.5536265432098766,43.75000000000001,8200.00000000002,93.18181818181841,0
425,32,2,5,180,0.010810810810810811,0.02702702702702703,0.972972972972973,185,5450,3500,1950,0.6422018348623854,74,35,39,177.62379978252653,0.47922542107324717,0.7226713949744432,0.10446940629766513,1051895.0908256127,-5081.67939899412,1046813.4114266186,424,0,144.15675675675675,73,112,46,39.04079741970904,0.5552364864864865,43.59515765765762,8204.954954954874,112.39664321855992,0
426,32,1,3,178,0.0055248618784530384,0.016574585635359115,0.9834254143646409,181,6450,5400,1050,0.8372093023255814,75,54,21,195.98122810496284,0.4786256906077348,0.7353456407492227,0.11478900503290757,1050625.0000000077,-1469.444444444137,1049155.5555555637,425,0,146.93370165745856,81,100,46,38.7279810298103,0.5528314917127072,43.75000000000002,8200.00000000006,101.23456790123531,8
427,32,1,0,179,0.00558659217877095,0.0,1.0,179,5400,3800,1600,0.7037037037037037,70,38,32,245.80459509996157,0.4783114158977256,0.7821998360669506,0.1431113050771492,1048786.0618014433,10359.286653517247,1059145.3484549606,426,0,147.98882681564245,64,115,42,37.681131071607425,0.5466713221601489,43.974358974358964,8192.820512820488,128.01282051282013,8
428,32,1,2,178,0.005555555555555556,0.011111111111111112,0.9888888888888889,180,5350,3700,1650,0.6915887850467289,70,37,33,244.06109237064902,0.4779355472791227,0.7829892252117578,0.14322532525961743,1051214.1630334237,9962.095389086848,1061176.2584225105,427,0,148.1611111111111,57,123,44,37.42234211509713,0.5488425925925926,43.67816091954022,8202.298850574696,143.8999798346438,0
429,32,2,1,179,0.011111111111111112,0.005555555555555556,0.9944444444444445,180,6250,4700,1550,0.752,78,47,31,246.46041144666026,0.47794395303124354,0.7944924126039585,0.13993302128543225,1041007.2314342392,9063.4141156462,1050070.6455498855,428,0,148.85555555555555,69,111,37,38.639020963382144,0.5351273148148148,44.925595238095234,8162.380952380943,118.29537612146295,8
430,32,1,2,178,0.005555555555555556,0.011111111111111112,0.9888888888888889,180,6400,4400,2000,0.6875,84,44,40,236.74072625121528,0.4780124922408442,0.785275835275834,0.13541569541569548,1043316.3265306149,6999.092970521739,1050315.4195011365,429,0,149.18333333333334,62,118,39,38.59751359751359,0.5376736111111111,44.64285714285715,8171.4285714285925,131.79723502304182,0
431,32,1,0,179,0.00558659217877095,0.0,1.0,179,8000,6000,2000,0.75,100,60,40,235.2063626804925,0.4779766388383236,0.7828969235042083,0.13549211596665037,1045506.2500000036,5381.944444444689,1050888.1944444482,430,0,150.19553072625698,64,115,37,38.36253735397991,0.5407937616387337,44.375000000000014,8180.000000000028,127.81250000000044,0
432,32,1,2,178,0.005555555555555556,0.011111111111111112,0.9888888888888889,180,6050,4700,1350,0.7768595041322314,74,47,27,247.08971995656805,0.4781049555141734,0.7914747347850377,0.1404881550610194,1041446.4168310268,9416.140696909662,1050862.5575279365,431,0,150.35555555555555,77,103,37,38.56783919597989,0.5405092592592593,44.871794871794854,8164.102564102521,106.02730602730547,8
433,32,1,2,177,0.00558659217877095,0.0111731843575419,0.9888268156424581,179,7100,5100,2000,0.7183098591549296,91,51,40,241.47796804241153,0.4777150942606658,0.7852629756584948,0.13851746270471682,1044195.7634779746,7530.054240631189,1051725.8177186057,432,0,152.07262569832403,64,115,36,38.36634569140371,0.5434124767225326,44.53525641025641,8174.871794871791,127.73237179487174,0
434,32,0,3,174,0.0,0.01694915254237288,0.9830508474576272,177,5750,4000,1750,0.6956521739130435,75,40,35,208.93806823545327,0.47727807738400957,0.7481725024492216,0.11851261336686675,1040701.2876319728,2338.423329594829,1043039.7109615676,433,1,154.64406779661016,78,99,41,39.63438803295077,0.5380767419962336,44.963080168776386,8161.181434599196,104.63053121281021,8
435,32,1,1,174,0.005714285714285714,0.005714285714285714,0.9942857142857143,175,5700,4400,1300,0.7719298245614035,70,44,26,211.38484573062732,0.47709359605911333,0.7470937971130378,0.12048725454057832,1042222.2257653103,3361.9968820863824,1045584.2226473967,434,0,156.59428571428572,69,106,43,39.38175373641963,0.5404166666666667,44.77678571428573,8167.1428571428905,118.36438923395494,0
436,32,4,3,175,0.02247191011235955,0.016853932584269662,0.9831460674157303,178,6150,4400,1750,0.7154471544715447,79,44,35,198.70400861064397,0.47714522630610046,0.7344457487841665,0.11439102799175911,1045307.0711755856,-208.65894567163286,1045098.412229914,435,0,154.77528089887642,76,102,41,39.32046328640484,0.5433637640449438,44.39935064935067,8179.220779220843,107.62132604237951,0
437,32,3,3,175,0.016853932584269662,0.016853932584269662,0.9831460674157303,178,6200,4000,2200,0.6451612903225806,84,40,44,204.08163265306086,0.4770824075837407,0.7492547580830078,0.11627906976744186,1042100.6944444461,734.722222222319,1042835.4166666685,436,0,155.38202247191012,77,101,41,39.58333333333331,0.5378043071161049,44.79166666666667,8166.666666666681,106.06060606060625,8
438,32,2,2,175,0.011299435028248588,0.011299435028248588,0.9887005649717514,177,5400,3500,1900,0.6481481481481481,73,35,38,233.41552537064922,0.4763912964389659,0.7779566586285447,0.1340909329588299,1044654.3402777803,7967.708333333561,1052622.0486111138,437,0,157.06214689265536,59,118,41,38.51491371110205,0.5393126177024482,44.47916666666668,8176.666666666687,138.58757062146927,8
439,32,1,3,173,0.005681818181818182,0.017045454545454544,0.9829545454545454,176,5750,3700,2050,0.6434782608695652,78,37,41,249.14526756171796,0.47651785714285716,0.7901003116478378,0.1399465868339018,1037649.439405394,10755.089443184843,1048404.5288485789,438,0,158.92613636363637,62,114,40,38.99250097389951,0.53125,45.337301587301596,8149.206349206367,131.43881208397366,8
440,32,5,2,176,0.028089887640449437,0.011235955056179775,0.9887640449438202,178,4800,3400,1400,0.7083333333333334,62,34,28,240.34170811152808,0.47706521509130534,0.7858478953927215,0.13673117304048168,1041628.1400034361,9669.337277092221,1051297.4772805283,439,0,156.92696629213484,71,107,40,38.71720722764043,0.5354634831460674,44.84953703703706,8164.814814814868,114.9973917579559,0
441,32,2,1,177,0.011235955056179775,0.0056179775280898875,0.9943820224719101,178,6050,4300,1750,0.7107438016528925,78,43,35,232.8660175771496,0.47695280264076684,0.7779663120842488,0.13368038993188833,1044434.5489724267,6992.662807839218,1051427.211780266,440,0,156.22471910112358,61,117,43,38.5564624843822,0.5380383895131087,44.50604838709678,8175.80645161292,134.02961396086755,0
442,32,2,3,176,0.0111731843575419,0.01675977653631285,0.9832402234636871,179,5950,4000,1950,0.6722689075630253,79,40,39,251.2949613555295,0.47738947126148185,0.7986948564823746,0.14014526690981435,1035395.5063096326,10287.934749153534,1045683.4410587861,441,0,156.13966480446928,56,123,41,39.22144396551726,0.5282821229050279,45.614035087719294,8140.350877192973,145.36340852130309,8
443,32,5,2,179,0.027624309392265192,0.011049723756906077,0.988950276243094,181,5300,3600,1700,0.6792452830188679,70,36,34,257.4571149981633,0.4782522508696542,0.7999220166684169,0.14504086513964504,1038570.0361604162,11977.449046679534,1050547.4852070957,442,0,154.12707182320443,64,117,39,38.66497882333207,0.5262430939226519,45.22435897435896,8152.820512820476,127.38782051281994,8
444,32,0,3,176,0.0,0.01675977653631285,0.9832402234636871,179,6050,4200,1850,0.6942148760330579,79,42,37,262.448697995607,0.47805379448873264,0.8020830479626466,0.14834786745977674,1039615.5325443771,12719.148586456173,1052334.6811308332,443,1,156.05027932960894,64,115,33,38.40623559243889,0.5282239292364991,45.09615384615384,8156.923076923064,127.45192307692288,0
445,32,0,1,175,0.0,0.005681818181818182,0.9943181818181818,176,5550,4000,1550,0.7207207207207207,71,40,31,249.74183631341168,0.4769162608225108,0.7854056824838898,0.13796417947799186,1032401.1479591866,10816.751700680445,1043217.899659867,444,2,159.6931818181818,76,100,36,39.638254247217354,0.5232599431818181,45.98214285714287,8128.571428571451,106.95488721804541,8
446,32,2,3,174,0.011299435028248588,0.01694915254237288,0.9830508474576272,177,5250,3600,1650,0.6857142857142857,69,36,33,243.3890877558928,0.477216551104263,0.7824921197055479,0.13554710166043205,1034956.3457070036,9729.416169759834,1044685.7618767634,445,0,159.29943502824858,62,115,38,39.477825813721665,0.5256002824858756,45.6679894179894,8138.624338624311,131.2681344939405,0
447,32,5,1,178,0.027932960893854747,0.00558659217877095,0.994413407821229,179,5650,4200,1450,0.7433628318584071,71,42,29,232.72591300290796,0.4782721842110769,0.7717024557900525,0.13114241181135472,1038651.4599232179,6894.221860486803,1045545.6817837047,446,0,157.31843575418995,68,111,44,39.284850190594675,0.5293878026070764,45.214371980676326,8153.140096618351,119.89911906791693,0
448,32,2,6,174,0.011111111111111112,0.03333333333333333,0.9666666666666667,180,5650,4300,1350,0.7610619469026548,70,43,27,228.879444797868,0.4783875181046969,0.7714484116034805,0.12997569474090145,1041066.3228684766,6005.73639517899,1047072.0592636556,447,0,156.62777777777777,73,107,34,39.08006134687197,0.5321180555555556,44.91835585585586,8162.612612612613,111.81661113167962,0
449,32,0,2,172,0.0,0.011494252873563218,0.9885057471264368,174,4900,3100,1800,0.6326530612244898,67,31,36,237.95387584707782,0.4776454499147344,0.7781044675479463,0.13314518396634123,1036437.1141975244,9624.845679011956,1046061.9598765364,448,1,162.48850574712642,68,106,36,39.42985447930877,0.5301724137931034,45.486111111111086,8144.4444444443925,119.7712418300646,8
450,32,3,1,174,0.017142857142857144,0.005714285714285714,0.9942857142857143,175,5100,3100,2000,0.6078431372549019,71,31,40,233.01828657128752,0.477915982484948,0.7754768392370586,0.13156570949486474,1039266.9753086367,8333.641975308426,1047600.6172839451,449,0,160.11428571428573,74,101,35,39.20015894641235,0.5329166666666667,45.13888888888887,8155.555555555513,110.21021021020964,0
451,32,2,3,173,0.011363636363636364,0.017045454545454544,0.9829545454545454,176,5500,4000,1500,0.7272727272727273,70,40,30,268.8691655112984,0.4778354978354978,0.7988490859048218,0.15651725402961802,1048741.6536007794,15694.858648116198,1064436.5122488956,450,0,160.11363636363637,67,109,32,37.09618510540699,0.5424952651515151,43.97977941176471,8192.647058823535,122.27831431079903,8
452,32,1,1,173,0.005747126436781609,0.005747126436781609,0.9942528735632183,174,5950,4200,1750,0.7058823529411765,77,42,35,263.8350380384454,0.47718520917768475,0.7908107400760576,0.1542861418094391,1050136.96145125,14662.585034013762,1064799.5464852636,451,0,162.70689655172413,69,105,35,37.05032140644362,0.5436422413793103,43.80952380952382,8198.095238095259,118.81297446514867,8
453,32,2,5,170,0.011428571428571429,0.02857142857142857,0.9714285714285714,175,5650,3900,1750,0.6902654867256637,74,39,35,230.26954842098064,0.47701559934318555,0.7665378429787817,0.13663909216068937,1054598.820918465,7918.398851638507,1062517.2197701035,452,0,162.73714285714286,70,105,35,37.35403927843492,0.552797619047619,43.26584507042252,8215.492957746452,117.3641851106636,8
454,32,2,3,169,0.011627906976744186,0.01744186046511628,0.9825581395348837,172,4700,3400,1300,0.723404255319149,60,34,26,226.72159738512914,0.47630077292714995,0.7599763697170827,0.1354763095191161,1056718.2841266815,8816.171472654574,1065534.4555993362,453,0,166.40697674418604,72,100,35,37.181426985008315,0.5557170542635659,43.00799086757989,8223.744292237407,114.21867072551953,0
455,32,1,1,169,0.0058823529411764705,0.0058823529411764705,0.9941176470588236,170,4650,3100,1550,0.6666666666666666,62,31,31,224.54615770930744,0.4756004176818656,0.7535491930112896,0.13363620307788557,1055494.634264615,8751.452921381873,1064246.0871859968,454,0,169.27058823529413,71,99,45,37.389513978858034,0.5546568627450981,43.156828703703695,8218.98148148146,115.7603025560769,7
456,32,3,3,169,0.01744186046511628,0.01744186046511628,0.9825581395348837,172,6200,4100,2100,0.6612903225806451,83,41,42,220.59629066195987,0.47568311120177703,0.7519239780378748,0.13218407653051256,1057562.0891161398,6058.854800746507,1063620.9439168863,455,0,168.27325581395348,73,99,42,37.23399401372463,0.5569282945736433,42.905405405405396,8227.027027027001,112.6990003702329,0
457,32,0,2,167,0.0,0.011834319526627219,0.9881656804733728,169,4700,3600,1100,0.7659574468085106,58,36,22,225.07331173340904,0.47461139288062365,0.7528142789319312,0.13511896149431976,1058126.9286503561,9131.226413127019,1067258.1550634832,456,1,171.9940828402367,72,97,45,37.048699737358035,0.5579388560157791,42.83675799086756,8229.223744292194,114.29477422628048,0
458,32,1,1,167,0.005952380952380952,0.005952380952380952,0.9940476190476191,168,6250,4900,1350,0.784,76,49,27,241.9755622356052,0.4737637819598897,0.7756217192417676,0.14161574543074976,1050380.9665532901,10983.304988662258,1061364.2715419524,457,0,173.51785714285714,69,99,38,37.579858287838306,0.5484871031746033,43.77976190476191,8199.047619047637,118.8267770876469,8
459,32,0,1,166,0.0,0.005988023952095809,0.9940119760479041,167,5350,3500,1850,0.6542056074766355,72,35,37,287.8779379680197,0.47344768294735834,0.7985082658663656,0.16388971889938003,1041846.7712742302,21234.94003861318,1063081.7113128435,458,1,175.4011976047904,66,101,38,37.47677146164626,0.5381112774451098,44.822761194029866,8165.671641791078,123.72229760289513,8
460,32,4,4,166,0.023529411764705882,0.023529411764705882,0.9764705882352941,170,5650,3800,1850,0.672566371681416,75,38,37,279.3908670516251,0.47427848358278224,0.7953003257277789,0.16106125031304905,1045729.7592119811,18783.468825584565,1064513.2280375657,459,0,173.18235294117648,60,110,39,37.204985193596514,0.5412377450980392,44.34767759562842,8180.8743169398995,136.34790528233165,0
461,32,4,4,166,0.023529411764705882,0.023529411764705882,0.9764705882352941,170,4350,2900,1450,0.6666666666666666,58,29,29,266.9255960930768,0.47498187144680354,0.7845702891326021,0.1556186775641455,1049201.8711419746,17661.76697530861,1066863.6381172831,460,0,172.2058823529412,65,105,31,37.0882768361582,0.544546568627451,43.92361111111111,8194.444444444438,126.06837606837597,0
462,32,0,2,164,0.0,0.012048192771084338,0.9879518072289156,166,4900,3200,1700,0.6530612244897959,66,32,34,303.81248015268926,0.4734179140805647,0.8066756481054396,0.17303078519157594,1041971.805332366,25212.807685440363,1067184.6130178063,461,1,175.9277108433735,65,101,32,37.05438132640649,0.5357680722891567,44.8074494949495,8166.161616161632,125.63325563325589,8
463,32,6,1,169,0.03529411764705882,0.0058823529411764705,0.9941176470588236,170,4450,2700,1750,0.6067415730337079,62,27,35,234.10732208491797,0.4748614978535793,0.7648708282873296,0.13092254032142167,1036268.2893059542,10069.59883418703,1046337.8881401413,462,0,172.2764705882353,66,104,42,39.54896959700243,0.5319240196078432,45.50684079601989,8143.781094527336,123.39062264435357,8
464,32,4,3,170,0.023121387283236993,0.017341040462427744,0.9826589595375722,173,5950,4700,1250,0.7899159663865546,72,47,25,233.07604518798996,0.47550353990231664,0.7680283942381654,0.13182408427090883,1039802.7884303225,7920.624340556799,1047723.4127708793,463,0,169.91907514450867,73,100,37,39.131465120559554,0.5352239884393064,45.0731981981982,8157.657657657661,111.74873503640632,0
465,32,0,2,168,0.0,0.011764705882352941,0.9882352941176471,170,5450,3600,1850,0.6605504587155964,73,36,37,244.51139640501952,0.4752465483234714,0.7752897620092296,0.13890939739471087,1041193.4845679036,11466.73456790137,1052660.219135805,464,1,173.58235294117648,74,96,39,38.66535997531806,0.5367647058823529,44.902777777777786,8163.1111111111295,110.31231231231256,0
466,32,2,0,170,0.011764705882352941,0.0,1.0,170,4600,2800,1800,0.6086956521739131,64,28,36,228.83734398089416,0.4754024538809607,0.7591553280691385,0.1267193718363928,1033159.30864197,8685.086419752774,1041844.3950617228,465,0,174.4,74,96,37,40.073877714618824,0.5298406862745098,45.88888888888887,8131.555555555513,109.88588588588532,8
467,32,1,0,171,0.005847953216374269,0.0,1.0,171,4950,3500,1450,0.7070707070707071,64,35,29,205.38097306140446,0.47549736268776516,0.7405165892143104,0.11238262233809364,1029379.3402777708,3132.9861111106693,1032512.3263888814,466,0,174.37426900584796,71,100,43,41.144763860369615,0.5277168615984406,46.35416666666664,8116.666666666611,114.31924882629029,8
468,32,6,2,175,0.03389830508474576,0.011299435028248588,0.9887005649717514,177,5700,3900,1800,0.6842105263157895,75,39,36,197.0770227522379,0.4766374015579524,0.7395168878264764,0.10917967610336264,1033297.3489178404,-372.16697149859965,1032925.1819463418,467,0,169.42937853107344,80,97,43,40.86363291331407,0.5314265536723164,45.87191358024689,8132.098765432039,101.65123456790049,0
469,32,2,1,176,0.011299435028248588,0.005649717514124294,0.9943502824858758,177,6100,4600,1500,0.7540983606557377,76,46,30,193.53359433082218,0.47655982494435883,0.7348216741784632,0.10765306184652011,1034579.5918367369,-1454.818594104128,1033124.7732426327,468,0,170.4180790960452,69,108,44,40.79300288701624,0.5330743879472692,45.71428571428572,8137.142857142875,117.92960662525905,0
470,32,4,1,179,0.022222222222222223,0.005555555555555556,0.9944444444444445,180,5450,3500,1950,0.6422018348623854,74,35,39,189.63013490322908,0.47735684357541897,0.7321376099693782,0.10675411271637376,1038347.7662759315,-2069.594600925768,1036278.1716750057,469,0,167.81666666666666,76,104,47,40.42082647407645,0.5358217592592592,45.25162337662338,8151.9480519480485,107.26247436773748,0
471,32,3,4,178,0.016483516483516484,0.02197802197802198,0.978021978021978,182,5700,4100,1600,0.7192982456140351,73,41,32,226.5960621384081,0.47769248477121407,0.7769469520916865,0.1257113411495405,1033745.5952031085,4748.536225190139,1038494.1314282987,470,0,166.92307692307693,62,120,42,40.05710769964662,0.5236378205128205,45.81679894179897,8133.862433862487,131.1913295784272,8
472,32,1,3,176,0.00558659217877095,0.01675977653631285,0.9832402234636871,179,5950,4300,1650,0.7226890756302521,76,43,33,245.88985611689392,0.4769330759734689,0.7861211621467754,0.13493838039402076,1030298.5520373832,8917.992543583081,1039216.5445809662,471,0,170.4022346368715,68,111,30,40.001264203700394,0.5233356610800746,46.24094202898549,8120.289855072433,119.41602728047695,8
473,32,5,0,181,0.027624309392265192,0.0,1.0,181,5450,4100,1350,0.7522935779816514,68,41,27,239.0903603200004,0.47779056680990384,0.7844992707182326,0.13308823940149625,1034802.8606838635,7832.277764214327,1042635.1384480778,472,0,169.45303867403314,63,118,36,39.606466666666684,0.5267610497237569,45.68684895833333,8138.020833333321,129.17493386243368,0
474,32,3,0,184,0.016304347826086956,0.0,1.0,184,4500,2900,1600,0.6444444444444445,61,29,32,230.9604674443761,0.47816991862675223,0.7786000408025555,0.12966078521877267,1037477.0558499118,6623.237156382051,1044100.2930062938,473,0,167.67391304347825,67,117,38,39.47724287633601,0.5288156702898551,45.358455882352935,8148.529411764692,121.6198419666372,0
475,32,4,4,184,0.02127659574468085,0.02127659574468085,0.9787234042553191,188,5750,3500,2250,0.6086956521739131,80,35,45,227.41881397896023,0.4789367391057003,0.7816208310779866,0.1263163195035309,1034116.9773025394,3685.5312987300613,1037802.5086012695,474,0,165.08510638297872,66,122,39,39.989501793868214,0.5263741134751774,45.771144278606954,8135.323383084557,123.26247550128116,8
476,32,1,5,180,0.005405405405405406,0.02702702702702703,0.972972972972973,185,6550,4600,1950,0.7022900763358778,85,46,39,236.86887450656084,0.4784089796318057,0.7893467192183528,0.12987984514002632,1030034.3984879453,5246.617734575951,1035281.0162225213,475,0,167.86486486486487,70,115,42,40.26348251802164,0.5191441441441442,46.273474178403724,8119.248826291007,115.9892689470144,8
477,32,3,4,179,0.01639344262295082,0.02185792349726776,0.9781420765027322,183,4950,3200,1750,0.6464646464646465,67,32,35,231.81858671548983,0.47741773254068337,0.783168537848117,0.127966345857155,1032162.4231734639,6304.88684018094,1038467.3100136449,476,0,169.50273224043715,75,108,42,40.12358795172055,0.5219148451730419,46.0115131578947,8127.631578947268,108.36842105263024,0
478,32,3,5,177,0.016483516483516484,0.027472527472527472,0.9725274725274725,182,6600,5400,1200,0.8181818181818182,78,54,24,227.88881368147307,0.4772921599579058,0.778985401246306,0.12688495749220477,1034882.3350694472,4167.621527777914,1039049.956597225,477,0,170.1098901098901,59,123,44,39.88134855621542,0.5248397435897436,45.67708333333334,8138.333333333355,137.937853107345,0
479,32,5,4,178,0.027472527472527472,0.02197802197802198,0.978021978021978,182,5200,3400,1800,0.6538461538461539,70,34,36,229.12967812775491,0.47760015077004025,0.7788981698745097,0.12480862831947709,1027930.4457199546,5505.874433106557,1033436.3201530611,478,0,170.32967032967034,69,113,38,40.72505088162193,0.516426282051282,46.532738095238095,8110.952380952381,117.55003450655624,8
480,32,6,6,178,0.03260869565217391,0.03260869565217391,0.967391304347826,184,6350,4700,1650,0.7401574803149606,80,47,33,221.20871416894715,0.4781284647976558,0.7750098419498646,0.12211683647521229,1032181.2307912108,2515.4965705288346,1034696.7273617396,479,0,168.44021739130434,76,108,40,40.39070128717265,0.5204936594202898,46.00919913419912,8127.705627705597,106.94349510138943,0
481,32,5,2,181,0.0273224043715847,0.01092896174863388,0.9890710382513661,183,4700,2900,1800,0.6170212765957447,65,29,36,225.43926570433385,0.4783209731980224,0.7812379132602869,0.12370691174041887,1030276.2632639505,5152.944852565863,1035429.2081165164,480,0,169.49726775956285,65,118,36,40.52302317867061,0.516507285974499,46.24368686868686,8120.202020202003,124.92618492618466,8
482,32,5,3,183,0.026881720430107527,0.016129032258064516,0.9838709677419355,186,6350,4600,1750,0.7244094488188977,81,46,35,220.09693307721278,0.47909946236559137,0.7801070650270123,0.12231828454856578,1034294.4677491565,1979.0080500632662,1036273.4757992198,481,0,167.65591397849462,61,125,39,40.153348642040584,0.5204413082437276,45.74932795698923,8136.021505376302,133.37740172748036,0
483,32,3,2,184,0.016129032258064516,0.010752688172043012,0.989247311827957,186,5400,4100,1300,0.7592592592592593,67,41,26,213.57373766375798,0.47962256611450155,0.7732374154287711,0.11966909427826437,1036872.2263313606,1689.735371466088,1038561.9617028268,482,0,168.2741935483871,64,122,42,39.99580316860772,0.5229054659498208,45.43269230769231,8146.153846153844,127.28365384615381,0
484,32,6,4,186,0.031578947368421054,0.021052631578947368,0.9789473684210527,190,6000,4200,1800,0.7,78,42,36,223.092636388828,0.48053525016244314,0.7806535952044047,0.12489884891659428,1036611.1480933676,2252.0627876401613,1038863.2108810077,483,0,163.65263157894736,64,126,44,39.78624944909654,0.5184758771929825,45.46474358974362,8145.128205128269,127.2676282051292,8
485,32,3,4,185,0.015873015873015872,0.021164021164021163,0.9788359788359788,189,6100,4300,1800,0.7049180327868853,79,43,36,220.5563355145742,0.48065827986040754,0.7824617369983216,0.12246492085722607,1034014.5896321527,1711.6937515749314,1035726.2833837277,484,0,164.33333333333334,62,127,40,40.1768292682927,0.5202821869488536,45.78373015873017,8134.920634920663,131.20839733743006,8
486,32,2,2,185,0.0106951871657754,0.0106951871657754,0.9893048128342246,187,6700,4800,1900,0.7164179104477612,86,48,38,219.32404472990868,0.4795979242136737,0.7791140487527901,0.12251098817962097,1035898.5304512733,1339.4911256682544,1037238.0215769416,485,0,166.7058823529412,62,125,41,39.971597677995106,0.5222816399286987,45.55224867724867,8142.328042328028,131.32787165045207,0
487,32,2,2,185,0.0106951871657754,0.0106951871657754,0.9893048128342246,187,5500,4100,1400,0.7454545454545455,69,41,28,213.8045629629626,0.47933677381020834,0.7723902554961373,0.12038545211878549,1038405.3048204182,1503.1584751103765,1039908.4632955287,486,0,167.58823529411765,68,119,45,39.797777777777796,0.5249554367201426,45.24456521739131,8152.173913043497,119.88491048593379,0
488,32,2,4,183,0.0106951871657754,0.0213903743315508,0.9786096256684492,187,6600,4900,1700,0.7424242424242424,83,49,34,207.8523290480647,0.47911635328618246,0.7650166816117021,0.1176566050227121,1040064.8157332082,-764.0211377813785,1039300.7945954269,487,0,168.5133689839572,70,117,40,39.74169927494538,0.5269607843137255,45.04107981220657,8158.685446009376,116.55264922870538,0
489,32,2,5,180,0.010810810810810811,0.02702702702702703,0.972972972972973,185,5650,4300,1350,0.7610619469026548,70,43,27,211.93895073258398,0.47890104778691733,0.7656948783353872,0.12054187608011299,1041548.3686587622,1498.93367815467,1043047.3023369169,488,0,170.9081081081081,76,109,44,39.45188229056206,0.529054054054054,44.85930735930737,8164.502164502195,107.42766005923941,0
490,32,4,2,182,0.021739130434782608,0.010869565217391304,0.9891304347826086,184,5450,3800,1650,0.6972477064220184,71,38,33,203.69379332819292,0.4792786538766136,0.7547550734060249,0.11670488619436863,1043827.4558624502,274.2348129479751,1044101.6906753981,489,0,170.84782608695653,68,116,47,39.37757353665507,0.5314198369565217,44.58031400966185,8173.429951690845,120.19749928957125,0
491,32,0,3,179,0.0,0.016483516483516484,0.9835164835164835,182,4850,3300,1550,0.6804123711340206,64,33,31,207.3004055034449,0.47897124744500436,0.7563438961998379,0.11603504066145812,1036550.2345679032,1725.4567901235605,1038275.6913580268,490,1,173.43406593406593,74,108,40,40.19585106769981,0.5271863553113554,45.47222222222223,8144.888888888905,110.06606606606628,8
492,32,3,3,179,0.016483516483516484,0.016483516483516484,0.9835164835164835,182,5600,3700,1900,0.6607142857142857,75,37,38,206.3370880489701,0.4789219183210896,0.7570489159609075,0.11642299933879133,1039057.2236616937,879.2083693197992,1039936.4320310135,491,0,174.3956043956044,80,102,38,39.90640980352574,0.5345123626373627,45.164609053497905,8154.732510287979,101.93415637859974,8
493,32,2,1,180,0.011049723756906077,0.0055248618784530384,0.994475138121547,181,6200,4300,1900,0.6935483870967742,81,43,38,208.22444261721398,0.47794403519541645,0.7603963118888217,0.11833130479340574,1041290.6667296462,964.4337364571365,1042255.1004661033,492,0,176.06629834254144,83,98,41,39.578877438589686,0.5372352670349908,44.89087301587299,8163.4920634919945,98.35532606616862,0
494,32,3,2,181,0.01639344262295082,0.01092896174863388,0.9890710382513661,183,6400,4400,2000,0.6875,84,44,40,222.54001130743052,0.4783147180688165,0.7721817680494707,0.12605033661109413,1040262.1667275368,3299.9908692475815,1043562.1575967844,493,0,175.04918032786884,73,110,37,39.34249751573369,0.5330714936247722,45.01689189189189,8159.459459459447,111.77341725286914,8
495,32,3,3,181,0.016304347826086956,0.016304347826086956,0.9836956521739131,184,5400,4200,1200,0.7777777777777778,66,42,24,207.82492794618585,0.4782546824265463,0.7629744407129699,0.11768198726823213,1040173.3456790145,1034.7901234569208,1041208.1358024714,494,0,173.22826086956522,74,110,40,39.728819406616566,0.5320425724637681,45.027777777777786,8159.111111111128,110.25825825825848,8
496,32,7,3,185,0.03723404255319149,0.015957446808510637,0.9840425531914894,188,6100,3700,2400,0.6065573770491803,85,37,48,228.30463830072284,0.47900666552888077,0.7860252614757375,0.12781367486539133,1036603.4698193013,3632.276047674024,1040235.7458669753,495,0,169.01063829787233,67,121,39,39.654549831487735,0.5255984042553192,45.46568627450981,8145.098039215694,121.56862745098051,8
497,32,3,0,188,0.015957446808510637,0.0,1.0,188,6350,4000,2350,0.6299212598425197,87,40,47,217.51594884161008,0.4790410361436644,0.7768473022216997,0.12257281052407064,1038654.7865433018,1234.7962827693277,1039889.5828260711,496,0,169.6755319148936,73,115,41,39.67196132596686,0.5282579787234043,45.21396396396397,8153.153153153167,111.68702949524886,7
498,32,0,5,183,0.0,0.026595744680851064,0.973404255319149,188,4850,3200,1650,0.6597938144329897,65,32,33,214.94192721310307,0.47911748113171765,0.7739213899689079,0.12153555551661435,1039720.1111111126,2245.888888888925,1041966.0000000015,497,1,170.6755319148936,74,114,38,39.60410537212595,0.5295323581560284,45.083333333333336,8157.333333333346,110.2342342342344,0
499,32,3,1,185,0.016129032258064516,0.005376344086021506,0.9946236559139785,186,6300,4500,1800,0.7142857142857143,81,45,36,217.87029844702474,0.4790298362879008,0.7746829113907219,0.1242383098196503,1042358.4965819814,1919.7913478216988,1044278.2879298031,498,0,173.18817204301075,65,121,41,39.19918171324924,0.5325940860215054,44.76010101010101,8167.676767676768,125.65656565656566,0
500,32,3,5,183,0.015957446808510637,0.026595744680851064,0.973404255319149,188,5900,3800,2100,0.6440677966101694,80,38,42,214.33622723454488,0.4790434065308909,0.7718387250906422,0.12287810511625563,1044018.6340067077,1254.2030351124822,1045272.8370418202,499,0,172.29255319148936,70,118,41,39.08185438324431,0.5384530141843972,44.55692488262913,8174.178403755925,116.77397719651321,8
501,32,3,2,184,0.016129032258064516,0.010752688172043012,0.989247311827957,186,6250,4600,1650,0.736,79,46,33,210.27509220031538,0.478573331395912,0.7652977242117656,0.12163693267631093,1046795.6964761888,573.0123182849302,1047368.7087944738,500,0,174.13978494623655,77,109,44,38.83894385561881,0.5414426523297491,44.21741452991454,8185.0427350427635,106.29925629925667,0
502,32,0,4,180,0.0,0.021739130434782608,0.9782608695652174,184,5550,3800,1750,0.6846846846846847,73,38,35,212.45915724908596,0.47803751385919063,0.76585639541655,0.12348075330896009,1048247.6544001165,2191.962648436103,1050439.6170485527,501,1,176.2663043478261,78,106,39,38.6019815921423,0.54296875,44.04008438818566,8190.71729957808,105.00919614843693,0
503,32,2,1,181,0.01098901098901099,0.005494505494505495,0.9945054945054945,182,6400,4600,1800,0.71875,82,46,36,215.58266578074287,0.4778923309655354,0.7679322986019099,0.12609623804122047,1050203.231638134,2481.1224576201303,1052684.3540957542,502,0,178.5879120879121,80,102,41,38.278243482916736,0.5459592490842491,43.80144032921812,8198.353909465044,102.47942386831305,0
504,32,2,4,179,0.01092896174863388,0.02185792349726776,0.9781420765027322,183,5800,3900,1900,0.6724137931034483,77,39,38,229.2981800420504,0.4776754438639685,0.7742980814617182,0.13011276797982824,1040825.0434027748,5331.857638888681,1046156.9010416635,503,0,177.89617486338798,79,104,34,39.09961881424,0.5381944444444444,44.94791666666666,8161.666666666643,103.31223628691954,8
505,32,3,5,177,0.016483516483516484,0.027472527472527472,0.9725274725274725,182,6750,4800,1950,0.7111111111111111,87,48,39,213.57593068599485,0.4777709054297452,0.7562511436231587,0.12097631363812973,1040270.8900817129,1285.364702949802,1041556.2547846626,504,0,179.1098901098901,78,104,37,39.56997448891647,0.5346268315018314,45.01582278481011,8159.493670886037,104.60889321648766,8
506,32,0,2,175,0.0,0.011299435028248588,0.9887005649717514,177,5550,3900,1650,0.7027027027027027,72,39,33,212.9570001128648,0.476962420818353,0.7487817306773774,0.12103890428908193,1041337.3905371068,3402.017358828057,1044739.4078959349,505,1,181.954802259887,77,100,39,39.45230024952447,0.5369585687382298,44.88514957264956,8163.6752136751875,106.02175602175568,0
507,32,0,0,175,0.0,0.0,1.0,175,5850,4100,1750,0.7008547008547008,76,41,35,239.14949565367192,0.4768596059113301,0.7812348888600023,0.13341385569714945,1035494.6844993097,8677.60631001343,1044172.2908093232,506,2,183.49142857142857,62,113,32,39.51793296936607,0.5301785714285714,45.60185185185183,8140.740740740706,131.3022700119469,8
508,32,2,4,173,0.011299435028248588,0.022598870056497175,0.9774011299435028,177,6450,4100,2350,0.6356589147286822,88,41,47,235.22295794967903,0.4768968819551447,0.7797092903975484,0.13239876901427308,1038295.095573129,6996.168721071181,1045291.2642942002,507,0,182.40677966101694,66,111,37,39.26596989116058,0.5328978342749529,45.258084577114424,8151.7412935323355,123.5112317201869,0
509,32,2,1,174,0.011428571428571429,0.005714285714285714,0.9942857142857143,175,5000,4000,1000,0.8,60,40,20,229.79187208639163,0.4772632731253421,0.7676602569457214,0.12851211891502531,1036275.5243764184,7625.538548752966,1043901.0629251715,508,0,183.52,69,106,38,39.657886017229984,0.5292261904761905,45.50595238095239,8143.809523809533,118.02622498274685,8
510,32,2,0,176,0.011363636363636364,0.0,1.0,176,5350,3700,1650,0.6915887850467289,70,37,33,226.1456199331302,0.477503382034632,0.7646796745318092,0.12736920814782643,1038491.2871916739,6420.051187423,1044911.3383790969,509,0,183.4431818181818,72,104,40,39.47259717710317,0.5314275568181819,45.234018264840174,8152.511415525093,113.22932521562629,0
511,32,6,4,178,0.03296703296703297,0.02197802197802198,0.978021978021978,182,6300,5000,1300,0.7936507936507936,76,50,26,223.9254717458097,0.47884096796389614,0.7735473712169012,0.12795628245962465,1043003.1414205211,4010.994094990512,1047014.1355155116,510,0,178.36263736263737,65,117,40,38.963948301085885,0.5353136446886446,44.68118686868688,8170.202020202043,125.69541569541605,0
512,32,1,1,178,0.00558659217877095,0.00558659217877095,0.994413407821229,179,6300,4700,1600,0.746031746031746,79,47,32,237.50335931201235,0.4784709580900968,0.7830845315505071,0.13170640834575262,1033611.1111111139,6997.222222222365,1040608.3333333363,511,0,180.6145251396648,70,109,33,39.79678961748632,0.5228119180633147,45.83333333333334,8133.333333333356,116.19047619047652,8
513,32,6,7,177,0.03260869565217391,0.03804347826086957,0.9619565217391304,184,5800,4200,1600,0.7241379310344828,74,42,32,217.42665798167945,0.479409821216441,0.7740455481564352,0.12269707877147969,1039100.4060938105,2585.6257208766565,1041686.0318146871,512,0,176.47282608695653,67,117,36,39.6183978520478,0.5300611413043479,45.1593137254902,8154.9019607843165,121.71495463857188,8
514,32,2,2,177,0.0111731843575419,0.0111731843575419,0.9888268156424581,179,6450,4700,1750,0.7286821705426356,82,47,35,222.08003986648183,0.47849057393342126,0.7738740729700417,0.12638795986118684,1041741.2770834757,4019.988869051803,1045761.2659525275,513,0,181.59217877094972,70,109,40,39.16899053204542,0.5338687150837989,44.835680751173726,8165.258215962478,116.64654594232111,0
515,32,4,0,181,0.022099447513812154,0.0,1.0,181,5450,3600,1850,0.6605504587155964,73,36,37,210.47709524076842,0.47895053202373644,0.7631108475879012,0.1208367421470497,1044457.7950361597,2316.888560157723,1046774.6835963174,514,0,179.79005524861878,64,117,44,39.12558280541091,0.5367173112338859,44.503205128205124,8175.89743589743,127.74839743589735,0
516,32,2,1,182,0.01092896174863388,0.00546448087431694,0.994535519125683,183,5650,3700,1950,0.6548672566371682,76,37,39,204.6538871200819,0.47925674052723233,0.7588585863809527,0.11842484307794982,1046898.8495723949,600.3837973065315,1047499.2333697014,515,0,178.81420765027323,70,113,45,38.96986425771915,0.5391621129326047,44.20481220657277,8185.446009389669,116.93494299128098,0
517,32,5,3,184,0.026737967914438502,0.016042780748663103,0.983957219251337,187,6150,4700,1450,0.7642276422764228,76,47,29,206.67785119862427,0.4796003200889349,0.754663534122765,0.1176834856500699,1041902.8679165842,-482.3508202635412,1041420.5170963207,516,0,175.93582887700535,85,102,36,39.541801151825794,0.5384358288770054,44.815891472868195,8165.891472868159,96.06931144550775,8
518,32,1,3,182,0.005405405405405406,0.016216216216216217,0.9837837837837837,185,6500,4800,1700,0.7384615384615385,82,48,34,208.1936026582552,0.4792009400705053,0.7549644882978208,0.11923815424972845,1043710.7377647965,-41.22027432813866,1043669.5174904683,517,0,178.6972972972973,73,112,37,39.27721744562023,0.5405405405405406,44.59459459459461,8172.97297297301,111.9585338763426,0
519,32,1,3,180,0.00546448087431694,0.01639344262295082,0.9836065573770492,183,6250,4300,1950,0.688,82,43,39,226.52988129386767,0.47881137532776874,0.7702777838314194,0.12723927106104058,1037639.3337673536,4161.263020833007,1041800.5967881866,518,0,177.9672131147541,79,104,37,39.56969867402938,0.5344945355191257,45.33854166666664,8149.166666666606,103.1540084388178,8
520,32,8,2,186,0.0425531914893617,0.010638297872340425,0.9893617021276596,188,6150,4500,1650,0.7317073170731707,78,45,33,216.01229506908618,0.47958681780255624,0.773846338117119,0.12059657844714143,1035730.2517361123,996.0937500000205,1036726.3454861123,519,0,174.11702127659575,67,121,44,40.07697884680997,0.5287566489361701,45.57291666666667,8141.666666666677,121.51741293532353,8
521,32,5,1,190,0.02617801047120419,0.005235602094240838,0.9947643979057592,191,6050,4300,1750,0.7107438016528925,78,43,35,207.45829599470954,0.4803113805456049,0.7690472094334986,0.11717658325019774,1039380.2500000023,-1124.3888888887964,1038255.8611111136,520,0,167.92146596858638,74,117,40,39.83740668083484,0.5322316753926701,45.12500000000001,8156.000000000018,110.21621621621647,0
522,32,3,9,184,0.015544041450777202,0.046632124352331605,0.9533678756476685,193,6250,4000,2250,0.64,85,40,45,223.3692329626662,0.4804203997553253,0.7883044131294112,0.12701743040274202,1041485.8253294267,1677.1779890645498,1043163.0033184913,521,0,166.40932642487047,82,111,37,39.16808090248739,0.5365392918825561,44.86696787148593,8164.257028112423,99.56411009893198,8
523,32,3,0,187,0.016042780748663103,0.0,1.0,187,6800,5300,1500,0.7794117647058824,83,53,30,216.27230385514147,0.4795116727042723,0.7751238791699244,0.12419382799975849,1044532.6672335604,980.6972789116312,1045513.364512472,522,0,169.6577540106952,69,118,40,38.96816152203455,0.5399398395721925,44.49404761904762,8176.190476190478,118.49551414768808,0
524,32,1,2,186,0.005319148936170213,0.010638297872340425,0.9893617021276596,188,5700,3700,2000,0.6491228070175439,77,37,40,217.5378650997453,0.4795014838624037,0.7785725285989986,0.126046513971949,1047305.8663408743,2265.736454046498,1049571.6027949208,523,0,169.75,71,117,38,38.58949709718766,0.541832890070922,44.15509259259258,8187.037037037009,115.31038080333816,0
525,32,4,0,190,0.021052631578947368,0.0,1.0,190,5850,4300,1550,0.7350427350427351,74,43,31,209.9723900434235,0.47988489742875706,0.773910457385542,0.12271719684760107,1049959.5209984842,242.5020145800563,1050202.0230130642,524,0,167.7736842105263,76,114,42,38.45233065765384,0.5446271929824562,43.83116883116884,8197.402597402615,107.86056049213967,0
526,32,1,6,185,0.005235602094240838,0.031413612565445025,0.9685863874345549,191,6550,4600,1950,0.7022900763358778,85,46,39,211.4758867155023,0.4795685220905667,0.7760731491944974,0.12422607395981156,1051517.602441769,-275.87652533366054,1051241.7259164355,525,0,167.89005235602093,66,125,43,38.21979804718297,0.5465750436300174,43.64116915422885,8203.48258706466,124.29519071310091,0
527,32,1,2,184,0.005376344086021506,0.010752688172043012,0.989247311827957,186,5950,4400,1550,0.7394957983193278,75,44,31,200.40113289686417,0.47906374116051537,0.7518716226669042,0.11324787842254616,1039538.5345645418,-1485.0599966639975,1038053.4745678778,526,0,168.74193548387098,72,114,38,39.99748082628895,0.5348342293906809,45.105593607305934,8156.621004566208,113.28640284119734,8
528,32,1,1,184,0.005405405405405406,0.005405405405405406,0.9945945945945946,185,7200,5600,1600,0.7777777777777778,88,56,32,203.0211189118628,0.478530160595378,0.7544543444025165,0.11531092454164375,1041119.3550706734,-1926.1567225511235,1039193.1983481223,527,0,170.43783783783783,77,108,42,39.73303099314175,0.5369932432432433,44.911858974358964,8162.820512820483,106.01065601065562,0
529,32,5,1,188,0.026455026455026454,0.005291005291005291,0.9947089947089947,189,7650,5700,1950,0.7450980392156863,96,57,39,202.10027289069473,0.4788793669556081,0.7566306570602197,0.11635183117150455,1045322.0238819957,-3198.026742958823,1042123.9971390369,528,0,167.75132275132276,73,116,42,39.23178947754896,0.5408399470899471,44.39752252252254,8179.279279279323,112.04492163396334,0
530,32,2,3,187,0.010526315789473684,0.015789473684210527,0.9842105263157894,190,5750,3900,1850,0.6782608695652174,76,39,37,203.2209562156645,0.4791086512577741,0.7598634456997617,0.11762182617330974,1046967.4744898045,-1196.8537414961447,1045770.6207483084,529,0,167.82631578947368,76,114,48,38.99796393251889,0.5425438596491228,44.1964285714286,8185.7142857143535,107.70676691729413,0
531,32,1,1,187,0.005319148936170213,0.005319148936170213,0.9946808510638298,188,5900,4200,1700,0.711864406779661,76,42,34,204.3378764252002,0.47885377555277425,0.7589205808481765,0.11858032671289243,1047779.7067901297,-679.7839506169439,1047099.9228395127,530,0,170.28191489361703,77,111,37,38.86815920398012,0.5439937943262412,44.09722222222224,8188.888888888938,106.34920634920698,0
532,32,1,2,186,0.005319148936170213,0.010638297872340425,0.9893617021276596,188,4850,3700,1150,0.7628865979381443,60,37,23,203.44389486249253,0.4786220702013881,0.7587512767688642,0.11849883733933894,1048917.361111119,229.16666666707806,1049146.527777786,531,0,171.27659574468086,79,109,40,38.749321941958236,0.5453789893617021,43.95833333333336,8193.333333333396,103.71308016877717,0
533,32,2,2,186,0.010638297872340425,0.010638297872340425,0.9893617021276596,188,5350,3700,1650,0.6915887850467289,70,37,33,201.61789390087168,0.47847095801570144,0.7529885193190518,0.11922472905514651,1053546.3317176763,-467.24149441852023,1053079.0902232577,532,0,171.04787234042553,78,110,44,38.22035095832689,0.5497562056737588,43.39398734177216,8211.392405063314,105.27426160337582,8
534,32,3,3,186,0.015873015873015872,0.015873015873015872,0.9841269841269842,189,5650,4000,1650,0.7079646017699115,73,40,33,194.3250178112054,0.47900132275132273,0.7439051994782417,0.1159810033716927,1056360.7482699018,-2394.535755478356,1053966.2125144235,533,0,169.7883597883598,84,105,35,38.05831783278486,0.5520833333333333,43.05147058823531,8222.352941176516,97.88515406162519,0
535,32,0,2,184,0.0,0.010752688172043012,0.989247311827957,186,5700,4100,1600,0.7192982456140351,73,41,32,218.30988656054808,0.47820158868545964,0.7761440610183792,0.12830718461409435,1051676.5450361597,3018.2774490466236,1054694.8224852064,534,1,173.31182795698925,64,122,39,38.02480518398132,0.5469310035842294,43.62179487179487,8204.102564102559,128.18910256410248,8
536,32,2,3,183,0.010752688172043012,0.016129032258064516,0.9838709677419355,186,4100,2500,1600,0.6097560975609756,57,25,32,213.70036533228188,0.4781761600309988,0.7707945330711448,0.12625281901059554,1053264.5234104653,3716.6026888695715,1056981.1260993348,535,0,174.10752688172042,67,119,44,37.9453624096961,0.5484991039426523,43.428308823529406,8210.294117647045,122.54170324846336,0
537,32,2,2,183,0.010810810810810811,0.010810810810810811,0.9891891891891892,185,5950,4600,1350,0.773109243697479,73,46,27,201.7619585465631,0.4777651292596945,0.7549283427650073,0.12032539600367513,1056123.246173464,-332.90107709781796,1055790.3450963662,536,0,175.73513513513512,69,116,42,37.8966961096631,0.5511261261261261,43.080357142857125,8221.428571428529,119.15113871635549,8
538,32,1,2,182,0.005434782608695652,0.010869565217391304,0.9891304347826086,184,5200,3700,1500,0.7115384615384616,67,37,30,205.40953177305207,0.4772208115546052,0.7600352836557303,0.11958990281332514,1048778.9647755881,1085.8392175960785,1049864.8039931841,537,0,177.33152173913044,73,111,44,38.71623231434645,0.5447803442028986,43.97522522522523,8192.792792792807,112.23003825743571,8
539,32,0,2,180,0.0,0.01098901098901099,0.989010989010989,182,5900,4100,1800,0.6949152542372882,77,41,36,209.20409698114003,0.47681088478740413,0.7604150986000289,0.12217519263698637,1049726.0695598703,1621.3988919670264,1051347.4684518373,538,1,180.06593406593407,75,107,45,38.50108804223745,0.5461881868131868,43.859649122807035,8196.49122807022,109.28654970760293,0
540,32,0,2,178,0.0,0.011111111111111112,0.9888888888888889,180,6350,4600,1750,0.7244094488188977,81,46,35,225.61893351712519,0.47629060624870684,0.7670608987003749,0.1321016190129056,1050516.8804189258,5053.299640371594,1055570.1800592975,539,2,182.8388888888889,78,102,38,37.98199797595157,0.5481481481481482,43.763185654008474,8199.57805907182,105.1227956291259,8
541,32,2,1,179,0.011111111111111112,0.005555555555555556,0.9944444444444445,180,4900,2700,2200,0.5510204081632653,71,27,44,239.1860071015501,0.47642315849368927,0.7738302127512857,0.13529614573731222,1039840.5815485322,8843.063344549055,1048683.6448930814,540,0,183.6611111111111,78,102,37,38.97096220819967,0.5351273148148148,45.06856540084385,8157.805907172926,104.58725522016572,8
542,32,1,4,176,0.005555555555555556,0.022222222222222223,0.9777777777777777,180,5350,3800,1550,0.7102803738317757,69,38,31,234.7228615418827,0.47653049348230914,0.7684760956175327,0.1332928467126968,1041063.5203912908,7522.2817106214425,1048585.8021019122,541,0,183.76111111111112,81,99,38,38.931357901726415,0.5367476851851851,44.91869918699184,8162.601626016175,100.7728595804466,0
543,32,2,1,177,0.011235955056179775,0.0056179775280898875,0.9943820224719101,178,5650,4000,1650,0.7079646017699115,73,40,33,229.37768355963465,0.4766195327874056,0.7620043874032492,0.130940447311865,1042691.5381998008,6584.0339399004,1049275.572139701,542,0,184.47752808988764,71,107,39,38.8637597997544,0.5393258426966292,44.719328703703695,8168.981481481465,115.0560772039643,0
544,32,2,4,175,0.0111731843575419,0.0223463687150838,0.9776536312849162,179,5350,4000,1350,0.7476635514018691,67,40,27,224.32416128827026,0.47613536501161263,0.7730457821664827,0.1308897934590985,1049455.2344613327,5933.633056024691,1055388.8675173575,543,0,184.31284916201116,72,107,39,38.14758840353615,0.545332867783985,43.89269406392694,8195.433789954333,113.8254693049213,8
545,32,3,1,177,0.016853932584269662,0.0056179775280898875,0.9943820224719101,178,6650,4900,1750,0.7368421052631579,84,49,35,226.34511543952135,0.47554434076049007,0.773233279863841,0.13323198985551166,1052141.0034758365,5379.395378078438,1057520.3988539148,544,0,184.02247191011236,61,117,38,37.760911463451926,0.5478698501872659,43.565188172043015,8205.913978494633,134.52317997532185,0
546,32,1,4,174,0.0056179775280898875,0.02247191011235955,0.9775280898876404,178,5850,4300,1550,0.7350427350427351,74,43,31,224.5219801619759,0.47582008188916397,0.7689671836789114,0.1285638599780995,1043647.9855371894,5414.382460973354,1049062.3679981628,545,0,184.8370786516854,65,113,38,38.86803238165865,0.539501404494382,44.60227272727273,8172.7272727272675,125.73426573426565,8
547,32,3,2,175,0.01694915254237288,0.011299435028248588,0.9887005649717514,177,4900,3600,1300,0.7346938775510204,62,36,26,240.65674980134685,0.47624015579524054,0.7787670743045136,0.14008756067383657,1048727.7091906716,10176.68038408782,1058904.3895747594,546,0,186.68926553672316,71,106,35,37.820223025919255,0.544138418079096,43.98148148148148,8192.592592592588,115.38862806468433,8
548,32,4,2,177,0.0223463687150838,0.0111731843575419,0.9888268156424581,179,5200,3100,2100,0.5961538461538461,73,31,42,242.29579086395236,0.4766950704078003,0.7713974495346352,0.13810945484881829,1042229.5915276506,9505.568628201272,1051735.1601558519,547,0,185.56424581005587,65,114,40,38.59191093109066,0.5373021415270018,44.77588383838384,8167.17171717172,125.6487956487957,8
549,32,4,3,178,0.022099447513812154,0.016574585635359115,0.9834254143646409,181,6150,4200,1950,0.6829268292682927,81,42,39,233.87722498723338,0.47691579701248205,0.7640682927613847,0.13456754905044394,1045141.1033163317,6536.940192744056,1051678.043509076,548,0,184.3314917127072,69,112,41,38.44220038816109,0.5405732044198894,44.419642857142875,8178.57142857147,118.53002070393435,0
550,32,1,2,177,0.00558659217877095,0.0111731843575419,0.9888268156424581,179,6300,4600,1700,0.7301587301587301,80,46,34,251.3540673555105,0.4762177515535748,0.7920823526075489,0.1482537463144776,1052761.5017361098,10823.17708333325,1063584.678819443,549,0,186.95530726256985,59,120,38,37.042089678511005,0.5497555865921788,43.48958333333333,8208.333333333323,139.12429378531056,8
551,32,0,2,175,0.0,0.011299435028248588,0.9887005649717514,177,5450,3900,1550,0.7155963302752294,70,39,31,251.79512212479932,0.4756409433316213,0.7893366846567154,0.1487016475944568,1053147.0034936834,12185.455672011623,1065332.4591656951,550,1,188.89265536723164,60,117,41,36.98263334220801,0.5505532015065913,43.44262295081967,8209.836065573762,136.83060109289602,0
552,32,2,2,175,0.011299435028248588,0.011299435028248588,0.9887005649717514,177,5200,3800,1400,0.7307692307692307,66,38,28,239.6584286250526,0.4753185991268618,0.7793914797845298,0.14118275299670333,1052388.305373592,9842.745513843549,1062231.0508874357,551,0,189.66101694915255,62,115,40,37.388654288354495,0.552554143126177,43.53505291005292,8206.878306878325,132.36900494965042,7
553,32,1,2,174,0.005681818181818182,0.011363636363636364,0.9886363636363636,176,5550,4100,1450,0.7387387387387387,70,41,29,234.19641635635952,0.47508725649350647,0.7724952735572819,0.13886262702152297,1054365.3021918426,8635.715060764007,1063001.0172526066,552,0,190.85795454545453,63,113,40,37.28231465043535,0.5548650568181819,43.29427083333334,8214.583333333352,130.39021164021193,0
554,32,2,4,172,0.011363636363636364,0.022727272727272728,0.9772727272727273,176,5200,3700,1500,0.7115384615384616,67,37,30,226.50946021978393,0.4747219967532468,0.7640591755133492,0.13511716756752923,1056197.394557956,7447.740345373117,1063645.134903329,553,0,191.60227272727272,65,111,37,37.251661138071555,0.556640625,43.071338383838395,8221.717171717193,126.48795648795682,0
555,32,0,4,168,0.0,0.023255813953488372,0.9767441860465116,172,5650,4000,1650,0.7079646017699115,73,40,33,226.0924681185908,0.4737862097103223,0.7588294560182842,0.13549079332934097,1057591.868622451,7772.711167800566,1065364.5797902516,554,1,195.76162790697674,69,103,38,37.088988732611774,0.5592296511627908,42.90178571428572,8227.142857142873,119.233954451346,0
556,32,1,1,168,0.005917159763313609,0.005917159763313609,0.9940828402366864,169,5150,3500,1650,0.6796116504854369,68,35,33,211.19324054954544,0.47285767117497884,0.7440451623972815,0.12361586006478109,1050419.186787321,5418.286398607022,1055837.473185928,555,0,198.52662721893492,82,87,42,38.36380371603971,0.5555350098619329,43.77510040160646,8199.196787148681,99.99020472132538,8
557,32,1,0,169,0.005917159763313609,0.0,1.0,169,5650,3700,1950,0.6548672566371682,76,37,39,208.29828841556548,0.4725905771578849,0.7414959543674657,0.1229958691221028,1053102.3040210968,4421.881490816559,1057524.1855119134,556,0,199.4792899408284,68,101,44,38.10413479267196,0.5580004930966469,43.44806763285024,8209.661835748788,120.73032111395275,0
558,32,3,0,172,0.01744186046511628,0.0,1.0,172,5700,4100,1600,0.7192982456140351,73,41,32,207.66496981255625,0.47271875991658735,0.7473456934705822,0.11957965760879258,1045384.5273526085,3317.949263038623,1048702.476615647,557,0,196.9825581395349,69,103,39,39.08175418680017,0.5465721899224807,44.389880952380956,8179.523809523816,118.54382332643212,8
559,32,1,1,172,0.005780346820809248,0.005780346820809248,0.9942196531791907,173,5650,4300,1350,0.7610619469026548,70,43,27,207.424932114436,0.4727421920509029,0.747317209125395,0.12001712141852315,1046870.0277777852,3179.3888888892943,1050049.4166666744,558,0,196.83815028901734,74,99,45,38.90257642395613,0.5481695568400771,44.20833333333336,8185.333333333392,110.6126126126134,0
560,32,4,3,173,0.022727272727272728,0.017045454545454544,0.9829545454545454,176,4650,2800,1850,0.6021505376344086,65,28,37,195.9715039457045,0.4725642586580086,0.7367939012183122,0.11439425195579976,1049583.5915295216,1287.6949897551503,1050871.2865192767,559,0,194.17613636363637,81,95,40,38.857752207122324,0.5509588068181819,43.87703252032523,8195.934959349663,101.18438221419336,0
561,32,1,1,173,0.005747126436781609,0.005747126436781609,0.9942528735632183,174,5650,4000,1650,0.7079646017699115,73,40,33,192.92721613861602,0.4716214869443891,0.7306022146339541,0.11317792028010776,1051106.2757609773,107.40152967862468,1051213.677290656,560,0,197.316091954023,70,104,45,38.74642243846594,0.5529214559386972,43.691314553990594,8201.877934272263,117.16968477531805,0
562,32,2,2,173,0.011428571428571429,0.011428571428571429,0.9885714285714285,175,5450,3600,1850,0.6605504587155964,73,36,37,188.27281850027407,0.4720032840722496,0.725843792381685,0.1110681635328739,1052819.2751450709,-806.5495394046056,1052012.7256056662,561,0,197.10857142857142,73,102,45,38.653018621156406,0.5554166666666667,43.48254504504502,8208.558558558505,112.44600765148637,0
563,32,3,2,174,0.017045454545454544,0.011363636363636364,0.9886363636363636,176,5000,3700,1300,0.74,63,37,26,201.9209891859833,0.47199810606060605,0.7405454053231679,0.11433185106751438,1040154.23138336,1805.7942613826067,1041960.0256447427,562,0,196.4090909090909,82,94,37,39.881743453435696,0.5397727272727273,45.030120481927696,8159.0361445782755,99.50044078753994,8
564,32,2,2,174,0.011363636363636364,0.011363636363636364,0.9886363636363636,176,5800,4300,1500,0.7413793103448276,73,43,30,199.08545653240773,0.4715746753246753,0.7382100018548667,0.11360490928388796,1042573.3560528164,512.2385116601135,1043085.5945644765,563,0,196.9943181818182,71,105,41,39.65181742613165,0.5421401515151515,44.73379629629631,8168.518518518553,115.04955659885286,0
565,32,1,5,170,0.005714285714285714,0.02857142857142857,0.9714285714285714,175,6600,4500,2100,0.6818181818181818,87,45,42,191.81214086530858,0.47158730158730156,0.721948880642542,0.11146385517203704,1048200.9882682267,-1388.4648766274759,1046812.5233915993,564,0,199.06857142857143,80,95,40,39.13626923914316,0.549404761904762,44.04578189300414,8190.534979423938,102.38168724279923,8
566,32,1,3,168,0.005847953216374269,0.017543859649122806,0.9824561403508771,171,6100,4700,1400,0.7704918032786885,75,47,28,199.46757157118947,0.4716632266941865,0.7091851155510724,0.11324167891263257,1040979.2014685591,1228.3186746100082,1042207.5201431691,565,0,203.50292397660817,90,81,32,39.84119059372619,0.5431286549707602,44.929029304029314,8162.271062271088,90.69190069190098,8
567,32,3,0,171,0.017543859649122806,0.0,1.0,171,6300,4900,1400,0.7777777777777778,77,49,28,204.35015486224555,0.4717477926843252,0.7156644292563747,0.11712584347821076,1043946.3904816004,2166.1213125592367,1046112.5117941597,566,0,203.83040935672514,82,89,35,39.34596046446881,0.5466008771929824,44.56576305220882,8173.89558232928,99.68165344304,0
568,32,3,3,171,0.017241379310344827,0.017241379310344827,0.9827586206896551,174,5550,3500,2050,0.6306306306306306,76,35,41,233.50625699743745,0.47210664296945937,0.7465155908940515,0.13483522862275463,1046246.3480349751,8511.013725377212,1054757.3617603523,567,0,201.29885057471265,75,99,39,38.313423469296595,0.5456776819923372,44.28453947368422,8182.894736842128,109.10526315789504,8
569,32,0,1,170,0.0,0.005847953216374269,0.9941520467836258,171,6000,4600,1400,0.7666666666666667,74,46,28,229.07186300401247,0.471766425868593,0.7393431363982699,0.13304693305984247,1048041.6119623375,7815.368911588311,1055856.9808739258,568,1,205.78947368421052,75,96,33,38.2024960281333,0.5474537037037037,44.065241228070185,8189.912280701778,109.19883040935704,0
570,32,1,3,168,0.005847953216374269,0.017543859649122806,0.9824561403508771,171,4500,3000,1500,0.6666666666666666,60,30,30,232.83497377925426,0.4715643274853801,0.7487961367692371,0.1362760940475617,1050403.1502408178,10214.117988793609,1060617.2682296115,569,0,203.78947368421052,76,95,40,37.8112900387188,0.5494030214424952,43.777056277056296,8199.134199134241,107.88334472545054,0
571,32,1,1,168,0.005917159763313609,0.005917159763313609,0.9940828402366864,169,6050,4600,1450,0.7603305785123967,75,46,29,234.43539221606983,0.4712037428383582,0.7471108904449664,0.13804956975449495,1052263.7663935225,9487.573757844613,1061751.340151367,570,0,206.1301775147929,72,97,41,37.53813802952739,0.5522066074950691,43.55022831050226,8206.392694063881,113.97767630644279,0
572,32,2,0,170,0.011764705882352941,0.0,1.0,170,4900,3200,1700,0.6530612244897959,66,32,34,231.8037913614924,0.47130902656920753,0.7489053534090153,0.1374536245022284,1054386.6944444433,9982.166666666646,1064368.86111111,571,0,205.58823529411765,74,96,40,37.34107017259102,0.5541666666666667,43.291666666666664,8214.666666666659,111.0090090090089,0
573,32,1,0,171,0.005847953216374269,0.0,1.0,171,5150,3100,2050,0.6019417475728155,72,31,41,256.4868219713402,0.47185385850246536,0.7835771850017896,0.144675308838818,1038962.035667324,13946.01413543722,1052908.0498027613,572,0,205.38011695906434,64,107,34,38.640389493323276,0.5340521442495128,45.17628205128205,8154.358974358973,127.41185897435895,8
574,32,3,0,174,0.017241379310344827,0.0,1.0,174,6250,4300,1950,0.688,82,43,39,252.11601376744943,0.4724250049830576,0.7941628028372274,0.14626450068088023,1047690.8535427564,11777.928331163503,1059468.78187392,573,0,202.82183908045977,63,111,37,37.656627655514576,0.5440014367816092,44.108072916666686,8188.541666666703,129.97685185185244,8
575,32,5,2,177,0.027932960893854747,0.0111731843575419,0.9888268156424581,179,5000,3400,1600,0.68,66,34,32,253.13413147008066,0.4739619295712761,0.7943034954230506,0.14678644837258795,1047546.6571112853,12233.962644450074,1059780.6197557354,574,0,198.12849162011173,60,119,36,37.648630761701334,0.5356727188081937,44.12568306010927,8187.978142076463,136.46630236794104,8
576,32,2,2,177,0.0111731843575419,0.0111731843575419,0.9888268156424581,179,6050,4400,1650,0.7272727272727273,77,44,33,251.25791558571373,0.4744549411001611,0.7986611082230808,0.14099772990572665,1037348.0042452719,10278.379456733586,1047626.3837020055,575,0,199.01117318435755,58,121,40,38.9766213655064,0.5246159217877095,45.37429378531075,8148.022598870088,140.48314825638082,8
577,32,5,5,177,0.027472527472527472,0.027472527472527472,0.9725274725274725,182,6650,5100,1550,0.7669172932330827,82,51,31,244.2523798435894,0.4752532228360958,0.7964978618650531,0.1387519952623627,1041170.4550849093,7811.672295464596,1048982.127380374,576,0,196.37362637362637,63,119,37,38.67485750441311,0.5283882783882784,44.90559895833334,8163.020833333355,129.5717592592596,0
578,32,4,2,179,0.022099447513812154,0.011049723756906077,0.988950276243094,181,6200,4200,2000,0.6774193548387096,82,42,40,213.3264071697813,0.47478898096992017,0.7657896374263042,0.12093200925135815,1040521.4321145173,1994.1397392293252,1042515.5718537467,577,0,197.59668508287294,69,112,42,39.54497821477894,0.5325161141804788,44.985119047619065,8160.476190476229,118.26777087646708,7
579,32,3,1,181,0.016483516483516484,0.005494505494505495,0.9945054945054945,182,7000,4800,2200,0.6857142857142857,92,48,44,238.62667245610828,0.47560674822415155,0.7841080973025021,0.134715109757395,1039227.0913233676,6197.460545746866,1045424.5518691144,578,0,195.03296703296704,70,112,33,39.06223015370444,0.528331043956044,45.14377934272299,8155.39906103284,116.50570087189772,8
580,32,3,5,179,0.016304347826086956,0.02717391304347826,0.9728260869565217,184,5950,4000,1950,0.6722689075630253,79,40,39,226.85183992378262,0.47582437435653757,0.7837107730244024,0.12965935437845547,1043077.1298038154,4574.7932156826955,1047651.9230194981,579,0,193.8695652173913,60,124,40,38.879971464241144,0.5314764492753623,44.67213114754098,8170.491803278683,136.17486338797804,8
581,32,2,0,181,0.011049723756906077,0.0,1.0,181,5950,4800,1150,0.8067226890756303,71,48,23,220.62583266504922,0.47595278289339066,0.7740811525969216,0.12691527709354863,1045073.4905587706,3964.0418101394366,1049037.53236891,580,0,197.31491712707182,62,119,43,38.78932953785771,0.5336095764272559,44.427910052910036,8178.306878306843,131.908175456562,0
582,32,2,4,179,0.01092896174863388,0.02185792349726776,0.9781420765027322,183,6150,4200,1950,0.6829268292682927,81,42,39,241.3376749606319,0.4760941472007046,0.7881900242192266,0.134764666283326,1035798.6472424536,7245.447450572193,1043044.0946930258,581,0,196.14754098360655,61,122,39,39.42402931854198,0.52367941712204,45.56451612903225,8141.9354838709505,133.47435219460576,8
583,32,1,1,179,0.005555555555555556,0.005555555555555556,0.9944444444444445,180,5800,4400,1400,0.7586206896551724,72,44,28,244.74471079064213,0.47550499172356714,0.787676929086325,0.13738898458269072,1037453.6514282209,8982.258775499009,1046435.91020372,582,0,196.49444444444444,63,117,39,39.129181314583995,0.526099537037037,45.36132812499999,8148.437499999986,129.34027777777757,0
584,32,4,2,181,0.02185792349726776,0.01092896174863388,0.9890710382513661,183,6650,5000,1650,0.7518796992481203,83,50,33,214.25115070117982,0.4767084008887288,0.7628284935197545,0.12046922734251986,1037969.476728617,1227.230956361915,1039196.7076849788,583,0,194.21857923497268,71,112,44,39.841013443150665,0.5266393442622951,45.29803240740743,8150.4629629630235,114.7952529994792,8
585,32,3,2,182,0.016304347826086956,0.010869565217391304,0.9891304347826086,184,5650,3500,2150,0.6194690265486725,78,35,43,201.3566651298982,0.47739343272352897,0.752556785931743,0.11235968611818058,1035576.6178907346,-745.9491470045155,1034830.66874373,584,0,193.71195652173913,68,116,44,40.46910851333175,0.5226449275362319,45.59178743961353,8141.062801932383,119.72151179312328,8
586,32,3,1,184,0.016216216216216217,0.005405405405405406,0.9945945945945946,185,5950,4500,1450,0.7563025210084033,74,45,29,196.36155693221932,0.47808827849588714,0.747088546904235,0.11047405545875613,1038150.5130155025,-2179.429786858445,1035971.083228644,585,0,191.38918918918918,70,115,47,40.274017970279914,0.5251689189189189,45.27582159624416,8151.173708920246,116.44533869886065,0
587,32,3,2,185,0.016042780748663103,0.0106951871657754,0.9893048128342246,187,5650,4000,1650,0.7079646017699115,73,40,33,218.82870047639835,0.47822029593851223,0.7687607272173256,0.12083830385067257,1032273.8246383384,2128.2279162812883,1034402.0525546197,586,0,188.66844919786095,75,112,37,40.43951003669327,0.5179924242424243,45.99780701754382,8128.070175438503,108.3742690058467,8
588,32,4,1,188,0.021164021164021163,0.005291005291005291,0.9947089947089947,189,6350,4300,2050,0.6771653543307087,84,43,41,201.60766421588576,0.47865304514240686,0.7543500127610365,0.11077196160814963,1030684.5162492202,-2591.220427102803,1028093.2958221175,587,0,187.61904761904762,80,109,34,41.07648037427373,0.5168099647266313,46.19341563786009,8121.810699588505,101.52263374485631,7
589,32,6,3,191,0.030927835051546393,0.015463917525773196,0.9845360824742269,194,5950,4300,1650,0.7226890756302521,76,43,33,194.16346438829873,0.4797575806135712,0.7569133958423835,0.10969862141388315,1039469.2558736396,-4384.609630889736,1035084.6462427499,588,0,182.27319587628867,83,111,38,40.165134118257576,0.5300687285223368,45.11408730158728,8156.349206349158,98.26926754637539,8
590,32,4,3,192,0.020512820512820513,0.015384615384615385,0.9846153846153847,195,6300,4300,2000,0.6825396825396826,83,43,40,193.9203068751338,0.4797988809586748,0.7606879078868494,0.11073484526093921,1042790.5608311027,-4856.346887427899,1037934.2139436748,589,0,182.3025641025641,73,122,40,39.75656153506838,0.5331196581196581,44.70720720720721,8169.3693693693795,111.90916944341616,0
591,32,1,0,193,0.0051813471502590676,0.0,1.0,193,6400,4300,2100,0.671875,85,43,42,192.87753742022076,0.47958832577720206,0.7561167957774568,0.11083857025648197,1044753.8962210269,-4698.0882573413,1040055.8079636856,590,0,184.2901554404145,76,117,44,39.538333598037624,0.5356757340241796,44.46699134199135,8177.056277056309,107.5928457507409,0
592,32,4,1,196,0.02030456852791878,0.005076142131979695,0.9949238578680203,197,5400,3300,2100,0.6111111111111112,75,33,42,199.9085407075676,0.4805026071342242,0.7676119935447396,0.11250452731259575,1038247.7808641968,-3289.0802469135456,1034958.7006172832,591,0,181.5279187817259,74,123,43,40.17149646511457,0.5255922165820643,45.263888888888886,8151.55555555555,110.15615615615609,8
593,32,7,5,198,0.034482758620689655,0.024630541871921183,0.9753694581280788,203,6750,5000,1750,0.7407407407407407,85,50,35,194.32217377047198,0.4815016908094751,0.7694978182941759,0.11109789584953264,1043164.333767365,-6808.007812499725,1036356.3259548652,592,0,177.0886699507389,71,132,41,39.69966428692848,0.5297619047619048,44.66145833333335,8170.833333333364,115.08215962441358,0
594,32,4,4,198,0.019801980198019802,0.019801980198019802,0.9801980198019802,202,6200,3700,2500,0.5967741935483871,87,37,50,224.9305793067427,0.48083786923468463,0.7918900188392495,0.12845477553385753,1042819.7151413985,312.4085278495504,1043132.1236692481,593,0,178.75742574257427,70,132,38,38.96124264888992,0.5320235148514851,44.70363849765259,8169.483568075137,116.7069081153591,8
595,32,4,2,200,0.019801980198019802,0.009900990099009901,0.9900990099009901,202,5100,3300,1800,0.6470588235294118,69,33,36,219.96561596656292,0.48075731080570744,0.7883846679208764,0.1270852690779924,1046413.8603099658,535.0138678062394,1046948.8741777721,594,0,179.490099009901,76,126,44,38.63875811115812,0.5351691419141914,44.26406926406927,8183.549783549796,107.67828662565522,0
596,32,1,11,190,0.004975124378109453,0.05472636815920398,0.945273631840796,201,6250,4200,2050,0.672,83,42,41,219.5521576657281,0.4803368573797678,0.7862144902346921,0.1276359176821059,1048326.5789365605,-417.52753122916783,1047909.0514053314,595,0,181.18407960199005,77,124,37,38.41058198987846,0.5371061359867331,44.03044871794874,8191.025641025685,106.37695637695695,0
597,32,1,3,188,0.005235602094240838,0.015706806282722512,0.9842931937172775,191,6650,4900,1750,0.7368421052631579,84,49,35,224.94699914703543,0.4796557821254708,0.7824160449721989,0.1310332052094104,1048939.8210266682,2341.1730051557934,1051280.994031824,596,0,189.16230366492147,75,116,39,38.19594998483309,0.5385034904013961,43.95559210526318,8193.421052631627,109.24561403508837,0
598,32,1,2,187,0.005291005291005291,0.010582010582010581,0.9894179894179894,189,5650,3700,1950,0.6548672566371682,76,37,39,239.14647883862494,0.479309730196255,0.7954521757456776,0.13819835459366023,1046483.8681336505,6602.586445117326,1053086.4545787678,597,0,191.96825396825398,67,122,40,38.139475391833905,0.5340608465608465,44.255514705882355,8183.823529411765,122.14661984196664,8
599,32,1,2,186,0.005319148936170213,0.010638297872340425,0.9893617021276596,188,5650,3800,1850,0.672566371681416,75,38,37,232.58552489072162,0.47921644479842224,0.787808252006766,0.13498992891230446,1047818.6573465955,5491.490481849868,1053310.1478284453,598,0,193.95744680851064,72,116,37,38.14042693580162,0.535793439716312,44.09246575342466,8189.041095890423,113.73668188736698,0
600,32,2,1,187,0.010638297872340425,0.005319148936170213,0.9946808510638298,188,6000,3900,2100,0.65,81,39,42,213.94767298896735,0.47912637008381687,0.7734336816075598,0.11915294039157473,1034962.1964631615,685.5507129688003,1035647.7471761303,599,0,194.61170212765958,68,120,35,40.22588096792701,0.5213874113475176,45.667270531400966,8138.64734299517,119.68599033816427,8
601,32,4,1,190,0.020942408376963352,0.005235602094240838,0.9947643979057592,191,5650,4100,1550,0.7256637168141593,72,41,31,205.41576110495123,0.4797269679434188,0.7683039335341888,0.11569378545008775,1038491.2871916713,-1185.5043681327124,1037305.7828235386,600,0,192.4764397905759,72,119,40,40.00072346066241,0.5243782722513088,45.23401826484017,8152.511415525072,113.229325215626,0
602,32,1,3,188,0.005235602094240838,0.015706806282722512,0.9842931937172775,191,5250,3400,1850,0.6476190476190476,71,34,37,222.24786746238243,0.47986589510425276,0.7854370375412212,0.1218818980473812,1030084.0326003052,2336.795910493665,1032420.8285107989,601,0,193.45549738219896,71,120,41,40.628207321245306,0.518651832460733,46.2673611111111,8119.444444444416,114.35837245696361,8
603,32,1,0,189,0.005291005291005291,0.0,1.0,189,5000,3500,1500,0.7,65,35,30,253.4290750785908,0.4802314345754062,0.8024757776879659,0.13946046009041685,1031175.3332134368,9465.962188027428,1040641.2954014642,602,0,194.8941798941799,72,117,37,39.69926273584022,0.5160934744268078,46.132990867579885,8123.744292237383,112.82978183663032,8
604,32,4,4,189,0.02072538860103627,0.02072538860103627,0.9792746113989638,193,6550,4400,2150,0.6717557251908397,87,44,43,246.34233402390004,0.48099947826712725,0.802659963349635,0.13715959145253195,1034882.3350694457,5837.065972222268,1040719.4010416679,603,0,191.8341968911917,59,134,42,39.41203324459003,0.51948402417962,45.677083333333336,8138.333333333343,137.9378531073448,0
605,32,3,3,189,0.015625,0.015625,0.984375,192,5400,4100,1300,0.7592592592592593,67,41,26,242.16452387599415,0.48108627381471786,0.8017196823615194,0.13681704953813484,1039466.4067149379,6544.377493442619,1046010.7842083805,604,0,190.51041666666666,70,122,34,38.94201250983326,0.5224066840277778,45.11443661971831,8156.338028169017,116.51911468812881,7
606,32,1,1,189,0.005263157894736842,0.005263157894736842,0.9947368421052631,190,6850,4600,2250,0.6715328467153284,91,46,45,213.43924213629955,0.48072670101178877,0.77023568370107,0.11980761599345521,1037433.1041019259,-564.2128986749358,1036868.891203251,605,0,192.85263157894738,70,120,43,39.928915072597356,0.528125,45.36384976525824,8148.3568075117855,116.40509725016837,8
607,32,5,3,191,0.02577319587628866,0.015463917525773196,0.9845360824742269,194,6100,4300,1800,0.7049180327868853,79,43,36,222.93974380581187,0.4810773997115539,0.7886817116093079,0.12844636549383526,1045555.6467187112,1719.1816028380044,1047274.8283215492,606,0,189.84536082474227,68,126,39,38.66992952617176,0.5375859106529209,44.36896135265701,8180.193236714987,120.29695936345568,8
608,32,2,5,188,0.010362694300518135,0.025906735751295335,0.9740932642487047,193,6100,4600,1500,0.7540983606557377,76,46,30,217.79639864346953,0.48078358880253314,0.7819787982884985,0.12648390286174682,1048007.1882716086,950.4382716050659,1048957.6265432136,607,0,191.26943005181346,74,119,37,38.49536911416219,0.5399395509499136,44.06944444444446,8189.7777777778065,110.67267267267306,0
609,32,1,2,187,0.005291005291005291,0.010582010582010581,0.9894179894179894,189,6150,4100,2050,0.6666666666666666,82,41,41,220.64392467481198,0.4804859000337724,0.7811152649247874,0.12882501463204807,1049652.124058648,2369.8728391106533,1052021.9968977587,608,0,194.015873015873,78,111,38,38.217288717288724,0.5423831569664903,43.86867088607596,8196.202531645598,105.07951963648203,0
610,32,2,2,187,0.010582010582010581,0.010582010582010581,0.9894179894179894,189,6250,4500,1750,0.72,80,45,35,221.0996663655332,0.48058323013996773,0.7826627237914021,0.130114592185175,1052071.0100263024,2472.5098619331293,1054543.5198882355,609,0,193.88359788359787,64,125,41,37.904141407828696,0.5446979717813052,43.57371794871796,8205.641025641056,128.2131410256415,0
611,32,2,2,187,0.010582010582010581,0.010582010582010581,0.9894179894179894,189,5800,4400,1400,0.7586206896551724,72,44,28,216.84239398661086,0.4805844027918496,0.7780626757036657,0.12869562516171287,1054655.6441326523,2138.8109410430307,1056794.4550736954,610,0,194.4920634920635,69,120,44,37.69169371510269,0.5472883597883598,43.25892857142857,8215.714285714279,119.06832298136636,0
612,32,2,1,188,0.010582010582010581,0.005291005291005291,0.9947089947089947,189,5950,4200,1750,0.7058823529411765,77,42,35,197.25100625455306,0.4802466790498705,0.7523547929914347,0.11580163448701587,1051336.9261188165,-2274.5466820993684,1049062.3794367171,611,0,195.0952380952381,71,118,41,38.606925160853365,0.5490520282186948,43.66319444444441,8202.777777777694,115.53208137715062,8
613,32,1,1,188,0.005291005291005291,0.005291005291005291,0.9947089947089947,189,5800,4000,1800,0.6896551724137931,76,40,36,232.4564022806546,0.48014583098802954,0.7887007209078412,0.13457885309481823,1047049.7809887617,5078.685019479085,1052128.4660082408,612,0,194.72486772486772,73,116,38,38.2398223555091,0.5421626984126984,44.18637387387388,8186.036036036057,112.13747994569941,8
614,32,4,3,189,0.020833333333333332,0.015625,0.984375,192,6400,4500,1900,0.703125,83,45,38,229.6331626073786,0.4803488810718441,0.7897606608902477,0.13173691960107553,1044228.5156250037,3157.8993055558276,1047386.4149305596,613,0,192.05208333333334,67,125,41,38.66484029901463,0.53759765625,44.531250000000014,8175.000000000029,122.01492537313476,8
615,32,3,1,191,0.015625,0.005208333333333333,0.9947916666666666,192,6450,4500,1950,0.6976744186046512,84,45,39,199.94962104919816,0.4799051956079116,0.7653816862190559,0.11328896333274174,1040356.4107129838,-3246.2259843669035,1037110.1847286168,614,0,192.8125,77,115,42,39.906733354282295,0.5317925347222222,45.00534188034189,8159.8290598290805,105.97180597180623,8
616,32,0,1,190,0.0,0.005235602094240838,0.9947643979057592,191,6050,4300,1750,0.7107438016528925,78,43,35,198.46857493873873,0.47978322770276477,0.7625401463803996,0.11288556511065845,1041562.3497836897,-2906.5209457173173,1038655.8288379724,615,1,194.71204188481676,78,113,44,39.79381998277347,0.5335405759162304,44.857594936708864,8164.556962025326,104.6738072054529,0
617,32,2,3,189,0.010416666666666666,0.015625,0.984375,192,6550,4700,1850,0.7175572519083969,84,47,37,213.6691004961514,0.47999722767597436,0.7731636109531939,0.12148937483103212,1041454.6975422354,-444.66231373194387,1041010.0352285034,616,0,194.67708333333334,78,114,41,39.4194575085706,0.5365668402777778,44.87078059071729,8164.13502109702,104.66839770637206,8
618,32,5,2,192,0.02577319587628866,0.010309278350515464,0.9896907216494846,194,6400,4700,1700,0.734375,81,47,34,223.07371928363148,0.48023331641828254,0.785293498842836,0.12710014238253445,1042100.6944444459,1293.0555555556248,1043393.7500000015,617,0,192.95876288659792,76,118,41,39.098639455782326,0.5383913230240549,44.79166666666667,8166.666666666679,107.45614035087735,8
619,32,2,2,192,0.010309278350515464,0.010309278350515464,0.9896907216494846,194,6550,5000,1550,0.7633587786259542,81,50,31,220.9524016756132,0.4803924514359988,0.7865692334001073,0.12465496458169667,1039020.7472753193,564.8259002545374,1039585.5731755738,618,0,193.7164948453608,68,126,38,39.538531793049,0.5304445876288659,45.16908212560388,8154.589371980706,119.92043194089274,8
620,32,4,0,196,0.02040816326530612,0.0,1.0,196,5250,3200,2050,0.6095238095238096,73,32,41,214.4106622240725,0.48108320251177394,0.7829862557267799,0.12216421452301865,1042100.6944444501,237.50000000031923,1042338.1944444504,619,0,191.9234693877551,74,122,43,39.31972789115649,0.5334821428571428,44.791666666666686,8166.6666666667115,110.36036036036097,0
621,32,2,2,196,0.010101010101010102,0.010101010101010102,0.98989898989899,198,7250,5400,1850,0.7448275862068966,91,54,37,219.25020449870152,0.4814740039993847,0.7853214001362157,0.12452560158421361,1041111.7495943722,-1197.207199086728,1039914.5423952854,620,0,190.9747474747475,85,113,37,39.31999841722065,0.5337752525252526,44.91279069767441,8162.790697674394,96.03283173734582,8
622,32,2,1,197,0.010101010101010102,0.005050505050505051,0.9949494949494949,198,5850,3700,2150,0.6324786324786325,80,37,43,207.3447821073452,0.4814387530123571,0.7798159134531484,0.11871058404167813,1043602.4605920824,-2172.895040368935,1041429.5655517135,621,0,190.26767676767676,67,131,42,39.312420025591805,0.5380892255892256,44.60784313725491,8172.549019607863,121.97834357623675,8
623,32,3,0,200,0.015,0.0,1.0,200,6250,4200,2050,0.672,83,42,41,201.0636134988293,0.48137824539363483,0.7753503486750339,0.11629768544583842,1046767.2464346085,-4156.638987927415,1042610.607446681,622,0,189.33,72,128,45,39.0781032078103,0.5410937499999999,44.22089041095892,8184.931506849358,113.67960426179664,0
624,32,1,5,196,0.004975124378109453,0.024875621890547265,0.9751243781094527,201,6850,5300,1550,0.7737226277372263,84,53,31,222.8087971256422,0.4811898839137645,0.7922767045125316,0.12643682041181195,1040840.7874180676,-668.3032312152873,1040172.4841868522,623,0,189.38308457711443,80,121,37,39.26315988504007,0.5341003316749585,44.94598765432096,8161.7283950616575,102.02160493827071,8
625,32,0,4,192,0.0,0.02040816326530612,0.9795918367346939,196,5700,4000,1700,0.7017543859649122,74,40,34,211.65660062522906,0.4808499040641898,0.7770052416376965,0.12050599422531902,1041870.7897086298,-796.2340719095919,1041074.5556367203,624,1,195.0,73,123,43,39.41876287143278,0.533375850340136,44.81981981981983,8165.765765765784,111.85980501049019,8
626,32,2,4,190,0.010309278350515464,0.020618556701030927,0.979381443298969,194,6450,4400,2050,0.6821705426356589,85,44,41,205.0270116931171,0.4804330698146466,0.7676313881269896,0.11762075933973573,1044228.515625002,-2430.9895833332266,1041797.5260416687,625,0,197.46907216494844,67,127,46,39.293450560652396,0.5360824742268041,44.53125000000001,8175.0000000000155,122.01492537313456,0
627,32,3,2,191,0.015544041450777202,0.010362694300518135,0.9896373056994818,193,5900,4200,1700,0.711864406779661,76,42,34,213.35209458237136,0.4798132106361543,0.764402480350103,0.12104600299220135,1040777.8120713223,-89.57475994545166,1040688.2373113768,626,0,197.8082901554404,89,104,38,39.51223755067468,0.5381044905008636,44.95370370370368,8161.481481481416,91.70203911776872,8
628,32,2,4,189,0.010362694300518135,0.02072538860103627,0.9792746113989638,193,6550,4400,2150,0.6717557251908397,87,44,43,206.51117802559477,0.4796231829303397,0.7557612678041059,0.11807696542611758,1043191.6137044347,-2063.854189495265,1041127.7595149395,627,0,198.7461139896373,77,116,41,39.38502440725245,0.5411269430051813,44.65811965811966,8170.9401709401745,106.11610611610617,0
629,32,2,1,190,0.010471204188481676,0.005235602094240838,0.9947643979057592,191,6650,5200,1450,0.7819548872180451,81,52,29,204.00025366425325,0.47938366859557274,0.7530000508809873,0.11774224272395173,1046101.7665037661,-2168.9948549216842,1043932.7716488444,628,0,198.6282722513089,82,109,38,39.08596740944346,0.5445571553228621,44.30220883534137,8182.3293172690765,99.78450386913508,0
630,32,2,3,189,0.010416666666666666,0.015625,0.984375,192,6250,4200,2050,0.672,83,42,41,198.38872654717034,0.4792098422047702,0.7474130571358095,0.11521253442590333,1048005.8956934427,-3067.4889878901085,1044938.4067055526,629,0,198.53645833333334,87,105,34,38.992231703744835,0.546875,44.06960227272728,8189.772727272748,94.13531870428446,0
631,32,2,5,186,0.010471204188481676,0.02617801047120419,0.9738219895287958,191,6450,4800,1650,0.7441860465116279,81,48,33,196.0961536662759,0.47958804078258477,0.7556855673605718,0.1127825071332944,1045012.9967874804,-3665.394159741034,1041347.6026277394,630,0,200.4607329842932,75,116,40,39.42378168686761,0.543357329842932,44.435307017543884,8178.0701754386555,109.0409356725154,8
632,32,2,5,183,0.010638297872340425,0.026595744680851064,0.973404255319149,188,6300,4500,1800,0.7142857142857143,81,45,36,194.12295753567534,0.47928044525353664,0.749868013855328,0.10997342862906699,1040316.0510762169,-3510.1542786503796,1036805.8967975664,631,0,203.9787234042553,80,108,40,40.0603523636608,0.539561170212766,45.010288065843596,8159.670781892941,101.99588477366176,8
633,32,0,1,182,0.0,0.00546448087431694,0.994535519125683,183,5600,4000,1600,0.7142857142857143,72,40,32,196.64130689196534,0.47790313056706496,0.7468958493569069,0.11159310796429808,1040856.147547752,-1264.9373719349283,1039591.2101758171,632,1,209.85792349726776,81,102,42,39.92865325231595,0.5414959016393442,44.9441056910569,8161.788617886148,100.76282244303887,0
634,32,4,3,183,0.021505376344086023,0.016129032258064516,0.9838709677419355,186,5850,4400,1450,0.7521367521367521,73,44,29,181.5378290244984,0.4779933158965417,0.7284136888617485,0.10403070860024764,1043886.8672627811,-5149.008873986022,1038737.858388795,633,0,207.31182795698925,80,106,44,39.93607978384183,0.5439068100358423,44.57304526748971,8173.662551440324,102.17078189300405,8
635,32,3,1,185,0.016129032258064516,0.005376344086021506,0.9946236559139785,186,5500,3900,1600,0.7090909090909091,71,39,32,191.30782728651076,0.4781228809454616,0.7460158043929248,0.1120970096026409,1050748.7959170532,-2496.706165838401,1048252.0897512148,634,0,207.2688172043011,68,118,44,38.83235149729994,0.5505152329749103,43.734903381642496,8200.483091787404,120.59533958510889,8
636,32,3,7,181,0.015957446808510637,0.03723404255319149,0.9627659574468085,188,5900,4100,1800,0.6949152542372882,77,41,36,217.87340313162684,0.47778473091364204,0.7769697728305485,0.1264032267343722,1047701.8078490804,2153.2716686471513,1049855.0795177275,635,0,206.04787234042553,72,116,40,38.53150151489804,0.5462101063829787,44.10673515981733,8188.584474885803,113.73033992896949,8
637,32,1,4,178,0.005494505494505495,0.02197802197802198,0.978021978021978,182,6100,4400,1700,0.7213114754098361,78,44,34,214.56522376801692,0.4768880405966041,0.7663503109321526,0.12511554699034436,1049258.7777777752,2526.8888888887595,1051785.666666664,636,0,213.12637362637363,74,108,41,38.422008894674015,0.5488209706959707,43.91666666666666,8194.666666666646,110.73873873873846,0
638,32,1,4,175,0.00558659217877095,0.0223463687150838,0.9776536312849162,179,5900,4200,1700,0.711864406779661,76,42,34,213.40290367099158,0.475847665976189,0.7612621830036423,0.12399766385314445,1048169.2449333813,3036.472081482784,1051205.717014864,637,0,217.40782122905028,72,107,39,38.58760290646896,0.5488244878957169,44.04965753424657,8190.410958904094,113.75570776255685,8
639,32,3,2,176,0.016853932584269662,0.011235955056179775,0.9887640449438202,178,5450,3900,1550,0.7155963302752294,70,39,31,222.93490105303027,0.4752375208954908,0.7668550942148802,0.12813647097197473,1044814.8184613447,5535.137634484065,1050349.9560958287,638,0,219.3988764044944,68,110,41,38.762652369980906,0.5419007490636705,44.45954106280195,8177.294685990368,120.25433361750541,8
640,32,0,0,176,0.0,0.0,1.0,176,5500,4400,1100,0.8,66,44,22,226.41931192621126,0.4748944805194805,0.7682187823688196,0.13076429337600098,1046296.7375259682,6680.35747625408,1052977.0950022223,639,1,222.71022727272728,68,108,41,38.48835035519608,0.5441524621212122,44.278381642512095,8183.091787439653,120.33958510940666,0
641,32,3,4,175,0.01675977653631285,0.0223463687150838,0.9776536312849162,179,4950,3200,1750,0.6464646464646465,67,32,35,206.24561796992796,0.4752121126524805,0.7459640769573064,0.11697869219993108,1040683.3526234471,2177.276234567493,1042860.6288580146,640,0,219.9608938547486,83,96,40,39.705298388926714,0.5391643389199254,44.96527777777775,8161.111111111034,98.32663989290403,8
642,32,3,2,176,0.016853932584269662,0.011235955056179775,0.9887640449438202,178,5450,3600,1850,0.6605504587155964,73,36,37,206.43223566733147,0.4750146797435409,0.7473621718803276,0.11828354287000334,1043852.8600778587,2046.9759227222216,1045899.8360005809,641,0,218.22471910112358,67,111,44,39.304456039342725,0.5428955992509363,44.577205882352956,8173.529411764737,121.99297629499608,0
643,32,2,2,176,0.011235955056179775,0.011235955056179775,0.9887640449438202,178,6000,4600,1400,0.7666666666666667,74,46,28,205.73459442656625,0.4750510484775387,0.7476789705026352,0.11886508834767932,1046418.5381262565,1456.898708369275,1047875.4368346258,642,0,218.8932584269663,70,108,43,39.002113093530625,0.5451779026217228,44.26349765258217,8183.568075117394,116.90811535881991,0
644,32,5,3,178,0.027624309392265192,0.016574585635359115,0.9834254143646409,181,5800,4800,1000,0.8275862068965517,68,48,20,202.5093936993747,0.4759425516676898,0.747639442164254,0.11856971950726046,1050514.0721922438,547.7935664627666,1051061.8657587066,643,0,215.12154696132598,76,105,43,38.574498882494794,0.5488029465930018,43.76352813852816,8199.567099567146,107.88904078377824,0
645,32,2,8,172,0.011111111111111112,0.044444444444444446,0.9555555555555556,180,5500,3600,1900,0.6545454545454545,74,36,38,202.64227521156127,0.4746980395199669,0.7469683291958189,0.11924407987548766,1052049.0933641903,1137.9243827156693,1053187.017746906,644,0,217.3,71,109,44,38.3801624915369,0.5502893518518519,43.576388888888864,8205.555555555498,115.57120500782392,0
646,32,2,3,171,0.011494252873563218,0.017241379310344827,0.9827586206896551,174,4850,3000,1850,0.6185567010309279,67,30,37,186.36813541451036,0.4738548656789139,0.7212735800636445,0.1092442479671357,1050865.6241045564,-480.42661288593445,1050385.1974916705,645,0,223.08620689655172,70,104,47,38.94442695214104,0.5487907088122606,43.720657276995276,8200.938967136084,117.15627095908691,8
647,32,1,2,170,0.005813953488372093,0.011627906976744186,0.9883720930232558,172,5900,4200,1700,0.711864406779661,76,42,34,187.62106995301207,0.4736275443129789,0.7196363843880256,0.11053368916773088,1052405.267409329,-809.3195408954734,1051595.9478684335,646,0,225.6860465116279,71,101,47,38.72112455576237,0.5514777131782946,43.532986111111086,8206.944444444387,115.59076682316038,0
648,32,1,3,168,0.005847953216374269,0.017543859649122806,0.9824561403508771,171,5650,4100,1550,0.7256637168141593,72,41,31,185.19858590666152,0.47312234835454653,0.7143048398720471,0.10957138238224008,1053702.2499999916,-821.1666666670872,1052881.0833333246,647,0,226.47368421052633,74,97,44,38.62234128917032,0.5536062378167641,43.37499999999997,8211.999999999935,110.97297297297209,0
649,32,1,0,169,0.005917159763313609,0.0,1.0,169,5200,3800,1400,0.7307692307692307,66,38,28,183.34062094830426,0.4723234831407908,0.7083616972997513,0.10903942193241185,1055289.2561983403,-304.5224977047219,1054984.7337006356,648,0,229.66863905325442,76,93,47,38.47329768928219,0.5557199211045365,43.18181818181816,8218.181818181763,108.13397129186531,0
650,32,2,2,169,0.011695906432748537,0.011695906432748537,0.9883040935672515,171,5500,4000,1500,0.7272727272727273,70,40,30,191.33172640429675,0.4726493521385162,0.7252023668332253,0.1123503217736293,1051401.6586317713,533.2988980715263,1051934.9575298429,649,0,227.97076023391813,65,106,44,38.75061568772315,0.552266081871345,43.655303030303024,8203.030303030295,126.20046620046607,7
651,32,2,0,171,0.011695906432748537,0.0,1.0,171,5500,4000,1500,0.7272727272727273,70,40,30,208.67438259695498,0.47287151702786373,0.7405143818303119,0.12106745565833343,1047704.8827523916,4025.8339104343404,1051730.716662826,650,0,228.66666666666666,75,96,38,38.76651490805215,0.552022417153996,44.10635964912283,8188.59649122812,109.18128654970826,7
652,32,1,1,171,0.005813953488372093,0.005813953488372093,0.9941860465116279,172,5350,3700,1650,0.6915887850467289,70,37,33,211.3786661741792,0.47283775896459496,0.7438448441279384,0.12331616423246246,1049405.1162131575,4614.37074829956,1054019.4869614572,651,0,228.33139534883722,76,96,41,38.48537671896183,0.5534762596899225,43.89880952380954,8195.238095238139,107.83208020050184,0
653,32,2,1,172,0.011560693641618497,0.005780346820809248,0.9942196531791907,173,5550,4300,1250,0.7747747747747747,68,43,25,207.09544826103036,0.4726161670475422,0.7420664916022437,0.12173481672088898,1051723.501275499,3411.4299886614353,1055134.9312641604,652,0,227.8092485549133,69,104,41,38.306476967129036,0.5561175337186898,43.61607142857139,8204.285714285625,118.90269151138587,0
654,32,1,2,171,0.005780346820809248,0.011560693641618497,0.9884393063583815,173,5800,4400,1400,0.7586206896551724,72,44,28,205.42979444061302,0.47281780705291926,0.7277785979535993,0.1187237435663564,1046508.9412725815,2596.823337177663,1049105.7646097592,653,0,228.71676300578034,84,89,40,38.99863433801332,0.5516016377649325,44.25245098039214,8183.921568627404,97.4276377217548,8
655,32,0,2,169,0.0,0.011695906432748537,0.9883040935672515,171,4850,3200,1650,0.6597938144329897,65,32,33,179.01300264545424,0.4725647861483775,0.7041994140505883,0.1009473959274121,1038876.4202668715,-1855.5225260935176,1037020.8977407779,654,1,232.0,86,85,38,40.625293675406496,0.5431286549707602,45.186781609195386,8154.022988505694,94.81422079657784,8
656,32,5,1,173,0.028735632183908046,0.005747126436781609,0.9942528735632183,174,5750,4000,1750,0.6956521739130435,75,40,35,193.94947932230588,0.4727364460833167,0.7288496375067222,0.1113809934812454,1044549.3343550039,-32.04009507687306,1044517.294259927,655,0,227.91954022988506,72,102,43,39.53644495327448,0.547713122605364,44.492009132420115,8176.255707762614,113.55910705225853,8
657,32,5,2,176,0.028089887640449437,0.011235955056179775,0.9887640449438202,178,6500,5100,1400,0.7846153846153846,79,51,28,185.14098128834982,0.4734111491990944,0.7219281802269741,0.10747682402678525,1047885.0192213361,-3298.7078527996464,1044586.3113685364,656,0,223.24157303370785,80,98,41,39.34631490787265,0.5507958801498127,44.08436213991773,8189.300411522725,102.36625514403406,0
658,32,3,0,179,0.01675977653631285,0.0,1.0,179,5850,4100,1750,0.7008547008547008,76,41,35,188.87087571046754,0.4729667524532881,0.7290113332958283,0.11033135771140995,1049811.6654069144,-1994.2302847059136,1047817.4351222086,657,0,222.9776536312849,83,96,46,39.01126387813067,0.5529562383612663,43.84920634920638,8196.825396825483,98.75693249187329,0
659,32,3,2,180,0.016483516483516484,0.01098901098901099,0.989010989010989,182,6250,4400,1850,0.704,81,44,37,204.58547375141683,0.47338061340133164,0.7507381425462618,0.11618328454868798,1041076.0133909116,-52.19411783683245,1041023.8192730747,658,0,220.28571428571428,82,100,38,39.69854448544488,0.5437843406593407,44.91716867469879,8162.650602409627,99.54451954158081,8
660,32,2,2,180,0.01098901098901099,0.01098901098901099,0.989010989010989,182,6250,3900,2350,0.624,86,39,47,206.3049454157184,0.4735361898690628,0.754826254826255,0.11794868745196055,1043164.3337673636,391.9921875001869,1043556.3259548638,659,0,221.21978021978023,71,111,41,39.39369794322625,0.5464171245421245,44.66145833333334,8170.833333333353,115.08215962441342,0
661,32,3,2,181,0.01639344262295082,0.01092896174863388,0.9890710382513661,183,6250,4200,2050,0.672,83,42,41,205.4475023133825,0.4736934286114614,0.756802786585705,0.11892858588131894,1047014.3254848788,171.2956114399135,1047185.6210963188,660,0,220.6830601092896,77,106,43,38.935167058209345,0.5493510928961749,44.19070512820513,8185.89743589744,106.31035631035637,0
662,32,1,1,181,0.005494505494505495,0.005494505494505495,0.9945054945054945,182,5550,4100,1450,0.7387387387387387,70,41,29,203.76621377453776,0.47363231841823,0.7540202007624104,0.11855322266804487,1048571.6793293479,782.696193630079,1049354.375522978,661,0,222.4835164835165,78,104,40,38.78412310069536,0.5512248168498168,44.000527426160346,8191.983122362889,105.02542464567806,0
663,32,0,1,180,0.0,0.0055248618784530384,0.994475138121547,181,5050,3700,1350,0.7326732673267327,64,37,27,182.00498275441095,0.4732530182115817,0.7099463223861702,0.10599877454224373,1048880.6529495989,-3069.6989696947303,1045810.9539799041,662,1,223.8121546961326,92,89,40,39.3028092509151,0.555651473296501,43.96281362007168,8193.189964157678,89.0564126538878,7
664,32,0,1,179,0.0,0.005555555555555556,0.9944444444444445,180,5900,4100,1800,0.6949152542372882,77,41,36,185.21323771218533,0.4730311142147734,0.7141885373578254,0.10832474004514203,1050180.168622799,-2998.5461576488306,1047181.6224651502,663,2,225.41666666666666,95,85,42,39.059169101972266,0.5574652777777778,43.80425347222221,8198.263888888836,86.29751461988248,0
665,32,1,1,179,0.005555555555555556,0.005555555555555556,0.9944444444444445,180,6550,5000,1550,0.7633587786259542,81,50,31,186.56099124684567,0.4728494206497,0.7174952788376308,0.10960661904956684,1051562.7091389128,-3313.883724964883,1048248.8254139479,664,0,225.46666666666667,81,99,40,38.85291239284481,0.5591435185185185,43.63567073170734,8203.658536585426,101.27973501957317,0
666,32,3,4,178,0.016483516483516484,0.02197802197802198,0.978021978021978,182,5400,4200,1200,0.7777777777777778,66,42,24,185.595568994249,0.47292590006678403,0.7211832576622399,0.10993678398811105,1054064.112480006,-2674.0742575708096,1051390.0382224352,665,0,223.9120879120879,86,96,42,38.56727464974885,0.5614697802197802,43.330938697318025,8213.409961685878,95.50476699634743,0
667,32,0,3,175,0.0,0.016853932584269662,0.9831460674157303,178,5150,3100,2050,0.6019417475728155,72,31,41,183.43820140153278,0.4722552847076747,0.7124415961909007,0.10897550324812469,1054949.3639993626,-2046.3972196529035,1052902.9667797096,666,1,228.9438202247191,86,92,44,38.51291227579346,0.5634363295880149,43.223180076628374,8216.858237547958,95.54486322730185,0
668,32,0,3,172,0.0,0.017142857142857144,0.9828571428571429,175,6000,4400,1600,0.7333333333333333,76,44,32,183.63381995183994,0.47179802955665023,0.7066980675713512,0.10949727563759598,1056076.1918179544,-2213.7389472552327,1053862.452870699,667,2,233.34857142857143,90,85,32,38.368272144002866,0.5655357142857143,43.0860805860806,8221.245421245456,91.34717134717174,0
669,32,0,1,171,0.0,0.005813953488372093,0.9941860465116279,172,4850,3500,1350,0.7216494845360825,62,35,27,188.30206901910807,0.47080840019946507,0.708818778603822,0.11284056750718233,1057582.4511264141,578.9927410810269,1058161.443867495,668,3,237.37209302325581,90,82,35,38.061739388542605,0.5677083333333333,42.90293040293042,8227.106227106282,91.41229141229202,0
670,32,1,2,170,0.005813953488372093,0.011627906976744186,0.9883720930232558,172,5000,3700,1300,0.74,63,37,26,189.517409691923,0.47051586087311303,0.7087918079264035,0.11400201106083459,1058732.686980618,729.655278547647,1059462.3422591656,669,0,238.29651162790697,94,78,38,37.88807189542483,0.5689801356589148,42.763157894736864,8231.578947368489,87.56998880179243,0
671,32,1,1,170,0.005847953216374269,0.005847953216374269,0.9941520467836258,171,5850,4400,1450,0.7521367521367521,73,44,29,200.98619231372305,0.4699991400068799,0.7276602443635585,0.11654115270454393,1047530.9271918463,2057.8504774308794,1049588.7776692773,670,0,240.02923976608187,79,92,35,38.98492231099354,0.5548245614035088,44.127604166666686,8187.916666666714,103.64451476793309,8
672,32,3,1,172,0.017341040462427744,0.005780346820809248,0.9942196531791907,173,5600,4500,1100,0.8035714285714286,67,45,22,202.0305989955221,0.47038412421024334,0.7345350770311996,0.11821588953818672,1050323.5510380703,2239.499231065359,1052563.0502691357,671,0,238.0635838150289,84,89,39,38.61047336617723,0.5573217726396917,43.786764705882376,8198.823529411828,97.60504201680747,0
673,32,2,2,172,0.011494252873563218,0.011494252873563218,0.9885057471264368,174,5950,4300,1650,0.7226890756302521,76,43,33,235.11389938900524,0.47050998826213103,0.7759290986650376,0.13385568216210658,1041857.6530612217,8241.043083900087,1050098.6961451217,672,0,237.61494252873564,69,105,40,38.821825674519886,0.5410680076628352,44.82142857142856,8165.7142857142635,118.34368530020672,8
674,32,3,1,174,0.017142857142857144,0.005714285714285714,0.9942857142857143,175,6300,4700,1600,0.746031746031746,79,47,32,238.52609013786673,0.47121921182266013,0.7841991636681909,0.13528757776545375,1040683.3526234536,8346.026234567707,1049029.3788580212,673,0,237.16571428571427,65,110,38,38.88203426367142,0.5379166666666666,44.965277777777764,8161.111111111086,125.55555555555517,7
675,32,1,1,174,0.005714285714285714,0.005714285714285714,0.9942857142857143,175,5300,4000,1300,0.7547169811320755,66,40,26,236.93940191440515,0.4711590038314177,0.7833444075304539,0.13537027368116727,1042951.5625000016,9123.263888888989,1052074.8263888906,674,0,234.45142857142858,59,116,37,38.638140894872855,0.5401785714285714,44.68750000000001,8170.000000000013,138.47457627118666,0
676,32,5,0,179,0.027932960893854747,0.0,1.0,179,5000,3000,2000,0.6,70,30,40,216.61423015560075,0.47241358567154185,0.7675734285671205,0.12373185014732438,1042886.098783696,4380.793885601652,1047266.8926692976,675,0,230.1731843575419,64,115,40,39.16525432594732,0.540677374301676,44.695512820512825,8169.743589743598,127.65224358974372,8
677,32,4,2,181,0.02185792349726776,0.01092896174863388,0.9890710382513661,183,5900,4500,1400,0.7627118644067796,73,45,28,211.73752644799558,0.4731091995436258,0.7657909793607642,0.12248746802766576,1046807.2026969856,1829.673553401111,1048636.8762503867,676,0,226.12021857923497,75,108,43,38.80010181116707,0.5437727686703097,44.21600877192983,8185.087719298261,109.13450292397681,0
678,32,3,5,179,0.016304347826086956,0.02717391304347826,0.9728260869565217,184,5750,4200,1550,0.7304347826086957,73,42,31,205.81266679927134,0.47331363348380456,0.760985622198052,0.12004518180925566,1049344.1406250088,643.6631944448873,1049987.8038194538,677,0,225.82608695652175,79,105,38,38.63551623618741,0.5463088768115942,43.90625000000003,8195.00000000007,103.73417721519075,0
679,32,1,4,176,0.005555555555555556,0.022222222222222223,0.9777777777777777,180,6050,4400,1650,0.7272727272727273,77,44,33,202.84738678337712,0.47201078522656736,0.7495152265284553,0.11957173593017373,1052578.2879818566,652.5510204079642,1053230.8390022647,678,0,231.1611111111111,69,111,40,38.30911077589539,0.5541087962962963,43.51190476190475,8207.619047619026,118.95100069013081,8
680,32,1,2,175,0.005649717514124294,0.011299435028248588,0.9887005649717514,177,4950,3600,1350,0.7272727272727273,63,36,27,222.60250595645806,0.4715534583119329,0.7565883951317454,0.12678886705510792,1041995.6730850664,6040.169604904438,1048035.8426899709,679,0,235.74576271186442,80,97,40,39.12381156352889,0.5423728813559322,44.8045267489712,8166.2551440329335,102.07818930041167,8
681,32,1,1,175,0.005681818181818182,0.005681818181818182,0.9943181818181818,176,5800,4100,1700,0.7068965517241379,75,41,34,222.14637257977142,0.47168695887445883,0.753287549804438,0.12725719645413827,1043778.7951299411,5374.334622760439,1049153.1297527016,680,0,233.32386363636363,70,106,40,38.91234418978692,0.5458096590909092,44.58626760563383,8173.2394366197705,116.76056338028243,0
682,32,3,0,178,0.016853932584269662,0.0,1.0,178,5750,3500,2250,0.6086956521739131,80,35,45,218.79097663024035,0.47194978734209353,0.754937703781116,0.12665988795988947,1047031.5866420518,4466.212680825319,1051497.799322877,681,0,231.67415730337078,75,103,40,38.59167381054438,0.548689138576779,44.1885964912281,8185.964912280767,109.14619883041023,0
683,32,3,3,178,0.016574585635359115,0.016574585635359115,0.9834254143646409,181,4850,3400,1450,0.7010309278350515,63,34,29,221.15718944796785,0.4723884796398608,0.7667562359893751,0.12647234260074597,1043243.7315908025,5094.170317566406,1048337.9019083689,682,0,228.81767955801104,66,115,40,39.00453097093684,0.5377532228360957,44.65174129353234,8171.144278606967,123.8052163425298,8
684,32,1,1,178,0.00558659217877095,0.00558659217877095,0.994413407821229,179,5500,3700,1800,0.6727272727272727,73,37,36,234.54369692506515,0.47221481179252195,0.7814988091727899,0.13387528542698748,1042658.6015184105,7609.800606169334,1050268.4021245798,683,0,229.31843575418995,60,119,36,38.73600798269675,0.5386405959031657,44.723360655737714,8168.852459016405,136.14754098360675,8
685,32,2,0,180,0.011111111111111112,0.0,1.0,180,5900,4200,1700,0.711864406779661,76,42,34,233.16998393841072,0.4726890647630871,0.7798147441604126,0.1315084443688298,1038927.188271608,6549.327160493971,1045476.5154321019,684,0,226.17777777777778,74,106,32,39.23893097872494,0.5369212962962964,45.180555555555564,8154.222222222246,110.19219219219252,8
686,32,4,1,183,0.021739130434782608,0.005434782608695652,0.9945652173913043,184,6250,4500,1750,0.72,80,45,35,232.30671145251551,0.47361370970935296,0.7868583383449683,0.13098518934030856,1038840.3110079031,5215.915274910913,1044056.2262828139,685,0,222.2391304347826,72,112,34,39.2718308413134,0.5350430253623188,45.1912100456621,8153.881278538819,113.24835109081693,8
687,32,5,4,184,0.026595744680851064,0.02127659574468085,0.9787234042553191,188,5800,4100,1700,0.7068965517241379,75,41,34,241.03447588796013,0.47436366954905756,0.7961376177123043,0.13620535241836518,1039527.8144477154,6712.408385272363,1046240.2228329878,686,0,218.4627659574468,75,113,33,38.96310560843143,0.5335217198581561,45.10690789473684,8156.578947368427,108.75438596491236,8
688,32,1,1,184,0.005405405405405406,0.005405405405405406,0.9945945945945946,185,5400,3700,1700,0.6851851851851852,71,37,34,236.82851737096314,0.47389957892675283,0.7905428338818239,0.1345071844441832,1041106.6134442763,6912.747137422541,1048019.3605816988,687,0,222.05405405405406,76,109,36,38.8722422571065,0.535472972972973,44.913419913419915,8162.770562770566,107.4048758259285,0
689,32,1,3,182,0.005405405405405406,0.016216216216216217,0.9837837837837837,185,5650,3800,1850,0.672566371681416,75,38,37,234.50622418533808,0.47398403838621234,0.7885281757801086,0.13389121695015305,1042745.2595717254,6256.050721864973,1049001.3102935904,688,0,223.02162162162162,65,120,36,38.726107676455435,0.5378378378378379,44.71275252525252,8169.191919191903,125.67987567987544,0
690,32,5,2,185,0.026737967914438502,0.0106951871657754,0.9893048128342246,187,5650,4000,1650,0.7079646017699115,73,40,33,205.81386694110316,0.47448752228164,0.7576258566073917,0.11828587346639803,1044788.8292551627,-43.59418282510569,1044745.2350723377,689,0,221.36363636363637,75,112,41,39.20340770936136,0.5413324420677361,44.46271929824564,8177.1929824561985,109.02923976608264,8
691,32,2,1,186,0.0106951871657754,0.0053475935828877,0.9946524064171123,187,6500,4600,1900,0.7076923076923077,84,46,38,217.20838596529535,0.4743449677036015,0.7673171316323317,0.12215224134368509,1038021.3611111167,1193.388888889213,1039214.7500000059,690,0,222.09625668449198,74,113,38,39.75918806914227,0.5329768270944741,45.291666666666686,8150.6666666667115,110.14414414414475,8
692,32,2,7,181,0.010638297872340425,0.03723404255319149,0.9627659574468085,188,6500,5000,1500,0.7692307692307693,80,50,30,213.36447058237184,0.474158631053969,0.7639248316711613,0.12072206259141786,1039923.2253660111,276.5336853059862,1040199.7590513171,691,0,221.89893617021278,81,107,37,39.61888775391565,0.5355164007092199,45.05843495934957,8158.130081300751,100.71765532470063,0
693,32,2,2,181,0.01092896174863388,0.01092896174863388,0.9890710382513661,183,5850,4100,1750,0.7008547008547008,76,41,35,217.38429913435482,0.4739536419864289,0.7681658237523576,0.12337006473288255,1040869.7898632296,2803.749951908353,1043673.539815138,692,0,227.03825136612022,75,108,38,39.39788319272035,0.5353483606557377,44.94243421052632,8161.8421052631775,108.82456140350904,7
694,32,2,2,181,0.01092896174863388,0.01092896174863388,0.9890710382513661,183,5000,3200,1800,0.64,68,32,36,215.33385829913155,0.4731930182749855,0.7662494463889793,0.12313550888467399,1043226.917681908,3328.4154531914887,1046555.3331350995,693,0,227.43715846994536,67,116,40,39.155330753694464,0.5377959927140255,44.65379901960787,8171.0784313726035,121.95639449809856,0
695,32,0,2,179,0.0,0.011049723756906077,0.988950276243094,181,5400,4400,1000,0.8148148148148148,64,44,20,229.72906788280596,0.47306118272969105,0.7736673801226819,0.1288958901833473,1037297.9678638984,6059.499054820674,1043357.466918719,694,1,230.6353591160221,68,113,44,39.53108324439699,0.5319406077348066,45.38043478260871,8147.826086956556,119.82097186700817,8
696,32,3,1,181,0.016483516483516484,0.005494505494505495,0.9945054945054945,182,5300,3700,1600,0.6981132075471698,69,37,32,221.68224404557682,0.47336227308603,0.7659401355341697,0.1251498917507073,1039228.7082268122,4375.710423261342,1043604.4186500736,695,0,229.72527472527472,73,109,39,39.4938667955445,0.5344551282051282,45.143581081081095,8155.4054054054395,111.71788226582794,0
697,32,4,1,184,0.021621621621621623,0.005405405405405406,0.9945945945945946,185,5750,4000,1750,0.6956521739130435,75,40,35,230.913328942724,0.4733561006658833,0.7773261477369415,0.13236437814094,1043978.0710844448,5463.690347462847,1049441.7614319075,696,0,226.97837837837838,67,118,40,38.66348075962019,0.5378941441441442,44.56188725490198,8174.019607843185,122.0002926543759,0
698,32,0,7,177,0.0,0.03804347826086957,0.9619565217391304,184,6150,4500,1650,0.7317073170731707,78,45,33,231.30173213977275,0.47288177120456165,0.7827555635020294,0.13184280262362544,1042229.591527647,5263.901961534346,1047493.4934891814,697,1,227.97282608695653,65,119,40,38.87250582318142,0.5405344202898551,44.77588383838383,8167.171717171692,125.64879564879526,8
699,32,1,1,177,0.0056179775280898875,0.0056179775280898875,0.9943820224719101,178,5650,4100,1550,0.7256637168141593,72,41,31,229.12053041753757,0.4727446094923718,0.774354542973819,0.13129477482489413,1043879.0229511615,6584.823086062027,1050463.8460372235,698,0,229.47752808988764,66,112,38,38.72167102887171,0.5424859550561798,44.57400497512437,8173.631840795995,123.8429066787272,0
700,32,3,0,180,0.016666666666666666,0.0,1.0,180,6400,4900,1500,0.765625,79,49,30,205.24274269321324,0.47295028967515,0.7555922148903562,0.1174123720211346,1043352.0911428297,428.0889561707504,1043780.1800990005,699,0,227.7722222222222,67,113,42,39.397370525894836,0.5407407407407407,44.638480392156865,8171.568627450981,121.96371085747732,8
701,32,2,3,179,0.01098901098901099,0.016483516483516484,0.9835164835164835,182,5150,3100,2050,0.6019417475728155,72,31,41,205.01422961451038,0.47293538643676764,0.757273289759085,0.11808141892805324,1045458.2458562001,1316.7633736691973,1046775.0092298693,700,0,226.25824175824175,70,112,40,39.14031261359506,0.5427541208791209,44.380868544600936,8179.812206572759,116.85446009389656,0
702,32,2,1,180,0.011049723756906077,0.0055248618784530384,0.994475138121547,181,5550,3600,1950,0.6486486486486487,75,36,39,216.28370728614345,0.472841211377123,0.759428863853564,0.12135565518297789,1037307.4297793788,3120.539301628744,1040427.9690810075,701,0,227.95580110497238,77,104,40,39.872242036434834,0.5328614180478821,45.379273504273485,8147.8632478632,105.8164058164052,8
703,32,4,0,184,0.021739130434782608,0.0,1.0,184,6150,4700,1450,0.7642276422764228,76,47,29,211.8241017749136,0.47364217054724,0.7615404524996661,0.12004960528033845,1040441.4638277405,1128.115704937149,1041569.5795326777,702,0,225.21195652173913,81,103,37,39.59329646972864,0.5357223731884058,44.99491869918697,8160.162601625957,100.7427481682217,0
704,32,3,4,183,0.016042780748663103,0.0213903743315508,0.9786096256684492,187,6050,3700,2350,0.6115702479338843,84,37,47,233.60162207003094,0.474791798439806,0.7895350268411103,0.12624877101032828,1025419.9388292062,4457.9522026907125,1029877.8910318969,703,0,222.58288770053477,63,124,40,40.92864643607215,0.5164884135472371,46.84244791666665,8101.041666666635,128.58796296296245,8
705,32,2,1,184,0.010810810810810811,0.005405405405405406,0.9945945945945946,185,6250,5000,1250,0.8,75,50,25,223.16030478351183,0.4745507735996866,0.7646232062164404,0.12105273129461125,1026603.1887754997,2569.4160997726503,1029172.6048752724,704,0,225.75135135135136,69,116,40,41.04369835115338,0.5191441441441442,46.696428571428534,8105.714285714202,117.47412008281452,8
706,32,2,2,184,0.010752688172043012,0.010752688172043012,0.989247311827957,186,6650,4200,2450,0.631578947368421,91,42,49,218.5259289282539,0.47481836675385064,0.7601137708464942,0.11942321060617739,1028974.0101332219,1121.5002814780473,1030095.5104146999,705,0,225.4516129032258,72,114,41,40.86238183659688,0.5218413978494624,46.404109589041056,8115.068493150594,112.70928462709158,0
707,32,4,2,186,0.02127659574468085,0.010638297872340425,0.9893617021276596,188,6350,4800,1550,0.7559055118110236,79,48,31,233.88871950316042,0.4758842729548299,0.7822470414241611,0.12703111681040474,1027002.783881295,4090.873209635476,1031093.6570909305,706,0,220.44148936170214,63,125,42,40.7214977086813,0.514239804964539,46.64713541666667,8107.29166666668,128.68716931216952,8
708,32,8,4,190,0.041237113402061855,0.020618556701030927,0.979381443298969,194,5700,3700,2000,0.6491228070175439,77,37,40,219.62146750675328,0.4776715764827377,0.7736002668143684,0.12114874450420271,1031941.2071017597,827.2884568755644,1032768.4955586353,707,0,212.77835051546393,70,124,41,40.46119776622375,0.5182023195876289,46.03873239436618,8126.760563380236,116.09657947686051,0
709,32,3,3,190,0.015544041450777202,0.015544041450777202,0.9844559585492227,193,5900,4700,1200,0.7966101694915254,71,47,24,239.34406667599717,0.4776250809585492,0.7953867866645048,0.12898100740923518,1024498.8878816054,4541.5460261243425,1029040.4339077298,708,0,214.76683937823833,76,117,42,40.899714871246566,0.5145185664939551,46.95616883116885,8097.402597402649,106.5447710184559,8
710,32,5,2,193,0.02564102564102564,0.010256410256410256,0.9897435897435898,195,6400,4300,2100,0.671875,85,43,42,228.25770334418488,0.47798704731694425,0.7851678224418157,0.12441696593722554,1028144.0006574526,1536.3576594339902,1029680.3583168866,709,0,213.52307692307693,64,131,43,40.72022379567583,0.5169337606837607,46.50641025641022,8111.794871794795,126.74679487179367,0
711,32,3,2,194,0.015306122448979591,0.01020408163265306,0.9897959183673469,196,6850,5200,1650,0.7591240875912408,85,52,33,253.24879839313988,0.4785528955171812,0.8092001878510906,0.13803892119168418,1028144.0006574587,6025.246548323179,1034169.2472057819,710,0,213.2704081632653,64,132,37,40.08671555611747,0.5142431972789115,46.50641025641024,8111.794871794844,126.74679487179444,8
712,32,9,6,197,0.04433497536945813,0.029556650246305417,0.9704433497536946,203,6700,4500,2200,0.6716417910447762,89,45,44,238.8190597337278,0.4793129867173909,0.8067881504317802,0.13277510848102853,1034418.1468883802,2107.7538422774505,1036525.9007306576,711,0,206.7487684729064,62,141,39,39.661773312524375,0.5190886699507389,45.734126984126966,8136.507936507898,131.23399897593384,0
713,32,5,2,200,0.024752475247524754,0.009900990099009901,0.9900990099009901,202,6100,4100,2000,0.6721311475409836,81,41,40,243.98119182024567,0.48003946849908874,0.8147294312095732,0.13300689753588799,1028190.7187567793,3671.8393961587212,1031862.558152938,712,0,208.5148514851485,63,139,37,40.315743713215625,0.5109839108910892,46.50065104166666,8111.979166666648,128.76157407407376,7
714,32,6,2,204,0.02912621359223301,0.009708737864077669,0.9902912621359223,206,6350,4000,2350,0.6299212598425197,87,40,47,224.5467779072986,0.4806436972136712,0.8000635038457788,0.1250292598202563,1034895.1797010528,-1073.5243852666817,1033821.6553157861,713,0,205.25728155339806,65,141,36,39.964730462124066,0.5196197411003236,45.67550505050506,8138.383838383854,125.20590520590544,8
715,32,3,1,206,0.014492753623188406,0.004830917874396135,0.9951690821256038,207,6300,4300,2000,0.6825396825396826,83,43,40,236.51834920030177,0.48095578693932434,0.8134284846937061,0.13068616441116415,1032466.5332562232,1139.4560100638137,1033605.989266287,714,0,205.2512077294686,73,134,40,39.96592042557902,0.5131843800322061,45.97409909909908,8128.828828828781,111.353819572997,8
716,32,1,2,205,0.004830917874396135,0.00966183574879227,0.9903381642512077,207,6450,5000,1450,0.7751937984496124,79,50,29,234.6115790567856,0.4810241858574488,0.8128649488680992,0.13047104360496112,1034503.1163434945,691.2819329027425,1035194.3982763973,715,0,206.15942028985506,56,151,41,39.758067414115295,0.5151469404186795,45.723684210526336,8136.842105263191,145.30075187969985,0
717,32,6,8,203,0.02843601895734597,0.037914691943127965,0.9620853080568721,211,6550,4400,2150,0.6717557251908397,87,44,43,226.69160623821102,0.4815147069886407,0.8079862025390725,0.1282187743183152,1039816.4997462968,-1606.4654959033678,1038210.0342503934,716,0,203.13270142180096,66,145,37,39.292502693582136,0.5193522906793049,45.071517412935336,8157.711442786097,123.60168852706208,0
718,32,4,0,207,0.01932367149758454,0.0,1.0,207,5350,3500,1850,0.6542056074766355,72,35,37,229.12347361528634,0.481120921470225,0.8079802137378895,0.13078538649220398,1042667.9012345694,1029.9382716049804,1043697.8395061743,717,0,204.17391304347825,59,148,41,38.873209104098656,0.5218900966183575,44.72222222222223,8168.8888888889005,138.4557438794729,0
719,32,3,7,203,0.014285714285714285,0.03333333333333333,0.9666666666666667,210,6950,4600,2350,0.6618705035971223,93,46,47,222.7341349003068,0.4814275271512114,0.8055661872132023,0.12844678715735416,1045841.946134326,-2361.0597770633085,1043480.8863572627,718,0,202.24285714285713,65,145,44,38.63940932567852,0.5245535714285714,44.33396464646466,8181.313131313155,125.86635586635623,0
720,32,3,7,199,0.014563106796116505,0.03398058252427184,0.9660194174757282,206,5450,3900,1550,0.7155963302752294,70,39,31,227.89530862027863,0.4812046136238062,0.8045801995612825,0.13107568520294377,1045023.0347021093,981.1694017473374,1046004.2041038566,719,0,204.91747572815535,66,140,38,38.609852171797066,0.52978357605178,44.43407960199004,8178.109452736302,123.91074928388336,8
721,32,5,6,198,0.024509803921568627,0.029411764705882353,0.9705882352941176,204,6450,4900,1550,0.7596899224806202,80,49,31,221.06516509135724,0.48136359428829006,0.7952811398504605,0.1224304419293328,1033197.8732897062,-1569.1883138344647,1031628.6849758717,720,0,207.4607843137255,81,123,37,40.26653002732784,0.5193525326797386,45.884146341463406,8131.707317073152,100.3914483589278,8
722,32,4,1,201,0.019801980198019802,0.0049504950495049506,0.995049504950495,202,6800,4700,2100,0.6911764705882353,89,47,42,203.06939500758682,0.4815680262056056,0.7782663313351654,0.11151145922142715,1030503.3943322828,-5347.259831935773,1025156.1345003471,721,0,207.0990099009901,78,124,36,41.06213522453717,0.5178424092409242,46.21571729957806,8121.097046413501,104.11662880017309,8
723,32,6,3,204,0.028985507246376812,0.014492753623188406,0.9855072463768116,207,5700,4300,1400,0.7543859649122807,71,43,28,215.02353998043478,0.48250844238075136,0.7936863738931776,0.11446861813553215,1020570.3973531818,-3210.668072375972,1017359.7292808059,722,0,202.96135265700482,67,140,41,42.01119316228946,0.5079005636070854,47.44178921568628,8081.862745098042,120.62481709101556,8
724,32,13,6,211,0.059907834101382486,0.027649769585253458,0.9723502304147466,217,6900,5200,1700,0.7536231884057971,86,52,34,192.83307139513715,0.48380696364567327,0.7789270701154836,0.1046135399383625,1026639.0493111329,-10706.007781430213,1015933.0415297026,723,0,193.61290322580646,73,144,44,41.807388626470335,0.5129608294930876,46.692004504504496,8105.855855855835,111.03912131309363,0
725,32,3,5,209,0.014018691588785047,0.02336448598130841,0.9766355140186916,214,7500,5500,2000,0.7333333333333333,95,55,40,201.0969614619056,0.48410191157328186,0.78555219692575,0.11084421210916418,1031695.663363727,-8805.827388825865,1022889.8359749012,724,0,197.12616822429908,83,131,38,40.96247212319512,0.5193730529595015,46.06894841269842,8125.7936507936665,97.90112832281525,8
726,32,5,4,210,0.02336448598130841,0.018691588785046728,0.9813084112149533,214,6250,4500,1750,0.72,80,45,35,198.55040736157554,0.4840968840039197,0.7864467128120869,0.11119591890649924,1036715.9431550208,-7881.925433665949,1028834.0177213548,725,0,197.6355140186916,70,144,47,40.39781460134487,0.5263337227414331,45.45187793427231,8145.539906103311,116.36485580147587,8
727,32,3,5,208,0.014084507042253521,0.023474178403755867,0.9765258215962441,213,7100,5600,1500,0.7887323943661971,86,56,30,214.21225017822172,0.4844142159033868,0.8016011493806794,0.11753583600491516,1030248.1736462916,-5561.644096245109,1024686.5295500465,726,0,198.88732394366198,72,141,35,40.81144913681605,0.5197085289514867,46.247146118721446,8120.091324200878,112.77904616945665,8
728,32,5,3,210,0.023474178403755867,0.014084507042253521,0.9859154929577465,213,7200,5300,1900,0.7361111111111112,91,53,38,205.61579670426033,0.4842693477426403,0.7933338168838251,0.11437378691674469,1034579.591836733,-7254.818594104438,1027324.7732426286,727,0,199.45539906103286,69,144,39,40.48576974094883,0.5236208920187793,45.71428571428571,8137.142857142844,117.92960662525861,0
729,32,2,5,207,0.009433962264150943,0.02358490566037736,0.9764150943396226,212,6800,4800,2000,0.7058823529411765,88,48,40,216.0520675417759,0.4843149199678083,0.8015788696005994,0.1212485053364159,1037366.5001417215,-4374.964569161141,1032991.5355725603,728,0,201.32075471698113,69,143,41,39.87073373853078,0.5262382075471699,45.3720238095238,8148.095238095223,118.08833678398874,8
730,32,5,2,210,0.02358490566037736,0.009433962264150943,0.9905660377358491,212,7800,5700,2100,0.7307692307692307,99,57,42,202.65607046966687,0.48407879146919436,0.7906778248820143,0.11199662325607108,1032525.2141317758,-8350.49948864094,1024174.7146431349,729,0,201.5188679245283,77,135,41,40.81874496197382,0.5224547955974843,45.96688034188031,8129.059829059758,105.57220557220465,8
731,32,6,6,210,0.027777777777777776,0.027777777777777776,0.9722222222222222,216,6850,5100,1750,0.7445255474452555,86,51,35,221.29738412133048,0.48421619293712315,0.7995810384219999,0.12295166301502108,1034207.8325784036,-4276.502402522,1029931.3301758816,730,0,198.65740740740742,70,146,38,40.1337113124435,0.5220871913580247,45.759976525821564,8135.680751173638,116.22401073105198,8
732,32,7,3,214,0.03225806451612903,0.013824884792626729,0.9861751152073732,217,5750,3600,2150,0.6260869565217392,79,36,43,218.3474325298601,0.4844078909939125,0.8005415074260647,0.1235512908388887,1039948.1503364799,-3735.9982819707257,1036212.1520545091,731,0,198.47926267281105,78,139,38,39.48872941987757,0.5261136712749617,45.05537974683543,8158.227848101229,104.59266471924653,0
733,32,0,2,212,0.0,0.009345794392523364,0.9906542056074766,214,6250,4500,1750,0.72,80,45,35,217.95568244326122,0.4840516358796601,0.7983669192849332,0.12367659060540524,1040825.043402775,-3679.2534722223736,1037145.7899305526,732,1,202.12616822429908,79,135,39,39.388911578517465,0.527161214953271,44.94791666666666,8161.666666666644,103.31223628691954,0
734,32,2,5,209,0.009345794392523364,0.02336448598130841,0.9766355140186916,214,7350,5300,2050,0.7210884353741497,94,53,41,207.07870322032198,0.48398490632267127,0.7918405017527546,0.11694629361900107,1039337.7712673596,-7105.056423611191,1032232.7148437484,733,0,202.52803738317758,79,135,37,39.852397738496634,0.5272585669781931,45.13020833333333,8155.833333333321,103.23839662447241,8
735,32,5,1,213,0.02336448598130841,0.004672897196261682,0.9953271028037384,214,6500,4900,1600,0.7538461538461538,81,49,32,208.327596859539,0.48400501660011996,0.7922675558302752,0.11739615497570274,1038657.6920765829,-6023.787810002422,1032633.9042665805,734,0,201.84112149532712,78,136,44,39.90570391071085,0.5254088785046729,45.21360759493668,8153.164556961967,104.52775073028162,8
736,32,3,4,212,0.013888888888888888,0.018518518518518517,0.9814814814814815,216,6400,4600,1800,0.71875,82,46,36,219.85501875006327,0.48403944157335627,0.8074412670999818,0.1222570672104625,1034483.4356077008,-4112.724973567742,1030370.7106341331,735,0,200.8101851851852,67,149,37,40.13576370062454,0.5220871913580247,45.72610294117648,8136.764705882368,121.44424934152788,8
737,32,2,4,210,0.009345794392523364,0.018691588785046728,0.9813084112149533,214,6200,4500,1700,0.7258064516129032,79,45,34,209.7463062532388,0.4842728489315958,0.7987920109363849,0.11434013786222207,1028180.8657273347,-5868.572250686817,1022312.2934766479,736,0,202.79439252336448,66,148,39,41.18483593989574,0.509053738317757,46.501865671641795,8111.940298507472,122.9081863410223,8
738,32,3,2,211,0.014084507042253521,0.009389671361502348,0.9906103286384976,213,6700,5300,1400,0.7910447761194029,81,53,28,209.90429453673565,0.484245356837039,0.798215387319875,0.11561437686991548,1031464.3396371962,-5998.24108973085,1025466.0985474653,737,0,203.28169014084506,70,143,39,40.76789360144843,0.5121283255086072,46.097417840375584,8124.882629107973,116.06975184439962,0
739,32,3,5,209,0.014018691588785047,0.02336448598130841,0.9766355140186916,214,7500,5300,2200,0.7066666666666667,97,53,44,206.17024437720812,0.484439672824068,0.795645378167146,0.11429095252624956,1033501.085179247,-7684.565740897134,1025816.5194383499,738,0,201.63084112149534,76,138,43,40.606980003903374,0.5148461838006231,45.84686147186146,8132.900432900403,107.0118478013211,0
740,32,8,4,213,0.03686635944700461,0.018433179723502304,0.9815668202764977,217,6900,4600,2300,0.6666666666666666,92,46,46,217.05932044900084,0.4857128634010355,0.8000154178947949,0.12045777989029591,1033843.2398198533,-5418.937782781917,1028424.3020370714,739,0,198.49769585253455,72,145,36,40.287250664271575,0.5154089861751152,45.804794520547944,8134.246575342463,112.97564687975643,8
741,32,3,3,213,0.013888888888888888,0.013888888888888888,0.9861111111111112,216,7450,5600,1850,0.7516778523489933,93,56,37,222.83943635438254,0.48552119221935114,0.8049975076018152,0.12493940628682867,1037069.7744738713,-4429.991199215455,1032639.7832746559,740,0,200.1851851851852,75,141,35,39.735139075818736,0.5187596450617284,45.40844298245612,8146.929824561361,108.62573099415148,0
742,32,3,1,215,0.013888888888888888,0.004629629629629629,0.9953703703703703,216,6700,4800,1900,0.7164179104477612,86,48,38,251.88979309644887,0.4855427253804192,0.8289116601160416,0.13958174284529332,1033379.0084652046,2159.524926502495,1035538.5333917071,741,0,200.65277777777777,72,144,39,39.46039210181545,0.5167341820987654,45.8618721461187,8132.4200913241475,112.95027904616872,8
743,32,3,1,217,0.013761467889908258,0.0045871559633027525,0.9954128440366973,218,6350,4500,1850,0.7086614173228346,82,45,37,243.25916121872422,0.48583777251652366,0.8239411163390058,0.13592257778747457,1035995.2969021279,453.06939019094625,1036448.3662923189,742,0,199.79357798165137,63,155,44,39.3504008357852,0.5188264525993884,45.540364583333336,8142.708333333343,129.24933862433878,0
744,32,4,11,210,0.01809954751131222,0.049773755656108594,0.9502262443438914,221,7600,5400,2200,0.7105263157894737,98,54,44,222.9801965453965,0.48588886603592485,0.8155218526288814,0.12658520276835314,1040966.743827165,-5377.00617283925,1035589.7376543258,743,0,198.0452488687783,74,147,38,39.24301207006085,0.5244626696832579,44.93055555555557,8162.222222222258,110.30030030030079,7
745,32,3,3,210,0.014084507042253521,0.014084507042253521,0.9859154929577465,213,7000,5300,1700,0.7571428571428571,87,53,34,220.19687346753295,0.48494939764372397,0.807121806354131,0.12608725429765077,1043647.9855371879,-3638.3953168045864,1040009.5902203833,744,0,205.30985915492957,65,148,40,38.978494623655905,0.5268974960876369,44.60227272727272,8172.727272727256,125.73426573426548,0
746,32,2,3,209,0.009433962264150943,0.014150943396226415,0.9858490566037735,212,6450,4400,2050,0.6821705426356589,85,44,41,212.18856431210406,0.4845752667739724,0.7953688669913959,0.12266682996408146,1046602.0727040845,-4434.601757369393,1042167.4709467151,745,0,207.0566037735849,69,143,44,38.81415944221407,0.5287441037735849,44.24107142857144,8184.2857142857365,118.61283643892372,7
747,32,3,6,206,0.014150943396226415,0.02830188679245283,0.9716981132075472,212,6550,3900,2650,0.5954198473282443,92,39,53,211.38182735596965,0.48421012921398554,0.7980316959751994,0.12232423779779873,1046914.5137576126,-4690.2593992860575,1042224.2543583266,746,0,207.87264150943398,68,144,44,38.79581267705382,0.5300216194968553,44.20289855072463,8185.5072463768,120.37510656436471,8
748,32,1,3,204,0.004830917874396135,0.014492753623188406,0.9855072463768116,207,7000,4300,2700,0.6142857142857143,97,43,54,204.04490865360174,0.4835148836045839,0.7871712448121224,0.1181453696417671,1047089.2892573685,-5669.352324263204,1041419.9369331053,747,0,212.2512077294686,69,138,43,38.96170234424987,0.5331119162640902,44.18154761904761,8186.190476190468,118.64044168391983,8
749,32,1,2,203,0.004878048780487805,0.00975609756097561,0.9902439024390244,205,7000,4900,2100,0.7,91,49,42,231.6071542784027,0.48332735533237686,0.8074214757119738,0.1291397864508441,1035332.7475653768,-41.90572102854367,1035290.8418443482,748,0,214.34634146341463,63,142,38,39.73016241175593,0.516920731707317,45.62174479166667,8140.104166666678,129.20800264550283,8
750,32,4,2,205,0.01932367149758454,0.00966183574879227,0.9903381642512077,207,6850,5000,1850,0.7299270072992701,87,50,37,222.73700705269596,0.4837914106592874,0.8008195088511167,0.1254087350993199,1038389.704423729,-1992.4370164648244,1036397.2674072642,749,0,212.6328502415459,70,137,40,39.57217519004838,0.5203804347826086,45.24647887323945,8152.112676056367,116.45875251509095,0
751,32,5,2,208,0.023809523809523808,0.009523809523809525,0.9904761904761905,210,7150,5300,1850,0.7412587412587412,90,53,37,212.18367361464948,0.48416163514847727,0.793202065700318,0.12076500922298819,1041764.9210574446,-4940.898401431065,1036824.0226560136,750,0,210.53809523809525,75,135,43,39.41855338310862,0.5239583333333333,44.83278508771931,8165.350877193014,108.87134502924019,0
752,32,1,3,206,0.004784688995215311,0.014354066985645933,0.9856459330143541,209,6800,5100,1700,0.75,85,51,34,210.91453880382778,0.4842158937553674,0.7918374804444397,0.1182815186064295,1037144.2177854923,-4850.241126543313,1032293.976658949,751,0,212.32057416267943,71,138,40,40.02940675076713,0.5234250398724083,45.39930555555555,8147.22222222221,114.7496087636931,8
753,32,6,3,209,0.02830188679245283,0.014150943396226415,0.9858490566037735,212,6850,5000,1850,0.7299270072992701,87,50,37,205.35567886766128,0.4841286252943456,0.7886930250614159,0.11663689628460308,1041119.3550706783,-6490.0456114398075,1034629.3094592384,752,0,210.08018867924528,77,135,41,39.67347913721792,0.5277122641509434,44.91185897435898,8162.820512820522,106.01065601065612,0
754,32,0,0,209,0.0,0.0,1.0,209,6900,4400,2500,0.6376811594202898,94,44,50,207.88465228475076,0.48382292050055203,0.7887161502041631,0.11803201125561062,1041010.3458981671,-5417.985243626233,1035592.3606545408,753,1,214.08612440191388,77,132,41,39.62260034904013,0.5286084529505581,44.925213675213676,8162.3931623931685,106.00510600510609,0
755,32,1,3,207,0.004761904761904762,0.014285714285714285,0.9857142857142858,210,7350,5100,2250,0.6938775510204082,96,51,45,207.02023883508105,0.4836784195336827,0.7873221402727169,0.11878628879601294,1044286.0544243573,-6112.330320184958,1038173.7241041723,754,0,214.06190476190477,73,137,40,39.23534584090953,0.5382440476190475,44.524211711711715,8175.225225225228,111.98938664692093,8
756,32,1,1,207,0.004807692307692308,0.004807692307692308,0.9951923076923077,208,6150,3800,2350,0.6178861788617886,85,38,47,192.22856544379303,0.4833545266629506,0.7661891474613602,0.11037565768519435,1044501.4701585291,-7593.396157498351,1036908.0740010308,755,0,216.3125,77,131,42,39.586382326294505,0.5361077724358974,44.49786324786327,8176.068376068437,106.18270618270698,8
757,32,2,2,207,0.009569377990430622,0.009569377990430622,0.9904306220095693,209,7750,5500,2250,0.7096774193548387,100,55,45,190.72141022618666,0.4834539090295669,0.7646011440330616,0.11018798344709474,1046409.858812768,-9635.447210528557,1036774.4116022395,756,0,216.244019138756,82,127,43,39.387135823068505,0.5384768740031898,44.26455823293175,8183.534136546239,99.79919678714926,0
758,32,3,7,203,0.014285714285714285,0.03333333333333333,0.9666666666666667,210,6750,5000,1750,0.7407407407407407,85,50,35,185.3879782151076,0.483411179463811,0.7572089182493789,0.10779819921757834,1048393.7048934047,-9878.08213527266,1038515.622758132,757,0,216.11428571428573,87,123,35,39.276734104046234,0.5411706349206349,44.02225378787882,8191.287878787962,94.15273423894209,0
759,32,2,1,204,0.00975609756097561,0.004878048780487805,0.9951219512195122,205,6300,3600,2700,0.5714285714285714,90,36,54,192.1350791278231,0.4828281922525108,0.762665656606647,0.11210988597652692,1049460.5501033154,-6972.362832873707,1042488.1872704417,758,0,222.0390243902439,87,118,39,38.971313243359816,0.5429369918699187,43.89204545454548,8195.454545454622,94.20062695924854,0
760,32,2,0,206,0.009708737864077669,0.0,1.0,206,6950,4700,2250,0.6762589928057554,92,47,45,189.90955135782337,0.4828725629489305,0.7625763207458613,0.11162640013910301,1051706.5018070494,-8204.178016343358,1043502.323790706,759,0,221.90291262135923,78,128,42,38.74920712473429,0.54540857605178,43.61814345991562,8204.219409282723,105.18230011900927,0
761,32,2,3,205,0.009615384615384616,0.014423076923076924,0.9855769230769231,208,6000,3700,2300,0.6166666666666667,83,37,46,199.67194370267313,0.48284695125727733,0.7722368698190132,0.1182992639805065,1054126.9092434028,-5504.086224415554,1048622.8230189872,760,0,220.7596153846154,82,126,41,38.19817947714978,0.5478766025641026,43.323293172690775,8213.654618473924,100.16651973748688,0
762,32,2,2,205,0.00966183574879227,0.00966183574879227,0.9903381642512077,207,6750,4700,2050,0.6962962962962963,88,47,41,210.51206194638075,0.48265598861842,0.7849643465513465,0.12299506216993902,1049865.8779149503,-3948.113854595418,1045917.7640603548,761,0,222.32850241545893,89,118,39,38.450170190975335,0.5445350241545894,43.84259259259259,8197.037037037024,92.10153974198903,7
763,32,0,2,203,0.0,0.00975609756097561,0.9902439024390244,205,6750,4700,2050,0.6962962962962963,88,47,41,216.6839779475379,0.482394787183166,0.7884295360237634,0.12727466722681105,1051491.7245734918,-2181.718068100182,1049310.0065053916,762,1,225.48292682926828,68,137,40,38.089506899868425,0.546239837398374,43.644323671497546,8203.381642511995,120.63796533105875,0
764,32,2,1,204,0.00975609756097561,0.004878048780487805,0.9951219512195122,205,7200,5100,2100,0.7083333333333334,93,51,42,182.84688996188555,0.4820859238004145,0.7499631104572149,0.10645040874917994,1048768.936410416,-9847.172337744216,1038921.7640726716,763,0,226.25853658536585,91,114,38,39.29513827466243,0.5464939024390244,43.97644927536231,8192.75362318839,90.0302595954768,8
765,32,0,1,203,0.0,0.004901960784313725,0.9950980392156863,204,6550,4800,1750,0.732824427480916,83,48,35,205.84726308587108,0.4818017724331112,0.7778480558672365,0.11832043794377163,1044829.0626826324,-4334.9594108406145,1040494.1032717917,764,1,227.84803921568627,77,127,41,39.197532880411096,0.5409517973856209,44.457799145299155,8177.350427350459,106.1993561993566,8
766,32,2,1,204,0.00975609756097561,0.004878048780487805,0.9951219512195122,205,6200,4000,2200,0.6451612903225806,84,40,44,201.45982357547135,0.48163657739518567,0.7743488556611151,0.1165116147453496,1046726.8735499389,-5025.317744584623,1041701.5558053543,765,0,227.56585365853658,80,125,43,39.07300098882135,0.5431910569105691,44.22582304526751,8184.773662551486,102.30967078189357,0
767,32,3,1,206,0.014492753623188406,0.004830917874396135,0.9951690821256038,207,6750,5100,1650,0.7555555555555555,84,51,33,219.41862394466582,0.4817179463127121,0.7891748974880868,0.12711456333008747,1047253.224017347,-2192.6277328995266,1045060.5962844475,766,0,226.34299516908212,80,127,32,38.54794996816461,0.5409621578099839,44.16152263374487,8186.831275720208,102.3353909465026,8
768,32,4,1,209,0.01904761904761905,0.004761904761904762,0.9952380952380953,210,5950,4300,1650,0.7226890756302521,76,43,33,250.61613391464158,0.48219127363864206,0.8114503086002607,0.143189866782582,1042963.8964736657,4326.71590935632,1047290.6123830221,767,0,223.91904761904763,68,142,35,38.28740933459477,0.533531746031746,44.68599033816426,8170.048309178763,120.14776925262886,8
769,32,2,5,206,0.009478672985781991,0.023696682464454975,0.976303317535545,211,5400,3400,2000,0.6296296296296297,74,34,40,212.00948377246178,0.48247761979989473,0.7902509442392798,0.12057917935913197,1041541.1021901006,-3436.6817193751795,1038104.4204707254,768,0,223.8388625592417,75,136,42,39.450991583848136,0.5313487361769352,44.86019736842106,8164.473684210555,108.8596491228074,8
770,32,5,4,207,0.023696682464454975,0.018957345971563982,0.981042654028436,211,6400,5000,1400,0.78125,78,50,28,228.88500261336432,0.4827192883472504,0.7900246870636882,0.13130771202556168,1044228.5156250005,-798.3506944444634,1043430.164930556,769,0,221.76777251184834,75,136,40,38.68395344886166,0.5391982622432859,44.53125,8175.000000000004,109.00000000000004,8
771,32,3,3,207,0.014285714285714285,0.014285714285714285,0.9857142857142858,210,6250,3600,2650,0.576,89,36,53,230.2455826842509,0.4826018645097592,0.7939876408578694,0.1334609350957389,1047424.3164062544,-17.035590277554547,1047407.2808159769,770,0,220.32380952380953,79,131,34,38.249575911789684,0.5417162698412699,44.140625000000014,8187.500000000035,103.63924050632956,0
772,32,2,8,201,0.009569377990430622,0.03827751196172249,0.9617224880382775,209,6050,4400,1650,0.7272727272727273,77,44,33,213.86716586339912,0.48255102901484476,0.7882486020201223,0.12389033252026503,1047232.9773221274,-3056.2502282851497,1044176.7270938422,771,0,222.08612440191388,77,132,35,38.69250361051663,0.5419657097288677,44.16399572649575,8186.752136752196,106.32145632145709,8
773,32,0,1,200,0.0,0.004975124378109453,0.9950248756218906,201,8050,5500,2550,0.6832298136645962,106,55,51,232.2752352254011,0.4820004145936982,0.801939424201243,0.13221061632112835,1041789.488007301,146.3796764490653,1041935.8676837501,772,1,231.318407960199,81,120,34,38.90280405237218,0.5354477611940298,44.82977642276422,8165.447154471522,100.80798956137681,8
774,32,3,2,201,0.014778325123152709,0.009852216748768473,0.9901477832512315,203,7900,6200,1700,0.7848101265822784,96,62,34,220.04067176791665,0.4824365133557691,0.7924776427331455,0.12632185647897706,1044444.5027888698,-2535.945996405577,1041908.5567924642,773,0,228.2216748768473,68,135,36,38.88289805404557,0.5382799671592775,44.50483091787442,8175.8454106280715,120.23302074453046,0
775,32,1,1,201,0.0049504950495049506,0.0049504950495049506,0.995049504950495,202,5850,4000,1850,0.6837606837606838,77,40,37,224.056069717068,0.4822001789731212,0.795309572872489,0.1271564318806018,1040869.7898632311,392.6388407973441,1041262.4287040285,774,0,230.17821782178217,75,127,40,39.227714636287125,0.5334158415841583,44.94243421052633,8161.842105263189,108.8245614035092,8
776,32,4,4,201,0.01951219512195122,0.01951219512195122,0.9804878048780488,205,6800,5100,1700,0.75,85,51,34,236.07853430111325,0.48269368723098993,0.8055163901067537,0.13160071208519614,1035255.6287282472,1080.3262914283068,1036335.9550196755,775,0,227.78536585365853,66,139,38,39.62611800419699,0.5251524390243902,45.63121890547263,8139.800995024859,123.33031810643726,8
777,32,1,2,200,0.0049504950495049506,0.009900990099009901,0.9900990099009901,202,6450,4300,2150,0.6666666666666666,86,43,43,227.34630912000065,0.4823982398239824,0.7987108118811883,0.12655098254364067,1034802.8606838604,201.72220865848521,1035004.5828925188,776,0,229.77722772277227,63,139,38,39.905133333333325,0.5236179867986799,45.686848958333314,8138.020833333297,129.17493386243328,8
778,32,3,0,203,0.014778325123152709,0.0,1.0,203,7350,5600,1750,0.7619047619047619,91,56,35,219.82223108037317,0.48291103740915964,0.7932733744893463,0.12362802275960175,1038036.1268641031,-2313.316530140758,1035722.8103339623,777,0,229.12807881773398,68,135,43,39.69075983878621,0.5266830870279147,45.289855072463766,8150.724637681151,119.8635976129581,0
779,32,0,4,199,0.0,0.019704433497536946,0.9802955665024631,203,7000,5300,1700,0.7571428571428571,87,53,34,236.69027625860133,0.4827027345591702,0.798326550744102,0.13089624837254296,1032744.8154305911,1288.1311337813072,1034032.9465643724,778,1,230.12807881773398,87,116,30,39.926511127677095,0.523758210180624,45.93986742424244,8129.924242424297,93.44740508533674,8
780,32,4,2,201,0.019704433497536946,0.009852216748768473,0.9901477832512315,203,5600,4000,1600,0.7142857142857143,72,40,32,236.1671279330118,0.48243143279845224,0.802061841813452,0.13214542349228822,1036437.1141975302,2754.475308641974,1039191.5895061722,779,0,230.54679802955664,74,129,32,39.47532969531601,0.5269909688013137,45.48611111111111,8144.44444444444,110.06006006006,0
781,32,3,2,202,0.014705882352941176,0.00980392156862745,0.9901960784313726,204,6950,4800,2150,0.6906474820143885,91,48,43,231.2560908175602,0.4825755014649538,0.8019872869516631,0.13075285134850603,1039702.680984726,337.5155234125409,1040040.1965081384,780,0,229.61764705882354,77,127,34,39.190416317407085,0.5300245098039216,45.085470085470064,8157.264957264907,105.93850593850529,0
782,32,4,5,201,0.019417475728155338,0.024271844660194174,0.9757281553398058,206,6150,3800,2350,0.6178861788617886,85,38,47,227.53121872372833,0.4832613071276344,0.8024537242853633,0.1297963949877942,1042476.0346080785,89.16852893086161,1042565.2031370094,781,0,224.4271844660194,67,139,39,38.93787883334335,0.5326658576051779,44.74571078431371,8168.137254901922,121.91249634181972,0
783,32,4,3,202,0.01951219512195122,0.014634146341463415,0.9853658536585366,205,6450,4700,1750,0.7286821705426356,82,47,35,221.45597583865973,0.4831171289654073,0.7959357417519834,0.12738586171246907,1045056.5877111203,-1163.1947123627642,1043893.3929987575,782,0,226.30243902439025,71,134,39,38.77022596471365,0.5351626016260163,44.429976851851855,8178.240740740745,115.18648930620768,0
784,32,2,1,203,0.00980392156862745,0.004901960784313725,0.9950980392156863,204,7000,5200,1800,0.7428571428571429,88,52,36,217.28347250368648,0.48297846437425546,0.7923772114709067,0.12586042652572071,1047211.1111111147,-2291.666666666547,1044919.4444444482,783,0,227.92156862745097,74,130,42,38.607831161780666,0.5378370098039216,44.16666666666668,8186.666666666695,110.63063063063102,0
785,32,3,3,203,0.014563106796116505,0.014563106796116505,0.9854368932038835,206,6850,5200,1650,0.7591240875912408,85,52,33,212.00217229001555,0.4831468545267977,0.7939025387590111,0.1214991759813815,1043914.4383230328,-3787.5742781211006,1040126.8640449117,784,0,226.64563106796118,60,146,46,39.15449369345281,0.5324635922330097,44.56967213114755,8173.77049180329,136.2295081967215,8
786,32,2,2,203,0.00975609756097561,0.00975609756097561,0.9902439024390244,205,5950,4000,1950,0.6722689075630253,79,40,39,215.67794927167344,0.4826956798979754,0.7903401246705437,0.12449529151028327,1046134.1951369692,-1824.3844259770353,1044309.8107109922,785,0,228.09268292682927,75,130,40,38.783322612921694,0.5334857723577235,44.2982456140351,8182.456140350909,109.09941520467878,8
787,32,3,3,203,0.014563106796116505,0.014563106796116505,0.9854368932038835,206,6350,4600,1750,0.7244094488188977,81,46,35,212.84247264144474,0.4826510576998974,0.7895262306667072,0.12342451600482791,1047552.2500000133,-2957.2777777770793,1044594.9722222362,786,0,227.80582524271844,74,132,34,38.67889323128699,0.5393911812297735,44.12500000000004,8188.0000000001055,110.64864864865008,8
788,32,3,3,203,0.014563106796116505,0.014563106796116505,0.9854368932038835,206,6600,4700,1900,0.7121212121212122,85,47,38,210.1438015911069,0.48277833688531063,0.7869584081862475,0.12261980101631778,1049465.3407551444,-3692.272731121178,1045773.0680240232,787,0,228.75728155339806,80,126,38,38.50949870282035,0.5414138349514563,43.891460905349824,8195.473251028878,102.44341563786097,0
789,32,3,0,206,0.014563106796116505,0.0,1.0,206,5950,4600,1350,0.773109243697479,73,46,27,201.35368358104486,0.4822480069460889,0.7778280822724521,0.11851567217434275,1052126.098860689,-4780.106880529034,1047345.9919801599,788,0,229.67961165048544,73,133,41,38.40363168103053,0.5442961165048543,43.56700450450452,8205.855855855887,112.40898432679298,0
790,32,4,3,207,0.01904761904761905,0.014285714285714285,0.9857142857142858,210,7050,4800,2250,0.6808510638297872,93,48,45,204.31478092963187,0.48221927925875296,0.7835922672694144,0.12159042922308155,1055481.4222086768,-5919.908889227465,1049561.5133194493,789,0,226.28571428571428,80,130,44,37.910783430135524,0.5473710317460317,43.15843621399178,8218.930041152284,102.73662551440354,0
791,32,2,3,206,0.009569377990430622,0.014354066985645933,0.9856459330143541,209,6800,4800,2000,0.7058823529411765,88,48,40,202.2074952151532,0.4820909627653049,0.7817921913709389,0.12103838199003525,1057245.0185224577,-5843.426595175051,1051401.5919272827,790,0,227.688995215311,83,126,40,37.74608238056184,0.5499401913875598,42.94394841269842,8225.79365079367,99.10594759992374,0
792,32,1,5,202,0.004830917874396135,0.024154589371980676,0.9758454106280193,207,6500,4800,1700,0.7384615384615385,82,48,34,184.02787077218096,0.4818928521176305,0.7538855892956084,0.10992657559200342,1056612.6736111199,-9010.76388888845,1047601.9097222314,791,0,230.4927536231884,89,118,36,38.29170044588571,0.5526871980676329,43.02083333333336,8223.333333333403,92.39700374531914,8
793,32,1,0,203,0.0049261083743842365,0.0,1.0,203,6250,4800,1450,0.768,77,48,29,182.49624628503958,0.481316758523143,0.7500813037327878,0.10963095670991838,1058326.5625000051,-8221.874999999844,1050104.6875000054,792,0,234.87192118226602,89,114,41,38.118924665856596,0.5546490147783252,42.812500000000014,8230.00000000004,92.47191011236,0
794,32,0,2,201,0.0,0.009852216748768473,0.9901477832512315,203,6050,4100,1950,0.6776859504132231,80,41,39,186.01971263758801,0.4806532377375669,0.7553667746449184,0.11243430420475022,1060173.8422501567,-7207.353303747873,1052966.4889464087,793,1,235.87192118226602,77,126,41,37.79977302204928,0.5567528735632183,42.588141025641,8237.179487179426,106.97635697635619,0
795,32,1,3,199,0.0049504950495049506,0.01485148514851485,0.9851485148514851,202,6350,4900,1450,0.7716535433070866,78,49,29,197.3663670254348,0.4803632415480354,0.772701202086193,0.11819513711319389,1057384.8096496046,-5011.560314315717,1052373.249335289,794,0,237.66336633663366,80,122,42,37.85319743204934,0.5533209570957096,42.92695473251026,8226.337448559603,102.82921810699504,8
796,32,2,4,197,0.009950248756218905,0.01990049751243781,0.9800995024875622,201,6100,4200,1900,0.6885245901639344,80,42,38,193.36666559238927,0.47971703980099506,0.7674674705607007,0.11645398937795957,1059086.571055005,-5341.592236283583,1053744.9788187216,795,0,238.97512437810946,87,114,45,37.74523617820719,0.5562810945273632,42.72017045454544,8232.954545454504,94.6316614420058,0
797,32,0,2,195,0.0,0.01015228426395939,0.9898477157360406,197,5700,4300,1400,0.7543859649122807,71,43,28,194.1548155187762,0.47912458130460306,0.7636703401056304,0.11734765893933607,1060164.4132653088,-3932.794784580311,1056231.6184807285,796,1,242.41116751269035,69,128,45,37.5915327398158,0.5578997461928934,42.58928571428572,8237.142857142879,119.37888198757796,0
798,32,2,1,196,0.01015228426395939,0.005076142131979695,0.9949238578680203,197,5450,3500,1950,0.6422018348623854,74,35,39,213.183665495241,0.4786066076176663,0.778879467733071,0.12708952806918655,1056009.9689452858,174.81519585452907,1056184.7841411403,797,0,243.17258883248732,80,117,34,37.617322420783914,0.5532466159052454,43.09413580246915,8220.987654321012,102.76234567901265,8
799,32,2,2,196,0.010101010101010102,0.010101010101010102,0.98989898989899,198,6200,4400,1800,0.7096774193548387,80,44,36,208.67099570669228,0.4787580756806645,0.7754096473186467,0.12525569436948844,1058087.3318347812,-1641.5725842795146,1056445.7592505016,798,0,242.85353535353536,85,113,37,37.475419198342045,0.5551872895622896,42.841569767441875,8229.069767441904,96.81258549931653,0
800,32,2,2,196,0.010101010101010102,0.010101010101010102,0.98989898989899,198,6500,4900,1600,0.7538461538461538,81,49,32,215.86529483466202,0.4788990796287751,0.7810068852130843,0.12782135997513128,1053955.5574295826,-597.5145705665072,1053358.042859016,799,0,243.76262626262627,76,122,40,37.803846897181835,0.5511889730639731,43.34415584415584,8212.987012987007,108.0656185919343,8
801,32,0,4,192,0.0,0.02040816326530612,0.9795918367346939,196,6150,4600,1550,0.7479674796747967,77,46,31,222.1918021517364,0.4783495770102913,0.7756198573140471,0.12904290106517907,1048022.4470594628,1222.3992415232515,1049244.8463009861,800,1,245.5765306122449,81,115,34,38.380972766830496,0.546609268707483,44.06758130081303,8189.837398374042,101.10910368363015,8
802,32,1,2,191,0.0051813471502590676,0.010362694300518135,0.9896373056994818,193,6200,4500,1700,0.7258064516129032,79,45,34,221.7295367220944,0.47841780008635576,0.7745373797187249,0.12934222975455623,1049375.3718025088,1735.5030074695796,1051110.8748099783,801,0,246.92746113989637,81,112,36,38.22399966931221,0.5483052677029361,43.902439024390276,8195.121951219593,101.1743450767851,0
803,32,2,1,192,0.010362694300518135,0.0051813471502590676,0.9948186528497409,193,5350,3600,1750,0.6728971962616822,71,36,35,235.77730313105525,0.47828961571675305,0.7974149744797101,0.13616959554586802,1046298.4774846273,5388.68665829099,1051687.1641429183,802,0,247.8082901554404,70,123,36,38.248828647925045,0.5437176165803108,44.27816901408451,8183.098591549306,116.90140845070437,8
804,32,0,0,192,0.0,0.0,1.0,192,5700,4200,1500,0.7368421052631579,72,42,30,238.14857168741318,0.47779754762943577,0.7984696545089516,0.13806149495399278,1047468.1284011988,5790.607733366595,1053258.7361345654,803,1,250.078125,72,120,35,38.04189206774116,0.5452473958333333,44.13527397260273,8187.671232876695,113.71765601217632,0
805,32,0,3,189,0.0,0.015625,0.984375,192,7100,4900,2200,0.6901408450704225,93,49,44,241.4678875682447,0.4774720267961024,0.8023011122258976,0.1408549945862345,1049372.5956790147,5177.956790123541,1054550.5524691383,804,2,251.078125,74,118,38,37.71885225156824,0.5475802951388888,43.902777777777786,8195.11111111113,110.74474474474499,0
806,32,1,2,188,0.005263157894736842,0.010526315789473684,0.9894736842105263,190,5450,3600,1850,0.6605504587155964,73,36,37,217.9656638713007,0.4773861737677527,0.7714278729801758,0.12786923005855844,1051113.151927435,2371.315192743682,1053484.4671201787,805,0,253.02105263157895,69,121,40,38.10380863910821,0.5486293859649123,43.69047619047618,8201.904761904741,118.86818495514117,7
807,32,4,1,191,0.020833333333333332,0.005208333333333333,0.9947916666666666,192,6150,4500,1650,0.7317073170731707,78,45,33,221.7133690978133,0.4777731193644561,0.7808294830628952,0.12903654825181984,1048670.58847841,1950.8578490668397,1050621.4463274768,806,0,249.3125,82,110,35,38.31233557200515,0.5446506076388888,43.98845381526104,8192.369477911632,99.90694485258088,8
808,32,1,1,191,0.005208333333333333,0.005208333333333333,0.9947916666666666,192,6250,4900,1350,0.784,76,49,27,227.62400976142456,0.4778895796974985,0.788491740808063,0.1331479448257506,1050223.077662434,3161.1976163013233,1053384.2752787352,807,0,250.26041666666666,84,108,38,37.967270161676076,0.546875,43.79901960784313,8198.431372548992,97.6003734827261,0
809,32,0,0,191,0.0,0.0,1.0,191,6150,4500,1650,0.7317073170731707,78,45,33,217.78136955531346,0.47766946817305045,0.7752992967355716,0.12211361394110215,1037095.7783407263,822.0277934150545,1037917.8061341413,808,1,252.05759162303664,72,119,39,39.860651832754215,0.5344131762652705,45.40525114155248,8147.031963470248,113.15322171486456,8
810,32,2,0,193,0.010362694300518135,0.0,1.0,193,5400,3500,1900,0.6481481481481481,73,35,38,197.88360988115193,0.47784771696891193,0.7585857900743433,0.10981727813050653,1033846.4640132022,-3083.74592764067,1030762.7180855615,809,0,250.43523316062175,71,122,43,40.77428381711251,0.5314119170984456,45.804398148148145,8134.259259259254,114.56703182055287,8
811,32,2,0,195,0.010256410256410256,0.0,1.0,195,6900,5300,1600,0.7681159420289855,85,53,32,195.630284632665,0.47815005727376864,0.7580088851575884,0.10946335773720874,1036437.1141975302,-5348.3024691358405,1031088.8117283944,810,0,248.85641025641024,74,121,41,40.50704865848109,0.5338141025641026,45.48611111111111,8144.44444444444,110.06006006006,0
812,32,2,4,193,0.01015228426395939,0.02030456852791878,0.9796954314720813,197,6350,4500,1850,0.7086614173228346,82,45,37,198.61682804795853,0.47839402258365277,0.7692172170408615,0.11031609365073367,1034109.5371972327,-4671.688773548631,1029437.8484236841,811,0,247.3197969543147,67,130,42,40.72266409576604,0.5294521996615905,45.77205882352941,8135.294117647066,121.42230026338905,8
813,32,4,2,195,0.02030456852791878,0.01015228426395939,0.9898477157360406,197,6450,3800,2650,0.5891472868217055,91,38,53,199.22857504683287,0.47897566386960877,0.7693606495732528,0.1118764364470037,1037560.8437063448,-4507.646316799055,1033053.1973895457,812,0,245.65989847715736,72,125,44,40.27478146363331,0.532519035532995,45.348173515981735,8148.858447488585,113.17858954845256,0
814,32,3,4,194,0.015151515151515152,0.020202020202020204,0.9797979797979798,198,5950,4300,1650,0.7226890756302521,76,43,33,194.3815449528948,0.479256930557692,0.76410825168721,0.10973790606435689,1039230.1991388854,-5148.5656659356755,1034081.6334729497,813,0,245.31313131313132,76,122,37,40.189456269794924,0.5343539562289562,45.14339826839827,8155.411255411264,107.30804283435874,0
815,32,1,4,191,0.005128205128205128,0.020512820512820513,0.9794871794871794,195,5350,3900,1450,0.7289719626168224,68,39,29,199.0542092595909,0.4784760771874174,0.7614037634798887,0.11199881968782956,1038178.1106180105,-3019.255424063347,1035158.8551939472,814,0,247.62564102564102,77,118,42,40.201976512530166,0.5343482905982906,45.272435897435884,8151.28205128202,105.86080586080546,8
816,32,2,2,191,0.010362694300518135,0.010362694300518135,0.9896373056994818,193,6250,4600,1650,0.736,79,46,33,212.79194419704623,0.47790618703223947,0.7780713024554802,0.1181425999983267,1033984.9194120057,-845.2677455785733,1033139.6516664271,815,0,249.77202072538861,67,126,40,40.37793763181679,0.5282815198618307,45.787377450980394,8134.803921568633,121.41498390400945,8
817,32,1,1,191,0.005208333333333333,0.005208333333333333,0.9947916666666666,192,5550,3700,1850,0.6666666666666666,74,37,37,214.1872171841593,0.4777401696116928,0.7783326432801363,0.11938834311322491,1035231.4351751747,396.66804834688355,1035628.1032235216,816,0,250.42708333333334,67,125,41,40.18600070259962,0.5301106770833333,45.634191176470594,8139.705882352955,121.4881474978053,0
818,32,3,3,191,0.015463917525773196,0.015463917525773196,0.9845360824742269,194,6000,4300,1700,0.7166666666666667,77,43,34,205.27185502895387,0.47788190178587325,0.7689585788705797,0.11527557873105675,1037575.9449785405,-2202.9722081670357,1035372.9727703735,817,0,248.01546391752578,76,118,40,40.11899702507438,0.5326997422680413,45.34632034632034,8148.917748917735,107.22260195944388,0
819,32,2,3,190,0.010362694300518135,0.015544041450777202,0.9844559585492227,193,6700,4800,1900,0.7164179104477612,86,48,38,204.19302282190776,0.4780051363701785,0.7688066970347582,0.11551271868911069,1039868.8178168373,-2833.2085503474154,1037035.60926649,818,0,250.05181347150258,79,114,38,39.859511466367024,0.5347582037996546,45.06510416666666,8157.916666666643,103.26476793248915,0
820,32,1,4,187,0.005235602094240838,0.020942408376963352,0.9790575916230366,191,5400,3700,1700,0.6851851851851852,71,37,34,202.70759684763462,0.47778198769174246,0.7641354047710558,0.11520311399905175,1041309.5010065443,-1383.730695270986,1039925.7703112734,819,0,250.717277486911,85,106,40,39.717263317823544,0.537085514834206,44.88856589147285,8163.565891472823,96.04195166438615,0
821,32,3,0,190,0.015789473684210527,0.0,1.0,190,7150,5000,2150,0.6993006993006993,93,50,43,208.10045650963016,0.4783422677063028,0.7582744343379568,0.11670670098008754,1037153.1700092482,-1983.5903701334591,1035169.5796391148,820,0,252.7157894736842,78,112,40,40.099931810727284,0.5325109649122808,45.39820675105482,8147.257383966169,104.45201774315602,8
822,32,1,1,190,0.005235602094240838,0.005235602094240838,0.9947643979057592,191,5450,3900,1550,0.7155963302752294,70,39,31,210.36483712519856,0.47837214108569853,0.7618366848481077,0.11868118268599707,1039019.2084418345,64.62131076353762,1039083.8297525981,821,0,252.38743455497382,79,112,35,39.808528349769205,0.5341950261780104,45.169270833333314,8154.583333333288,103.22257383966186,0
823,32,0,4,186,0.0,0.021052631578947368,0.9789473684210527,190,5400,4100,1300,0.7592592592592593,67,41,26,210.87370010256447,0.47795124385036664,0.7615128218912988,0.11933257364185458,1039975.0434027665,460.6770833328019,1040435.7204860992,822,1,251.64736842105262,83,107,37,39.675902281239345,0.5362390350877193,45.0520833333333,8158.333333333244,98.29317269076198,0
824,32,1,0,187,0.0053475935828877,0.0,1.0,187,6100,4000,2100,0.6557377049180327,82,40,42,213.3263110539815,0.4783317041381558,0.7614644084097208,0.11788965880666505,1032514.9966359144,552.5230680509958,1033067.5197039654,823,0,255.68449197860963,84,103,38,40.54896923794364,0.5283533868092691,45.968137254901976,8129.019607843179,96.77404295051403,8
825,32,1,2,186,0.005319148936170213,0.010638297872340425,0.9893617021276596,188,6200,4600,1600,0.7419354838709677,78,46,32,199.61975206000056,0.47858058842492507,0.7563459485886213,0.11127820167149385,1035259.1440543509,-2468.3652692046076,1032790.7787851463,824,0,255.31914893617022,71,117,41,40.55307511470067,0.5305296985815603,45.630787037037024,8139.814814814779,114.6452790818983,8
826,32,2,1,187,0.010638297872340425,0.005319148936170213,0.9946808510638298,188,5300,3900,1400,0.7358490566037735,67,39,28,192.0871979756999,0.47819303011339936,0.7466525179759793,0.10785390727328098,1037525.065746213,-3040.943458251485,1034484.1222879614,825,0,255.37234042553192,77,111,43,40.461112859240615,0.5331892730496454,45.35256410256408,8148.717948717896,105.82750582750515,0
827,32,1,4,184,0.005319148936170213,0.02127659574468085,0.9787234042553191,188,5500,4000,1500,0.7272727272727273,70,40,30,190.03404504536053,0.47805969583191105,0.743916600898739,0.10718828928476518,1038952.3557765521,-3612.736244475253,1035339.6195320769,826,0,254.2340425531915,80,108,39,40.33497350492046,0.534906914893617,45.17746913580245,8154.3209876542705,101.92901234567839,0
828,32,6,1,189,0.031578947368421054,0.005263157894736842,0.9947368421052631,190,5600,4000,1600,0.7142857142857143,72,40,32,207.83722319398007,0.47838926018750577,0.7704884141614259,0.11650325079956167,1037002.7777777811,-494.4444444442606,1036508.3333333369,827,0,251.92631578947368,69,121,39,40.12547735951992,0.5263157894736843,45.41666666666668,8146.666666666693,118.06763285024194,8
829,32,2,3,188,0.010471204188481676,0.015706806282722512,0.9842931937172775,191,5200,3800,1400,0.7307692307692307,66,38,28,198.34512928850071,0.47850188297970053,0.7632769300083304,0.10821295285341449,1028440.1256001325,-2602.782064472136,1025837.3435356604,828,0,251.0890052356021,71,120,43,41.441261508027104,0.5218695462478184,46.46990740740739,8112.962962962925,114.26708398539331,8
830,32,5,2,191,0.025906735751295335,0.010362694300518135,0.9896373056994818,193,5250,3400,1850,0.6476190476190476,71,34,37,197.965916954823,0.47886194768278645,0.7577807142608737,0.10638234029146125,1023594.3453741871,-3322.6413656451896,1020271.7040085419,829,0,249.09326424870466,80,113,42,42.060707748627216,0.517756908462867,47.06790123456792,8093.827160493878,101.17283950617347,8
831,32,2,0,193,0.010362694300518135,0.0,1.0,193,6100,4100,2000,0.6721311475409836,81,41,40,214.9853207730566,0.47923413212435234,0.7705538421748888,0.11678457075904058,1027058.5401099825,-539.4980603497997,1026519.0420496326,830,0,249.32124352331607,70,123,42,41.19339568012045,0.5206174438687392,46.640258215962426,8107.511737089166,115.82159624413094,0
832,32,7,6,194,0.035,0.03,0.97,200,6850,4700,2150,0.6861313868613139,90,47,43,215.12353480734342,0.4798728015075377,0.7805088260827615,0.11907024481301326,1033013.1584006198,-2404.9115724718977,1030608.2468281479,831,0,241.56,84,116,41,40.44072135944183,0.5253645833333334,45.90686274509805,8130.9803921569,96.79738562091548,0
833,32,7,3,198,0.03482587064676617,0.014925373134328358,0.9850746268656716,201,5650,3900,1750,0.6902654867256637,74,39,35,219.67329401793785,0.4800217661691542,0.7883224797842003,0.12140635922402654,1032538.9560967728,-485.75326247602607,1032053.2028342967,832,0,239.98009950248758,78,123,40,40.384723519844975,0.5199523217247097,45.9651898734177,8129.113924050581,104.21940928269976,8
834,32,4,1,201,0.019801980198019802,0.0049504950495049506,0.995049504950495,202,6600,4700,1900,0.7121212121212122,85,47,38,219.00956547992405,0.48049408485624684,0.7895247673150334,0.12251399330474814,1036357.4556690692,-1605.5607904075496,1034751.8948786616,833,0,239.73762376237624,70,132,40,39.922008608597075,0.5230507425742574,45.495892018779344,8144.1314553990605,116.34473507712944,0
835,32,1,6,196,0.0049504950495049506,0.0297029702970297,0.9702970297029703,202,6400,4200,2200,0.65625,86,42,44,230.2339224508273,0.48110673940528376,0.7947049264196933,0.12666715800388323,1031102.3472031703,678.9475689682131,1031781.2947721385,834,0,240.63366336633663,80,122,34,40.297302431610916,0.5179971122112211,46.141975308641975,8123.456790123457,101.54320987654322,7
836,32,4,1,199,0.02,0.005,0.995,200,6600,5100,1500,0.7727272727272727,81,51,30,184.98888970928212,0.481900649078727,0.7504117264901744,0.09999794503424513,1025489.3362621212,-8659.173255232203,1016830.163006889,835,0,243.11,75,125,45,42.15058966307545,0.51046875,46.83388157894738,8101.3157894737005,108.01754385964934,8
837,32,7,7,199,0.03398058252427184,0.03398058252427184,0.9660194174757282,206,5300,3600,1700,0.6792452830188679,70,36,34,226.1755145159832,0.4827003907174994,0.8027098944319175,0.12315007473745995,1027802.5451102675,-7.246107769763512,1027795.2990024977,836,0,236.97087378640776,66,140,40,40.81605528973948,0.5089502427184466,46.54850746268656,8110.447761194013,122.88557213930322,8
838,32,3,1,201,0.01485148514851485,0.0049504950495049506,0.995049504950495,202,5650,4400,1250,0.7787610619469026,69,44,25,222.20145276574425,0.48268096399192156,0.7956671976098133,0.12189171077306211,1030175.9667670177,-268.6807160027365,1029907.286051015,837,0,238.78217821782178,68,134,43,40.61781096303346,0.5113964521452146,46.25603864734299,8119.806763285013,119.40892298948549,0
839,32,2,1,202,0.009852216748768473,0.0049261083743842365,0.9950738916256158,203,7350,5600,1750,0.7619047619047619,91,56,35,234.14005114966622,0.483105114698662,0.8099635793203954,0.1258233717158733,1023599.1494082891,-16.888560157375196,1023582.2608481317,838,0,238.57142857142858,64,139,35,41.14514034087311,0.5049261083743842,47.067307692307715,8093.846153846194,126.46634615384679,8
840,32,8,5,205,0.0380952380952381,0.023809523809523808,0.9761904761904762,210,6500,4800,1700,0.7384615384615385,82,48,34,235.3342699258982,0.48444548872180454,0.8143909796597222,0.12906295447650692,1030094.8759040126,-16.674884944030964,1030078.2010190686,839,0,231.57142857142858,64,146,42,40.294795679909065,0.509375,46.26602564102565,8119.487179487196,126.86698717948744,0
841,32,2,3,204,0.00966183574879227,0.014492753623188406,0.9855072463768116,207,6350,4400,1950,0.6929133858267716,83,44,39,223.7920546436431,0.4838519925581977,0.804430923976271,0.123878269805961,1033038.7429236629,-1512.8274389257035,1031525.9154847371,840,0,235.83574879227052,73,134,43,40.21724327368749,0.5158011272141707,45.9037162162162,8131.081081081049,111.38467234357601,8
842,32,1,4,201,0.004878048780487805,0.01951219512195122,0.9804878048780488,205,7650,5700,1950,0.7450980392156863,96,57,39,222.16113458652268,0.48371094372708434,0.7999135963635342,0.1214636771623578,1029115.1428222657,-2924.122450086844,1026191.0203721789,841,0,239.1219512195122,63,142,41,40.7524173191289,0.5091971544715448,46.38671875,8115.625000000001,128.81944444444446,8
843,32,4,1,204,0.01951219512195122,0.004878048780487805,0.9951219512195122,205,5500,3900,1600,0.7090909090909091,71,39,32,216.30210624712257,0.48408556512035705,0.7943080115840058,0.11952475267897511,1032490.0917015119,-1834.0436971354966,1030656.0480043764,842,0,237.71219512195123,67,138,41,40.47650455285536,0.5125,45.97120098039217,8128.921568627473,121.32718759145482,0
844,32,2,4,202,0.009708737864077669,0.019417475728155338,0.9805825242718447,206,6250,4100,2150,0.656,84,41,43,214.60292375274398,0.48408270187070807,0.7917083860847014,0.11925692892001491,1034273.1094360371,-3058.3933512368376,1031214.7160848003,843,0,237.41747572815535,63,143,41,40.29571570322004,0.5146136731391586,45.75195312500001,8135.9375000000155,129.14186507936532,0
845,32,3,2,203,0.014634146341463415,0.00975609756097561,0.9902439024390244,205,7100,5200,1900,0.7323943661971831,90,52,38,210.71245943040753,0.48393212976247413,0.787590458322164,0.11836317165535272,1037661.5059033222,-4370.358406970029,1033291.1474963522,844,0,239.46829268292683,66,139,46,39.96972934472933,0.5175813008130081,45.335820895522396,8149.253731343308,123.47354138398951,0
846,32,0,2,201,0.0,0.009852216748768473,0.9901477832512315,203,6800,5200,1600,0.7647058823529411,84,52,32,210.862090049809,0.48383671495228336,0.7861365933202158,0.11886025075992068,1038752.168146111,-3593.3093561879405,1035158.858789923,845,1,242.6551724137931,65,138,42,39.82929674595308,0.5189860426929392,45.202020202020215,8153.535353535381,125.43900543900585,0
847,32,0,4,197,0.0,0.01990049751243781,0.9800995024875622,201,6400,4900,1500,0.765625,79,49,30,218.52609033345803,0.4837282338308458,0.7849149751538347,0.12269556459067041,1037516.4744200051,-1255.1162376890156,1036261.3581823161,846,2,245.00497512437812,75,126,37,39.78893060265174,0.5211961028192371,45.3536184210526,8148.684210526246,108.64912280701661,8
848,32,1,2,196,0.005050505050505051,0.010101010101010102,0.98989898989899,198,6550,4400,2150,0.6717557251908397,87,44,43,224.16224438308004,0.4833172033362389,0.7852865629776709,0.1263095471608684,1038633.6450879044,414.4897949365004,1039048.1348828409,847,0,248.67676767676767,75,123,40,39.50527417648429,0.5229903198653199,45.216557017543835,8153.070175438539,108.70760233918053,0
849,32,2,2,196,0.010101010101010102,0.010101010101010102,0.98989898989899,198,6250,4400,1850,0.704,81,44,37,221.04827701147687,0.4830864696029671,0.784408829329148,0.12552741522597383,1041063.520391296,175.05948839941266,1041238.5798796954,848,0,249.5050505050505,81,117,36,39.280170982735676,0.5257260101010102,44.91869918699185,8162.601626016217,100.77285958044712,0
850,32,4,4,196,0.02,0.02,0.98,200,4750,2900,1850,0.6105263157894737,66,29,37,217.8615853655463,0.483376256281407,0.7853953106416718,0.1249360835595797,1044110.2464045379,744.3027156209064,1044854.5491201589,849,0,247.96,71,129,39,38.98035009722302,0.5282291666666667,44.5457175925926,8174.537037037058,115.13432446531068,0
851,32,2,1,197,0.010101010101010102,0.005050505050505051,0.9949494949494949,198,6400,4800,1600,0.75,80,48,32,215.4464532334301,0.48317459707053617,0.7821518097711682,0.12438333805207571,1046188.0277777811,-920.4999999997926,1045267.5277777814,850,0,250.43434343434345,74,124,41,38.78252131877684,0.5311447811447811,44.29166666666668,8182.666666666693,110.57657657657694,0
852,32,1,4,194,0.005050505050505051,0.020202020202020204,0.9797979797979798,198,6100,4000,2100,0.6557377049180327,82,40,42,218.1241297733371,0.48348918542446456,0.7830279856235325,0.12661105133237918,1047853.5617070573,12.429255448922959,1047865.9909625063,851,0,250.62121212121212,76,122,36,38.5061496713714,0.5334069865319866,44.08820346320348,8189.177489177531,107.75233538391488,0
853,32,0,2,192,0.0,0.010309278350515464,0.9896907216494846,194,5550,4000,1550,0.7207207207207207,71,40,31,219.0460468133332,0.48293304755800087,0.7789721831578489,0.1276224177338173,1049003.7904582634,1606.0266784170844,1050609.8171366805,852,1,255.56185567010309,78,116,36,38.33906225861271,0.5351696735395188,43.94778481012659,8193.670886075975,105.04706264199969,0
854,32,0,2,190,0.0,0.010416666666666666,0.9895833333333334,192,6050,4600,1450,0.7603305785123967,75,46,29,221.10145072996602,0.48274001054392085,0.7862240115882766,0.12427426368615255,1037851.5624999929,1444.0972222217433,1039295.6597222147,853,2,258.34375,63,129,41,39.68132242672118,0.5245225694444444,45.31249999999997,8149.999999999944,129.36507936507846,8
855,32,4,4,190,0.020618556701030927,0.020618556701030927,0.979381443298969,194,7000,5100,1900,0.7285714285714285,89,51,38,193.2763200107373,0.4828829701048733,0.7441257826895611,0.11019979200612195,1042318.832639344,-5508.890349916075,1036809.942289428,854,0,256.5257731958763,77,117,43,39.83186828519606,0.5372100515463918,44.76495726495726,8167.521367521356,106.07170607170593,8
856,32,2,2,190,0.010416666666666666,0.010416666666666666,0.9895833333333334,192,6600,4700,1900,0.7121212121212122,85,47,38,212.534527722299,0.482620141615765,0.7705946275280087,0.11905051418381035,1036776.4938271542,-929.8395061732208,1035846.6543209809,855,0,259.0729166666667,74,118,37,40.03425996653569,0.5300021701388888,45.44444444444442,8145.777777777727,110.0780780780774,8
857,32,6,4,192,0.030612244897959183,0.02040816326530612,0.9795918367346939,196,6750,4800,1950,0.7111111111111111,87,48,39,204.62411294679853,0.48254186289900575,0.7673823884440139,0.11609076558639829,1040768.7073595447,-3356.7252947538555,1037411.9820647908,856,0,254.45408163265307,82,114,34,39.73597989043073,0.5336947278911565,44.95481927710839,8161.445783132419,99.52982662356608,0
858,32,1,6,187,0.0051813471502590676,0.031088082901554404,0.9689119170984456,193,6100,4700,1400,0.7704918032786885,75,47,28,232.98575433769278,0.4822071099597007,0.7972277734841242,0.1326496782234208,1041870.7897086338,3848.2103725350416,1045719.0000811688,857,0,258.9481865284974,73,120,42,38.87448514268906,0.5306563039723662,44.81981981981984,8165.765765765815,111.85980501049062,7
859,32,2,0,189,0.010582010582010581,0.0,1.0,189,5950,4400,1550,0.7394957983193278,75,44,31,238.04853394516954,0.481238742541934,0.7831434782926152,0.13453240781628198,1039561.2080920412,5743.204306515396,1045304.4123985566,858,0,260.72486772486775,76,113,29,39.03502370590524,0.5271164021164021,45.10281385281382,8156.709956709869,107.32513100934038,8
860,32,5,2,192,0.02577319587628866,0.010309278350515464,0.9896907216494846,194,6050,3900,2150,0.6446280991735537,82,39,43,224.82750271107642,0.4820589177928529,0.7837067118552967,0.12717422286178906,1039840.5815485405,1906.9522334383523,1041747.5337819789,859,0,254.97938144329896,78,116,37,39.33700562049584,0.5283505154639175,45.06856540084388,8157.805907172992,104.58725522016657,8
861,32,1,2,191,0.0051813471502590676,0.010362694300518135,0.9896373056994818,193,5650,3600,2050,0.6371681415929203,77,36,41,218.88108353759128,0.482116031591825,0.7775362847657383,0.12454104857731287,1041675.3906250047,1350.6076388890942,1043025.9982638938,860,0,256.6062176165803,79,114,40,39.25886235286113,0.530332469775475,44.843750000000014,8165.000000000036,103.3544303797473,0
862,32,2,0,193,0.010362694300518135,0.0,1.0,193,6550,5000,1550,0.7633587786259542,81,50,31,222.02892561983387,0.48219586571675305,0.7880876118699944,0.1246080705009278,1037379.9725651629,915.6721536353748,1038295.6447187983,861,0,256.419689119171,71,122,41,39.71685606060609,0.5267163212435233,45.37037037037039,8148.148148148189,114.76264997391816,8
863,32,3,2,194,0.015306122448979591,0.01020408163265306,0.9897959183673469,196,4900,3700,1200,0.7551020408163265,61,37,24,223.79497271028524,0.48227858451072736,0.7939441446936804,0.12669002076557323,1040086.8656702093,2453.2423437982343,1042540.1080140076,862,0,253.4795918367347,75,121,41,39.332464251155805,0.5293898809523809,45.038377192982466,8158.771929824586,108.78362573099447,0
864,32,3,0,197,0.015228426395939087,0.0,1.0,197,6100,4500,1600,0.7377049180327869,77,45,32,216.64508552433918,0.48251191339479954,0.782533701910785,0.12397727559978769,1043457.3152232264,-288.02014049336594,1043169.295082733,863,0,253.12690355329948,68,129,38,39.09304307558918,0.5299280879864636,44.6256038647343,8171.980676328508,120.1761864165957,7
865,32,3,4,196,0.015,0.02,0.98,200,6300,4500,1800,0.7142857142857143,81,45,36,213.3512291817269,0.4830904522613065,0.7825532983591923,0.12307879344746225,1045949.8472717399,-1669.062884427024,1044280.7843873128,864,0,250.315,72,128,42,38.8658285895003,0.5326041666666667,44.320776255707756,8181.735159817337,113.63521055301857,0
866,32,2,1,197,0.010101010101010102,0.005050505050505051,0.9949494949494949,198,5800,4200,1600,0.7241379310344828,74,42,32,224.0914148380649,0.482659184911723,0.7881010682063476,0.13013969433410139,1048007.1882716088,1569.882716049523,1049577.0709876583,865,0,249.27777777777777,74,124,37,38.334260414970785,0.5356165824915825,44.06944444444446,8189.777777777808,110.67267267267309,0
867,32,2,0,199,0.010050251256281407,0.0,1.0,199,6400,3800,2600,0.59375,90,38,52,221.69051078845928,0.4824099453496438,0.7868973726011212,0.1296619133831039,1050187.0114690638,363.2989991965251,1050550.3104682604,866,0,249.01507537688443,77,122,41,38.123783708646094,0.5378978224455611,43.80341880341881,8198.290598290607,106.47130647130658,0
868,32,2,3,198,0.009950248756218905,0.014925373134328358,0.9850746268656716,201,5950,4300,1650,0.7226890756302521,76,43,33,200.25150065200748,0.48260883084577116,0.7717874023799796,0.11501273993545118,1044583.3634741572,-4314.1227816354785,1040269.2406925217,867,0,247.5273631840796,71,130,43,39.37117801936471,0.532960199004975,44.48784722222224,8176.388888888936,115.16040688575966,8
869,32,0,2,196,0.0,0.010101010101010102,0.98989898989899,198,6450,3800,2650,0.5891472868217055,91,38,53,198.10743027922973,0.48252405612811705,0.7660780284001034,0.11415550380998443,1045599.6310804667,-4621.788797147383,1040977.8422833193,868,1,251.94949494949495,72,126,44,39.29923713833843,0.5349326599326599,44.36358447488586,8180.365296803697,113.61618467782912,0
870,32,1,1,196,0.005076142131979695,0.005076142131979695,0.9949238578680203,197,6550,4400,2150,0.6717557251908397,87,44,43,231.76253409356036,0.48253349563175524,0.7882361081702647,0.12916586225175142,1035185.1225906998,2033.4254535145228,1037218.5480442144,869,0,253.87817258883248,69,128,37,39.74476637609939,0.5262796108291032,45.63988095238094,8139.523809523785,117.96411318150413,7
871,32,5,4,197,0.024875621890547265,0.01990049751243781,0.9800995024875622,201,6600,4900,1700,0.7424242424242424,83,49,34,225.58949743895806,0.4827757048092869,0.7888062606597563,0.12731141260500506,1039119.8745338296,82.90605498375953,1039202.7805888134,870,0,247.53233830845772,76,125,33,39.40793431716034,0.5296434494195688,45.15692640692639,8154.978354978308,107.30234677603036,0
872,32,4,2,199,0.01990049751243781,0.009950248756218905,0.9900497512437811,201,5950,4100,1850,0.6890756302521008,78,41,37,232.27781000173403,0.4824979270315091,0.7995465410625535,0.13007094501624836,1036683.0359226587,2009.6930500128778,1038692.7289726717,871,0,246.2537313432836,68,133,39,39.54342367989246,0.525342039800995,45.455917874396135,8145.410628019325,119.78545041204889,7
873,32,2,2,199,0.009950248756218905,0.009950248756218905,0.9900497512437811,201,6900,5100,1800,0.7391304347826086,87,51,36,228.04790717043028,0.48238184079601987,0.7960944765158984,0.12856529260837468,1038795.0638717442,279.0080589851286,1039074.0719307293,872,0,247.19900497512438,71,130,35,39.38602468014232,0.5275186567164178,45.19675925925927,8153.703703703721,114.84089723526367,0
874,32,0,2,197,0.0,0.010050251256281407,0.9899497487437185,199,6400,4600,1800,0.71875,82,46,36,227.73315169186526,0.48191821904133464,0.7943938355499187,0.12880222914240172,1039802.788430329,1159.5132294461068,1040962.3016597751,873,1,250.6532663316583,73,126,38,39.26766979569301,0.5286327470686767,45.07319819819822,8157.657657657711,111.748735036407,0
875,32,2,3,196,0.010050251256281407,0.01507537688442211,0.9849246231155779,199,6550,4900,1650,0.7480916030534351,82,49,33,230.3502969562925,0.48148148148148145,0.8002436897914877,0.13158856586393344,1042911.0371000281,1696.9734189973583,1044608.0105190255,874,0,251.41708542713567,62,137,39,38.811443559354984,0.5310406197654942,44.69246031746033,8169.841269841293,131.77163338453698,0
876,32,2,4,194,0.010101010101010102,0.020202020202020204,0.9797979797979798,198,5950,4400,1550,0.7394957983193278,75,44,31,229.65679263445725,0.48191357312550204,0.7968175113281637,0.13221797926466544,1045325.5128622091,2463.2209085809095,1047788.73377079,875,0,252.32828282828282,65,133,41,38.527001646598784,0.5333017676767677,44.397095959595966,8179.292929292938,125.83527583527598,0
877,32,4,1,197,0.020202020202020204,0.005050505050505051,0.9949494949494949,198,4550,2900,1650,0.6373626373626373,62,29,33,237.30248231414845,0.4819771317233246,0.800467853659343,0.13302001531554514,1037002.7777777738,5066.666666666449,1042069.4444444402,876,0,252.4090909090909,69,129,36,39.37534097108564,0.5230429292929293,45.41666666666665,8146.666666666635,118.06763285024108,8
878,32,4,2,199,0.01990049751243781,0.009950248756218905,0.9900497512437811,201,6750,4500,2250,0.6666666666666666,90,45,45,246.03426475567053,0.4823756218905473,0.8132897870617051,0.13446525735013937,1028995.0642791506,3683.608815426731,1032678.6730945773,877,0,249.4825870646766,65,136,37,40.16212347523026,0.5132151741293532,46.401515151515135,8115.151515151478,124.84848484848428,8
879,32,5,4,200,0.024509803921568627,0.0196078431372549,0.9803921568627451,204,6450,4500,1950,0.6976744186046512,84,45,39,237.6970353229711,0.48299858736598084,0.8104674259640983,0.1316202986639132,1033146.9318821484,1865.1925522818046,1035012.1244344302,878,0,246.75,72,132,37,39.85030136268346,0.5165951797385622,45.89041095890409,8131.506849315021,112.9375951293753,0
880,32,4,0,204,0.0196078431372549,0.0,1.0,204,6450,4600,1850,0.7131782945736435,83,46,37,240.74807960773325,0.4832259771724782,0.8141805488352805,0.1304946597109433,1026361.9614512466,2168.934240362831,1028530.8956916095,879,0,244.72058823529412,62,142,35,40.62867215041128,0.5081188725490196,46.726190476190474,8104.761904761901,130.7219662058371,8
881,32,7,3,208,0.03317535545023697,0.014218009478672985,0.985781990521327,211,6850,4900,1950,0.7153284671532847,88,49,39,243.2328048491605,0.48441378921236744,0.8182113611020689,0.1342238790163787,1032060.4411878113,1156.191176794494,1033216.6323646058,880,0,237.56872037914692,70,141,37,39.846533032946276,0.5156496840442337,46.024061032863834,8127.230046948323,116.10328638497604,8
882,32,1,3,206,0.004784688995215311,0.014354066985645933,0.9856459330143541,209,6100,4100,2000,0.6721311475409836,81,41,40,247.20245320108097,0.4842791528646792,0.8201572498896237,0.13677482698199103,1032895.272653133,3166.849059930809,1036062.1217130638,881,0,240.58373205741626,70,139,38,39.640475228086366,0.5171451355661882,45.921361502347416,8130.5164319248815,116.15023474178402,0
883,32,5,2,209,0.023696682464454975,0.009478672985781991,0.990521327014218,211,6250,4100,2150,0.656,84,41,43,233.20266215489846,0.48448525539757764,0.8108270902679686,0.13074394413716603,1037055.816650394,-81.16455078100716,1036974.652099613,882,0,239.13270142180096,63,148,43,39.473053317990065,0.5203396524486572,45.410156250000014,8146.875000000026,129.3154761904766,0
884,32,4,3,210,0.018779342723004695,0.014084507042253521,0.9859154929577465,213,7750,5100,2650,0.6580645161290323,104,51,53,198.2810587607286,0.48423428411137687,0.7840907419288761,0.11012960010686279,1034109.5371972347,-9341.133217992952,1024768.4039792417,883,0,237.48356807511738,67,146,46,40.73120028922631,0.5208822378716744,45.77205882352942,8135.294117647081,121.42230026338927,8
885,32,4,3,211,0.018691588785046728,0.014018691588785047,0.985981308411215,214,7300,5200,2100,0.7123287671232876,94,52,42,221.56459937515515,0.4845987268366168,0.8053257613021516,0.12232038071164178,1032199.5563271561,-4360.223765432357,1027839.3325617238,884,0,235.44392523364485,71,143,38,40.37935748462061,0.5174746884735202,46.00694444444443,8127.777777777743,114.47574334898229,7
886,32,6,7,210,0.027649769585253458,0.03225806451612903,0.967741935483871,217,6450,4400,2050,0.6821705426356589,85,44,41,233.8307613600589,0.48542395602207433,0.8142501449750621,0.1309362958424212,1036672.78860168,-1368.802512002715,1035303.9860896772,885,0,231.3963133640553,71,146,38,39.50518169072789,0.5245775729646698,45.457175925925924,8145.370370370367,114.7235263432446,8
887,32,3,2,211,0.014084507042253521,0.009389671361502348,0.9906103286384976,213,6650,4700,1950,0.706766917293233,86,47,39,247.25653459200376,0.4849770794578794,0.8141369945997972,0.1395365430877072,1039113.9112085081,2135.5409463518645,1041249.4521548599,886,0,234.7511737089202,73,140,32,38.85651421417,0.5298317683881064,45.157657657657666,8154.954954954973,111.71171171171196,8
888,32,4,6,209,0.018604651162790697,0.027906976744186046,0.9720930232558139,215,5950,4200,1750,0.7058823529411765,77,42,35,216.3794792557972,0.48507299137868576,0.7924518460389014,0.12127542953985694,1036960.8714796153,-4074.5893241208423,1032886.2821554944,887,0,233.53953488372093,80,135,35,39.913261096517836,0.526453488372093,45.42181069958847,8146.502057613143,101.83127572016429,8
889,32,4,6,207,0.018779342723004695,0.028169014084507043,0.971830985915493,213,6750,5300,1450,0.7851851851851852,82,53,29,221.8484233971677,0.4848156022086397,0.7977386004038585,0.12593229260701175,1040940.9793962342,-3163.7769742883775,1037777.2024219458,888,0,236.2112676056338,87,126,34,39.2751067384444,0.530956572769953,44.93371212121212,8162.121212121205,93.81748519679546,0
890,32,6,4,209,0.028169014084507043,0.018779342723004695,0.9812206572769953,213,7050,5100,1950,0.723404255319149,90,51,39,223.0460151684785,0.4847362476747276,0.8020513137518517,0.12838729877622632,1045265.9326146947,-3021.519787785601,1042244.4128269091,889,0,233.93427230046947,77,136,34,38.703421895954165,0.5352112676056338,44.404380341880355,8179.059829059862,106.22155622155665,0
891,32,3,2,210,0.014150943396226415,0.009433962264150943,0.9905660377358491,212,6950,4700,2250,0.6762589928057554,92,47,45,218.05074238087724,0.48458225282422723,0.7959442650838218,0.12628823176073836,1047170.5030391795,-3682.7388825900307,1043487.7641565894,890,0,234.06132075471697,83,129,43,38.59327031830669,0.5373427672955975,44.17162698412699,8186.507936507944,98.63262574105956,0
892,32,2,7,205,0.009433962264150943,0.0330188679245283,0.9669811320754716,212,6000,4200,1800,0.7,78,42,36,218.9384646193553,0.4845626918835137,0.7977817702422951,0.12741813419953915,1048662.3159524994,-2481.496528236421,1046180.819424263,891,0,234.74056603773585,86,126,36,38.38440822498677,0.5394064465408805,43.98946360153258,8192.337164750983,95.25973447384864,0
893,32,0,7,198,0.0,0.03414634146341464,0.9658536585365853,205,6900,4400,2500,0.6376811594202898,94,44,50,240.94737730458735,0.48326956798979753,0.8107931557847838,0.140761191581143,1049830.576587938,2690.7848086049053,1052521.361396543,892,1,241.54634146341462,85,120,32,37.67495744278417,0.5422764227642276,43.84689922480618,8196.899224806142,96.43410852713109,8
894,32,0,4,194,0.0,0.020202020202020204,0.9797979797979798,198,5700,3500,2200,0.6140350877192983,79,35,44,213.25143077352155,0.48256197764446496,0.7847026756150453,0.12389774087832511,1048139.6572175081,-596.5436895793982,1047543.1135279287,893,2,250.11111111111111,78,120,39,38.595169405663505,0.5392992424242424,44.05327004219411,8190.295358649819,105.00378664935666,8
895,32,0,5,189,0.0,0.02577319587628866,0.9742268041237113,194,7050,5400,1650,0.7659574468085106,87,54,33,212.5112650841814,0.48247122215693605,0.774581886142131,0.12325145278612198,1047599.7547579672,-1324.6501629010718,1046275.1045950662,894,3,255.97938144329896,78,116,37,38.68144302449413,0.5383913230240549,44.1191983122363,8188.1856540084755,104.97673915395481,8
896,32,1,3,187,0.005263157894736842,0.015789473684210527,0.9842105263157894,190,6800,4700,2100,0.6911764705882353,89,47,42,188.2521143661399,0.4817721386800334,0.7465177072417715,0.1097784801753107,1049276.7486149569,-5294.286703601254,1043982.4619113556,895,0,259.8,75,115,41,39.09360950545921,0.5417214912280701,43.91447368421052,8194.73684210525,109.26315789473668,8
897,32,0,3,184,0.0,0.016042780748663103,0.983957219251337,187,5650,3900,1750,0.6902654867256637,74,39,35,227.68636515123677,0.48145592547869587,0.7820360075134432,0.1312706609653351,1045766.6250053624,4571.360328789702,1050337.9853341521,896,1,264.668449197861,71,116,39,38.522213890932456,0.539605614973262,44.34317129629631,8181.018518518551,115.225612936881,8
898,32,5,0,189,0.026455026455026454,0.0,1.0,189,6000,4200,1800,0.7,78,42,36,176.93684716617497,0.4818192052234605,0.7282317112967314,0.10159531092386807,1044501.4701585291,-6837.840601942755,1037663.6295565864,897,0,259.7354497354497,77,112,48,39.9770889957488,0.5372023809523809,44.49786324786327,8176.068376068437,106.18270618270698,8
899,32,3,2,190,0.015625,0.010416666666666666,0.9895833333333334,192,4700,2900,1800,0.6170212765957447,65,29,36,175.78756075689563,0.4817998063917976,0.7300730035756828,0.10171431963795649,1046878.3462224973,-6294.361821666462,1040583.9844008308,898,0,256.6614583333333,81,111,52,39.710799894053736,0.53955078125,44.20731707317076,8185.365853658622,101.05389942788422,0
900,32,3,2,191,0.015544041450777202,0.010362694300518135,0.9896373056994818,193,6000,4000,2000,0.6666666666666666,80,40,40,175.1811816345311,0.4820429440126655,0.7299826961632507,0.10207635556102619,1049036.4536386163,-7845.710894777356,1041190.7427438389,899,0,256.0362694300518,85,108,42,39.45817565436768,0.5420444732297064,43.94379844961244,8193.798449612503,96.39762881897062,0
901,32,0,1,190,0.0,0.005235602094240838,0.9947643979057592,191,6250,4600,1650,0.736,79,46,33,209.97032567968918,0.48164668871130706,0.7689768994703958,0.12186316031074856,1047815.6990510845,-447.9592835902704,1047367.7397674941,900,1,259.71204188481676,78,113,37,38.71953575845015,0.5402486910994764,44.09282700421943,8189.02953586503,104.98755815211577,8
902,32,0,3,187,0.0,0.015789473684210527,0.9842105263157894,190,6200,4300,1900,0.6935483870967742,81,43,38,209.75311016774313,0.48126102292768963,0.7666722366985008,0.12227308255527441,1049167.1727311837,-186.78448674703668,1048980.3882444366,901,2,262.06315789473683,81,109,38,38.556652445679134,0.5421052631578948,43.9278455284553,8194.308943089472,101.1643079393762,0
903,32,0,3,184,0.0,0.016042780748663103,0.983957219251337,187,6600,5100,1500,0.7727272727272727,81,51,30,211.15138783078947,0.4808509669752554,0.765926064733292,0.12337707521858379,1049886.9609349926,337.0177733749633,1050223.9787083676,902,3,267.14973262032083,80,107,39,38.431167059926054,0.5431706773618539,43.84002057613171,8197.119341563835,102.46399176954795,0
904,32,0,1,183,0.0,0.005434782608695652,0.9945652173913043,184,6450,4600,1850,0.7131782945736435,83,46,37,208.83638498850343,0.4802067246772788,0.759793062593962,0.12241456285164953,1050865.6241045583,641.7956093364564,1051507.4197138946,903,4,269.94565217391306,70,114,42,38.36861212884513,0.5448935688405797,43.72065727699528,8200.938967136099,117.15627095908712,0
905,32,1,2,182,0.005434782608695652,0.010869565217391304,0.9891304347826086,184,5800,4000,1800,0.6896551724137931,76,40,36,225.35802457692864,0.48003472222222227,0.7815429652952222,0.13126303895973687,1048917.3611111094,4676.388888888805,1053593.7499999981,904,0,270.8641304347826,69,115,38,38.1882289123949,0.5437613224637681,43.95833333333333,8193.33333333332,118.7439613526568,8
906,32,1,1,182,0.00546448087431694,0.00546448087431694,0.994535519125683,183,5450,3500,1950,0.6422018348623854,74,35,39,224.36779077990818,0.4797396365019316,0.7802755145446814,0.13136593424144943,1050509.5752424707,5090.102518058498,1055599.6777605293,905,0,267.60655737704917,73,110,41,38.014967770880226,0.5458788706739526,43.76407657657657,8199.549549549538,112.32259656917175,0
907,32,1,2,181,0.00546448087431694,0.01092896174863388,0.9890710382513661,183,6000,4100,1900,0.6833333333333333,79,41,38,211.7637673889616,0.47967333213234853,0.7583312863687905,0.12346635023899885,1049219.8794041276,1837.3508964023285,1051057.2303005299,906,0,267.5136612021858,78,105,36,38.49859687966635,0.5459357923497268,43.92141350210973,8194.514767932551,105.05788164016091,8
908,32,1,0,182,0.005494505494505495,0.0,1.0,182,5950,4400,1550,0.7394957983193278,75,44,31,204.26244433833466,0.4792741788598142,0.7528468097187291,0.11634330151156243,1041996.9538014743,218.1689553176111,1042215.1227567919,907,0,269.4175824175824,81,101,43,39.59168160021241,0.5393772893772895,44.80436991869919,8166.2601626016285,100.81802669878553,8
909,32,4,0,186,0.021505376344086023,0.0,1.0,186,6000,4300,1700,0.7166666666666667,77,43,34,225.88191475895096,0.48046413348832706,0.7779438729568797,0.12551679078482067,1034253.0457670165,3523.811664626246,1037776.8574316427,908,0,264.60215053763443,65,121,41,40.011471330726145,0.5269377240143369,45.754419191919204,8135.858585858609,125.16705516705552,8
910,32,5,1,190,0.02617801047120419,0.005235602094240838,0.9947643979057592,191,5900,4500,1400,0.7627118644067796,73,45,28,199.15704606237452,0.480818866538073,0.7531728741757151,0.11098968350827361,1035172.3727492972,-2867.6256155745705,1032304.7471337226,909,0,258.64921465968587,75,116,41,40.57571757014048,0.5294502617801047,45.64144736842102,8139.473684210444,108.52631578947259,8
911,32,6,3,193,0.030612244897959183,0.015306122448979591,0.9846938775510204,196,5600,3700,1900,0.6607142857142857,75,37,38,196.46229407241248,0.4818839394732252,0.7584309660641064,0.11098616774176927,1039437.5720754446,-3957.9420090001418,1035479.6300664445,910,0,252.8265306122449,82,114,33,40.110501091470105,0.5328975340136055,45.11797188755018,8156.224899598348,99.46615731217497,0
912,32,2,1,194,0.010256410256410256,0.005128205128205128,0.9948717948717949,195,5300,3500,1800,0.660377358490566,71,35,36,199.37664958629517,0.48087827121332277,0.7625139902808153,0.11327783722894949,1041220.8514995382,-2780.9750297265027,1038439.8764698117,911,0,255.10256410256412,86,109,35,39.813315497981776,0.5347222222222222,44.89942528735632,8163.218390804603,94.92114407912328,0
913,32,4,3,195,0.020202020202020204,0.015151515151515152,0.9848484848484849,198,5800,3900,1900,0.6724137931034483,77,39,38,196.4327806629416,0.48059646806474215,0.7629344178639932,0.11249462483995211,1043689.2623456877,-4397.043209876101,1039292.2191358117,912,0,252.2020202020202,74,124,40,39.58027443942934,0.5371948653198653,44.59722222222225,8172.888888888958,110.44444444444538,0
914,32,4,4,195,0.020100502512562814,0.020100502512562814,0.9798994974874372,199,4850,3600,1250,0.7422680412371134,61,36,25,204.89417812229468,0.4805297531428185,0.7734858881953106,0.11865967643047505,1047147.9433394321,-1739.0965554030581,1045408.846784029,913,0,251.86934673366835,80,119,44,38.93266475644695,0.541247906197655,44.17438271604939,8186.419753086437,102.33024691358045,8
915,32,0,2,193,0.0,0.010256410256410256,0.9897435897435898,195,6150,4300,1850,0.6991869918699187,80,43,37,204.18886828240983,0.4800797427086087,0.7687977822618663,0.11867859699685845,1048259.3652723377,-2341.421307720715,1045917.943964617,914,1,255.54358974358973,82,113,37,38.8122088747242,0.5432692307692308,44.038654618473906,8190.763052208862,99.88735429523003,0
916,32,1,1,193,0.005154639175257732,0.005154639175257732,0.9948453608247423,194,5600,4000,1600,0.7142857142857143,72,40,32,203.3322511171385,0.4799439800224347,0.766483156053728,0.11878285949833554,1049821.2322183813,-1707.4971164934977,1048113.7351018877,915,0,257.79896907216494,84,110,39,38.63964373425189,0.5449420103092784,43.848039215686285,8196.86274509807,97.58169934640559,0
917,32,1,0,194,0.005154639175257732,0.0,1.0,194,7050,5200,1850,0.7375886524822695,89,52,37,198.34188227516617,0.47960400975731354,0.7611106105275962,0.11639383310384817,1051210.1271084787,-4150.200944517694,1047059.926163961,916,0,258.58247422680415,72,122,37,38.59472712427393,0.5469286941580755,43.67865296803651,8202.283105022789,113.92059868087206,0
918,32,3,3,194,0.015228426395939087,0.015228426395939087,0.9847715736040609,197,5400,3800,1600,0.7037037037037037,70,38,32,195.9794580600082,0.4798411115715322,0.7649976613044538,0.11248181376018312,1044370.4475308695,-3864.9691358022087,1040505.4783950673,917,0,255.62944162436548,74,123,43,39.50688592914742,0.5363261421319797,44.51388888888891,8175.555555555598,110.48048048048106,7
919,32,5,2,197,0.02512562814070352,0.010050251256281407,0.9899497487437185,199,6250,4100,2150,0.656,84,41,43,197.0076754260176,0.4800010151768946,0.7674677443084339,0.11204698680279063,1041541.1021901019,-5011.68171937487,1036529.420470727,918,0,253.60804020100502,75,124,42,39.83374742591101,0.5284233668341709,44.86019736842107,8164.473684210566,108.85964912280754,8
920,32,3,3,197,0.015,0.015,0.985,200,5850,4000,1850,0.6837606837606838,77,40,37,201.71149041713025,0.48064750837520936,0.7715704873338627,0.11346110224549497,1038087.3976551773,-3971.168767146824,1034116.2288880305,919,0,253.155,71,129,45,40.14564163732058,0.5266145833333333,45.28356481481481,8150.925925925918,114.8017736045904,8
921,32,4,3,198,0.01990049751243781,0.014925373134328358,0.9850746268656716,201,6250,4400,1850,0.704,81,44,37,205.77309724312067,0.4812531094527363,0.7756039944164079,0.11469216123328718,1035214.5853623834,-3846.1376917461484,1031368.4476706373,920,0,252.80597014925374,73,128,40,40.40213982660024,0.5260157545605306,45.63626126126124,8139.639639639591,111.50191287177522,8
922,32,3,1,200,0.014925373134328358,0.004975124378109453,0.9950248756218906,201,7300,5400,1900,0.7397260273972602,92,54,38,204.0645644302857,0.48158996683250416,0.7722298351941779,0.11495438816098964,1038550.1900514418,-5113.741565632894,1033436.4484858089,921,0,253.71144278606965,78,123,41,40.027774902529025,0.5289697346600332,45.226793248945114,8152.742616033675,104.52234123120097,0
923,32,3,2,201,0.014778325123152709,0.009852216748768473,0.9901477832512315,203,7650,5600,2050,0.7320261437908496,97,56,41,199.50302050935375,0.4817150742167813,0.7703145749840816,0.11312419228336809,1040600.0096116766,-6729.430988082104,1033870.5786235945,922,0,252.1871921182266,84,119,40,39.887674195098484,0.5311986863711002,44.9754901960784,8160.784313725401,97.15219421101668,0
924,32,3,4,200,0.014705882352941176,0.0196078431372549,0.9803921568627451,204,6950,5300,1650,0.762589928057554,86,53,33,222.24061638241457,0.4821710293312727,0.798682589987376,0.1229464299702072,1032850.9233006402,-1841.7148349040763,1031009.2084657361,923,0,250.81372549019608,77,127,41,40.28027814279456,0.5205269607843137,45.92681623931623,8130.341880341859,105.58885558885531,7
925,32,2,4,198,0.009900990099009901,0.019801980198019802,0.9801980198019802,202,6500,5000,1500,0.7692307692307693,80,50,30,219.84818079019755,0.48183689637620475,0.7848806758207947,0.11982766144142006,1028129.3531927039,-1693.5264167165424,1026435.8267759874,924,0,252.93564356435644,70,132,41,40.93524520584944,0.5204207920792079,46.5082159624413,8111.73708920184,115.88195841716914,8
926,32,3,5,196,0.014925373134328358,0.024875621890547265,0.9751243781094527,201,5000,3700,1300,0.74,63,37,26,224.38225676287195,0.48176513266998344,0.7881542610919481,0.12338359249549816,1030937.4038165563,1064.8122499229594,1032002.2160664793,925,0,255.07960199004975,75,126,36,40.466612670986294,0.5226471807628523,46.162280701754376,8122.807017543839,108.30409356725119,0
927,32,8,0,204,0.0392156862745098,0.0,1.0,204,6200,4200,2000,0.6774193548387096,82,42,40,219.97361536138163,0.48299556891722206,0.792272598386591,0.12352255068998724,1037552.6550342755,-1353.15826886194,1036199.4967654136,926,0,249.77941176470588,70,134,41,39.747532215628674,0.5274203431372548,45.34917840375587,8148.82629107982,116.41180415828315,0
928,32,3,3,204,0.014492753623188406,0.014492753623188406,0.9855072463768116,207,6850,5800,1050,0.8467153284671532,79,58,21,204.39969768541985,0.4832031799634164,0.7857750765390972,0.11573278287514863,1040147.312642033,-5728.840749533407,1034418.4718924996,927,0,247.14492753623188,73,134,37,39.81940917204955,0.5321054750402576,45.030968468468465,8159.009009009002,111.76724669875345,8
929,32,4,4,204,0.019230769230769232,0.019230769230769232,0.9807692307692307,208,5600,3500,2100,0.625,77,35,42,200.54429703557497,0.4833714619720055,0.7821079146389434,0.11461649922200733,1043059.4438107556,-5364.075414930605,1037695.368395825,928,0,245.23557692307693,70,138,40,39.55388438774926,0.534755608974359,44.6742957746479,8170.422535211298,116.72032193158998,0
930,32,1,2,203,0.004878048780487805,0.00975609756097561,0.9902439024390244,205,5800,3300,2500,0.5689655172413793,83,33,50,203.3297891851753,0.48330344332855096,0.7825716100875628,0.116736153348836,1044465.0741598078,-4325.827331961533,1040139.2468278463,929,0,249.42926829268293,71,134,41,39.30728576821444,0.5370934959349594,44.50231481481482,8175.925925925924,115.15388628064682,0
931,32,0,4,199,0.0,0.019704433497536946,0.9802955665024631,203,7050,4700,2350,0.6666666666666666,94,47,47,205.03898983821665,0.4829659074281813,0.7822229851247022,0.11853104193459772,1046595.3066057967,-4731.431112825654,1041863.875492971,930,1,252.61083743842366,71,132,41,38.99785986348381,0.5392549261083743,44.24189814814815,8184.259259259267,115.27125717266574,0
932,32,5,1,203,0.024509803921568627,0.004901960784313725,0.9950980392156863,204,6200,4200,2000,0.6774193548387096,82,42,40,216.8191587474142,0.48251966016291575,0.7886706072380496,0.12374787794011788,1042632.4462890604,-1787.4620225695453,1040844.9842664909,931,0,251.94117647058823,63,141,41,39.191745303068934,0.5351817810457516,44.72656249999999,8168.749999999984,129.66269841269815,8
933,32,1,6,198,0.004901960784313725,0.029411764705882353,0.9705882352941176,204,7150,5000,2150,0.6993006993006993,93,50,43,231.25180088875987,0.4820648805499211,0.7978249714512824,0.1301808477282041,1038336.7382369633,73.44812925179576,1038410.1863662151,932,0,252.9264705882353,69,135,44,39.361905387775806,0.5284415849673203,45.2529761904762,8151.904761904777,118.14354727398228,8
934,32,4,3,199,0.019801980198019802,0.01485148514851485,0.9851485148514851,202,6850,4700,2150,0.6861313868613139,90,47,43,220.41717528488397,0.4820826765512372,0.7846377836380412,0.1251039414789304,1040901.3424327951,-1363.4932701438502,1039537.8491626512,933,0,256.1831683168317,77,125,41,39.31657634780178,0.5323329207920793,44.93856837606838,8161.965811965831,105.99955599955624,0
935,32,2,2,199,0.009950248756218905,0.009950248756218905,0.9900497512437811,201,6400,4400,2000,0.6875,84,44,40,223.18461380428948,0.4818988391376451,0.7884718601736294,0.12742714889814308,1042745.2595717311,-55.06038924571203,1042690.1991824853,934,0,255.6417910447761,65,136,41,39.015133951571386,0.5346185737976783,44.71275252525254,8169.191919191949,125.67987567987613,0
936,32,2,3,198,0.009950248756218905,0.014925373134328358,0.9850746268656716,201,6000,4200,1800,0.7,78,42,36,216.01967547319506,0.4821165008291874,0.7803064806412834,0.12414624722977641,1044776.0204081677,-1061.564625850162,1043714.4557823176,935,0,252.96517412935324,69,132,48,38.9442115071046,0.5366915422885572,44.46428571428573,8177.142857142892,118.50931677018684,0
937,32,4,2,200,0.019801980198019802,0.009900990099009901,0.9900990099009901,202,6500,4600,1900,0.7076923076923077,84,46,38,191.45157147275376,0.4822140329704612,0.7584846302838977,0.1081554927688491,1039437.572075442,-7099.608675666934,1032337.963399775,936,0,252.490099009901,82,120,39,40.23821540532113,0.532539191419142,45.117971887550176,8156.224899598326,99.46615731217472,8
938,32,4,2,202,0.0196078431372549,0.00980392156862745,0.9901960784313726,204,5900,3700,2200,0.6271186440677966,81,37,44,186.0427916934472,0.4828114435429344,0.7549676140523189,0.10590352335510433,1041813.9632341483,-7935.604370941326,1033878.358863207,937,0,250.7156862745098,88,116,45,40.079465186680096,0.5350796568627452,44.826779026217196,8165.54307116096,92.79026217228363,0
939,32,4,3,203,0.019417475728155338,0.014563106796116505,0.9854368932038835,206,6300,5300,1000,0.8412698412698413,73,53,20,182.516731737772,0.48325538716552213,0.7516980895709353,0.10471606980809492,1044255.4639792516,-9381.181123038756,1034874.2828562128,938,0,248.42233009708738,78,128,46,39.86516129032258,0.5374190938511327,44.52795358649792,8175.1054852321495,104.80904468246345,0
940,32,4,7,200,0.01932367149758454,0.033816425120772944,0.966183574879227,207,6550,4700,1850,0.7175572519083969,84,47,37,181.52453391733056,0.48268530244047336,0.750629810352283,0.1051814514180445,1047311.4403114287,-9927.455786235596,1037383.9845251931,939,0,247.59903381642513,84,123,33,39.51018664878417,0.5407105475040257,44.15441176470591,8187.058823529492,97.46498599439872,0
941,32,3,4,199,0.014778325123152709,0.019704433497536946,0.9802955665024631,203,6200,4000,2200,0.6451612903225806,84,40,44,212.29825662487008,0.48218045326700154,0.7742234984122027,0.12253157735056985,1046101.7665037693,-2382.883743810491,1043718.8827599589,940,0,249.7832512315271,82,121,38,38.87378930663264,0.5405377668308703,44.302208835341375,8182.329317269103,99.7845038691354,8
942,32,2,4,197,0.009950248756218905,0.01990049751243781,0.9800995024875622,201,6300,4900,1400,0.7777777777777778,77,49,28,206.71085065469197,0.4813951077943615,0.767595518529157,0.12012695678280241,1048214.6193771682,-3164.532871972019,1045050.0865051962,941,0,253.20398009950247,84,117,36,38.75323182993395,0.542910447761194,44.04411764705884,8190.588235294162,97.50700280112098,0
943,32,1,3,195,0.005050505050505051,0.015151515151515152,0.9848484848484849,198,5100,3300,1800,0.6470588235294118,69,33,36,209.28564566488834,0.4809804901809978,0.7690236012406144,0.1222607201142397,1049821.232218378,-757.4971164936051,1049063.7351018845,942,0,257.27272727272725,84,114,43,38.487146365579065,0.5449284511784511,43.84803921568628,8196.862745098044,97.58169934640529,0
944,32,3,2,196,0.015151515151515152,0.010101010101010102,0.98989898989899,198,6050,4200,1850,0.6942148760330579,79,42,37,202.47805758863709,0.48068619784990346,0.7599778037044507,0.11934766324575018,1052562.0030864177,-3025.8580246914926,1049536.1450617262,943,0,256.550505050505,74,124,44,38.320607931264746,0.548348063973064,43.51388888888888,8207.555555555538,110.91291291291267,0
945,32,2,4,194,0.010101010101010102,0.020202020202020204,0.9797979797979798,198,6450,4200,2250,0.6511627906976745,87,42,45,199.73996810747724,0.48080370113999554,0.7694000116454152,0.11747702677034799,1051895.0908256166,-4028.901621216106,1047866.1892044005,944,0,256.969696969697,73,125,39,38.473728154451464,0.5419297138047139,43.59515765765764,8204.954954954905,112.39664321856034,8
946,32,3,2,195,0.015228426395939087,0.01015228426395939,0.9898477157360406,197,6150,3900,2250,0.6341463414634146,84,39,45,203.36157796995818,0.48083065713595086,0.773856642187889,0.11930452214146284,1051120.2274265394,-2798.5063828797292,1048321.7210436597,945,0,259.1015228426396,68,129,42,38.477245062237365,0.5463197969543148,43.68961352657003,8201.932367149719,120.6166524580841,8
947,32,1,1,195,0.00510204081632653,0.00510204081632653,0.9948979591836735,196,6100,3800,2300,0.6229508196721312,84,38,46,199.1042983964655,0.48063513867085295,0.7673095357546009,0.11750248490858692,1052934.8267186035,-3371.2300137979505,1049563.5967048055,946,0,261.3775510204082,73,123,42,38.360815408252826,0.5480442176870748,43.468468468468444,8209.009009008954,112.45217820560211,0
948,32,2,2,195,0.01015228426395939,0.01015228426395939,0.9898477157360406,197,6150,4900,1250,0.7967479674796748,74,49,25,196.3509083370106,0.4804259901930315,0.765541759654562,0.11677333257037932,1055279.405121143,-4108.9860510250255,1051170.4190701179,947,0,260.9086294416244,78,119,45,38.14039208639248,0.5507085448392555,43.1830168776371,8218.143459915538,105.36081358866075,0
949,32,3,2,196,0.015151515151515152,0.010101010101010102,0.98989898989899,198,5850,4300,1550,0.7350427350427351,74,43,31,219.67101929098843,0.48035184757900495,0.7879775901404056,0.12691698830829293,1046418.5381262472,523.5653750355332,1046942.1035012827,948,0,260.4848484848485,70,128,43,38.64570783852525,0.5429819023569024,44.26349765258214,8183.56807511732,116.90811535881886,8
950,32,3,3,196,0.01507537688442211,0.01507537688442211,0.9849246231155779,199,6150,4100,2050,0.6666666666666666,82,41,41,206.86901354656078,0.4810838705311067,0.772470369665702,0.11757492035747506,1041327.4793388369,-2866.322314049803,1038461.157024787,949,0,260.1005025125628,87,112,37,39.60885300668149,0.53732202680067,44.88636363636362,8163.636363636316,93.83490073145191,8
951,32,1,1,196,0.005076142131979695,0.005076142131979695,0.9949238578680203,197,6100,4000,2100,0.6557377049180327,82,40,42,208.41499359646795,0.48119755516419765,0.7756674790718479,0.11843208549530955,1041270.9138905334,-2096.705829863518,1039174.2080606698,950,0,263.34517766497464,81,116,38,39.576486405736475,0.5314615059221659,44.893292682926806,8163.414634146278,100.7828967178553,8
952,32,3,2,197,0.01507537688442211,0.010050251256281407,0.9899497487437185,199,5400,3900,1500,0.7222222222222222,69,39,30,199.61112496187903,0.48182304620746835,0.769565027027094,0.1135426067646374,1041582.0428688296,-3617.727336572067,1037964.3155322575,951,0,261.5929648241206,81,118,42,39.76220853041241,0.5341813232830821,44.85518292682927,8164.634146341476,100.79795242396884,8
953,32,3,0,200,0.015,0.0,1.0,200,6250,4000,2250,0.64,85,40,45,211.08625299400498,0.4818776172529313,0.7780869515927882,0.12036146332644684,1042337.0118527175,-2245.3971622079753,1040091.6146905095,952,0,259.135,71,129,40,39.37502361788157,0.5341145833333334,44.76273148148151,8167.592592592659,115.036515388629,8
954,32,2,0,202,0.009900990099009901,0.0,1.0,202,6050,3800,2250,0.628099173553719,83,38,45,216.75538420539502,0.48223250496691455,0.7919555017746214,0.12201498737495517,1038323.2596021958,-1437.5685871055375,1036885.6910150903,953,0,257.55940594059405,71,131,43,39.73288656671214,0.527588696369637,45.25462962962963,8151.8518518518595,114.81481481481492,8
955,32,3,4,201,0.014634146341463415,0.01951219512195122,0.9804878048780488,205,5150,3800,1350,0.7378640776699029,65,38,27,210.93883715359743,0.482528295871194,0.7907844709412091,0.11997305394200432,1041548.3686587625,-2209.399655178643,1039338.9690035839,954,0,254.77560975609757,76,129,46,39.47739925768825,0.5299288617886179,44.85930735930737,8164.502164502198,107.42766005923944,0
956,32,2,1,202,0.009852216748768473,0.0049261083743842365,0.9950738916256158,203,6300,4500,1800,0.7142857142857143,81,45,36,202.9753219342357,0.48241619112650186,0.7805177214348502,0.11634972475948328,1043978.071084435,-4519.642985871055,1039458.4280985639,955,0,255.78817733990147,67,136,46,39.377123938031005,0.5324302134646962,44.56188725490195,8174.019607843107,122.00029265437473,0
957,32,5,4,203,0.024154589371980676,0.01932367149758454,0.9806763285024155,207,6900,4700,2200,0.6811594202898551,91,47,44,203.26957523388583,0.48293935556493595,0.7825979721940726,0.11815863695853689,1048296.7458677744,-5682.633149678291,1042614.1127180961,956,0,251.30917874396135,76,131,42,38.83108274756442,0.5360305958132046,44.03409090909093,8190.9090909091365,107.77511961722549,0
958,32,1,0,204,0.004901960784313725,0.0,1.0,204,6700,4800,1900,0.7164179104477612,86,48,38,204.38523496390513,0.4826333550661644,0.7807258848358407,0.1194162995381593,1049868.279767313,-4584.484991721214,1045283.7947755918,957,0,255.38725490196077,78,126,47,38.60681439920386,0.5380412581699346,43.842299578059084,8197.046413502138,105.09033863464279,0
959,32,2,2,204,0.009708737864077669,0.009708737864077669,0.9902912621359223,206,6150,4200,1950,0.6829268292682927,81,42,39,208.1623748272473,0.4823294064251322,0.7862411184978586,0.1227246863038758,1052627.9067993201,-3526.4950222437897,1049101.4117770763,958,0,253.89805825242718,63,143,47,38.1666164308226,0.540402508090615,43.505859375000014,8207.81250000003,130.28273809523856,0
960,32,3,3,204,0.014492753623188406,0.014492753623188406,0.9855072463768116,207,6300,4500,1800,0.7142857142857143,81,45,36,217.96032022276276,0.4824722886668855,0.7942859641069349,0.12609746274667755,1046832.1330589909,-2066.4266117967136,1044765.7064471942,959,0,252.07246376811594,71,136,40,38.63782051282051,0.5361312399355878,44.21296296296298,8185.185185185233,115.28429838289061,8
961,32,5,4,205,0.023923444976076555,0.019138755980861243,0.9808612440191388,209,7300,5500,1800,0.7534246575342466,91,55,36,212.47325763859612,0.48210629830695617,0.7938345520473189,0.12493885095868447,1051828.3960413486,-4402.918843263022,1047425.4771980855,960,0,248.244019138756,70,139,35,38.155541886015094,0.5399222488038278,43.60328638497652,8204.69483568074,117.20992622401059,0
962,32,3,2,206,0.014423076923076924,0.009615384615384616,0.9903846153846154,208,6150,4100,2050,0.6666666666666666,82,41,41,206.04782856937518,0.4825009870865849,0.7859437124174415,0.1221159409318747,1054224.5690981785,-4305.863342567231,1049918.7057556114,961,0,246.22596153846155,75,133,38,38.02239071621813,0.5421173878205128,43.31140350877191,8214.035087719254,109.52046783625673,0
963,32,2,3,205,0.009615384615384616,0.014423076923076924,0.9855769230769231,208,6100,3900,2200,0.639344262295082,83,39,44,203.77030124038407,0.4825096966740989,0.7830360142041382,0.12142891928934353,1055887.9848783643,-4668.277449046973,1051219.7074293173,962,0,246.94230769230768,77,131,35,37.874298190892084,0.5444210737179487,43.10897435897434,8220.51282051278,106.75990675990624,0
964,32,1,2,204,0.0048543689320388345,0.009708737864077669,0.9902912621359223,206,6750,4100,2650,0.6074074074074074,94,41,53,218.7611333062146,0.48238120609361435,0.7953173197349075,0.12726775336874066,1048548.3245069436,-2073.6760409054677,1046474.6484660382,963,0,246.95145631067962,73,133,34,38.403167271527565,0.5346885113268609,44.00337837837839,8191.891891891925,112.21769714920445,8
965,32,1,2,203,0.004878048780487805,0.00975609756097561,0.9902439024390244,205,7050,4900,2150,0.6950354609929078,92,49,43,222.53136342651626,0.48240574685158616,0.7977213673362047,0.13000589718906458,1049838.414824757,-1325.6052343026777,1048512.8095904543,964,0,249.06829268292682,75,130,40,38.145711826921364,0.5365853658536586,43.84594298245615,8196.92982456143,109.29239766081906,0
966,32,0,1,202,0.0,0.0049261083743842365,0.9950738916256158,203,6600,4800,1800,0.7272727272727273,84,48,36,224.2787660861436,0.48201076265261994,0.7980424949625291,0.13141963167766663,1050756.4143655486,-67.52958579894857,1050688.8847797497,965,1,252.30541871921181,64,139,42,37.98647155691742,0.5379207717569787,43.73397435897436,8200.512820512819,128.1330128205128,0
967,32,2,3,201,0.00980392156862745,0.014705882352941176,0.9852941176470589,204,6800,4700,2100,0.6911764705882353,89,47,42,214.99136798165432,0.48219064924820504,0.7897730665870413,0.12680628590534657,1052761.5017361077,-2333.0729166667907,1050428.428819441,966,0,251.67156862745097,67,137,43,37.974830795262285,0.5401858660130718,43.48958333333332,8208.333333333307,122.51243781094487,0
968,32,1,0,202,0.0049504950495049506,0.0,1.0,202,6200,4400,1800,0.7096774193548387,80,44,36,209.3982470267719,0.48178609838595804,0.7818643302643966,0.12413475098549917,1054305.880406586,-2446.0393625689358,1051859.841044017,967,0,254.81683168316832,71,131,44,37.92628313513308,0.5427495874587458,43.301504629629605,8214.351851851798,115.69509650495489,0
969,32,1,3,200,0.0049261083743842365,0.014778325123152709,0.9852216748768473,203,6150,4300,1850,0.6991869918699187,80,43,37,230.9675491174876,0.4817780731275098,0.7982990270699575,0.1322352671321001,1043602.4605920805,1457.660515186437,1045060.121107267,968,0,254.55665024630542,67,136,39,38.709113083813165,0.5321223316912972,44.6078431372549,8172.549019607848,121.97834357623654,8
970,32,5,6,199,0.024390243902439025,0.02926829268292683,0.9707317073170731,205,6650,4800,1850,0.7218045112781954,85,48,37,224.66959130711643,0.48206300813008135,0.7953318463524688,0.13011934838800324,1047165.0155222812,-596.7727862996562,1046568.2427359815,969,0,252.8439024390244,73,132,43,38.424626756171826,0.5351626016260163,44.172297297297305,8186.486486486503,112.14365049981511,0
971,32,2,1,200,0.009950248756218905,0.004975124378109453,0.9950248756218906,201,6650,4900,1750,0.7368421052631579,84,49,35,242.47038850707054,0.4812707296849088,0.7956305353799331,0.13940220896658687,1044897.7076247236,3821.3506235831646,1048719.0582483066,970,0,253.5771144278607,69,132,37,38.25305955084536,0.5376762023217247,44.44940476190479,8177.619047619103,118.51621808143628,8
972,32,2,2,200,0.009900990099009901,0.009900990099009901,0.9900990099009901,202,5900,3900,2000,0.6610169491525424,79,39,40,237.42114625189862,0.48107595274452813,0.8028159598353191,0.13901641452631663,1050526.8222170824,3583.4564598287006,1054110.278676911,971,0,253.30693069306932,86,116,35,37.678340575985544,0.5464624587458746,43.76197318007662,8199.616858237532,95.34438207252944,7
973,32,3,3,200,0.014778325123152709,0.014778325123152709,0.9852216748768473,203,6950,5100,1850,0.7338129496402878,88,51,37,226.5863628609503,0.4807131883139053,0.7939137318127696,0.1339741312576846,1053511.178576118,192.25323738340467,1053703.4318135015,972,0,248.35960591133005,76,127,35,37.58402309152256,0.549055829228243,43.398268398268414,8211.255411255448,108.04283435862432,0
974,32,3,3,200,0.014778325123152709,0.014778325123152709,0.9852216748768473,203,6750,5100,1650,0.7555555555555555,84,51,33,216.50828742027196,0.4806105610561056,0.7846213045967829,0.12836289063292927,1054337.1548216653,-1695.4536492003353,1052641.701172465,973,0,249.2216748768473,75,128,40,37.73987977646074,0.5465927750410509,43.29769736842102,8214.473684210443,109.52631578947258,8
975,32,1,2,199,0.004975124378109453,0.009950248756218905,0.9900497512437811,201,6150,4600,1550,0.7479674796747967,77,46,31,217.71055228345364,0.4804767827529022,0.784496243441841,0.12981290732857245,1056067.6365931956,-366.5863177231777,1055701.0502754725,974,0,252.5174129353234,76,125,39,37.49385673915713,0.5484038142620232,43.08712121212118,8221.21212121205,108.17384370015854,0
976,32,2,6,195,0.009950248756218905,0.029850746268656716,0.9701492537313433,201,6800,4700,2100,0.6911764705882353,89,47,42,217.98437902497824,0.48049958540630183,0.7843163144231036,0.12778131258191516,1050876.24050845,-1185.0790561328113,1049691.1614523171,975,0,253.49751243781094,67,134,44,38.132845188284506,0.5419776119402986,43.71936274509801,8200.980392156796,122.40269242025069,8
977,32,3,2,196,0.015151515151515152,0.010101010101010102,0.98989898989899,198,6100,4300,1800,0.7049180327868853,79,43,36,208.74065762991188,0.4802268668068161,0.7710502197667033,0.12347253441341766,1053634.7815964555,-1712.7165575617892,1051922.0650388936,976,0,256.24747474747477,70,128,43,38.026580336554,0.5452967171717171,43.383215962441284,8211.737089201806,117.31052984574009,0
978,32,1,3,194,0.005076142131979695,0.015228426395939087,0.9847715736040609,197,5750,4600,1150,0.8,69,46,23,241.64381095739515,0.48004074726337237,0.8022702656844314,0.14110300607303955,1049689.1354433796,5580.176601822214,1055269.312045202,977,0,258.24365482233503,72,125,37,37.67479108635096,0.5387584602368867,43.86415525114155,8196.347031963458,113.83815322171469,8
979,32,2,2,194,0.01020408163265306,0.01020408163265306,0.9897959183673469,196,7600,5900,1700,0.7763157894736842,93,59,34,231.50587684618108,0.4801832592011164,0.7925432198326743,0.13095186140854406,1039840.5815485339,1345.8411223268918,1041186.4226708608,978,0,257.89285714285717,78,118,34,39.16675287059066,0.5321534863945578,45.06856540084386,8157.8059071729385,104.58725522016587,8
980,32,2,2,194,0.01020408163265306,0.01020408163265306,0.9897959183673469,196,6400,4000,2400,0.625,88,40,48,235.50844756789306,0.48016745159602303,0.7969221227820329,0.1345635685846448,1042976.5932874422,3525.9596669552657,1046502.5529543975,979,0,258.7448979591837,67,129,35,38.671539069218625,0.5352891156462585,44.68443627450982,8170.098039215724,121.94176177933917,0
981,32,2,1,195,0.01020408163265306,0.00510204081632653,0.9948979591836735,196,6750,4900,1850,0.725925925925926,86,49,37,241.5439855938983,0.4804045656724228,0.8040280146210037,0.13785575587693316,1042624.2644641682,4417.924063116405,1047042.1885272847,980,0,259.42857142857144,64,132,34,38.56161194467114,0.5347045068027211,44.7275641025641,8168.717948717947,127.63621794871793,8
982,32,3,1,197,0.015151515151515152,0.005050505050505051,0.9949494949494949,198,5900,4400,1500,0.7457627118644068,74,44,30,233.2921436286893,0.48083895212702316,0.8005735229638411,0.13481367788845508,1046480.2862811787,3327.125850340094,1049807.4121315188,981,0,257.75757575757575,69,129,37,38.289644672019854,0.5376157407407407,44.25595238095238,8183.80952380952,118.6059351276742,0
983,32,5,3,199,0.024752475247524754,0.01485148514851485,0.9851485148514851,202,6850,5300,1550,0.7737226277372263,84,53,31,227.46202660185747,0.48153723954485,0.8008517577917929,0.1300446163749976,1043164.3337673595,206.05468749992815,1043370.3884548594,982,0,253.51980198019803,63,139,40,38.85347611762707,0.5340346534653465,44.66145833333333,8170.83333333332,129.695767195767,8
984,32,1,3,197,0.005,0.015,0.985,200,5200,3300,1900,0.6346153846153846,71,33,38,223.5061295063976,0.481748324958124,0.795302085830736,0.12858538843740427,1045105.3080545901,1517.4884659743957,1046622.7965205645,983,0,256.975,67,133,40,38.71173979061775,0.5357291666666666,44.42401960784312,8178.431372548986,122.06613988879083,0
985,32,2,1,198,0.010050251256281407,0.005025125628140704,0.9949748743718593,199,5950,3800,2150,0.6386554621848739,81,38,43,209.4383293509326,0.4815734818875523,0.7782942213690531,0.11989261535425993,1043559.5379818619,-2037.7267573694726,1041521.8112244924,984,0,254.26130653266333,69,130,39,39.26431457095136,0.5384736180904522,44.61309523809525,8172.380952380971,118.44030365769524,8
986,32,2,2,198,0.01,0.01,0.99,200,6000,4300,1700,0.7166666666666667,77,43,34,219.69294569496662,0.48155726549413735,0.790747540814748,0.12790938310522348,1048787.7237666782,82.25288860451201,1048869.9766552828,985,0,250.385,78,122,33,38.349448936498966,0.54640625,43.97415611814349,8192.827004219485,105.03624364383955,8
987,32,0,0,198,0.0,0.0,1.0,198,6550,4800,1750,0.732824427480916,83,48,35,224.16913203425952,0.4810477875198687,0.7934231802282694,0.13095537165399992,1049821.2322183833,917.5028835065832,1050738.7351018898,986,1,253.78787878787878,84,114,35,38.10590294389692,0.547979797979798,43.84803921568629,8196.862745098086,97.58169934640578,0
988,32,2,5,195,0.01,0.025,0.975,200,6150,4400,1750,0.7154471544715447,79,44,35,219.34127736551903,0.4810599874371859,0.7901589695985152,0.1292943316235322,1052578.2879818585,24.773242630310506,1052603.0612244888,987,0,252.24,69,131,38,37.88606211804749,0.5504687500000001,43.51190476190476,8207.61904761904,118.95100069013102,0
989,32,3,1,197,0.015151515151515152,0.005050505050505051,0.9949494949494949,198,5950,4000,1950,0.6722689075630253,79,40,39,212.42630086937248,0.4810921183065853,0.7814760177843347,0.12617610401036186,1054900.1736111082,-732.2916666667857,1054167.8819444415,988,0,255.06565656565655,75,123,38,37.774678837052065,0.5524515993265993,43.22916666666666,8216.666666666642,109.55555555555523,0
990,32,2,8,191,0.010050251256281407,0.04020100502512563,0.9597989949748744,199,6250,4800,1450,0.768,77,48,29,209.0731982130458,0.48078248989053013,0.7786794224387867,0.12472599065686638,1056221.424685434,-1884.481743975195,1054336.9429414587,989,0,254.74371859296483,80,119,32,37.696664831406295,0.554177135678392,43.06841563786009,8221.810699588503,102.77263374485628,0
991,32,1,2,190,0.005208333333333333,0.010416666666666666,0.9895833333333334,192,5350,3600,1750,0.6728971962616822,71,36,35,212.93003362565318,0.47987622254944734,0.7762574103256801,0.1274710524750878,1057279.020919067,1275.2914951989692,1058554.3124142662,990,0,263.0833333333333,80,112,35,37.466231427285024,0.5553927951388888,42.93981481481482,8225.925925925925,102.82407407407406,0
992,32,0,0,190,0.0,0.0,1.0,190,5150,3500,1650,0.6796116504854369,68,35,33,216.0123198610296,0.4794080107676599,0.7779028393386871,0.12953523474933926,1057790.8230251707,2549.1699218748195,1060339.9929470455,991,1,266.8315789473684,79,111,35,37.32344364544825,0.555921052631579,42.87760416666666,8227.916666666642,104.15084388185623,0
993,32,1,5,186,0.005235602094240838,0.02617801047120419,0.9738219895287958,191,6100,4800,1300,0.7868852459016393,74,48,26,214.71233869044306,0.4791620740332507,0.7775788347310932,0.12967637364043205,1059940.9031382147,1216.4780372932219,1061157.381175508,992,0,266.42931937172773,67,124,36,37.090078562075924,0.5582460732984293,42.616421568627445,8236.274509803912,122.92947029558078,0
994,32,0,5,181,0.0,0.026881720430107527,0.9731182795698925,186,5150,3600,1550,0.6990291262135923,67,36,31,221.36665233608727,0.4780399350963867,0.7762890251697716,0.1305003269670405,1052606.6098391982,4252.400289388052,1056859.0101285863,993,1,273.68817204301075,68,118,42,37.83058661958012,0.5487791218637993,43.508454106280176,8207.729468598996,120.70190394998524,8
995,32,0,1,180,0.0,0.0055248618784530384,0.994475138121547,181,5850,4100,1750,0.7008547008547008,76,41,35,220.5481574310855,0.47744909965213833,0.7689460827036709,0.13071512745305772,1054237.2545129913,4452.016795609167,1058689.2713086004,994,4,278.6740331491713,70,111,41,37.64860539551898,0.5502992633517496,43.30985915492957,8214.084507042235,117.34406438631764,0
996,32,3,3,180,0.01639344262295082,0.01639344262295082,0.9836065573770492,183,6800,5000,1800,0.7352941176470589,86,50,36,198.3945728801084,0.47755284333153186,0.7496734166730068,0.11550022340372232,1048764.1793821733,-1786.1757159030171,1046978.0036662703,995,0,274.6830601092896,77,106,41,38.897673134769505,0.5446265938069217,43.97702991452993,8192.735042735083,106.39915639915692,8
997,32,0,2,178,0.0,0.011111111111111112,0.9888888888888889,180,4950,3700,1250,0.7474747474747475,62,37,25,247.92390056509817,0.47682922098075725,0.7926524837935616,0.14095465745628374,1041429.2017736207,10689.03797322244,1052118.239746843,996,1,279.85,75,105,35,38.54871781096666,0.5394097222222223,44.873903508771924,8164.035087719282,108.85380116959043,8
998,32,2,2,178,0.011111111111111112,0.011111111111111112,0.9888888888888889,180,5150,3300,1850,0.6407766990291263,70,33,37,246.8416284926811,0.4768305141733913,0.7928095690200812,0.1414395206585663,1043856.8349150391,10383.464208728994,1054240.2991237682,997,0,280.1611111111111,62,118,36,38.27180972725703,0.5421875,44.57671957671959,8173.544973544999,131.8313705410484,0
999,32,2,2,178,0.011111111111111112,0.011111111111111112,0.9888888888888889,180,5500,3900,1600,0.7090909090909091,71,39,32,241.91616511087108,0.47709109248913717,0.7883310705782827,0.13982605776674392,1046543.8261394659,9135.173808023566,1055678.9999474895,998,0,278.9277777777778,68,112,38,38.061138657694386,0.5451388888888888,44.2481884057971,8184.0579710144875,120.35379369138953,0
1000,32,3,1,180,0.016574585635359115,0.0055248618784530384,0.994475138121547,181,5600,4200,1400,0.75,70,42,28,242.95568152956574,0.47738131778187026,0.7881003688208756,0.13971836039151111,1044980.0294658286,8976.76704873112,1053956.7965145598,999,0,277.44198895027625,67,114,35,38.230346760175,0.5455801104972375,44.43933823529411,8177.941176470574,122.05882352941155,8
1001,32,3,3,180,0.01639344262295082,0.01639344262295082,0.9836065573770492,183,6050,4800,1250,0.7933884297520661,73,48,25,247.90515392076804,0.4771400048039392,0.7946005882782576,0.14388289257883805,1047822.1454914497,9302.102051929498,1057124.2475433792,1000,0,275.3879781420765,66,117,35,37.74794957472663,0.5414389799635702,44.09203980099503,8189.054726368171,124.07658676315411,8
1002,32,1,3,178,0.0055248618784530384,0.016574585635359115,0.9834254143646409,181,4900,3100,1800,0.6326530612244898,67,31,36,250.62355737127808,0.4768339472068754,0.7960837526495739,0.1461941602279494,1049369.2480055755,11499.330786236158,1060868.5787918116,1001,0,279.4033149171271,67,114,37,37.484796825776606,0.5425874769797422,43.90318627450981,8195.098039215693,122.31489610769691,0
1003,32,1,0,179,0.00558659217877095,0.0,1.0,179,5150,3600,1550,0.6990291262135923,67,36,31,251.97184570179263,0.4766689159500345,0.7929620330330931,0.147723073998676,1050914.5679721655,12010.17667336966,1062924.7446455352,1002,0,283.122905027933,58,121,38,37.25702098833473,0.5451000931098696,43.71468926553672,8201.129943502818,141.39879212935892,0
1004,32,2,1,180,0.011049723756906077,0.0055248618784530384,0.994475138121547,181,7050,5800,1250,0.8226950354609929,83,58,25,229.28419354454584,0.4771984346224678,0.7738663182616992,0.12904575210742206,1038270.1052756347,4361.784753907188,1042631.8900295419,1003,0,280.98342541436466,70,111,41,39.42039106145252,0.5319981583793738,45.261150234741805,8151.643192488311,116.45204560697587,8
1005,32,3,3,180,0.01639344262295082,0.01639344262295082,0.9836065573770492,183,5600,4100,1500,0.7321428571428571,71,41,30,238.49316147443437,0.4776354110370504,0.7822959864330121,0.13563503456931714,1041525.9801609077,7479.364753266988,1049005.3449141746,1004,0,277.44262295081967,73,110,40,38.77718390804597,0.5350068306010929,44.86204954954956,8164.414414414443,111.84129334814305,0
1006,32,4,0,184,0.021739130434782608,0.0,1.0,184,5950,4500,1450,0.7563025210084033,74,45,29,249.60727294507097,0.47775785519125685,0.7940395762623051,0.14274994941598823,1043261.055153812,9331.109389348121,1052592.1645431602,986,0,271.44565217391306,65,119,32,38.27589004264788,0.5349298007246377,44.64962121212122,8171.212121212131,125.71095571095586,8
1007,32,3,1,186,0.016042780748663103,0.0053475935828877,0.9946524064171123,187,6200,4900,1300,0.7903225806451613,75,49,26,245.29877518041025,0.47835446495313666,0.7932176679712,0.14164026050739884,1046236.7346938829,7728.1179138325315,1053964.8526077154,987,0,268.0748663101604,69,118,37,38.013074177529504,0.5374331550802138,44.285714285714306,8182.857142857185,118.5921325051766,0
1008,32,1,1,186,0.0053475935828877,0.0053475935828877,0.9946524064171123,187,6850,5500,1350,0.8029197080291971,82,55,27,248.50228630767623,0.478288578383455,0.7976286051041999,0.1443597197681463,1048100.1103451755,7841.054740021104,1055941.1650851965,988,0,269.05882352941177,70,117,32,37.69788382535589,0.539605614973262,44.05809859154932,8190.140845070469,117.00201207243528,0
1009,32,5,3,188,0.02617801047120419,0.015706806282722512,0.9842931937172775,191,5450,3700,1750,0.6788990825688074,72,37,35,240.45877271348408,0.4789577018462386,0.7972337564711995,0.14161705682571235,1052308.1230550455,6957.343957249262,1059265.4670122948,989,0,262.8219895287958,65,126,37,37.37813352616572,0.5433027923211169,43.54482323232323,8206.565656565657,126.25485625485626,0
1010,32,2,1,189,0.010526315789473684,0.005263157894736842,0.9947368421052631,190,6350,4100,2250,0.6456692913385826,86,41,45,239.67297055106644,0.47872052817228256,0.7953271529575923,0.1372608851783698,1043696.3568793394,5679.161241319439,1049375.5181206588,990,0,264.2368421052632,63,127,41,38.47501911802194,0.5315241228070176,44.596354166666664,8172.91666666666,129.72883597883586,8
1011,32,5,1,193,0.02577319587628866,0.005154639175257732,0.9948453608247423,194,5900,4300,1600,0.7288135593220338,75,43,32,202.84985950669002,0.47934805833021743,0.7688600266704799,0.11668325523235684,1045056.5877111201,-2302.0836012516806,1042754.5041098684,991,0,259.75773195876286,71,123,41,39.245742522879524,0.5346864261168385,44.429976851851855,8178.2407407407445,115.18648930620768,8
1012,32,0,4,189,0.0,0.02072538860103627,0.9792746113989638,193,6000,4000,2000,0.6666666666666666,80,40,40,202.563588179533,0.479094703511802,0.7657381927285662,0.1171378716770461,1046695.0197416545,-2195.540214296504,1044499.479527358,992,1,261.2435233160622,75,118,42,39.04874024257364,0.5362694300518135,44.22971491228071,8184.649122807044,109.12865497076058,0
1013,32,2,1,190,0.010471204188481676,0.005235602094240838,0.9947643979057592,191,5250,4100,1150,0.780952380952381,64,41,23,204.88620096816732,0.47908514742353264,0.7673796436516258,0.119571687938636,1049515.9854575463,-443.73137684804897,1049072.2540806984,993,0,263.4502617801047,76,115,39,38.63784421438133,0.5393760907504364,43.885281385281395,8195.670995671015,107.83777625882914,0
1014,32,0,6,184,0.0,0.031578947368421054,0.968421052631579,190,5550,3600,1950,0.6486486486486487,75,36,39,214.83556324147696,0.47883191775735634,0.7725106443879939,0.12296619203432377,1043519.0007716031,1286.9984567900342,1044805.9992283931,994,1,265.7736842105263,71,119,40,39.13154316791298,0.534484649122807,44.61805555555555,8172.222222222207,115.1017214397494,8
1015,32,2,0,186,0.010752688172043012,0.0,1.0,186,6950,5000,1950,0.7194244604316546,89,50,39,226.62352239615166,0.4787822096289838,0.7752293335196383,0.1283189375975528,1040154.23138336,2994.6831502715036,1043148.9145336315,995,0,265.4462365591398,82,104,37,39.25190326179693,0.5339941756272402,45.030120481927696,8159.0361445782755,99.50044078753994,8
1016,32,2,4,184,0.010638297872340425,0.02127659574468085,0.9787234042553191,188,6050,4000,2050,0.6611570247933884,81,40,41,229.38492631616126,0.4790019247544279,0.7815162292634124,0.12931905641102015,1038795.0638717521,4006.7858367632534,1042801.8497085153,996,0,263.61170212765956,71,117,38,39.35195699901583,0.5302526595744681,45.196759259259295,8153.7037037037835,114.84089723526456,8
1017,32,4,3,185,0.02127659574468085,0.015957446808510637,0.9840425531914894,188,5900,4400,1500,0.7457627118644068,74,44,30,223.62429133317465,0.4790677029999621,0.7745080952507759,0.1273210134696144,1041873.854938282,3097.6604938277114,1044971.5154321097,997,0,258.4308510638298,74,114,42,39.11298735463274,0.5334109042553192,44.81944444444448,8165.777777777861,110.34834834834948,0
1018,32,2,4,183,0.0106951871657754,0.0213903743315508,0.9786096256684492,187,6000,4000,2000,0.6666666666666666,80,40,40,221.53387260678602,0.47853535353535354,0.7842135272703921,0.12390175652586308,1036295.7224151217,2514.9209104937063,1038810.6433256154,998,0,260.6898395721925,59,128,42,39.86551208586306,0.5242312834224598,45.503472222222214,8143.888888888876,138.03201506591316,8
1019,32,4,0,187,0.0213903743315508,0.0,1.0,187,6000,4300,1700,0.7166666666666667,77,43,34,235.58089710726537,0.47878811837540486,0.7942218599630848,0.13035281087296288,1032914.8813619338,5267.002877337524,1038181.8842392713,999,0,260.5401069518717,72,115,38,39.93328559661535,0.521557486631016,45.918949771689476,8130.593607305887,112.92491121258178,8
1020,32,1,2,186,0.005319148936170213,0.010638297872340425,0.9893617021276596,188,6000,3600,2400,0.6,84,36,48,211.8753424767224,0.4791648888762468,0.7680236386155699,0.11505005377026323,1026933.3352570086,-83.62957833147038,1026849.7056786771,1000,0,260.1489361702128,75,113,33,41.287960758854524,0.519780585106383,46.65570175438599,8107.0175438597,108.09356725146266,8
1021,32,6,5,187,0.03125,0.026041666666666668,0.9739583333333334,192,5600,4400,1200,0.7857142857142857,68,44,24,203.0680838828698,0.4797148823807446,0.7690252124288919,0.11150678058052184,1030492.1225761712,-2147.9878424134017,1028344.1347337578,1001,0,255.63541666666666,75,117,38,41.06358464751209,0.5225151909722222,46.217105263157876,8121.052631578898,108.2807017543853,8
1022,32,5,1,191,0.026041666666666668,0.005208333333333333,0.9947916666666666,192,5550,4400,1150,0.7927927927927928,67,44,23,200.7209538674332,0.47997166321262363,0.7565569462505404,0.10940913915796531,1028148.9372474235,-2675.792919581484,1025473.1443278419,1002,0,251.41145833333334,78,114,43,41.41764195925443,0.5193684895833333,46.50580168776374,8111.814345991636,103.99761982040559,8
1023,32,6,6,191,0.030456852791878174,0.030456852791878174,0.9695431472081218,197,6500,4600,1900,0.7076923076923077,84,46,38,201.9822165764771,0.48038930039020683,0.7686947290265742,0.11083280253991917,1030269.5180247707,-4280.775815635863,1025988.7422091347,1003,0,245.26395939086294,75,122,35,41.11910806236722,0.5187182741116751,46.24451754385963,8120.175438596441,108.26900584795256,7
1024,32,5,2,194,0.025510204081632654,0.01020408163265306,0.9897959183673469,196,6300,4500,1800,0.7142857142857143,81,45,36,204.61023633089903,0.48042200854700856,0.7736689617065213,0.1137308778971949,1034347.9573619005,-3172.3639991597397,1031175.5933627407,1004,0,246.76020408163265,68,128,38,40.54039009618815,0.5221619897959184,45.74275362318841,8136.231884057985,119.65046888320566,0
1025,32,3,2,195,0.015228426395939087,0.01015228426395939,0.9898477157360406,197,5300,4000,1300,0.7547169811320755,66,40,26,202.10801830578868,0.48082202424116854,0.7716207534985291,0.11334969696424216,1037163.3320398127,-2776.194860400837,1034387.1371794118,1005,0,246.44670050761422,73,124,45,40.25122786163176,0.524746192893401,45.39695945945947,8147.297297297318,111.60681229174409,0
1026,32,6,6,195,0.029850746268656716,0.029850746268656716,0.9701492537313433,201,6450,4400,2050,0.6821705426356589,85,44,41,195.28199451700138,0.48147077114427855,0.7683227557973278,0.11088621079965373,1041037.59765625,-5990.8203125000455,1035046.77734375,1006,0,240.86069651741295,79,122,38,39.94065849923431,0.5283996683250415,44.921875,8162.5,103.32278481012658,0
1027,32,3,1,197,0.015151515151515152,0.005050505050505051,0.9949494949494949,198,5900,3900,2000,0.6610169491525424,79,39,40,255.78985394845876,0.4813447503802834,0.8213419088292959,0.14067022489618292,1030973.9065439354,7242.532995908821,1038216.4395398443,1007,0,244.72222222222223,60,138,37,39.664760623388275,0.5136784511784511,46.15778688524588,8122.950819672096,135.3825136612016,8
1028,32,4,1,200,0.01990049751243781,0.004975124378109453,0.9950248756218906,201,5700,4000,1700,0.7017543859649122,74,40,34,203.25477439426618,0.4822160033167496,0.7736458468619205,0.11334692985012282,1035376.9109278519,-3810.939911265584,1031565.9710165863,1008,0,237.3084577114428,71,130,39,40.445849684354236,0.523269071310116,45.616319444444436,8140.277777777754,114.65179968701061,8
1029,32,4,2,202,0.0196078431372549,0.00980392156862745,0.9901960784313726,204,6300,4100,2200,0.6507936507936508,85,41,44,199.50536203793263,0.482490984899707,0.7710581638723737,0.11260457923010486,1039158.0631574554,-5636.478879027229,1033521.5842784282,1009,0,234.7892156862745,77,127,34,40.067894199025304,0.5260416666666667,45.15224358974357,8155.128205128151,105.91075591075521,0
1030,32,3,2,203,0.014634146341463415,0.00975609756097561,0.9902439024390244,205,6600,4400,2200,0.6666666666666666,88,44,44,210.96502270805982,0.4828610712577714,0.787138291914212,0.11626633137334993,1031648.9673185588,-4071.6304365788674,1027577.33688198,1010,0,234.11707317073171,81,124,35,40.71775935097639,0.5228658536585367,46.074695121951216,8125.609756097549,100.31616982836479,7
1031,32,6,0,209,0.028708133971291867,0.0,1.0,209,6950,5500,1450,0.7913669064748201,84,55,29,223.3942488578335,0.4836542295423874,0.8028472821397752,0.12388226527570796,1033611.1111111137,-2569.4444444442433,1031041.6666666694,1011,0,227.23444976076556,69,140,44,40.15539617486338,0.5203847687400319,45.83333333333334,8133.333333333354,117.874396135266,8
1032,32,4,4,209,0.018779342723004695,0.018779342723004695,0.9812206572769953,213,7650,4900,2750,0.6405228758169934,104,49,55,206.12556926562937,0.4840811114063838,0.7891559213144796,0.11579235236649991,1037677.1263370286,-7471.642323971336,1030205.4840130572,1012,0,223.94835680751174,72,141,42,40.084584710782416,0.5236697965571204,45.33390410958906,8149.315068493189,113.18493150684985,0
1033,32,3,4,208,0.014150943396226415,0.018867924528301886,0.9811320754716981,212,6150,4300,1850,0.6991869918699187,80,43,37,204.58547375141717,0.4842804554532177,0.7876676181856155,0.11618328454868776,1041076.0133909084,-5952.1941178370935,1035123.8192730712,1013,0,225.5754716981132,82,130,40,39.69854448544484,0.5293828616352201,44.91716867469878,8162.650602409602,99.54451954158051,7
1034,32,2,3,207,0.009523809523809525,0.014285714285714285,0.9857142857142858,210,6400,4300,2100,0.671875,85,43,42,227.70898415446567,0.48444026733500417,0.8092024539877298,0.1279881531626824,1037851.5625000002,-1134.3749999999563,1036717.1875000002,1014,0,228.0952380952381,69,141,39,39.51303680981596,0.5224206349206348,45.3125,8150.000000000002,118.11594202898553,8
1035,32,3,2,208,0.014285714285714285,0.009523809523809525,0.9904761904761905,210,6200,4100,2100,0.6612903225806451,83,41,42,239.1830153184623,0.4838929710640237,0.8175644028103035,0.13263785394932942,1033611.1111111138,1244.4444444446817,1034855.5555555585,1015,0,229.01904761904763,64,146,39,39.75409836065572,0.5142361111111111,45.83333333333334,8133.333333333355,127.08333333333367,8
1036,32,7,3,212,0.03255813953488372,0.013953488372093023,0.986046511627907,215,7000,5300,1700,0.7571428571428571,87,53,34,223.43401944191135,0.4844363544157067,0.8092414621356008,0.1257312144906849,1038215.4336734684,-3605.470521542026,1034609.9631519264,1016,0,224.5860465116279,69,146,42,39.57627448689491,0.5185077519379845,45.26785714285714,8151.428571428563,118.1366459627328,0
1037,32,3,2,213,0.013953488372093023,0.009302325581395349,0.9906976744186047,215,6800,4300,2500,0.6323529411764706,93,43,50,220.36394402266595,0.48429055277838157,0.8061943985096196,0.12060312404393149,1029437.2510998478,-4429.829444757503,1025007.4216550903,1017,0,224.77209302325582,72,143,41,40.757435118511864,0.5120639534883721,46.34703196347031,8116.894977168917,112.7346524606794,8
1038,32,4,1,216,0.018433179723502304,0.004608294930875576,0.9953917050691244,217,7150,5500,1650,0.7692307692307693,88,55,33,214.33246528212285,0.4842772159640439,0.8035065653597806,0.11827976787791179,1032071.2809917314,-6308.723599632984,1025762.5573920985,1018,0,223.67281105990784,76,141,41,40.57916977380061,0.5146409370199693,46.02272727272726,8127.272727272694,106.93779904306177,0
1039,32,3,1,218,0.0136986301369863,0.0045662100456621,0.995433789954338,219,6950,4400,2550,0.6330935251798561,95,44,51,218.55223540567323,0.48475486294387893,0.8105453391798956,0.1219896826433329,1035666.0034690343,-5480.575961636423,1030185.427507398,1019,0,222.6164383561644,65,154,40,40.02041976840366,0.5186453576864536,45.58080808080808,8141.414141414146,125.25252525252532,8
1040,32,5,5,218,0.02242152466367713,0.02242152466367713,0.9775784753363229,223,7400,5600,1800,0.7567567567567568,92,56,36,247.66716414031686,0.4853662519021263,0.8272311361103184,0.13821425611701574,1035605.5363321817,-702.9027297192497,1034902.6336024624,1020,0,219.5695067264574,67,156,36,39.28729126525371,0.5218142750373692,45.58823529411765,8141.176470588249,121.51009657594402,7
1041,32,3,2,219,0.013574660633484163,0.00904977375565611,0.9909502262443439,221,6250,3800,2450,0.608,87,38,49,234.87000539437616,0.48541152474976007,0.8164616563705005,0.13133639953484363,1036237.973616346,-1773.7563093742701,1034464.2173069718,1021,0,220.68325791855204,70,151,38,39.53336984511316,0.5232371794871795,45.51056338028169,8143.661971830987,116.3380281690141,8
1042,32,3,5,217,0.013513513513513514,0.02252252252252252,0.9774774774774775,222,6550,4600,1950,0.7022900763358778,85,46,39,247.84697636827588,0.4855234193469487,0.831007163364686,0.14106289082996581,1041764.9210574378,689.6571541241065,1042454.5782115619,1022,0,220.46396396396398,75,147,39,38.50854281928704,0.5278716216216216,44.83278508771929,8165.350877192959,108.87134502923945,8
1043,32,3,2,218,0.013636363636363636,0.00909090909090909,0.990909090909091,220,8700,6700,2000,0.7701149425287356,107,67,40,216.38408211898704,0.48536304829113047,0.8074694870854782,0.12134104427970362,1037124.0114795943,-7816.574546485211,1029307.4369331091,1023,0,221.78636363636363,69,151,38,39.89268562355096,0.5244318181818182,45.40178571428572,8147.142857142877,118.07453416149097,8
1044,32,1,5,214,0.0045662100456621,0.0228310502283105,0.9771689497716896,219,6800,4500,2300,0.6617647058823529,91,45,46,206.81236666672197,0.4853012022956726,0.790796239054242,0.1164839417673928,1038500.867454821,-7645.035563245096,1030855.831891576,1024,0,223.07305936073058,84,135,41,39.963943271281295,0.5281107305936072,45.23284313725489,8152.549019607811,97.05415499533107,8
1045,32,2,0,216,0.009259259259259259,0.0,1.0,216,7150,4500,2650,0.6293706293706294,98,45,53,212.96717671715507,0.48510443583118,0.7983028766223792,0.11737546475617025,1031664.391303711,-6407.86945288525,1025256.5218508258,1025,0,226.69907407407408,86,130,36,40.66498098201939,0.5199652777777778,46.072796934865906,8125.670498084302,94.48454067539886,7
1046,32,7,6,217,0.03139013452914798,0.026905829596412557,0.9730941704035875,223,6550,4500,2050,0.6870229007633588,86,45,41,210.92931364684551,0.4855674059709934,0.8046543781621074,0.1180238067962883,1036437.1141975302,-7427.0061728395085,1029010.1080246906,1026,0,220.55156950672645,71,152,41,40.1176671214188,0.523822869955157,45.48611111111111,8144.44444444444,114.71048513302028,0
1047,32,2,2,217,0.0091324200913242,0.0091324200913242,0.9908675799086758,219,6750,4300,2450,0.6370370370370371,92,43,49,209.5295027687612,0.48543211428092664,0.8004011316103621,0.11826239282272305,1039158.0631574605,-7003.145545693686,1032154.9176117668,1027,0,220.31506849315068,77,142,36,39.812431221506046,0.526683789954338,45.152243589743584,8155.128205128192,105.91075591075574,0
1048,32,1,4,214,0.0045871559633027525,0.01834862385321101,0.981651376146789,218,7350,5300,2050,0.7210884353741497,94,53,41,209.9425716559648,0.48549690666441186,0.7989853299828651,0.11909556868080885,1040735.8295652721,-7251.04870531283,1033484.7808599593,1028,0,220.89908256880733,80,138,39,39.604448198198206,0.5284785932721712,44.9588477366255,8161.31687242795,102.01646090534938,0
1049,32,1,7,208,0.004651162790697674,0.03255813953488372,0.9674418604651163,215,6550,4500,2050,0.6870229007633588,86,45,41,226.60188797002655,0.48543523147141926,0.8011878164278832,0.12599413924955125,1034446.5693810699,-2668.4908748266926,1031778.0785062432,1029,0,224.3674418604651,70,145,39,39.96884195949453,0.524079457364341,45.73063380281688,8136.6197183098175,116.23742454728311,8
1050,32,5,6,207,0.023474178403755867,0.028169014084507043,0.971830985915493,213,5650,3700,1950,0.6548672566371682,76,37,39,209.74272490565977,0.4852658930522337,0.7912050223981724,0.11843754395855915,1039302.8210623248,-4652.75886164991,1034650.0622006749,1030,0,226.06103286384976,78,135,37,39.78887509269315,0.5288047730829422,45.13449367088606,8155.696202531606,104.56020772476418,8
1051,32,0,5,202,0.0,0.024154589371980676,0.9758454106280193,207,5950,3700,2250,0.6218487394957983,82,37,45,216.87216669128793,0.484748995513031,0.792653786883968,0.12275878849949463,1040055.724687993,-2238.172301447593,1037817.5523865453,1031,1,231.18357487922705,78,129,37,39.51286891463243,0.5302435587761675,45.042194092826996,8158.649789029519,104.59807421832716,0
1052,32,1,1,202,0.0049261083743842365,0.0049261083743842365,0.9950738916256158,203,6400,4600,1800,0.71875,82,46,36,201.25608472622855,0.4845957502154156,0.7764613458555158,0.11302042180449066,1037575.9449785427,-5236.305541500384,1032339.6394370424,1032,0,230.24137931034483,76,127,40,40.22126009349765,0.5282224958949097,45.34632034632035,8148.917748917752,107.2226019594441,8
1053,32,2,3,201,0.00980392156862745,0.014705882352941176,0.9852941176470589,204,6900,4600,2300,0.6666666666666666,92,46,46,198.82288421170145,0.48452391013876817,0.775273911741164,0.11224575462000637,1039231.5782335042,-6375.396050347365,1032856.1821831568,1033,0,230.0441176470588,79,125,39,40.07609334287029,0.5303819444444444,45.14322916666666,8155.416666666645,103.23312236286893,0
1054,32,5,3,203,0.024271844660194174,0.014563106796116505,0.9854368932038835,206,6300,4400,1900,0.6984126984126984,82,44,38,195.288844770039,0.4850777488357408,0.775425019045064,0.11144327488972969,1042586.8622449067,-6778.8832199542,1035807.9790249525,1034,0,228.74271844660194,69,137,45,39.74704636430765,0.5332726537216829,44.73214285714289,8168.5714285714985,118.38509316770288,0
1055,32,3,2,204,0.014563106796116505,0.009708737864077669,0.9902912621359223,206,5850,3800,2050,0.6495726495726496,79,38,41,198.74462273914384,0.48475905754203175,0.7795122765305165,0.11465248390985142,1045949.8472717437,-5474.618439982394,1040475.2288317613,1035,0,229.4757281553398,72,134,44,39.23928916917813,0.5360032362459547,44.32077625570777,8181.735159817367,113.635210553019,0
1056,32,2,5,201,0.009708737864077669,0.024271844660194174,0.9757281553398058,206,5800,3600,2200,0.6206896551724138,80,36,44,195.43993673493156,0.48446009945536345,0.7756944617765238,0.11347184386550561,1047929.3628808913,-6038.550323176164,1041890.8125577151,1036,0,230.29126213592232,75,131,42,39.077227934875765,0.5381270226537217,44.07894736842107,8189.473684210565,109.19298245614087,0
1057,32,0,2,199,0.0,0.009950248756218905,0.9900497512437811,201,6600,4200,2400,0.6363636363636364,90,42,48,197.93309625690443,0.48410758706467666,0.7729120163021745,0.11533955409455686,1049052.1242112978,-5271.572983994909,1043780.5512273029,1037,1,232.18905472636817,75,126,42,38.873648431645414,0.5402155887230514,43.94188596491229,8193.859649122824,109.25146198830431,0
1058,32,1,1,199,0.005,0.005,0.995,200,6000,4400,1600,0.7333333333333333,76,44,32,180.6508134280554,0.4837280150753769,0.7513613476886813,0.104770737368387,1047592.6517053369,-8150.307065635381,1039442.3446397015,1038,0,234.24,75,125,42,39.497573963968826,0.5391666666666667,44.1200657894737,8188.157894736877,109.17543859649169,8
1059,32,0,3,196,0.0,0.01507537688442211,0.9849246231155779,199,6350,4400,1950,0.6929133858267716,83,44,39,214.03523021523444,0.48334158164560176,0.7823826764086796,0.12113237082991937,1040002.6353516631,-1630.5593036111713,1038372.0760480519,1039,1,236.39698492462313,76,123,42,39.59184530758073,0.5284233668341709,45.0487012987013,8158.441558441573,107.34791524265228,8
1060,32,3,2,197,0.01507537688442211,0.010050251256281407,0.9899497487437185,199,5450,3700,1750,0.6788990825688074,72,37,35,232.12889183777853,0.4832199719134393,0.7993505218823713,0.13193636945500986,1041339.0177532809,3094.9744437022814,1044433.9921969832,1040,0,235.74371859296483,66,133,39,38.96299286976661,0.5243404522613065,44.88495024875625,8163.68159203986,123.69214533393728,8
1061,32,4,0,201,0.01990049751243781,0.0,1.0,201,6500,4500,2000,0.6923076923076923,85,45,40,224.384808779472,0.4837406716417911,0.7932545553287513,0.12865805222823018,1044064.7600263036,154.45430637769914,1044219.2143326813,1041,0,234.044776119403,64,137,41,38.819400878293635,0.5275186567164178,44.55128205128207,8174.358974359015,127.7243589743596,0
1062,32,1,2,200,0.0049504950495049506,0.009900990099009901,0.9900990099009901,202,6750,4800,1950,0.7111111111111111,87,48,39,218.3049840418451,0.4835337544948524,0.7946298018994145,0.12480277397699024,1043147.9659763317,-1605.1199868507297,1041542.845989481,1042,0,233.88118811881188,64,138,43,39.08933764304696,0.5259385313531353,44.66346153846154,8170.769230769234,127.66826923076928,8
1063,32,3,3,200,0.014778325123152709,0.014778325123152709,0.9852216748768473,203,6100,4200,1900,0.6885245901639344,80,42,38,211.8914201554546,0.48343839925864507,0.7896304211696128,0.12227614934149678,1046049.6780846679,-2370.2096314968567,1043679.4684531711,1043,0,232.1871921182266,68,135,43,38.89069296018577,0.5287356321839081,44.308574879227045,8182.1256038647225,120.32537652742239,0
1064,32,2,0,202,0.009900990099009901,0.0,1.0,202,5650,3900,1750,0.6902654867256637,74,39,35,206.62817944423907,0.4835163087204242,0.783651362932033,0.12014040022697707,1048372.1580557675,-2725.353920181918,1045646.8041355857,1044,0,232.2029702970297,71,131,37,38.73571704440555,0.5315078382838283,44.02488425925925,8191.203703703684,115.36906624934767,0
1065,32,3,4,201,0.014634146341463415,0.01951219512195122,0.9804878048780488,205,5850,3800,2050,0.6495726495726496,79,38,41,212.20359586661408,0.48362326637972264,0.7929560005361898,0.12069513840522977,1041555.4488320935,-2645.6376926728544,1038909.8111394206,1045,0,229.79024390243902,77,128,42,39.44424452586584,0.5258130081300814,44.85844017094018,8164.529914529931,106.03285603285624,8
1066,32,1,3,199,0.0049504950495049506,0.01485148514851485,0.9851485148514851,202,6000,4500,1500,0.75,75,45,30,249.60624304095214,0.4827214997619165,0.8145191908300105,0.1409690655707858,1039350.2649221423,5485.6629661666375,1044835.9278883089,1046,0,233.93564356435644,67,135,34,38.76692911808312,0.5226897689768977,45.128676470588225,8155.882352941152,121.72958735733063,8
1067,32,6,1,204,0.02926829268292683,0.004878048780487805,0.9951219512195122,205,5850,4100,1750,0.7008547008547008,76,41,35,238.07195135866476,0.48355850470269407,0.8090738529762913,0.136177156177156,1043316.3265306101,2826.8707482991294,1046143.1972789093,1047,0,231.25853658536585,62,143,40,38.563519813519775,0.5261178861788618,44.64285714285713,8171.428571428554,131.7972350230412,0
1068,32,6,9,201,0.02857142857142857,0.04285714285714286,0.9571428571428572,210,6150,4400,1750,0.7154471544715447,79,44,35,224.57674606417308,0.48449248120300753,0.8018616682452917,0.1301878817204107,1047454.7760770944,-1103.2029478459535,1046351.5731292485,1048,0,225.71428571428572,69,141,34,38.39081462525688,0.5299603174603175,44.13690476190475,8187.619047619023,118.661145617667,0
1069,32,6,1,206,0.028985507246376812,0.004830917874396135,0.9951690821256038,207,6000,3800,2200,0.6333333333333333,82,38,44,222.60253630377642,0.484187147257008,0.7990865036484163,0.1301329643198203,1050040.0357842785,-651.684962782485,1049388.350821496,1049,0,227.81642512077295,72,135,41,38.11874524220649,0.5328099838969405,43.821347031963455,8197.716894977133,113.85717909690463,0
1070,32,3,6,203,0.014354066985645933,0.028708133971291867,0.9712918660287081,209,6750,4800,1950,0.7111111111111111,87,48,39,225.59051120256964,0.4839887360446571,0.803665663278673,0.13369520606403967,1054218.0425739244,-985.6825713550688,1053232.3600025694,1050,0,226.60287081339712,68,141,42,37.52156482189419,0.5359350079744817,43.312198067632856,8214.009661835764,120.79425973287888,0
1071,32,1,4,200,0.004901960784313725,0.0196078431372549,0.9803921568627451,204,7750,6300,1450,0.8129032258064516,92,63,29,224.83032458241232,0.4835222882256351,0.7990996741357892,0.13399520025316675,1055925.0947783736,-1069.2036412528305,1054855.8911371208,1051,0,231.68627450980392,70,134,39,37.32866933181043,0.5386029411764706,43.10446009389672,8220.65727699531,117.43796109993302,0
1072,32,2,2,200,0.009900990099009901,0.009900990099009901,0.9900990099009901,202,6250,4400,1850,0.704,81,44,37,220.75038690302677,0.4832782252105807,0.7925025314251086,0.1324722851275207,1058009.5057703138,61.2015491754255,1058070.7073194892,1052,0,234.43564356435644,72,130,41,37.17445387788319,0.5417182343234324,42.851027397260275,8228.767123287675,114.28843226788437,0
1073,32,1,3,198,0.004975124378109453,0.014925373134328358,0.9850746268656716,201,6300,4000,2300,0.6349206349206349,86,40,46,217.76506049243096,0.4831125621890547,0.788809099353152,0.13136255978164815,1059579.8980933656,-352.10387902657476,1059227.794214339,1053,0,234.72139303482587,64,137,44,37.05629592726366,0.5442578772802653,42.66025641025643,8234.87179487184,128.6698717948725,0
1074,32,0,3,195,0.0,0.015151515151515152,0.9848484848484849,198,6200,4100,2100,0.6612903225806451,83,41,42,221.42089773415998,0.4826180587601907,0.7907885123363119,0.13386823083193744,1060256.3476562535,1152.5824652779602,1061408.9301215315,1054,1,238.63131313131314,63,135,43,36.87826673410895,0.545770202020202,42.578125000000014,8237.500000000027,130.75396825396868,0
1075,32,2,1,196,0.01015228426395939,0.005076142131979695,0.9949238578680203,197,6700,4900,1800,0.7313432835820896,85,49,36,219.24635506984822,0.4825162298421907,0.7871483534818395,0.133482095538361,1062353.0613083579,483.40729783084043,1062836.4686061887,1055,0,240.51776649746193,64,133,43,36.67425938594854,0.5473244500846024,42.32371794871798,8245.641025641089,128.83814102564202,0
1076,32,1,2,195,0.005076142131979695,0.01015228426395939,0.9898477157360406,197,6150,4100,2050,0.6666666666666666,82,41,41,215.1994982389484,0.48262629925066475,0.7833447942076828,0.1317650083901605,1064053.8329806225,246.77019133215936,1064300.6031719546,1056,0,241.12182741116752,66,131,46,36.56791965595546,0.5491222504230118,42.11753731343285,8252.238805970175,125.0339213025784,0
1077,32,0,3,192,0.0,0.015384615384615385,0.9846153846153847,195,5200,3500,1700,0.6730769230769231,69,35,34,212.45410952473787,0.48218895937968104,0.7782989697681633,0.13056645760112603,1065158.6129489664,1059.4649233358082,1066218.0778723022,1057,1,240.77948717948718,68,127,43,36.50203323386578,0.5510683760683761,41.983695652173935,8256.521739130483,121.41943734015416,0
1078,32,0,4,188,0.0,0.020833333333333332,0.9791666666666666,192,5650,3500,2150,0.6194690265486725,78,35,43,204.28731167608368,0.4819412630890052,0.7691781426553681,0.12052951388888873,1052854.4423440394,-1033.0392774630227,1051821.4030665765,1058,2,243.55729166666666,68,124,47,38.23784722222222,0.54296875,43.4782608695652,8208.695652173867,120.71611253196863,8
1079,32,2,4,186,0.010526315789473684,0.021052631578947368,0.9789473684210527,190,5550,4000,1550,0.7207207207207207,71,40,31,203.3661566831218,0.4815777870602432,0.7656048542288088,0.12091444315833376,1055201.5693535176,-631.542462915545,1054570.026890602,1059,0,244.73684210526315,70,120,51,37.96989259597805,0.5462719298245614,43.19248826291078,8217.84037558681,117.39771965124014,0
1080,32,0,3,183,0.0,0.016129032258064516,0.9838709677419355,186,6050,4400,1650,0.7272727272727273,77,44,33,223.46215974157425,0.48132204785430593,0.7734940831600552,0.12757410942707784,1042717.2308572035,3351.5688814212454,1046068.7997386247,1060,1,248.9516129032258,68,118,34,39.01155627833628,0.5337141577060932,44.71618357487925,8169.0821256039235,120.13356067064593,8
1081,32,1,2,182,0.005434782608695652,0.010869565217391304,0.9891304347826086,184,5050,3600,1450,0.7128712871287128,65,36,29,227.65464307415883,0.4807852221430269,0.7756445520569026,0.13132530502659373,1045938.3368875305,5772.543752342443,1051710.880639873,1061,0,251.8695652173913,70,114,37,38.50155888372451,0.5366847826086957,44.32218309859158,8181.690140845136,116.88128772635908,0
1082,32,2,2,182,0.010869565217391304,0.010869565217391304,0.9891304347826086,184,6050,4300,1750,0.7107438016528925,78,43,35,225.48091485449177,0.4809454690346084,0.7761935856300621,0.12771008921141555,1040247.4414904319,4061.188956461438,1044308.6304468933,1062,0,246.54891304347825,77,107,40,39.26935482463032,0.5352694746376812,45.018696581196586,8159.401709401723,105.96625596625614,8
1083,32,2,2,182,0.010869565217391304,0.010869565217391304,0.9891304347826086,184,5200,3700,1500,0.7115384615384616,67,37,30,223.5477111212526,0.4808000712758375,0.7756185823193731,0.12719631089233646,1041675.3906250001,4572.829861111097,1046248.2204861112,1063,0,247.2663043478261,79,105,42,39.13979043342179,0.5374773550724637,44.84375,8165.000000000001,103.35443037974684,0
1084,32,1,3,180,0.00546448087431694,0.01639344262295082,0.9836065573770492,183,4850,3600,1250,0.7422680412371134,61,36,25,217.87722691396132,0.4810457074801337,0.7686748318938073,0.12473194746881547,1043580.6881432513,4024.493278723183,1047605.1814219746,1064,0,249.07650273224044,68,115,42,39.04615179996454,0.5395036429872495,44.61050724637683,8172.463768115975,120.18329070758786,0
1085,32,4,4,180,0.021739130434782608,0.021739130434782608,0.9782608695652174,184,7150,5300,1850,0.7412587412587412,90,53,37,235.91827416949386,0.4810852983685752,0.7802777035980806,0.14029902052436605,1055267.0209750507,5841.354875283114,1061108.3758503338,1065,0,246.47282608695653,69,115,41,37.12577741723646,0.5501019021739131,43.18452380952379,8218.095238095191,119.10282953761147,7
1086,32,1,4,177,0.0055248618784530384,0.022099447513812154,0.9779005524861879,181,5800,4100,1700,0.7068965517241379,75,41,34,236.17967955230233,0.4805389298137917,0.7795903897862366,0.141021808662142,1056490.306122447,7904.308390022499,1064394.6145124694,1066,0,250.79005524861878,69,112,34,36.966740020075676,0.5523710865561695,43.03571428571428,8222.857142857127,119.17184265010329,0
1087,32,0,3,174,0.0,0.01694915254237288,0.9830508474576272,177,5450,3200,2250,0.5871559633027523,77,32,45,256.6119334030689,0.4799089946070878,0.7851697552620254,0.1480608128969123,1046003.3576871109,12833.388792438109,1058836.746479549,1067,2,251.94915254237287,71,106,35,37.75303428959428,0.5407250470809792,44.3142361111111,8181.944444444418,115.23865414710448,8
1088,32,4,4,174,0.02247191011235955,0.02247191011235955,0.9775280898876404,178,6250,4800,1450,0.768,77,48,29,252.18930185963924,0.48040386487229947,0.7855686609476307,0.14723709651038136,1049639.6542159778,11091.578320184159,1060731.232536162,1068,0,249.02808988764045,77,101,35,37.410872568955625,0.54500234082397,43.870192307692314,8196.153846153858,106.4435564435566,0
1089,32,2,1,175,0.011363636363636364,0.005681818181818182,0.9943181818181818,176,6850,5400,1450,0.7883211678832117,83,54,29,255.0564129115689,0.47984713203463203,0.7879665173652268,0.15013212611913923,1052141.0034758365,11621.062044745117,1063762.0655205816,1069,0,252.48863636363637,61,115,34,37.024653846993814,0.5481770833333333,43.565188172043015,8205.913978494633,134.52317997532185,0
1090,32,0,4,171,0.0,0.022857142857142857,0.9771428571428571,175,6000,4600,1400,0.7666666666666667,74,46,28,252.995222780674,0.47934455391351943,0.7794735223466236,0.1462572786387979,1046602.0727040861,11957.064909297307,1058559.1376133834,1070,1,254.89142857142858,69,106,38,37.7704927173639,0.5413095238095238,44.241071428571445,8184.285714285749,118.6128364389239,7
1091,32,4,0,175,0.022857142857142857,0.0,1.0,175,5100,3500,1600,0.6862745098039216,67,35,32,229.22456151187686,0.47942391899288456,0.7634050265627983,0.1323065381410345,1046114.9695294832,7859.04903628143,1053974.0185657647,1071,0,255.48,69,106,44,38.439336844555676,0.5432738095238095,44.300595238095255,8182.38095238099,118.58523119392738,8
1092,32,4,2,177,0.0223463687150838,0.0111731843575419,0.9888268156424581,179,5300,3800,1500,0.7169811320754716,68,38,30,276.1263063648542,0.48015399744732495,0.8103386483309485,0.15924273367062694,1045852.8888968655,16657.499042420528,1062510.387939286,1072,0,250.7486033519553,58,121,39,37.272978385470616,0.5385242085661079,44.332627118644055,8181.355932203364,141.05786090005802,8
1093,32,3,0,180,0.016666666666666666,0.0,1.0,180,5100,2900,2200,0.5686274509803921,73,29,44,243.25889547928205,0.4804960686943927,0.7918463536418803,0.13507628411040898,1034027.8197691757,9207.293066379792,1043235.1128355556,1073,0,249.98888888888888,60,120,37,39.5980273616802,0.5243055555555556,45.7821038251366,8134.972677595611,135.58287795992683,8
1094,32,5,3,182,0.02702702702702703,0.016216216216216217,0.9837837837837837,185,6700,4700,2000,0.7014925373134329,87,47,40,235.37950499658123,0.4814764492753623,0.7894241475947408,0.13128651659577428,1035436.7028270892,5044.11571334656,1040480.8185404358,1074,0,244.2054054054054,64,121,39,39.62113098987862,0.5249436936936938,45.608974358974365,8140.512820512835,127.19551282051304,7
1095,32,5,4,183,0.026737967914438502,0.0213903743315508,0.9786096256684492,187,6100,4200,1900,0.6885245901639344,80,42,38,236.49732257843763,0.4820069767887605,0.7928215219094876,0.1326555913711877,1037208.5118865432,5559.407203346658,1042767.9190898899,1075,0,241.5614973262032,65,122,39,39.369989255310365,0.5245655080213903,45.391414141414145,8147.4747474747555,125.34576534576547,8
1096,32,6,8,181,0.031746031746031744,0.042328042328042326,0.9576719576719577,189,5900,4300,1600,0.7288135593220338,75,43,32,238.41220339226945,0.4821264400165109,0.7957742536859378,0.13568275659026002,1041741.2770834696,5972.766646829265,1047714.0437302989,1076,0,239.7989417989418,70,119,36,38.752251993253616,0.5283840388007055,44.835680751173705,8165.258215962429,116.64654594232042,0
1097,32,0,0,181,0.0,0.0,1.0,181,5250,3600,1650,0.6857142857142857,69,36,33,251.10365282370105,0.48088807039083287,0.7998178549341721,0.14253902821509767,1040940.9793962342,10826.816460055044,1051767.795856289,1077,1,251.1988950276243,65,116,36,38.52890446135759,0.528372467771639,44.93371212121212,8162.121212121205,125.57109557109546,0
1098,32,5,1,185,0.026881720430107527,0.005376344086021506,0.9946236559139785,186,5650,4000,1650,0.7079646017699115,73,40,33,235.71674946871062,0.4812100406858471,0.7927013062844301,0.13555718246383994,1044984.0705934243,6414.049673372857,1051398.120266797,1078,0,245.41935483870967,61,125,40,38.414839589770565,0.5320900537634409,44.43884408602152,8177.9569892473355,134.06486867618582,0
1099,32,2,1,186,0.0106951871657754,0.0053475935828877,0.9946524064171123,187,5150,3500,1650,0.6796116504854369,68,35,33,231.39396254398827,0.4813816533456002,0.7907971401429574,0.13098054179525154,1040060.0277777811,5582.722222222399,1045642.7500000035,1079,0,240.15508021390374,74,113,37,39.142084763305554,0.5298016934046346,45.04166666666668,8158.666666666693,110.25225225225262,7
1100,32,3,2,187,0.015873015873015872,0.010582010582010581,0.9894179894179894,189,6450,4700,1750,0.7286821705426356,82,47,35,232.5419652257543,0.4814240215392698,0.7944054963922507,0.133865066785383,1045293.2400173623,4364.908854166714,1049658.148871529,1080,0,238.59259259259258,63,126,39,38.45729325861776,0.5335097001763669,44.40104166666667,8179.166666666676,129.82804232804247,0
1101,32,3,1,189,0.015789473684210527,0.005263157894736842,0.9947368421052631,190,5800,4100,1700,0.7068965517241379,75,41,34,228.60125509122986,0.4812708855472014,0.7918474112412259,0.13324860786451706,1049140.0178533935,4166.94496954429,1053306.9628229376,1081,0,237.8842105263158,68,122,40,38.07739358566207,0.5365679824561403,43.93115942028986,8194.202898550735,120.50298380221669,0
1102,32,3,4,188,0.015625,0.020833333333333332,0.9791666666666666,192,5800,3900,1900,0.6724137931034483,77,39,38,220.09061353067315,0.4814788303519488,0.7862044648613802,0.12959777584892673,1052252.6140085633,2118.1846812797157,1054370.7986898432,1082,0,236.375,62,130,43,37.90739845261121,0.5393880208333333,43.55158730158729,8206.349206349183,132.36047107014812,0
1103,32,0,3,185,0.0,0.015957446808510637,0.9840425531914894,188,5050,2800,2250,0.5544554455445545,73,28,45,221.13388411496126,0.48093260515037733,0.7814901858611529,0.1304152155174676,1052728.616042078,3908.7935568705498,1056637.4095989487,1083,1,238.92021276595744,64,124,43,37.82136386355115,0.5412234042553192,43.493589743589745,8208.20512820513,128.25320512820517,0
1104,32,2,2,185,0.0106951871657754,0.0106951871657754,0.9893048128342246,187,5600,3800,1800,0.6785714285714286,74,38,36,212.2789595997076,0.4812654533954344,0.7737393401099453,0.12209382567879587,1045023.0347021093,1367.28051285848,1046390.3152149678,1084,0,240.22994652406416,66,121,39,39.008952832866925,0.5328097147950089,44.43407960199004,8178.109452736302,123.91074928388336,8
1105,32,1,0,186,0.005376344086021506,0.0,1.0,186,6400,4200,2200,0.65625,86,42,44,220.035024268521,0.4812935919790759,0.7772677936243588,0.12369913010443992,1037913.0821314459,2075.4460430819763,1039988.5281745278,1085,0,242.4731182795699,68,118,43,39.70076857724301,0.5288418458781362,45.304951690821284,8150.241545893779,119.85649332196735,8
1106,32,4,2,188,0.021052631578947368,0.010526315789473684,0.9894736842105263,190,5800,3700,2100,0.6379310344827587,79,37,42,215.7490334321203,0.48163000092824654,0.778176661032002,0.12270308805411978,1041533.641975314,1141.975308642283,1042675.6172839563,1086,0,238.34736842105264,74,116,41,39.356514244238824,0.5321271929824561,44.86111111111113,8164.444444444487,110.33033033033091,0
1107,32,2,2,188,0.010526315789473684,0.010526315789473684,0.9894736842105263,190,6350,4100,2250,0.6456692913385826,86,41,45,209.55233796378994,0.4811658776571057,0.7720402036699738,0.12002288323154485,1043727.6565804019,-606.8858732217873,1043120.7707071801,1087,0,239.2736842105263,67,123,42,39.24040114756391,0.5341008771929825,44.59252450980392,8173.039215686276,121.98565993561607,0
1108,32,3,1,190,0.015706806282722512,0.005235602094240838,0.9947643979057592,191,5750,4000,1750,0.6956521739130435,75,40,35,204.2097403160412,0.4807201249196289,0.7666293379126954,0.11800639357851173,1046476.903426144,-1209.8446609222692,1045267.0587652217,1088,0,238.9476439790576,71,120,41,39.033831626784334,0.5363219895287958,44.256365740740755,8183.796296296327,115.2647365675539,0
1109,32,3,4,189,0.015544041450777202,0.02072538860103627,0.9792746113989638,193,6550,4800,1750,0.732824427480916,83,48,35,202.99713040705686,0.4806362892199194,0.7681410405989337,0.11802009821457624,1048348.4567901256,-2587.6543209875244,1045760.802469138,1089,0,237.43523316062175,74,119,37,38.83161512027497,0.5384822970639033,44.027777777777786,8191.111111111128,110.69069069069091,0
1110,32,7,4,192,0.03571428571428571,0.02040816326530612,0.9795918367346939,196,6000,4500,1500,0.75,75,45,30,199.94794884637483,0.48097036891679745,0.7697740664143291,0.11749750252433008,1051630.142252977,-3145.7420222992628,1048484.4002306778,1090,0,234.75510204081633,67,129,43,38.50133444869343,0.541188350340136,43.62745098039215,8203.921568627431,122.44659057652882,0
1111,32,1,3,190,0.0051813471502590676,0.015544041450777202,0.9844559585492227,193,5550,3900,1650,0.7027027027027027,72,39,33,222.67471081744398,0.4808195703799654,0.7833887557033492,0.12922146604130386,1047779.706790121,2512.8086419751735,1050292.5154320963,1091,0,238.30569948186528,71,122,38,38.39891451831752,0.5356217616580311,44.097222222222214,8188.8888888888705,115.33646322378691,8
1112,32,3,1,192,0.015544041450777202,0.0051813471502590676,0.9948186528497409,193,6200,3900,2300,0.6290322580645161,85,39,46,225.27607146029186,0.48064303576568795,0.7877060516069783,0.13218506716147005,1051176.1475315094,2560.9665857326427,1053737.114117242,1092,0,238.96373056994818,61,132,39,37.9085824156616,0.5383203799654577,43.68279569892474,8202.15053763443,134.46148422351524,0
1113,32,2,1,193,0.010309278350515464,0.005154639175257732,0.9948453608247423,194,5100,3200,1900,0.6274509803921569,70,32,38,218.72827176716908,0.4809037978740452,0.7829189606644504,0.1293671506243143,1053603.7497768085,2190.5854632180244,1055794.3352400265,1093,0,238.61340206185568,65,129,42,37.77414303872725,0.5405927835051547,43.38699494949495,8211.61616161616,126.33255633255632,0
1114,32,0,4,189,0.0,0.02072538860103627,0.9792746113989638,193,6200,4700,1500,0.7580645161290323,77,47,30,217.46169241427103,0.48069813255613125,0.7809501644511898,0.12919336102949092,1054962.1964631581,1082.7729351908974,1056044.969398349,1094,1,240.81865284974094,68,125,45,37.63767221275014,0.5423143350604491,43.22161835748791,8216.90821256036,120.83688547882882,0
1115,32,2,2,189,0.010471204188481676,0.010471204188481676,0.9895287958115183,191,5450,4000,1450,0.7339449541284404,69,40,29,235.55070557729186,0.48037567741342885,0.7915251019709344,0.13764557072447334,1049913.315007719,5811.5644290124255,1055724.8794367313,1095,0,243.21465968586386,71,120,40,37.80286343612333,0.5389397905759162,43.836805555555564,8197.222222222244,115.45383411580626,8
1116,32,3,1,191,0.015625,0.005208333333333333,0.9947916666666666,192,6350,4600,1750,0.7244094488188977,81,46,35,258.70605597144595,0.480632362565445,0.8133219286812379,0.14846571934748043,1044333.2185568433,9285.065618561603,1053618.284175405,1096,0,242.79166666666666,60,132,36,37.90898001470491,0.5302734375,44.518442622950836,8175.4098360656035,136.25683060109338,8
1117,32,5,6,190,0.025510204081632654,0.030612244897959183,0.9693877551020408,196,6700,4800,1900,0.7164179104477612,86,48,38,227.05802980428004,0.4814565890458748,0.7908954131061763,0.13350611609109436,1051808.0251479298,1864.29158448393,1053672.3167324136,1097,0,238.66836734693877,64,132,41,37.78413234160468,0.538531037414966,43.60576923076923,8204.61538461539,128.19711538461547,8
1118,32,1,3,188,0.005235602094240838,0.015706806282722512,0.9842931937172775,191,4600,3000,1600,0.6521739130434783,62,30,32,231.97566977943495,0.48042504822265086,0.7880997239022025,0.13394568853781066,1046233.1532643684,5740.127294790411,1051973.280559159,1098,0,245.48167539267016,67,124,43,38.354212843706954,0.5369219022687609,44.28615196078431,8182.843137254894,122.13198712320737,8
1119,32,2,3,187,0.010526315789473684,0.015789473684210527,0.9842105263157894,190,6850,5200,1650,0.7591240875912408,85,52,33,224.85468067693304,0.48056831894551194,0.7789219991023151,0.12875436810736454,1043647.9855371868,2083.8269054175325,1045731.8124426043,1099,0,244.34736842105264,65,125,41,38.85953528612033,0.5361842105263157,44.60227272727271,8172.7272727272475,125.73426573426535,7
1120,32,2,2,187,0.010582010582010581,0.010582010582010581,0.9894179894179894,189,5450,3600,1850,0.6605504587155964,73,36,37,219.41234581387073,0.4805011445082367,0.7719559477008275,0.12669293516349286,1046236.7346938753,2661.451247165339,1048898.1859410407,1100,0,243.2010582010582,69,120,45,38.67502715704532,0.5384149029982364,44.28571428571428,8182.857142857125,118.59213250517573,0
1121,32,1,1,187,0.005319148936170213,0.005319148936170213,0.9946808510638298,188,6500,4500,2000,0.6923076923076923,85,45,40,224.15121448074598,0.4802872672279744,0.7730972283325988,0.1303058083157899,1048317.7096014989,2896.3375537702605,1051214.0471552692,1101,0,245.13297872340425,73,115,37,38.29396722393313,0.5413896276595744,44.03153153153155,8190.990990991035,112.20535604097307,0
1122,32,3,1,189,0.015789473684210527,0.005263157894736842,0.9947368421052631,190,5900,4000,1900,0.6779661016949152,78,40,38,231.886197272983,0.480269539589715,0.7854257874581614,0.13234379205880895,1042624.2644641717,4454.035174227727,1047078.2996383994,1102,0,243.53157894736842,64,126,39,38.808148659677315,0.534155701754386,44.727564102564116,8168.717948717976,127.63621794871837,8
1123,32,1,1,189,0.005263157894736842,0.005263157894736842,0.9947368421052631,190,6600,5400,1200,0.8181818181818182,78,54,24,219.4846934560816,0.47990056158915806,0.768089792898135,0.12396933239804721,1039380.2500000001,1025.6111111110722,1040405.8611111112,1103,0,244.52105263157895,74,116,34,39.530883875538116,0.5304276315789473,45.125,8156.000000000001,110.21621621621622,7
1124,32,2,0,191,0.010471204188481676,0.0,1.0,191,6400,4600,1800,0.71875,82,46,36,248.764637049883,0.4800186001653348,0.7962542609722694,0.13801006009988648,1033745.5952031023,6831.869558523036,1040577.4647616254,1104,0,244.20942408376965,62,129,38,39.49361976625686,0.524923647469459,45.81679894179894,8133.862433862438,131.1913295784264,8
1125,32,1,1,191,0.005208333333333333,0.005208333333333333,0.9947916666666666,192,6550,4500,2050,0.6870229007633588,86,45,41,238.56583582292268,0.48000518106457246,0.7821312133005598,0.13265129959994348,1034458.5069444401,4407.291666666353,1038865.7986111065,1105,0,243.93229166666666,69,123,30,39.6631332787109,0.5275607638888888,45.72916666666665,8136.666666666632,117.92270531400916,7
1126,32,5,5,191,0.025510204081632654,0.025510204081632654,0.9744897959183674,196,5800,3600,2200,0.6206896551724138,80,36,44,217.4094127446892,0.4806258721437293,0.7787380258225733,0.12387280493592778,1042100.6944444462,312.5000000000582,1042413.1944444464,1106,0,238.30612244897958,82,114,40,39.24319727891154,0.5331101190476191,44.79166666666667,8166.6666666666815,99.59349593495953,8
1127,32,1,1,191,0.005208333333333333,0.005208333333333333,0.9947916666666666,192,7900,5900,2000,0.7468354430379747,99,59,40,229.96752989284732,0.4800966450334497,0.7800903561429724,0.13342241711899835,1047707.7241227385,1887.7514732325762,1049595.475595971,1107,0,244.140625,78,114,35,38.22128183988596,0.5421549479166667,44.106012658227854,8188.607594936722,104.9821486530349,8
1128,32,1,3,189,0.005208333333333333,0.015625,0.984375,192,5350,3700,1650,0.6915887850467289,70,37,33,237.07877462439308,0.479613192626527,0.7837502224538557,0.13823386482472458,1049237.4376085117,6000.385199653006,1055237.8228081646,1108,0,245.13541666666666,79,113,36,37.8481402857579,0.5437282986111112,43.91927083333335,8194.583333333372,103.728902953587,0
1129,32,1,1,189,0.005263157894736842,0.005263157894736842,0.9947368421052631,190,5650,4200,1450,0.7433628318584071,71,42,29,233.2211091613454,0.47907848324514996,0.7799991683028331,0.13697198651739695,1051455.60391482,5394.328435785133,1056849.932350605,1109,0,248.1157894736842,71,119,36,37.670074025998424,0.5461622807017543,43.64872685185184,8203.240740740714,115.53860198226357,0
1130,32,6,3,192,0.03076923076923077,0.015384615384615385,0.9846153846153847,195,6000,4200,1800,0.7,78,42,36,224.82549415427096,0.4795136135342321,0.7778757043227196,0.1335867883255283,1055004.5545806165,2438.3840637191424,1057442.9386443356,1110,0,242.53333333333333,81,114,43,37.44331486428551,0.5498931623931624,43.21646341463418,8217.073170731785,101.44534778681215,0
1131,32,2,2,192,0.010309278350515464,0.010309278350515464,0.9896907216494846,194,5250,4000,1250,0.7619047619047619,65,40,25,226.39624896883086,0.47942039242917933,0.7781495238388998,0.1351983593986205,1056531.094497989,3788.935342655858,1060320.0298406447,1111,0,244.38144329896906,83,111,35,37.21306662806035,0.5518685567010309,43.03075396825398,8223.01587301591,99.07248039778204,0
1132,32,0,3,189,0.0,0.015625,0.984375,192,6500,5100,1400,0.7846153846153846,79,51,28,253.1072701344063,0.47898317062972656,0.7971344941530496,0.1503694311572421,1054960.449315605,8503.631885207593,1063464.0812008125,1112,1,247.640625,70,122,38,36.72258884698888,0.5496419270833333,43.22183098591547,8216.901408450649,117.38430583500927,8
1133,32,3,3,189,0.015625,0.015625,0.984375,192,5950,3400,2550,0.5714285714285714,85,34,51,252.05970028479214,0.47908656468150085,0.8108985881657857,0.1440024676713003,1042937.6110439254,8226.508331093833,1051164.1193750193,1113,0,248.41145833333334,60,132,34,38.25385147035872,0.5335828993055556,44.689207650273225,8169.945355191261,136.16575591985435,8
1134,32,5,1,193,0.02577319587628866,0.005154639175257732,0.9948453608247423,194,6550,4500,2050,0.6870229007633588,86,45,41,247.35418801518395,0.4795294499937681,0.8058628266928525,0.14210452124857398,1044667.8599423275,6330.594048318728,1050998.4539906462,1114,0,246.43298969072166,62,132,38,38.15705750399033,0.5374785223367697,44.477513227513214,8176.71957671955,131.88257381805727,8
1135,32,2,3,192,0.010256410256410256,0.015384615384615385,0.9846153846153847,195,6200,4100,2100,0.6612903225806451,83,41,42,245.6342933491396,0.4797559256322143,0.799584845701957,0.13733970820125138,1036201.4665852203,5705.323002400542,1041906.7895876209,1115,0,246.01538461538462,71,124,38,39.264023119196494,0.5290598290598291,45.5150462962963,8143.5185185185255,114.69744392279614,8
1136,32,3,0,195,0.015384615384615385,0.0,1.0,195,5800,3700,2100,0.6379310344827587,79,37,42,237.9017723118085,0.47984514054101685,0.7932355507994029,0.1340234543209179,1038568.3393536465,4615.44971983279,1043183.7890734792,1116,0,246.77435897435896,76,119,41,39.163414396714984,0.531784188034188,45.224567099567096,8152.8138528138425,107.27386648439267,0
1137,32,5,5,195,0.025,0.025,0.975,200,5500,3800,1700,0.6909090909090909,72,38,34,209.6498224564472,0.48010573701842546,0.7764022988505757,0.11843853606305693,1039443.969726554,-1916.151258681074,1037527.8184678729,1117,0,241.58,79,121,37,39.77357386121749,0.5344791666666666,45.11718749999997,8156.249999999933,103.2436708860751,8
1138,32,3,0,198,0.015151515151515152,0.0,1.0,198,6050,3800,2250,0.628099173553719,83,38,45,209.85047651011186,0.47978302483378626,0.7821503129590419,0.11688607236053553,1035002.5409333955,-2210.8447191899654,1032791.6962142056,1118,0,243.27272727272728,66,132,41,40.32502496077591,0.5267255892255892,45.66231343283583,8138.805970149277,123.31524197195874,8
1139,32,0,1,197,0.0,0.005050505050505051,0.9949494949494949,198,5900,3800,2100,0.6440677966101694,80,38,42,210.12074535818846,0.47966338512023793,0.7697983404052413,0.11642074704351582,1033337.8316857517,-2074.8569198748037,1031262.9747658769,1119,1,244.27272727272728,92,106,36,40.52707259024199,0.5291456228956228,45.86693548387099,8132.25806451619,88.39410939691511,8
1140,32,3,3,197,0.015,0.015,0.985,200,6750,5100,1650,0.7555555555555555,84,51,33,177.43699300496428,0.47988484087102173,0.7438810859216671,0.09806409691550717,1032540.1881394855,-10107.834771949869,1022432.3533675356,1120,0,242.8,86,114,42,41.457518342209845,0.5273958333333333,45.96503831417624,8129.118773946348,94.52463690635288,7
1141,32,6,2,201,0.029556650246305417,0.009852216748768473,0.9901477832512315,203,6200,4000,2200,0.6451612903225806,84,40,44,185.94991379529682,0.48103021509047456,0.7618576673522648,0.10330487213340098,1034183.6378185651,-8338.728339826092,1025844.909478739,1121,0,236.96059113300493,73,130,44,41.0354147057195,0.5259133825944171,45.76295045045046,8135.585585585612,111.4463778847344,8
1142,32,3,2,202,0.014705882352941176,0.00980392156862745,0.9901960784313726,204,6250,4500,1750,0.72,80,45,35,188.26857578411045,0.48116739511896717,0.7597913698177605,0.10464903157803294,1034352.5634765554,-8102.783203125262,1026249.7802734302,1122,0,234.2941176470588,79,125,37,40.9553118758642,0.5289522058823529,45.74218749999998,8136.249999999944,102.99050632911322,8
1143,32,3,4,201,0.014634146341463415,0.01951219512195122,0.9804878048780488,205,6400,4200,2200,0.65625,86,42,44,186.0159930107731,0.4814243583612307,0.7571172923827314,0.10245053193620199,1031444.9345742508,-9026.949251847444,1022417.9853224034,1123,0,233.8780487804878,85,120,38,41.37685653404575,0.5237296747967479,46.09980620155041,8124.806201550439,95.58595531235811,7
1144,32,4,4,201,0.01951219512195122,0.01951219512195122,0.9804878048780488,205,6350,4200,2150,0.6614173228346457,85,42,43,195.1499657528851,0.481694364737765,0.769613985848125,0.10750672220493748,1031520.2628325613,-7089.771206963747,1024430.4916255976,1124,0,234.6341463414634,80,125,40,41.13549263911401,0.5266260162601626,46.090534979423865,8125.1028806584245,101.56378600823031,8
1145,32,5,4,202,0.024271844660194174,0.019417475728155338,0.9805825242718447,206,6200,4100,2100,0.6612903225806451,83,41,42,204.64950198546398,0.4816500907727524,0.7805607041892151,0.11323118796654078,1032896.7098312955,-5123.640546120097,1027773.0692851754,1125,0,233.7233009708738,82,124,38,40.72147443813286,0.5214401294498382,45.92118473895583,8130.522088353434,99.15270839455407,8
1146,32,2,2,202,0.00980392156862745,0.00980392156862745,0.9901960784313726,204,6800,5000,1800,0.7352941176470589,86,50,36,215.58625049339224,0.48151049212788566,0.7912026292208625,0.11631092809926803,1024865.3223675513,-3410.6255780156407,1021454.6967895356,1126,0,236.59803921568627,86,118,40,41.45466695051565,0.5133272058823529,46.910919540229884,8098.850574712639,94.17268110130976,8
1147,32,4,3,203,0.019417475728155338,0.014563106796116505,0.9854368932038835,206,5250,3900,1350,0.7428571428571429,66,39,27,209.3332572977003,0.4818336095982319,0.7874496789314871,0.11385295555804896,1027447.7076247087,-3434.204931973206,1024013.5026927354,1127,0,235.20873786407768,69,137,41,41.28759518077005,0.5154733009708738,46.59226190476188,8109.047619047556,117.52242926155877,0
1148,32,5,5,203,0.02403846153846154,0.02403846153846154,0.9759615384615384,208,7750,6100,1650,0.7870967741935484,94,61,33,207.54672255861442,0.4822866344605475,0.7875944697757395,0.11434615578113422,1031548.3948106162,-6531.102299291355,1025017.2925113247,1128,0,233.85096153846155,77,131,41,40.81719306088815,0.518729967948718,46.087072649572654,8125.213675213689,105.5222555222557,0
1149,32,6,4,205,0.028708133971291867,0.019138755980861243,0.9808612440191388,209,6150,4200,1950,0.6829268292682927,81,42,39,219.53879408906766,0.4823957566556251,0.7952738037780966,0.1215790701058769,1033182.1823425738,-2585.2859228400102,1030596.8964197338,1129,0,231.5071770334928,78,131,36,40.3072895046354,0.5188397129186603,45.88607594936709,8131.645569620257,104.25186627718278,7
1150,32,7,2,210,0.0330188679245283,0.009433962264150943,0.9905660377358491,212,6800,4400,2400,0.6470588235294118,92,44,48,216.42289478909575,0.4828622872514829,0.7956347675835784,0.12197474669449987,1038700.6944444473,-4240.277777777679,1034460.4166666697,1130,0,225.81603773584905,74,138,40,39.69405832651948,0.5235357704402516,45.20833333333334,8153.333333333356,110.18018018018049,0
1151,32,4,3,211,0.018691588785046728,0.014018691588785047,0.985981308411215,214,7300,5000,2300,0.684931506849315,96,50,46,214.04174423875776,0.482451954718968,0.7962372134851448,0.12223238248663865,1042809.7270447578,-5459.037422839185,1037350.6896219186,1131,0,224.65887850467288,71,143,37,39.24047942876575,0.5270638629283488,44.70486111111113,8169.4444444444825,115.06259780907722,0
1152,32,1,6,206,0.0047169811320754715,0.02830188679245283,0.9716981132075472,212,6600,4900,1700,0.7424242424242424,83,49,34,228.3151427223062,0.4824142485618051,0.8070956175386286,0.1319375939080551,1046480.2862811805,-1214.540816326471,1045265.745464854,1132,0,227.70283018867926,69,143,45,38.416928507700064,0.5339524371069182,44.25595238095239,8183.809523809534,118.6059351276744,8
1153,32,5,1,210,0.023696682464454975,0.004739336492890996,0.995260663507109,211,7450,5800,1650,0.7785234899328859,91,58,33,197.4246762937481,0.48263935906116,0.7766840391183754,0.11227441759123179,1041514.0911943393,-8525.883538116303,1032988.207656223,1133,0,228.53554502369667,86,125,42,39.82648176826688,0.5338171406003159,44.86350574712642,8164.367816091906,94.93450948944077,8
1154,32,1,1,210,0.004739336492890996,0.004739336492890996,0.995260663507109,211,6550,4600,1950,0.7022900763358778,85,46,39,189.9286044197243,0.4825236966824644,0.7684099444505081,0.1089882009865243,1044311.4616714518,-9081.076301043438,1035230.3853704084,1134,0,229.5165876777251,76,135,44,39.66882887653342,0.5359893364928909,44.52110389610392,8175.324675324726,107.5700615174306,0
1155,32,4,3,211,0.018691588785046728,0.014018691588785047,0.985981308411215,214,6250,4300,1950,0.688,82,43,39,186.55930969263486,0.48241356237111144,0.7674533913749104,0.10807080216210235,1047231.6600740368,-9975.836881662817,1037255.823192374,1135,0,227.2710280373832,82,132,39,39.3913007930668,0.5387461059190031,44.16415662650604,8186.746987951853,99.83837790185187,0
1156,32,3,1,213,0.014018691588785047,0.004672897196261682,0.9953271028037384,214,7000,4800,2200,0.6857142857142857,92,48,44,210.3605898369303,0.48215030055723745,0.7935918274906255,0.1212498677885796,1045685.643659591,-5805.790243151571,1039879.8534164394,1136,0,228.16822429906543,75,139,44,38.975266280649116,0.5347546728971962,44.35307017543861,8180.701754385992,109.07602339181322,8
1157,32,1,6,208,0.004672897196261682,0.028037383177570093,0.9719626168224299,214,7550,5800,1750,0.7682119205298014,93,58,35,210.96445725035568,0.48182168034165535,0.7954422879860694,0.12244013715056598,1047815.6990510842,-6139.625950256939,1041676.0731008273,1137,0,229.14953271028037,78,136,37,38.69409521846664,0.5368477414330218,44.09282700421943,8189.029535865028,104.98755815211575,0
1158,32,2,5,205,0.009523809523809525,0.023809523809523808,0.9761904761904762,210,7350,5200,2150,0.7074829931972789,95,52,43,210.3401185261966,0.48140047087415505,0.7925091111788192,0.12274000375127836,1049479.4790840487,-5200.472395729759,1044279.0066883189,1138,0,232.53809523809525,81,129,41,38.502709439015945,0.5393849206349206,43.88973577235774,8195.528455284591,101.17936364548878,0
1159,32,1,3,203,0.0048543689320388345,0.014563106796116505,0.9854368932038835,206,7650,5400,2250,0.7058823529411765,99,54,45,215.17626821626496,0.4813555726576683,0.7948813403876587,0.12647226033367953,1051692.979600696,-3590.1258680554974,1048102.8537326404,1139,0,234.35922330097088,63,143,42,38.10309801929914,0.5417172330097088,43.61979166666667,8204.166666666679,130.22486772486792,0
1160,32,1,2,202,0.004901960784313725,0.00980392156862745,0.9901960784313726,204,6100,4500,1600,0.7377049180327869,77,45,32,210.35486724935657,0.4811960703821758,0.7878065151924789,0.12448163514759707,1053767.6652309212,-2566.968533737021,1051200.6966971841,1140,0,233.43627450980392,67,137,43,37.96863497085099,0.5436070261437909,43.36703431372549,8212.254901960787,122.5709686859819,0
1161,32,2,2,202,0.00980392156862745,0.00980392156862745,0.9901960784313726,204,6300,4700,1600,0.746031746031746,79,47,32,204.69452531859747,0.48113268295824074,0.7823441654993355,0.12230033142395724,1056684.0579185965,-3840.5116705246373,1052843.5462480718,1141,0,234.06372549019608,71,133,41,37.75175223779765,0.5465686274509804,43.01215277777778,8223.611111111117,115.82550860719883,0
1162,32,0,0,202,0.0,0.0,1.0,202,6950,4700,2250,0.6762589928057554,92,47,45,221.82874395740427,0.48064853127103757,0.7934361786584869,0.13056074306515847,1052111.0323461469,-672.3062381852469,1051438.7261079617,1142,1,236.44059405940595,68,134,42,37.88046037913574,0.5448638613861386,43.56884057971015,8205.797101449283,120.67348678601887,8
1163,32,3,2,203,0.014634146341463415,0.00975609756097561,0.9902439024390244,205,6450,4600,1850,0.7131782945736435,83,46,37,217.10941380582676,0.480648214570381,0.7920753148564759,0.1288368383371012,1054614.8919753076,-1656.6358024692336,1052958.2561728384,1143,0,233.9658536585366,74,131,43,37.689906230276804,0.5473069105691057,43.263888888888886,8215.555555555547,111.02102102102091,0
1164,32,1,1,203,0.004901960784313725,0.004901960784313725,0.9950980392156863,204,6400,4100,2300,0.640625,87,41,46,218.29845048326246,0.4806447004088992,0.793409491824413,0.1300788704941497,1055870.4197530826,-1101.0246913582005,1054769.3950617244,1144,0,233.9656862745098,74,130,40,37.50326647202997,0.5485089869281046,43.1111111111111,8220.444444444414,111.08708708708669,0
1165,32,3,2,204,0.014563106796116505,0.009708737864077669,0.9902912621359223,206,7100,5400,1700,0.7605633802816901,88,54,34,221.99627020635694,0.4807443365695793,0.8019018663017425,0.1338640174365586,1059465.239518949,-1260.533682701578,1058204.7058362474,1145,0,230.8398058252427,60,146,44,36.96164310836816,0.5513754045307444,42.67418032786886,8234.426229508215,137.24043715847026,0
1166,32,1,1,204,0.004878048780487805,0.004878048780487805,0.9951219512195122,205,6200,4100,2100,0.6612903225806451,83,41,42,223.71898816259468,0.4802875418460067,0.8027257999318869,0.13552241946956256,1060844.6243785429,266.21719273913277,1061110.8415712821,1146,0,232.89268292682928,61,144,44,36.74610683370309,0.5527947154471544,42.506720430107535,8239.784946236574,135.0784417415832,0
1167,32,0,2,202,0.0,0.00980392156862745,0.9901960784313726,204,7250,5300,1950,0.7310344827586207,92,53,39,221.0580718320759,0.4800440291058952,0.7987504318647576,0.13448510889872092,1062130.2071730888,-1091.508873542743,1061038.698299546,1147,1,234.86274509803923,66,138,45,36.65520154477433,0.5549428104575164,42.350746268656714,8244.776119402977,124.9208502939845,0
1168,32,2,1,203,0.00980392156862745,0.004901960784313725,0.9950980392156863,204,6700,4200,2500,0.6268656716417911,92,42,50,212.331242188692,0.4798106024018803,0.7889745824255636,0.1277393836696668,1058765.7086555548,-2538.1923788753397,1056227.5162766795,1148,0,235.6421568627451,81,123,42,37.29711934156377,0.5534109477124183,42.75914634146339,8231.707317073113,101.62601626016189,8
1169,32,1,2,202,0.004901960784313725,0.00980392156862745,0.9901960784313726,204,6200,3900,2300,0.6290322580645161,85,39,46,197.56367975664523,0.47939254724878455,0.7745299335669418,0.11809106022049223,1056815.5616391539,-5242.325763696823,1051573.235875457,1149,0,236.26470588235293,75,129,44,37.91869989156133,0.5506025326797386,42.99616228070174,8224.12280701751,109.65497076023345,8
1170,32,1,4,199,0.0049261083743842365,0.019704433497536946,0.9802955665024631,203,5900,3900,2000,0.6610169491525424,79,39,40,189.27236939619002,0.479542627908111,0.7629798690738123,0.11071427405139261,1050223.077662444,-6744.357939253756,1043478.7197231902,1150,0,237.60591133004925,84,119,43,38.94984294779811,0.5454638752052545,43.79901960784316,8198.43137254907,97.60037348272702,8
1171,32,1,1,199,0.005,0.005,0.995,200,6300,4600,1700,0.7301587301587301,80,46,34,187.10070273792982,0.47917661222780566,0.7567227943222941,0.10988114170274196,1051444.2235618413,-6954.809376368881,1044489.4141854724,1151,0,240.845,72,128,43,38.853789776417074,0.5475520833333334,43.6501141552511,8203.196347031877,113.93328259766496,0
1172,32,0,2,197,0.0,0.010050251256281407,0.9899497487437185,199,5500,3500,2000,0.6363636363636364,75,35,40,186.54455344125233,0.47865379083972054,0.7553664388263026,0.10989070006553883,1052380.87000374,-6036.816111007611,1046344.0538927325,1152,1,242.94472361809045,72,127,45,38.75176190211239,0.5489426298157454,43.53595890410954,8206.84931506839,113.98401826483875,0
1173,32,1,2,196,0.005050505050505051,0.010101010101010102,0.98989898989899,198,6000,4100,1900,0.6833333333333333,79,41,38,184.56266157477455,0.47871000615289955,0.7507352623688337,0.10935885054707835,1054158.5216049273,-6688.339506173477,1047470.1820987538,1153,0,245.06565656565655,74,124,44,38.58207979366193,0.5506628787878788,43.31944444444441,8213.77777777769,110.99699699699582,0
1174,32,2,3,195,0.010101010101010102,0.015151515151515152,0.9848484848484849,198,6200,4400,1800,0.7096774193548387,80,44,36,181.13456827392767,0.47852520552393646,0.7467715458204536,0.10813559504060208,1056436.9686655223,-7528.549154431232,1048908.419511091,1154,0,245.59595959595958,77,121,43,38.387806853420635,0.5536090067340067,43.042200854700816,8222.649572649478,106.78765678765555,0
1175,32,1,3,193,0.00510204081632653,0.015306122448979591,0.9846938775510204,196,6350,4300,2050,0.6771653543307087,84,43,41,180.88932865231013,0.4781898656898657,0.744561302517667,0.10847317257507255,1057790.8230251637,-7281.3856336810895,1050509.4373914825,1155,0,248.67857142857142,79,117,46,38.226534410290164,0.5553784013605443,42.877604166666636,8227.916666666588,104.15084388185554,0
1176,32,0,2,191,0.0,0.010362694300518135,0.9896373056994818,193,5950,3900,2050,0.6554621848739496,80,39,41,221.42801326337397,0.4779714036413356,0.7822136055118805,0.13190427183213915,1055779.7090344194,2205.8406830546774,1057985.549717474,1156,1,253.22797927461139,72,121,37,37.43415083509237,0.5526230569948187,43.122146118721446,8220.09132420088,114.16793505834555,8
1177,32,1,1,191,0.005208333333333333,0.005208333333333333,0.9947916666666666,192,6500,4600,1900,0.7076923076923077,84,46,38,223.9602072516628,0.477652114237929,0.7857861314659425,0.12846964837669944,1044197.662139138,1871.7449648765642,1046069.4071040145,1157,0,255.32291666666666,68,124,41,38.81362526100145,0.5384114583333333,44.535024154589365,8174.879227053126,120.21881216254597,8
1178,32,1,1,191,0.005208333333333333,0.005208333333333333,0.9947916666666666,192,5800,4000,1800,0.6896551724137931,76,40,36,222.51179171919713,0.47772255853694007,0.7852175139622062,0.1284084604662969,1046058.3768652601,2352.064735832822,1048410.4416010929,1158,0,256.21875,70,122,41,38.618052367837194,0.5403645833333333,44.3075117370892,8182.159624413143,116.88799463447347,0
1179,32,1,2,190,0.005208333333333333,0.010416666666666666,0.9895833333333334,192,6950,4700,2250,0.6762589928057554,92,47,45,274.88068283325487,0.4775015679537522,0.8200440499613526,0.158181439441975,1045183.0709555399,12110.127246003272,1057293.1982015432,1159,0,257.0416666666667,57,135,32,37.38896013397981,0.5361870659722222,44.414511494252864,8178.735632183889,143.48659003831384,8
1180,32,2,3,189,0.010416666666666666,0.015625,0.984375,192,6350,4900,1450,0.7716535433070866,78,49,29,267.8513842115152,0.47784754035776617,0.8156540351093562,0.15556869793602987,1048038.2103867014,11393.697071727727,1059431.9074584292,1160,0,257.0989583333333,65,127,31,37.21041975004114,0.5396050347222222,44.06565656565659,8189.8989898990385,125.99844599844674,0
1181,32,1,4,186,0.005263157894736842,0.021052631578947368,0.9789473684210527,190,6450,4400,2050,0.6821705426356589,85,44,41,258.9512751880442,0.47782535041306967,0.8089309828336668,0.14926046529829803,1045692.6515367327,9706.689114040972,1055399.3406507736,1161,0,256.67894736842106,63,127,36,37.732181511428024,0.537719298245614,44.35221354166668,8180.7291666666915,129.85284391534432,8
1182,32,2,3,185,0.010638297872340425,0.015957446808510637,0.9840425531914894,188,6300,4800,1500,0.7619047619047619,78,48,30,228.71018130301786,0.47753465506125076,0.7860640859102148,0.13189306610635768,1045841.9461343243,3938.9402229365055,1049780.8863572609,1162,0,259.8351063829787,65,123,39,38.48662211659155,0.5413342198581561,44.33396464646465,8181.313131313142,125.86635586635603,8
1183,32,2,2,185,0.0106951871657754,0.0106951871657754,0.9893048128342246,187,5650,4000,1650,0.7079646017699115,73,40,33,212.97922419112618,0.47765726525214186,0.7735749064179518,0.12175809038526089,1043147.9659763336,1383.768902038254,1044531.7348783718,1163,0,258.40106951871655,64,123,41,39.225323751542916,0.5357063279857397,44.66346153846155,8170.769230769249,127.66826923076951,8
1184,32,4,5,184,0.021164021164021163,0.026455026455026454,0.9735449735449735,189,4800,3200,1600,0.6666666666666666,64,32,32,203.63478515966582,0.47815466809261137,0.7645218697077247,0.1188115677948713,1049438.992305381,140.45674725633944,1049579.4490526374,1164,0,255.79365079365078,71,118,40,38.67948066131886,0.5428240740740741,43.89467592592592,8195.370370370347,115.427751695357,6
1185,32,3,1,186,0.016042780748663103,0.0053475935828877,0.9946524064171123,187,7700,5800,1900,0.7532467532467533,96,58,38,225.40572603356833,0.4773865313476319,0.7838762794374994,0.1297364101230376,1045244.0869493721,2020.800460223359,1047264.8874095954,1165,0,259.3101604278075,64,123,40,38.645839864568295,0.5379344919786097,44.40705128205127,8178.974358974333,127.79647435897395,8
1186,32,1,2,185,0.0053475935828877,0.0106951871657754,0.9893048128342246,187,5600,3900,1700,0.6964285714285714,73,39,34,225.69095245507333,0.4774176777260269,0.7851784895439868,0.13075233521432197,1047262.7952504811,4271.547546168539,1051534.3427966496,1166,0,260.28877005347596,65,122,35,38.386284186716004,0.5399955436720143,44.16035353535352,8186.868686868659,125.95182595182553,0
1187,32,2,1,186,0.0106951871657754,0.0053475935828877,0.9946524064171123,187,6100,4200,1900,0.6885245901639344,80,42,38,222.61773758622036,0.4773865313476319,0.7814771980509094,0.12982935548170588,1049302.0599142527,3218.6501245340896,1052520.7100387868,1167,0,257.1016042780749,70,117,38,38.21039816671442,0.5427807486631016,43.9113849765258,8194.835680751128,117.06908115358755,0
1188,32,2,1,187,0.010638297872340425,0.005319148936170213,0.9946808510638298,188,5700,3700,2000,0.6491228070175439,77,37,40,220.49011839959226,0.4774694694125232,0.780890785185826,0.12936953742759927,1051158.921983502,3054.0310329857925,1054212.9530164879,1168,0,255.72340425531914,63,125,40,38.033401066802135,0.5453235815602837,43.684895833333314,8202.083333333296,130.19179894179834,0
1189,32,3,2,188,0.015789473684210527,0.010526315789473684,0.9894736842105263,190,5000,3500,1500,0.7,65,35,30,191.1484003042093,0.4779761904761905,0.7524992870939013,0.10964850402583352,1044199.3527293039,-3080.59282542046,1041118.7599038834,1169,0,251.47368421052633,72,118,42,39.65164125193171,0.5412280701754386,44.534817351598186,8174.885844748882,113.5400811770678,8
1190,32,4,4,188,0.020833333333333332,0.020833333333333332,0.9791666666666666,192,6450,5100,1350,0.7906976744186046,78,51,27,182.54210764873835,0.47790719077225136,0.7437550373292605,0.10562708997818822,1046891.3438585149,-6629.649522569047,1040261.6943359459,1170,0,249.48958333333334,79,113,44,39.53640663442777,0.5439995659722222,44.20572916666669,8185.41666666673,103.61286919831304,0
1191,32,3,2,189,0.015706806282722512,0.010471204188481676,0.9895287958115183,191,5900,4000,1900,0.6779661016949152,78,40,38,208.34223797905855,0.4783296592266005,0.7638467897492425,0.11928692819415265,1043616.1803340279,-614.133879610119,1043002.0464544178,1171,0,247.03141361256544,72,119,41,39.28523205572319,0.5422665794066317,44.60616438356167,8172.602739726079,113.50837138508443,8
1192,32,0,0,189,0.0,0.0,1.0,189,6100,4600,1500,0.7540983606557377,76,46,30,213.25441253878276,0.4782320631168149,0.7644450605152999,0.12089714486727458,1040536.7861048648,479.81220915692575,1041016.5983140217,1172,1,250.0,86,103,35,39.54489256146611,0.5410604056437389,44.9832375478927,8160.536398467375,94.88995812171366,8
1193,32,1,1,189,0.005263157894736842,0.005263157894736842,0.9947368421052631,190,6700,4900,1800,0.7313432835820896,85,49,36,214.36457562757747,0.47802144249512674,0.7702875708641654,0.12227917661536383,1042460.1737970876,-6.693447067252237,1042453.4803500203,1173,0,249.67894736842106,70,120,39,39.27594646894281,0.5433114035087719,44.74765258215963,8168.075117370903,116.6867873910129,0
1194,32,5,2,192,0.02577319587628866,0.010309278350515464,0.9896907216494846,194,5950,4000,1950,0.6722689075630253,79,40,39,203.07847414691201,0.47854014208642703,0.7633357286973816,0.11736919203079613,1046520.3671064144,-2244.8481368725215,1044275.5189695419,1174,0,243.81443298969072,78,116,43,39.057344297793364,0.5468213058419245,44.251054852320685,8183.966244725765,104.92264416315084,0
1195,32,1,3,190,0.0051813471502590676,0.015544041450777202,0.9844559585492227,193,6100,4300,1800,0.7049180327868853,79,43,36,209.1179921157385,0.47812994746689697,0.7684069264209747,0.12118216857088142,1047342.311801452,-896.3757396446399,1046445.9360618073,1175,0,245.98445595854923,77,116,37,38.800370602359315,0.548089378238342,44.15064102564104,8187.179487179531,106.3270063270069,0
1196,32,0,5,185,0.0,0.02631578947368421,0.9736842105263158,190,5700,3600,2100,0.631578947368421,78,36,42,212.1918536111437,0.477862480274761,0.7683982915824281,0.12320918412783001,1047957.4245876784,773.6056857641488,1048731.0302734426,1176,2,250.6157894736842,79,111,38,38.645011871449185,0.5494517543859649,44.07552083333335,8189.583333333371,103.66561181434648,0
1197,32,1,2,184,0.005376344086021506,0.010752688172043012,0.989247311827957,186,6150,4500,1650,0.7317073170731707,78,45,33,219.2731183483391,0.47738000096871064,0.773520738698636,0.1279526870917766,1049479.4790840487,2674.5276042701876,1052154.006688319,1177,0,254.5,81,105,40,38.2739261445365,0.5513552867383513,43.88973577235774,8195.528455284591,101.17936364548878,0
1198,32,0,1,183,0.0,0.005434782608695652,0.9945652173913043,184,6050,4500,1550,0.743801652892562,76,45,31,219.98291899239567,0.4768056545497743,0.7725048464761426,0.12890241325054633,1050756.4143655521,3379.692636423637,1054136.1070019759,1178,1,256.2880434782609,64,120,43,38.09655952306506,0.5534420289855073,43.73397435897437,8200.512820512846,128.13301282051322,0
1199,32,0,2,181,0.0,0.01092896174863388,0.9890710382513661,183,5450,3700,1750,0.6788990825688074,72,37,35,240.0127657302125,0.47654576752937405,0.786962570655493,0.136701629185584,1041987.2716049427,7968.049382716286,1049955.320987659,1179,2,258.1256830601093,74,109,39,38.680563114545926,0.53716985428051,44.80555555555557,8166.222222222258,110.35435435435484,8
1200,32,3,2,182,0.016304347826086956,0.010869565217391304,0.9891304347826086,184,6600,4900,1700,0.7424242424242424,83,49,34,229.43254064431602,0.4767771937118872,0.7778732842910037,0.13188649218148005,1044850.9040105176,4544.559500328564,1049395.4635108463,1180,0,256.2173913043478,64,120,40,38.59209728667584,0.5408740942028986,44.4551282051282,8177.435897435884,127.77243589743568,0
1201,32,1,2,181,0.00546448087431694,0.01092896174863388,0.9890710382513661,183,6150,4500,1650,0.7317073170731707,78,45,33,216.75690973557172,0.47681223603354755,0.7663487981713628,0.12282891551682393,1040400.0000000003,2352.777777777769,1042752.7777777781,1181,0,258.26229508196724,74,109,39,39.4726988017429,0.535462204007286,45.0,8160.000000000003,110.2702702702703,8
1202,32,2,1,182,0.01092896174863388,0.00546448087431694,0.994535519125683,183,6150,4200,1950,0.6829268292682927,81,42,39,219.74719758602487,0.47731139534418227,0.772157836092263,0.12343824061931087,1037661.5059033245,2854.641593030221,1040516.1474963546,1182,0,259.08196721311475,66,117,44,39.73964692714696,0.5318192167577414,45.33582089552241,8149.253731343325,123.47354138398977,8
1203,32,4,2,184,0.021505376344086023,0.010752688172043012,0.989247311827957,186,6650,4900,1750,0.7368421052631579,84,49,35,204.81811433492283,0.4779388259226969,0.762281280899644,0.11448824341409068,1036118.498451586,-1406.8325839228696,1034711.6658676631,1183,0,255.80645161290323,70,116,41,40.31313058518306,0.529233870967742,45.52523474178404,8143.192488262912,116.33132126089875,8
1204,32,6,2,188,0.031578947368421054,0.010526315789473684,0.9894736842105263,190,5750,4400,1350,0.7652173913043478,71,44,27,223.4069137859221,0.47872981063770537,0.788378088077335,0.12728998576174658,1042100.694444446,2812.500000000096,1044913.1944444461,1184,0,251.33157894736843,67,123,38,39.09013605442175,0.5367872807017544,44.79166666666667,8166.66666666668,121.89054726368178,8
1205,32,1,2,187,0.005291005291005291,0.010582010582010581,0.9894179894179894,189,6250,4100,2150,0.656,84,41,43,225.17808287508876,0.478816043753987,0.7863688059150946,0.12718907906256677,1039390.1002648827,2759.5740273985148,1042149.6742922812,1185,0,251.56613756613757,68,121,35,39.38453868783191,0.5316909171075838,45.123792270531396,8156.038647342987,119.94174481386746,8
1206,32,3,1,189,0.015789473684210527,0.005263157894736842,0.9947368421052631,190,6250,4500,1750,0.72,80,45,35,224.29951838102212,0.4791533231226213,0.7788963219687806,0.1273631178285283,1041037.5976562502,2450.8463541666633,1043488.4440104169,1186,0,247.7736842105263,79,111,39,39.20048494129658,0.5354714912280703,44.921875,8162.500000000002,103.3227848101266,8
1207,32,4,1,192,0.02072538860103627,0.0051813471502590676,0.9948186528497409,193,5400,4000,1400,0.7407407407407407,68,40,28,215.36105880154327,0.4791936528497409,0.7729653141452144,0.12358411528150123,1044316.0067554917,981.0001876525721,1045297.0069431443,1187,0,244.56476683937825,72,121,42,39.01851541554957,0.538860103626943,44.520547945205486,8175.342465753448,113.54642313546455,0
1208,32,3,2,193,0.015384615384615385,0.010256410256410256,0.9897435897435898,195,5650,4100,1550,0.7256637168141593,72,41,31,220.6525321890527,0.47977575116750376,0.7798184011392182,0.12633522140498027,1043616.1803340266,1405.3105648342462,1045021.4908988609,1188,0,242.62051282051283,72,123,40,38.97083473013746,0.5365384615384615,44.60616438356166,8172.602739726069,113.50837138508429,8
1209,32,5,2,196,0.025252525252525252,0.010101010101010102,0.98989898989899,198,5400,3300,2100,0.6111111111111112,75,33,42,215.60508791922862,0.4803160624861132,0.7809643243835909,0.12511885810745857,1047779.7067901297,181.32716049417104,1047961.0339506238,1189,0,236.7020202020202,77,121,37,38.57982813206695,0.5402988215488216,44.09722222222224,8188.888888888938,106.34920634920698,0
1210,32,2,2,196,0.010101010101010102,0.010101010101010102,0.98989898989899,198,5650,3800,1850,0.672566371681416,75,38,37,218.05341358244812,0.48030057341605564,0.7847786862751953,0.12714780745731488,1049254.5624185032,508.7078104626671,1049763.270228966,1190,0,237.6010101010101,80,118,39,38.333207787207684,0.5419297138047139,43.91718106995886,8194.650205761343,102.43312757201679,0
1211,32,1,4,193,0.005076142131979695,0.02030456852791878,0.9796954314720813,197,6200,3700,2500,0.5967741935483871,87,37,50,217.31566250762134,0.4797990262094685,0.7837036848290273,0.12759860689131702,1051378.8116349473,96.21659938485391,1051475.028234332,1191,0,239.76142131979697,67,130,39,38.087376996932406,0.5437817258883249,43.658088235294116,8202.941176470584,122.4319578577699,0
1212,32,2,3,192,0.010256410256410256,0.015384615384615385,0.9846153846153847,195,5850,4000,1850,0.6837606837606838,77,40,37,213.6183873979469,0.4797570270508415,0.7779961698296376,0.12610841060231223,1053032.480879011,139.4200886065919,1053171.9009676178,1192,0,242.5948717948718,70,125,42,37.97633344771056,0.5455662393162393,43.45657276995304,8209.389671361476,117.27699530516394,0
1213,32,0,5,187,0.0,0.026041666666666668,0.9739583333333334,192,5650,4100,1550,0.7256637168141593,72,41,31,210.83913220527532,0.47949957278941246,0.7696430666353824,0.12309539472039567,1049639.6542159822,211.0227646288431,1049850.676980611,1193,1,246.21875,77,115,40,38.46997366911728,0.5445963541666667,43.87019230769233,8196.153846153893,106.44355644355706,8
1214,32,0,1,186,0.0,0.0053475935828877,0.9946524064171123,187,7050,5300,1750,0.75177304964539,88,53,35,220.43845710066785,0.47862639679527724,0.7734587937617508,0.12615617982578917,1043477.2721128913,1554.5039768360239,1045031.7760897273,1194,2,252.048128342246,67,120,42,38.9936741447224,0.5389928698752229,44.62316176470589,8172.058823529428,121.97102721685714,8
1215,32,3,2,187,0.015873015873015872,0.010582010582010581,0.9894179894179894,189,5250,3600,1650,0.6857142857142857,69,36,33,215.10783276265133,0.47909865285751807,0.7692581057478634,0.12411749283039442,1046012.9555230954,1951.1159808459533,1047964.0715039414,1195,0,245.33333333333334,73,116,46,38.813036776040484,0.5415564373897708,44.313063063063076,8181.98198198202,112.08194495865781,0
1216,32,3,4,186,0.015789473684210527,0.021052631578947368,0.9789473684210527,190,5700,3700,2000,0.6491228070175439,77,37,40,195.9018417835345,0.4794375986261951,0.7458502749844005,0.11182498900674943,1042675.5672480011,-2847.587198684625,1039827.9800493165,1196,0,244.30526315789473,73,117,46,39.7203267162945,0.5375548245614035,44.72128378378382,8168.9189189189965,111.90299888930132,8
1217,32,1,2,185,0.0053475935828877,0.0106951871657754,0.9893048128342246,187,5800,4200,1600,0.7241379310344828,74,42,32,191.4944199791874,0.4789618193318383,0.7347116094531645,0.10986687554328642,1044255.463979249,-3206.1811230389812,1041049.28285621,1197,0,248.59893048128342,78,109,47,39.635806451612915,0.5397727272727273,44.527953586497915,8175.1054852321295,104.8090446824632,0
1218,32,3,4,184,0.015957446808510637,0.02127659574468085,0.9787234042553191,188,6250,4200,2050,0.672,83,42,41,216.58121230887113,0.479453483521068,0.7727466801658782,0.12261148631526628,1040100.0216262911,1203.2247212607126,1041303.2463475518,1198,0,245.19148936170214,84,104,39,39.51474004646319,0.5342420212765957,45.036764705882334,8158.823529411713,97.12885154061563,8
1219,32,4,4,184,0.02127659574468085,0.02127659574468085,0.9787234042553191,188,6600,5000,1600,0.7575757575757576,82,50,32,217.40456206367747,0.47973911518185614,0.774930031886591,0.12436246761268627,1043333.9495962653,1165.1120796290375,1044499.0616758944,1199,0,245.53191489361703,68,120,43,39.08907281505569,0.5380097517730497,44.64070048309182,8171.497584541132,120.16908212560487,0
1220,32,4,0,188,0.02127659574468085,0.0,1.0,188,5200,3600,1600,0.6923076923076923,68,36,32,214.1188822308833,0.47978355994235217,0.7693940486550015,0.12361689372069043,1046188.0277777852,2001.722222222685,1048189.7500000079,1200,0,244.7712765957447,74,114,45,38.81646841562112,0.5403922872340425,44.29166666666669,8182.666666666725,110.57657657657737,0
1221,32,4,1,191,0.020833333333333332,0.005208333333333333,0.9947916666666666,192,6050,4600,1450,0.7603305785123967,75,46,29,200.41681365222533,0.48005062899941825,0.7647780521783165,0.11626194504813031,1047665.9753086473,-2456.024691357706,1045209.9506172895,1201,0,240.65104166666666,74,118,37,38.982667535099154,0.5407986111111112,44.11111111111113,8188.444444444487,110.65465465465523,8
1222,32,4,2,193,0.020512820512820513,0.010256410256410256,0.9897435897435898,195,6550,4300,2250,0.6564885496183206,88,43,45,216.88853043727633,0.48063595911534057,0.7881211261282097,0.12457977278053615,1044612.4520364902,-237.10808026508812,1044375.3439562251,1202,0,237.8820512820513,60,135,42,38.94244692463631,0.5333867521367521,44.48428961748634,8176.502732240442,136.2750455373407,8
1223,32,1,4,190,0.005154639175257732,0.020618556701030927,0.979381443298969,194,6400,4000,2400,0.625,88,40,48,217.79743620037738,0.4803735332870395,0.7835331689825182,0.1252335258152176,1044938.2716049436,316.9753086423225,1045255.2469135859,1203,0,240.05670103092783,68,126,39,38.87850996376812,0.5388208762886597,44.444444444444464,8177.777777777819,120.26143790849734,8
1224,32,5,2,193,0.02564102564102564,0.010256410256410256,0.9897435897435898,195,5550,4000,1550,0.7207207207207207,71,40,31,190.41601703442234,0.48055775839280995,0.7536244014793161,0.10869914657303173,1042691.5381998129,-4840.966060098872,1037850.572139714,1204,0,236.02564102564102,71,124,43,39.85837583829222,0.5357905982905983,44.71932870370374,8168.981481481562,115.05607720396566,8
1225,32,1,3,191,0.005154639175257732,0.015463917525773196,0.9845360824742269,194,6100,4300,1800,0.7049180327868853,79,43,36,220.31614189497984,0.4802861759521393,0.7879782918287459,0.12590525748293438,1043031.3491821286,1059.3285454643728,1044090.6777275929,1205,0,236.70103092783506,63,131,40,39.05257272476151,0.5367268041237113,44.677734375,8170.312499999997,129.68749999999994,8
1226,32,2,3,190,0.010362694300518135,0.015544041450777202,0.9844559585492227,193,5400,3500,1900,0.6481481481481481,73,35,38,219.18966558332033,0.4800527130109384,0.7859952346734247,0.1261722024576254,1045277.3446201815,1822.7983218236418,1047100.1429420051,1206,0,238.25906735751295,66,127,42,38.80056265206816,0.5394537996545768,44.40298507462686,8179.104477611931,123.92582541836259,0
1227,32,1,4,187,0.005235602094240838,0.020942408376963352,0.9790575916230366,191,6100,4500,1600,0.7377049180327869,77,45,32,206.0370369761679,0.47973270873518875,0.7648481223415142,0.1154001476489124,1036747.0477314907,-1578.342038322774,1035168.7056931679,1207,0,241.43979057591622,72,119,45,40.20334660014578,0.5292866492146597,45.448059360730596,8145.662100456626,113.13419583967536,8
1228,32,3,3,187,0.015789473684210527,0.015789473684210527,0.9842105263157894,190,5700,3900,1800,0.6842105263157895,75,39,36,213.03363018917833,0.47957451499118164,0.7676016689287681,0.12056551935571355,1040002.635351663,611.1073630554938,1040613.7427147184,1208,0,243.58947368421053,76,114,39,39.61738123032296,0.5325109649122808,45.0487012987013,8158.441558441572,107.34791524265226,0
1229,32,2,3,186,0.010582010582010581,0.015873015873015872,0.9841269841269842,189,5900,3600,2300,0.6101694915254238,82,36,46,216.39231181218162,0.4792780685954445,0.7709387323897459,0.12316541229968626,1041777.6709572887,1386.535722551499,1043164.2066798402,1209,0,245.68253968253967,78,111,42,39.30956748656469,0.5347773368606702,44.83122362869198,8165.400843881849,104.68462620361345,0
1230,32,3,1,188,0.015873015873015872,0.005291005291005291,0.9947089947089947,189,5650,4100,1550,0.7256637168141593,72,41,31,212.22964136612794,0.47921591804570524,0.7675578820968882,0.12164381883180551,1043950.8506616304,861.4629279565975,1044812.313589587,1210,0,241.85714285714286,68,121,45,39.14413416075652,0.5374779541446209,44.565217391304365,8173.913043478298,120.20460358056322,0
1231,32,4,4,188,0.020833333333333332,0.020833333333333332,0.9791666666666666,192,5550,4200,1350,0.7567567567567568,69,42,27,208.50441512981504,0.4797824861838278,0.7720125276256389,0.11654879408400387,1036118.4984515858,-742.943695034005,1035375.5547565517,1211,0,238.38020833333334,70,122,41,40.21932353223794,0.5276692708333333,45.52523474178404,8143.19248826291,116.33132126089872,8
1232,32,6,9,185,0.030927835051546393,0.04639175257731959,0.9536082474226804,194,6900,5100,1800,0.7391304347826086,87,51,36,206.61601875963748,0.4800947687979631,0.7735622679974885,0.11718186479111603,1040664.9519311892,-2696.3901538574783,1037968.5617773316,1212,0,236.34536082474227,76,118,41,39.698153157932,0.5316795532646048,44.96753246753248,8161.038961038988,107.38209159261827,0
1233,32,4,0,189,0.021164021164021163,0.0,1.0,189,6150,4200,1950,0.6829268292682927,81,42,39,216.1414181586833,0.48045306578107994,0.7777369731097239,0.12153339399487578,1037972.8458049876,919.7845804987946,1038892.6303854864,1213,0,241.12698412698413,69,120,41,39.79244566487499,0.525462962962963,45.297619047619044,8150.476190476182,118.12284334023452,8
1234,32,5,6,188,0.02577319587628866,0.030927835051546393,0.9690721649484536,194,6050,4500,1550,0.743801652892562,76,45,31,207.93427367081648,0.48093773925894273,0.7749707647738342,0.11813849348028317,1041217.0434633939,-1549.0580667526538,1039667.9853966413,1214,0,235.88659793814432,76,118,40,39.5954862031783,0.5287263745704467,44.899891774891785,8163.203463203487,107.41057188425641,0
1235,32,1,2,187,0.005291005291005291,0.010582010582010581,0.9894179894179894,189,5300,3300,2000,0.6226415094339622,73,33,40,204.52100871137043,0.4806289635633607,0.7614068136529335,0.1141486582576086,1035640.6666721847,-737.9452379373452,1034902.7214342473,1215,0,239.984126984127,70,119,47,40.380576860234896,0.5257385361552028,45.58392018779345,8141.314553990672,116.30449362843817,8
1236,32,4,2,189,0.020942408376963352,0.010471204188481676,0.9895287958115183,191,6750,5800,950,0.8592592592592593,77,58,19,196.29747836524825,0.48123909249563696,0.7545613536874001,0.11093692523569401,1039561.2080920609,-4137.3512490390885,1035423.8568430218,1216,0,237.04712041884818,76,115,43,40.09924636450485,0.5294502617801047,45.10281385281388,8156.709956710025,107.32513100934243,0
1237,32,4,2,191,0.02072538860103627,0.010362694300518135,0.9896373056994818,193,5800,3900,1900,0.6724137931034483,77,39,38,236.447777406609,0.48164040011514103,0.7949729082674262,0.13375429488545287,1039857.0153088559,4774.376018089763,1044631.3913269456,1217,0,235.24352331606218,71,122,33,39.038706183909326,0.5286593264248705,45.066550925925924,8157.870370370367,114.89958268127278,8
1238,32,6,1,196,0.030456852791878174,0.005076142131979695,0.9949238578680203,197,6750,4500,2250,0.6666666666666666,90,45,45,239.64727107477538,0.4827428433302255,0.804212107823278,0.1366656909864429,1042379.6293185826,3810.6867180268473,1046190.3160366095,1218,0,230.56852791878174,60,137,41,38.640697129858836,0.5300338409475465,44.75751366120219,8167.759562841533,136.1293260473589,8
1239,32,2,2,196,0.010101010101010102,0.010101010101010102,0.98989898989899,198,6650,4800,1850,0.7218045112781954,85,48,37,232.70921014061452,0.48282155309439573,0.7984025501543663,0.13361628313048132,1044494.6458604576,2362.704806857523,1046857.3506673151,1219,0,230.38888888888889,63,135,44,38.55294729689557,0.5320391414141414,44.49869791666666,8176.041666666647,129.77843915343885,0
1240,32,1,5,192,0.005076142131979695,0.025380710659898477,0.9746192893401016,197,6650,4900,1750,0.7368421052631579,84,49,35,251.47978709232981,0.4827709002382679,0.8075215382487504,0.14318712572444667,1041888.0316840219,6352.7560763886395,1048240.7877604106,1220,0,232.49238578680203,79,118,36,38.400389495526746,0.5325719120135364,44.817708333333314,8165.833333333287,103.364978902953,8
1241,32,0,2,190,0.0,0.010416666666666666,0.9895833333333334,192,6850,5000,1850,0.7299270072992701,87,50,37,246.57726677042766,0.4821173738365329,0.7985063503419996,0.1409515646422114,1043116.6965236011,6191.772790277393,1049308.4693138786,1221,1,238.46354166666666,66,126,34,38.37136434674946,0.5347222222222222,44.66728855721393,8170.646766169156,123.79767827529024,0
1242,32,3,1,192,0.015544041450777202,0.0051813471502590676,0.9948186528497409,193,5750,3500,2250,0.6086956521739131,80,35,45,256.5042330496363,0.4822307228698906,0.8109706519553179,0.14773420025086592,1045450.3764295739,9282.489399504258,1054732.865829078,1222,0,237.90673575129534,60,133,39,37.82511635157099,0.5329231433506045,44.381830601092894,8179.781420765027,136.3296903460838,8
1243,32,3,2,193,0.015384615384615385,0.010256410256410256,0.9897435897435898,195,7300,5000,2300,0.684931506849315,96,50,46,219.59899956339157,0.48237730196493084,0.7854567051214905,0.12675074267711656,1046114.9695294793,-354.8398526077058,1045760.1296768716,1223,0,236.25641025641025,69,126,40,38.68546189062835,0.5382478632478632,44.30059523809524,8182.380952380959,118.58523119392694,8
1244,32,2,4,191,0.010256410256410256,0.020512820512820513,0.9794871794871794,195,6300,4400,1900,0.6984126984126984,82,44,38,224.1122033080905,0.48228037712573796,0.7885659782770993,0.13010570280002653,1047898.1836473322,1669.3541559498458,1049567.537803282,1224,0,237.0974358974359,71,124,38,38.34733685718055,0.5401175213675213,44.082754629629626,8189.35185185184,115.34298382889916,0
1245,32,3,2,192,0.015463917525773196,0.010309278350515464,0.9896907216494846,194,5650,3500,2150,0.6194690265486725,78,35,43,228.07133151366853,0.4816827804782508,0.7879218346155323,0.1322514612836308,1047542.7731695808,3332.8950188614094,1050875.6681884422,1225,0,238.17525773195877,71,123,38,38.29040860944625,0.5393041237113403,44.126157407407405,8187.962962962956,115.32342201356276,8
1246,32,3,2,193,0.015384615384615385,0.010256410256410256,0.9897435897435898,195,6900,4700,2200,0.6811594202898551,91,47,44,221.75953466851715,0.48219997356595296,0.7825307483844071,0.1298877274487031,1050625.0000000019,697.2222222223345,1051322.222222224,1226,0,237.58461538461538,77,118,43,38.06741192411925,0.5420405982905983,43.75000000000001,8200.000000000015,106.49350649350669,0
1247,32,3,1,195,0.015306122448979591,0.00510204081632653,0.9948979591836735,196,5500,4000,1500,0.7272727272727273,70,40,30,218.6004291511619,0.4821559392987964,0.7807539765950533,0.12892189835846465,1052730.5224450906,1325.46879740444,1054055.9912424951,1227,0,237.3265306122449,68,128,45,37.88611127459634,0.5438988095238095,43.49335748792268,8208.212560386417,120.70900824097671,0
1248,32,2,3,194,0.01015228426395939,0.015228426395939087,0.9847715736040609,197,5800,4000,1800,0.6896551724137931,76,40,36,220.80621582656386,0.48218602161676855,0.7843932989355886,0.13128369571427131,1055201.5693535157,1399.0130926398424,1056600.5824461556,1228,0,237.08629441624365,70,127,48,37.52201877666054,0.5461082910321489,43.19248826291077,8217.840375586795,117.39771965123992,0
1249,32,1,3,192,0.005128205128205128,0.015384615384615385,0.9846153846153847,195,7150,5300,1850,0.7412587412587412,90,53,37,229.6250683278756,0.48214710547184775,0.793707254700083,0.1342347667507984,1050031.9124281956,2072.729927554735,1052104.6423557503,1229,0,239.63589743589745,71,124,39,37.939856648029966,0.5408653846153846,43.822337962962955,8197.685185185166,115.46035472091783,8
1250,32,3,1,194,0.015384615384615385,0.005128205128205128,0.9948717948717949,195,5950,4100,1850,0.6890756302521008,78,41,37,223.22121550055917,0.48223962463653186,0.7875387257988042,0.13145426453701253,1052282.9919123282,2028.377701046974,1054311.369613375,1230,0,240.1179487179487,66,129,42,37.82333030211173,0.5436965811965813,43.5478855721393,8206.467661691537,124.34041911653844,0
1251,32,2,4,192,0.01020408163265306,0.02040816326530612,0.9795918367346939,196,5650,4100,1550,0.7256637168141593,72,41,31,215.0711498281584,0.4823107448107448,0.7843879039942832,0.12420963035019451,1046294.8936907474,155.56916907983214,1046450.4628598273,1231,0,239.80102040816325,66,130,47,38.778777561608315,0.5352891156462585,44.27860696517412,8183.084577114405,123.98612995627886,8
1252,32,1,2,191,0.0051813471502590676,0.010362694300518135,0.9896373056994818,193,5700,4100,1600,0.7192982456140351,73,41,32,215.70914741055546,0.481913635218768,0.7805293496984438,0.12521323893817668,1047863.3368175657,906.7413975391532,1048770.0782151048,1232,0,241.48704663212436,67,126,42,38.5667325112734,0.5372409326424871,44.08700980392155,8189.215686274474,122.2270997951414,0
1253,32,2,2,191,0.010362694300518135,0.010362694300518135,0.9896373056994818,193,6250,4600,1650,0.736,79,46,33,221.4198975186959,0.4819507412204951,0.7837781269702093,0.1272103669562693,1044680.1506223801,1412.5943781244032,1046092.7450005045,1233,0,241.6321243523316,65,128,41,38.81820053530988,0.5308721934369602,44.47601010101008,8176.767676767634,125.79642579642514,8
1254,32,1,1,191,0.005208333333333333,0.005208333333333333,0.9947916666666666,192,6100,4800,1300,0.7868852459016393,74,48,26,223.98605488083658,0.481803214986911,0.7846049715083709,0.12289861196994448,1030248.1736462914,1652.2447926437071,1031900.4184389351,1234,0,243.77083333333334,72,120,37,40.56343605315939,0.51806640625,46.247146118721446,8120.091324200876,112.77904616945662,8
1255,32,3,4,190,0.015463917525773196,0.020618556701030927,0.979381443298969,194,7050,5300,1750,0.75177304964539,88,53,35,223.73018005912354,0.4818797517938857,0.7870965016055431,0.12406855439642331,1033611.1111111137,400.0000000001496,1034011.1111111138,1235,0,242.15463917525773,67,127,40,40.14685792349725,0.5210481099656357,45.83333333333334,8133.333333333354,121.39303482587096,0
1256,32,5,4,191,0.02564102564102564,0.020512820512820513,0.9794871794871794,195,5800,3900,1900,0.6724137931034483,77,39,38,221.43600938436978,0.4819235174905278,0.7879607781448266,0.12446230872293916,1037851.5625000023,1163.5416666667893,1039015.1041666691,1236,0,241.62564102564102,71,124,44,39.672801635991824,0.524465811965812,45.31250000000001,8150.000000000018,114.78873239436645,0
1257,32,2,3,190,0.010362694300518135,0.015544041450777202,0.9844559585492227,193,4850,2900,1950,0.5979381443298969,68,29,39,235.5738332534942,0.4819147596430628,0.7965478294271435,0.13284602895809167,1038884.3361942997,5496.793076860418,1044381.1292711601,1237,0,242.0880829015544,73,120,33,39.18305527934297,0.5306023316062176,45.1858108108108,8154.054054054033,111.6993706034799,8
1258,32,2,2,190,0.010416666666666666,0.010416666666666666,0.9895833333333334,192,7500,5600,1900,0.7466666666666667,94,56,38,234.53674668967503,0.48170834242292027,0.7964705010117941,0.1335377877159202,1041882.5790780853,2971.950105924068,1044854.5291840093,1238,0,244.22916666666666,77,115,37,38.833429279184976,0.5337456597222222,44.81837606837605,8165.811965811913,106.04950604950537,0
1259,32,3,1,192,0.015544041450777202,0.0051813471502590676,0.9948186528497409,193,6200,4400,1800,0.7096774193548387,80,44,36,185.80097491764266,0.48141326640759935,0.748215263871554,0.10594268531564821,1042333.7744469501,-6066.673703633989,1036267.1007433161,1239,0,243.84974093264248,72,121,45,40.02080188591346,0.5376727115716753,44.763127853881294,8167.579908675827,113.43860984271981,8
1260,32,0,3,189,0.0,0.015625,0.984375,192,6550,4600,1950,0.7022900763358778,85,46,39,186.00080457238417,0.48076813827079695,0.7476229177290512,0.10634040168117978,1043164.3337673653,-6144.118923610869,1037020.2148437544,1240,1,246.11458333333334,71,121,43,39.912140914499446,0.5392252604166667,44.66145833333335,8170.833333333367,115.08215962441362,0
1261,32,4,2,191,0.02072538860103627,0.010362694300518135,0.9896373056994818,193,6650,5200,1450,0.7819548872180451,81,52,29,180.45412168050836,0.48034618775187105,0.7397110978915844,0.104329913509295,1046628.2808355228,-7476.322571168754,1039151.958264354,1241,0,245.04663212435233,78,115,50,39.6225361310168,0.5430699481865284,44.23786919831226,8184.388185654077,104.92805366223175,0
1262,32,3,3,191,0.015463917525773196,0.015463917525773196,0.9845360824742269,194,7250,4800,2450,0.6620689655172414,97,48,49,200.19643724795037,0.48005971458077384,0.7625537357220997,0.11548346773797825,1045932.3350694526,-4171.614583332899,1041760.7204861197,1242,0,244.20103092783506,79,115,41,39.204352549738566,0.5446198453608248,44.32291666666669,8181.6666666667315,103.56540084388267,8
1263,32,2,1,192,0.010362694300518135,0.0051813471502590676,0.9948186528497409,193,6050,4300,1750,0.7107438016528925,78,43,35,227.2024608092741,0.47986043645653426,0.792742591659827,0.1300446769846076,1043519.0007716023,2768.016975308488,1046287.0177469108,1243,0,246.2901554404145,59,134,43,38.81571493315203,0.5389140759930915,44.61805555555554,8172.222222222201,138.51224105461358,8
1264,32,1,3,190,0.0051813471502590676,0.015544041450777202,0.9844559585492227,193,5400,3800,1600,0.7037037037037037,70,38,32,223.6696078092804,0.47964117371905585,0.7896201440372952,0.12872244220088788,1045208.7182609639,2756.2848184539916,1047965.0030794179,1244,0,246.9119170984456,62,131,41,38.69463492474232,0.5407491364421416,44.41137566137565,8178.835978835955,131.91670933606378,0
1265,32,0,2,188,0.0,0.010526315789473684,0.9894736842105263,190,4700,3100,1600,0.6595744680851063,63,31,32,221.5930233310819,0.479485751415576,0.7842111860247261,0.12792106657998353,1046161.8014464172,3664.4312952004952,1049826.2327416178,1245,1,250.1263157894737,64,126,42,38.62862455084815,0.5419956140350877,44.294871794871796,8182.564102564105,127.85256410256414,0
1266,32,2,2,188,0.010526315789473684,0.010526315789473684,0.9894736842105263,190,6200,4100,2100,0.6612903225806451,83,41,42,215.33882803500092,0.47972477490021354,0.7733938127115598,0.12288226529947442,1042580.0140238915,701.591670523821,1043281.6056944154,1246,0,249.14736842105262,70,120,39,39.23609115466407,0.5367324561403508,44.73298122065727,8168.544600938956,116.69349429912795,8
1267,32,2,2,188,0.010526315789473684,0.010526315789473684,0.9894736842105263,190,5200,3500,1700,0.6730769230769231,69,35,34,211.9046441864514,0.4794863315696649,0.7693387924110313,0.1216792532941565,1044516.2254737867,1067.5678211996828,1045583.7932949864,1247,0,249.82631578947368,73,117,40,39.08181137862008,0.5389802631578947,44.496058558558566,8176.1261261261425,112.00172775515264,0
1268,32,4,0,192,0.020833333333333332,0.0,1.0,192,5600,4000,1600,0.7142857142857143,72,40,32,203.8776150158282,0.47951832006253636,0.7635874635321247,0.11825864493184964,1047637.5434027809,-1282.03124999987,1046355.512152781,1248,0,248.11979166666666,79,113,38,38.89765248660018,0.5419379340277778,44.11458333333334,8188.333333333358,103.64978902953617,0
1269,32,3,0,195,0.015384615384615385,0.0,1.0,195,6550,5000,1550,0.7633587786259542,81,50,31,197.720367550386,0.4798374306106265,0.7599397149121165,0.11542443390010435,1049608.3809681328,-4044.2090262028296,1045564.17194193,1249,0,245.2871794871795,83,112,41,38.80987540750783,0.5442307692307693,43.87400793650795,8196.031746031784,98.74737043411788,0
1270,32,4,1,198,0.020100502512562814,0.005025125628140704,0.9949748743718593,199,6200,4400,1800,0.7096774193548387,80,44,36,222.71808865894175,0.4799153596264149,0.7841847164081628,0.12832607573611168,1045573.5208189093,573.6272218376535,1046147.1480407469,1250,0,241.33668341708542,75,124,40,38.67336201812238,0.5377407872696818,44.36677631578949,8180.263157894764,109.07017543859685,8
1271,32,1,5,194,0.005025125628140704,0.02512562814070352,0.9748743718592965,199,6950,4700,2250,0.6762589928057554,92,47,45,208.91176375550765,0.47960763413024715,0.779985635900089,0.11962947313999633,1043658.8860235,-3143.4762723442286,1040515.4097511558,1251,0,242.32663316582915,70,129,41,39.26535213694858,0.5350188442211055,44.600938967136166,8172.769953051673,116.75385647216676,8
1272,32,5,4,195,0.02512562814070352,0.020100502512562814,0.9798994974874372,199,7100,5600,1500,0.7887323943661971,86,56,30,219.08709007614382,0.4790080452768895,0.7908727632952757,0.12685838139303657,1047097.4104938277,-1018.8950617284027,1046078.5154320992,1252,0,243.19597989949747,74,125,39,38.57588178873267,0.5362751256281407,44.18055555555556,8186.222222222225,110.62462462462467,8
1273,32,1,5,191,0.00510204081632653,0.025510204081632654,0.9744897959183674,196,6350,4400,1950,0.6929133858267716,83,44,39,217.5989548685264,0.4781560701203558,0.7862576983456098,0.12680766680269337,1049072.5436180022,105.41781450886629,1049177.961432511,1253,0,247.31632653061226,76,120,38,38.367541913214986,0.5385841836734694,43.93939393939395,8193.939393939425,107.81499202551875,0
1274,32,1,1,191,0.005208333333333333,0.005208333333333333,0.9947916666666666,192,6150,4700,1450,0.7642276422764228,76,47,29,200.19642826722765,0.47809409540430486,0.7650481403142511,0.11716962660193157,1050394.1568257434,-2492.9683061440846,1047901.1885195993,1254,0,253.05729166666666,73,119,43,38.64868329487602,0.541015625,43.77815315315315,8199.099099099089,112.31642601505601,8
1275,32,0,2,189,0.0,0.010471204188481676,0.9895287958115183,191,6850,5000,1850,0.7299270072992701,87,50,37,214.37831652397824,0.4779243593276385,0.7762142832896599,0.12376282473323702,1046178.4237309645,-194.40614736928183,1045984.0175835952,1255,1,255.10994764397907,70,121,42,38.81103333524583,0.538230802792321,44.29284037558686,8182.629107981244,116.89470154258919,8
1276,32,0,0,189,0.0,0.0,1.0,189,5350,3100,2250,0.5794392523364486,76,31,45,237.57123092777914,0.47771609628879136,0.793016668243411,0.1354191108050661,1042235.7296828169,6371.04504353165,1048606.7747263485,1256,2,258.55026455026456,62,127,40,38.71172367625465,0.533289241622575,44.775132275132265,8167.195767195745,131.72896398702815,8
1277,32,2,1,190,0.010471204188481676,0.005235602094240838,0.9947643979057592,191,6450,4500,1950,0.6976744186046512,84,45,39,231.36873060677672,0.4777199871406264,0.7900306778692348,0.13266250236949714,1044064.7600262983,3662.787639710693,1047727.547666009,1257,0,256.8324607329843,64,127,42,38.64099749058972,0.5356130017452008,44.55128205128205,8174.358974358973,127.72435897435895,0
1278,32,1,5,186,0.005235602094240838,0.02617801047120419,0.9738219895287958,191,6200,4400,1800,0.7096774193548387,80,44,36,221.47751320061917,0.4773055019748324,0.7831086824058153,0.12713751715218521,1044422.0615243345,1863.2001836546801,1046285.2617079891,1258,0,257.80104712041884,65,126,44,38.84899308129477,0.5337041884816753,44.50757575757576,8175.757575757577,125.7808857808858,8
1279,32,2,1,187,0.010638297872340425,0.005319148936170213,0.9946808510638298,188,6150,4400,1750,0.7154471544715447,79,44,35,214.24334559753746,0.47822265995373003,0.771948260172465,0.12375703845693056,1046358.5069444457,1085.0694444444784,1047443.5763888902,1259,0,261.92021276595744,69,119,43,38.792006109979596,0.5356272163120568,44.270833333333336,8183.333333333343,118.59903381642526,0
1280,32,3,3,187,0.015789473684210527,0.015789473684210527,0.9842105263157894,190,5500,3600,1900,0.6545454545454545,74,36,38,206.04667572121338,0.4787187877100158,0.7651617379585229,0.11992606168516415,1048689.7808642045,-284.1913580242817,1048405.5895061803,1260,0,259.9789473684211,74,116,38,38.711030036709545,0.5381578947368422,43.986111111111136,8192.4444444445,110.70870870870945,0
1281,32,2,1,188,0.010582010582010581,0.005291005291005291,0.9947089947089947,189,5550,3700,1850,0.6666666666666666,74,37,37,210.45317559937158,0.47786150512214337,0.7721285371054951,0.1209141361233865,1044691.3726107966,621.7233774417573,1045313.0959882383,1261,0,262.3333333333333,68,121,43,39.097025286541424,0.5373126102292769,44.47463768115942,8176.8115942029035,120.24722932651329,8
1282,32,2,1,189,0.010526315789473684,0.005263157894736842,0.9947368421052631,190,5400,3900,1500,0.7222222222222222,69,39,30,221.35184253631024,0.4778613199665831,0.7860031050741034,0.12607311701060647,1041987.2716049385,2729.1604938271485,1044716.4320987657,1262,0,261.62105263157895,74,116,37,39.1567795072748,0.5372807017543859,44.80555555555556,8166.222222222224,110.35435435435438,8
1283,32,3,4,188,0.015625,0.020833333333333332,0.9791666666666666,192,6850,4900,1950,0.7153284671532847,88,49,39,202.78585301831518,0.4781298856529959,0.7642003058480125,0.1151991405380174,1041178.4588151773,-3022.7476169740635,1038155.7111982033,1263,0,259.859375,82,110,41,39.73164501951526,0.5372721354166667,44.904618473895574,8163.052208835316,99.5494171809185,8
1284,32,3,1,190,0.015706806282722512,0.005235602094240838,0.9947643979057592,191,6800,5000,1800,0.7352941176470589,86,50,36,220.43018364604825,0.47840888215302657,0.780357697162841,0.12176601847696651,1032386.5744100987,513.8324381869779,1032900.4068482857,1264,0,261.70680628272254,82,109,37,40.384654973649575,0.5240510471204188,45.983935742971916,8128.514056224968,99.12822019786546,6
1285,32,2,1,191,0.010416666666666666,0.005208333333333333,0.9947916666666666,192,6550,4500,2050,0.6870229007633588,86,45,41,216.74993642697072,0.4785281231820826,0.7789755441142061,0.1207526047395627,1035064.0022675735,-79.98866213150995,1034984.013605442,1265,0,261.328125,69,123,38,40.141830485997374,0.5269097222222222,45.654761904761905,8139.047619047617,117.95721187025532,0
1286,32,5,2,194,0.025510204081632654,0.01020408163265306,0.9897959183673469,196,5900,4300,1600,0.7288135593220338,75,43,32,212.8464416029475,0.47961745595674166,0.7798914662187106,0.12033199817354757,1039671.5561224496,-841.9217687074879,1038829.6343537421,1266,0,256.85714285714283,76,120,34,39.6636018680677,0.5305590986394557,45.089285714285715,8157.142857142862,107.33082706766925,0
1287,32,2,4,192,0.01020408163265306,0.02040816326530612,0.9795918367346939,196,6400,4200,2200,0.65625,86,42,44,213.18117728098363,0.47898406157334733,0.781710884868086,0.1212181535132537,1041470.6456713879,-1195.612330437687,1040275.0333409503,1267,0,257.8469387755102,80,116,38,39.42991078179341,0.532578656462585,44.868827160493815,8164.197530864169,102.05246913580211,0
1288,32,1,4,189,0.0051813471502590676,0.02072538860103627,0.9792746113989638,193,5900,4400,1500,0.7457627118644068,74,44,30,213.22981954298945,0.4785977079735175,0.7793255856600685,0.12198150623821706,1043352.0911428328,-5.24437716254306,1043346.8467656702,1268,0,261.4715025906736,67,126,41,39.19341131773643,0.5344343696027634,44.63848039215687,8171.568627451005,121.9637108574777,0
1289,32,3,0,192,0.015625,0.0,1.0,192,6100,3800,2300,0.6229508196721312,84,38,46,219.77294721079858,0.47903657195317045,0.7813977740787388,0.1257753107775914,1043477.2721128935,1365.6150879472016,1044842.8872008407,1269,0,262.609375,67,125,40,39.0106697258713,0.5384657118055556,44.6231617647059,8172.058823529446,121.97102721685741,8
1290,32,4,1,195,0.02040816326530612,0.00510204081632653,0.9948979591836735,196,5100,3100,2000,0.6078431372549019,71,31,40,212.0496157513424,0.4792876766091052,0.779178103114456,0.1227186502367331,1046934.5527960467,100.41392744137192,1047034.9667234881,1270,0,258.2295918367347,73,123,41,38.77623083131559,0.5411352040816326,44.200450450450475,8185.585585585645,112.13130939158418,0
1291,32,3,8,190,0.015151515151515152,0.04040404040404041,0.9595959595959596,198,5950,4200,1750,0.7058823529411765,77,42,35,210.62593859834038,0.4796591122733254,0.7788733980357965,0.12285896137221343,1049359.9489407153,-1345.5151653709554,1048014.4337753443,1271,0,255.35858585858585,80,118,34,38.510281711358864,0.5437710437710438,43.90432098765434,8195.061728395101,102.43827160493876,0
1292,32,1,3,188,0.005235602094240838,0.015706806282722512,0.9842931937172775,191,6750,5000,1750,0.7407407407407407,85,50,35,222.00975940777982,0.47855125378892255,0.7854774914835727,0.12990015966758378,1050308.665790283,1685.7548392017393,1051994.4206294846,1272,0,261.64921465968587,80,111,36,38.10043668122276,0.5454842931937173,43.788580246913604,8198.765432098822,102.48456790123528,0
1293,32,1,2,187,0.005291005291005291,0.010582010582010581,0.9894179894179894,189,6000,4200,1800,0.7,78,42,36,199.724703560842,0.47756599684791173,0.7587549794355211,0.11515555765308005,1045782.6196128585,-2026.2752617480546,1043756.3443511105,1273,0,265.36507936507934,73,116,42,39.23507873582203,0.5401785714285714,44.341216216216225,8181.0810810811,112.06960385042602,8
1294,32,0,1,186,0.0,0.0053475935828877,0.9946524064171123,187,5900,3700,2200,0.6271186440677966,81,37,44,183.93501547228232,0.47735538496923696,0.7361337194741204,0.1067639880585061,1047848.2227101214,-4752.804188641941,1043095.4185214795,1274,1,263.427807486631,82,105,39,39.38175338793261,0.5457887700534759,44.08885542168676,8189.156626506055,99.86776373787872,8
1295,32,1,1,186,0.0053475935828877,0.0053475935828877,0.9946524064171123,187,5700,3900,1800,0.6842105263157895,75,39,36,183.2300658466808,0.47731106127690565,0.7349575644977409,0.10519848847144092,1044471.0633311961,-4824.299658174506,1039646.7636730216,1275,0,264.3048128342246,78,109,42,39.820083088197336,0.5445632798573975,44.50158227848101,8175.949367088601,104.8198636806231,8
1296,32,1,1,186,0.0053475935828877,0.0053475935828877,0.9946524064171123,187,5750,4100,1650,0.7130434782608696,74,41,33,202.79018702416946,0.4772547582082687,0.7624543308396541,0.11280706440670722,1034593.6311232417,-1188.9128101008819,1033404.7183131409,1276,0,264.9946524064171,68,119,44,40.55586064276103,0.5316399286987522,45.71256038647341,8137.198067632809,119.66467746518838,8
1297,32,4,2,188,0.021052631578947368,0.010526315789473684,0.9894736842105263,190,5700,4400,1300,0.7719298245614035,70,44,26,206.4787590358014,0.4778195488721804,0.7661653355177844,0.1144629876449537,1033503.8705736175,-1020.6806690527756,1032483.1899045648,1277,0,261.6736842105263,78,112,44,40.59878945092951,0.5282894736842105,45.846518987341746,8132.911392404995,104.26809477442302,8
1298,32,2,1,189,0.010526315789473684,0.005263157894736842,0.9947368421052631,190,5050,3300,1750,0.6534653465346535,68,33,35,200.73204289092604,0.4779019307528079,0.7606600640315959,0.11223384089165263,1036201.4665852202,-1450.232553154985,1034751.2340320653,1278,0,260.3578947368421,71,119,46,40.40671783210156,0.531140350877193,45.5150462962963,8143.518518518525,114.69744392279613,0
1299,32,2,1,190,0.010471204188481676,0.005235602094240838,0.9947643979057592,191,6650,4900,1750,0.7368421052631579,84,49,35,224.45723734608944,0.47819991733259853,0.7854682654062317,0.12551020141469468,1036229.1884431456,1667.8281790656688,1037897.0166222113,1279,0,258.4816753926702,67,124,42,39.79946678304141,0.5309227748691099,45.51164215686274,8143.627450980382,121.54667837284151,8
1300,32,3,3,190,0.015544041450777202,0.015544041450777202,0.9844559585492227,193,6850,5300,1550,0.7737226277372263,84,53,31,217.1098627731531,0.47842567105641914,0.7802210429550389,0.12237101356304979,1038723.9632201149,-346.55657721909756,1038377.4066428959,1280,0,256.77720207253884,72,121,34,39.67363911290321,0.5334628670120898,45.20547945205479,8153.424657534235,113.24200913241992,0
1301,32,4,2,192,0.020618556701030927,0.010309278350515464,0.9896907216494846,194,6200,4500,1700,0.7258064516129032,79,45,34,219.96631742782353,0.47845723608069374,0.7698030025878575,0.12397180009872222,1038700.6944444407,695.8333333331584,1039396.5277777738,1281,0,256.33505154639175,79,115,36,39.60377487053691,0.5349548969072164,45.20833333333332,8153.333333333303,103.20675105485194,8
1302,32,2,0,194,0.010309278350515464,0.0,1.0,194,6500,4900,1600,0.7538461538461538,81,49,32,212.20562395875805,0.4779080533447287,0.7711561673511973,0.11982779154192297,1039301.5096214121,-1190.874933902258,1038110.6346875099,1282,0,256.72680412371136,81,113,34,39.726268504211724,0.5357603092783505,45.134654471544685,8155.6910569104875,100.68754391247515,8
1303,32,5,5,194,0.02512562814070352,0.02512562814070352,0.9748743718592965,199,6750,4700,2050,0.6962962962962963,88,47,41,209.88975333023376,0.4783978816642133,0.7771905815406419,0.12008959598158675,1043400.7717388967,-2750.173879029574,1040650.5978598671,1283,0,251.25125628140702,71,128,38,39.27262147564822,0.5393111390284757,44.632523148148145,8171.759259259254,115.09520083463738,0
1304,32,2,3,193,0.01020408163265306,0.015306122448979591,0.9846938775510204,196,7550,5300,2250,0.7019867549668874,98,53,45,208.07656761181693,0.478575789290075,0.7733449657681117,0.11721444429724501,1038550.1900514457,-3530.408232299277,1035019.7818191465,1284,0,255.66326530612244,78,118,42,39.92555981092362,0.5341198979591837,45.22679324894513,8152.742616033706,104.52234123120137,8
1305,32,2,1,194,0.010256410256410256,0.005128205128205128,0.9948717948717949,195,7300,5300,2000,0.726027397260274,93,53,40,221.7153829107439,0.47815005727376864,0.7883322414922598,0.124596226517347,1037793.4154834086,-281.04710076966103,1037512.3683826389,1285,0,257.53846153846155,72,123,39,39.67297923203344,0.5300747863247863,45.31963470319633,8149.7716894976775,113.19127346524552,8
1306,32,3,3,194,0.015228426395939087,0.015228426395939087,0.9847715736040609,197,6750,4700,2050,0.6962962962962963,88,47,41,204.66764638131792,0.4785656013674506,0.7676884679741074,0.11203253304347936,1029493.5983280545,-4009.193653112782,1025484.4046749418,1286,0,255.9035532994924,73,124,43,41.148492415834234,0.5185596446700508,46.34009009009008,8117.117117117092,111.19338516598756,8
1307,32,2,1,195,0.01020408163265306,0.00510204081632653,0.9948979591836735,196,5950,4300,1650,0.7226890756302521,76,43,33,207.1778788390565,0.4791345063666492,0.7728842519234065,0.11174225654841186,1024772.7631427962,-2687.950528007147,1022084.8126147891,1287,0,257.2551020408163,87,109,40,41.6791393826006,0.5133397108843538,46.9223484848485,8098.484848484886,93.08603274120559,8
1308,32,7,3,199,0.034653465346534656,0.01485148514851485,0.9851485148514851,202,5900,4100,1800,0.6949152542372882,77,41,36,197.2880590523053,0.4798629583107565,0.7676263735322946,0.10787878973711112,1029156.8559556738,-5691.92828562664,1023464.9276700472,1288,0,250.52970297029702,75,127,46,41.37799034443,0.5169657590759076,46.3815789473684,8115.789473684172,108.21052631578895,0
1309,32,5,8,196,0.024509803921568627,0.0392156862745098,0.9607843137254902,204,5650,4100,1550,0.7256637168141593,72,41,31,193.384076480995,0.48086152564474066,0.7660371915288058,0.10690271747869441,1032614.6193771664,-6511.755094194374,1026102.8642829721,1289,0,246.85294117647058,84,120,42,41.043073645280636,0.5206801470588236,45.95588235294119,8129.411764705912,96.7787114845942,0
1310,32,2,3,195,0.010101010101010102,0.015151515151515152,0.9848484848484849,198,7300,5200,2100,0.7123287671232876,94,52,42,194.12536054136484,0.48035451810832525,0.7616889112734,0.10781423870066509,1034088.4745090199,-6751.440410853491,1027337.0340981664,1290,0,255.04040404040404,70,128,46,40.83948907356112,0.5230429292929293,45.77464788732392,8135.211267605585,116.21730382293693,0
1311,32,3,0,198,0.015151515151515152,0.0,1.0,198,6350,4700,1650,0.7401574803149606,80,47,33,190.0958545585076,0.4801029542463553,0.75621778677213,0.10648156547519293,1036776.4938271559,-6532.617283950891,1030243.876543205,1291,0,255.93939393939394,74,124,43,40.60544885784956,0.5249894781144782,45.44444444444443,8145.777777777741,110.07807807807758,0
1312,32,6,5,199,0.029411764705882353,0.024509803921568627,0.9754901960784313,204,6550,4800,1750,0.732824427480916,83,48,35,184.96555534223464,0.4806985294117647,0.7566544398414823,0.10496716846131614,1040856.1475477492,-8845.49292749059,1032010.6546202586,1292,0,249.38235294117646,81,123,40,40.22645017764053,0.5289522058823529,44.94410569105689,8161.788617886125,100.76282244303859,0
1313,32,3,1,201,0.01485148514851485,0.0049504950495049506,0.995049504950495,202,6300,4300,2000,0.6825396825396826,83,43,40,219.2667915423454,0.48079682035367716,0.7921090332253902,0.12433582452658858,1040612.510850693,-1065.6467013889505,1039546.864149304,1293,0,252.74257425742573,79,123,38,39.38208414173389,0.5317141089108911,44.97395833333333,8160.833333333321,103.30168776371292,8
1314,32,1,3,199,0.0049504950495049506,0.01485148514851485,0.9851485148514851,202,6950,5200,1750,0.7482014388489209,87,52,35,216.81502847558858,0.4808650641183521,0.7932822526012684,0.12033159368118004,1033867.8610601011,-2518.3820528514625,1031349.4790072496,1294,0,253.67821782178217,65,137,40,40.29036797880708,0.5223803630363036,45.801767676767696,8134.343434343476,125.14374514374578,8
1315,32,7,2,204,0.03398058252427184,0.009708737864077669,0.9902912621359223,206,5600,4100,1500,0.7321428571428571,71,41,30,217.75328678383755,0.48131413292288266,0.7920385543183008,0.12142414641814675,1035356.1280517122,-1709.5600249902373,1033646.568026722,1295,0,249.05339805825244,67,139,40,40.07963988919668,0.5288733818770226,45.61887254901961,8140.196078431383,121.49546385718483,8
1316,32,2,5,201,0.009708737864077669,0.024271844660194174,0.9757281553398058,206,7350,5600,1750,0.7619047619047619,91,56,35,222.22089187850153,0.48194362222748444,0.7959281486261183,0.12657351894086183,1042000.615148018,-2239.138792772189,1039761.4763552458,1296,0,249.34466019417476,84,122,39,39.13293155333587,0.5323118932038835,44.803921568627445,8166.274509803906,97.21755368814173,8
1317,32,2,4,199,0.009852216748768473,0.019704433497536946,0.9802955665024631,203,6750,4900,1850,0.725925925925926,86,49,37,197.74317880129223,0.4821265993594433,0.7700236923023662,0.1120970621023795,1040518.60803136,-6198.908569196919,1034319.699462163,1297,0,250.86699507389162,85,118,38,39.94272663943507,0.5298132183908046,44.985465116279045,8160.465116279003,96.00547195622357,8
1318,32,2,5,196,0.009950248756218905,0.024875621890547265,0.9751243781094527,201,7400,5700,1700,0.7702702702702703,91,57,34,211.05983428779518,0.48160966003316746,0.7793553190273403,0.11905844592661784,1038980.2315334072,-3742.6009008528254,1035237.6306325544,1298,0,254.08955223880596,78,123,40,39.795698368346606,0.5314054726368159,45.17405063291139,8154.430379746828,104.54397922752344,8
1319,32,4,1,199,0.02,0.005,0.995,200,6250,4400,1850,0.704,81,44,37,195.51719125715786,0.48123272613065327,0.7658603618982582,0.10866600629833313,1034317.2501929017,-5804.639274691326,1028512.6109182104,1299,0,255.1,71,129,37,40.77543530215088,0.53046875,45.74652777777778,8136.111111111115,114.59311424100162,8
1320,32,1,1,199,0.005,0.005,0.995,200,6300,4700,1600,0.746031746031746,79,47,32,187.69853957634623,0.4809542504187605,0.7499550113073188,0.10551633075507716,1037901.5018262203,-7337.480776624413,1030564.0210495959,1300,0,256.03,84,116,37,40.52581035782451,0.53296875,45.306372549019606,8150.19607843137,97.02614379084964,8
1321,32,2,5,196,0.009950248756218905,0.024875621890547265,0.9751243781094527,201,6600,4000,2600,0.6060606060606061,92,40,52,195.68024332433725,0.48082089552238805,0.7641943450535682,0.11097475236701335,1040651.1515187356,-6073.0258910125285,1034578.125627723,1301,0,255.4825870646766,87,114,35,39.97877504448057,0.5353959369817578,44.96922348484848,8160.984848484825,93.80442354580259,0
1322,32,1,2,195,0.005076142131979695,0.01015228426395939,0.9898477157360406,197,7500,5300,2200,0.7066666666666667,97,53,44,216.04763821614694,0.4801583704547809,0.7840209482851344,0.12162610090428276,1038347.7662759303,-2033.4834898147665,1036314.2827861155,1302,0,260.65482233502536,76,121,40,39.74784486573557,0.5362732656514382,45.25162337662337,8151.948051948039,107.26247436773735,8
1323,32,4,1,198,0.020100502512562814,0.005025125628140704,0.9949748743718593,199,5000,3200,1800,0.64,68,32,36,207.51382802410785,0.48010359034228384,0.7788937215586371,0.117802379216739,1040959.8313875666,-1597.288113887238,1039362.5432736794,1303,0,258.76884422110555,81,118,38,39.63837633016249,0.5388923785594639,44.93140243902439,8162.1951219512175,100.76784101174343,0
1324,32,1,2,197,0.005025125628140704,0.010050251256281407,0.9899497487437185,199,5550,3900,1650,0.7027027027027027,72,39,33,211.31683604826188,0.4797281863864778,0.7847945054815315,0.12060121758096662,1042616.3306040224,-1285.5231609017628,1041330.8074431206,1304,0,259.7638190954774,65,134,41,39.33421952928571,0.5407768006700168,44.728535353535364,8168.6868686868875,125.67210567210596,0
1325,32,5,3,199,0.024752475247524754,0.01485148514851485,0.9851485148514851,202,5850,4100,1750,0.7008547008547008,76,41,35,200.92096343543443,0.48022059668653433,0.7772294272925513,0.11585866011998351,1045818.3037977545,-4224.635764508344,1041593.6680332461,1305,0,256.8217821782178,70,132,45,39.200045908412754,0.543523102310231,44.336854460093925,8181.220657277052,116.8745808182436,0
1326,32,3,2,200,0.01485148514851485,0.009900990099009901,0.9900990099009901,202,6750,5200,1550,0.7703703703703704,83,52,31,213.6538786782395,0.47997276406745154,0.7865982765935391,0.12141298271994845,1041280.9092796842,-2655.2589877584305,1038625.6502919258,1306,0,257.5742574257426,82,120,39,39.44158836358868,0.5362520627062706,44.892068273092356,8163.453815261006,99.55431482025617,8
1327,32,2,1,201,0.009900990099009901,0.0049504950495049506,0.995049504950495,202,6700,5000,1700,0.746268656716418,84,50,34,209.55917766853125,0.4797798343267163,0.783527554741642,0.1199699698348073,1043580.6881432511,-3361.6178323878353,1040219.0703108633,1307,0,258.4950495049505,68,134,40,39.25858603771355,0.538417904290429,44.61050724637683,8172.463768115973,120.18329070758784,0
1328,32,1,4,198,0.0049504950495049506,0.019801980198019802,0.9801980198019802,202,6700,4800,1900,0.7164179104477612,86,48,38,229.54969083901426,0.4798650107548068,0.7971689412944698,0.13137920633176534,1043497.824930081,806.9206207769867,1044304.745550858,1308,0,259.01485148514854,66,136,40,38.758421608019816,0.5375928217821782,44.62064676616917,8172.139303482627,123.8202924770095,8
1329,32,2,3,197,0.01,0.015,0.985,200,6250,3800,2450,0.608,87,38,49,197.1114800155945,0.47968907035175884,0.7666375579204638,0.11382159235596237,1046251.9558376794,-5004.345703124791,1041247.6101345547,1309,0,262.255,79,121,43,39.243395369757465,0.5427083333333333,44.283854166666686,8182.916666666712,103.58122362869257,8
1330,32,3,6,194,0.015,0.03,0.97,200,7050,5300,1750,0.75177304964539,88,53,35,191.12525323283296,0.4791823701842546,0.7575329716584034,0.11123135995167267,1048662.315952502,-6964.829861569542,1041697.4860909324,1310,0,262.26,86,114,42,39.096455741589516,0.545625,43.989463601532584,8192.337164751003,95.25973447384887,0
1331,32,2,1,195,0.01020408163265306,0.00510204081632653,0.9948979591836735,196,6000,4500,1500,0.75,75,45,30,212.27931897911844,0.47870497557997554,0.7691073780895521,0.1230930248960832,1047539.9187109931,-725.7878905177013,1046814.1308204754,1311,0,268.484693877551,82,114,37,38.69484091949518,0.5463966836734694,44.1265060240964,8187.951807228952,99.85307081986527,8
1332,32,0,0,195,0.0,0.0,1.0,195,5950,4100,1850,0.6890756302521008,78,41,37,194.81478403402838,0.4781853026698388,0.757894765153381,0.10934746797694414,1037416.2449092258,-4529.195658923628,1032887.0492503023,1312,1,270.83076923076925,77,118,44,40.40527044981734,0.5364850427350427,45.36591880341878,8148.290598290536,105.82195582195502,8
1333,32,4,5,194,0.020100502512562814,0.02512562814070352,0.9748743718592965,199,6600,4600,2000,0.696969696969697,86,46,40,198.45557640303872,0.47869080249733514,0.7667698538816914,0.11267469632440821,1041000.0865051788,-5081.545559400733,1035918.5409457781,1313,0,266.36683417085425,84,115,39,39.864394157778435,0.5394681742043551,44.92647058823526,8162.352941176379,97.17086834733784,0
1334,32,2,0,196,0.01020408163265306,0.0,1.0,196,6550,4300,2250,0.6564885496183206,88,43,45,179.12558759473728,0.4781386272457701,0.7328583114797973,0.09869832529560821,1031582.3044011708,-8793.442714361116,1022788.8616868097,1314,0,270.9948979591837,95,101,40,41.53459431933113,0.5310374149659864,46.08289930555558,8125.34722222229,85.52997076023463,8
1335,32,6,0,202,0.0297029702970297,0.0,1.0,202,6450,4700,1750,0.7286821705426356,82,47,35,183.82910696120726,0.47890395382821865,0.7556653034117891,0.10394191855143815,1039715.9661287904,-8623.98849064727,1031091.9776381431,1315,0,263.91584158415844,81,121,37,40.39774048603841,0.5374381188118812,45.08384146341463,8157.317073170716,100.7076181872928,8
1336,32,4,1,205,0.019417475728155338,0.0048543689320388345,0.9951456310679612,206,6750,4600,2150,0.6814814814814815,89,46,43,211.5192309363399,0.4792747059752151,0.7845191439168002,0.11941349602298651,1039231.5782334971,-3986.5071614588373,1035245.0710720383,1316,0,259.7718446601942,79,127,30,39.75251835010813,0.5356492718446602,45.143229166666636,8155.416666666588,103.2331223628682,8
1337,32,2,0,207,0.00966183574879227,0.0,1.0,207,7250,5600,1650,0.7724137931034483,89,56,33,228.3862901948973,0.47922040867376453,0.8022803097889304,0.1304370332146537,1042840.5600189002,-1015.9026465030511,1041824.6573723971,1317,0,259.4830917874396,68,139,31,38.87040979244281,0.5383957326892109,44.70108695652173,8169.565217391277,120.14066496163642,0
1338,32,4,1,210,0.018957345971563982,0.004739336492890996,0.995260663507109,211,7200,5100,2100,0.7083333333333334,93,51,42,219.89941274144743,0.4795080117354999,0.798996704539191,0.12697812886156543,1046246.3480349705,-3386.2084968452236,1042860.1395381253,1318,0,255.54502369668248,75,136,36,38.66137151381967,0.5413210900473934,44.284539473684205,8182.894736842091,109.10526315789456,0
1339,32,2,2,210,0.009433962264150943,0.009433962264150943,0.9905660377358491,212,6800,4500,2300,0.6617647058823529,91,45,46,219.16292431278362,0.4792579510566634,0.8002868822082276,0.12322858161889365,1037963.2705495862,-3703.386859418645,1034259.8836901676,1319,0,253.42924528301887,75,137,39,39.716687743277895,0.5300707547169812,45.2987938596491,8150.43859649118,108.67251461988239,8
1340,32,2,3,209,0.009433962264150943,0.014150943396226415,0.9858490566037735,212,7400,5000,2400,0.6756756756756757,98,50,48,231.34505729417688,0.47950106560553224,0.8055490019528715,0.12735486308103483,1031292.6375700751,-2083.1091348575583,1029209.5284352176,1320,0,254.35377358490567,83,129,34,40.245129764405135,0.5206367924528301,46.11855158730159,8124.206349206355,97.88200420730549,8
1341,32,4,3,210,0.018779342723004695,0.014084507042253521,0.9859154929577465,213,7300,5300,2000,0.726027397260274,93,53,40,230.20747660391734,0.4803975846694422,0.8138687462064906,0.12504321744068864,1027032.1073388206,-2613.906035665308,1024418.2013031553,1321,0,253.5962441314554,62,151,41,40.8110628902086,0.5131064162754304,46.64351851851852,8107.40740740741,130.7646356033453,8
1342,32,3,0,213,0.014084507042253521,0.0,1.0,213,7600,5700,1900,0.75,95,57,38,218.91872943305364,0.4813323072607553,0.8040711454137071,0.11619954086678168,1019619.1043083953,-5557.25623582725,1014061.8480725681,1322,0,249.5868544600939,69,144,36,42.03312897901442,0.5035700312989045,47.55952380952383,8078.09523809528,117.07384403036639,8
1343,32,7,5,215,0.031818181818181815,0.022727272727272728,0.9772727272727273,220,7200,5300,1900,0.7361111111111112,91,53,38,192.8527989866037,0.48189774456897744,0.7863352420614256,0.10382605083785804,1024186.6517850606,-11696.547503706544,1012490.1042813541,1323,0,242.61363636363637,86,134,39,42.11545438770841,0.5117424242424242,46.99473180076629,8096.168582375492,94.14149514390107,7
1344,32,5,4,216,0.022727272727272728,0.01818181818181818,0.9818181818181818,220,7100,5100,2000,0.7183098591549296,91,51,40,204.0844311134924,0.4819967656012176,0.7926421152717091,0.11024591822145031,1025273.4408489789,-9251.530617712608,1016021.9102312663,1324,0,243.4090909090909,71,149,40,41.69434998380674,0.5133996212121212,46.860532407407405,8100.462962962956,114.09102764736558,8
1345,32,3,2,217,0.0136986301369863,0.0091324200913242,0.9908675799086758,219,5850,4100,1750,0.7008547008547008,76,41,35,204.49895556925566,0.48247873989359474,0.7923921020883813,0.11154872253507854,1028378.350189479,-7589.540291243628,1020788.8098982354,1325,0,242.15068493150685,75,144,42,41.29301373195658,0.5165525114155252,46.477521929824555,8112.7192982455945,108.16959064327459,0
1346,32,4,6,215,0.01809954751131222,0.027149321266968326,0.9728506787330317,221,7350,5100,2250,0.6938775510204082,96,51,45,181.34514925069323,0.48261346496640617,0.7734156282482509,0.10231484567136788,1039036.4935437997,-13865.15440027678,1025171.3391435229,1326,0,239.8054298642534,85,136,41,40.54588106215437,0.5285633484162896,45.167151162790674,8154.651162790637,95.93707250341926,8
1347,32,3,1,217,0.013761467889908258,0.0045871559633027525,0.9954128440366973,218,7150,5300,1850,0.7412587412587412,90,53,37,182.3858671458644,0.48232385955269946,0.7725388888029094,0.10348675172110082,1040806.5614497904,-12784.318551775352,1028022.2428980151,1327,0,243.59633027522935,91,127,44,40.2984329219568,0.5309155198776758,44.95018115942026,8161.59420289847,89.68784838349967,0
1348,32,4,3,218,0.01809954751131222,0.013574660633484163,0.9864253393665159,221,7150,5400,1750,0.7552447552447552,89,54,35,177.80735874663196,0.4827223022075963,0.7694203219160494,0.10185843530622643,1043781.7559357526,-14231.584573828291,1029550.1713619244,1328,0,241.21719457013575,80,141,45,40.044454794152706,0.5341251885369532,44.58590534979425,8173.251028806619,102.16563786008274,0
1349,32,1,1,218,0.0045662100456621,0.0045662100456621,0.995433789954338,219,5500,3600,1900,0.6545454545454545,74,36,38,174.17325020517927,0.4825049222906455,0.760678905742781,0.09986260097679539,1044048.9770326341,-12930.919259366448,1031118.0577732676,1329,0,243.87671232876713,82,137,48,40.10401313419147,0.536101598173516,44.55321285140564,8174.297188755065,99.68655108237884,8
1350,32,3,5,216,0.013574660633484163,0.02262443438914027,0.9773755656108597,221,8100,6600,1500,0.8148148148148148,96,66,30,174.71857573105618,0.4824977718360071,0.7620242354471796,0.10118645890161639,1047154.8847596237,-15708.517992996109,1031446.3667666275,1330,0,242.54298642533936,90,131,47,39.703771235103716,0.5392156862745099,44.173534798534796,8186.446886446885,90.96052096052095,0
1351,32,1,2,215,0.004608294930875576,0.009216589861751152,0.9907834101382489,217,6300,4300,2000,0.6825396825396826,83,43,40,207.11867531913322,0.48199618108892306,0.7922478656746643,0.11772009819898545,1041336.1655549814,-6563.966565669879,1034772.1989893116,1331,0,246.8294930875576,88,129,39,39.601397745867146,0.5325940860215054,44.88529962546813,8163.6704119849155,92.76898195437404,8
1352,32,3,2,216,0.013761467889908258,0.009174311926605505,0.9908256880733946,218,7400,5500,1900,0.7432432432432432,93,55,38,193.0135724799764,0.48191649403176484,0.775873478760553,0.10892041356095195,1039100.4060938023,-10887.903690888532,1028212.5024029138,1332,0,246.61009174311926,84,134,37,40.24054259838102,0.5288608562691132,45.15931372549017,8154.901960784252,97.08216619981252,8
1353,32,4,4,216,0.01818181818181818,0.01818181818181818,0.9818181818181818,220,7200,5200,2000,0.7222222222222222,92,52,40,208.3931608709577,0.48218875397813754,0.7951118561595056,0.11912623972175687,1043121.7777777814,-7724.11111111088,1035397.6666666705,1333,0,245.31363636363636,74,146,39,39.34569462576156,0.5320549242424242,44.66666666666668,8170.666666666695,110.4144144144148,0
1354,32,1,4,213,0.004608294930875576,0.018433179723502304,0.9815668202764977,217,6950,4600,2350,0.6618705035971223,93,46,47,209.17879654712112,0.4821295229561358,0.7914273286773497,0.12019300579977925,1044719.8594674646,-6643.35141354322,1038076.5080539214,1334,0,248.56221198156683,77,140,42,39.12603219400025,0.5347542242703534,44.471153846153875,8176.923076923148,106.19380619380712,0
1355,32,4,3,214,0.018433179723502304,0.013824884792626729,0.9861751152073732,217,6450,4800,1650,0.7441860465116279,81,48,33,200.30454928017645,0.48240242931103144,0.7831627814118269,0.1161602919565053,1047569.097804373,-7883.428804890527,1039685.6689994825,1335,0,249.24884792626727,80,137,38,38.997608517196916,0.5372983870967742,44.1229423868313,8188.065843621456,102.3508230452682,0
1356,32,1,1,214,0.004651162790697674,0.004651162790697674,0.9953488372093023,215,6600,4900,1700,0.7424242424242424,83,49,34,203.99638932788827,0.482044664203434,0.7832757484971207,0.11895757050798211,1049271.269684888,-6790.489911758422,1042480.7797731295,1336,0,252.32093023255814,81,134,41,38.69110364270716,0.5390988372093024,43.9151422764228,8194.71544715456,101.16932650808099,0
1357,32,1,6,209,0.004651162790697674,0.027906976744186046,0.9720930232558139,215,6350,4800,1550,0.7559055118110236,79,48,31,237.30619337975097,0.4823190610736796,0.8041902627949145,0.13290386026098236,1036723.5068498565,-145.81820043130574,1036577.6886494252,1337,0,253.28372093023256,78,137,35,39.41034274367605,0.5253875968992248,45.45094936708858,8145.569620253106,104.43037974683469,8
1358,32,5,6,208,0.02336448598130841,0.028037383177570093,0.9719626168224299,214,6950,4800,2150,0.6906474820143885,91,48,43,238.04283666152327,0.48225999297968497,0.8095883722427044,0.13498496972551408,1040617.4532217039,-207.69391112350968,1040409.7593105803,1338,0,254.96728971962617,85,129,35,38.90262605873504,0.529595015576324,44.97335271317827,8160.852713178234,96.01003191974392,0
1359,32,3,4,207,0.014218009478672985,0.018957345971563982,0.981042654028436,211,7650,5800,1850,0.7581699346405228,95,58,37,243.26257356377917,0.4820525840668021,0.8174158231088058,0.13825021507486113,1041306.8641975346,812.1975308644251,1042119.061728399,1339,0,258.73933649289097,74,137,37,38.68299034552844,0.5295221169036335,44.8888888888889,8163.555555555586,110.31831831831873,8
1360,32,0,4,203,0.0,0.01932367149758454,0.9806763285024155,207,8050,6200,1850,0.7701863354037267,99,62,37,242.25088514821465,0.48158798836827543,0.8126130896010784,0.13837572073489487,1042886.0987836977,1078.0161078240217,1043964.1148915217,1340,1,261.8309178743961,64,143,34,38.51073902035864,0.5323067632850241,44.69551282051283,8169.743589743612,127.65224358974393,0
1361,32,1,2,202,0.004901960784313725,0.00980392156862745,0.9901960784313726,204,6750,5000,1750,0.7407407407407407,85,50,35,244.08438065480692,0.48148785376219455,0.8111200744196856,0.1401148210652493,1044422.0615243383,3435.4224058772306,1047857.4839302156,1341,0,265.25,65,139,40,38.27140474425499,0.5343137254901961,44.50757575757577,8175.757575757609,125.7808857808863,0
1362,32,2,0,204,0.00980392156862745,0.0,1.0,204,6950,4700,2250,0.6762589928057554,92,47,45,241.18740474754068,0.4812604639556972,0.8076554735929995,0.1394648153076202,1046676.6022190052,2739.042659835198,1049415.6448788405,1342,0,265.9313725490196,66,138,41,38.063162320426336,0.5365604575163399,44.23196517412936,8184.577114427867,124.00874415799798,0
1363,32,7,7,204,0.03317535545023697,0.03317535545023697,0.966824644549763,211,6550,3900,2650,0.5954198473282443,92,39,53,248.40516698426444,0.48194726547807115,0.8277671548281733,0.1462671084275588,1052245.5957276353,3526.6485830358647,1055772.2443106712,1343,0,258.07582938388623,57,154,38,37.182152695100044,0.5369766982622433,43.55244252873562,8206.32183908043,143.97055858035844,8
1364,32,1,0,205,0.004878048780487805,0.0,1.0,205,5850,4000,1850,0.6837606837606838,77,40,37,236.0033953501743,0.4809162282799298,0.8133951879128434,0.1343522597058838,1041834.8693847675,2325.3133138021585,1044160.1826985696,1344,0,266.5658536585366,63,142,43,38.80198367138667,0.5211382113821138,44.82421875000001,8165.625000000015,129.61309523809547,7
1365,32,3,2,206,0.014423076923076924,0.009615384615384616,0.9903846153846154,208,7150,5400,1750,0.7552447552447552,89,54,35,227.49169794509112,0.4813668052458813,0.8082102865721352,0.13061131176724702,1044472.830630955,-1228.220460449657,1043244.6101705054,1345,0,263.7067307692308,60,148,46,38.688984315822275,0.5239883814102564,44.501366120218584,8175.956284153019,136.265938069217,0
1366,32,1,1,206,0.004830917874396135,0.004830917874396135,0.9951690821256038,207,6650,4700,1950,0.706766917293233,86,47,39,233.50130297528887,0.48109063052076984,0.8112599681638191,0.134789842357439,1046148.903371254,805.4264086713356,1046954.3297799253,1346,0,265.7826086956522,60,147,42,38.32573683273229,0.5254126409017713,44.296448087431685,8182.513661202168,136.3752276867028,0
1367,32,4,1,209,0.01904761904761905,0.004761904761904762,0.9952380952380953,210,8300,6600,1700,0.7951807228915663,100,66,34,255.99595648911298,0.48145505809979494,0.8270603388242832,0.14706920117408046,1044667.8599423344,3186.149603874671,1047854.009546209,1347,0,262.9,62,148,35,37.93624088693329,0.5300099206349207,44.47751322751324,8176.719576719604,131.88257381805815,8
1368,32,1,1,209,0.004761904761904762,0.004761904761904762,0.9952380952380953,210,6850,4900,1950,0.7153284671532847,88,49,39,242.7414193991758,0.48130363788258523,0.8177150499116397,0.13892835541962037,1043495.7420720251,1809.9275135120188,1045305.669585537,1348,0,263.8857142857143,60,150,37,38.42179315724954,0.5273809523809524,44.62090163934427,8172.131147540995,136.20218579234992,8
1369,32,3,5,207,0.014150943396226415,0.02358490566037736,0.9764150943396226,212,6550,4100,2450,0.6259541984732825,90,41,49,206.23483863455488,0.4815321432829593,0.7865566037735845,0.11882057961940132,1045552.3090658258,-5824.137651164496,1039728.1714146612,1349,0,262.1839622641509,73,139,46,39.09737518355361,0.5346403301886793,44.36936936936938,8180.180180180206,112.0572627421946,8
1370,32,3,2,208,0.014285714285714285,0.009523809523809525,0.9904761904761905,210,7200,5000,2200,0.6944444444444444,94,50,44,217.0027797620313,0.481271834890256,0.7984312430095561,0.12460599869354386,1044514.507685455,-3867.489666097257,1040647.0180193578,1350,0,265.3619047619048,66,144,39,38.95176666261003,0.5315972222222223,44.496268656716424,8176.1194029850885,123.88059701492558,8
1371,32,0,7,201,0.0,0.03365384615384615,0.9663461538461539,208,6250,4400,1850,0.704,81,44,37,219.18966558331988,0.4811664847330608,0.798841942728804,0.12617220245762542,1045277.3446201837,-2027.2016781763186,1043250.1429420074,1351,1,268.47115384615387,66,142,41,38.80056265206811,0.533203125,44.40298507462687,8179.104477611949,123.92582541836286,0
1372,32,1,1,201,0.0049504950495049506,0.0049504950495049506,0.995049504950495,202,5750,3900,1850,0.6782608695652174,76,39,37,216.6063481495282,0.4803124435577886,0.7914474632085051,0.12537640928072685,1046985.3879817857,-793.2637086697532,1046192.1242731159,1352,0,275.43564356435644,67,135,43,38.653325049404195,0.5353238448844885,44.19424019607843,8185.784313725489,122.1758852794849,0
1373,32,1,1,201,0.0049504950495049506,0.0049504950495049506,0.995049504950495,202,5800,3900,1900,0.6724137931034483,77,39,38,217.98019868504986,0.48022726712969804,0.7904955269966858,0.12680052118716,1048517.0049450486,-488.810987484866,1048028.1939575637,1353,0,273.9257425742574,80,122,36,38.42706554137777,0.5440903465346535,44.00720164609054,8191.769547325126,102.39711934156408,8
1374,32,3,5,199,0.014705882352941176,0.024509803921568627,0.9754901960784313,204,6700,5000,1700,0.746268656716418,84,50,34,218.3309466851467,0.4802568297433916,0.793135614764517,0.12835282945800114,1051755.8188256896,-1573.8312788351714,1050181.9875468544,1354,0,270.4852941176471,67,137,37,38.01439176674434,0.5475388071895425,43.61213235294117,8204.411764705863,122.4539069359084,0
1375,32,0,0,199,0.0,0.0,1.0,199,6550,4900,1650,0.7480916030534351,82,49,33,201.40716685580162,0.47937287447337695,0.7678297237499456,0.11702169987135265,1048153.8670552579,-4128.859841489108,1044025.0072137688,1355,1,276.2462311557789,75,124,39,38.89654956981183,0.5423471524288107,44.05153508771933,8190.350877193063,109.20467836257417,8
1376,32,2,0,201,0.009950248756218905,0.0,1.0,201,6300,4600,1700,0.7301587301587301,80,46,34,211.2398488943384,0.4795501658374793,0.7820466619274891,0.1234250533798138,1049877.7370876765,-2144.797092013766,1047732.9399956628,1356,0,274.4875621890547,79,122,39,38.43005006862198,0.5452943615257049,43.84114583333334,8197.083333333358,103.76054852320706,8
1377,32,2,3,200,0.009852216748768473,0.014778325123152709,0.9852216748768473,203,5650,3700,1950,0.6548672566371682,76,37,39,209.08999464108604,0.4797600757612707,0.7810464410744695,0.1237475339395671,1053803.1477144037,-2182.061098327226,1051621.0866160765,1357,0,272.7733990147783,77,126,41,37.99668479297843,0.5506465517241379,43.36271367521367,8212.393162393148,106.65445665445647,8
1378,32,2,2,200,0.009900990099009901,0.009900990099009901,0.9900990099009901,202,6350,4400,1950,0.6929133858267716,83,44,39,205.03560644782408,0.4797198003382428,0.7781617688535796,0.12219971613407547,1055929.674842876,-3449.363750467748,1052480.3110924081,1358,0,274.85643564356434,78,124,37,37.83661824838746,0.5532178217821782,43.10390295358647,8220.675105485163,105.39327058314312,0
1379,32,1,5,196,0.004975124378109453,0.024875621890547265,0.9751243781094527,201,7350,5500,1850,0.7482993197278912,92,55,37,188.8489441845871,0.4792993366500829,0.7572944599812472,0.10730322177912494,1041240.6191698503,-8222.56168553389,1033018.0574843164,1359,0,276.4029850746269,88,113,38,40.079410595216224,0.5388163349917081,44.89700374531833,8163.295880149752,92.76472591079263,8
1380,32,3,1,198,0.01507537688442211,0.005025125628140704,0.9949748743718593,199,6550,4300,2250,0.6564885496183206,88,43,45,199.12220114308673,0.4791116779182106,0.7661875966653509,0.11427249805874558,1044334.9636501753,-4759.944661458307,1039575.018988717,1360,0,277.2613065326633,79,120,38,39.431019910639975,0.541928391959799,44.51822916666667,8175.41666666668,103.48628691983139,0
1381,32,3,4,197,0.014925373134328358,0.01990049751243781,0.9800995024875622,201,5600,4000,1600,0.7142857142857143,72,40,32,214.69962102558142,0.4795553482587065,0.7843641522941158,0.12354669397517686,1045174.9105152627,-920.2685613853828,1044254.6419538774,1361,0,273.7562189054726,71,130,40,38.92811992905393,0.5443615257048093,44.41550925925927,8178.703703703721,115.19300991132,8
1382,32,2,4,195,0.010050251256281407,0.020100502512562814,0.9798994974874372,199,5900,3700,2200,0.6271186440677966,81,37,44,206.84363784398477,0.4790736087846641,0.7724770323814101,0.11983837280044338,1047275.880045046,-2375.5294290442944,1044900.3506160016,1362,0,270.8894472361809,78,121,37,38.86684189730111,0.5468488274706867,44.158755274261615,8186.919831223655,104.96051065671352,0
1383,32,4,3,196,0.020100502512562814,0.01507537688442211,0.9849246231155779,199,5650,3800,1850,0.672566371681416,75,38,37,206.96437888302404,0.47947016225910694,0.7750753374890518,0.12085653815804429,1049698.999310498,-1999.9397187140976,1047699.0595917838,1363,0,271.3969849246231,82,117,42,38.561827298414116,0.5491520100502513,43.862951807228924,8196.385542168697,99.95592124595971,0
1384,32,2,1,197,0.010101010101010102,0.005050505050505051,0.9949494949494949,198,6200,4600,1600,0.7419354838709677,78,46,32,208.1743223693617,0.4788745107590285,0.7769997723821154,0.12224032335224715,1051401.658631767,-2025.0344352620587,1049376.624196505,1364,0,273.55555555555554,65,133,44,38.31886467183845,0.5508733164983165,43.65530303030301,8203.03030303026,126.20046620046554,0
1385,32,1,6,192,0.005050505050505051,0.030303030303030304,0.9696969696969697,198,4900,3300,1600,0.673469387755102,65,33,32,210.7265305385738,0.4787388478695585,0.7755233946887727,0.12238785032177556,1048031.6655984683,-330.3846427742046,1047701.280955694,1365,0,274.3686868686869,78,120,36,38.673256912244575,0.548348063973064,44.06645569620255,8189.87341772157,104.99837715027654,8
1386,32,1,1,192,0.0051813471502590676,0.0051813471502590676,0.9948186528497409,193,6750,5100,1650,0.7555555555555555,84,51,33,189.06422281183902,0.47809733916234887,0.7445670458620217,0.1067266050639452,1039202.6174385841,-6054.792957989296,1033147.8244805948,1366,0,279.1658031088083,87,106,36,40.32841771172006,0.5378346286701209,45.14678030303028,8155.30303030298,93.73911529083885,8
1387,32,1,2,191,0.0051813471502590676,0.010362694300518135,0.9896373056994818,193,6150,4600,1550,0.7479674796747967,77,46,31,194.96187019117548,0.4781895419545193,0.7538964732182651,0.11064575671910659,1040872.2758058924,-4163.918895747936,1036708.3569101444,1367,0,280.1502590673575,89,104,40,39.96947368819107,0.5399935233160622,44.94212962962961,8161.851851851804,91.70620058260454,0
1388,32,4,3,192,0.020512820512820513,0.015384615384615385,0.9846153846153847,195,5950,4600,1350,0.773109243697479,73,46,27,182.48977184933588,0.4781137104590713,0.7383962370034787,0.10446396279211426,1043553.605658009,-6862.428118183592,1036691.1775398253,1368,0,276.98974358974357,81,114,44,39.953284586815236,0.5428952991452991,44.613821138211385,8172.357723577245,100.89330522934871,0
1389,32,2,1,193,0.010309278350515464,0.005154639175257732,0.9948453608247423,194,6150,4600,1550,0.7479674796747967,77,46,31,184.3488344566225,0.4779937414311914,0.7401763760875959,0.10613961384971829,1045343.9547115173,-6408.412068531012,1038935.5426429863,1369,0,277.57216494845363,83,111,46,39.68278996054078,0.5452104810996563,44.39484126984128,8179.365079365103,98.5465672212663,0
1390,32,3,4,192,0.015306122448979591,0.02040816326530612,0.9795918367346939,196,6600,4900,1700,0.7424242424242424,83,49,34,180.18216613570303,0.47804160125588696,0.7380485891567423,0.10457337583054459,1047812.0179960177,-8040.592178890831,1039771.4258171269,1370,0,274.68367346938777,87,109,39,39.48229373853253,0.5477253401360545,44.09327651515154,8189.015151515203,94.12661093695635,0
1391,32,0,1,191,0.0,0.005208333333333333,0.9947916666666666,192,6400,4800,1600,0.75,80,48,32,198.4352166537534,0.477640184155032,0.7584479279488372,0.11440560260777947,1045765.1267825669,-3296.6740995922883,1042468.4526829746,1371,1,280.4010416666667,78,114,39,39.270226245121805,0.5426974826388888,44.34335443037975,8181.012658227848,104.88477766958779,8
1392,32,8,2,197,0.04020100502512563,0.010050251256281407,0.9899497487437185,199,5800,3800,2000,0.6551724137931034,78,38,40,189.2028659419725,0.4787933776627244,0.7585444624514679,0.10931157536325833,1046412.4589408824,-6003.152762199398,1040409.306178683,1372,0,271.2211055276382,78,121,48,39.42564664432413,0.541928391959799,44.26424050632914,8183.544303797528,104.91723466407088,8
1393,32,4,4,197,0.01990049751243781,0.01990049751243781,0.9800995024875622,201,6600,4700,1900,0.7121212121212122,85,47,38,197.0462454310673,0.4794444444444444,0.7702662213147271,0.11336998884767426,1045125.0895708326,-5612.405018851816,1039512.6845519807,1373,0,269.46268656716416,75,126,44,39.38552448114977,0.5363805970149254,44.42160087719299,8178.508771929849,109.04678362573132,8
1394,32,4,4,197,0.01990049751243781,0.01990049751243781,0.9800995024875622,201,5950,4400,1550,0.7394957983193278,75,44,31,201.77798583287358,0.4795553482587065,0.7652258403145429,0.1141591711016005,1039903.430052314,-4184.076084669851,1035719.3539676442,1374,0,270.363184079602,88,113,38,39.91675083402195,0.5322864842454395,45.06086142322095,8158.052434456863,92.70514130064618,8
1395,32,3,2,198,0.015,0.01,0.99,200,6100,3900,2200,0.639344262295082,83,39,44,177.68773080818744,0.47935929648241205,0.7452064159174352,0.09884570216044637,1034601.6080330153,-9332.797595622531,1025268.8104373928,1375,0,272.41,76,124,42,41.19318685605862,0.5277083333333333,45.71158008658007,8137.229437229396,107.06880838459732,8
1396,32,2,5,195,0.01,0.025,0.975,200,5750,3600,2150,0.6260869565217392,79,36,43,204.26103272572988,0.4792101130653266,0.7685956500247157,0.1124714396309615,1031366.681585783,-3616.395300075663,1027750.2862857074,1376,0,273.355,82,118,38,40.92344290657441,0.5221354166666667,46.10943775100402,8124.497991967888,99.07924380448644,8
1397,32,4,1,198,0.020100502512562814,0.005025125628140704,0.9949748743718593,199,5100,3200,1900,0.6274509803921569,70,32,38,207.8049341011776,0.47965839297497587,0.771945237699663,0.11554274343623692,1034446.5693810739,-1907.3797637153657,1032539.1896173586,1377,0,275.4070351758794,70,129,42,40.446790914161525,0.5249685929648241,45.7306338028169,8136.619718309849,116.23742454728357,0
1398,32,4,1,201,0.019801980198019802,0.0049504950495049506,0.995049504950495,202,5850,4100,1750,0.7008547008547008,76,41,35,218.11938588778628,0.4798716811979706,0.7856673665875693,0.12066274481173943,1032841.0525711768,-1193.4687786955092,1031647.5837924812,1378,0,272.2277227722772,87,115,38,40.386228102869964,0.5211427392739274,45.92803030303033,8130.303030303115,93.45175896900132,8
1399,32,4,4,201,0.01951219512195122,0.01951219512195122,0.9804878048780488,205,6150,4300,1850,0.6991869918699187,80,43,37,208.20731782592122,0.48011318348477605,0.7874589432942865,0.11748418606802975,1039073.0261306104,-3881.4784408162886,1035191.5476897941,1379,0,269.1756097560976,72,133,43,39.856771562424164,0.5273373983739837,45.162671232876725,8154.794520547979,113.26103500761081,8
1400,32,2,3,200,0.009852216748768473,0.014778325123152709,0.9852216748768473,203,6100,4500,1600,0.7377049180327869,77,45,32,208.2481891734106,0.4799206213724821,0.7840446382589288,0.11839742801691758,1041429.2017736277,-3324.8509156661526,1038104.3508579615,1380,0,272.5615763546798,75,128,47,39.56094874825402,0.5301724137931034,44.873903508771946,8164.035087719338,108.85380116959116,0
1401,32,4,4,200,0.0196078431372549,0.0196078431372549,0.9803921568627451,204,5750,4100,1650,0.7130434782608696,74,41,33,214.23512305642672,0.4803468801313629,0.7903816770617704,0.12057583279185596,1038270.1052756347,-2063.215246092806,1036206.8900295419,1381,0,271.88235294117646,70,134,42,39.80374935207049,0.5253267973856209,45.261150234741805,8151.643192488311,116.45204560697587,8
1402,32,2,8,194,0.009900990099009901,0.039603960396039604,0.9603960396039604,202,6600,4700,1900,0.7121212121212122,85,47,38,221.46543174299057,0.48032783688816644,0.7956545962236896,0.12585375043551175,1041285.1196805781,-878.2682804776446,1040406.8514001005,1382,0,274.4257425742574,72,130,40,39.241782264981175,0.5283106435643564,44.89155251141554,8163.470319634737,113.38153221714913,0
1403,32,1,3,192,0.005128205128205128,0.015384615384615385,0.9846153846153847,195,7300,5800,1500,0.7945205479452054,88,58,30,218.4713849121386,0.4791082914794255,0.785959865101431,0.12505603412212063,1043540.8284023661,-703.2380013150096,1042837.5904010511,1383,0,281.0615384615385,64,131,41,39.035961554551506,0.5315705128205128,44.61538461538461,8172.307692307687,127.69230769230761,0
1404,32,1,2,191,0.0051813471502590676,0.010362694300518135,0.9896373056994818,193,4450,2700,1750,0.6067415730337079,62,27,35,198.84374740760336,0.47867754209844554,0.764367880871079,0.11257459018897863,1040113.0068074055,-1686.0063998051169,1038427.0004076004,1384,0,284.51295336787564,76,117,38,39.965356997576976,0.5286053540587219,45.03517316017316,8158.874458874453,107.35361130097965,8
1405,32,1,3,189,0.005208333333333333,0.015625,0.984375,192,5550,4000,1550,0.7207207207207207,71,40,31,227.452571022752,0.47871105111983714,0.7871986750797455,0.12882250369589773,1040236.9926867713,3370.9156919166458,1043607.9083786879,1385,0,286.5572916666667,72,120,40,39.22039099371349,0.5277777777777778,45.01997716894979,8159.3607305936475,113.32445459157844,7
1406,32,3,3,189,0.015625,0.015625,0.984375,192,5600,3800,1800,0.6785714285714286,74,38,36,227.2444002175185,0.47965068717277487,0.790276176866882,0.12462627601814948,1030094.8759040124,2816.658448389357,1032911.5343524017,1386,0,286.75,64,128,40,40.500063159224425,0.515625,46.26602564102565,8119.487179487194,126.86698717948741,8
1407,32,4,1,192,0.02072538860103627,0.0051813471502590676,0.9948186528497409,193,7100,5000,2100,0.704225352112676,92,50,42,242.40343881953038,0.4801123074985607,0.8019736396979906,0.1375689415368295,1040869.7898632269,4762.083285241635,1045631.8731484686,1387,0,285.1139896373057,75,118,36,38.759751106095635,0.5307102763385148,44.942434210526315,8161.842105263156,108.82456140350874,8
1408,32,3,6,189,0.015384615384615385,0.03076923076923077,0.9692307692307692,195,6100,4300,1800,0.7049180327868853,79,43,36,226.38470024285434,0.4804057626222575,0.7847778118296058,0.12855782751347544,1041063.5203912958,2036.1705995105185,1043099.6909908063,1388,0,283.174358974359,81,114,37,39.14404880478084,0.5356303418803419,44.91869918699185,8162.601626016215,100.7728595804471,8
1409,32,8,2,195,0.04060913705583756,0.01015228426395939,0.9898477157360406,197,6250,4100,2150,0.656,84,41,43,201.64517417653468,0.48074324907628024,0.7696630725891429,0.11610639681852432,1045366.1861981692,-3491.390661161787,1041874.7955370075,1389,0,279.7005076142132,72,125,46,39.23791380561603,0.5356916243654822,44.39212328767126,8179.452054794586,113.60350076103592,8
1410,32,1,1,195,0.00510204081632653,0.00510204081632653,0.9948979591836735,196,4650,2800,1850,0.6021505376344086,65,28,37,194.65098346719316,0.48075614861329147,0.7592093441150047,0.1125772145884507,1046736.2001281917,-3100.3538428666134,1043635.8462853251,1390,0,282.06632653061223,78,118,49,39.24599185483043,0.537733843537415,44.22468354430382,8184.810126582335,104.93346316131199,0
1411,32,2,5,192,0.01015228426395939,0.025380710659898477,0.9746192893401016,197,6250,4500,1750,0.72,80,45,35,195.982381364728,0.48108964397941917,0.7635197338227966,0.1143669561484137,1049493.2768221544,-4513.561676424253,1044979.7151457302,1391,0,281.4213197969543,82,115,40,38.868709266428205,0.5397102368866329,43.88805220883536,8195.58232931732,99.94612596728439,0
1412,32,0,6,186,0.0,0.03125,0.96875,192,7050,5100,1950,0.723404255319149,90,51,39,197.003605201105,0.47997166321262363,0.7595877747479756,0.11530942300946895,1050416.6769945174,-4062.825533742888,1046353.8514607745,1392,1,288.1875,81,111,41,38.72768963807636,0.54248046875,43.77540650406505,8199.186991869949,101.22453076382652,0
1413,32,0,1,185,0.0,0.005376344086021506,0.9946236559139785,186,5750,3700,2050,0.6434782608695652,78,37,41,201.8211245851748,0.47852610675191315,0.7589697493842922,0.11816781904379957,1050516.880418916,-546.7003596288714,1049970.1800592872,1393,2,297.93548387096774,78,108,43,38.59178545086537,0.5433467741935484,43.763185654008446,8199.578059071744,105.12279562912492,0
1414,32,1,2,184,0.005376344086021506,0.010752688172043012,0.989247311827957,186,5250,3900,1350,0.7428571428571429,66,39,27,207.00008708682773,0.4784679841131454,0.7649497965160961,0.11735050640882168,1040534.2148545743,628.1346183442779,1041162.3494729185,1394,0,298.28494623655916,75,111,41,39.70470995019529,0.5314740143369175,44.98355263157896,8160.526315789502,108.80701754386003,8
1415,32,5,1,188,0.026455026455026454,0.005291005291005291,0.9947089947089947,189,6600,4500,2100,0.6818181818181818,87,45,42,221.67843643475715,0.4793578089234118,0.7746863240483117,0.12550539614119946,1040120.5667104562,1714.4601864016195,1041835.0268968578,1395,0,294.26984126984127,72,117,39,39.38220561898366,0.5295414462081129,45.03424657534248,8158.9041095890725,113.31811263318156,8
1416,32,0,4,184,0.0,0.02127659574468085,0.9787234042553191,188,6350,4200,2150,0.6614173228346457,85,42,43,222.3173098331755,0.47917318523153946,0.7763185135652866,0.12652699345757062,1041751.1233085279,2369.861449928416,1044120.9847584562,1396,1,296.75,72,116,43,39.16170357528987,0.5315270390070922,44.83447488584477,8165.296803653018,113.40690005073637,0
1417,32,2,3,183,0.010752688172043012,0.016129032258064516,0.9838709677419355,186,7700,6200,1500,0.8051948051948052,92,62,30,224.64335499924042,0.4790873534825148,0.7791534666715856,0.1272516925156146,1040286.66975309,1838.6975308643878,1042125.3672839544,1397,0,300.60752688172045,74,112,36,39.28579534106796,0.5319780465949822,45.0138888888889,8159.555555555585,110.26426426426465,8
1418,32,0,1,182,0.0,0.00546448087431694,0.994535519125683,183,5850,4300,1550,0.7350427350427351,74,43,31,222.989151039429,0.47923422206209093,0.7743381443012278,0.12700686428767535,1041990.2175746381,4020.5028016719616,1046010.72037631,1398,1,297.57923497267757,76,107,38,39.11462750918859,0.5338683970856102,44.80519480519482,8166.233766233805,107.45044429255006,0
1419,32,1,1,182,0.00546448087431694,0.00546448087431694,0.994535519125683,183,7050,5300,1750,0.75177304964539,88,53,35,225.15362331139158,0.47887642867151065,0.7751382580499915,0.12923330394258145,1044387.3952686843,3379.5212370982576,1047766.9165057825,1399,0,298.4972677595628,66,117,37,38.759406884520985,0.5369421675774135,44.51181592039802,8175.621890547286,123.87305894768615,0
1420,32,1,1,182,0.00546448087431694,0.00546448087431694,0.994535519125683,183,5900,4200,1700,0.711864406779661,76,42,34,212.04487354804593,0.47894273304109375,0.760482335072638,0.11887077540060431,1037026.3504426028,1479.224269118749,1038505.5747117215,1400,0,299.1639344262295,71,112,41,40.01540272016062,0.5300546448087431,45.41377314814815,8146.759259259272,114.74308815858129,8
1421,32,8,5,185,0.042105263157894736,0.02631578947368421,0.9736842105263158,190,5900,4300,1600,0.7288135593220338,75,43,32,199.1003348771472,0.4795948203842941,0.7537312300925245,0.11325871508585159,1041600.346020751,-2423.404459823646,1039176.9415609274,1401,0,289.0736842105263,84,106,41,39.77295469100223,0.5347587719298246,44.85294117647056,8164.7058823528605,97.19887955181977,0
1422,32,0,1,184,0.0,0.005405405405405406,0.9945945945945946,185,7000,5300,1700,0.7571428571428571,87,53,34,204.1449942173409,0.47848731884057966,0.7531507358440099,0.11648962684382884,1042566.8805122987,-1433.038041324844,1041133.8424709738,1402,1,297.3243243243243,72,113,43,39.52347345668661,0.5364301801801802,44.734589041095916,8168.493150684991,113.45129375951376,0
1423,32,1,1,184,0.005405405405405406,0.005405405405405406,0.9945945945945946,185,4850,3500,1350,0.7216494845360825,62,35,27,203.4457373427275,0.47820089110849984,0.7526914581964994,0.11664865072854666,1044055.9087381379,631.7448360527087,1044687.6535741907,1403,0,298.1837837837838,73,112,42,39.355391616612515,0.538231981981982,44.55236486486489,8174.324324324387,111.97704553869023,0
1424,32,2,0,186,0.010752688172043012,0.0,1.0,186,6050,3800,2250,0.628099173553719,83,38,45,217.39092790472273,0.47844497723529983,0.7723469716707418,0.12199987429903941,1037366.5001417234,1852.8132086168066,1039219.3133503402,1404,0,295.6666666666667,69,117,40,39.83664260806891,0.5273297491039426,45.37202380952381,8148.0952380952385,118.08833678398896,8
1425,32,3,3,186,0.015873015873015872,0.015873015873015872,0.9841269841269842,189,5900,4300,1600,0.7288135593220338,75,43,32,236.62714243693057,0.4789825603212128,0.7923459213067037,0.13103046549912384,1033153.2038795466,5194.418066714898,1038347.6219462615,1405,0,291.95767195767195,73,116,38,39.876698796070606,0.5230379188712522,45.88963963963961,8131.531531531462,111.39084289769126,8
1426,32,1,3,184,0.0053475935828877,0.016042780748663103,0.983957219251337,187,5800,4000,1800,0.6896551724137931,76,40,36,224.40964054184576,0.47850660303221976,0.7837297513923227,0.12238206015636567,1028306.9880696018,2952.4003118734727,1031259.3883814753,1406,0,295.16577540106954,66,121,36,40.79722699210922,0.5197749554367201,46.4863184079602,8112.43781094527,122.91572440826167,7
1427,32,6,4,186,0.031578947368421054,0.021052631578947368,0.9789473684210527,190,6350,4500,1850,0.7086614173228346,82,45,37,233.69074728514013,0.47907094124199384,0.787804910422452,0.1296456433259747,1033741.4571005944,3965.1627218936364,1037706.619822488,1407,0,290.4,64,126,40,39.877293361074315,0.522094298245614,45.8173076923077,8133.846153846175,127.09134615384649,8
1428,32,5,3,188,0.02617801047120419,0.015706806282722512,0.9842931937172775,191,6650,5000,1650,0.7518796992481203,83,50,33,216.05303784195473,0.47893588683751265,0.7753569174373927,0.12134542348736689,1037615.7541366572,-13.99284122104018,1037601.7612954362,1408,0,289.74869109947645,71,120,40,39.839459531113896,0.5326134380453752,45.341435185185176,8149.074074074053,114.77569118414159,8
1429,32,2,2,188,0.010526315789473684,0.010526315789473684,0.9894736842105263,190,5850,4000,1850,0.6837606837606838,77,40,37,217.2234522945805,0.47852385593613667,0.7755391352814724,0.11734611144713694,1025280.334636911,692.9867719141785,1025973.3214088252,1409,0,291.4736842105263,67,123,39,41.360879979828525,0.5157894736842106,46.85968137254899,8100.490196078372,120.90283874743838,8
1430,32,3,4,187,0.015706806282722512,0.020942408376963352,0.9790575916230366,191,6050,4200,1850,0.6942148760330579,79,42,37,209.71319068193415,0.4788291081105906,0.7693955948204678,0.11417571285945105,1027772.3535067906,-1142.5160902824118,1026629.8374165082,1410,0,290.5497382198953,70,121,42,41.237095996140816,0.5180519197207678,46.552230046948324,8110.328638497579,115.86183769282256,0
1431,32,4,4,187,0.020942408376963352,0.020942408376963352,0.9790575916230366,191,5950,4200,1750,0.7058823529411765,77,42,35,227.85927759880704,0.47939744649582067,0.7772141786461315,0.12568346578866288,1031917.3611111082,2876.388888888797,1034793.749999997,1411,0,291.0471204188482,79,112,38,40.254990429313644,0.5226876090750436,46.04166666666666,8126.666666666643,102.869198312236,0
1432,32,3,4,186,0.015789473684210527,0.021052631578947368,0.9789473684210527,190,5650,3700,1950,0.6548672566371682,76,37,39,243.5702267762146,0.47926935394040654,0.7944239602747953,0.13475434746482284,1032869.9245876796,6665.272352430866,1039535.1969401104,1412,0,292.55263157894734,79,111,34,39.735955943900684,0.5227521929824561,45.924479166666686,8130.416666666714,102.91666666666727,6
1433,32,8,2,192,0.041237113402061855,0.010309278350515464,0.9896907216494846,194,5700,4200,1500,0.7368421052631579,72,42,30,228.0010038063679,0.4808125456261239,0.7870214291939934,0.1283400984722815,1038310.5096228012,2847.167691340157,1041157.6773141414,1413,0,287.0257731958763,73,121,40,39.44800933856442,0.5275987972508591,45.2561936936937,8151.801801801824,111.6685178329017,0
1434,32,8,7,193,0.04,0.035,0.965,200,6450,3900,2550,0.6046511627906976,90,39,51,230.6257880215738,0.4818781407035176,0.802448114058834,0.12947289680116922,1037477.0558499136,1403.7927119377173,1038880.8485618513,1414,0,279.32,67,133,38,39.485765204836675,0.5252083333333333,45.35845588235294,8148.529411764706,121.61984196663741,8
1435,32,3,3,193,0.015306122448979591,0.015306122448979591,0.9846938775510204,196,6400,4500,1900,0.703125,83,45,38,216.48634188971909,0.48151000784929354,0.786337376033704,0.1220933057862193,1038913.0316840293,-617.9036458332907,1038295.128038196,1415,0,285.32142857142856,71,125,37,39.66583631408616,0.5285395408163265,45.18229166666667,8154.166666666679,114.84741784037575,8
1436,32,0,2,191,0.0,0.010362694300518135,0.9896373056994818,193,6350,4800,1550,0.7559055118110236,79,48,31,216.12471080975786,0.48095000359815776,0.782932196623906,0.1225895574834276,1040702.7617491294,34.31668438941642,1040737.0784335188,1416,1,290.2953367875648,72,121,38,39.45091758518436,0.5307642487046632,44.962899543378995,8161.187214611871,113.34982242516487,0
1437,32,1,5,187,0.005208333333333333,0.026041666666666668,0.9739583333333334,192,6900,5300,1600,0.7681159420289855,85,53,32,212.74468971261925,0.4805891870273415,0.778507653061224,0.12121499762695787,1042100.694444448,-959.7222222220512,1041140.972222226,1417,0,289.546875,73,119,39,39.362244897959194,0.5326605902777778,44.79166666666668,8166.666666666695,111.87214611872186,0
1438,32,3,0,190,0.015789473684210527,0.0,1.0,190,6200,4600,1600,0.7419354838709677,78,46,32,208.06829616572404,0.47979729416132927,0.7721367025758572,0.12002668643760635,1045938.3368875269,-674.6784698800429,1045263.6584176469,1418,0,288.1578947368421,70,120,42,39.00233832558677,0.5363486842105263,44.322183098591566,8181.690140845107,116.88128772635866,0
1439,32,1,1,190,0.005235602094240838,0.005235602094240838,0.9947643979057592,191,6250,4700,1550,0.752,78,47,31,228.53260631623172,0.4799864517314228,0.7937314296563618,0.13026881517934472,1042240.1572158086,3187.171907193874,1045427.3291230025,1419,0,287.64397905759165,60,131,39,38.941857353138005,0.5327225130890052,44.774590163934455,8167.2131147541495,136.12021857923583,8
1440,32,2,2,190,0.010416666666666666,0.010416666666666666,0.9895833333333334,192,6100,4400,1700,0.7213114754098361,78,44,34,222.16887452022755,0.48025457660703896,0.7890374519608465,0.12761906919477026,1044627.7236938546,1916.7531331384744,1046544.4768269932,1420,0,287.0989583333333,63,129,41,38.80561659978344,0.53466796875,44.48242187500003,8176.5625000000555,129.78670634920724,0
1441,32,1,2,189,0.005235602094240838,0.010471204188481676,0.9895287958115183,191,6850,4800,2050,0.7007299270072993,89,48,41,219.8644914021092,0.4799738219895288,0.7858955699187353,0.12683993005639893,1045958.968268504,943.8473171660271,1046902.8155856701,1421,0,289.5130890052356,63,128,41,38.6981586988351,0.5367582897033158,44.31966145833335,8181.770833333361,129.86937830687876,0
1442,32,4,1,192,0.02072538860103627,0.0051813471502590676,0.9948186528497409,193,6900,4800,2100,0.6956521739130435,90,48,42,218.29200876313004,0.48072624316350027,0.7813893512765813,0.12628935585510875,1046832.1330589805,203.0178326471987,1047035.1508916277,1422,0,287.39896373056996,71,122,40,38.62933634992457,0.5395077720207253,44.21296296296295,8185.18518518515,115.28429838288943,8
1443,32,5,2,195,0.025380710659898477,0.01015228426395939,0.9898477157360406,197,7000,5200,1800,0.7428571428571429,88,52,36,233.93342158297423,0.48104540039366,0.7934919613540603,0.1331033708042382,1041670.007588707,2336.2858071179244,1044006.293395825,1423,0,282.3553299492386,78,119,41,38.875467245448114,0.5316201353637902,44.844409282700425,8164.978902953599,104.67921670453332,8
1444,32,2,5,192,0.01015228426395939,0.025380710659898477,0.9746192893401016,197,6200,4500,1700,0.7258064516129032,79,45,34,247.32472774890675,0.4809320936496426,0.8079825990417058,0.14164305211079717,1043696.3568793392,6026.383463541583,1049722.7403428808,1424,0,280.6802030456853,63,134,34,38.27959044948596,0.5294521996615905,44.596354166666664,8172.916666666658,129.72883597883583,8
1445,32,2,7,187,0.010309278350515464,0.03608247422680412,0.9639175257731959,194,5600,3900,1700,0.6964285714285714,73,39,34,243.60778986344758,0.4805243220625679,0.8013250239510097,0.14024984560392928,1045325.5128622074,6529.887575247341,1051855.4004374547,1425,0,284.2680412371134,65,129,36,38.17041010599982,0.532323883161512,44.39709595959596,8179.292929292925,125.83527583527577,0
1446,32,4,3,188,0.020942408376963352,0.015706806282722512,0.9842931937172775,191,6600,5300,1300,0.803030303030303,79,53,26,239.8902418420999,0.4801517865343988,0.8040904517513756,0.13623673236079378,1041085.1874025388,5149.235476844531,1046234.4228793833,1426,0,281.90575916230364,66,125,37,38.79682960524978,0.5295593368237348,44.9160447761194,8162.6865671641735,123.67706919945718,8
1447,32,7,1,194,0.035897435897435895,0.005128205128205128,0.9948717948717949,195,5950,4000,1950,0.6722689075630253,79,40,39,228.83362934674832,0.48048836901929687,0.7994540020844256,0.13272018015908277,1047604.7378369553,2995.4388560161356,1050600.1766929715,1427,0,276.6051282051282,64,131,38,38.263162564455875,0.5338675213675214,44.118589743589766,8188.205128205176,127.94070512820588,0
1448,32,2,0,196,0.01020408163265306,0.0,1.0,196,6050,4100,1950,0.6776859504132231,80,41,39,224.4835160010073,0.48037349555206693,0.7967478533463879,0.13094610678663118,1049369.248005577,1863.2196751251217,1051232.467680702,1428,0,276.13775510204084,67,129,40,38.15423495633451,0.5357142857142857,43.903186274509814,8195.098039215703,122.31489610769707,0
1449,32,3,2,197,0.01507537688442211,0.010050251256281407,0.9899497487437185,199,6100,4500,1600,0.7377049180327869,77,45,32,239.2477606229889,0.48041025836251966,0.8055960752025346,0.13791228564310262,1045712.8258596094,4136.890368330001,1049849.7162279394,1429,0,272.95979899497485,65,134,41,38.23337243281067,0.5352282244556115,44.34974747474749,8180.808080808107,125.85858585858625,8
1450,32,1,1,197,0.005050505050505051,0.005050505050505051,0.9949494949494949,198,6050,4200,1850,0.6942148760330579,79,42,37,236.91003621499488,0.4802476969355142,0.8025270670779654,0.13718438296776772,1047110.7867166492,3964.210880430758,1051074.99759708,1430,0,274.9646464646465,67,131,42,38.11826347305391,0.5369318181818181,44.17892156862746,8186.274509803936,122.18320163886472,0
1451,32,0,4,193,0.0,0.02030456852791878,0.9796954314720813,197,6750,5000,1750,0.7407407407407407,85,50,35,239.1336766273478,0.48000945301978665,0.8036145989021211,0.13877285013728785,1047779.7067901248,3961.882716049435,1051741.5895061742,1431,1,277.34517766497464,68,129,39,37.97772501130712,0.5381768189509306,44.09722222222223,8188.8888888889,120.42483660130735,0
1452,32,3,1,195,0.015306122448979591,0.00510204081632653,0.9948979591836735,196,6500,4500,2000,0.6923076923076923,85,45,40,246.6556119734471,0.48017235740450026,0.806169345349415,0.1440844416054457,1049806.09570797,6088.112998060814,1055894.2087060309,1432,0,279.21938775510205,72,124,37,37.53179952834569,0.5402317176870748,43.849885844748854,8196.803652968028,113.84449518011151,8
1453,32,1,1,195,0.00510204081632653,0.00510204081632653,0.9948979591836735,196,5750,4100,1650,0.7130434782608696,74,41,33,250.14748318953184,0.4802137842316414,0.8037347766765925,0.14849068923575354,1054714.1159945307,7816.81632010035,1062530.932314631,1433,0,279.88775510204084,68,128,38,36.82932027988474,0.545546343537415,43.25181159420287,8215.942028985442,120.82267689684474,8
1454,32,5,8,192,0.025,0.04,0.96,200,5300,3600,1700,0.6792452830188679,70,36,34,243.82716390691235,0.4802010050251256,0.801821043411618,0.14627227596346568,1057909.5427775655,6289.4166971019495,1064198.9594746674,1434,0,275.25,73,127,35,36.593481414572686,0.5485416666666667,42.86317567567564,8228.378378378304,112.7175120325795,0
1455,32,0,4,188,0.0,0.020833333333333332,0.9791666666666666,192,6000,4200,1800,0.7,78,42,36,251.64477748852974,0.479091677574171,0.8026667269657508,0.15068157820153635,1057347.0273526004,8815.171485260322,1066162.1988378607,1435,1,284.0364583333333,69,123,35,36.46255426917508,0.5495876736111112,42.93154761904759,8226.190476190419,119.22015182884665,0
1456,32,1,3,186,0.005291005291005291,0.015873015873015872,0.9841269841269842,189,5250,3600,1650,0.6857142857142857,69,36,33,247.33492632324518,0.47871871364779167,0.7957789793457086,0.148827828255621,1058826.7083815534,9326.965181326905,1068153.6735628804,1436,0,288.14285714285717,71,118,37,36.38908807153703,0.5523037918871252,42.75173611111109,8231.944444444403,115.94287949921694,0
1457,32,2,4,184,0.010638297872340425,0.02127659574468085,0.9787234042553191,188,5650,4100,1550,0.7256637168141593,72,41,31,240.88291142298192,0.4784265132552054,0.7905169638983616,0.1432421067796896,1055247.1897573231,7588.203067932726,1062835.3928252559,1437,0,290.3670212765957,73,115,38,37.00074910472849,0.5493683510638299,43.18693693693693,8218.018018018005,112.57558928791788,8
1458,32,2,5,181,0.010752688172043012,0.026881720430107527,0.9731182795698925,186,7100,5000,2100,0.704225352112676,92,50,42,236.5913394304501,0.4779321660370048,0.7845160477001318,0.14167159823740466,1057355.1882715991,5732.21604938238,1063087.4043209816,1438,0,293.3225806451613,74,112,37,36.8485151367803,0.55146729390681,42.930555555555536,8226.222222222177,111.16516516516455,0
1459,32,0,2,179,0.0,0.011049723756906077,0.988950276243094,181,5300,4200,1100,0.7924528301886793,64,42,22,244.5613361093109,0.477841722938408,0.7831151251955806,0.14484359089824986,1054019.2811959297,10054.472738850205,1064073.75393478,1439,1,301.0,67,114,38,37.05939769223119,0.5513351749539595,43.336397058823515,8213.235294117612,122.58560140474049,8
1460,32,1,3,177,0.005555555555555556,0.016666666666666666,0.9833333333333333,180,5650,4200,1450,0.7433628318584071,71,42,29,241.18555388777457,0.4775922046348024,0.77846764656192,0.1437640778914132,1055970.3233506908,9286.957465277534,1065257.2808159683,1440,0,303.5444444444444,71,109,34,36.90287633046123,0.5534143518518518,43.09895833333332,8220.833333333305,115.78638497652543,0
1461,32,0,2,175,0.0,0.011299435028248588,0.9887005649717514,177,5100,3200,1900,0.6274509803921569,70,32,38,257.9146695696656,0.4770627354048964,0.789554079195435,0.15027123124510688,1049009.6304074393,13610.994440386603,1062620.6248478258,1441,3,307.7231638418079,73,104,36,37.34309144218437,0.5438441619585688,43.94707207207209,8193.693693693733,112.24237936566757,8
1462,32,0,0,175,0.0,0.0,1.0,175,5700,3900,1800,0.6842105263157895,75,39,36,238.68380236041492,0.47603037766830875,0.7690959236054651,0.1379010672438221,1046416.8934133999,9252.552594816732,1055669.4460082166,1442,4,310.64,72,103,37,38.159687348882194,0.54375,44.26369863013699,8183.561643835628,113.66057838660595,8
1463,32,2,1,176,0.011299435028248588,0.005649717514124294,0.9943502824858758,177,6050,4400,1650,0.7272727272727273,77,44,33,241.51682242059408,0.4762548686012669,0.7771520349093688,0.13284182339159006,1031023.9974494119,8351.927940671827,1039375.9253900837,1443,0,308.1186440677966,71,106,36,40.02075496789392,0.5247763653483992,46.15162037037035,8123.148148148107,114.41053729786066,8
1464,32,1,4,173,0.005649717514124294,0.022598870056497175,0.9774011299435028,177,5600,4400,1200,0.7857142857142857,68,44,24,235.72298651880402,0.476299007019346,0.7716728470092691,0.12524778413291227,1019951.4759948129,7085.201605152083,1027036.677599965,1444,0,309.08474576271186,67,110,39,41.56681025765481,0.5140654425612052,47.51838235294119,8079.411764705908,120.58823529411804,8
1465,32,7,4,176,0.03888888888888889,0.022222222222222223,0.9777777777777777,180,6150,4800,1350,0.7804878048780488,75,48,27,228.63961289537704,0.4773775346575626,0.7712122381016684,0.1248523990417305,1028724.490428478,4891.433853511802,1033615.9242819898,1445,0,302.52777777777777,70,110,40,40.63735559027174,0.5240162037037037,46.43485915492955,8114.084507042186,115.91549295774551,8
1466,32,6,5,177,0.03296703296703297,0.027472527472527472,0.9725274725274725,182,5500,3800,1700,0.6909090909090909,72,38,34,222.2179038689665,0.47827241818954525,0.7668588402276846,0.12267395310613972,1032181.2307912061,3973.829903861938,1036155.0606950681,1446,0,299.467032967033,76,106,39,40.365068797159324,0.5273580586080586,46.00919913419911,8127.70562770556,106.94349510138895,0
1467,32,6,1,182,0.03278688524590164,0.00546448087431694,0.994535519125683,183,5700,3900,1800,0.6842105263157895,75,39,36,222.0537266296246,0.4783097139654517,0.7702064814518439,0.12400798514592198,1035828.1106180185,3701.898422091023,1039530.0090401096,1447,0,297.1693989071038,64,119,44,39.910982343431805,0.5310792349726776,45.56089743589745,8142.051282051315,127.2195512820518,0
1468,32,4,5,181,0.021505376344086023,0.026881720430107527,0.9731182795698925,186,6850,4800,2050,0.7007299270072993,89,48,41,189.99055200711152,0.47859452194129615,0.7434024935127022,0.10429901779186768,1030410.6790972628,-4896.341256857648,1025514.3378404052,1448,0,293.3333333333333,81,105,37,41.40568945954519,0.5251456093189963,46.22713414634146,8120.731707317067,100.25594700391441,8
1469,32,4,2,183,0.021621621621621623,0.010810810810810811,0.9891891891891892,185,7100,5600,1500,0.7887323943661971,86,56,30,187.556788415553,0.47888146298472384,0.7399210637284492,0.10423851703020369,1034307.5754258683,-5301.718583849319,1029005.8568420189,1449,0,293.96216216216214,72,113,39,40.97904272832719,0.5291103603603604,45.747716894977174,8136.073059360742,113.00101471334364,0
1470,32,2,1,184,0.010810810810810811,0.005405405405405406,0.9945945945945946,185,6150,4500,1650,0.7317073170731707,78,45,33,186.22051126170373,0.4787333529181355,0.737231399726687,0.10425990698345224,1036623.1707111832,-4541.90063288688,1032081.2700782963,1450,0,294.61621621621623,75,110,42,40.72327149857307,0.5319256756756756,45.46326754385966,8145.175438596514,108.60233918128685,0
1471,32,3,5,182,0.016042780748663103,0.026737967914438502,0.9732620320855615,187,5550,3800,1750,0.6846846846846847,73,38,35,199.4638776989663,0.47902531002625875,0.7495153727386401,0.11054281779925272,1033414.092076797,-1724.2435851210862,1031689.8484916759,1451,0,292.4331550802139,85,102,41,40.788334445397645,0.5295231729055259,45.85755813953488,8132.5581395348745,95.67715458276322,8
1472,32,4,2,184,0.021505376344086023,0.010752688172043012,0.989247311827957,186,5400,3900,1500,0.7222222222222222,69,39,30,216.48864330507013,0.47935677613096966,0.7705088411199037,0.11821716341995277,1028724.4904284797,1941.4338535119514,1030665.9242819917,1434,0,286.6720430107527,70,116,41,40.945461821828786,0.5202732974910393,46.434859154929555,8114.0845070422,115.91549295774571,8
1473,32,5,2,187,0.026455026455026454,0.010582010582010581,0.9894179894179894,189,6050,4300,1750,0.7107438016528925,78,43,35,215.51704738733477,0.47953370670569256,0.7749825139575475,0.11922686323187019,1032850.923300636,669.3962762068795,1033520.3195768428,1435,0,283.04232804232805,77,112,41,40.45110600087603,0.5240299823633157,45.92681623931622,8130.341880341826,105.58885558885488,0
1474,32,6,5,188,0.031088082901554404,0.025906735751295335,0.9740932642487047,193,6200,4100,2100,0.6612903225806451,83,41,42,196.9198430645327,0.4804001601180196,0.7577720914662982,0.10963208410929295,1034854.0771604901,-4043.33950617308,1030810.737654317,1436,0,278.13471502590676,74,119,41,40.67250104672964,0.5281196027633852,45.68055555555554,8138.222222222193,109.97597597597557,8
1475,32,4,3,189,0.020833333333333332,0.015625,0.984375,192,7250,6100,1150,0.8413793103448276,84,61,23,212.75806746644218,0.4806511098385689,0.7700749931882436,0.12015367607005549,1039337.7712673575,-1424.5008680557057,1037913.2703993018,1437,0,275.3541666666667,79,113,36,39.70764790027585,0.5324978298611112,45.13020833333332,8155.833333333305,103.23839662447222,0
1476,32,2,3,188,0.010471204188481676,0.015706806282722512,0.9842931937172775,191,5700,3800,1900,0.6666666666666666,76,38,38,210.61587791518673,0.48033893634610086,0.7675918582004841,0.11967477610540404,1041250.1736111096,-39.23611111120772,1041210.9374999984,1438,0,277.57068062827227,79,112,40,39.52293453110113,0.5342495636998255,44.89583333333333,8163.333333333321,103.33333333333319,0
1477,32,1,2,187,0.005291005291005291,0.010582010582010581,0.9894179894179894,189,6450,4800,1650,0.7441860465116279,81,48,33,226.97970363468204,0.48040967766145076,0.7812090374367939,0.12431137292016463,1029661.1882716111,2492.438271605317,1032153.6265432164,1439,0,281.4021164021164,74,115,37,40.56141071265625,0.5222663139329806,46.319444444444464,8117.7777777778265,109.69969969970036,8
1478,32,6,3,190,0.031088082901554404,0.015544041450777202,0.9844559585492227,193,5500,3700,1800,0.6727272727272727,73,37,36,216.2359057912725,0.4808757915947035,0.7759934849575685,0.11955612423472177,1032669.9674211302,560.0651577505969,1033230.0325788808,1440,0,276.47668393782385,80,113,36,40.45558086560366,0.5255289291882557,45.94907407407409,8129.629629629671,101.62037037037089,0
1479,32,5,6,189,0.02564102564102564,0.03076923076923077,0.9692307692307692,195,5600,3800,1800,0.6785714285714286,74,38,36,215.59991708086903,0.4815776720415896,0.7722091234375801,0.1186974085082223,1031319.898596704,-129.50307573963346,1031190.3955209644,1441,0,273.42051282051284,84,111,38,40.64144181107304,0.5204059829059828,46.1151960784314,8124.3137254902795,96.71802054155094,8
1480,32,2,6,185,0.010471204188481676,0.031413612565445025,0.9685863874345549,191,6750,5200,1550,0.7703703703703704,83,52,31,218.01934963719367,0.481383760448241,0.775298257660286,0.12090163934426235,1033611.1111111143,119.44444444457076,1033730.5555555589,1442,0,279.32460732984293,84,107,43,40.29200819672132,0.5231239092495636,45.83333333333334,8133.3333333333585,96.82539682539712,0
1481,32,7,4,188,0.036458333333333336,0.020833333333333332,0.9791666666666666,192,6700,4800,1900,0.7164179104477612,86,48,38,205.8826698089397,0.48142372473094824,0.7601691513761479,0.11712531841949007,1041622.8310117903,-2209.582123469574,1039413.2488883208,1443,0,277.8072916666667,88,104,37,39.59709480122321,0.5361870659722222,44.85018726591758,8164.794007490584,92.78175008512027,8
1482,32,1,2,187,0.005291005291005291,0.010582010582010581,0.9894179894179894,189,6450,4400,2050,0.6821705426356589,85,44,41,224.58193149171422,0.4807837536117678,0.7866535849286207,0.12432426817591677,1033061.0400151768,2151.368743089332,1035212.4087582661,1444,0,283.2010582010582,76,113,40,40.19436902163301,0.5228174603174602,45.900974025974016,8131.1688311688085,106.98906356801064,8
1483,32,2,3,186,0.010582010582010581,0.015873015873015872,0.9841269841269842,189,5900,4200,1700,0.711864406779661,76,42,34,221.70666020432742,0.4809866223873316,0.7834877159456242,0.12352457638258443,1035090.9172825471,2197.3100557092657,1037288.2273382563,1445,0,284.13227513227514,62,127,41,40.01237838306355,0.5243055555555556,45.65145502645501,8139.153439153409,131.27666837344208,0
1484,32,5,3,188,0.02617801047120419,0.015706806282722512,0.9842931937172775,191,6300,4700,1600,0.746031746031746,79,47,32,215.74481195356452,0.48136538991457706,0.7803254577278407,0.12163198221902163,1038802.1065382016,323.23302641001646,1039125.3395646116,1446,0,279.3350785340314,66,125,35,39.69862916183617,0.5271596858638743,45.19589552238805,8153.731343283558,123.54138398914482,0
1485,32,3,4,187,0.015706806282722512,0.020942408376963352,0.9790575916230366,191,5900,4100,1800,0.6949152542372882,77,41,36,227.4170123276786,0.481018646091669,0.7695539235703859,0.12850245993677395,1039508.727547254,3180.3938214683394,1042689.1213687223,1447,0,280.21989528795814,81,110,39,39.31259863776059,0.5318499127399651,45.109247967479654,8156.504065040601,100.69758104988396,8
1486,32,1,2,186,0.005319148936170213,0.010638297872340425,0.9893617021276596,188,6350,4500,1850,0.7086614173228346,82,45,37,228.58806460982365,0.48076964102855846,0.7701576389322837,0.1301986285780192,1041996.9538014717,3687.6133997619336,1045684.5672012337,1448,0,285.02127659574467,81,107,41,38.97090240098232,0.5341866134751774,44.80436991869918,8166.2601626016085,100.81802669878529,0
1487,32,1,2,185,0.0053475935828877,0.0106951871657754,0.9893048128342246,187,6850,4900,1950,0.7153284671532847,88,49,39,213.77705623913585,0.4804748145592548,0.7634948763118476,0.12355589182634949,1046529.0000000132,494.77777777842493,1047023.7777777916,1449,0,287.3048128342246,74,113,39,38.782651786684056,0.5386586452762923,44.25000000000004,8184.000000000105,110.594594594596,8
1488,32,3,4,184,0.015957446808510637,0.02127659574468085,0.9787234042553191,188,4750,3100,1650,0.6526315789473685,64,31,33,227.15665061455866,0.4807951226912428,0.7812000695077588,0.12901403024060604,1041106.6134442765,4948.858248533645,1046055.4716928102,1450,0,285.0691489361702,76,112,38,39.11895859850091,0.5322473404255319,44.913419913419915,8162.770562770568,107.40487582592853,8
1489,32,3,5,182,0.016042780748663103,0.026737967914438502,0.9732620320855615,187,5650,4000,1650,0.7079646017699115,73,40,33,208.47994239529504,0.48030830122860485,0.7671023166855366,0.11840656005438827,1041106.6134442778,359.96935964481554,1041466.5828039226,1451,0,284.4064171122995,76,111,40,39.59537636119363,0.5320298573975044,44.91341991341992,8162.770562770578,107.40487582592866,8
1490,32,2,0,184,0.010869565217391304,0.0,1.0,184,5650,3900,1750,0.6902654867256637,74,39,35,192.60948472556265,0.47976125069295955,0.7416494894779717,0.11014930809967606,1043250.5985715506,-2262.0079538995087,1040988.590617651,1452,0,289.6467391304348,73,111,40,39.73263506063947,0.5348165760869565,44.65090090090092,8171.17117117122,111.93385165987972,8
1491,32,1,1,184,0.005405405405405406,0.005405405405405406,0.9945945945945946,185,5800,4200,1600,0.7241379310344828,74,42,32,189.86492526877402,0.4799451625538582,0.73835720315339,0.10914633105073543,1044864.5194992677,-3123.375217855373,1041741.1442814124,1453,0,289.07567567567565,76,109,41,39.60153079230635,0.5368806306306306,44.45346320346323,8177.48917748924,107.59854180906895,0
1492,32,2,1,185,0.010752688172043012,0.005376344086021506,0.9946236559139785,186,6200,4800,1400,0.7741935483870968,76,48,28,184.66098667431814,0.480069383900029,0.733390679579716,0.10692072885702812,1047086.3180811749,-4728.801473989976,1042357.5166071849,1454,0,287.3225806451613,81,105,44,39.45794848876087,0.5400425627240144,44.18191056910571,8186.178861788667,101.06393656529218,0
1493,32,0,1,184,0.0,0.005405405405405406,0.9945945945945946,185,6300,4500,1800,0.7142857142857143,81,45,36,183.53774417435707,0.4796367019193106,0.7302267755285787,0.10683441107680428,1048716.553729338,-4804.185890042096,1043912.367839296,1455,1,289.36756756756756,84,101,40,39.28396199320281,0.5419481981981982,43.98284313725491,8192.549019607868,97.53034547152224,0
1494,32,1,3,182,0.005405405405405406,0.016216216216216217,0.9837837837837837,185,6400,4300,2100,0.671875,85,43,42,207.33641736251798,0.4797015765765766,0.7606655515450291,0.1200986417552702,1047211.1111111146,25.000000000147338,1047236.1111111147,1456,0,290.34054054054053,74,111,41,38.86230998914223,0.5364864864864864,44.16666666666668,8186.666666666694,110.630630630631,8
1495,32,0,1,181,0.0,0.005494505494505495,0.9945054945054945,182,6100,4800,1300,0.7868852459016393,74,48,26,223.44675799709196,0.478994014732965,0.7744595576616082,0.125364424656334,1037281.444920922,3855.435199624046,1041136.8801205461,1457,1,293.9230769230769,66,116,39,39.69311636237814,0.525812728937729,45.38246268656718,8147.761194029885,123.45092718227099,8
1496,32,5,2,184,0.026881720430107527,0.010752688172043012,0.989247311827957,186,6150,4600,1550,0.7479674796747967,77,46,31,207.90194216708372,0.48004334980141433,0.7635080245373671,0.114135586147246,1030421.1446008066,-504.6885574926191,1029916.4560433141,1458,0,288.14516129032256,68,118,40,40.94983144953404,0.5164650537634409,46.22584541062802,8120.772946859896,119.42313157146907,8
1497,32,2,0,186,0.010752688172043012,0.0,1.0,186,6200,3900,2300,0.6290322580645161,85,39,46,213.95705216225886,0.4802697859149472,0.7725457887065093,0.11585546760700977,1026037.9693571882,505.6118660426,1026543.5812232308,1459,0,289.01075268817203,66,120,40,41.348052758677134,0.5173611111111112,46.766169154228834,8103.482587064629,122.78003919794892,8
1498,32,4,3,187,0.021052631578947368,0.015789473684210527,0.9842105263157894,190,5950,3900,2050,0.6554621848739496,80,39,41,184.3510286117442,0.4808201058201058,0.7386348909208733,0.10132376083848464,1030788.9660493785,-5944.598765432238,1024844.3672839463,1460,0,283.90526315789475,80,110,41,41.501367989056085,0.5219298245614035,46.18055555555554,8122.222222222189,101.52777777777736,8
1499,32,4,2,189,0.020942408376963352,0.010471204188481676,0.9895287958115183,191,5800,3800,2000,0.6551724137931034,78,38,40,204.99712987562802,0.48051345641590887,0.762691233934345,0.1113809375174919,1027122.0887804629,-1888.5839536292115,1025233.5048268336,1461,0,283.37696335078533,72,119,38,41.43845742284297,0.5163067190226875,46.632420091324185,8107.762557077588,112.60781329274428,8
1500,32,5,1,193,0.02577319587628866,0.005154639175257732,0.9948453608247423,194,5800,4100,1700,0.7068965517241379,75,41,34,202.90165068564096,0.48099671937040406,0.7722629525622411,0.10988831972776797,1026093.9643347056,-2960.7681755829663,1023133.1961591226,1462,0,279.6340206185567,62,132,43,41.62096282754415,0.5086447594501718,46.75925925925926,8103.703703703708,130.704898446834,8
1501,32,5,2,196,0.025252525252525252,0.010101010101010102,0.98989898989899,198,5950,4100,1850,0.6890756302521008,78,41,37,213.79026226252194,0.4817250337554906,0.7861886830508682,0.11814281586507264,1032506.3340159653,-1402.0400126022223,1031104.2940033631,1463,0,274.72727272727275,68,130,44,40.53827182504308,0.5131523569023568,45.96920289855073,8128.985507246396,119.54390451832936,0
1502,32,5,3,198,0.024875621890547265,0.014925373134328358,0.9850746268656716,201,6950,4900,2050,0.7050359712230215,90,49,41,208.792055568661,0.4819195688225539,0.7841786081741176,0.11686077899007664,1036525.4889594255,-3866.342502169733,1032659.1464572557,1464,0,271.4726368159204,63,138,46,40.16098605959841,0.5161691542288558,45.47526041666669,8144.791666666722,129.2824074074083,0
1503,32,2,1,199,0.01,0.005,0.995,200,7250,5100,2150,0.7034482758620689,94,51,43,208.27398591945902,0.48214771775544385,0.7823668390044478,0.11743828751811208,1038850.5773020063,-3976.889898115634,1034873.6874038907,1465,0,273.775,67,133,42,39.88292052422751,0.51859375,45.18995098039218,8153.921568627507,121.70032191981355,0
1504,32,0,1,198,0.0,0.005025125628140704,0.9949748743718593,199,6200,4400,1800,0.7096774193548387,80,44,36,208.97774589759712,0.48205780586433855,0.7823902385800676,0.11815169385300042,1039689.6735229355,-2545.599118833527,1037144.0744041019,1466,1,273.1105527638191,66,133,42,39.759951614214856,0.5196293969849246,45.087064676616926,8157.213930348282,123.59415045982246,0
1505,32,3,6,195,0.014925373134328358,0.029850746268656716,0.9701492537313433,201,6800,5000,1800,0.7352941176470589,86,50,36,207.30653470514255,0.482389096185738,0.7826656364955455,0.11879688078108813,1043885.1718768011,-3719.156477627812,1040166.0153991733,1467,0,271.33830845771143,61,140,47,39.278089302549915,0.5226471807628523,44.57325268817202,8173.655913978451,133.9943592455484,0
1506,32,4,2,197,0.020100502512562814,0.010050251256281407,0.9899497487437185,199,6450,4300,2150,0.6666666666666666,86,43,43,203.67039909567006,0.48236130145677886,0.7772978348879993,0.11826120219277353,1047957.4245876705,-3562.4186197918225,1044395.0059678786,1468,0,274.50251256281405,63,136,42,38.86309675231067,0.5252826633165829,44.07552083333332,8189.5833333333085,129.99338624338586,0
1507,32,4,3,198,0.01990049751243781,0.014925373134328358,0.9850746268656716,201,6500,4300,2200,0.6615384615384615,87,43,44,223.8346452150338,0.4827601575456053,0.7980474983572707,0.1272700330601837,1041456.3285952966,-77.19843638396469,1041379.1301589126,1469,0,270.03980099502485,65,136,42,39.159900505206735,0.5223362354892206,44.87058080808081,8164.141414141415,125.60217560217562,8
1508,32,3,1,200,0.014925373134328358,0.004975124378109453,0.9950248756218906,201,6200,4400,1800,0.7096774193548387,80,44,36,238.95791773196768,0.4826741293532338,0.8050345049838086,0.13208188487928954,1032580.9625081117,2948.679338121703,1035529.6418462334,1470,0,270.9004975124378,73,128,37,39.88953611865312,0.5141998341625207,45.96002252252251,8129.279279279243,111.35999012711292,8
1509,32,3,2,201,0.014778325123152709,0.009852216748768473,0.9901477832512315,203,5550,3400,2150,0.6126126126126126,77,34,43,227.70330652368273,0.48343230258986486,0.7959023934987706,0.12380952380952367,1027358.5184309965,636.5863264017116,1027995.1047573981,1471,0,269.1034482758621,68,135,39,40.833333333333336,0.5149835796387521,46.6032608695652,8108.695652173869,119.24552429667455,8
1510,32,3,2,202,0.014705882352941176,0.00980392156862745,0.9901960784313726,204,5550,3800,1750,0.6846846846846847,73,38,35,211.85794848346248,0.48349160066325386,0.7863511659807954,0.11440329218107004,1025156.2500000023,-2912.499999999918,1022243.7500000024,1472,0,268.1078431372549,86,118,40,41.51234567901235,0.5138378267973855,46.87500000000001,8100.000000000018,94.18604651162812,7
1511,32,8,2,208,0.0380952380952381,0.009523809523809525,0.9904761904761905,210,5800,4000,1800,0.6896551724137931,76,40,36,202.9273784950279,0.4838792055897319,0.7817090671885201,0.11054998977714163,1027970.6790123413,-6079.3209876545825,1021891.3580246867,1473,0,261.2761904761905,74,136,43,41.38413242009135,0.5146825396825396,46.527777777777764,8111.111111111077,109.60960960960915,8
1512,32,10,4,214,0.045871559633027525,0.01834862385321101,0.981651376146789,218,7500,5200,2300,0.6933333333333334,98,52,46,216.18798533502186,0.48546916176947247,0.8033049154618084,0.11697134648392513,1025786.0108660612,-6747.477785203707,1019038.5330808575,1474,0,252.43119266055047,66,152,42,41.32332473699289,0.5125668960244648,46.797263681592014,8102.487562189003,122.76496306346975,8
1513,32,4,2,216,0.01834862385321101,0.009174311926605505,0.9908256880733946,218,7100,5000,2100,0.704225352112676,92,50,42,209.79184800136392,0.4855752970024944,0.7950211676117247,0.11490373277768653,1029677.0681798086,-7496.42900438654,1022180.639175422,1475,0,252.76605504587155,70,148,46,40.99543596861566,0.5158639143730888,46.31748826291078,8117.840375586808,115.96914822266868,0
1514,32,6,10,212,0.02702702702702703,0.04504504504504504,0.954954954954955,222,6550,4300,2250,0.6564885496183206,88,43,45,199.90147633620404,0.4857200243229655,0.7886389889975349,0.11097847837925522,1033964.1505111844,-9611.807966821103,1024352.3425443632,1476,0,249.14414414414415,71,151,41,40.70823373740825,0.5193787537537538,45.78993055555554,8134.722222222191,114.57355242566466,0
1515,32,6,3,215,0.027522935779816515,0.013761467889908258,0.9862385321100917,218,6250,4700,1550,0.752,78,47,31,208.82057317708143,0.4854127911892783,0.7990710510811152,0.11471284006624216,1030623.077662431,-6806.93963860097,1023816.1380238301,1477,0,254.58715596330276,67,151,42,40.901134717527725,0.5096043577981652,46.200980392156836,8121.568627450929,121.21744220076013,8
1516,32,3,3,215,0.013761467889908258,0.013761467889908258,0.9862385321100917,218,7500,5200,2300,0.6933333333333334,98,52,46,214.84920090750865,0.48529520568215445,0.8002844160333031,0.11855258040376453,1032038.2971938736,-6753.479308390236,1025284.8178854833,1478,0,255.05963302752295,69,149,39,40.570191500166054,0.5119457186544343,46.0267857142857,8127.142857142825,117.78467908902645,8
1517,32,1,3,213,0.004629629629629629,0.013888888888888888,0.9861111111111112,216,7000,4900,2100,0.7,91,49,42,212.34357221553034,0.4855099770312949,0.7968472989659439,0.11789789443900539,1033996.2479912767,-6287.508608815379,1027708.7393824613,1479,0,257.4490740740741,65,151,44,40.387913640032316,0.5139853395061729,45.78598484848485,8134.848484848487,125.15151515151518,0
1518,32,5,4,214,0.022935779816513763,0.01834862385321101,0.981651376146789,218,7200,5300,1900,0.7361111111111112,91,53,38,229.58900160631546,0.4861196254174946,0.8183838503791854,0.12552792333487142,1029123.1483075672,-3544.9287700237333,1025578.2195375435,1480,0,256.0045871559633,65,153,43,40.56302767232975,0.5118501529051988,46.38573232323231,8115.656565656538,124.85625485625444,8
1519,32,5,4,215,0.0228310502283105,0.0182648401826484,0.9817351598173516,219,6900,5000,1900,0.7246376811594203,88,50,38,222.69213739820322,0.48685032745451245,0.8133360713673179,0.12344754619356874,1033495.0565302962,-4669.755374158771,1028825.3011561375,1481,0,253.5159817351598,72,147,41,40.18782868264924,0.5159341704718416,45.84760273972599,8132.876712328691,112.95662100456515,0
1520,32,6,8,213,0.027149321266968326,0.03619909502262444,0.9638009049773756,221,7250,5100,2150,0.7034482758620689,94,51,43,221.11738337405333,0.48694038804332923,0.8146565799061556,0.12464993976577392,1038774.5484141981,-5511.777987817706,1033262.7704263804,1482,0,252.13574660633483,68,153,34,39.56518841094916,0.5195607088989442,45.199275362318836,8153.6231884057925,119.90622335890872,0
1521,32,6,3,216,0.0273972602739726,0.0136986301369863,0.9863013698630136,219,7050,4500,2550,0.6382978723404256,96,45,51,217.437962193207,0.4869690209878095,0.8109227150323044,0.12437451437451442,1043316.3265306127,-5478.684807256184,1037837.6417233564,1483,0,249.07762557077626,62,157,39,39.09042346542348,0.52425799086758,44.642857142857146,8171.428571428574,131.7972350230415,0
1522,32,3,6,213,0.0136986301369863,0.0273972602739726,0.9726027397260274,219,7600,6000,1600,0.7894736842105263,92,60,32,215.7366196423606,0.4867464706128775,0.8089166643417116,0.12461962381694015,1046358.5069444455,-6252.430555555491,1040106.07638889,1484,0,248.8675799086758,65,154,40,38.75381873727084,0.5268740487062404,44.270833333333336,8183.333333333342,125.89743589743603,0
1523,32,6,9,210,0.0273972602739726,0.0410958904109589,0.9589041095890412,219,7500,5300,2200,0.7066666666666667,97,53,44,226.9833316893869,0.4866015946825297,0.8193692389546765,0.1325553252964038,1049719.260949138,-3646.2449622487397,1046073.0159868894,1485,0,249.10502283105023,65,154,38,38.04653963070223,0.5281107305936072,43.8604797979798,8196.464646464648,126.09945609945613,8
1524,32,0,1,209,0.0,0.004761904761904762,0.9952380952380953,210,6550,5000,1550,0.7633587786259542,81,50,31,235.17717178308556,0.4857456140350877,0.8187924227224457,0.1376303607327551,1050366.1775584172,854.4293949600178,1051220.6069533771,1486,1,259.1857142857143,65,145,38,37.75589298180775,0.5298611111111111,43.781565656565675,8198.989898989938,126.13830613830673,0
1525,32,3,0,212,0.014150943396226415,0.0,1.0,212,7500,5100,2400,0.68,99,51,48,244.20629017900183,0.4857922367283674,0.8192836603728413,0.1417550480795829,1047863.3368175678,1278.9636197615064,1049142.3004373293,1487,0,257.6792452830189,67,145,38,37.837453609481635,0.5352790880503144,44.08700980392156,8189.2156862744905,122.22709979514165,8
1526,32,1,4,209,0.004694835680751174,0.018779342723004695,0.9812206572769953,213,6650,4600,2050,0.6917293233082706,87,46,41,238.59457167939098,0.4858056884282635,0.8172968895497408,0.135445762732598,1040958.2838296067,423.3991732877412,1041381.6830028945,1488,0,257.46478873239437,66,147,42,38.845798285180216,0.5217136150234742,44.93159203980099,8162.1890547263565,123.66953113221753,8
1527,32,3,2,210,0.014150943396226415,0.009433962264150943,0.9905660377358491,212,7300,5000,2300,0.684931506849315,96,50,46,233.62218597686612,0.4859431354138723,0.8132008617840651,0.13388968037708635,1043914.4383230282,-923.685389232438,1042990.7529337957,1489,0,257.4858490566038,60,152,43,38.60225297499664,0.5253537735849056,44.56967213114753,8173.770491803252,136.22950819672087,0
1528,32,3,4,209,0.014084507042253521,0.018779342723004695,0.9812206572769953,213,7300,5100,2200,0.6986301369863014,95,51,44,221.74858480222125,0.4859136475034695,0.8036464089343702,0.1283302661185691,1046931.1132459517,-3468.901450459579,1043462.2117954921,1490,0,255.4694835680751,66,147,47,38.52856115399421,0.5286091549295775,44.20087064676614,8185.572139303423,124.0238202924761,0
1529,32,3,6,206,0.014150943396226415,0.02830188679245283,0.9716981132075472,212,6500,4200,2300,0.6461538461538462,88,42,46,217.85436827972984,0.4857647582640317,0.8001573240656501,0.12709402298624156,1049405.1162131443,-3176.502267574112,1046228.6139455702,1491,0,257.1792452830189,69,143,44,38.31953321712182,0.5318887578616351,43.8988095238095,8195.238095238035,118.7715665976527,0
1530,32,2,4,204,0.009615384615384616,0.019230769230769232,0.9807692307692307,208,7600,5900,1700,0.7763157894736842,93,59,34,217.88077499508267,0.4853872476155085,0.7956360461891445,0.12778820540369035,1051038.347099376,-3399.7900768873797,1047638.5570224886,1492,0,257.05288461538464,61,147,46,38.11530372555448,0.5348557692307692,43.69959677419355,8201.612903225809,134.4526705446854,0
1531,32,0,1,203,0.0,0.004901960784313725,0.9950980392156863,204,6800,4900,1900,0.7205882352941176,87,49,38,223.33603887230262,0.4850058557905921,0.7950150489791707,0.1316705064193272,1052627.9067993164,-582.0505777994686,1052045.8562215168,1493,1,260.34313725490193,63,141,44,37.777420838885725,0.5367136437908497,43.505859375,8207.8125,130.2827380952381,0
1532,32,2,3,202,0.00975609756097561,0.014634146341463415,0.9853658536585366,205,7550,5300,2250,0.7019867549668874,98,53,45,219.89897973345953,0.4848537382432648,0.7927046861709506,0.13098330531949476,1055756.2499999937,-2118.055555555854,1053638.1944444377,1494,0,259.8439024390244,69,136,38,37.47634495809678,0.5397865853658537,43.12499999999998,8219.99999999995,119.13043478260798,0
1533,32,0,5,197,0.0,0.024752475247524754,0.9752475247524752,202,7050,4200,2850,0.5957446808510638,99,42,57,206.66173374001062,0.4843788483325944,0.7822595682281961,0.1202275803964276,1048545.3677450952,-4111.15927934797,1044434.2084657472,1495,1,262.9950495049505,77,125,38,38.713276209852694,0.5383663366336633,44.00373931623934,8191.880341880405,106.38805638805721,7
1534,32,0,2,195,0.0,0.01015228426395939,0.9898477157360406,197,5700,3600,2100,0.631578947368421,78,36,42,217.74260724698001,0.4839805846196346,0.7789495493628917,0.12406264831513997,1042100.6944444461,281.9444444445289,1042382.6388888906,1496,2,268.8578680203046,78,119,43,39.23469387755098,0.5318845177664975,44.79166666666667,8166.666666666681,104.70085470085488,7
1535,32,4,0,199,0.020100502512562814,0.0,1.0,199,6150,3500,2650,0.5691056910569106,88,35,53,222.02651075080465,0.48434301135306157,0.783562784335881,0.12515078334922525,1038745.3952177562,175.80313173269406,1038921.1983494889,1497,0,267.08040201005025,75,124,35,39.54567868029409,0.5278475711892797,45.20285087719297,8153.5087719298,108.71345029239733,8
1536,32,3,3,199,0.01485148514851485,0.01485148514851485,0.9851485148514851,202,6850,5300,1550,0.7737226277372263,84,53,31,232.77542984982338,0.48501048798909746,0.7895151291371765,0.12913404083354305,1033732.1464002146,875.4889455775274,1034607.6353457922,1498,0,264.0990099009901,69,133,39,39.90173048026069,0.5241852310231023,45.81845238095234,8133.809523809427,117.88129744651344,8
1537,32,8,1,206,0.03864734299516908,0.004830917874396135,0.9951690821256038,207,7250,5300,1950,0.7310344827586207,92,53,39,214.71170493867277,0.48593229679658556,0.7855762891979186,0.12076883548971792,1038074.9846106454,-4072.630040012492,1034002.3545706329,1499,0,255.7826086956522,75,132,46,39.816060410388864,0.5291867954911433,45.28508771929823,8150.877192982425,108.67836257309901,8
1538,32,4,9,201,0.01904761904761905,0.04285714285714286,0.9571428571428572,210,6400,4500,1900,0.703125,83,45,38,200.9393702179226,0.48596253892306523,0.7800031905559528,0.11556917535655183,1045016.0677425498,-6403.02589604005,1038613.0418465098,1500,0,252.93333333333334,72,138,40,39.299623115577894,0.5352678571428571,44.434931506849345,8178.0821917808935,113.58447488584574,8
1539,32,6,2,205,0.028985507246376812,0.00966183574879227,0.9903381642512077,207,6200,4400,1800,0.7096774193548387,80,44,36,210.52310276885257,0.4860016728421119,0.7924968156195034,0.119168419541275,1040064.8157332168,-3808.4655822253912,1036256.3501509915,1501,0,257.35748792270533,70,137,40,39.673605516553515,0.5254126409017713,45.0410798122066,8158.685446009445,116.55264922870636,8
1540,32,5,3,207,0.023809523809523808,0.014285714285714285,0.9857142857142858,210,7700,4600,3100,0.5974025974025974,108,46,62,192.63274621135935,0.4859022556390977,0.7739086969237725,0.11079166617358564,1045016.0677425448,-9439.137007151374,1035576.9307353934,1502,0,254.62857142857143,72,138,42,39.51191140889638,0.5324404761904762,44.43493150684933,8178.0821917808535,113.58447488584518,8
1541,32,2,2,207,0.009569377990430622,0.009569377990430622,0.9904306220095693,209,6800,4800,2000,0.7058823529411765,88,48,40,236.15964880102985,0.4855107885535517,0.8111610188871261,0.1369084598335362,1047468.1284012031,873.9410667001175,1048342.0694679032,1503,0,256.7177033492823,72,137,32,38.09278158868254,0.5308512759170654,44.13527397260275,8187.67123287673,113.7176560121768,8
1542,32,2,3,206,0.009569377990430622,0.014354066985645933,0.9856459330143541,209,7000,4800,2200,0.6857142857142857,92,48,44,238.72943815815617,0.485097687400319,0.806795237687516,0.14121124798188395,1053634.7815964639,1506.72788688302,1055141.509483347,1504,0,257.6937799043062,70,139,38,37.25701789491737,0.539872408293461,43.38321596244131,8211.737089201873,117.31052984574104,8
1543,32,6,10,202,0.02830188679245283,0.04716981132075472,0.9528301886792453,212,6900,5200,1700,0.7536231884057971,86,52,34,234.69020112452708,0.4855584369131718,0.8065412181041534,0.14050356653334073,1057291.3855624818,327.1855849774465,1057618.5711474593,1505,0,254.30188679245282,76,136,37,36.905325755183654,0.5436320754716981,42.938311688311664,8225.974025973966,108.23650034176272,0
1544,32,0,2,200,0.0,0.009900990099009901,0.9900990099009901,202,6500,4600,1900,0.7076923076923077,84,46,38,245.34352704922827,0.4845112309738437,0.8080042190879655,0.14125495466793253,1045338.2403182747,4393.39416782357,1049731.6344860983,1506,1,264.55940594059405,70,132,35,38.12444992920827,0.5351691419141914,44.395539906103274,8179.342723004661,116.84775318578087,8
1545,32,4,2,202,0.0196078431372549,0.00980392156862745,0.9901960784313726,204,6350,4300,2050,0.6771653543307087,84,43,41,244.0670201719397,0.48465169113622464,0.8102066111306168,0.141897639803434,1048348.4567901255,4023.4567901235823,1052371.913580249,1507,0,262.8970588235294,74,130,34,37.780340025321074,0.5379391339869282,44.027777777777786,8191.111111111127,110.6906906906909,0
1546,32,1,7,196,0.0049261083743842365,0.034482758620689655,0.9655172413793104,203,7200,5100,2100,0.7083333333333334,93,51,42,229.7461154005143,0.48437525402786585,0.8013105365530855,0.13117762072868086,1042755.1775147942,113.79026955959398,1042868.9677843538,1508,0,265.1625615763547,64,139,37,38.846385227034936,0.5314552545155993,44.71153846153847,8169.230769230779,127.64423076923092,8
1547,32,0,2,194,0.0,0.01020408163265306,0.9897959183673469,196,7750,5800,1950,0.7483870967741936,97,58,39,226.79214225941155,0.48372579801151233,0.7915815239602453,0.12996051988768267,1043879.0229511615,398.71197495091747,1044277.7349261125,1509,1,274.7755102040816,66,130,37,38.78114411508104,0.5346513605442177,44.57400497512437,8173.631840795995,123.8429066787272,0
1548,32,3,4,193,0.015228426395939087,0.02030456852791878,0.9796954314720813,197,6150,4200,1950,0.6829268292682927,81,42,39,220.94551708605576,0.4835230411961739,0.787316535360729,0.12782450072256038,1046832.1330589785,708.5733882026734,1047540.7064471812,1510,0,274.0761421319797,71,126,37,38.56146304675716,0.5369606598984771,44.21296296296294,8185.185185185134,115.28429838288922,0
1549,32,3,3,193,0.015306122448979591,0.015306122448979591,0.9846938775510204,196,6650,4900,1750,0.7368421052631579,84,49,35,217.46265144826697,0.4831152974010117,0.7837546822260046,0.12627558179434598,1047971.834799335,-271.0532322859199,1047700.7815670491,1511,0,275.93367346938777,73,123,36,38.50832141613041,0.5395408163265306,44.07376126126129,8189.639639639709,112.18684437862615,8
1550,32,1,3,191,0.005154639175257732,0.015463917525773196,0.9845360824742269,194,6650,4700,1950,0.706766917293233,86,47,39,228.84023716278693,0.48284457739080894,0.79413088086232,0.13144129324639478,1044604.2387543308,2359.496347558954,1046963.7351018897,1512,0,279.1082474226804,67,127,40,38.63808952837732,0.5373711340206185,44.48529411764708,8176.470588235337,122.03687445127369,8
1551,32,2,5,188,0.010362694300518135,0.025906735751295335,0.9740932642487047,193,6750,5200,1550,0.7703703703703704,83,52,31,224.14168241116806,0.48305717472654003,0.7872896062446249,0.12964174696244057,1046756.3456790224,1574.3456790128594,1048330.6913580352,1513,0,280.26943005181346,74,119,40,38.48917607877211,0.5400474956822108,44.22222222222226,8184.888888888969,110.60660660660768,0
1552,32,3,3,188,0.015706806282722512,0.015706806282722512,0.9842931937172775,191,6600,4900,1700,0.7424242424242424,83,49,34,225.05290076035084,0.48272940203912923,0.7821827157764181,0.13092808871489967,1048548.3245069454,2395.7684035389975,1050944.0929104844,1514,0,282.6649214659686,73,118,36,38.24210015029879,0.5417212041884817,44.0033783783784,8191.89189189194,112.21769714920465,7
1553,32,1,3,186,0.005291005291005291,0.015873015873015872,0.9841269841269842,189,6450,4700,1750,0.7286821705426356,82,47,35,206.42734618740832,0.4822472231603437,0.7609695705520769,0.11928547081173278,1046470.6718653826,-1045.967268774958,1045424.7045966076,1515,0,286.5978835978836,75,114,41,38.9778949389928,0.5382495590828924,44.25712719298246,8183.771929824569,109.11695906432759,8
1554,32,6,4,188,0.03125,0.020833333333333332,0.9791666666666666,192,6100,4500,1600,0.7377049180327869,77,45,32,206.00707880788315,0.4824548247527632,0.76339570732527,0.11717833840448352,1041575.640569692,-1585.6089857577954,1039990.0315839342,1516,0,282.3177083333333,80,112,41,39.59981938844087,0.5336371527777778,44.85596707818929,8164.609053497908,102.05761316872385,8
1555,32,2,0,190,0.010526315789473684,0.0,1.0,190,6650,5000,1650,0.7518796992481203,83,50,33,205.46929660703628,0.4819647498375568,0.7606528784432038,0.11764999977307898,1043637.2365022759,-1762.9182205930738,1041874.3182816828,1517,0,286.0842105263158,71,119,41,39.35597584924188,0.5362390350877193,44.603587962962976,8172.685185185217,115.10824204486221,0
1556,32,2,3,189,0.010416666666666666,0.015625,0.984375,192,5450,3600,1850,0.6605504587155964,73,36,37,201.31640504009994,0.4820196607766143,0.7575394346046562,0.11601220260388553,1045619.8641975385,-1749.9135802464825,1043869.950617292,1518,0,284.09375,74,118,46,39.21468090115538,0.5380859375,44.361111111111136,8180.444444444505,110.54654654654738,0
1557,32,1,4,186,0.005263157894736842,0.021052631578947368,0.9789473684210527,190,6450,4800,1650,0.7441860465116279,81,48,33,213.47471611899715,0.4816636498654043,0.7696663226694174,0.12466271590155241,1049710.020727047,367.30973639485455,1050077.3304634418,1519,0,287.0473684210526,83,107,38,38.393700072621634,0.5445175438596491,43.86160714285716,8196.42857142862,98.75215146299541,8
1558,32,1,4,183,0.0053475935828877,0.0213903743315508,0.9786096256684492,187,7000,5100,1900,0.7285714285714285,89,51,38,211.8789730343597,0.4809372184846568,0.7654154005070175,0.12430431194989112,1051127.5110534374,142.36351403280332,1051269.8745674703,1520,0,292.24064171122996,67,120,41,38.25802852816956,0.5471813725490196,43.68872549019606,8201.960784313696,122.4173251390104,0
1559,32,0,2,181,0.0,0.01092896174863388,0.9890710382513661,183,6100,4200,1900,0.6885245901639344,80,42,38,206.28591994235111,0.48083053103544904,0.7574737319892189,0.11762956872277446,1042350.9137110775,304.46342752819464,1042655.3771386057,1521,1,298.1256830601093,67,116,44,39.495808826471446,0.5366006375227687,44.761029411764724,8167.647058823568,121.90517998244131,8
1560,32,5,1,185,0.026881720430107527,0.005376344086021506,0.9946236559139785,186,6200,4300,1900,0.6935483870967742,81,43,38,197.4432712418678,0.4816029739416836,0.7506357680684475,0.11377279524921466,1045599.631080468,-2110.6776860361715,1043488.9533944317,1522,0,294.01075268817203,72,114,43,39.31621546190343,0.5394265232974911,44.36358447488587,8180.365296803707,113.61618467782927,0
1561,32,2,2,185,0.0106951871657754,0.0106951871657754,0.9893048128342246,187,5450,4000,1450,0.7339449541284404,69,40,29,196.84348958301013,0.4812522760814981,0.7493747008146423,0.1140787773997541,1047368.2076456303,-1616.4774257459226,1045751.7302198844,1523,0,293.24064171122996,75,112,40,39.11118774664737,0.5422794117647058,44.14747807017547,8187.280701754454,109.16374269005938,0
1562,32,1,2,184,0.005376344086021506,0.010752688172043012,0.989247311827957,186,5800,4000,1800,0.6896551724137931,76,40,36,198.87186643368122,0.4810320401046207,0.7513773881686907,0.11593611209495484,1049183.3952933876,-1269.3879893550911,1047914.0073040324,1524,0,291.7903225806452,76,110,43,38.83327169950871,0.5442988351254481,43.92586580086583,8194.372294372362,107.82068808384687,0
1563,32,1,3,182,0.005405405405405406,0.016216216216216217,0.9837837837837837,185,6350,4800,1550,0.7559055118110236,79,48,31,218.27817801780355,0.48034909909909906,0.7740470111805613,0.12643660500276566,1047211.1111111128,2366.666666666716,1049577.7777777794,1525,0,294.34054054054053,74,111,44,38.582383279044514,0.5434684684684685,44.16666666666667,8186.66666666668,110.6306306306308,8
1564,32,1,1,182,0.00546448087431694,0.00546448087431694,0.994535519125683,183,6350,4600,1750,0.7244094488188977,81,46,35,217.91837268420431,0.4799710762825517,0.7719752760242584,0.1269568204033504,1048983.0138478011,2768.5342702171747,1051751.5481180183,1526,0,297.75409836065575,77,106,40,38.37052756480468,0.5458219489981785,43.950320512820525,8193.589743589773,106.41025641025679,0
1565,32,3,3,182,0.016216216216216217,0.016216216216216217,0.9837837837837837,185,5550,4400,1150,0.7927927927927928,67,44,23,226.8098958511189,0.4799084410497454,0.7830683016604973,0.12945001479362972,1042632.4462890606,4745.8713107638005,1047378.3175998244,1527,0,295.31891891891894,63,122,38,38.93670832270679,0.538400900900901,44.72656249999999,8168.749999999985,129.66269841269818,8
1566,32,1,3,180,0.00546448087431694,0.01639344262295082,0.9836065573770492,183,6600,4300,2300,0.6515151515151515,89,43,46,212.31458117004428,0.4794131187573811,0.7628721320964396,0.123345936374578,1048120.9382716161,1306.271604938805,1049427.209876555,1528,0,297.1693989071038,74,109,35,38.621481803053335,0.5445696721311475,44.05555555555559,8190.222222222311,110.67867867867987,8
1567,32,2,0,182,0.01098901098901099,0.0,1.0,182,6100,4400,1700,0.7213114754098361,78,44,34,225.0580550215573,0.47909646752878793,0.7671530102803354,0.128097749434623,1041777.6709572906,4392.091278107198,1046169.7622353978,1529,0,299.5989010989011,78,104,38,39.08844477745626,0.5365728021978022,44.83122362869199,8165.400843881865,104.68462620361365,8
1568,32,0,0,182,0.0,0.0,1.0,182,7000,5300,1700,0.7571428571428571,87,53,34,192.19517440297648,0.4788061846072896,0.7273913687390787,0.10680708463676447,1034280.0789666,-3643.2719682982224,1030636.8069983018,1530,1,300.5989010989011,75,107,37,40.86455525606469,0.5294184981684982,45.751096491228054,8135.964912280661,108.47953216374215,8
1569,32,8,6,184,0.042105263157894736,0.031578947368421054,0.968421052631579,190,6050,4000,2050,0.6611570247933884,81,40,41,221.8255431245738,0.479775828460039,0.7722386205578504,0.125667339116401,1040316.0510762213,2103.7346102387564,1042419.7856864601,1531,0,288.9,80,110,34,39.353964931746326,0.5341008771929825,45.01028806584361,8159.670781892976,101.9958847736622,8
1570,32,2,0,186,0.010752688172043012,0.0,1.0,186,5800,4100,1700,0.7068965517241379,75,41,34,223.3834971250917,0.47886636636636637,0.7702481573911466,0.12642298458917373,1040002.6353516628,3463.885140833271,1043466.5204924961,1532,0,296.0698924731183,76,110,37,39.35351002865332,0.5316980286738351,45.0487012987013,8158.44155844157,107.34791524265223,8
1571,32,1,2,185,0.0053475935828877,0.0106951871657754,0.9893048128342246,187,6450,4500,1950,0.6976744186046512,84,45,39,224.6001181842072,0.47858806279109883,0.7738908323769433,0.12779291052580377,1041670.007588704,2941.841362673332,1044611.8489513773,1533,0,295.4812834224599,78,109,40,39.113611699653774,0.5340352049910874,44.84440928270042,8164.978902953574,104.679216704533,0
1572,32,2,2,185,0.0106951871657754,0.0106951871657754,0.9893048128342246,187,6200,4300,1900,0.6935483870967742,81,43,38,199.83212582006735,0.4782742031318881,0.7569327440399147,0.1109009867855232,1033853.188775515,-2280.583900226499,1031572.6048752884,1534,0,295.3636363636364,69,118,43,40.72391015884167,0.5230614973262032,45.803571428571445,8134.285714285752,117.88819875776453,8
1573,32,5,3,187,0.02631578947368421,0.015789473684210527,0.9842105263157894,190,6600,4500,2100,0.6818181818181818,87,45,42,201.95352185744224,0.4790517961570593,0.7620161616940861,0.11478482975432068,1041337.39053711,-2539.649307838415,1038797.7412292716,1535,0,288.69473684210527,77,113,41,39.7330153204558,0.5333333333333333,44.885149572649574,8163.675213675213,106.02175602175602,8
1574,32,5,3,189,0.026041666666666668,0.015625,0.984375,192,7300,5500,1800,0.7534246575342466,91,55,36,194.43856681296856,0.47948252981384526,0.7561370636072637,0.11191464038412312,1045249.4735305832,-5052.6380809404545,1040196.8354496427,1536,0,284.0208333333333,72,120,44,39.43666722495161,0.5368923611111112,44.406392694063946,8178.995433790004,113.59715880263894,0
1575,32,1,1,189,0.005263157894736842,0.005263157894736842,0.9947368421052631,190,7050,5300,1750,0.75177304964539,88,53,35,193.3252903066559,0.4791277963427086,0.7527792821623751,0.11192419562736111,1047049.7809887613,-4565.759424965376,1042484.021563796,1537,0,287.62631578947367,73,117,51,39.24084952035073,0.5390899122807018,44.18637387387388,8186.036036036055,112.13747994569938,0
1576,32,1,0,190,0.005263157894736842,0.0,1.0,190,5900,3900,2000,0.6610169491525424,79,39,40,188.960031626149,0.4789473684210526,0.7469561492745087,0.10990988821805012,1048490.6684027793,-4275.434027777677,1044215.2343750016,1538,0,288.56315789473683,75,115,41,39.17323669040353,0.5408991228070175,44.01041666666667,8191.666666666679,109.22222222222238,0
1577,32,2,6,186,0.010416666666666666,0.03125,0.96875,192,5850,4000,1850,0.6837606837606838,77,40,37,188.31716611403743,0.47935470749709136,0.7492251916153774,0.11038795897943895,1050869.0617913709,-4670.663265306832,1046198.398526064,1539,0,286.546875,69,123,45,38.89405024580963,0.5433485243055556,43.72023809523805,8200.952380952283,118.85438233264179,0
1578,32,1,3,184,0.0053475935828877,0.016042780748663103,0.983957219251337,187,6600,4700,1900,0.7121212121212122,85,47,38,186.0517750703524,0.4788240565043222,0.7394552973635926,0.10967484288440231,1052588.1910204068,-4832.8197285126025,1047755.3712918942,1540,0,294.1016042780749,73,114,45,38.738669209520104,0.5462344028520499,43.51069819819818,8207.657657657614,112.43366654325499,0
1579,32,0,1,183,0.0,0.005434782608695652,0.9945652173913043,184,5850,4400,1450,0.7521367521367521,73,44,29,187.89164936835175,0.4782856181199018,0.7381202621143232,0.11126432097866622,1053975.0762164106,-3043.3769073132044,1050931.6993090974,1541,1,299.39130434782606,73,111,43,38.519385637763015,0.5487998188405797,43.34177927927925,8213.063063062997,112.50771319264379,0
1580,32,2,4,181,0.010810810810810811,0.021621621621621623,0.9783783783783784,185,5550,3800,1750,0.6846846846846847,73,38,35,186.22152669402976,0.47828412651782215,0.7354224262147184,0.10944345484602658,1051664.1081537618,-3381.500842058249,1048282.6073117036,1542,0,298.43243243243245,73,112,43,38.84902496385368,0.5510135135135135,43.623310810810814,8204.054054054055,112.38430211032953,8
1581,32,1,1,181,0.005494505494505495,0.005494505494505495,0.9945054945054945,182,6650,5200,1450,0.7819548872180451,81,52,29,187.13040288430162,0.47775446238844027,0.7318549250662711,0.11050744252170135,1053132.049382716,-3635.395061728416,1049496.6543209876,1543,0,303.6978021978022,74,108,45,38.64350999711271,0.5528273809523809,43.44444444444444,8209.777777777777,110.94294294294293,0
1582,32,3,2,182,0.016304347826086956,0.010869565217391304,0.9891304347826086,184,5350,3600,1750,0.6728971962616822,71,36,35,186.89842475196974,0.4773662093133761,0.7352189536648508,0.11127082256015823,1055604.5149459688,-2691.835799106193,1052912.6791468626,1544,0,301.23369565217394,78,106,45,38.34285164271045,0.5550271739130435,43.14345991561182,8219.409282700439,105.37704208590306,0
1583,32,2,6,178,0.010869565217391304,0.03260869565217391,0.967391304347826,184,5100,3600,1500,0.7058823529411765,66,36,30,189.86724205541788,0.4770562336659539,0.7346985428588262,0.1101828010983025,1047779.7067901328,-2112.1913580242294,1045667.5154321085,1545,0,299.0326086956522,80,104,34,39.23846675712347,0.5469316123188406,44.09722222222225,8188.888888888963,102.36111111111204,7
1584,32,0,1,177,0.0,0.0056179775280898875,0.9943820224719101,178,5750,3900,1850,0.6782608695652174,76,39,37,188.6779947411415,0.47657985780486256,0.7233952075378671,0.10996364418317404,1049100.255987819,-1761.5734835597527,1047338.6825042593,1546,1,308.91011235955057,83,95,35,39.10464792483898,0.5497425093632959,43.936011904761926,8194.047619047677,98.72346528973104,0
1585,32,2,4,175,0.0111731843575419,0.0223463687150838,0.9776536312849162,179,5450,3400,2050,0.6238532110091743,75,34,41,189.52441441916957,0.4764021404808236,0.7274218396119572,0.11108757756054323,1050846.873184539,-1417.7723430968022,1049429.1008414421,1547,0,308.1117318435754,76,103,37,38.86586782094592,0.5524906890130354,43.72294372294373,8200.865800865828,107.90612895876089,0
1586,32,2,2,175,0.011299435028248588,0.011299435028248588,0.9887005649717514,177,6200,4400,1800,0.7096774193548387,80,44,36,213.2841554941286,0.47535337485019685,0.750424354450522,0.12324548685084379,1046465.0634765626,3038.883463541657,1049503.9469401042,1548,0,310.5819209039548,79,98,37,38.80323685148413,0.5483168549905838,44.2578125,8183.750000000001,103.59177215189875,8
1587,32,6,6,175,0.03314917127071823,0.03314917127071823,0.9668508287292817,181,5650,4100,1550,0.7256637168141593,72,41,31,208.54253455491437,0.4754054123183957,0.7498812669916042,0.12179498885430731,1049741.5651010687,1933.1533227638529,1051674.7184238324,1549,0,301.4475138121547,86,95,36,38.51610339830784,0.552255985267035,43.85775862068965,8196.55172413792,95.30874097834791,0
1588,32,2,2,175,0.011299435028248588,0.011299435028248588,0.9887005649717514,177,5450,3400,2050,0.6238532110091743,75,34,41,236.6311502987735,0.4749507789762027,0.7803394680812987,0.1344946404093263,1041337.3905371068,8432.572914383603,1049769.9634514903,1550,0,309.1186440677966,77,100,36,38.84833752115719,0.5387241054613936,44.88514957264956,8163.6752136751875,106.02175602175568,8
1589,32,3,2,176,0.016853932584269662,0.011235955056179775,0.9887640449438202,178,5650,3600,2050,0.6371681415929203,77,36,41,214.12824626443745,0.47496574726507124,0.7616346479851885,0.11884043881237188,1033867.8610600971,3026.0623915927968,1036893.9234516899,1551,0,307.3988764044944,65,113,41,40.35866550767831,0.5279143258426966,45.80176767676768,8134.343434343444,125.14374514374529,8
1590,32,1,2,175,0.005649717514124294,0.011299435028248588,0.9887005649717514,177,5750,3700,2050,0.6434782608695652,78,37,41,215.14143971677584,0.47481568866632423,0.7604674466191133,0.11997764951076659,1035382.1842281149,3400.722754387393,1038782.9069825023,1552,0,305.9717514124294,66,111,41,40.14281057735405,0.530484934086629,45.61567164179105,8140.2985074627,123.33785617367728,0
1591,32,8,2,181,0.04371584699453552,0.01092896174863388,0.9890710382513661,183,6000,4200,1800,0.7,78,42,36,206.22262403516078,0.476465701875538,0.7588614495858597,0.1170415819855186,1040885.7709750587,330.8390022676658,1041216.6099773264,1553,0,296.44262295081967,76,107,42,39.68057176196032,0.5347222222222222,44.9404761904762,8161.904761904778,107.3934837092734,0
1592,32,1,2,180,0.005494505494505495,0.01098901098901099,0.989010989010989,182,6000,4400,1600,0.7333333333333333,76,44,32,207.43360130140476,0.476523131564568,0.7590552797806682,0.11806475484259592,1041773.5299556227,819.7670118344104,1042593.2969674572,1554,0,299.0659340659341,77,105,45,39.53868346679225,0.5359432234432234,44.831730769230774,8165.384615384627,106.0439560439562,0
1593,32,3,1,182,0.01639344262295082,0.00546448087431694,0.994535519125683,183,5650,3700,1950,0.6548672566371682,76,37,39,200.8547313560744,0.4770474288916912,0.7488355867496306,0.1119586129191171,1035236.559392001,-663.5677946667683,1034572.9915973343,1555,0,298.3224043715847,72,111,42,40.52449137963274,0.5289731329690346,45.6335616438356,8139.726027397221,113.05175038051695,8
1594,32,6,4,184,0.031914893617021274,0.02127659574468085,0.9787234042553191,188,5650,4000,1650,0.7079646017699115,73,40,33,192.0761044414984,0.477913917017484,0.7429298993501121,0.10831753103716517,1038887.135736816,-3340.9212026578753,1035546.2145341581,1556,0,291.18617021276594,81,107,36,40.2910892035163,0.5323581560283688,45.185467479674756,8154.0650406502955,100.66746963765797,0
1595,32,4,3,185,0.02127659574468085,0.015957446808510637,0.9840425531914894,188,6650,5100,1550,0.7669172932330827,82,51,31,227.86034748185568,0.47845021712747,0.7850057623379245,0.12892154805510422,1039917.6234934254,3141.198208343486,1043058.8217017689,1557,0,291.1436170212766,73,115,35,39.25002990815897,0.5308621453900709,45.05912162162162,8158.108108108105,111.75490559052199,8
1596,32,2,6,181,0.0106951871657754,0.03208556149732621,0.9679144385026738,187,6650,5000,1650,0.7518796992481203,83,50,33,231.27046686461384,0.4780897207367796,0.7891162443000943,0.13162448203625926,1041755.8468519201,4135.47221207702,1045891.3190639971,1558,0,293.16042780748666,73,114,42,38.932658005553385,0.5332553475935828,44.8338963963964,8165.315315315321,111.85363445637425,0
1597,32,3,1,183,0.016304347826086956,0.005434782608695652,0.9945652173913043,184,6500,4700,1800,0.7230769230769231,83,47,36,216.70727727045718,0.4788065751960085,0.7748085376742915,0.12358171757855818,1042375.1300728422,1878.0552665048886,1044253.1853393471,1559,0,298.0217391304348,61,123,44,39.22678602773391,0.5323822463768115,44.75806451612904,8167.741935483882,133.8974087784243,8
1598,32,1,3,181,0.005434782608695652,0.016304347826086956,0.9836956521739131,184,6350,5300,1050,0.8346456692913385,74,53,21,212.85241948566272,0.47845514571948994,0.7700230051407688,0.12217267933663636,1044387.3952686827,1310.0767926537615,1045697.4720613365,1560,0,299.0108695652174,66,118,41,39.07368810726381,0.5343070652173914,44.511815920398014,8175.621890547274,123.87305894768598,0
1599,32,4,4,181,0.021621621621621623,0.021621621621621623,0.9783783783783784,185,5850,4300,1550,0.7350427350427351,74,43,31,207.69849598611108,0.47871254406580493,0.7652462278229135,0.12046789053853613,1047619.5233805075,667.7998743638295,1048287.3232548713,1561,0,297.5891891891892,70,115,38,38.80212812720982,0.5377815315315315,44.1167840375587,8188.262910798165,116.97518443997379,0
1600,32,3,2,182,0.016304347826086956,0.010869565217391304,0.9891304347826086,184,6350,4600,1750,0.7244094488188977,81,46,35,213.60141776286352,0.47854424051635386,0.7704360505016894,0.12478889954892713,1049838.414824761,1699.394765697572,1051537.8095904586,1562,0,299.7826086956522,75,109,41,38.37445600799044,0.5400815217391304,43.845942982456165,8196.929824561461,109.29239766081947,0
1601,32,1,4,179,0.00546448087431694,0.02185792349726776,0.9781420765027322,183,6350,4600,1750,0.7244094488188977,81,46,35,232.8965150165114,0.4786162152965432,0.7875954786234207,0.13341375622757418,1043774.8635746073,5668.305637672132,1049443.1692122794,1563,0,300.5409836065574,60,123,39,38.63826302065927,0.5323315118397085,44.586748633879786,8173.2240437158525,136.22040072859755,8
1602,32,5,1,183,0.02717391304347826,0.005434782608695652,0.9945652173913043,184,6350,4800,1550,0.7559055118110236,79,48,31,225.00512880659193,0.4780232834402471,0.7805140326515714,0.13031063428820958,1047157.8131781671,3973.1757269964596,1051130.9889051635,1564,0,297.8152173913044,63,121,47,38.41694235907876,0.5348731884057971,44.17317708333333,8186.458333333322,129.9437830687829,0
1603,32,1,4,180,0.005434782608695652,0.021739130434782608,0.9782608695652174,184,4850,3300,1550,0.6804123711340206,64,33,31,223.56396421009524,0.4780925793933634,0.7794031067746485,0.13015030188840818,1048757.341172957,5242.869737412993,1054000.21091037,1565,0,298.75,63,121,38,38.25413223140495,0.536231884057971,43.97786458333332,8192.70833333331,130.04298941798905,0
1604,32,2,2,180,0.01098901098901099,0.01098901098901099,0.989010989010989,182,6900,5100,1800,0.7391304347826086,87,51,36,226.95027250471813,0.478183878736365,0.7810244700354589,0.133476629128803,1051885.6238242404,4445.145794141296,1056330.7696183817,1566,0,302.8956043956044,60,122,39,37.77722277722279,0.5383470695970696,43.596311475409834,8204.918032786882,136.74863387978135,0
1605,32,1,1,180,0.0055248618784530384,0.0055248618784530384,0.994475138121547,181,5950,4100,1850,0.6890756302521008,78,41,37,224.3320386239103,0.47795938203396765,0.777313413832194,0.1327051726545932,1053658.0999248438,5123.8539137470525,1058781.9538385908,1567,0,305.292817679558,61,120,43,37.623576011522836,0.5406883057090239,43.38037634408601,8211.827956989224,134.62013044244628,0
1606,32,0,2,178,0.0,0.011111111111111112,0.9888888888888889,180,5100,3600,1500,0.7058823529411765,66,36,30,221.43052944394404,0.4777389819987585,0.7726730207796664,0.13143628674333196,1054696.3970773495,5608.39632149151,1060304.793398841,1568,1,307.22222222222223,62,118,44,37.568827279752696,0.5420138888888889,43.25396825396825,8215.873015873016,132.51408090117766,0
1607,32,2,3,177,0.011111111111111112,0.016666666666666666,0.9833333333333333,180,4900,3300,1600,0.673469387755102,65,33,32,219.67492086675168,0.47711243016759775,0.7707004559754962,0.13113431426572966,1056415.0065746221,5513.576594345872,1061928.583168968,1569,0,305.3,64,116,39,37.40021204939502,0.5447337962962964,43.044871794871796,8222.564102564105,128.47756410256414,0
1608,32,0,4,173,0.0,0.022598870056497175,0.9774011299435028,177,5750,3700,2050,0.6434782608695652,78,37,41,238.19534529059197,0.4767203282828283,0.7821934901624925,0.13721393834345388,1045506.2500000017,8656.94444444454,1054163.1944444464,1570,1,310.42937853107344,64,113,35,38.28613148600924,0.5384887005649718,44.37500000000001,8180.000000000014,127.81250000000021,8
1609,32,3,2,174,0.017045454545454544,0.011363636363636364,0.9886363636363636,176,6050,4600,1450,0.7603305785123967,75,46,29,238.76171486125156,0.47640151515151513,0.7760767707019469,0.13309643668977633,1035255.6287282491,8185.881846983926,1043441.510575233,1571,0,311.02840909090907,66,110,36,39.55786626734305,0.5287642045454546,45.631218905472636,8139.800995024873,123.33031810643747,8
1610,32,6,2,178,0.03333333333333333,0.011111111111111112,0.9888888888888889,180,5450,3800,1650,0.6972477064220184,71,38,33,231.0710778996532,0.4774564194082351,0.7736213761353747,0.13043392703185186,1039189.39346552,6575.322657992762,1045764.7161235127,1572,0,296.21666666666664,72,108,32,39.25951847704366,0.5321180555555556,45.148401826484005,8155.25114155248,113.26737696600667,0
1611,32,1,1,178,0.00558659217877095,0.00558659217877095,0.994413407821229,179,6650,5500,1150,0.8270676691729323,78,55,23,232.30119202378765,0.47716192747891956,0.7744983864832853,0.13241249828046128,1042229.5915276549,5972.235294868175,1048201.826822523,1573,0,298.8659217877095,65,114,40,38.8469971966277,0.5395716945996276,44.775883838383855,8167.171717171755,125.64879564879622,8
1612,32,3,4,177,0.016574585635359115,0.022099447513812154,0.9779005524861879,181,5400,3300,2100,0.6111111111111112,75,33,42,228.4871518210631,0.47757443216697365,0.7728751079100451,0.131132440401642,1044353.7491589851,6124.282727797456,1050478.0318867825,1574,0,296.5414364640884,67,114,43,38.67844865491468,0.5411487108655617,44.51593137254905,8175.490196078494,122.02224173251483,0
1613,32,5,6,176,0.027472527472527472,0.03296703296703297,0.967032967032967,182,5050,3700,1350,0.7326732673267327,64,37,27,219.45061836126322,0.47744204460364686,0.7651076990772265,0.12742994865621746,1047971.8347993381,4545.61343438099,1052517.4482337192,1575,0,294.4835164835165,73,109,34,38.45744412665242,0.5440132783882784,44.0737612612613,8189.639639639733,112.18684437862647,0
1614,32,1,5,172,0.005649717514124294,0.02824858757062147,0.9717514124293786,177,6500,4800,1700,0.7384615384615385,82,48,34,224.38544760795952,0.47647422316384186,0.76533208989884,0.13040679325030338,1048234.6944444543,5141.722222222716,1053376.416666677,1576,0,303.6045197740113,74,103,35,38.29833414726793,0.5460805084745763,44.0416666666667,8190.666666666744,110.68468468468573,0
1615,32,5,3,174,0.02824858757062147,0.01694915254237288,0.9830508474576272,177,5950,4300,1650,0.7226890756302521,76,43,33,213.85014764421288,0.47743189308337614,0.7614866866424652,0.12214376606836952,1042862.6495940703,3253.2663176654432,1046115.9159117357,1577,0,302.6101694915254,66,111,42,39.23875423746015,0.5401365348399247,44.69838308457712,8169.651741293539,123.78260214081119,8
1616,32,2,0,176,0.011363636363636364,0.0,1.0,176,5800,4300,1500,0.7413793103448276,73,43,30,198.48691296533994,0.477441829004329,0.7401677298975191,0.11342516131147035,1043017.0282708737,405.0460223536229,1043422.0742932273,1578,0,304.8125,64,112,45,39.61170913884004,0.5390625,44.679487179487175,8170.256410256405,127.66025641025632,8
1617,32,4,0,180,0.022222222222222223,0.0,1.0,180,6450,4600,1850,0.7131782945736435,83,46,37,190.68279955699552,0.47795753155390025,0.7346571622539035,0.11014735833233495,1046358.5069444432,-2545.486111111181,1043813.0208333321,1579,0,299.01666666666665,69,111,51,39.39451799049561,0.5423611111111111,44.27083333333333,8183.333333333323,118.59903381642498,0
1618,32,1,3,178,0.0055248618784530384,0.016574585635359115,0.9834254143646409,181,6500,4400,2100,0.676923076923077,86,44,42,191.2081207183893,0.47762686719869035,0.7370979521018459,0.11110139492470848,1048169.2449333844,-2616.3056962949304,1045552.9392370895,1580,0,298.35911602209944,72,109,45,39.15567913623608,0.5445441988950277,44.04965753424658,8190.410958904118,113.7557077625572,0
1619,32,4,0,182,0.02197802197802198,0.0,1.0,182,5750,3900,1850,0.6782608695652174,76,39,37,186.59852794614463,0.47794292493878127,0.7321476061392378,0.10952117943211326,1051262.534497899,-2917.1917155521487,1048345.3427823469,1581,0,297.53846153846155,66,116,44,38.889225854713814,0.5469894688644689,43.67226368159201,8202.48756218898,124.28011457862091,0
1620,32,0,4,178,0.0,0.02197802197802198,0.978021978021978,182,5350,3400,1950,0.6355140186915887,73,34,39,185.58695851373784,0.4778695636775747,0.7313054561755512,0.10937284218217164,1052510.0359537133,-2683.5727244333466,1049826.46322928,1582,1,298.53846153846155,67,115,48,38.76029037010494,0.5483630952380952,43.52022058823527,8207.35294117642,122.49780509218536,0
1621,32,0,2,176,0.0,0.011235955056179775,0.9887640449438202,178,5450,3600,1850,0.6605504587155964,73,36,37,210.66787306303647,0.4773627774603779,0.7587297922535423,0.1214043405350522,1045627.9797335609,3006.044501133816,1048634.0242346947,1583,2,304.9943820224719,69,109,43,38.974608048586454,0.5457631086142323,44.36011904761905,8180.476190476196,118.55762594893038,8
1622,32,1,1,176,0.005649717514124294,0.005649717514124294,0.9943502824858758,177,4050,2900,1150,0.7160493827160493,52,29,23,208.10285059940145,0.47713228685156656,0.7551160466752989,0.12046750674140627,1047018.9446538368,4127.525402808015,1051146.4700566449,1584,0,307.6497175141243,70,107,44,38.866664754913195,0.54719868173258,44.19014084507042,8185.915492957733,116.94164989939618,0
1623,32,2,4,174,0.011235955056179775,0.02247191011235955,0.9775280898876404,178,6200,4100,2100,0.6612903225806451,83,41,42,207.30434063365485,0.47742559618273767,0.7547545166026013,0.11890389627991796,1044167.6906179115,1492.0989229023112,1045659.7895408139,1585,0,305.7247191011236,69,109,40,39.24286664336615,0.5444171348314606,44.53869047619047,8174.761904761886,118.47481021394039,8
1624,32,0,1,173,0.0,0.005747126436781609,0.9942528735632183,174,6600,4800,1800,0.7272727272727273,84,48,36,204.24707490644516,0.4767547283679933,0.7437812141170554,0.11759813831214226,1045349.2931719349,1301.9070771774805,1046651.2002491123,1586,1,312.0919540229885,75,99,38,39.173514665665714,0.5465158045977012,44.39418859649122,8179.3859649122605,109.05847953216347,0
1625,32,1,1,173,0.005747126436781609,0.005747126436781609,0.9942528735632183,174,5550,4100,1450,0.7387387387387387,70,41,29,200.8439901769277,0.4765630190685004,0.7362744326282338,0.11540061621721281,1044711.1234568015,1614.7901234575002,1046325.9135802591,1587,0,312.0287356321839,74,100,38,39.34010037322904,0.54477969348659,44.472222222222264,8176.88888888898,110.49849849849973,8
1626,32,3,3,173,0.017045454545454544,0.017045454545454544,0.9829545454545454,176,6400,4700,1700,0.734375,81,47,34,198.78379451043702,0.4762743506493507,0.7391877931650648,0.11424326675522867,1044782.6880173533,-62.8265674190493,1044719.8614499342,1588,0,309.4318181818182,72,104,43,39.383818219045544,0.5472301136363636,44.46347031963472,8177.168949771736,113.57179096905189,8
1627,32,2,1,174,0.011428571428571429,0.005714285714285714,0.9942857142857143,175,5300,3400,1900,0.6415094339622641,72,34,38,188.72493311112095,0.47643951833607007,0.7214990604026843,0.10772301192750948,1042660.4369854206,-944.7957544627734,1041715.6412309578,1589,0,310.9428571428571,75,100,40,39.90542505592843,0.5410714285714286,44.72313596491229,8168.859649122823,108.91812865497097,8
1628,32,1,1,174,0.005714285714285714,0.005714285714285714,0.9942857142857143,175,5250,4100,1150,0.780952380952381,64,41,23,187.290262277357,0.4762424740010947,0.7185150893130103,0.10766721404380267,1044867.2851562542,-1111.3064236109221,1043755.9787326433,1590,0,311.8342857142857,79,96,41,39.666980875709115,0.5431547619047619,44.453125000000014,8177.500000000033,103.51265822784852,0
1629,32,3,1,176,0.01694915254237288,0.005649717514124294,0.9943502824858758,177,4650,3300,1350,0.7096774193548387,60,33,27,224.7254868670983,0.4768942068995035,0.7693246650015679,0.12768763566571928,1041239.4097500381,6748.606660257367,1047988.0164102954,1591,0,304.06779661016947,78,99,39,39.164340724660185,0.5358992467043315,44.89715189873417,8163.29113924049,104.65757870821142,8
1630,32,1,1,176,0.005649717514124294,0.005649717514124294,0.9943502824858758,177,7000,5300,1700,0.7571428571428571,87,53,34,222.2809146624609,0.47709349854476973,0.7664512754873827,0.12690725378155823,1042735.6377317412,3956.0462612312535,1046691.6839929725,1592,0,304.98870056497174,66,111,40,39.03940824198134,0.5380767419962336,44.713930348258714,8169.154228855737,123.77506407357177,0
1631,32,2,3,175,0.011235955056179775,0.016853932584269662,0.9831460674157303,178,5450,3800,1650,0.6972477064220184,71,38,33,217.28623827323395,0.47735484246386933,0.7631044212302653,0.12490731677370294,1044858.287046224,4356.665344177929,1049214.9523904019,1593,0,304.23595505617976,70,108,40,38.901567344126775,0.5404962546816479,44.45422535211269,8177.464788732419,116.82092555332027,0
1632,32,2,1,176,0.011299435028248588,0.005649717514124294,0.9943502824858758,177,5850,4400,1450,0.7521367521367521,73,44,29,216.24364999792803,0.4779120655709639,0.7599431408601129,0.12516579338975037,1046983.7160493884,4030.716049382992,1051014.4320987714,1594,0,306.7457627118644,74,103,42,38.662811742136356,0.5431967984934087,44.194444444444464,8185.777777777823,110.61861861861922,0
1633,32,2,2,176,0.011235955056179775,0.011235955056179775,0.9887640449438202,178,5350,3900,1450,0.7289719626168224,68,39,29,194.05617272954586,0.4782395945745784,0.7284001463018097,0.1116496591449512,1045125.0895708376,-387.40501885155936,1044737.684551986,1595,0,305.8988764044944,75,103,45,39.46194428058134,0.5411985018726592,44.42160087719301,8178.508771929889,109.04678362573185,8
1634,32,4,2,178,0.022222222222222223,0.011111111111111112,0.9888888888888889,180,5000,3000,2000,0.6,70,30,40,192.08370754833865,0.47796787709497207,0.7256012346935288,0.11149477814988461,1047850.7921007077,-744.9869791660249,1047105.8051215416,1596,0,303.3833333333333,79,101,44,39.172899494589714,0.5439814814814814,44.08854166666671,8189.166666666772,103.66033755274394,0
1635,32,1,2,177,0.00558659217877095,0.0111731843575419,0.9888268156424581,179,5750,4100,1650,0.7130434782608696,74,41,33,196.01591338365176,0.4773214696712908,0.7318847681912226,0.11421193886487582,1049024.0478515762,-424.9186197909967,1048599.1292317852,1597,0,306.07262569832403,79,100,46,38.926233155352186,0.545332867783985,43.94531250000004,8193.75000000011,103.71835443038113,0
1636,32,0,2,175,0.0,0.011299435028248588,0.9887005649717514,177,6400,4800,1600,0.75,80,48,32,195.2552679795474,0.47662670133538776,0.72787936299896,0.11393227840060693,1049465.340755144,-817.2727311211211,1048648.0680240227,1598,1,310.2090395480226,80,97,47,38.890806762072195,0.5469632768361582,43.891460905349824,8195.473251028874,102.44341563786092,0
1637,32,2,1,176,0.011299435028248588,0.005649717514124294,0.9943502824858758,177,5300,4000,1300,0.7547169811320755,66,40,26,223.84160791309665,0.47654109955487073,0.7521526875450653,0.12623594391170934,1038899.2428927498,5809.7753977623815,1044709.0182905123,1599,0,310.61581920903956,76,101,34,39.480139980179786,0.533662900188324,45.183982683982684,8154.1125541125575,107.29095465937576,8
1638,32,2,3,175,0.011235955056179775,0.016853932584269662,0.9831460674157303,178,6550,5000,1550,0.7633587786259542,81,50,31,217.07835092074248,0.47626708669248186,0.7505727871880989,0.12591343169781907,1047632.0047647257,3333.6455932240697,1050965.6503579498,1600,0,309.73595505617976,76,102,38,38.56055599612305,0.5454705056179776,44.11525974025977,8188.311688311766,107.74094326726008,8
1639,32,1,2,174,0.005681818181818182,0.011363636363636364,0.9886363636363636,176,4650,3000,1650,0.6451612903225806,63,30,33,218.36866542602823,0.47586241883116887,0.7482504202034745,0.12713836211625873,1048787.7237666785,5954.475110826814,1054742.1988775053,1601,0,314.1931818181818,78,98,40,38.383353933838066,0.5468158143939394,43.97415611814349,8192.827004219487,105.03624364383958,0
1640,32,2,1,175,0.011363636363636364,0.005681818181818182,0.9943181818181818,176,5200,3700,1500,0.7115384615384616,67,37,30,231.65093090581428,0.4755891504329004,0.7625416627113477,0.13665977915655028,1052822.576530605,8377.465986394182,1061200.0425169992,1602,0,314.40340909090907,69,107,42,37.53988281703214,0.5501302083333333,43.48214285714283,8208.571428571371,118.96480331262856,0
1641,32,0,1,174,0.0,0.005714285714285714,0.9942857142857143,175,5750,4300,1450,0.7478260869565218,72,43,29,234.53520913704153,0.4751929392446634,0.763653941942597,0.13894999945318418,1054116.746153758,8695.498302805692,1062812.2444565636,1603,1,316.4685714285714,70,105,38,37.30458702486425,0.5520238095238095,43.32453051643191,8213.61502347415,117.33735747820215,0
1642,32,2,0,176,0.011363636363636364,0.0,1.0,176,6500,5000,1500,0.7692307692307693,80,50,30,234.16042368872002,0.47523065476190474,0.76689140615372,0.13672744528314926,1049676.1402606273,7458.521947873526,1057134.6622085008,1604,0,312.32954545454544,71,105,38,37.86809007380627,0.5456321022727273,43.865740740740726,8196.296296296267,115.44079290558122,8
1643,32,4,3,177,0.022222222222222223,0.016666666666666666,0.9833333333333333,180,5200,3800,1400,0.7307692307692307,66,38,28,225.62790383658313,0.47522630871094557,0.7713874767254545,0.12898921391561835,1043147.9659763332,5872.657790927142,1049020.6237672605,1605,0,306.3666666666667,64,116,38,38.90235674386497,0.5376157407407407,44.66346153846155,8170.769230769246,127.66826923076947,8
1644,32,5,1,181,0.027472527472527472,0.005494505494505495,0.9945054945054945,182,6350,4700,1650,0.7401574803149606,80,47,33,217.70806236320269,0.4763093720276041,0.7645936209327053,0.1259413471736547,1046807.2026969871,2829.673553401248,1049636.8762503883,1606,0,303.0879120879121,75,107,41,38.64738506055087,0.5399496336996337,44.216008771929836,8185.0877192982725,109.13450292397697,8
1645,32,4,5,180,0.021621621621621623,0.02702702702702703,0.972972972972973,185,5800,4100,1700,0.7068965517241379,75,41,34,212.3042103204202,0.47681771445358406,0.7625676489906237,0.12392293823978653,1049570.7378617832,1765.6573354336288,1051336.395197217,1607,0,298.61621621621623,80,105,39,38.441035683202806,0.5427927927927928,43.87860082304529,8195.88477366261,102.44855967078263,0
1646,32,2,0,182,0.01098901098901099,0.0,1.0,182,6550,5200,1350,0.7938931297709924,79,52,27,197.55359513627167,0.476248659259709,0.7485888009500818,0.11379341168074572,1045482.9053814622,-1642.218677675217,1043840.686703787,1608,0,304.11538461538464,72,110,41,39.32794648505827,0.5394917582417582,44.37785388127856,8179.908675799137,113.60984271943246,8
1647,32,5,6,181,0.026737967914438502,0.03208556149732621,0.9679144385026738,187,6000,4100,1900,0.6833333333333333,79,41,38,187.2614056140984,0.4767803749065609,0.741432184866957,0.10914886789587683,1049130.7400173692,-4107.660590277335,1045023.0794270919,1609,0,296.9572192513369,79,108,38,39.13713176717857,0.5429478609625669,43.93229166666669,8194.16666666673,103.72362869198392,0
1648,32,1,3,179,0.005494505494505495,0.016483516483516484,0.9835164835164835,182,5600,3900,1700,0.6964285714285714,73,39,34,204.71519168924405,0.47596723028352866,0.7552475183083669,0.1171662227586314,1043499.5654020981,724.0427117866789,1044223.6081138848,1610,0,305.31868131868134,72,110,38,39.39242610493379,0.5387477106227105,44.62043378995434,8172.146118721466,113.50202942668703,7
1649,32,1,1,179,0.005555555555555556,0.005555555555555556,0.9944444444444445,180,6400,4800,1600,0.75,80,48,32,192.75301957517692,0.4758664390647631,0.7380725623582765,0.10982439487422885,1042100.6944444458,-2226.3888888887973,1039874.305555557,1611,0,308.8888888888889,74,106,41,39.87244897959184,0.5400462962962963,44.79166666666667,8166.666666666678,110.36036036036052,8
1650,32,5,2,182,0.02717391304347826,0.010869565217391304,0.9891304347826086,184,5350,3800,1550,0.7102803738317757,69,38,31,186.47812030148992,0.47624138750296985,0.7350074962518722,0.10737639057071412,1045375.1643655545,-3162.080867849794,1042213.0834977047,1612,0,303.125,77,107,45,39.62447753396029,0.5432518115942029,44.39102564102566,8179.487179487223,106.2271062271068,0
1651,32,2,3,181,0.010869565217391304,0.016304347826086956,0.9836956521739131,184,7650,5800,1850,0.7581699346405228,95,58,37,198.78492194698813,0.47628964718460437,0.7504638763329421,0.11391854809404464,1043898.7111243401,-2947.7352377171183,1040950.9758866229,1613,0,303.29891304347825,70,114,41,39.49406471376605,0.541213768115942,44.57159624413147,8173.708920187825,116.7672702883975,8
1652,32,2,2,181,0.01092896174863388,0.01092896174863388,0.9890710382513661,183,4650,2800,1850,0.6021505376344086,65,28,37,206.41067649882825,0.47653075521927984,0.7554559800110074,0.11586234480315875,1037433.1041019217,1577.4537679914897,1039010.5578699132,1614,0,301.9945355191257,70,113,42,40.107887762157176,0.5297700364298725,45.36384976525822,8148.356807511752,116.40509725016788,7
1653,32,1,1,181,0.005494505494505495,0.005494505494505495,0.9945054945054945,182,5950,4200,1750,0.7058823529411765,77,42,35,197.6481512029175,0.476450402728027,0.7438620227154866,0.108346773411569,1029953.5158300758,-1636.3183542480733,1028317.1974758278,1615,0,301.2362637362637,80,102,46,41.26877523780559,0.5245535714285714,46.28343621399178,8118.930041152283,101.48662551440353,8
1654,32,5,0,186,0.026881720430107527,0.0,1.0,186,5500,3600,1900,0.6545454545454545,74,36,38,204.99873606380896,0.47749564080209245,0.7547904178351963,0.10983044865935195,1022626.5625000002,-772.5694444444753,1021853.9930555557,1616,0,295.7204301075269,79,107,33,42.004875703886825,0.5182571684587813,47.1875,8090.000000000002,102.40506329113926,8
1655,32,3,1,188,0.015873015873015872,0.005291005291005291,0.9947089947089947,189,5800,3900,1900,0.6724137931034483,77,39,38,203.1358145467618,0.4782062647754137,0.7576789956454035,0.10981217616357863,1025503.0258960417,-1936.7215028876767,1023566.304393154,1617,0,292.010582010582,72,117,39,41.68944688685981,0.5207782186948854,46.83219178082192,8101.369863013708,112.51902587519038,0
1656,32,6,2,192,0.030927835051546393,0.010309278350515464,0.9896907216494846,194,6200,4500,1700,0.7258064516129032,79,45,34,200.20706318417913,0.47913495094635256,0.7571695159241967,0.10873541928620314,1026996.0169890099,-3877.628707356068,1023118.3882816539,1618,0,285.319587628866,77,117,41,41.57568349937628,0.5200279209621993,46.6479700854701,8107.26495726499,105.28915528915572,8
1657,32,4,5,191,0.02040816326530612,0.025510204081632654,0.9744897959183674,196,7000,5100,1900,0.7285714285714285,89,51,38,195.55774060775173,0.47924624978196406,0.7543853670308849,0.10702457339353615,1029430.2738060727,-5937.388308252825,1023492.8854978199,1619,0,283.05102040816325,82,114,42,41.38752824369568,0.5226403061224489,46.347891566265076,8116.8674698795585,98.98618865706779,0
1658,32,5,7,189,0.025510204081632654,0.03571428571428571,0.9642857142857143,196,6150,4800,1350,0.7804878048780488,75,48,27,212.73964587130348,0.48024539944182804,0.768366236921983,0.11691430973101274,1030754.9878227836,-1493.5097820999417,1029261.4780406837,1620,0,280.5969387755102,82,114,36,40.785082080696206,0.5248193027210885,46.18473895582331,8122.088353413707,99.04985796845985,7
1659,32,2,3,188,0.010471204188481676,0.015706806282722512,0.9842931937172775,191,6350,4200,2150,0.6614173228346457,85,42,43,195.28953323030123,0.47893014604574263,0.7543221051044484,0.10796000711577085,1032626.203728744,-4217.782134486984,1028408.421594257,1621,0,288.87958115183244,85,106,43,40.99321382028541,0.524760034904014,45.95445736434109,8129.457364341099,95.64067487460116,8
1660,32,3,2,189,0.015706806282722512,0.010471204188481676,0.9895287958115183,191,6650,4700,1950,0.706766917293233,86,47,39,201.01377288421008,0.4792883714521907,0.7594217189343055,0.11009045162608937,1029661.1882716,-3454.7839506175715,1026206.4043209825,1622,0,289.5130890052356,74,117,46,41.220115886485985,0.5193608202443281,46.31944444444443,8117.777777777739,109.69969969969918,8
1661,32,7,9,187,0.03571428571428571,0.04591836734693878,0.9540816326530612,196,7350,5400,1950,0.7346938775510204,93,54,39,205.11009607819148,0.4804132871097157,0.7744050688867612,0.11301455022608412,1031578.7777777701,-4232.555555555942,1027346.2222222141,1623,0,283.0204081632653,74,122,39,40.875246143747916,0.5163159013605443,46.08333333333331,8125.333333333272,109.80180180180098,8
1662,32,3,3,187,0.015789473684210527,0.015789473684210527,0.9842105263157894,190,6800,4700,2100,0.6911764705882353,89,47,42,241.39903165210058,0.47946428571428573,0.798254411958778,0.13287547702104907,1031259.0556412851,4988.9874828529455,1036248.0431241381,1624,0,292.19473684210527,71,119,35,39.994111389712025,0.5173793859649123,46.12268518518517,8124.074074074039,114.42357850808506,8
1663,32,7,4,190,0.03608247422680412,0.020618556701030927,0.979381443298969,194,4650,3100,1550,0.6666666666666666,62,31,31,254.21334548801147,0.4800174269536884,0.8107684701074633,0.1390436472277903,1029242.9760665948,8879.460053185216,1038122.4361197801,1625,0,286.9381443298969,61,133,41,39.923379261614535,0.5136920103092784,46.37096774193547,8116.129032258045,133.05129561078763,8
1664,32,2,2,190,0.010416666666666666,0.010416666666666666,0.9895833333333334,192,7000,4700,2300,0.6714285714285714,93,47,46,251.32965556797933,0.4797387425465387,0.8091110598605997,0.1390006870590248,1032764.0624999957,6512.847222222057,1039276.9097222177,1626,0,290.625,69,123,40,39.55215593822604,0.51708984375,45.937499999999986,8129.999999999966,117.82608695652125,0
1665,32,3,3,190,0.015544041450777202,0.015544041450777202,0.9844559585492227,193,6450,5100,1350,0.7906976744186046,78,51,27,241.78523381414317,0.47985256548647093,0.8053700835069364,0.13431329508353884,1034157.7783558739,4958.816048097703,1039116.5944039716,1627,0,289.9896373056995,61,132,34,39.61912943871706,0.5213730569948187,45.76612903225804,8135.483870967699,133.3685880486508,8
1666,32,3,2,191,0.015544041450777202,0.010362694300518135,0.9896373056994818,193,5850,4300,1550,0.7350427350427351,74,43,31,240.10646150791058,0.4800841968911917,0.803730184598539,0.13484572768639455,1037594.3183412345,5376.620051525009,1042970.9383927595,1628,0,290.8238341968912,65,128,40,39.22961212684639,0.5243415371329879,45.34406565656563,8148.98989898985,125.36907536907462,0
1667,32,4,3,192,0.020512820512820513,0.015384615384615385,0.9846153846153847,195,6300,4700,1600,0.746031746031746,79,47,32,218.69875527789378,0.48059740946338886,0.7871558925627617,0.12297274954364329,1037976.4130682888,100.82990916943709,1038077.2429774583,1629,0,288.7025641025641,67,128,41,39.72686243258959,0.524732905982906,45.29718137254901,8150.490196078414,121.64910740415543,8
1668,32,3,2,193,0.015384615384615385,0.010256410256410256,0.9897435897435898,195,5700,3800,1900,0.6666666666666666,76,38,38,212.88125945930122,0.4808474314917614,0.7813016322974791,0.11764226869119304,1032511.1153276688,-739.5466726638224,1031771.5686550051,1630,0,289.0205128205128,76,119,42,40.56076259452552,0.5202991452991452,45.9686147186147,8129.0043290042895,106.96058327637223,8
1669,32,3,1,195,0.015306122448979591,0.00510204081632653,0.9948979591836735,196,5150,3300,1850,0.6407766990291263,70,33,37,205.75145564102036,0.48128325047967907,0.775581299626561,0.11474114918876602,1035382.1842281193,-1743.7216900567842,1033638.4625380626,1631,0,288.5,66,130,46,40.381677056594555,0.522374574829932,45.61567164179107,8140.298507462736,123.33785617367782,0
1670,32,2,3,194,0.01015228426395939,0.015228426395939087,0.9847715736040609,197,6600,5100,1500,0.7727272727272727,81,51,30,205.76927747231815,0.48177056355537135,0.7729810020293129,0.11005975983439373,1022090.3638659464,-3937.040863176499,1018153.32300277,1632,0,287.497461928934,76,121,33,42.053047333583095,0.5117385786802031,47.253787878787925,8087.8787878789035,106.41945773524873,8
1671,32,5,4,195,0.02512562814070352,0.020100502512562814,0.9798994974874372,199,6000,4000,2000,0.6666666666666666,80,40,40,200.51175554551168,0.48243003739234896,0.7705588538218839,0.1086388551232462,1026226.0712160286,-4645.921774780132,1021580.1494412485,1633,0,283.49748743718595,70,129,35,41.66485633182714,0.5160175879396984,46.74295774647887,8104.225352112677,115.77464788732395,0
1672,32,4,5,194,0.020100502512562814,0.02512562814070352,0.9748743718592965,199,6900,5300,1600,0.7681159420289855,85,53,32,187.52582561007821,0.48274305026817593,0.7573621145954264,0.10114283934267171,1024772.763142801,-8265.728305784736,1016507.0348370163,1634,0,284.07035175879395,87,112,43,42.176488930464615,0.5140284757118928,46.92234848484851,8098.4848484849235,93.08603274120601,8
1673,32,3,0,197,0.015228426395939087,0.0,1.0,197,5700,3500,2200,0.6140350877192983,79,35,44,204.59768923743655,0.482680254843054,0.7532479296517101,0.10999956945348456,1023750.4822530797,-3208.603395061993,1020541.8788580176,1635,0,287.6954314720812,89,108,36,41.873284145504456,0.5140651438240271,47.04861111111109,8094.44444444439,90.94881398252123,8
1674,32,7,4,200,0.03431372549019608,0.0196078431372549,0.9803921568627451,204,6450,4300,2150,0.6666666666666666,86,43,43,197.2550226174367,0.48370892897388845,0.7543703015181908,0.10749373279986746,1028071.2656879894,-6691.555846875593,1021379.7098411138,1636,0,278.78921568627453,83,121,36,41.51526547951011,0.5178206699346406,46.51537698412699,8111.507936507946,97.72901128322827,0
1675,32,4,3,201,0.0196078431372549,0.014705882352941176,0.9852941176470589,204,6850,5100,1750,0.7445255474452555,86,51,35,201.1934494605619,0.4837391134614766,0.7611537748682469,0.11092346815392123,1031770.1441398937,-6132.921130014395,1025637.2230098794,1637,0,278.95588235294116,91,113,33,40.950671779323464,0.5212928921568627,46.05978260869567,8126.086956521796,89.29765886287689,0
1676,32,3,10,194,0.014705882352941176,0.049019607843137254,0.9509803921568627,204,7200,5300,1900,0.7361111111111112,91,53,38,205.6218802930864,0.48381256238127435,0.7728658335389262,0.11547471282641285,1037582.922185714,-5330.049716036124,1032252.8724696779,1638,0,277.84313725490193,78,126,44,40.10920968604909,0.5315053104575164,45.34546413502106,8148.9451476792365,104.4736557394774,8
1677,32,4,4,194,0.020202020202020204,0.020202020202020204,0.9797979797979798,198,6850,5200,1650,0.7591240875912408,85,52,33,202.1640280866069,0.48229011775966085,0.7623950639073538,0.11413200235763277,1039231.578233499,-4430.951605903203,1034800.6266275957,1639,0,286.5656565656566,79,119,37,39.99094202898553,0.5356691919191919,45.14322916666664,8155.416666666602,103.23312236286839,0
1678,32,3,2,195,0.015228426395939087,0.01015228426395939,0.9898477157360406,197,6450,4400,2050,0.6821705426356589,85,44,41,207.47051391993824,0.4822043665181808,0.7707736424205207,0.11809730658609335,1041803.961694754,-2621.279332672596,1039182.6823620814,1640,0,288.92893401015226,85,112,42,39.53393735858609,0.5383883248730965,44.828003875968975,8165.503875968945,96.06475148198759,0
1679,32,3,5,193,0.015151515151515152,0.025252525252525252,0.9747474747474747,198,5900,4300,1600,0.7288135593220338,75,43,32,203.8390981132098,0.48186176485668875,0.7722838159819438,0.11610561287259502,1042006.1749828507,-3019.6802126201123,1038986.4947702306,1641,0,288.3838383838384,89,109,39,39.60133301585862,0.5388257575757576,44.80324074074073,8166.2962962962765,91.75613816063232,8
1680,32,2,2,193,0.010256410256410256,0.010256410256410256,0.9897435897435898,195,6350,4300,2050,0.6771653543307087,84,43,41,198.21318730967408,0.4812373336857873,0.7632218604440828,0.11352209818645032,1043710.737764798,-3974.5536076613157,1039736.1841571367,1642,0,293.53333333333336,73,122,42,39.53212264844212,0.540758547008547,44.59459459459462,8172.972972973022,111.95853387634276,0
1681,32,6,1,198,0.03015075376884422,0.005025125628140704,0.9949748743718593,199,6000,4300,1700,0.7166666666666667,77,43,34,212.55922670065485,0.4810426289697647,0.7780381022484344,0.12305953573848417,1047049.7809887638,-1287.9816471874565,1045761.7993415763,1643,0,288.5678391959799,73,126,47,38.748819218987876,0.5402010050251256,44.18637387387389,8186.036036036074,112.13747994569964,8
1682,32,2,7,193,0.01,0.035,0.965,200,6250,4700,1550,0.752,78,47,31,219.27735150262725,0.4810636515912898,0.7829738702077522,0.1274976281651028,1048378.3952754792,-272.87242228324976,1048105.5228531959,1644,0,288.11,75,125,36,38.41115156707362,0.54375,44.02412280701758,8191.228070175517,109.21637426900689,8
1683,32,0,3,190,0.0,0.015544041450777202,0.9844559585492227,193,6350,4400,1950,0.6929133858267716,83,44,39,218.9065556426615,0.48022250107944736,0.776264135244505,0.12785102732114137,1049749.1142523284,1009.392577982765,1050758.5068303111,1645,1,298.73056994818654,77,116,40,38.249695863746986,0.5457145941278065,43.85683760683764,8196.581196581268,106.44910644910738,0
1684,32,4,2,192,0.020618556701030927,0.010309278350515464,0.9896907216494846,194,6950,5200,1750,0.7482014388489209,87,52,35,209.53698993394974,0.48036129213183054,0.7662764533729438,0.12375311660843014,1053165.9488880734,-1614.5554338124093,1051551.3934542611,1646,0,294.10309278350513,73,121,42,38.06444090859213,0.5488079896907216,43.4403153153153,8209.909909909878,112.46451931383395,0
1685,32,0,3,189,0.0,0.015625,0.984375,192,5950,3800,2150,0.6386554621848739,81,38,43,261.2835046959384,0.47978362238219896,0.8092026589758023,0.14929285782787208,1042980.9089708005,10152.741445369205,1053133.6504161698,1647,1,297.984375,57,135,40,38.01291971487524,0.5347222222222222,44.683908045977006,8170.114942528724,143.335349868925,8
1686,32,3,1,191,0.015625,0.005208333333333333,0.9947916666666666,192,7050,5100,1950,0.723404255319149,90,51,39,275.0109222654368,0.479776805191972,0.8192016423357655,0.15517502615471562,1039064.7144274412,11700.829081632939,1050765.5435090743,1648,0,298.875,69,123,34,38.155413625304156,0.5323350694444444,45.16369047619049,8154.761904761933,118.18495514147729,8
1687,32,2,4,189,0.010362694300518135,0.02072538860103627,0.9792746113989638,193,6500,4600,1900,0.7076923076923077,84,46,38,248.22222904746755,0.47961418753598156,0.8021498123710802,0.14369461414140142,1047024.5742797852,6878.954739040788,1053903.5290188259,1649,0,298.23316062176167,63,130,41,37.83966670908359,0.5364853195164077,44.189453125,8185.9375,129.93551587301587,8
1688,32,1,2,188,0.005263157894736842,0.010526315789473684,0.9894736842105263,190,5500,3700,1800,0.6727272727272727,73,37,36,257.55924986694134,0.4793412930474334,0.8084094852515902,0.14467834406106014,1037661.5059033233,9951.863815252298,1047613.3697185756,1650,0,303.4736842105263,66,124,38,38.776709401709425,0.5257127192982456,45.3358208955224,8149.253731343316,123.47354138398964,8
1689,32,6,5,189,0.030927835051546393,0.02577319587628866,0.9742268041237113,194,5950,4200,1750,0.7058823529411765,77,42,35,251.89038981450597,0.47992561828962127,0.8096251355154966,0.14336215122899962,1041760.4444444455,7731.8888888889105,1049492.3333333344,1651,0,297.75773195876286,74,120,37,38.405930219899844,0.5286726804123711,44.833333333333336,8165.333333333342,110.34234234234246,0
1690,32,1,0,190,0.005263157894736842,0.0,1.0,190,7400,5800,1600,0.7837837837837838,90,58,32,216.75690973557144,0.47979033231226215,0.7741400068799449,0.12282891551682407,1040400.0000000021,-297.222222222098,1040102.77777778,1652,0,304.4526315789474,74,116,39,39.47269880174293,0.5322916666666666,45.00000000000001,8160.000000000016,110.27027027027049,8
1691,32,0,5,185,0.0,0.02631578947368421,0.9736842105263158,190,6250,4300,1950,0.688,82,43,39,226.02479425018564,0.4795321637426901,0.7755218469917056,0.13053915935567567,1046303.1550430103,3048.0910683833654,1049351.2461113937,1653,1,305.4526315789474,76,114,37,38.497637059373325,0.5390350877192982,44.27759740259741,8183.116883116893,107.67259056732755,7
1692,32,4,4,185,0.021164021164021163,0.021164021164021163,0.9788359788359788,189,6050,3900,2150,0.6446280991735537,82,39,43,220.71567529763857,0.4792534429059252,0.7714939378546424,0.12853292215035877,1048854.9128536282,2449.744075947012,1051304.6569295751,1654,0,306.56613756613757,81,108,36,38.31488257669729,0.5418320105820106,43.965955284552855,8193.089430894332,101.14925223326335,0
1693,32,3,1,187,0.015957446808510637,0.005319148936170213,0.9946808510638298,188,6050,4400,1650,0.7272727272727273,77,44,33,216.69514442302736,0.4795429656388668,0.7742365211591078,0.12044817235553289,1034347.9573619048,1177.6360008405463,1035525.5933627454,1655,0,308.7074468085106,68,120,37,40.23312255076595,0.5293107269503546,45.74275362318843,8136.231884058019,119.65046888320616,8
1694,32,4,3,188,0.020942408376963352,0.015706806282722512,0.9842931937172775,191,7450,5700,1750,0.7651006711409396,92,57,35,212.0358117527667,0.4795444107651327,0.7715965769124136,0.1192637265621499,1038074.9846106542,-1628.185595567582,1036446.7990150866,1656,0,304.8324607329843,75,116,42,39.884219400200905,0.5328315881326353,45.28508771929826,8150.877192982493,108.67836257309992,0
1695,32,7,5,190,0.035897435897435895,0.02564102564102564,0.9743589743589743,195,6700,4700,2000,0.7014925373134329,87,47,40,216.64549712632012,0.47976143272535027,0.7807195272711498,0.12358231500524698,1042465.3096655356,-530.916950113251,1041934.3927154223,1657,0,297.8205128205128,69,126,39,39.217083017547935,0.5334401709401709,44.74702380952382,8168.095238095259,118.37819185645303,8
1696,32,2,3,189,0.010416666666666666,0.015625,0.984375,192,6400,4200,2200,0.65625,86,42,44,213.58825422013038,0.4794717359293194,0.7742261350307058,0.12040196687718144,1038765.1996652901,-426.3908917733297,1038338.8087735168,1658,0,303.3489583333333,78,114,35,39.75820223556199,0.5354275173611112,45.20042194092825,8153.58649789025,104.53316022936218,8
1697,32,3,2,190,0.015625,0.010416666666666666,0.9895833333333334,192,6000,4200,1800,0.7,78,42,36,238.07074973725622,0.4796586405613729,0.7985130257376016,0.13593071839836937,1042755.1775147977,5249.901380670914,1048005.0788954686,1659,0,304.265625,64,128,35,38.63386691776524,0.5316840277777778,44.71153846153848,8169.230769230807,127.64423076923136,8
1698,32,3,3,190,0.015544041450777202,0.015544041450777202,0.9844559585492227,193,6100,4500,1600,0.7377049180327869,77,45,32,230.24580055454857,0.4800369710708117,0.7933718657715003,0.13265573803301037,1045555.6467187109,3446.959380615759,1049002.6060993266,1660,0,300.85492227979273,68,125,37,38.48316403866218,0.5344343696027634,44.36896135265701,8180.193236714984,120.29695936345564,0
1699,32,1,2,189,0.005235602094240838,0.010471204188481676,0.9895287958115183,191,5550,3300,2250,0.5945945945945946,78,33,45,232.00870294334794,0.4800530449159548,0.7908830451335376,0.13446326921332838,1047379.2712259499,4850.221241376413,1052229.4924673263,1661,0,303.0628272251309,70,121,35,38.21009423323205,0.5369219022687609,44.14612676056339,8187.323943661992,116.96177062374275,0
1700,32,3,1,191,0.015625,0.005208333333333333,0.9947916666666666,192,5800,4000,1800,0.6896551724137931,76,40,36,250.1194510416866,0.4799211023851076,0.8015022684771975,0.14287595444427922,1042898.373074005,7969.833713107747,1050868.2067871129,1662,0,302.4322916666667,63,129,38,38.30831102044287,0.5361328125,44.69401041666668,8169.791666666693,129.67923280423324,8
1701,32,2,1,192,0.010362694300518135,0.0051813471502590676,0.9948186528497409,193,5750,3800,1950,0.6608695652173913,77,38,39,250.79901902614543,0.4795264824409902,0.8080229413106528,0.14140795753601865,1038831.3609467493,7757.577251808284,1046588.9381985576,1663,0,301.82901554404145,64,129,36,38.80175576519918,0.5301705526770293,45.19230769230771,8153.846153846184,127.40384615384663,8
1702,32,1,1,192,0.0051813471502590676,0.0051813471502590676,0.9948186528497409,193,6250,5000,1250,0.8,75,50,25,248.59940631687704,0.4794972474093264,0.8067535101303553,0.14097313766065891,1040621.7509451862,6889.589897080894,1047511.3408422671,1664,0,300.32124352331607,68,125,39,38.63286568401114,0.5324913644214162,44.972826086956545,8160.869565217445,120.01278772378595,0
1703,32,3,1,194,0.015384615384615385,0.005128205128205128,0.9948717948717949,195,5550,3700,1850,0.6666666666666666,74,37,37,218.43856163605022,0.4797449114459424,0.7863559316958053,0.1232062559109269,1038943.367346943,839.0589569162794,1039782.4263038593,1665,0,298.0923076923077,69,126,37,39.61228879545281,0.5300213675213675,45.178571428571445,8154.285714285748,118.17805383022824,8
1704,32,1,1,194,0.005128205128205128,0.005128205128205128,0.9948717948717949,195,6950,5000,1950,0.7194244604316546,89,50,39,217.05040306628808,0.47948167239404355,0.7858398496696357,0.12331325097282539,1041205.41897507,-751.1888273314362,1040454.2301477386,1666,0,298.55897435897435,75,120,39,39.3643885665162,0.5329059829059829,44.901315789473685,8163.157894736849,108.84210526315799,0
1705,32,5,3,196,0.02512562814070352,0.01507537688442211,0.9849246231155779,199,6700,4700,2000,0.7014925373134329,87,47,40,208.5554830217042,0.4798371064074582,0.7817799137138581,0.11998412685290057,1045105.3080545961,-2907.511534025295,1042197.7965205708,1667,0,293.4824120603015,67,132,42,39.093842403899934,0.5359610552763819,44.42401960784314,8178.431372549033,122.06613988879154,0
1706,32,2,3,195,0.010101010101010102,0.015151515151515152,0.9848484848484849,198,6300,4400,1900,0.6984126984126984,82,44,38,200.8462675337897,0.4800110880377378,0.7723675773735978,0.11640272713598407,1047379.2712259482,-3827.55653640152,1043551.7146895467,1668,0,295.57575757575756,70,128,41,39.007397213142966,0.5386679292929293,44.146126760563384,8187.32394366198,116.96177062374257,0
1707,32,2,6,191,0.01015228426395939,0.030456852791878174,0.9695431472081218,197,5700,3700,2000,0.6491228070175439,77,37,40,200.37533383181477,0.47965442522186535,0.7709800541420759,0.11695497971726351,1049557.562934024,-3038.9105902779506,1046518.652343746,1669,0,297.8984771573604,71,126,43,38.74819945771904,0.5408206429780034,43.88020833333332,8195.833333333303,115.43427230046906,0
1708,32,0,2,189,0.0,0.010471204188481676,0.9895287958115183,191,6250,4100,2150,0.656,84,41,43,207.10261904541926,0.4789611463213006,0.7722669053320614,0.12082831945377101,1049422.2927549616,-982.3789371598973,1048439.9138178017,1670,1,308.0052356020942,70,121,43,38.59274747937673,0.5412849040139616,43.896713615023465,8195.305164319225,117.07578806170321,0
1709,32,2,0,191,0.010471204188481676,0.0,1.0,191,6400,4400,2000,0.6875,84,44,40,242.3134991089512,0.47889684945347666,0.8031934185878811,0.13958622695149425,1045506.2499999985,6068.055555555448,1051574.3055555539,1671,0,307.62303664921467,59,132,40,38.18086117902744,0.5334860383944153,44.37499999999999,8179.999999999988,138.64406779660996,8
1710,32,3,2,192,0.015463917525773196,0.010309278350515464,0.9896907216494846,194,5400,3900,1500,0.7222222222222222,69,39,30,237.3499394060845,0.478936866798426,0.8023497980274372,0.13836609565012123,1049179.9843852727,5604.56114398421,1054784.545529257,1672,0,303.85051546391753,64,130,38,37.848373907420154,0.5361361683848798,43.92628205128205,8194.358974358973,128.03685897435895,0
1711,32,0,1,191,0.0,0.005208333333333333,0.9947916666666666,192,6800,4200,2600,0.6176470588235294,94,42,52,243.98626744037676,0.4784593831806283,0.805966908864753,0.1428468090118952,1050497.516305289,6061.393591742708,1056558.9098970317,1673,1,307.7760416666667,66,126,39,37.513778492405386,0.5384657118055556,43.76554726368159,8199.502487562186,124.23488617518463,0
1712,32,0,0,191,0.0,0.0,1.0,191,6100,4200,1900,0.6885245901639344,80,42,38,236.08907477244435,0.4783778818774685,0.7933995280321684,0.1324643491387911,1037297.9678638983,4678.943499265099,1041976.9113631634,1674,2,310.30366492146595,68,123,39,39.369145025495065,0.5284685863874345,45.38043478260871,8147.826086956555,119.82097186700815,8
1713,32,4,3,192,0.020512820512820513,0.015384615384615385,0.9846153846153847,195,5500,3300,2200,0.6,77,33,44,218.24759959979275,0.47961714688518814,0.7816230032355675,0.1213733889248277,1034509.8754272519,655.8594148556031,1035165.7348421075,1675,0,304.9179487179487,65,130,42,40.17331585045419,0.5177350427350427,45.722853535353536,8136.868686868684,125.18259518259514,8
1714,32,2,2,192,0.010309278350515464,0.010309278350515464,0.9896907216494846,194,6250,4600,1650,0.736,79,46,33,229.03201152938985,0.4791727872442711,0.7923270546295385,0.12898118544023618,1038458.0498866285,2518.027210884755,1040976.0770975132,1676,0,306.8144329896907,69,125,39,39.40323208722741,0.5250751718213058,45.23809523809526,8152.38095238101,118.15044858523203,8
1715,32,2,3,191,0.010309278350515464,0.015463917525773196,0.9845360824742269,194,5550,4200,1350,0.7567567567567568,69,42,27,223.2369729271597,0.4792239775296903,0.7864673985807991,0.12619953431553177,1039654.9279623091,2067.8838014223234,1041722.8117637314,1677,0,304.47938144329896,72,122,39,39.400820085087325,0.5272229381443299,45.09132420091326,8157.077625570828,113.29274479959483,0
1716,32,2,1,192,0.010362694300518135,0.0051813471502590676,0.9948186528497409,193,5850,4200,1650,0.717948717948718,75,42,33,219.44654890615098,0.4787854868307426,0.777925923425576,0.12443024633227431,1040593.6798990575,1220.9383734801604,1041814.6182725376,1678,0,300.66321243523316,78,115,41,39.37985798734981,0.5316817789291883,44.97626582278482,8160.759493670909,104.62512171372961,8
1717,32,0,7,185,0.0,0.036458333333333336,0.9635416666666666,192,6450,4900,1550,0.7596899224806202,80,49,31,216.35074700870052,0.4789036367437464,0.7736582264126501,0.12310931887309215,1041695.6412194484,224.32602670683264,1041919.9672461553,1679,1,302.8177083333333,83,109,45,39.3208916537066,0.53369140625,44.841269841269835,8165.079365079346,98.37445018167887,0
1718,32,3,0,188,0.015957446808510637,0.0,1.0,188,6350,4700,1650,0.7401574803149606,80,47,33,208.99546821126606,0.479362816209656,0.7628316928449641,0.11858270677243282,1040800.0384467425,-445.5017301042444,1040354.5367166382,1680,0,306.4840425531915,84,104,39,39.62057146518033,0.5385084219858156,44.950980392156836,8161.568627450911,97.16153127917751,8
1719,32,0,2,186,0.0,0.010638297872340425,0.9893617021276596,188,6600,5000,1600,0.7575757575757576,82,50,32,209.96654862145857,0.4792365930898472,0.7641330759376508,0.11955781445275677,1041907.3637654876,-446.86136937600713,1041460.5023961116,1681,1,307.4840425531915,87,101,42,39.45731669604478,0.5403368794326241,44.815340909090885,8165.909090909025,93.86102403343706,0
1720,32,2,4,184,0.010638297872340425,0.02127659574468085,0.9787234042553191,188,6300,4700,1600,0.746031746031746,79,47,32,202.06491473446866,0.47901673967459324,0.7543869746649889,0.11580479423127558,1043916.299382722,-1712.2283950614055,1042204.0709876606,1682,0,308.17021276595744,74,114,42,39.408089101553294,0.5421653368794326,44.569444444444464,8173.777777777825,110.45645645645709,0
1721,32,1,3,182,0.005405405405405406,0.016216216216216217,0.9837837837837837,185,6400,4500,1900,0.703125,83,45,38,196.8572456761955,0.4784420289855072,0.7394747758384133,0.11121575844743906,1039455.7698902601,-2475.120027434853,1036980.6498628252,1683,0,305.07027027027027,89,96,33,40.09815941634127,0.5419481981981982,45.11574074074074,8156.296296296292,91.6437786100707,8
1722,32,0,3,179,0.0,0.016483516483516484,0.9835164835164835,182,5450,3900,1550,0.7155963302752294,70,39,31,185.32744940172964,0.4778145427316698,0.7252265560272575,0.10396566095946183,1037245.2522675707,-3403.996598639558,1033841.2556689312,1684,1,310.0274725274725,83,99,36,40.66822520942916,0.5366300366300366,45.38690476190475,8147.619047619024,98.16408491107258,8
1723,32,3,4,178,0.016483516483516484,0.02197802197802198,0.978021978021978,182,6200,4300,1900,0.6935483870967742,81,43,38,181.3740271553936,0.47769817659320424,0.7202447095382225,0.10235390381725959,1039106.0843699742,-4906.628967229322,1034199.4554027449,1685,0,309.467032967033,87,95,36,40.53645663988112,0.5390338827838828,45.158617424242415,8154.924242424211,93.73476140717484,0
1724,32,2,1,179,0.011111111111111112,0.005555555555555556,0.9944444444444445,180,6250,4800,1450,0.768,77,48,29,208.66158273464134,0.4775799193047796,0.7581381097454214,0.11595152399597546,1034262.9232412932,912.1877054572215,1035175.1109467504,1686,0,310.25555555555553,64,116,41,40.448051265889305,0.5296296296296297,45.753205128205146,8135.897435897472,127.123397435898,8
1725,32,5,2,182,0.02717391304347826,0.010869565217391304,0.9891304347826086,184,6750,4700,2050,0.6962962962962963,88,47,41,198.90726638064586,0.47850588025659296,0.7525565731528883,0.11196344633563166,1038310.5096228016,-2244.4989753264963,1036066.010647475,1687,0,304.4402173913044,73,111,45,40.1891542797149,0.5331748188405797,45.2561936936937,8151.8018018018265,111.66851783290173,0
1726,32,4,5,181,0.021505376344086023,0.026881720430107527,0.9731182795698925,186,6300,4500,1800,0.7142857142857143,81,45,36,190.27897316113504,0.47912125835512936,0.7434915773353745,0.10804536476019276,1041037.5976562547,-3882.486979166489,1037155.1106770881,1688,0,302.0483870967742,79,107,45,40.068274629913226,0.5362343189964158,44.921875000000014,8162.500000000036,103.32278481012705,0
1727,32,2,2,181,0.01092896174863388,0.01092896174863388,0.9890710382513661,183,5300,3600,1700,0.6792452830188679,70,36,34,191.06235113020506,0.4785574170820073,0.7402184326743511,0.10890363523543257,1042222.2257653123,-2074.1142290245566,1040148.1115362878,1689,0,303.6885245901639,69,114,48,39.900430975842035,0.538023679417122,44.77678571428574,8167.142857142906,118.36438923395517,0
1728,32,2,2,181,0.01092896174863388,0.01092896174863388,0.9890710382513661,183,5350,3600,1750,0.6728971962616822,71,36,35,185.48692896563438,0.4783359855081166,0.7321175789341494,0.10635169984010731,1044055.90873814,-3218.2551639471476,1040837.6535741929,1690,0,304.57377049180326,73,110,48,39.814145129589875,0.5398451730418943,44.5523648648649,8174.324324324403,111.97704553869046,0
1729,32,3,1,183,0.016304347826086956,0.005434782608695652,0.9945652173913043,184,5950,4100,1850,0.6890756302521008,78,41,37,180.01517257477477,0.47837966262770254,0.7259063871972806,0.1042729395857663,1047211.1111111173,-5047.222222221908,1042163.8888888954,1691,0,303.20652173913044,79,105,50,39.56127850162869,0.5427989130434783,44.166666666666686,8186.666666666715,103.62869198312298,0
1730,32,1,5,179,0.005434782608695652,0.02717391304347826,0.9728260869565217,184,6550,4900,1650,0.7480916030534351,82,49,33,195.26601129165368,0.47844400886988203,0.7454093607200121,0.10864300927969239,1034655.8955453351,-2943.374043493814,1031712.5215018414,1692,0,304.0923913043478,72,112,40,40.73938985840678,0.5294384057971014,45.704908675799075,8137.442922374398,113.0200405885333,8
1731,32,6,4,181,0.032432432432432434,0.021621621621621623,0.9783783783783784,185,5800,4100,1700,0.7068965517241379,75,41,34,210.62237206420357,0.47887779083431253,0.7675520485149467,0.11921226258833936,1040032.4648973309,1010.8209560912978,1041043.2858534221,1693,0,302.4918918918919,73,112,39,39.675123306831615,0.5330518018018018,45.04504504504505,8158.558558558567,111.7610761446379,8
1732,32,1,1,181,0.005494505494505495,0.005494505494505495,0.9945054945054945,182,6400,4900,1500,0.765625,79,49,30,214.46286680774637,0.4781547872017485,0.7689363438887991,0.12187435259977444,1041285.1196805784,1863.3983861890279,1043148.5180667674,1694,0,307.97802197802196,72,110,42,39.42042361188798,0.5349130036630036,44.89155251141554,8163.470319634739,113.38153221714916,0
1733,32,2,2,181,0.01092896174863388,0.01092896174863388,0.9890710382513661,183,5300,4000,1300,0.7547169811320755,66,40,26,210.62731014047785,0.4782534178025981,0.7658132387305678,0.12040140321744053,1043116.6965236012,2041.7727902774054,1045158.4693138786,1695,0,307.24590163934425,66,117,44,39.28928433700702,0.5369990892531876,44.66728855721393,8170.646766169157,123.79767827529025,0
1734,32,4,0,185,0.021621621621621623,0.0,1.0,185,6400,4600,1800,0.71875,82,46,36,229.43411401733297,0.4787945554249902,0.7837484413836364,0.1281026706207329,1035761.8971374551,4127.822640529192,1039889.7197779842,1696,0,303.2810810810811,66,119,39,39.73151542926979,0.5293355855855856,45.5690298507463,8141.791044776182,123.3604703753967,8
1735,32,7,3,189,0.036458333333333336,0.015625,0.984375,192,6400,4500,1900,0.703125,83,45,38,205.39910460393963,0.48006767197498545,0.766533265213442,0.11597149444560875,1039266.9753086395,-2107.0987654322676,1037159.8765432072,1697,0,293.1875,77,115,35,39.90406448683011,0.5321180555555556,45.13888888888888,8155.555555555536,105.91630591630566,8
1736,32,2,3,188,0.010471204188481676,0.015706806282722512,0.9842931937172775,191,5400,3700,1700,0.6851851851851852,71,37,34,215.78885230697495,0.47942040966290067,0.7650759236624876,0.12241855856928775,1040752.4688718581,1316.5561587013035,1042069.0250305594,1698,0,295.71204188481676,81,110,35,39.45326119440155,0.5361583769633508,44.9568089430894,8161.382113821055,100.75780387433402,8
1737,32,6,0,194,0.030927835051546393,0.0,1.0,194,5650,3800,1850,0.672566371681416,75,38,37,206.7476934846987,0.4802811682068266,0.7684519244294277,0.11748464008374936,1041270.9138905365,-1393.9280520856537,1039876.9858384508,1699,0,291.17525773195877,81,113,43,39.61902034989872,0.5364583333333333,44.89329268292681,8163.414634146303,100.78289671785559,8
1738,32,4,6,192,0.020202020202020204,0.030303030303030304,0.9696969696969697,198,5900,4100,1800,0.6949152542372882,77,41,36,213.79114581578207,0.48054839853697723,0.7807851840109903,0.12447636763995047,1048795.4400510222,-655.3642290248781,1048140.0758219974,1700,0,286.27272727272725,83,115,37,38.49958829797543,0.5474010942760943,43.97321428571429,8192.857142857156,98.70912220309826,8
1739,32,3,3,192,0.015384615384615385,0.015384615384615385,0.9846153846153847,195,6600,4300,2300,0.6515151515151515,89,43,46,245.40588468444219,0.47984183628513527,0.8023633243310839,0.1427673870566341,1048545.3677450924,5863.840720651851,1054409.2084657443,1701,0,291.38461538461536,77,118,32,37.72144043333857,0.5462072649572649,44.00373931623933,8191.880341880382,106.38805638805691,8
1740,32,2,5,189,0.010309278350515464,0.02577319587628866,0.9742268041237113,194,6300,4300,2000,0.6825396825396826,83,43,40,243.07545192062537,0.47942929508751314,0.8021546999536828,0.14217457170006675,1050197.960069449,5955.468750000246,1056153.4288194492,1702,0,293.8144329896907,79,115,35,37.57454089584606,0.5486469072164948,43.80208333333335,8198.33333333337,103.77637130801735,0
1741,32,1,5,185,0.005263157894736842,0.02631578947368421,0.9736842105263158,190,6050,4100,1950,0.6776859504132231,80,41,39,243.73201694275204,0.4786480089111668,0.8003197404060911,0.143264164318207,1051709.9360320223,7217.076789563332,1058927.0128215856,1703,0,300.8315789473684,62,128,37,37.36886796508878,0.5507675438596491,43.61772486772485,8204.232804232775,132.32633555214153,0
1742,32,2,2,185,0.0106951871657754,0.0106951871657754,0.9893048128342246,187,5650,3800,1850,0.672566371681416,75,38,37,242.5154354982556,0.4785413432235064,0.7956442534447652,0.14298163563319724,1052635.7650903524,8006.084198385375,1060641.8492887379,1704,0,304.3529411764706,67,120,36,37.28449992036947,0.5506907308377897,43.50490196078432,8207.843137254922,122.505121451566,8
1743,32,0,5,180,0.0,0.02702702702702703,0.972972972972973,185,5700,4100,1600,0.7192982456140351,73,41,32,223.50920278316855,0.47833553662358014,0.7776181684429906,0.1289804213812105,1046049.6780846707,4060.345924059001,1050110.0240087297,1705,1,308.4054054054054,68,117,42,38.59363622050347,0.5416666666666667,44.30857487922706,8182.125603864744,120.3253765274227,8
1744,32,3,5,178,0.01639344262295082,0.0273224043715847,0.9726775956284153,183,6300,5100,1200,0.8095238095238095,75,51,24,200.41649312786302,0.4783409896114814,0.74847775175644,0.11419079259610822,1042100.6944444461,-1129.1666666665724,1040971.5277777795,1706,0,312.10928961748635,76,107,44,39.67687074829927,0.5372267759562841,44.79166666666667,8166.666666666681,107.45614035087738,8
1745,32,2,1,179,0.011111111111111112,0.005555555555555556,0.9944444444444445,180,5350,4000,1350,0.7476635514018691,67,40,27,226.60231745436542,0.4787800020691082,0.7701974401652989,0.13051544386801336,1045458.2458562003,6030.652262558081,1051488.8981187583,1707,0,316.8,70,110,37,38.5884797872544,0.5399305555555556,44.380868544600936,8179.812206572761,116.85446009389659,8
1746,32,4,4,179,0.02185792349726776,0.02185792349726776,0.9781420765027322,183,4150,2300,1850,0.5542168674698795,60,23,37,217.31946559538582,0.4790840989611482,0.76393169754822,0.12606718621314225,1047665.9753086449,4785.6419753088085,1052451.6172839538,1708,0,312.5409836065574,74,109,34,38.55014745259806,0.5419512750455373,44.11111111111112,8188.444444444468,110.65465465465498,0
1747,32,2,2,179,0.011049723756906077,0.011049723756906077,0.988950276243094,181,5400,3700,1700,0.6851851851851852,71,37,34,223.45570770078044,0.47893518518518513,0.7678847966982054,0.1304446567176355,1049600.250000004,5307.833333333534,1054908.0833333374,1709,0,315.8618784530387,74,107,36,38.151740686513776,0.5444290976058932,43.875000000000014,8196.000000000031,110.75675675675717,0
1748,32,0,2,177,0.0,0.0111731843575419,0.9888268156424581,179,5700,4000,1700,0.7017543859649122,74,40,34,225.46163474048186,0.4784683426443203,0.77042061132532,0.12919808849499057,1043879.0229511656,5570.9341971734,1049449.957148339,1710,1,320.33519553072625,66,113,41,38.81512873577209,0.5384660148975792,44.57400497512438,8173.631840796028,123.8429066787277,8
1749,32,4,1,180,0.022099447513812154,0.0055248618784530384,0.994475138121547,181,5650,4100,1550,0.7256637168141593,72,41,31,218.1967597816547,0.47863847963986084,0.765143359722835,0.12632334232277886,1047049.7809887638,3842.5739083681115,1050892.354897132,1711,0,316.8674033149171,73,108,44,38.604603441002226,0.5418968692449355,44.18637387387389,8186.036036036074,112.13747994569964,0
1750,32,2,2,180,0.01098901098901099,0.01098901098901099,0.989010989010989,182,6850,4800,2050,0.7007299270072993,89,48,41,216.4119627222163,0.47874926638738796,0.7652688850586244,0.12616144263532048,1049183.3952933853,2161.167566200363,1051344.5628595855,1712,0,316.0164835164835,76,106,39,38.38411520242312,0.5440705128205128,43.92586580086582,8194.372294372344,107.82068808384663,0
1751,32,3,1,182,0.01639344262295082,0.00546448087431694,0.994535519125683,183,5250,3400,1850,0.6476190476190476,71,34,37,222.19007201738816,0.47830345883624575,0.7672068028006509,0.12761297111867004,1044583.3634741547,4569.210551697735,1049152.5740258524,1713,0,315.26229508196724,71,112,40,38.810620859521,0.5394467213114754,44.487847222222236,8176.388888888917,115.16040688575939,8
1752,32,0,4,178,0.0,0.02197802197802198,0.978021978021978,182,6550,4800,1750,0.732824427480916,83,48,35,226.00210984843343,0.4780807935158764,0.7693801314510216,0.13022926336232532,1045599.6310804638,4311.544536185844,1049911.1756166497,1714,1,317.74725274725273,72,110,42,38.58614754860918,0.5411515567765568,44.363584474885855,8180.365296803673,113.6161846778288,0
1753,32,6,3,181,0.03260869565217391,0.016304347826086956,0.9836956521739131,184,5750,4000,1750,0.6956521739130435,75,40,35,219.93482203886785,0.478511448681397,0.7670359583612778,0.1283388117836655,1049479.4790840507,3613.4164931592263,1053092.89557721,1715,0,313.2445652173913,81,103,37,38.25697923383432,0.5447803442028986,43.889735772357746,8195.528455284608,101.17936364548899,0
1754,32,2,2,181,0.01092896174863388,0.01092896174863388,0.9890710382513661,183,5500,4200,1300,0.7636363636363637,68,42,26,209.46174390666616,0.4784323144978883,0.7589415752798554,0.11993604168616258,1043637.2365022758,1620.4151127402638,1045257.651615016,1716,0,315.94535519125685,71,112,42,39.254010177684634,0.5342668488160291,44.603587962962976,8172.685185185216,115.1082420448622,8
1755,32,3,0,184,0.016304347826086956,0.0,1.0,184,5150,3900,1250,0.7572815533980582,64,39,25,205.30567874935272,0.47868406985032075,0.7548806113482149,0.11837919090298872,1045797.7725117365,991.6443040167132,1046789.4168157532,1717,0,314.4402173913044,75,109,44,39.09050599546097,0.5363451086956521,44.339364035087726,8181.14035087721,109.08187134502947,0
1756,32,1,0,185,0.005405405405405406,0.0,1.0,185,5300,4000,1300,0.7547169811320755,66,40,26,205.93067956349165,0.4787223364669017,0.7604890604890604,0.1153211805555557,1036694.2148760369,397.4288337927169,1037091.6437098295,1718,0,313.7351351351351,65,120,44,40.2126736111111,0.5275900900900901,45.45454545454547,8145.454545454576,125.31468531468579,8
1757,32,5,3,187,0.02631578947368421,0.015789473684210527,0.9842105263157894,190,5500,3800,1700,0.6909090909090909,72,38,34,206.66782267346463,0.4792095980692472,0.7672477371773381,0.11749555043914825,1041420.2500000021,-454.38888888875954,1040965.8611111133,1719,0,306.4526315789474,74,116,42,39.60238717404324,0.531359649122807,44.87500000000001,8164.000000000016,110.32432432432455,0
1758,32,4,0,191,0.020942408376963352,0.0,1.0,191,6750,4700,2050,0.6962962962962963,88,47,41,198.86462311679668,0.48010356388353087,0.7603596835160706,0.1142423701418043,1044654.340277783,-3401.041666666379,1041253.2986111166,1720,0,305.6806282722513,69,122,46,39.39776124473435,0.5343041012216405,44.479166666666686,8176.666666666708,118.50241545893779,0
1759,32,1,1,191,0.005208333333333333,0.005208333333333333,0.9947916666666666,192,6200,4400,1800,0.7096774193548387,80,44,36,195.64662745765526,0.48005460569371733,0.7581963971276058,0.11326811598560023,1047049.7809887659,-3629.648313854048,1043420.1326749119,1721,0,305.0833333333333,73,119,46,39.18146655294485,0.5367296006944444,44.1863738738739,8186.03603603609,112.13747994569987,0
1760,32,0,3,188,0.0,0.015706806282722512,0.9842931937172775,191,6600,4300,2300,0.6515151515151515,89,43,46,222.93594633619426,0.4800392670157068,0.7755331265503096,0.12647536857999706,1040757.925515543,1604.4706063404183,1042362.3961218834,1722,1,307.65968586387436,75,116,34,39.2702959300659,0.5293411867364747,44.95614035087719,8161.4035087719285,108.81871345029238,8
1761,32,1,1,188,0.005291005291005291,0.005291005291005291,0.9947089947089947,189,6450,4400,2050,0.6821705426356589,85,44,41,226.7747343604793,0.4800449829261886,0.7778248102505938,0.12930569568077463,1042333.7744469487,3024.9929630325823,1045358.7674099812,1723,0,307.44973544973544,72,117,37,38.975000465887724,0.5319113756613756,44.76312785388129,8167.579908675816,113.43860984271967,0
1762,32,1,1,188,0.005291005291005291,0.005291005291005291,0.9947089947089947,189,6000,4100,1900,0.6833333333333333,79,41,38,224.53675474888817,0.4800813351345266,0.7784724208061762,0.12893282617675061,1044516.2254737888,3106.4567100886547,1047622.6821838774,1724,0,308.021164021164,73,116,40,38.75905597487743,0.5346671075837742,44.49605855855857,8176.126126126159,112.00172775515286,0
1763,32,0,3,185,0.0,0.015957446808510637,0.9840425531914894,188,6350,4500,1850,0.7086614173228346,82,45,37,235.91384597108916,0.4800123023097053,0.7896109919415613,0.1332005868790609,1039266.9753086397,5085.493827160297,1044352.4691358,1725,1,310.47340425531917,71,117,31,39.126362397820124,0.5296431737588653,45.13888888888888,8155.5555555555375,114.8669796557118,8
1764,32,1,4,182,0.005376344086021506,0.021505376344086023,0.978494623655914,186,5550,4000,1550,0.7207207207207207,71,40,31,237.0816692057707,0.4798780635474184,0.7903580680648703,0.13467775660602357,1041168.6350628636,6618.399585079573,1047787.0346479431,1726,0,313.31720430107526,72,114,34,38.85800656336818,0.5314180107526882,44.90582191780822,8163.013698630138,113.37519025875191,0
1765,32,2,1,183,0.010869565217391304,0.005434782608695652,0.9945652173913043,184,5350,3500,1850,0.6542056074766355,72,35,37,233.99725658175552,0.4798187910826008,0.7872033283636222,0.13415676931547005,1044034.9876606995,6710.264577594262,1050745.2522382939,1727,0,317.1141304347826,65,119,35,38.577579548965105,0.534759963768116,44.55492424242425,8174.242424242438,125.75757575757596,0
1766,32,3,0,186,0.016129032258064516,0.0,1.0,186,6650,4700,1950,0.706766917293233,86,47,39,225.43599207181245,0.4799864380509542,0.7787979876495235,0.13054316750204964,1047117.6580972043,3361.601613811283,1050479.2597110155,1728,0,314.5752688172043,72,114,40,38.410935408299885,0.5402105734767024,44.178082191780824,8186.301369863016,113.69863013698632,8
1767,32,1,2,185,0.0053475935828877,0.0106951871657754,0.9893048128342246,187,6150,4900,1250,0.7967479674796748,74,49,25,220.30827039844178,0.4797452705422345,0.7738695325192053,0.12371047069898938,1037552.6550342765,2166.2861755826075,1039718.9412098591,1729,0,313.88770053475935,70,117,42,39.73901019761484,0.5275735294117647,45.34917840375588,8148.8262910798285,116.41180415828326,8
1768,32,3,5,183,0.015957446808510637,0.026595744680851064,0.973404255319149,188,5550,3500,2050,0.6306306306306306,76,35,41,214.80772343623497,0.4797278558425304,0.7688080530770984,0.12151531800224996,1039863.2271468173,1524.130501692996,1041387.3576485103,1730,0,311.8191489361702,75,113,40,39.58960573476703,0.529864804964539,45.06578947368422,8157.894736842128,108.77192982456171,0
1769,32,2,1,184,0.010810810810810811,0.005405405405405406,0.9945945945945946,185,5950,3900,2050,0.6554621848739496,80,39,41,219.37508850466355,0.4798827359968664,0.774903146381958,0.12447259205821509,1040801.427603103,2715.1810592425463,1043516.6086623456,1731,0,315.28648648648647,71,114,41,39.35566632631841,0.5269707207207207,44.95081018518521,8161.574074074138,114.95174752217095,8
1770,32,4,4,184,0.02127659574468085,0.02127659574468085,0.9787234042553191,188,5700,3700,2000,0.6491228070175439,77,37,40,217.60197877336702,0.48033230458527704,0.7746285579746952,0.12495739048624546,1044532.6672335682,2158.4750566898697,1046691.142290258,1732,0,309.93617021276594,69,119,44,38.9341875364007,0.5304188829787234,44.49404761904765,8176.19047619054,118.49551414768898,0
1771,32,2,2,184,0.010752688172043012,0.010752688172043012,0.989247311827957,186,5800,4100,1700,0.7068965517241379,75,41,34,214.18888919992497,0.48011600309987407,0.7686722255656078,0.12391042042826712,1046819.3309441294,1843.4139375867553,1048662.744881716,1733,0,310.96774193548384,73,113,45,38.735886394071144,0.5337141577060932,44.21452702702706,8185.135135135211,112.12513883746865,0
1772,32,0,2,182,0.0,0.010869565217391304,0.9891304347826086,184,6300,4600,1700,0.7301587301587301,80,46,34,228.75164447125616,0.48001925437554444,0.7754132378385101,0.12847479133037795,1037609.0171485285,4370.953798186038,1041979.9709467145,1734,1,314.8858695652174,69,115,42,39.51692426810028,0.5244565217391304,45.34226190476191,8149.047619047638,118.10213940648751,8
1773,32,6,2,186,0.031914893617021274,0.010638297872340425,0.9893617021276596,188,6250,4200,2050,0.672,83,42,41,218.5376054765868,0.48107364319035156,0.7704552668066171,0.1242977360116166,1041555.4488320939,1673.806751771639,1043229.2555838655,1735,0,308.8723404255319,77,111,41,39.282637616679736,0.5282579787234043,44.85844017094018,8164.529914529934,106.03285603285629,0
1774,32,4,1,189,0.021052631578947368,0.005263157894736842,0.9947368421052631,190,4650,2600,2050,0.5591397849462365,67,26,41,214.17738181775616,0.4813637102014295,0.7704329748966163,0.12283241049380654,1044133.193640011,2075.9427365660395,1046209.1363765771,1736,0,306.6,66,124,43,39.07159738705293,0.5305372807017543,44.5429104477612,8174.626865671658,123.85798281320695,0
1775,32,1,1,189,0.005263157894736842,0.005263157894736842,0.9947368421052631,190,6350,4100,2250,0.6456692913385826,86,41,45,209.12414952716844,0.48140548129583216,0.7656522591394692,0.12075233150117136,1046236.7346938772,-591.3265306122648,1045645.4081632649,1737,0,307.43684210526317,69,121,42,38.93811103351953,0.5330592105263158,44.285714285714285,8182.8571428571395,118.59213250517594,0
1776,32,0,2,187,0.0,0.010582010582010581,0.9894179894179894,189,6550,4500,2050,0.6870229007633588,86,45,41,214.95900600819863,0.48133020938872,0.7749029992782577,0.12355215941258993,1044814.818461339,568.4709678170766,1045383.2894291561,1738,1,309.21693121693124,68,121,43,38.96646875800003,0.5316358024691358,44.459541062801925,8177.294685990322,120.25433361750474,5
1777,32,5,3,189,0.026041666666666668,0.015625,0.984375,192,5700,4000,1700,0.7017543859649122,74,40,34,205.7906501261948,0.48159358638743455,0.7689032059516165,0.12000600833201704,1049276.7486149587,-913.7311480455082,1048363.0174669132,1739,0,304.7916666666667,75,117,44,38.64447298936703,0.53515625,43.91447368421053,8194.736842105265,109.26315789473686,0
1778,32,1,0,190,0.005263157894736842,0.0,1.0,190,5450,3800,1650,0.6972477064220184,71,38,33,227.26677629814083,0.48171122250069615,0.7790509942366652,0.12931018489107074,1041670.007588704,3897.396918228883,1045567.4045069328,1740,0,306.1,78,112,39,39.04557042702358,0.531469298245614,44.84440928270042,8164.978902953574,104.679216704533,6
1779,32,3,1,192,0.015544041450777202,0.0051813471502590676,0.9948186528497409,193,6300,4200,2100,0.6666666666666666,84,42,42,257.568160281188,0.482167755109384,0.8085939575023289,0.14490921577452948,1038150.5130154929,8578.903546474341,1046729.4165619672,1741,0,302.3264248704663,70,123,36,38.71493779518485,0.521103195164076,45.27582159624412,8151.173708920171,116.44533869885959,8
1780,32,4,2,194,0.02040816326530612,0.01020408163265306,0.9897959183673469,196,6500,4500,2000,0.6923076923076923,85,45,40,234.5530356556437,0.48253859236002095,0.7981760863282157,0.13093314643062726,1035695.4942294509,2885.104437278083,1038580.598666729,1742,0,298.59183673469386,60,136,41,39.609621451104104,0.5195578231292517,45.57718579234974,8141.530054644828,135.6921675774138,8
1781,32,7,3,198,0.03482587064676617,0.014925373134328358,0.9850746268656716,201,7550,5700,1850,0.7549668874172185,94,57,37,223.895801967717,0.48325974295190716,0.7936018134181138,0.12731625347424086,1041484.3403580075,-1113.2056757447453,1040371.1346822627,1743,0,290.2238805970149,68,133,42,39.154832347140015,0.5246683250414594,44.867149758454126,8164.251207729518,120.0625177607282,0
1782,32,1,4,195,0.005025125628140704,0.020100502512562814,0.9798994974874372,199,6350,4800,1550,0.7559055118110236,79,48,31,250.41843254974546,0.4828498553372926,0.8126326408416265,0.13917942864102537,1034317.2501929001,5652.420910493766,1039969.6711033939,1744,0,293.9849246231156,59,140,38,39.37955217935586,0.5177449748743719,45.74652777777777,8136.111111111102,137.90018832391698,8
1783,32,5,0,200,0.025,0.0,1.0,200,6000,4300,1700,0.7166666666666667,77,43,34,234.39132635905295,0.48321084589614743,0.7995741435945567,0.1284030633601902,1029741.7233560053,2272.505668933999,1032014.2290249392,1745,0,293.425,69,131,41,40.36323908962928,0.5114583333333333,46.309523809523796,8118.095238095208,117.65355417529287,8
1784,32,6,3,203,0.02912621359223301,0.014563106796116505,0.9854368932038835,206,7200,5300,1900,0.7361111111111112,91,53,38,211.45716271515064,0.48396232930775906,0.7868391209493475,0.11689109785044038,1032608.0651017486,-4729.525671361129,1027878.5394303874,1746,0,285.8495145631068,75,131,45,40.58476081287651,0.517748786407767,45.95668859649118,8129.385964912172,108.39181286549564,8
1785,32,3,2,204,0.014563106796116505,0.009708737864077669,0.9902912621359223,206,7100,4700,2400,0.6619718309859155,95,47,48,206.00135498256748,0.48401807561764937,0.782265874818008,0.11509883981215735,1035979.7050713701,-5617.3554041712305,1030362.3496671988,1747,0,285.0339805825243,67,139,46,40.300415889069484,0.5208333333333333,45.54227941176472,8142.647058823556,121.53204565408292,0
1786,32,2,2,204,0.009708737864077669,0.009708737864077669,0.9902912621359223,206,6450,4500,1950,0.6976744186046512,84,45,39,203.09850811131236,0.4838977030547005,0.7800971161589154,0.11399875328830338,1037420.9761313016,-5510.269492870142,1031910.7066384314,1748,0,285.93203883495147,68,138,45,40.1937461710243,0.5228559870550162,45.36533816425122,8148.309178743988,119.82807615799982,0
1787,32,3,4,203,0.014492753623188406,0.01932367149758454,0.9806763285024155,207,6650,4000,2650,0.6015037593984962,93,40,53,198.2317109969741,0.48392136860372403,0.7781200935177468,0.11102410544740017,1036734.8126346534,-6947.256848261225,1029787.5557863922,1749,0,285.42995169082127,75,132,39,40.40356450570752,0.5262177938808373,45.44956140350876,8145.614035087692,108.60818713450256,8
1788,32,3,2,204,0.014563106796116505,0.009708737864077669,0.9902912621359223,206,6150,4200,1950,0.6829268292682927,81,42,39,192.35508524077304,0.48388290314941984,0.7693296779236665,0.10917106493466329,1040885.7709750499,-7306.065759637573,1033579.7052154123,1750,0,287.45631067961165,83,123,38,40.03427654609101,0.5286205501618123,44.94047619047617,8161.904761904709,98.33620195065915,8
1789,32,2,2,204,0.009708737864077669,0.009708737864077669,0.9902912621359223,206,7650,6300,1350,0.8235294117647058,90,63,27,197.59521086196736,0.48347590575420313,0.7755700625574318,0.11304240681951933,1043365.6238586593,-7617.189909503928,1035748.4339491554,1751,0,288.3932038834951,73,133,38,39.59097026992263,0.5311994336569579,44.63682432432434,8171.621621621648,111.94002221399518,0
1790,32,2,2,204,0.009708737864077669,0.009708737864077669,0.9902912621359223,206,6850,4800,2050,0.7007299270072993,89,48,41,195.98438420566418,0.4833806930302313,0.7727953868520923,0.10940518379420737,1035701.207752129,-7453.747315527511,1028247.4604366014,1752,0,289.3398058252427,72,134,42,40.59018040755281,0.5225525889967637,45.57648401826483,8141.552511415502,113.07711821410419,8
1791,32,0,2,202,0.0,0.00980392156862745,0.9901960784313726,204,6350,4400,1950,0.6929133858267716,83,44,39,197.51491665956314,0.4830790793328826,0.7724450501200153,0.11073325426859436,1037048.6491559109,-6183.484498011583,1030865.1646578994,1753,1,293.13235294117646,73,131,41,40.38252423605736,0.5242544934640523,45.41103603603603,8146.846846846833,111.60064173762784,0
1792,32,5,5,202,0.024154589371980676,0.024154589371980676,0.9758454106280193,207,5650,3600,2050,0.6371681415929203,77,36,41,201.77261373518692,0.4836731782436721,0.7760483919889773,0.114125502041649,1039819.5931654369,-5088.576574790496,1034731.0165906464,1754,0,289.72463768115944,81,126,35,39.927371935419536,0.5301932367149759,45.07113821138209,8157.723577235717,100.71263675599651,8
1793,32,3,3,202,0.014634146341463415,0.014634146341463415,0.9853658536585366,205,7550,5100,2450,0.6754966887417219,100,51,49,217.58263665609468,0.48306930495775546,0.7875574125936213,0.12262025690956098,1038679.9797780709,-3350.2542715977124,1035329.7255064732,1755,0,293.23414634146343,81,124,43,39.66710500074785,0.527489837398374,45.21087398373982,8153.252032520291,100.65743250025051,8
1794,32,3,1,204,0.014634146341463415,0.004878048780487805,0.9951219512195122,205,5900,4100,1800,0.6949152542372882,77,41,36,212.43451716879827,0.48298162761039376,0.785253391438814,0.12084389747143087,1041600.3460207585,-2645.6266820455257,1038954.719338713,1756,0,291.86829268292684,84,121,44,39.43273695164904,0.5307418699186992,44.85294117647058,8164.70588235292,97.19887955182047,0
1795,32,2,2,204,0.009708737864077669,0.009708737864077669,0.9902912621359223,206,7100,4900,2200,0.6901408450704225,93,49,44,208.37549113467068,0.4828469097797774,0.7833182174654625,0.11923023664333063,1043419.0884745204,-4815.406995965788,1038603.6814785546,1757,0,290.8495145631068,70,136,43,39.309002642766856,0.5328681229773462,44.63028169014088,8171.830985915583,116.7404426559369,0
1796,32,2,1,205,0.009708737864077669,0.0048543689320388345,0.9951456310679612,206,6650,4600,2050,0.6917293233082706,87,46,41,204.89452758022782,0.4832835069855553,0.7830106650109925,0.11629314978258147,1040900.0600730439,-5195.054786620829,1035705.0052864231,1758,0,291.3883495145631,84,122,39,39.712659555726376,0.5254348705501618,44.93872549019606,8161.960784313687,97.16619981325819,8
1797,32,3,2,206,0.014423076923076924,0.009615384615384616,0.9903846153846154,208,7450,5300,2150,0.7114093959731543,96,53,43,199.54390935615154,0.48368210392666916,0.7799028710487046,0.11428423899488743,1043710.737764798,-7396.775829883563,1036313.9619349145,1759,0,289.44711538461536,73,135,43,39.498135288065875,0.528145032051282,44.59459459459462,8172.972972973022,111.95853387634276,0
1798,32,5,3,208,0.023696682464454975,0.014218009478672985,0.985781990521327,211,5950,4500,1450,0.7563025210084033,74,45,29,194.37186134511015,0.4839558414202964,0.7792250387242103,0.10936427384355851,1038178.1106180148,-7791.477646285301,1030386.6329717295,1760,0,285.7962085308057,77,134,44,40.321248820383744,0.5209320695102686,45.2724358974359,8151.282051282054,105.8608058608059,8
1799,32,2,3,207,0.009523809523809525,0.014285714285714285,0.9857142857142858,210,7550,5100,2450,0.6754966887417219,100,51,49,191.22671564730638,0.48391433128275235,0.7749029876943805,0.10844823568743861,1040648.7953599048,-9750.029744199896,1030898.7656157048,1761,0,285.96666666666664,81,129,41,40.09264793783622,0.5245039682539683,44.96951219512195,8160.975609756097,100.75278530563082,0
1800,32,1,1,207,0.004807692307692308,0.004807692307692308,0.9951923076923077,208,6400,4400,2000,0.6875,84,44,40,190.64535799969596,0.4836274270717205,0.7725342098989207,0.1083379421878619,1041280.9092796895,-8296.925654424918,1032983.9836252646,1762,0,285.6201923076923,82,126,44,40.02855397582854,0.5262920673076923,44.89206827309237,8163.4538152610485,99.55431482025669,0
1801,32,3,3,207,0.014285714285714285,0.014285714285714285,0.9857142857142858,210,7850,6000,1850,0.7643312101910829,97,60,37,208.49807823499805,0.483971766537556,0.7903572929802443,0.1179981273482394,1040001.2727776906,-6482.3466527800065,1033518.9261249106,1763,0,283.06190476190477,80,130,42,39.73318621269441,0.5272321428571429,45.04886831275719,8158.436213991748,101.98045267489685,8
1802,32,3,4,206,0.014285714285714285,0.01904761904761905,0.9809523809523809,210,7150,4800,2350,0.6713286713286714,95,48,47,208.99763688090542,0.4840928077770183,0.7929419871473815,0.11943701019128392,1043031.349182123,-5551.782565647025,1037479.5666164759,1764,0,283.01428571428573,63,147,43,39.341559359129654,0.5297619047619048,44.67773437499998,8170.312499999953,129.68749999999926,0
1803,32,4,5,205,0.01904761904761905,0.023809523809523808,0.9761904761904762,210,7150,5100,2050,0.7132867132867133,92,51,41,215.1078853056181,0.48424707602339184,0.7954192854311752,0.12205432166226383,1040808.9009284489,-4372.759662803264,1036436.1412656456,1765,0,283.33809523809526,78,132,37,39.4635656309776,0.5284226190476191,44.949894514767934,8161.603375527433,104.63594071189017,8
1804,32,2,2,205,0.00966183574879227,0.00966183574879227,0.9903381642512077,207,6900,5100,1800,0.7391304347826086,87,51,36,229.07289296178158,0.4836888122821006,0.794208322393195,0.1302955976077247,1041569.0782335082,-580.9516059027337,1040988.1266276054,1766,0,286.9710144927536,79,128,37,39.01213107085138,0.5281803542673108,44.856770833333336,8164.583333333343,103.34915611814358,7
1805,32,2,5,202,0.00966183574879227,0.024154589371980676,0.9758454106280193,207,6750,5100,1650,0.7555555555555555,84,51,33,247.59461229559912,0.4836643840970561,0.804761682183835,0.14102375104460016,1041995.673085065,3448.5029382378425,1045444.1760233028,1767,0,287.84057971014494,80,127,41,38.48602432305312,0.5322061191626408,44.80452674897119,8166.2551440329225,102.07818930041154,8
1806,32,3,5,200,0.014634146341463415,0.024390243902439025,0.975609756097561,205,5850,3900,1950,0.6666666666666666,78,39,39,256.7358729597103,0.48389526542324246,0.8154220540699391,0.14695915486659292,1043540.8284023675,6732.8731097961745,1050273.7015121637,1768,0,290.5170731707317,64,141,33,38.0587453982597,0.5304369918699188,44.61538461538462,8172.307692307698,127.69230769230778,7
1807,32,2,1,201,0.009900990099009901,0.0049504950495049506,0.995049504950495,202,6600,5100,1500,0.7727272727272727,81,51,30,252.6338673841677,0.4836199571449682,0.8108535925500502,0.14557852137109809,1045606.4975009639,5831.122645136561,1051437.6201461004,1769,0,294.2227722772277,67,135,36,37.904482262703766,0.5334674092409242,44.36274509803923,8180.392156862767,122.09540532630994,0
1808,32,1,3,199,0.0049504950495049506,0.01485148514851485,0.9851485148514851,202,6900,4900,2000,0.7101449275362319,89,49,40,249.16329206659867,0.4834793647275175,0.8110000303205531,0.1416084383278042,1041317.3073686097,4591.609677977659,1045908.9170465873,1770,0,295.05445544554453,75,127,36,38.53114534644245,0.5269698844884488,44.887609649122794,8163.596491228041,108.84795321637388,8
1809,32,5,2,202,0.024509803921568627,0.00980392156862745,0.9901960784313726,204,7250,5600,1650,0.7724137931034483,89,56,33,247.54550074629248,0.4839810924369748,0.8172336644979996,0.1431173656632543,1046624.9084472691,3767.457411024464,1050392.3658582936,1771,0,292.5049019607843,63,141,39,37.907014976029856,0.5337009803921569,44.238281250000014,8184.375000000027,129.91071428571473,8
1810,32,3,2,203,0.014634146341463415,0.00975609756097561,0.9902439024390244,205,6850,5000,1850,0.7299270072992701,87,50,37,214.51217259346333,0.48438845050215207,0.7891064772548064,0.1236619342601914,1045733.48456791,-2985.4876543205723,1042747.9969135894,1772,0,291.3951219512195,74,131,41,38.86315894315568,0.5316056910569106,44.34722222222225,8180.888888888959,110.5525525525535,8
1811,32,2,5,200,0.00975609756097561,0.024390243902439025,0.975609756097561,205,5750,3800,1950,0.6608695652173913,77,38,39,210.09605658158102,0.4841383707954727,0.7859501197172594,0.12187861157007882,1047670.3494822565,-2727.718195265905,1044942.6312869906,1773,0,292.30731707317074,77,128,36,38.73444105213714,0.534349593495935,44.11057692307695,8188.461538461602,106.34365634365716,0
1812,32,3,7,196,0.014778325123152709,0.034482758620689655,0.9655172413793104,203,6500,4000,2500,0.6153846153846154,90,40,50,209.7983609414849,0.4835115592840072,0.7824287247281936,0.12234740082912347,1049287.5744947742,-3072.2373429456748,1046215.3371518286,1774,0,295.935960591133,82,121,39,38.54049252634162,0.5369458128078818,43.91315261044179,8194.779116465927,99.93633068860886,0
1813,32,1,2,195,0.005076142131979695,0.01015228426395939,0.9898477157360406,197,5300,3600,1700,0.6792452830188679,70,36,34,227.5167943828438,0.4827914033633758,0.791402617259249,0.1303121783835506,1043727.656580402,2793.114126778233,1046520.7707071803,1775,0,305.38578680203045,67,130,38,38.78157550130948,0.5316201353637902,44.59252450980392,8173.039215686277,121.98565993561608,8
1814,32,4,4,195,0.020100502512562814,0.020100502512562814,0.9798994974874372,199,6550,5000,1550,0.7633587786259542,81,50,31,221.84786567737945,0.48359643334517705,0.7892163827506693,0.12854382885448135,1047305.866340876,118.51423182427061,1047424.3805727003,1776,0,301.66331658291455,71,128,33,38.479227927316614,0.5345477386934674,44.15509259259259,8187.037037037022,115.31038080333833,0
1815,32,1,3,193,0.00510204081632653,0.015306122448979591,0.9846938775510204,196,6500,4600,1900,0.7076923076923077,84,46,38,263.5373896686221,0.48361787022501307,0.816783304825,0.15251426915996597,1046931.1132459574,9481.09854954073,1056412.2117954982,1777,0,306.86224489795916,66,130,39,37.45960716384044,0.5338010204081632,44.20087064676616,8185.572139303468,124.02382029247678,8
1816,32,3,4,192,0.015306122448979591,0.02040816326530612,0.9795918367346939,196,6250,4300,1950,0.688,82,43,39,255.55103978567493,0.48335513692656545,0.815911604613424,0.14856123345557773,1048321.3699574483,8129.9232244338755,1056451.2931818822,1778,0,304.36224489795916,62,134,37,37.48977240918978,0.5370960884353742,44.03108465608466,8191.005291005294,132.11298856460152,8
1817,32,0,2,190,0.0,0.010416666666666666,0.9895833333333334,192,5450,4000,1450,0.7339449541284404,69,40,29,223.20558224341718,0.48234574970913324,0.7910462469464805,0.1309740339903706,1051185.1839409913,3076.080205440322,1054261.2641464316,1779,1,311.5364583333333,60,132,40,37.960526315789494,0.5405815972222222,43.68169398907102,8202.185792349694,136.70309653916155,8
1818,32,1,2,189,0.005235602094240838,0.010471204188481676,0.9895287958115183,191,5200,3500,1700,0.6730769230769231,69,35,34,223.172212110745,0.4819096169743731,0.7896475414260267,0.13199819862647721,1053609.9213347891,3627.2913692225834,1057237.2127040117,1780,0,313.91623036649213,62,129,42,37.65933741408933,0.543357329842932,43.386243386243386,8211.640211640213,132.44580986516473,0
1819,32,0,3,186,0.0,0.015873015873015872,0.9841269841269842,189,6950,5400,1550,0.7769784172661871,85,54,31,223.49111020229248,0.4814392660137341,0.7804091721933211,0.13075990534820006,1050292.2341457296,2196.1954892152476,1052488.4296349448,1781,1,318.18518518518516,76,113,39,38.06453174226025,0.5424382716049383,43.79058441558443,8198.701298701339,107.87764866712287,7
1820,32,1,2,185,0.0053475935828877,0.0106951871657754,0.9893048128342246,187,5550,3900,1650,0.7027027027027027,72,39,33,224.67163964022302,0.4812175358902114,0.7787952675182181,0.13212683960005378,1051863.2873579331,4314.769889612493,1056178.0572475456,1782,0,322.3422459893048,68,119,39,37.83843126864498,0.5441176470588236,43.59903381642513,8204.83091787441,120.65927820403543,0
1821,32,1,1,185,0.005376344086021506,0.005376344086021506,0.9946236559139785,186,6200,4400,1800,0.7096774193548387,80,44,36,259.77009348169986,0.4813741160515354,0.8072342974143836,0.15235988015110682,1051045.1239586105,11206.018020842432,1062251.141979453,1783,0,324.89247311827955,60,126,35,37.04083105692141,0.5414426523297491,43.698770491803266,8201.639344262272,136.69398907103786,8
1822,32,1,3,183,0.005376344086021506,0.016129032258064516,0.9838709677419355,186,6400,4500,1900,0.703125,83,45,38,243.92888689658892,0.48125968710646133,0.7855264931323147,0.14176491506203998,1048234.6944444568,7538.944444445102,1055773.638888902,1784,0,325.73655913978496,74,112,33,37.798103532475984,0.5366823476702509,44.04166666666671,8190.666666666765,110.68468468468602,8
1823,32,2,2,183,0.010810810810810811,0.010810810810810811,0.9891891891891892,185,6550,5000,1550,0.7633587786259542,81,50,31,238.97693304690932,0.4806000293772033,0.7809227532896832,0.13957804874832536,1049760.1991312031,6623.694564618096,1056383.8936958213,1785,0,328.3297297297297,78,107,37,37.73422217646457,0.5394144144144144,43.855485232067544,8196.624472573918,105.08492913556304,0
1824,32,0,5,178,0.0,0.0273224043715847,0.9726775956284153,183,6250,4400,1850,0.704,81,44,37,241.33173011384892,0.4802012650373306,0.7835549440917766,0.14165047447701537,1051272.1955986624,7891.067556881867,1059163.2631555442,1786,1,332.6885245901639,65,118,36,37.48505582579071,0.5413251366120219,43.671085858585855,8202.525252525244,126.19269619269606,0
1825,32,2,1,179,0.011111111111111112,0.005555555555555556,0.9944444444444445,180,6450,4400,2050,0.6821705426356589,85,44,41,238.80239079102742,0.4796438547486033,0.7785984848484857,0.14144449300699302,1054044.4444444429,7891.666666666607,1061936.1111111094,1787,0,338.26666666666665,69,111,40,37.204071969696955,0.5451388888888888,43.33333333333333,8213.333333333321,119.03381642512059,0
1826,32,2,2,179,0.011049723756906077,0.011049723756906077,0.988950276243094,181,6500,4500,2000,0.6923076923076923,85,45,40,233.05929323326046,0.4794710456312666,0.7747336308375365,0.13917230611623022,1056520.0705350584,6546.364185130847,1063066.4347201893,1788,0,337.1381215469613,73,108,34,37.043218752853086,0.5482849907918969,43.03209459459458,8222.972972972944,112.64346538319101,0
1827,32,2,1,180,0.011049723756906077,0.0055248618784530384,0.994475138121547,181,5750,4400,1350,0.7652173913043478,71,44,27,249.36623358999537,0.47932908737466745,0.7885388964796332,0.15035950479739252,1059447.9331032236,10888.108152531331,1070336.041255755,1789,0,338.060773480663,64,117,37,36.259497415457425,0.5502992633517496,42.67628205128206,8234.35897435899,128.6618589743592,0
1828,32,0,3,177,0.0,0.016666666666666666,0.9833333333333333,180,4950,3700,1250,0.7474747474747475,62,37,25,250.0718453891361,0.47895070349679286,0.7872635951918823,0.15150100844870967,1060873.990058411,12108.94328384846,1072982.9333422594,1790,1,340.8388888888889,65,115,37,36.063885483706215,0.5517361111111111,42.50315656565656,8239.898989898978,126.76767676767659,0
1829,32,2,0,179,0.0111731843575419,0.0,1.0,179,5950,4300,1650,0.7226890756302521,76,43,33,262.81169530338144,0.47893258426966295,0.8046254613497221,0.15451625259901622,1051783.511283474,13534.20153851049,1065317.7128219844,1791,0,343.1899441340782,58,121,35,36.87049534040305,0.5452164804469274,43.608757062146886,8204.519774011289,141.45723748295325,8
1830,32,1,1,179,0.005555555555555556,0.005555555555555556,0.9944444444444445,180,5450,3100,2350,0.5688073394495413,78,31,47,233.51055973754805,0.47893841816677013,0.7852318448146614,0.1375496508818988,1052363.0063200232,7697.5749305755035,1060060.5812505987,1792,0,342.27777777777777,58,122,42,37.54948024232411,0.5454282407407407,43.53813559322034,8206.77966101695,141.49620105201637,8
1831,32,0,2,177,0.0,0.0111731843575419,0.9888268156424581,179,6450,4700,1750,0.7286821705426356,82,47,35,222.00742276077042,0.47870504048710066,0.7717561186485762,0.12432415674603177,1036694.214876035,3780.762167125891,1040474.9770431609,1793,1,344.9776536312849,65,114,38,39.803447420634896,0.5284567039106145,45.45454545454546,8145.454545454561,125.31468531468556,8
1832,32,3,1,179,0.016666666666666666,0.005555555555555556,0.9944444444444445,180,5500,3800,1700,0.6909090909090909,72,38,34,218.71503771845914,0.4790198893027105,0.7697878299570291,0.12371069320950352,1039825.4314620127,3985.0916925654915,1043810.5231545782,1794,0,336.8,70,110,40,39.49472932013505,0.5318865740740741,45.07042253521127,8157.746478873249,116.53923541247498,0
1833,32,2,1,180,0.011049723756906077,0.0055248618784530384,0.994475138121547,181,6100,4300,1800,0.7049180327868853,79,43,36,225.07063645082613,0.47922933292408426,0.7765790676043074,0.12569280671578525,1035828.1106180168,4326.898422090861,1040155.0090401077,1795,0,335.90055248618785,64,117,38,39.834220360689486,0.5279120626151013,45.560897435897445,8142.051282051301,127.21955128205158,8
1834,32,5,4,181,0.02702702702702703,0.021621621621621623,0.9783783783783784,185,6300,4600,1700,0.7301587301587301,80,46,34,216.1440274945884,0.4803662358010184,0.7717632296347339,0.12208245763475578,1039380.2500000068,1631.1666666669971,1041011.4166666737,1796,0,329.5189189189189,74,111,39,39.616029099231646,0.5313063063063064,45.12500000000002,8156.000000000054,110.21621621621694,0
1835,32,3,0,184,0.016304347826086956,0.0,1.0,184,5850,3900,1950,0.6666666666666666,78,39,39,229.7972442826269,0.47953913241466695,0.7770257590423328,0.1293564538787878,1038323.2596021922,5070.764746227533,1043394.0243484197,1797,0,332.1141304347826,71,113,43,39.40065121914277,0.5276268115942029,45.25462962962962,8151.851851851831,114.81481481481453,8
1836,32,6,2,188,0.031578947368421054,0.010526315789473684,0.9894736842105263,190,5000,3100,1900,0.62,69,31,38,226.30341782524692,0.48090944954980047,0.7833830694468205,0.12659276039557718,1036353.9413927309,3906.0878027680133,1040260.0291954989,1798,0,322.59473684210525,67,123,42,39.73681834597327,0.5232456140350877,45.496323529411754,8144.1176470588025,121.55399473222093,8
1837,32,4,6,186,0.020833333333333332,0.03125,0.96875,192,6400,4500,1900,0.703125,83,45,38,229.58910100574394,0.4807278032286213,0.7873998883369913,0.12683808853903777,1032418.1847737423,2606.3925808370195,1035024.5773545793,1799,0,320.1354166666667,70,122,38,40.148025682492005,0.5193142361111112,45.9800469483568,8128.638497652568,116.1234071093224,8
1838,32,6,4,188,0.03125,0.020833333333333332,0.9791666666666666,192,6750,5100,1650,0.7555555555555555,84,51,33,241.81650853838104,0.4802278759453171,0.7942023486281442,0.1363306074453229,1038802.1065382075,5089.899693077101,1043892.0062312846,1800,0,320.9947916666667,66,126,36,39.03431163178555,0.5241970486111112,45.19589552238807,8153.731343283606,123.54138398914554,0
1839,32,4,1,191,0.020833333333333332,0.005208333333333333,0.9947916666666666,192,5950,4500,1450,0.7563025210084033,74,45,29,241.25067060472458,0.48051192553810357,0.794291637079116,0.13713067886139477,1041361.0914198775,5895.812329343084,1047256.9037492205,1801,0,317.9739583333333,68,124,42,38.727513462335075,0.5268012152777778,44.88224637681162,8163.76811594209,120.05541346973662,0
1840,32,2,2,191,0.010362694300518135,0.010362694300518135,0.9896373056994818,193,5850,4600,1250,0.7863247863247863,71,46,25,235.26518516507096,0.4804709988485895,0.7911396124455328,0.13485214813661903,1043962.419297961,4671.602376302109,1048634.021674263,1802,0,316.9637305699482,63,130,39,38.55427764326068,0.5291990500863557,44.563802083333336,8173.958333333341,129.7453703703705,0
1841,32,5,1,195,0.025510204081632654,0.00510204081632653,0.9948979591836735,196,5800,4000,1800,0.6896551724137931,76,40,36,225.15694792587655,0.4807725013082156,0.7840848381237293,0.13031811228437185,1046967.4744898035,2146.4002267578617,1049113.8747165613,1803,0,312.3520408163265,69,127,47,38.436833430288964,0.5321003401360545,44.1964285714286,8185.714285714346,118.63354037267169,0
1842,32,1,4,192,0.00510204081632653,0.02040816326530612,0.9795918367346939,196,6350,4400,1950,0.6929133858267716,83,44,39,218.96360801337198,0.4809998037676609,0.7901109066475742,0.12640556198651906,1046167.6729845783,264.5296527312976,1046432.2026373096,1804,0,313.30102040816325,66,130,42,38.69512677083967,0.5310905612244898,44.29415422885572,8182.587064676607,123.9785918890395,8
1843,32,0,1,191,0.0,0.005208333333333333,0.9947916666666666,192,5750,3900,1850,0.6782608695652174,76,39,37,232.83912275556014,0.48085562554537525,0.7931698467563617,0.13044328624259893,1036822.7771719708,4132.581177940936,1040955.3583499118,1805,1,320.2864583333333,65,127,38,39.51158110649558,0.5238172743055556,45.43876262626262,8145.9595959595845,125.32245532245514,8
1844,32,5,3,193,0.025510204081632654,0.015306122448979591,0.9846938775510204,196,6050,4700,1350,0.7768595041322314,74,47,27,216.52945326311155,0.481647915576487,0.7867701144675414,0.11832790387773885,1028962.5935385383,-689.8584385814916,1028272.7350999569,1806,0,313.9030612244898,70,126,41,40.91444894417127,0.5183886054421769,46.40551643192488,8115.023474178393,115.92890677397705,7
1845,32,7,1,199,0.035,0.005,0.995,200,5850,3900,1950,0.6666666666666666,78,39,39,203.20099875157678,0.4822885259631491,0.777936394343619,0.10857484996004266,1021760.6289919855,-4325.443940757799,1017435.1850512277,1807,0,308.22,71,129,46,42.1595604091525,0.5044791666666666,47.29456018518519,8086.574074074087,113.89540949400121,8
1846,32,5,2,202,0.024509803921568627,0.00980392156862745,0.9901960784313726,204,6450,4400,2050,0.6821705426356589,85,44,41,210.45170060826518,0.4830428579477768,0.7878292244960847,0.1141371207160399,1026541.979158926,-4042.4989480461536,1022499.4802108799,1808,0,302.86764705882354,66,138,42,41.37332228496602,0.5079146241830066,46.703980099502466,8105.472636815875,122.8101914669072,0
1847,32,8,5,205,0.0380952380952381,0.023809523809523808,0.9761904761904762,210,6300,4900,1400,0.7777777777777778,77,49,28,204.48535531155363,0.4840301511354143,0.7856813882720628,0.11275906735751257,1031828.2548476334,-6101.24653739671,1025727.0083102367,1809,0,294.05238095238093,75,135,37,40.859779792746075,0.5125,46.05263157894733,8126.315789473589,108.35087719298119,0
1848,32,1,3,203,0.0048543689320388345,0.014563106796116505,0.9854368932038835,206,7250,5000,2250,0.6896551724137931,95,50,45,207.94224330844304,0.4840170889572974,0.7868382191221301,0.11515081215467451,1033165.2527700748,-5482.259926131546,1027682.9928439432,1810,0,298.99514563106794,75,131,40,40.60409924487593,0.5138551779935275,45.888157894736814,8131.578947368354,108.42105263157806,0
1849,32,5,1,207,0.02403846153846154,0.004807692307692308,0.9951923076923077,208,7250,5300,1950,0.7310344827586207,92,53,39,228.68931568258242,0.4843159683512945,0.8041139751830899,0.12652519770206613,1032879.0734178395,-1608.3183034428948,1031270.7551143966,1811,0,296.71634615384613,80,128,39,40.112892476927996,0.519130608974359,45.92335390946502,8130.45267489712,101.630658436214,8
1850,32,4,4,207,0.018957345971563982,0.018957345971563982,0.981042654028436,211,6350,4500,1850,0.7086614173228346,82,45,37,239.13991441539798,0.4845811705408862,0.8087103972901724,0.1322403774941467,1032719.4906124914,842.8901200367536,1033562.3807325282,1812,0,290.33175355450237,75,136,38,39.86746511293339,0.5167357819905214,45.942982456140335,8129.82456140347,108.39766081871294,7
1851,32,2,2,207,0.009569377990430622,0.009569377990430622,0.9904306220095693,209,6100,3700,2400,0.6065573770491803,85,37,48,234.25581364000004,0.4844698886639676,0.8040527125309425,0.13036138687696747,1034716.4789435003,577.6701323252373,1035294.1490758256,1813,0,291.0047846889952,68,141,41,39.740279014544384,0.5187898724082934,45.697463768115945,8137.681159420298,119.67178175618085,0
1852,32,4,6,205,0.018957345971563982,0.02843601895734597,0.9715639810426541,211,7300,5400,1900,0.7397260273972602,92,54,38,229.97252156080648,0.4846075001880689,0.8029435870015127,0.1293803807873287,1038142.3220168424,-1751.1584933593613,1036391.1635234831,1814,0,289.12796208530807,72,139,36,39.418893432674196,0.5216725908372828,45.27682648401825,8151.141552511379,113.21029934043582,0
1853,32,6,7,204,0.02843601895734597,0.03317535545023697,0.966824644549763,211,7100,5300,1800,0.7464788732394366,89,53,36,220.56892067613228,0.4850212517866546,0.7963147879996315,0.12363085497275697,1036979.5282886033,-3554.9089364279607,1033424.6193521754,1815,0,289.18009478672985,72,139,44,39.80426639015001,0.5239928909952607,45.41952054794518,8146.575342465704,113.14687975646811,8
1854,32,5,6,203,0.023923444976076555,0.028708133971291867,0.9712918660287081,209,6150,4700,1450,0.7642276422764228,76,47,29,198.42266988657371,0.48514465249662614,0.7707717627904531,0.11188773383175828,1038862.4732300205,-6723.226883346532,1032139.2463466739,1816,0,292.2200956937799,83,126,36,40.13245409123351,0.5303030303030303,45.18849206349203,8153.968253968156,98.24058137311032,8
1855,32,3,0,206,0.014563106796116505,0.0,1.0,206,6700,4700,2000,0.7014925373134329,87,47,40,203.84341041473286,0.4845188057463099,0.7741428915303592,0.11587608632300504,1041383.3647844307,-5444.172674634752,1035939.192109796,1817,0,297.40776699029124,82,124,40,39.6790551620097,0.5324130258899676,44.87951807228913,8163.855421686681,99.55921245959368,0
1856,32,1,2,205,0.004830917874396135,0.00966183574879227,0.9903381642512077,207,6750,4800,1950,0.7111111111111111,87,48,39,203.96907236204956,0.4843669386989353,0.7754706749079487,0.11688707357131538,1043892.3995844937,-5565.647122191133,1038326.7524623026,1818,0,296.9661835748792,75,132,40,39.362434714173304,0.5346215780998389,44.57236842105265,8173.684210526365,108.98245614035153,0
1857,32,2,3,204,0.00966183574879227,0.014492753623188406,0.9855072463768116,207,6750,4800,1950,0.7111111111111111,87,48,39,216.66473759715063,0.48407477760580336,0.7928671817783406,0.12149529840603687,1037115.9290123394,-3208.709876543587,1033907.2191357958,1819,0,297.8309178743961,74,133,38,39.886553743203656,0.5260165056360708,45.40277777777776,8147.111111111062,110.09609609609544,8
1858,32,2,4,202,0.009708737864077669,0.019417475728155338,0.9805825242718447,206,6950,5200,1750,0.7482014388489209,87,52,35,216.13484791459888,0.48453755229299866,0.7938285215086707,0.12241657227034815,1040247.4414904297,-3183.255487983146,1037064.1860024466,1820,0,296.6650485436893,77,129,38,39.50766205764767,0.5290756472491909,45.01869658119658,8159.401709401705,105.96625596625591,0
1859,32,3,2,203,0.014634146341463415,0.00975609756097561,0.9902439024390244,205,5200,2900,2300,0.5576923076923077,75,29,46,212.94821030262926,0.48428682448589194,0.7901502176707043,0.12142857905757791,1042350.9137110788,-1806.647683582859,1040544.266027496,1821,0,298.9512195121951,67,138,42,39.325761213139714,0.5314024390243902,44.76102941176473,8167.647058823578,121.90517998244147,0
1860,32,4,1,206,0.01932367149758454,0.004830917874396135,0.9951690821256038,207,7700,6000,1700,0.7792207792207793,94,60,34,204.0848616154874,0.48442556634304207,0.7834532635998499,0.11759988085691489,1045599.6310804696,-6421.788797147188,1039177.8422833224,1822,0,296.8985507246377,72,135,39,39.14643222625364,0.5346215780998389,44.363584474885876,8180.3652968037195,113.61618467782944,0
1861,32,3,2,207,0.014354066985645933,0.009569377990430622,0.9904306220095693,209,7550,5300,2250,0.7019867549668874,98,53,45,213.62107964603769,0.48414592534658324,0.7945927373241628,0.12348727838274685,1046582.8427977854,-4635.568636503553,1041947.2741612819,1823,0,295.00956937799043,75,134,43,38.77992140050017,0.534988038277512,44.24342105263158,8184.210526315801,109.12280701754402,8
1862,32,3,7,203,0.014285714285714285,0.03333333333333333,0.9666666666666667,210,5450,3500,1950,0.6422018348623854,74,35,39,211.17894889348332,0.48400499354446724,0.7934176339400723,0.12260760451910352,1047923.6795429903,-3190.115766703911,1044733.5637762863,1824,0,294.54285714285714,78,132,35,38.67514211620042,0.5367559523809524,44.079641350210984,8189.45147679328,104.9929676511959,0
1863,32,3,9,197,0.014563106796116505,0.043689320388349516,0.9563106796116505,206,7500,5500,2000,0.7333333333333333,95,55,40,214.69009681328916,0.48373194411555764,0.7942192890109228,0.12493220762898816,1048629.1954798477,-3673.9393002378456,1044955.2561796099,1825,0,300.5533980582524,76,130,36,38.49730060593248,0.5381270226537217,43.9935064935065,8192.207792207815,107.79220779220809,0
1864,32,3,2,198,0.015,0.01,0.99,200,6900,4900,2000,0.7101449275362319,89,49,40,213.78321331801615,0.4834270309882747,0.7878327488946486,0.12508511116439516,1050304.7119140644,-1992.4967447915064,1048312.2151692729,1826,0,308.555,79,121,40,38.3117027494029,0.54015625,43.78906250000001,8198.750000000015,103.78164556962044,0
1865,32,3,3,198,0.014925373134328358,0.014925373134328358,0.9850746268656716,201,6050,3800,2250,0.628099173553719,83,38,45,205.93626811420734,0.48348880597014926,0.7812104730584368,0.12150239818738237,1052854.4423440455,-2885.8170552405186,1049968.625288805,1827,0,307.2636815920398,68,133,42,38.195547904896394,0.5426513266998342,43.47826086956522,8208.695652173916,120.71611253196934,0
1866,32,2,6,194,0.01,0.03,0.97,200,6100,4200,1900,0.6885245901639344,80,42,38,259.647950020849,0.48286379815745395,0.8181524172566124,0.15497297471991892,1056369.7719425221,8756.849149773316,1065126.6210922955,1828,0,309.42,66,134,34,36.37872874689903,0.54609375,43.050373134328346,8222.388059701461,124.58163726820396,8
1867,32,0,0,194,0.0,0.0,1.0,194,6100,4500,1600,0.7377049180327869,77,45,32,267.22503846077535,0.48160988996314297,0.8179344775892305,0.1598322842197372,1057009.0468057713,11591.856637211898,1068600.9034429833,1829,2,319.9072164948454,66,128,35,36.104222114686685,0.546875,42.972636815920396,8224.87562189054,124.61932760440212,0
1868,32,0,1,193,0.0,0.005154639175257732,0.9948453608247423,194,6650,4500,2150,0.6766917293233082,88,45,43,269.66521970125046,0.4813745259334437,0.8172447865002876,0.16041777323430723,1055361.0946745551,11468.83629191322,1066829.9309664683,1830,3,320.9072164948454,64,130,38,36.247348059403464,0.5496134020618557,43.17307692307692,8218.46153846153,128.4134615384614,8
1869,32,1,2,192,0.005154639175257732,0.010309278350515464,0.9896907216494846,194,5750,3800,1950,0.6608695652173913,77,38,39,257.4297455806127,0.48147134234282357,0.8090758017345439,0.15037610495994105,1049801.8681150377,9500.045563781692,1059301.9136788193,1831,0,321.88659793814435,82,112,38,37.25634901192229,0.5439218213058419,43.85040160642573,8196.787148594436,99.960818885298,8
1870,32,1,2,191,0.0051813471502590676,0.010362694300518135,0.9896373056994818,193,6300,4700,1600,0.746031746031746,79,47,32,256.2406433210515,0.4814998470782959,0.7980588200626118,0.14773339015093997,1045766.6250053607,8693.582551011805,1054460.2075563725,1832,0,324.3730569948186,71,122,41,37.79220427065061,0.5374568221070812,44.343171296296305,8181.018518518537,115.22561293688081,8
1871,32,3,4,190,0.015463917525773196,0.020618556701030927,0.979381443298969,194,6000,4300,1700,0.7166666666666667,77,43,34,250.79772850189178,0.4814463036162598,0.7956665068328928,0.14573381521055945,1048185.9410430891,7776.530612245175,1055962.4716553343,1833,0,323.50515463917526,76,118,36,37.62839147286825,0.5406464776632303,44.047619047619065,8190.476190476232,107.76942355889778,0
1872,32,1,0,191,0.005235602094240838,0.0,1.0,191,6250,4700,1550,0.752,78,47,31,254.47241791291847,0.481046201892165,0.8087283245246741,0.14870665226820623,1049921.686370627,8985.222029988527,1058906.9084006154,1834,0,324.73298429319374,84,107,35,37.317111578880215,0.5461387434554974,43.83578431372549,8197.254901960787,97.58636788048555,8
1873,32,1,0,192,0.005208333333333333,0.0,1.0,192,5100,3600,1500,0.7058823529411765,66,36,30,257.57594496989987,0.4810641179464805,0.8126873251631812,0.15141915574698803,1051745.517184746,10680.86909134336,1062426.3862760894,1835,0,324.0364583333333,60,132,36,37.00948559122596,0.5476345486111112,43.61338797814207,8204.371584699444,136.7395264116574,0
1874,32,1,2,191,0.0051813471502590676,0.010362694300518135,0.9896373056994818,193,5750,3900,1850,0.6782608695652174,76,39,37,222.8394340836532,0.48112541378814044,0.7794504687104835,0.12901118303925693,1047049.7809887718,2314.796130590789,1049364.5771193625,1836,0,323.3523316062176,73,120,42,38.48583750619054,0.5416666666666667,44.18637387387392,8186.036036036137,112.1374799457005,8
1875,32,0,0,191,0.0,0.0,1.0,191,6650,4700,1950,0.706766917293233,86,47,39,223.41325983518024,0.4807017543859649,0.7807949752379129,0.1303840886313091,1049515.9854575533,2045.1575120411335,1051561.1429695943,1837,1,327.2303664921466,76,115,39,38.16333896753295,0.5449389179755673,43.88528138528142,8195.67099567107,107.83777625882986,7
1876,32,2,1,192,0.010362694300518135,0.0051813471502590676,0.9948186528497409,193,5250,3600,1650,0.6857142857142857,69,36,33,221.42040018401497,0.48070150582901555,0.7838351768744067,0.13044824719412473,1052410.5838964325,2755.034528847982,1055165.6184252806,1838,0,324.82901554404145,66,127,39,37.85362107985774,0.5474417098445596,43.53233830845769,8206.965174129307,124.34795718377738,0
1877,32,1,1,192,0.0051813471502590676,0.0051813471502590676,0.9948186528497409,193,6400,4600,1800,0.71875,82,46,36,215.25124448616458,0.48020675913932065,0.7770137928576206,0.12777584345466594,1054714.115994533,405.70520898936365,1055119.8212035224,1839,0,325.66321243523316,68,125,43,37.72527488681129,0.5493847150259068,43.25181159420288,8215.94202898546,120.82267689684501,0
1878,32,0,3,189,0.0,0.015625,0.984375,192,7050,5100,1950,0.723404255319149,90,51,39,222.12175684299075,0.4799489392452007,0.7850704696438462,0.13126257364581945,1053344.5606634496,1344.1488751146085,1054688.709538564,1840,1,327.9270833333333,65,127,39,37.719328596912106,0.5495334201388888,43.418560606060595,8210.606060606036,126.31701631701594,8
1879,32,2,1,190,0.010471204188481676,0.005235602094240838,0.9947643979057592,191,6850,5100,1750,0.7445255474452555,86,51,35,208.43162706627157,0.4794008909708827,0.7691105673056267,0.12203831903521803,1050516.880418923,-1257.811470739694,1049259.0689481832,1841,0,330.4659685863874,78,113,43,38.42240004116713,0.5459205933682374,43.76318565400847,8199.578059071799,105.12279562912562,8
1880,32,0,1,189,0.0,0.005263157894736842,0.9947368421052631,190,5800,3800,2000,0.6551724137931034,78,38,40,218.97164342264304,0.47897405550914324,0.7751898776436794,0.12714872775535874,1047964.3489627326,2094.89514814227,1050059.2441108748,1842,1,333.12631578947367,76,114,36,38.470636430912386,0.5424342105263158,44.07467532467535,8189.610389610445,107.7580314422427,8
1881,32,1,2,188,0.005263157894736842,0.010526315789473684,0.9894736842105263,190,5850,4300,1550,0.7350427350427351,74,43,31,216.85465852401734,0.4788197345214889,0.7736155976320302,0.12651724327700328,1049420.7512647065,1664.3557327053404,1051085.106997412,1843,0,334.11578947368423,77,113,37,38.34318671672662,0.5441885964912281,43.896901709401725,8195.299145299185,106.43245643245695,0
1882,32,1,2,187,0.005291005291005291,0.010582010582010581,0.9894179894179894,189,5550,4000,1550,0.7207207207207207,71,40,31,217.0894663304041,0.4787656197230665,0.7746065117646164,0.12752362701539113,1051517.6024417698,2304.6790302219224,1053822.2814719917,1844,0,335.58730158730157,66,123,36,38.07588897648934,0.5464616402116402,43.64116915422885,8203.482587064665,124.295190713101,0
1883,32,2,3,186,0.010582010582010581,0.015873015873015872,0.9841269841269842,189,6700,4900,1800,0.7313432835820896,85,49,36,216.99242742984183,0.47877851889376716,0.776825366599716,0.1290673612694319,1055322.1397044235,1299.3825629834632,1056621.522267407,1845,0,336.06349206349205,70,119,41,37.604970008568955,0.5498787477954145,43.17781690140845,8218.309859154928,117.40442655935611,8
1884,32,1,1,186,0.0053475935828877,0.0053475935828877,0.9946524064171123,187,6400,4800,1600,0.75,80,48,32,246.94878300072773,0.4780394073562954,0.8026960414751594,0.1491887377222434,1060027.7749783525,8554.51379557476,1068582.2887739271,1846,0,337.4385026737968,60,127,33,36.24955770804308,0.5549242424242424,42.6058743169399,8236.612021857934,137.27686703096558,8
1885,32,3,3,186,0.015873015873015872,0.015873015873015872,0.9841269841269842,189,6250,4300,1950,0.688,82,43,39,240.34093734803827,0.47816639461143007,0.7996235209409306,0.14659205516393572,1062899.4486522593,7041.649959159327,1069941.0986114186,1847,0,334.85185185185185,66,123,36,36.06285438532997,0.5571538800705467,42.25746268656716,8247.761194029837,124.96607869742178,0
1886,32,1,1,186,0.0053475935828877,0.0053475935828877,0.9946524064171123,187,7250,5100,2150,0.7034482758620689,94,51,43,241.1970502291165,0.4777662775765243,0.7986908623359927,0.14777269059888634,1064234.9697231816,6688.067089580771,1070923.0368127623,1848,0,333.1818181818182,67,120,39,35.875009899421855,0.5592134581105169,42.09558823529411,8252.941176470573,123.17822651448616,0
1887,32,1,4,183,0.0053475935828877,0.0213903743315508,0.9786096256684492,187,6400,4700,1700,0.734375,81,47,34,198.25804920047904,0.47747997048281676,0.754485703219065,0.12067586658443342,1062283.3210090855,-1678.7562157065822,1060604.564793379,1849,0,333.93048128342247,71,116,42,37.223703911660074,0.5593248663101604,42.33217592592592,8245.370370370352,116.13197704746975,8
1888,32,0,2,181,0.0,0.01092896174863388,0.9890710382513661,183,5500,4000,1500,0.7272727272727273,70,40,30,192.67047903443984,0.4763731259632899,0.7416497286755452,0.1146721540736002,1055511.6213151843,-1426.8140589573236,1054084.807256227,1850,1,341.89617486338796,76,107,44,38.20611239860951,0.5516848816029144,43.15476190476188,8219.047619047553,108.14536340852044,8
1889,32,1,1,181,0.005494505494505495,0.005494505494505495,0.9945054945054945,182,5900,4500,1400,0.7627118644067796,73,45,28,203.13110444932798,0.47595205209155483,0.7545316780322897,0.11605462401056053,1042951.562500004,71.18055555573937,1043022.7430555597,1851,0,344.3901098901099,69,113,41,39.5013089895281,0.5398923992673993,44.687500000000014,8170.000000000031,118.40579710144972,8
1890,32,4,1,184,0.021621621621621623,0.005405405405405406,0.9945945945945946,185,6200,4600,1600,0.7419354838709677,78,46,32,203.82786168394966,0.47695480806893853,0.7544681459881872,0.11574364833956861,1041050.719000319,-760.971608325433,1040289.7473919935,1852,0,339.07027027027027,80,105,42,39.72103184606333,0.5371621621621622,44.920267489711925,8162.551440329196,102.03189300411495,8
1891,32,4,0,188,0.02127659574468085,0.0,1.0,188,5900,4000,1900,0.6779661016949152,78,40,38,184.88503995544443,0.47725435677172223,0.7371832191862002,0.10225869883066879,1032782.4729081382,-5310.794246219101,1027471.6786619191,1853,0,334.49468085106383,91,97,39,41.237958093795044,0.5293107269503546,45.93523550724639,8130.072463768151,89.34145564580385,8
1892,32,4,1,191,0.020833333333333332,0.005208333333333333,0.9947916666666666,192,6750,4500,2250,0.6666666666666666,90,45,45,193.09240543379042,0.4780742119328098,0.7523908174917175,0.10660717088494273,1032216.1572472155,-5287.379853902228,1026928.7773933132,1854,0,328.5052083333333,84,108,40,41.100449515905964,0.52490234375,46.00490196078432,8127.843137254925,96.76003734827292,8
1893,32,3,4,190,0.015463917525773196,0.020618556701030927,0.979381443298969,194,5050,3400,1650,0.6732673267326733,67,34,33,193.24721986831574,0.478500080123925,0.7557758813782132,0.10772582814599592,1035259.1440543496,-3837.809713649158,1031421.3343407004,1855,0,326.0927835051546,71,123,46,40.71517271451863,0.5274914089347079,45.63078703703702,8139.814814814769,114.64527908189815,0
1894,32,3,2,191,0.015544041450777202,0.010362694300518135,0.9896373056994818,193,6100,3900,2200,0.639344262295082,83,39,44,193.07171807538086,0.47849426093839953,0.7535410796456876,0.10879085078215334,1038633.6450879063,-4593.8435383967135,1034039.8015495095,1856,0,327.8911917098446,75,118,42,40.2974093101655,0.5302245250431779,45.21655701754384,8153.070175438554,108.70760233918071,0
1895,32,2,1,192,0.010362694300518135,0.0051813471502590676,0.9948186528497409,193,6100,4300,1800,0.7049180327868853,79,43,36,190.33204765465265,0.4783233484455958,0.7503126675004472,0.10811645181207535,1041155.6927297617,-5066.941015089472,1036088.7517146722,1857,0,323.86528497409324,80,113,42,40.05217785843919,0.5333009499136443,44.90740740740739,8162.962962962923,102.03703703703653,0
1896,32,4,3,193,0.02040816326530612,0.015306122448979591,0.9846938775510204,196,6350,4700,1650,0.7401574803149606,80,47,33,185.67157521502565,0.4787774725274725,0.7476875859010095,0.10636304347162667,1043780.3729272503,-6789.93079601391,1036990.4421312364,1858,0,319.8673469387755,75,121,42,39.84376397459978,0.5361394557823129,44.58607456140352,8173.245614035115,108.97660818713487,0
1897,32,3,1,195,0.015306122448979591,0.00510204081632653,0.9948979591836735,196,5700,3500,2200,0.6140350877192983,79,35,44,229.80114991808816,0.478495115995116,0.7899899163729867,0.13036783517675654,1040752.4688718583,2933.222825368014,1043685.6916972264,1859,0,320.80102040816325,81,115,40,39.09588708472379,0.531781462585034,44.9568089430894,8161.382113821057,100.75780387433403,8
1898,32,2,2,195,0.01015228426395939,0.01015228426395939,0.9898477157360406,197,6400,4400,2000,0.6875,84,44,40,222.9416458430463,0.4789767429814566,0.7847358681750671,0.1271270945597827,1042350.9137110765,676.6856497503286,1043027.5993608268,1860,0,318.56345177664974,67,130,42,39.07068979314207,0.5339467005076142,44.76102941176472,8167.64705882356,121.9051799824412,0
1899,32,2,4,193,0.01015228426395939,0.02030456852791878,0.9796954314720813,197,5500,3800,1700,0.6909090909090909,72,38,34,231.9633354610238,0.47889257225732934,0.7963870375672844,0.13444988404218325,1047408.8660178784,3692.0908305911917,1051100.9568484696,1861,0,319.4162436548223,68,129,36,38.207556447171726,0.5375951776649746,44.14251207729469,8187.439613526583,120.4035237283321,8
1900,32,6,7,192,0.03015075376884422,0.035175879396984924,0.964824120603015,199,6150,4900,1250,0.7967479674796748,74,49,25,232.29806425578101,0.4786633081231071,0.8002986493698907,0.13660394700092493,1051845.5924036263,2918.3390022673857,1054763.9314058938,1862,0,317.1507537688442,62,137,40,37.645095763203685,0.541247906197655,43.60119047619047,8204.76190476189,132.3348694316434,0
1901,32,1,1,192,0.0051813471502590676,0.0051813471502590676,0.9948186528497409,193,5700,4100,1600,0.7192982456140351,73,41,32,230.6990646499527,0.4778893206678181,0.7929197022697991,0.13607100519772636,1052761.5017361096,4274.2187499999145,1057035.7204861096,1863,0,324.94300518134713,63,130,38,37.571912013536405,0.5425841968911918,43.48958333333333,8208.333333333321,130.2910052910051,0
1902,32,1,1,192,0.0051813471502590676,0.0051813471502590676,0.9948186528497409,193,5650,4300,1350,0.7610619469026548,70,43,27,227.28419988186974,0.4775969703511802,0.7904469031369035,0.13482876715092984,1054511.162764005,3684.7451790634027,1058195.9079430683,1864,0,325.19170984455957,65,128,41,37.44159596704783,0.5446891191709844,43.276515151515156,8215.151515151523,126.3869463869465,0
1903,32,2,1,193,0.010309278350515464,0.005154639175257732,0.9948453608247423,194,5800,4300,1500,0.7413793103448276,73,43,30,212.56984574167097,0.47745457418585185,0.7758269402572346,0.12315769672792114,1047280.2563966035,-75.95948989507633,1047204.2969067085,1865,0,323.32474226804123,73,121,37,38.71979596515362,0.5360287800687284,44.158220720720735,8186.936936936971,112.1498210539311,8
1904,32,1,1,193,0.005154639175257732,0.005154639175257732,0.9948453608247423,194,5800,3800,2000,0.6551724137931034,78,38,40,215.8379335798495,0.4774473407759557,0.7789856868539649,0.1256454288833799,1048740.0237298855,671.5759168685072,1049411.5996467539,1866,0,324.28350515463916,76,118,39,38.45409511228532,0.5378006872852233,43.97997835497838,8192.640692640754,107.79790385053624,0
1905,32,1,3,191,0.005154639175257732,0.015463917525773196,0.9845360824742269,194,6150,4000,2150,0.6504065040650406,83,40,43,220.30020822819083,0.4772242179014654,0.7838513898332298,0.1266032944908585,1044768.7557238708,1082.5548872554468,1045851.3106111262,1867,0,325.2680412371134,66,128,46,38.83573659446742,0.5346327319587629,44.465174129353244,8177.114427860717,123.8956731494048,8
1906,32,1,3,189,0.005208333333333333,0.015625,0.984375,192,6350,4400,1950,0.6929133858267716,83,44,39,211.72614239174752,0.47693233256980805,0.7773243721579157,0.12050953845779741,1041777.670957293,-635.6864996704389,1041141.9844576225,1868,0,329.34375,78,114,39,39.42863356070001,0.5306532118055556,44.831223628691994,8165.400843881884,104.68462620361389,8
1907,32,6,0,195,0.03076923076923077,0.0,1.0,195,5650,3600,2050,0.6371681415929203,77,36,41,202.09238450340214,0.4778196316856111,0.7713810944846387,0.11645175517460464,1045599.6310804638,-2388.4554638141867,1043211.1756166496,1869,0,323.83076923076925,72,123,42,39.19736719694855,0.5343482905982906,44.363584474885855,8180.365296803673,113.6161846778288,0
1908,32,4,3,196,0.020100502512562814,0.01507537688442211,0.9849246231155779,199,5300,3400,1900,0.6415094339622641,72,34,38,198.25657016398233,0.4782773294079827,0.7713626093267101,0.11510504846882286,1047923.6795429904,-3548.4491000371518,1044375.2304429533,1870,0,318.30150753768845,78,121,40,39.00585209610664,0.5367462311557789,44.079641350210984,8189.451476793281,104.99296765119591,0
1909,32,3,5,194,0.01507537688442211,0.02512562814070352,0.9748743718592965,199,7100,5300,1800,0.7464788732394366,89,53,36,211.4565881353722,0.4781789841463208,0.7860613247770023,0.12328854736912206,1049223.104780817,-2526.9724140495355,1046696.1323667674,1871,0,317.7286432160804,66,133,43,38.50606115799482,0.5369556113902847,43.92101990049749,8194.527363184037,124.15950550278845,8
1910,32,1,1,194,0.005128205128205128,0.005128205128205128,0.9948717948717949,195,6550,4600,1950,0.7022900763358778,85,46,39,208.62243945456214,0.4773845713278703,0.7783764511080102,0.12209448422147612,1050377.430045035,-1723.5396391985387,1048653.8904058365,1872,0,323.3692307692308,68,127,44,38.43487312436169,0.5396901709401709,43.78019323671495,8199.033816425064,120.5740267121333,0
1911,32,3,1,196,0.015228426395939087,0.005076142131979695,0.9949238578680203,197,6100,4200,1900,0.6885245901639344,80,42,38,201.54296127977065,0.47762569494803,0.7727407520175336,0.11881013242293628,1052597.0784023637,-3071.293556870644,1049525.784845493,1873,0,319.8020304568528,64,133,47,38.34023221909818,0.5420368020304569,43.50961538461537,8207.692307692281,128.2451923076919,0
1912,32,1,3,194,0.005076142131979695,0.015228426395939087,0.9847715736040609,197,6100,4000,2100,0.6557377049180327,82,40,42,230.08352131366482,0.4773785783348872,0.7935127826317034,0.13125717073036677,1042487.4096074376,2471.834825528018,1044959.2444329655,1874,0,320.43147208121826,65,132,41,38.87130557101343,0.5344754653130288,44.74431818181818,8168.181818181814,125.66433566433561,8
1913,32,1,5,190,0.005128205128205128,0.02564102564102564,0.9743589743589743,195,5500,3200,2300,0.5818181818181818,78,32,46,224.5940178336619,0.4770376244603049,0.7861521546918848,0.1287420160665628,1043978.0710844388,2394.2459030180953,1046372.3169874569,1875,0,319.4769230769231,67,128,40,38.82490004997501,0.5368055555555555,44.56188725490196,8174.019607843138,122.0002926543752,0
1914,32,4,1,193,0.020618556701030927,0.005154639175257732,0.9948453608247423,194,6300,4500,1800,0.7142857142857143,81,45,36,225.13474489309323,0.47713018357281484,0.7819060846358206,0.13024270771895657,1046819.330944128,2035.0806042533895,1048854.4115483814,1876,0,321.1855670103093,73,121,46,38.455907306514035,0.5397336769759451,44.21452702702705,8185.1351351352005,112.1251388374685,0
1915,32,2,5,190,0.010256410256410256,0.02564102564102564,0.9743589743589743,195,6200,4200,2000,0.6774193548387096,82,42,40,245.7155335423849,0.47710040532205483,0.800587398114561,0.14323567279789093,1049164.433407401,6359.199705679004,1055523.63311308,1877,0,320.4974358974359,75,120,37,37.63609743260364,0.5367521367521367,43.928179824561425,8194.298245614085,109.25730994152114,8
1916,32,2,0,192,0.010416666666666666,0.0,1.0,192,5800,4200,1600,0.7241379310344828,74,42,32,249.77691905774887,0.4770629953824898,0.7946870129480865,0.14358299668233546,1044854.7583861997,7996.1204825068235,1052850.8788687065,1878,0,326.109375,67,125,38,38.0717240139072,0.5332573784722222,44.454656862745104,8177.450980392174,122.05150717003244,8
1917,32,4,1,195,0.02040816326530612,0.00510204081632653,0.9948979591836735,196,6100,4500,1600,0.7377049180327869,77,45,32,233.99154488542266,0.47762406244549105,0.7828896005740726,0.13598959888658071,1048234.69444445,3755.6111111114114,1051990.3055555613,1879,0,320.43367346938777,74,122,36,38.052458082370194,0.5361394557823129,44.041666666666686,8190.666666666711,110.68468468468528,0
1918,32,2,3,194,0.01015228426395939,0.015228426395939087,0.9847715736040609,197,5950,3900,2050,0.6554621848739496,80,39,41,233.67830504884068,0.47785015021236926,0.786143351755068,0.13652263826287614,1049848.6283287462,3715.3696051425404,1053563.9979338888,1880,0,319.79695431472084,76,121,40,37.85890326555762,0.5375951776649746,43.84469696969698,8196.96969696973,107.85486443381224,0
1919,32,4,1,197,0.020202020202020204,0.005050505050505051,0.9949494949494949,198,5400,3700,1700,0.6851851851851852,71,37,34,261.62532218323986,0.47833613204806097,0.8157506285634746,0.1457653868578329,1035090.9172825475,9161.198944598165,1044252.1162271457,1881,0,318.87373737373736,62,136,37,38.99705302390082,0.5216224747474747,45.65145502645501,8139.1534391534115,131.2766683734421,8
1920,32,9,0,206,0.043689320388349516,0.0,1.0,206,4750,3500,1250,0.7368421052631579,60,35,25,225.21939885251072,0.47968713000236796,0.7924377990243114,0.12574870621056794,1035760.1142850848,704.6540589389242,1036464.7683440237,1882,0,307.1116504854369,70,136,39,39.838974743397515,0.5243224110032363,45.56924882629108,8141.7840375586875,116.31120053655268,8
1921,32,4,3,207,0.01904761904761905,0.014285714285714285,0.9857142857142858,210,6450,4500,1950,0.6976744186046512,84,45,39,218.43781277567007,0.4806818181818182,0.7909395150384604,0.12331884791371989,1039230.1991388805,-3048.56566593593,1036181.6334729445,1883,0,302.24285714285713,76,134,37,39.57636640302919,0.527281746031746,45.14339826839826,8155.411255411225,107.30804283435823,0
1922,32,2,3,206,0.009569377990430622,0.014354066985645933,0.9856459330143541,209,6150,4700,1450,0.7642276422764228,76,47,29,215.96722450662344,0.48077977395411603,0.7870104711277626,0.1225261288783802,1040768.7073595524,-2995.6141836425104,1037773.0931759098,1884,0,303.27272727272725,82,127,41,39.44667929665712,0.529505582137161,44.95481927710841,8161.44578313248,99.52982662356683,0
1923,32,2,7,201,0.009615384615384616,0.03365384615384615,0.9663461538461539,208,6950,4800,2150,0.6906474820143885,91,48,43,232.27523522540054,0.48078713381023164,0.8025600656375536,0.13221061632112832,1041789.4880073036,-153.62032355088104,1041635.8676837527,1885,0,304.1057692307692,81,127,38,38.90280405237219,0.5298978365384616,44.829776422764226,8165.447154471542,100.80798956137706,8
1924,32,5,1,205,0.024271844660194174,0.0048543689320388345,0.9951456310679612,206,6500,4800,1700,0.7384615384615385,82,48,34,188.31186177961968,0.4805558844423396,0.7607044067174522,0.1061240456240978,1038678.634677009,-8580.898502651922,1030097.736174357,1886,0,305.97087378640776,76,130,48,40.413060599624785,0.5249797734627832,45.21103896103895,8153.246753246734,107.27956254272019,8
1925,32,5,4,206,0.023809523809523808,0.01904761904761905,0.9809523809523809,210,6750,4700,2050,0.6962962962962963,88,47,41,186.2797813080278,0.48094146350725303,0.7625920444931753,0.10655752550045756,1043332.3264129467,-9879.656480839687,1033452.669932107,1887,0,300.73809523809524,75,135,42,39.88407537616517,0.5288194444444445,44.640899122807056,8171.49122807027,108.95321637427027,0
1926,32,2,5,203,0.009615384615384616,0.02403846153846154,0.9759615384615384,208,6900,4600,2300,0.6666666666666666,92,46,46,187.15126712786778,0.480736327883067,0.7627008653286473,0.10793322543331127,1045860.39253857,-9353.180459510997,1036507.212079059,1888,0,303.38461538461536,76,132,43,39.546845512108234,0.5313501602564102,44.33170995670999,8181.3852813853755,107.6498063340181,0
1927,32,4,4,203,0.01932367149758454,0.01932367149758454,0.9806763285024155,207,6600,4300,2300,0.6515151515151515,89,43,46,228.9221891307348,0.4810114832012257,0.8049970340532362,0.1318613935113761,1045481.188875671,-133.23150951571643,1045347.9573661553,1889,0,302.77294685990336,67,140,40,38.52631040131033,0.5334641706924316,44.378063725490186,8179.901960784299,122.08808896692985,8
1928,32,0,2,201,0.0,0.009852216748768473,0.9901477832512315,203,5600,4100,1500,0.7321428571428571,71,41,30,230.85290259809975,0.4804053065405063,0.8031121140391182,0.13337817769480914,1046420.2781861875,2113.8317113583676,1048534.1098975459,1890,1,309.6453201970443,68,135,41,38.3595287288469,0.5348932676518883,44.263285024154584,8183.574879227043,120.3466894003977,0
1929,32,6,7,200,0.028985507246376812,0.033816425120772944,0.966183574879227,207,6600,4700,1900,0.7121212121212122,85,47,38,227.7083746447216,0.4804310695245689,0.8055064608617093,0.13337204800619437,1050625.0000000023,-152.77777777772826,1050472.2222222246,1891,0,304.55555555555554,75,132,39,37.91497289972899,0.5392512077294687,43.75000000000001,8200.000000000018,109.33333333333357,0
1930,32,4,4,200,0.0196078431372549,0.0196078431372549,0.9803921568627451,204,7100,5100,2000,0.7183098591549296,91,51,40,217.13148004852633,0.4800294399368943,0.7949061356516123,0.12923832183080008,1055529.6077530265,-2062.258806709048,1053467.3489463176,1892,0,308.5833333333333,67,137,41,37.575607343790374,0.5435559640522876,43.15257352941176,8219.117647058814,122.67339771729574,8
1931,32,1,4,197,0.004975124378109453,0.01990049751243781,0.9800995024875622,201,5750,4100,1650,0.7130434782608696,74,41,33,212.92144508523623,0.48,0.7880361113491641,0.12268547300055356,1045583.713556011,-1424.56095041344,1044159.1526055975,1893,0,312.30845771144277,65,136,42,38.92252423288263,0.5343076285240465,44.36553030303029,8180.303030303001,125.8508158508154,8
1932,32,3,5,195,0.015,0.025,0.975,200,5850,3900,1950,0.6666666666666666,78,39,39,206.51567833548282,0.479742985762144,0.7800345153106385,0.1197480065722916,1047532.472315568,-2583.624180261191,1044948.8481353068,1894,0,313.23,68,132,42,38.84324542254216,0.5372395833333333,44.12741545893718,8187.9227053139675,120.41062801932306,0
1933,32,4,2,197,0.020100502512562814,0.010050251256281407,0.9899497487437185,199,5900,4100,1800,0.6949152542372882,77,41,36,201.87983586620427,0.47943843798115154,0.7740478959735191,0.11815366143460017,1050390.9947665723,-3289.447676237447,1047101.5470903348,1895,0,315.06532663316585,72,127,47,38.60594415979801,0.5400963149078727,43.77853881278536,8199.086757990797,113.8762049720944,0
1934,32,0,3,194,0.0,0.015228426395939087,0.9847715736040609,197,6400,4700,1700,0.734375,81,47,34,219.96978351359238,0.479114869297973,0.7846779626268923,0.1295093706624439,1052211.9083049872,490.96513605425207,1052702.8734410414,1896,1,317.46700507614213,69,128,39,37.91556654867598,0.5455266497461929,43.55654761904761,8206.190476190464,118.93029675638354,8
1935,32,2,2,194,0.01020408163265306,0.01020408163265306,0.9897959183673469,196,5700,3600,2100,0.631578947368421,78,36,42,218.16415347090972,0.47894863073434507,0.7811115985383401,0.12909767836647992,1053755.2624038423,1078.3249575700602,1054833.5873614124,1897,0,319.9540816326531,70,126,36,37.76976617882458,0.5470875850340136,43.36854460093896,8212.20657276994,117.31723675385628,0
1936,32,4,3,195,0.020202020202020204,0.015151515151515152,0.9848484848484849,198,7200,5300,1900,0.7361111111111112,91,53,38,204.670491063684,0.47926173751046847,0.7676520454824578,0.12239643247462804,1056957.5655675498,-3534.3952043626778,1053423.170363187,1898,0,317.6313131313131,76,122,34,37.71843254908153,0.5502946127946128,42.978896103896105,8224.675324675327,108.21941216678061,0
1937,32,1,5,191,0.00510204081632653,0.025510204081632654,0.9744897959183674,196,6950,5500,1450,0.7913669064748201,84,55,29,222.46104327970343,0.4791083420547706,0.7889794096819798,0.12872293937482177,1046884.04380643,428.1833156108878,1047312.2271220408,1899,0,321.64285714285717,72,124,47,38.51621480902971,0.5368303571428572,44.20662100456622,8185.388127853912,113.68594622019322,7
1938,32,1,3,189,0.005208333333333333,0.015625,0.984375,192,6550,4800,1750,0.732824427480916,83,48,35,227.58796627622343,0.47850028632198954,0.789581069219194,0.1325417357641764,1048870.5960311498,2792.0651675319073,1051662.6611986817,1900,0,329.1302083333333,72,120,40,38.136970777833504,0.53857421875,43.96404109589041,8193.150684931503,113.79375951293754,0
1939,32,1,2,188,0.005263157894736842,0.010526315789473684,0.9894736842105263,190,6500,4300,2200,0.6615384615384615,87,43,44,229.13980938268892,0.47851051239209136,0.7888365757517048,0.1339580915822533,1050047.939620361,3621.556945458841,1053669.4965658197,1901,0,331.86315789473684,73,117,42,37.95028801948824,0.5400767543859649,43.820382882882875,8197.747747747728,112.2979143527086,0
1940,32,4,1,191,0.020833333333333332,0.005208333333333333,0.9947916666666666,192,5900,4100,1800,0.6949152542372882,77,41,36,215.79733876169186,0.4785548238438045,0.7780905271100014,0.12776319335558228,1053912.8246219617,1186.3165680475472,1055099.1411900092,1902,0,319.8177083333333,64,128,42,37.81090644187742,0.5431315104166667,43.349358974358985,8212.820512820534,128.32532051282084,0
1941,32,0,3,188,0.0,0.015706806282722512,0.9842931937172775,191,5850,4000,1850,0.6837606837606838,77,40,37,214.9138396089736,0.4785811059061266,0.7766816813144226,0.12759920958973692,1054770.4953576191,1286.9554127131269,1056057.4507703322,1903,1,321.9947643979058,65,126,45,37.72692812064584,0.5444480802792322,43.2449494949495,8216.161616161635,126.40248640248669,0
1942,32,0,2,186,0.0,0.010638297872340425,0.9893617021276596,188,5400,4100,1300,0.7592592592592593,67,41,26,215.8775247699242,0.4785468104069481,0.7745598223195032,0.12873966426643796,1056114.1161419265,2598.2602534590283,1058712.3763953855,1904,2,327.8776595744681,66,122,41,37.53517397881996,0.5456560283687943,43.08146766169154,8221.393034825865,124.56656113372523,0
1943,32,1,2,185,0.0053475935828877,0.0106951871657754,0.9893048128342246,187,5100,3500,1600,0.6862745098039216,67,35,32,224.08602746945814,0.4781520134935695,0.7831611574116781,0.12916400856744184,1045692.6515367327,4365.022447374327,1050057.673984107,1905,0,324.0053475935829,63,124,41,38.623503851785834,0.5374331550802138,44.35221354166668,8180.7291666666915,129.85284391534432,8
1944,32,1,1,185,0.005376344086021506,0.005376344086021506,0.9946236559139785,186,6450,4400,2050,0.6821705426356589,85,44,41,220.45617632918,0.4778570909619297,0.7790724463089549,0.12812529566206193,1048239.7132413049,2568.1838115149767,1050807.8970528198,1906,0,326.59139784946234,67,119,38,38.398280866598846,0.5398185483870968,44.04105392156864,8190.6862745098315,122.24904887328107,0
1945,32,1,4,182,0.005376344086021506,0.021505376344086023,0.978494623655914,186,6250,4200,2050,0.672,83,42,41,210.53110377522083,0.4776609270560883,0.7696258765242034,0.12168362735443077,1046538.6056558392,615.78555842067,1047154.3912142599,1907,0,327.4623655913978,70,116,46,38.86446860180511,0.540714605734767,44.248826291079794,8184.037558685406,116.91482226693438,8
1946,32,2,0,184,0.010869565217391304,0.0,1.0,184,5850,4200,1650,0.717948717948718,75,42,33,212.4980326469117,0.4780709244080146,0.7684916324116959,0.12081701530564082,1041437.9210706315,1610.7018702797236,1043048.6229409112,1908,0,316.4782608695652,76,108,37,39.451433444686,0.5359488224637681,44.872835497835496,8164.069264069259,107.4219640009113,8
1947,32,2,0,186,0.010752688172043012,0.0,1.0,186,6250,4600,1650,0.736,79,46,33,224.44736325434312,0.4788258016080597,0.7782248542603214,0.12438386967561199,1033401.9310233863,2938.867720029033,1036340.7987434154,1909,0,314.06451612903226,80,106,38,40.15492696420741,0.5266017025089607,45.859053497942384,8132.510288065836,101.65637860082295,8
1948,32,3,2,187,0.015873015873015872,0.010582010582010581,0.9894179894179894,189,7250,5800,1450,0.8,87,58,29,238.53226328809887,0.4788031445832864,0.7914889903853888,0.13363275007203018,1036822.7771719731,4413.136733496635,1041235.9139054698,1910,0,310.06349206349205,65,124,39,39.36665581664499,0.5283840388007055,45.43876262626263,8145.959595959604,125.32245532245544,8
1949,32,2,2,187,0.010582010582010581,0.010582010582010581,0.9894179894179894,189,6500,4700,1800,0.7230769230769231,83,47,36,227.31536335242163,0.4787234042553192,0.7810938209113962,0.1271761419501628,1036396.7155612273,2817.7791950114715,1039214.4947562388,1911,0,310.46031746031747,69,120,40,39.70569247110644,0.5268408289241622,45.49107142857144,8144.2857142857365,118.03312629399618,8
1950,32,1,1,187,0.005319148936170213,0.005319148936170213,0.9946808510638298,188,6550,4600,1950,0.7022900763358778,85,46,39,227.5976473459013,0.4785314028899761,0.7804934769093725,0.12822638952436166,1038587.4567901234,3126.0123456789906,1041713.4691358024,1912,0,312.54787234042556,74,114,42,39.4235399403983,0.5291445035460993,45.22222222222222,8152.888888888889,110.17417417417417,0
1951,32,3,3,187,0.015789473684210527,0.015789473684210527,0.9842105263157894,190,6950,5000,1950,0.7194244604316546,89,50,39,219.58776216029702,0.47933433119836627,0.774769559882972,0.12453231393022893,1040648.7953599001,752.7480335776299,1041401.5433934777,1913,0,310.18947368421055,81,109,41,39.36935478514977,0.5317434210526315,44.969512195121936,8160.975609756059,100.75278530563037,0
1952,32,1,5,183,0.005319148936170213,0.026595744680851064,0.973404255319149,188,6500,4800,1700,0.7384615384615385,82,48,34,219.69964476003304,0.47896992452687076,0.7717982249911828,0.12533581453215714,1042493.359631827,1707.084155161454,1044200.4437869884,1914,0,312.6648936170213,64,124,45,39.135615477984274,0.5343528368794326,44.743589743589766,8168.205128205175,127.62820512820586,0
1953,32,6,1,188,0.031746031746031744,0.005291005291005291,0.9947089947089947,189,5900,3900,2000,0.6610169491525424,79,39,40,208.68504776402858,0.4797916901197043,0.7599004299615288,0.1205463040613396,1046358.5069444514,-28.124999999594365,1046330.3819444517,1915,0,306.41269841269843,71,118,47,38.93414799728448,0.5378637566137566,44.27083333333336,8183.3333333333885,115.2582159624421,0
1954,32,2,2,188,0.010526315789473684,0.010526315789473684,0.9894736842105263,190,5900,4400,1500,0.7457627118644068,74,44,30,223.35122716422688,0.4803623642439432,0.7774956603438483,0.12721188617221135,1041987.2716049472,2645.827160494304,1044633.0987654414,1916,0,305.2631578947368,74,116,43,39.10575632233956,0.5311951754385965,44.805555555555586,8166.222222222294,110.35435435435532,8
1955,32,3,4,187,0.015706806282722512,0.020942408376963352,0.9790575916230366,191,6950,4700,2250,0.6762589928057554,92,47,45,216.89032647131282,0.4804227519059429,0.7779128861599176,0.12314522103454507,1041010.3458981714,7.014756373991986,1041017.3606545454,1917,0,304.4083769633508,77,114,43,39.39288830715533,0.5315772251308901,44.92521367521369,8162.393162393202,106.00510600510653,8
1956,32,2,1,188,0.010582010582010581,0.005291005291005291,0.9947089947089947,189,5300,3600,1700,0.6792452830188679,70,36,34,216.6577059788895,0.47990426470036396,0.7768683095959199,0.1239061514680964,1043261.0551538087,2106.109389347931,1045367.1645431566,1918,0,308.55555555555554,65,124,44,39.117258483218976,0.5336199294532629,44.649621212121204,8171.212121212104,125.71095571095545,0
1957,32,3,4,187,0.015706806282722512,0.020942408376963352,0.9790575916230366,191,6400,4100,2300,0.640625,87,41,46,211.6330172611964,0.4798337466703408,0.7737971872235831,0.12215284298283977,1046114.969529479,-321.5065192743082,1045793.4630102047,1919,0,306.26701570680626,69,122,45,38.88915158392987,0.5359947643979057,44.30059523809524,8182.380952380957,118.58523119392692,0
1958,32,2,3,186,0.010582010582010581,0.015873015873015872,0.9841269841269842,189,6450,4800,1650,0.7441860465116279,81,48,33,220.23126403980865,0.47966387106458025,0.7815637978050982,0.12665084629076143,1044981.9567718562,1777.5394477315149,1046759.4962195877,1920,0,302.56613756613757,64,125,40,38.81085261595703,0.5354387125220459,44.43910256410255,8177.948717948682,127.78044871794816,8
1959,32,2,1,187,0.010638297872340425,0.005319148936170213,0.9946808510638298,188,4950,3400,1550,0.6868686868686869,65,34,31,228.85528230288645,0.47955541017180564,0.7822610237905936,0.12706325028640061,1033990.4991522493,4776.837516398114,1038767.3366686475,1921,0,305.1276595744681,66,122,40,39.96888569506453,0.5209441489361701,45.78669154228856,8134.825870646771,123.25493743404199,8
1960,32,5,2,190,0.026041666666666668,0.010416666666666666,0.9895833333333334,192,5750,4400,1350,0.7652173913043478,71,44,27,214.83093449209866,0.4801182328025015,0.7824970103222553,0.12052379545234736,1037263.9053254483,417.2748191981691,1037681.1801446464,1922,0,299.734375,64,128,40,39.914689283316534,0.5238172743055556,45.3846153846154,8147.692307692344,127.30769230769288,8
1961,32,2,1,191,0.010416666666666666,0.005208333333333333,0.9947916666666666,192,7300,5100,2200,0.6986301369863014,95,51,44,206.45865711195188,0.4800108620564281,0.7734096845269356,0.116856827627984,1040035.7461734704,-2755.123299319601,1037280.6228741508,1923,0,300.6666666666667,69,123,39,39.780868791221614,0.5266927083333333,45.04464285714286,8158.571428571437,118.24016563147009,0
1962,32,3,1,193,0.015463917525773196,0.005154639175257732,0.9948453608247423,194,5750,4400,1350,0.7652173913043478,71,44,27,203.16161347056897,0.48020605202713534,0.7725020187799905,0.11589671195134814,1042481.6372119493,-2191.5497141160467,1040290.0874978333,1924,0,298.4742268041237,66,128,43,39.559223616356036,0.5289948453608248,44.74502487562189,8168.159203980093,123.75998793909231,0
1963,32,5,2,196,0.025252525252525252,0.010101010101010102,0.98989898989899,198,6700,5000,1700,0.746268656716418,84,50,34,197.0766635400418,0.4809527166760669,0.7702234472796752,0.113928098693946,1046595.3066057988,-5048.0977794923,1041547.2088263065,1925,0,292.449494949495,71,127,46,39.2015028095184,0.5329335016835017,44.24189814814816,8184.259259259285,115.27125717266598,0
1964,32,2,1,197,0.010101010101010102,0.005050505050505051,0.9949494949494949,198,6600,5000,1600,0.7575757575757576,82,50,32,226.78606815451977,0.4807481541301338,0.7913083825983114,0.13110568965259786,1046602.0727040824,1270.9537981859503,1047873.0265022683,1926,0,293.2676767676768,69,129,40,38.44081524795871,0.5314078282828283,44.24107142857143,8184.28571428572,118.61283643892348,8
1965,32,3,6,194,0.015,0.03,0.97,200,5800,3800,2000,0.6551724137931034,78,38,40,222.548949943456,0.48097780569514237,0.7889351281914032,0.12973110863630613,1049164.4334074012,898.0885945679174,1050062.5220019692,1927,0,291.315,75,125,39,38.22932835554607,0.5338541666666667,43.928179824561425,8194.298245614087,109.25730994152116,0
1966,32,5,2,197,0.02512562814070352,0.010050251256281407,0.9899497487437185,199,6050,4100,1950,0.6776859504132231,80,41,39,226.55721787566608,0.4807391333773243,0.7938876422833008,0.13384856586241745,1053264.5234104677,1874.9360222029304,1055139.4594326706,1928,0,293.42713567839195,67,132,43,37.615491969669826,0.5379501675041876,43.42830882352941,8210.294117647063,122.54170324846363,0
1967,32,1,2,196,0.005050505050505051,0.010101010101010102,0.98989898989899,198,6650,4700,1950,0.706766917293233,86,47,39,206.08525306225474,0.48087313490232275,0.7747758321757972,0.11829748277585585,1044411.0012755096,-3202.45890022681,1041208.5423752827,1929,0,294.5,69,129,39,39.2436343603782,0.5331965488215489,44.50892857142857,8175.714285714281,118.48861283643885,8
1968,32,5,6,195,0.024875621890547265,0.029850746268656716,0.9701492537313433,201,6300,4100,2200,0.6507936507936508,85,41,44,209.73109965475368,0.4810313018242123,0.779238255398832,0.12195856999592104,1048407.5565487965,-2523.2660557332783,1045884.2904930632,1930,0,290.94029850746267,76,125,37,38.6518778846493,0.5365360696517413,44.02056277056279,8191.341991342039,107.78081567555314,0
1969,32,2,3,194,0.01015228426395939,0.015228426395939087,0.9847715736040609,197,6750,5300,1450,0.7851851851851852,82,53,29,222.75381057635553,0.4805403760488967,0.7915544029639054,0.12459339528930592,1036319.2870423953,18.814032493122795,1036338.1010748885,1931,0,297.6700507614213,71,126,39,39.831507115380944,0.5260152284263959,45.5005787037037,8143.981481481481,114.70396452790818,8
1970,32,2,1,195,0.01020408163265306,0.00510204081632653,0.9948979591836735,196,5850,4000,1850,0.6837606837606838,77,40,37,220.8718754393869,0.48059916274201986,0.7894692963923127,0.12514205498103523,1040353.425178793,906.9624278060155,1041260.387606599,1932,0,299.21938775510205,72,124,37,39.37360100727479,0.5298681972789115,45.00570776255709,8159.817351598189,113.33079654997485,8
1971,32,3,1,197,0.015151515151515152,0.005050505050505051,0.9949494949494949,198,6100,4300,1800,0.7049180327868853,79,43,36,216.6415296325038,0.4809292160180485,0.788497420806292,0.12359363802206441,1042499.4956122492,-530.262925889806,1041969.2326863594,1933,0,293.04545454545456,63,135,42,39.21290835086825,0.5329335016835017,44.742838541666664,8168.229166666657,129.65443121693107,0
1972,32,1,3,195,0.005050505050505051,0.015151515151515152,0.9848484848484849,198,6500,4100,2400,0.6307692307692307,89,41,48,235.19944024301927,0.4808528388794886,0.7966504768032485,0.1347685813380623,1043856.8349150354,3002.9086531731537,1046859.7435682085,1934,0,294.010101010101,62,136,42,38.56917831866044,0.5349852693602694,44.576719576719576,8173.544973544969,131.8313705410479,8
1973,32,1,0,196,0.00510204081632653,0.0,1.0,196,7250,5100,2150,0.7034482758620689,94,51,43,234.0774755966989,0.48075996424210715,0.7936136914632479,0.13481930280100052,1045454.6092235484,2493.4751555962357,1047948.0843791447,1935,0,297.90816326530614,65,131,41,38.39785543755658,0.5373618197278911,44.38131313131313,8179.797979797979,125.84304584304583,0
1974,32,1,3,194,0.005076142131979695,0.015228426395939087,0.9847715736040609,197,6850,5100,1750,0.7445255474452555,86,51,35,232.4604516856005,0.48036448081770783,0.7943075972552431,0.13477219453330713,1047487.0279760167,2449.861531622335,1049936.889507639,1936,0,297.39086294416245,67,130,38,38.185069049472126,0.5393401015228426,44.1329656862745,8187.7450980392,122.20515071700298,0
1975,32,3,2,195,0.015228426395939087,0.01015228426395939,0.9898477157360406,197,5950,4400,1550,0.7394957983193278,75,44,31,272.1150207516615,0.48052203114748443,0.8242661595763079,0.15376688541425185,1039524.4267166577,11224.042189572254,1050748.46890623,1937,0,293.11675126903555,65,132,33,38.171310629514956,0.5294521996615905,45.10732323232322,8156.565656565625,125.48562548562501,8
1976,32,6,4,197,0.029850746268656716,0.01990049751243781,0.9800995024875622,201,6050,4200,1850,0.6942148760330579,79,42,37,264.9509993859671,0.4806343283582089,0.8254489000453522,0.15248665414230628,1045222.2415123419,9136.535493826907,1054358.7770061688,1938,0,287.93532338308455,59,142,38,37.63783226916634,0.5335820895522387,44.40972222222221,8178.888888888859,138.6252354048959,0
1977,32,1,4,194,0.005050505050505051,0.020202020202020204,0.9797979797979798,198,5600,3600,2000,0.6428571428571429,76,36,40,244.98995829764792,0.4805126134440855,0.8091437004480477,0.13885872327108423,1040469.8641865315,5780.933727403791,1046250.7979139353,1939,0,292.3989898989899,72,126,36,38.743984667897735,0.530513468013468,44.9914383561644,8160.273972602779,113.33713850837194,8
1978,32,1,3,192,0.005128205128205128,0.015384615384615385,0.9846153846153847,195,6150,4400,1750,0.7154471544715447,79,44,35,238.89156005581845,0.480305533527183,0.8009295081143524,0.1359639325076061,1041760.4444444518,4623.555555555877,1046384.0000000077,1940,0,296.95384615384614,74,121,39,38.73761702590901,0.5325854700854701,44.83333333333336,8165.333333333392,110.34234234234313,0
1979,32,3,2,193,0.015384615384615385,0.010256410256410256,0.9897435897435898,195,6250,4300,1950,0.688,82,43,39,231.56265097688467,0.48032756189972686,0.7949100818666035,0.13271762293853204,1043933.7647929031,3097.214003944995,1047030.9787968481,1941,0,297.36410256410255,64,131,40,38.6524405546145,0.5346153846153846,44.56730769230771,8173.846153846183,127.71634615384662,0
1980,32,3,2,194,0.015306122448979591,0.01020408163265306,0.9897959183673469,196,5800,4000,1800,0.6896551724137931,76,40,36,245.94042607203477,0.4810123408337694,0.8030515647476861,0.1374207512941452,1035995.2969021237,5958.624945746383,1041953.9218478701,1942,0,296.7244897959184,63,133,39,39.28217346808239,0.5285926870748299,45.54036458333332,8142.708333333309,129.24933862433824,8
1981,32,5,5,194,0.02512562814070352,0.02512562814070352,0.9748743718592965,199,5750,4200,1550,0.7304347826086957,73,42,31,232.7104177796165,0.4811367443276991,0.7929174479811782,0.1333406703112486,1043852.8600778574,3033.0870338332943,1046885.9471116906,1943,0,293.1959798994975,67,132,40,38.63325136939744,0.538787688442211,44.57720588235295,8173.529411764727,121.99297629499593,8
1982,32,0,1,193,0.0,0.005154639175257732,0.9948453608247423,194,6700,4500,2200,0.6716417910447762,89,45,44,236.83185873575974,0.4803768717839147,0.792925174921393,0.135725453320805,1043905.9789817357,3946.0386695234643,1047852.0176512591,1944,1,301.47938144329896,65,129,42,38.52132764870653,0.5398947594501718,44.570707070707066,8173.737373737366,125.74980574980563,0
1983,32,2,1,194,0.010256410256410256,0.005128205128205128,0.9948717948717949,195,5300,3600,1700,0.6792452830188679,70,36,34,222.16574593154297,0.48038263283108645,0.7798428795213344,0.12761341131740697,1044618.3517379786,2115.68306552976,1046734.0348035084,1945,0,300.8615384615385,70,125,43,38.80686820548152,0.5391559829059829,44.4835680751174,8176.525821596306,116.80751173709008,8
1984,32,6,2,198,0.03,0.01,0.99,200,6800,5100,1700,0.75,85,51,34,212.265688629384,0.480551716917923,0.775457782299084,0.1234657822027728,1048490.6684027857,-2288.281249999558,1046202.3871527861,1946,0,293.145,79,121,38,38.57663614784675,0.5427083333333333,44.01041666666669,8191.666666666729,103.69198312236365,0
1985,32,2,2,198,0.01,0.01,0.99,200,7000,5600,1400,0.8,84,56,28,217.37486449140388,0.48043446398659967,0.7829249976083428,0.12715273970501695,1050223.0776624414,-1341.580161476134,1048881.4975009654,1947,0,293.8,84,116,41,38.22985426831214,0.5452083333333333,43.79901960784315,8198.43137254905,97.60037348272678,0
1986,32,1,1,198,0.005025125628140704,0.005025125628140704,0.9949748743718593,199,5800,3600,2200,0.6206896551724138,80,36,44,216.02354056299606,0.48012368238498887,0.781887175705394,0.12688674307506786,1051491.724573495,-170.60695698890777,1051321.1176165063,1948,0,296.2361809045226,68,131,42,38.106437587107145,0.5466917922948074,43.64432367149756,8203.38164251202,120.63796533105912,0
1987,32,1,3,196,0.005025125628140704,0.01507537688442211,0.9849246231155779,199,5750,4000,1750,0.6956521739130435,75,40,35,211.90115377730612,0.47997880818232574,0.7775263211882315,0.1251156270529445,1053083.6284950185,-920.0728195830679,1052163.5556754353,1949,0,297.1457286432161,72,127,43,38.01402562248546,0.5488379396984925,43.450342465753394,8209.589041095822,114.02207001521975,0
1988,32,1,3,194,0.005076142131979695,0.015228426395939087,0.9847715736040609,197,6550,4900,1650,0.7480916030534351,82,49,33,214.28464730522393,0.4796091025242584,0.781574098261123,0.12733112513426076,1055022.4489795878,-734.9773242632364,1054287.4716553246,1950,0,291.76142131979697,69,128,44,37.711762092412286,0.5479589678510999,43.2142857142857,8217.142857142826,119.08902691511342,8
1989,32,0,4,190,0.0,0.020618556701030927,0.979381443298969,194,6550,4500,2050,0.6870229007633588,86,45,41,246.6651476995149,0.4790820914124958,0.8068609219477649,0.14454134601822025,1050765.0319881162,6487.422362566851,1057252.4543506831,1951,1,296.6546391752577,60,134,39,37.411707869660844,0.5438144329896908,43.73292349726776,8200.546448087436,136.6757741347906,7
1990,32,0,4,186,0.0,0.021052631578947368,0.9789473684210527,190,5700,3900,1800,0.6842105263157895,75,39,36,242.17991620478512,0.47839448157430614,0.798926845953225,0.14264281188903877,1052334.0277777791,7270.833333333426,1059604.8611111126,1952,2,303.3578947368421,64,126,39,37.33076089899809,0.5463267543859649,43.54166666666667,8206.666666666679,128.22916666666686,0
1991,32,0,2,184,0.0,0.010752688172043012,0.989247311827957,186,5900,4400,1500,0.7457627118644068,74,44,30,239.82789672335076,0.47776627433885493,0.7931801590707461,0.14174545789728962,1053386.4275147952,7426.290269559646,1060812.717784355,1953,3,309.4569892473118,64,122,39,37.25980055378594,0.5479950716845878,43.41346153846155,8210.769230769249,128.2932692307695,0
1992,32,2,5,181,0.010752688172043012,0.026881720430107527,0.9731182795698925,186,6000,4400,1600,0.7333333333333333,76,44,32,250.60611066353016,0.47738423907778743,0.7974504857495575,0.1509161047182181,1059066.5462563336,9881.709618231496,1068948.255874565,1954,0,310.3440860215054,72,114,39,36.275073950822716,0.5545474910394266,42.72260273972603,8232.876712328769,114.34550989345513,8
1993,32,4,1,184,0.021621621621621623,0.005405405405405406,0.9945945945945946,185,5450,3800,1650,0.6972477064220184,71,38,33,215.41451733292394,0.4769511359185272,0.7697544964893721,0.12743469341168756,1053669.4397531324,2945.138758574686,1056614.578511707,1955,0,311.44864864864866,72,113,36,37.85100645017793,0.549436936936937,43.37899543378995,8211.872146118718,114.05377980720442,8
1994,32,0,1,183,0.0,0.005434782608695652,0.9945652173913043,184,5350,4000,1350,0.7476635514018691,67,40,27,207.9810313513441,0.4766039538290964,0.762345635863741,0.12022695306741255,1046582.8427977827,1383.8758079408422,1047966.7186057236,1956,1,314.1141304347826,75,109,42,38.924169346195065,0.5432518115942029,44.243421052631575,8184.210526315779,109.12280701754372,8
1995,32,4,3,184,0.0213903743315508,0.016042780748663103,0.983957219251337,187,5400,4100,1300,0.7592592592592593,67,41,26,207.3170432800782,0.4770391294347651,0.7650394020491313,0.12092886935792273,1049359.948940711,710.0403901843929,1050069.9893308955,1957,0,309.5133689839572,80,107,42,38.595021090689954,0.5465129233511586,43.90432098765432,8195.061728395069,102.43827160493836,0
1996,32,3,2,185,0.016042780748663103,0.0106951871657754,0.9893048128342246,187,7100,5400,1700,0.7605633802816901,88,54,34,212.6239091314395,0.476543183255707,0.7724312237448654,0.12528840359865856,1052465.5489809366,255.8678500987662,1052721.4168310354,1958,0,310.19786096256684,64,123,40,38.072382945930165,0.5499108734402852,43.525641025641036,8207.179487179512,128.23717948717987,0
1997,32,0,1,184,0.0,0.005405405405405406,0.9945945945945946,185,5650,4100,1550,0.7256637168141593,72,41,31,208.16793108019158,0.4759535350567959,0.7644790370041825,0.12326934852993152,1053970.0496219266,1230.5529300566254,1055200.6025519832,1959,1,314.3027027027027,68,117,43,37.99960296453152,0.5515202702702703,43.34239130434782,8213.043478260857,120.78005115089496,0
1998,32,1,0,185,0.005405405405405406,0.0,1.0,185,5850,4400,1450,0.7521367521367521,73,44,29,201.77815462371706,0.47594007050528786,0.75648841573566,0.1200541066699403,1055413.7777777682,-258.11111111161154,1055155.6666666565,1960,0,314.9081081081081,74,111,44,37.98433106208087,0.5533220720720721,43.166666666666636,8218.666666666591,111.06306306306205,0
1999,32,1,4,182,0.005376344086021506,0.021505376344086023,0.978494623655914,186,6000,4000,2000,0.6666666666666666,80,40,40,223.26392708097754,0.47579676450644187,0.7759928575970259,0.12994707824072274,1048689.7808642054,3626.9197530868514,1052316.7006172922,1961,0,314.2096774193548,74,112,37,38.270244489050405,0.5449148745519714,43.986111111111136,8192.444444444507,110.70870870870955,8
2000,32,3,1,184,0.016216216216216217,0.005405405405405406,0.9945945945945946,185,6750,4900,1850,0.725925925925926,86,49,37,222.40753767906332,0.4758751958480219,0.7759891182210663,0.13054710330923386,1051282.1540105208,3012.615055884413,1054294.7690664052,1962,0,316.27027027027026,64,121,39,37.96889653016572,0.5472972972972974,43.6698717948718,8202.564102564114,128.1650641025643,0
2001,32.141522217674336,5,1,188,0.026455026455026454,0.005291005291005291,0.9947089947089947,189,5350,3500,1850,0.6542056074766355,72,35,37,215.8747550089273,0.47617171376036627,0.774444593486848,0.12832474552606998,1059804.3584319686,2607.001246778795,1062411.3596787474,1963,0,308.962962962963,71,118,44,37.65657276995308,0.5504850088183422,43.200231481481474,8253.935465331568,116.25261218776856,0
2002,31.731337657086687,3,4,187,0.015706806282722512,0.020942408376963352,0.9790575916230366,191,6600,4500,2100,0.6818181818181818,87,45,42,209.0421946906226,0.47659364379535224,0.7696149492008444,0.12539004138496201,1048992.559243083,-943.2586403387522,1048049.3006027442,1964,0,304.36649214659684,71,120,43,37.492322155329234,0.5540466841186736,42.86747685185184,8159.1589146325205,114.91773119200732,8
2003,32.1299787884255,1,1,187,0.005319148936170213,0.005319148936170213,0.9946808510638298,188,6300,4800,1500,0.7619047619047619,78,48,30,225.3949368761975,0.47577286475518643,0.7819148936170213,0.13201703445605895,1054892.467643427,3653.4842311334587,1058545.9518745604,1965,0,310.0,78,110,43,37.97425474254748,0.5470412234042553,43.750000000000014,8233.307064534065,105.55521877607775,8
2004,31.978021999872222,4,3,188,0.020942408376963352,0.015706806282722512,0.9842931937172775,191,5150,3500,1650,0.6796116504854369,68,35,33,216.80058273559106,0.4763376044824102,0.7766868189841827,0.12824305656732446,1052918.2141020885,2304.6564780502017,1055222.8705801386,1966,0,306.0680628272251,67,124,42,37.81886739891751,0.5493019197207678,43.38235294117648,8206.124763202522,122.47947407764958,0
2005,31.56678411695302,2,0,190,0.010526315789473684,0.0,1.0,190,5750,3800,1950,0.6608695652173913,77,38,39,214.01479705116498,0.4754676041956744,0.7737683696220747,0.12793297410184293,1042528.1983652691,873.2921586518696,1043401.490523921,1967,0,308.4947368421053,72,118,39,37.493406806951356,0.5523026315789474,42.993721461187214,8112.86171133619,112.6786348796693,0
2006,31.28438505344581,2,3,189,0.010416666666666666,0.015625,0.984375,192,6400,4700,1700,0.734375,81,47,34,237.26815580412227,0.47555810063990694,0.7969927357068851,0.1380618223266669,1025159.1727539808,3847.5252650033403,1029006.6980189842,1968,0,306.2708333333333,71,121,36,37.92178816991614,0.5422092013888888,43.99594907407407,8008.929304408608,112.80182118885364,8
2007,31.51757416216383,2,1,190,0.010471204188481676,0.005235602094240838,0.9947643979057592,191,5500,3800,1700,0.6909090909090909,72,38,34,234.19785117261935,0.4759656011757141,0.7931469358141514,0.13687172728005842,1034121.9105378906,4737.82585969966,1038859.7363975903,1969,0,307.3455497382199,75,116,39,37.83284287497773,0.5439027050610821,43.832236842105274,8073.786473284591,107.65048631046122,0
2008,31.628778195991167,0,3,187,0.0,0.015789473684210527,0.9842105263157894,190,6000,4200,1800,0.7,78,42,36,235.34568909045151,0.4755575280794579,0.7944748538011706,0.1382063610430501,1039228.6765897329,4915.597802913624,1044144.2743926465,1970,1,309.61052631578946,63,127,37,37.61931216931219,0.5458881578947368,43.65234374999999,8107.963160593421,128.69782794592732,0
2009,32.14335714987917,2,0,189,0.010582010582010581,0.0,1.0,189,5900,4000,1900,0.6779661016949152,78,40,38,228.6527383091306,0.4757636309054749,0.7871619216910706,0.13504751208222127,1057894.4342487918,4678.091846594803,1062572.5260953866,1971,0,310.92063492063494,66,123,40,37.57271845836868,0.5484457671957672,43.43905472636815,8246.730094640927,124.95045597940798,0
2010,32.41104441357418,0,3,186,0.0,0.015873015873015872,0.9841269841269842,189,5900,3800,2100,0.6440677966101694,80,38,42,210.13874500088335,0.47560532290142216,0.7713910287327359,0.12124655698336963,1059439.4150857748,825.853818118976,1060265.268903894,1972,1,311.92063492063494,71,118,41,38.9412875572908,0.5384700176366843,44.314236111111114,8287.042649321424,116.71891055382287,8
2011,32.1581374438856,2,1,187,0.010638297872340425,0.005319148936170213,0.9946808510638298,188,6350,4900,1450,0.7716535433070866,78,49,29,208.97021573936541,0.4759109398111276,0.7649942831576857,0.11768322675848517,1043589.8968113599,-334.1588239813964,1043255.7379873785,1973,0,308.15425531914894,69,119,46,39.91433021806854,0.5301418439716312,45.238095238095255,8192.668348799461,118.73432389564437,8
2012,32.085541671757014,3,2,188,0.015789473684210527,0.010526315789473684,0.9894736842105263,190,5600,4000,1600,0.7142857142857143,72,40,32,225.62856392655198,0.4765577137287664,0.7840006193974622,0.12757814732926498,1042499.4672506076,3443.531537990135,1045942.9987885976,1974,0,305.53684210526313,74,116,38,39.33168519123894,0.5286732456140351,45.083333333333336,8179.139331158739,110.5289098805235,8
2013,32.51754988527291,1,2,187,0.005291005291005291,0.010582010582010581,0.9894179894179894,189,5750,4100,1650,0.7130434782608696,74,41,33,215.14456589165206,0.4764777759015348,0.7680929210595662,0.11764065686403227,1045795.7463504372,1449.4543719798644,1047245.200722417,1975,0,307.7037037037037,73,116,42,40.925873249338586,0.5205026455026456,46.38231981981979,8247.025567046128,112.97295297323464,8
2014,32.45320517856419,5,4,188,0.026041666666666668,0.020833333333333332,0.9791666666666666,192,5850,4200,1650,0.717948717948718,75,42,33,197.09655139908332,0.4775055446480512,0.7588743419414514,0.10757086681192893,1043123.0700661492,-3130.8080410272896,1039992.262025122,1976,0,303.4166666666667,76,116,41,41.458355565041124,0.5208333333333333,46.45562770562773,8228.327535939576,108.2674675781523,8
2015,31.96624939539658,1,3,186,0.005291005291005291,0.015873015873015872,0.9841269841269842,189,5550,3600,1950,0.6486486486486487,75,36,39,186.48293532555005,0.4774803932605351,0.7374641821192058,0.1035173826090617,1032838.3524960921,-4828.654461944872,1028009.6980341473,1977,0,308.5978835978836,79,110,38,41.05376777817618,0.527502204585538,45.79427083333332,8126.003736280271,102.86080678835786,8
2016,32.01218142356845,7,3,190,0.03626943005181347,0.015544041450777202,0.9844559585492227,193,6050,4400,1650,0.7272727272727273,77,44,33,178.35845817329255,0.4784863899683362,0.7333867164624783,0.10094829755551461,1040420.3580748829,-7536.44581633233,1032883.9122585505,1978,0,301.1554404145078,85,108,43,40.498707381189924,0.5335168393782384,45.04602713178291,8161.6328341168055,96.01920981313889,8
2017,31.672069447820697,4,2,192,0.020618556701030927,0.010309278350515464,0.9896907216494846,194,5700,4200,1500,0.7368421052631579,72,42,30,196.61119998454205,0.4786853667004967,0.7547401088677959,0.10727081271983374,1017912.1801842158,-4473.412955019693,1013438.767229196,1979,0,300.5618556701031,81,113,42,41.48378261014798,0.5189540378006873,46.46849593495937,8029.86740395846,99.13416548096865,8
2018,31.504181959008875,4,2,194,0.02040816326530612,0.01020408163265306,0.9897959183673469,196,6500,4600,1900,0.7076923076923077,84,46,38,195.9100000995118,0.4790930795395081,0.7591707976566007,0.10819419866122967,1016313.1975516191,-5878.816273305055,1010434.381278314,1980,0,298.4642857142857,90,106,41,41.01735015772876,0.5221619897959184,45.99358974358977,8002.2641674726865,88.91404630525207,0
2019,31.64794199836546,3,2,195,0.015228426395939087,0.01015228426395939,0.9898477157360406,197,5900,3800,2100,0.6440677966101694,80,38,42,194.94300019015395,0.4795206153527401,0.7616834024481371,0.10838344213380174,1023043.1402391121,-5412.980183566337,1017630.1600555457,1981,0,297.9035532994924,72,125,42,40.776699029126206,0.5245875634517767,45.73344748858447,8047.013106005608,111.76407091674456,0
2020,31.40261960245239,4,0,199,0.020100502512562814,0.0,1.0,199,5700,4300,1400,0.7543859649122807,71,43,28,192.4265533693145,0.4798794054447321,0.7594928800958953,0.10776891827080382,1017369.809953957,-6346.2067937132,1011023.6031602438,1982,0,295.7788944723618,78,121,46,40.55274971941636,0.5266959798994975,45.4509493670886,7993.507007190686,102.48085906654725,0
2021,31.848273803236435,4,3,200,0.019704433497536946,0.014778325123152709,0.9852216748768473,203,6650,4700,1950,0.706766917293233,86,47,39,189.98948358310795,0.4805150465785495,0.762020008948044,0.10688814445566418,1033225.4129121773,-7989.607475174759,1025235.8054370026,1983,0,290.9310344827586,85,118,46,40.4366777619274,0.5301211001642037,45.27616279069765,8112.514511652815,95.44134719591547,8
2022,31.929691624206388,6,7,199,0.02912621359223301,0.03398058252427184,0.9660194174757282,206,6700,5000,1700,0.746268656716418,84,50,34,200.9321300607739,0.48090516220696183,0.7736451507193116,0.11349773060847201,1037116.535832985,-6221.993066765808,1030894.5427662191,1984,0,287.6504854368932,84,122,34,40.001242106612814,0.5322613268608414,45.12254901960782,8138.158411767628,96.8828382353289,8
2023,31.509504375753384,0,5,194,0.0,0.02512562814070352,0.9748743718592965,199,6450,4700,1750,0.7286821705426356,82,47,35,226.27488891225812,0.4794088286550598,0.792718852720353,0.1268674684101589,1021178.2269871956,-36.6020257710361,1021141.6249614245,1985,1,298.5175879396985,70,129,42,39.6470831172324,0.5280569514237856,45.40786384976526,8022.072028058232,114.60102897226045,8
2024,31.56532733330387,1,1,194,0.005128205128205128,0.005128205128205128,0.9948717948717949,195,5600,3500,2100,0.625,77,35,42,228.39805429563518,0.4787216935412812,0.7897355500043073,0.1289250711036677,1025073.5426886495,2224.9605320043056,1027298.5032206539,1986,0,300.24615384615385,72,123,37,39.327640910787636,0.5301816239316239,45.14840182648402,8044.47411776266,111.72880719114806,0
2025,31.296243366771687,1,3,192,0.005128205128205128,0.015384615384615385,0.9846153846153847,195,6350,4500,1850,0.7086614173228346,82,45,37,229.6114884164188,0.47887368931183366,0.7901656380564559,0.13032877441100965,1018024.2727435564,1400.013701738092,1019424.2864452945,1987,0,300.91282051282053,78,117,38,39.08016266887231,0.5327457264957265,44.936708860759495,7982.52283342342,102.34003632594128,0
2026,31.422325963794023,3,2,193,0.015384615384615385,0.010256410256410256,0.9897435897435898,195,6200,4200,2000,0.6774193548387096,82,42,40,230.03580921767156,0.4791953035509737,0.7938329484325521,0.12903898700664596,1018503.0675611062,1658.435467419993,1020161.5030285262,1988,0,300.8666666666667,67,128,36,39.53213053767322,0.528258547008547,45.3890931372549,8000.466909378379,119.40995387131909,8
2027,31.71210504945286,3,3,193,0.015306122448979591,0.015306122448979591,0.9846938775510204,196,6350,4500,1850,0.7086614173228346,82,45,37,228.81097410252983,0.4794135923600209,0.7937154599889888,0.12944701910436332,1030532.1584348829,1609.413403093522,1032141.5718379763,1989,0,300.1530612244898,72,124,33,39.22954214709504,0.530984268707483,45.06278538812785,8084.595730786588,112.2860518164804,0
2028,31.596928258080553,2,1,194,0.010256410256410256,0.005128205128205128,0.9948717948717949,195,6750,4900,1850,0.725925925925926,86,49,37,235.30547257028334,0.4791754780156842,0.80100700489607,0.13435625545194418,1029630.7408059449,2705.5496076469526,1032336.2904135919,1990,0,299.6666666666667,63,132,35,38.70317978960789,0.5335470085470085,44.71028645833335,8066.370763802009,128.03763117146045,0
2029,31.35479430774477,5,0,199,0.02512562814070352,0.0,1.0,199,6500,4900,1600,0.7538461538461538,81,49,32,228.92720703829835,0.4798963250596417,0.7967740945051129,0.13223912783035827,1025261.1174188122,642.032819130689,1025903.1502379429,1991,0,294.50251256281405,71,128,41,38.416496945010195,0.5375837520938023,44.270833333333336,8018.335419324316,112.93430168062416,7
2030,31.686543510981355,3,10,192,0.01485148514851485,0.04950495049504951,0.9504950495049505,202,6750,5000,1750,0.7407407407407407,85,50,35,224.62370033259504,0.48039454131980364,0.7958650652636579,0.13071275845922706,1038357.332170555,-502.06675607323996,1037855.2654144817,1992,0,291.11386138613864,76,126,36,38.24299390544637,0.5399649339933994,43.99350649350652,8111.960895587343,106.73632757351767,0
2031,31.715716099331164,3,3,192,0.015384615384615385,0.015384615384615385,0.9846153846153847,195,6800,5400,1400,0.7941176470588235,82,54,28,230.23754405063892,0.4793230681117279,0.7958386879627923,0.134154847096005,1039711.7020491968,2076.1337601035225,1041787.8358093003,1993,0,301.3948717948718,74,121,39,38.04908421928115,0.5409188034188035,43.944444444444464,8120.985305656561,109.74304467103461,0
2032,31.438563226935443,0,3,189,0.0,0.015625,0.984375,192,5750,3900,1850,0.6782608695652174,76,39,37,253.83383078962552,0.47889625145433395,0.8095920513928314,0.1465650650910023,1027873.3662591033,8031.806824835355,1035905.1730839387,1994,1,306.65625,65,127,39,37.79574538122865,0.5394965277777778,44.28661616161617,8039.261385776667,123.68094439656412,8
2033,31.201897458866025,5,6,188,0.02577319587628866,0.030927835051546393,0.9690721649484536,194,5950,3900,2050,0.6554621848739496,80,39,41,250.91455748736078,0.479606235421897,0.8108842257032369,0.14703370213682027,1024562.8405372646,6665.546350280178,1031228.3868875448,1995,0,301.6958762886598,58,136,38,37.302216098289136,0.5437070446735395,43.73234463276836,7996.0371047923745,137.8627087033168,0
2034,31.24500727113001,1,1,188,0.005291005291005291,0.005291005291005291,0.9947089947089947,189,4700,3100,1600,0.6595744680851063,63,31,32,247.63053270856238,0.47865539044617056,0.8029463356249673,0.14537832268158737,1026532.1844059443,8340.142333385627,1034872.32673933,1996,0,308.6296296296296,59,130,39,37.315512473191106,0.5452491181657848,43.66319444444444,8009.245353441571,135.7499212447724,0
2035,31.486327529680157,0,5,183,0.0,0.026595744680851064,0.973404255319149,188,6250,4000,2250,0.64,85,40,45,253.1280490207031,0.4783506608639587,0.8029172648524829,0.1440553155180218,1025013.9186865014,8041.9546912359465,1033055.8733777374,1997,1,311.1648936170213,69,119,35,38.37740080869345,0.5306405141843972,44.836309523809526,8034.167532015267,116.43721060891691,8
2036,31.745893746563677,2,0,185,0.010810810810810811,0.0,1.0,185,5350,4200,1150,0.7850467289719626,65,42,23,241.3634414687605,0.47851179984332154,0.7964527230127805,0.13609625374208023,1030601.2514245516,7399.89296516833,1038001.1443897199,1998,0,316.2648648648649,67,118,37,39.03976794517254,0.5291103603603604,45.18995098039216,8089.172741733164,120.73392151840544,8
2037,31.934568083133026,3,2,186,0.015957446808510637,0.010638297872340425,0.9893617021276596,188,5800,4200,1600,0.7241379310344828,74,42,32,228.71336245245791,0.47916074069860054,0.7889805222307358,0.13026464248725325,1039853.5698039541,4165.681281610734,1044019.2510855648,1999,0,312.20212765957444,72,116,40,38.96930682919555,0.5318040780141844,44.80593607305936,8149.512208886278,113.18766956786497,0
2038,31.908990582601394,0,4,182,0.0,0.021505376344086023,0.978494623655914,186,5800,4100,1700,0.7068965517241379,75,41,34,232.34902222282838,0.4788342778262133,0.7906713203645301,0.13292070689824742,1040388.8440842725,5346.66613090408,1045735.5102151766,2000,1,316.33870967741933,60,126,40,38.70466653292321,0.5339941756272402,44.63797814207652,8148.344350618564,135.80573917697606,0
2039,31.700833374209267,0,2,180,0.0,0.01098901098901099,0.989010989010989,182,5550,3800,1750,0.6846846846846847,73,38,35,234.79094192347705,0.47840269767065347,0.7853647675419062,0.13006972761400326,1023629.2279045145,6117.77412002052,1029747.0020245351,2001,2,321.8791208791209,78,104,37,39.90621594977432,0.5269001831501832,45.87289029535865,8056.041160616238,103.28257898225947,8
2040,32.21295360945004,7,1,186,0.0374331550802139,0.0053475935828877,0.9946524064171123,187,5550,3800,1750,0.6846846846846847,73,38,35,211.63216048001064,0.4801369961474326,0.7704221879599966,0.11813967540807008,1042591.8975539495,1179.1951556595186,1043771.0927096091,2002,0,313.5882352941176,68,119,44,40.19227536145888,0.5270164884135473,45.57669082125606,8195.726255737687,120.52538611378952,8
2041,31.960314115886643,3,2,187,0.015873015873015872,0.010582010582010581,0.9894179894179894,189,6600,5100,1500,0.7727272727272727,81,51,30,204.53388333547923,0.4806066831776052,0.7647878407756816,0.11504633568403858,1036793.6120299895,-1988.1152628173104,1034805.4967671721,2003,0,310.3492063492063,73,116,43,40.074548678272095,0.5295965608465609,45.28434684684687,8140.792285008064,111.51770253435704,0
2042,31.961160581998467,5,3,189,0.026041666666666668,0.015625,0.984375,192,7200,4800,2400,0.6666666666666666,96,48,48,199.60650406667781,0.48146633216986623,0.7618416577951255,0.1138646009028142,1041205.3146888617,-4033.7294238618633,1037171.5852649999,2004,0,306.25,68,124,42,39.65134847409507,0.5337456597222222,44.74637681159423,8158.202039861629,119.97355940972983,0
2043,32.31683979503293,2,0,191,0.010471204188481676,0.0,1.0,191,6800,5200,1600,0.7647058823529411,84,52,32,219.66505423155994,0.48131716726370904,0.7712199125762293,0.1238106224426572,1049007.1158430395,1086.0409981908397,1050093.1568412303,2005,0,308.4973821989529,77,114,39,39.608721194332354,0.5302137870855148,45.205662393162406,8234.147789121736,106.93698427430826,8
2044,32.23807678670707,2,7,186,0.010362694300518135,0.03626943005181347,0.9637305699481865,193,6850,4700,2150,0.6861313868613139,90,47,43,226.51702015530145,0.4812862064622913,0.7814063835638545,0.12880112246663883,1049219.0826954916,2083.1960204523793,1051302.278715944,2006,0,306.2901554404145,80,113,36,39.0896718584606,0.5325453367875648,44.86882716049383,8224.938340682638,102.81172925853298,0
2045,32.53494491946812,2,6,182,0.010638297872340425,0.031914893617021274,0.9680851063829787,188,6300,4600,1700,0.7301587301587301,80,46,34,232.8395962847855,0.48011245117002316,0.7789434695666708,0.13336085842858938,1061175.6818052807,5516.743467754787,1066692.4252730354,2007,0,313.07978723404256,67,121,42,38.64562716167858,0.5364583333333333,44.59252450980393,8309.668147093951,124.02489771782017,8
2046,32.61729618290345,1,2,181,0.00546448087431694,0.01092896174863388,0.9890710382513661,183,5550,3600,1950,0.6486486486486487,75,36,39,234.6588134765612,0.4797008547008547,0.7726647882513649,0.13547312942976814,1066364.7633450713,7896.378019954035,1074261.1413650254,2008,0,318.8087431693989,72,111,41,38.29182942708335,0.5390482695810564,44.2922374429224,8340.495827591809,115.84021982766401,0
2047,32.97916410115415,3,0,184,0.016304347826086956,0.0,1.0,184,5900,4300,1600,0.7288135593220338,75,43,32,232.59482741986338,0.4796857676011721,0.7755682611488084,0.1356367589111342,1081383.440003071,7604.83892044262,1088988.2789235136,2009,0,317.5380434782609,75,109,42,37.9580568043959,0.5417232789855073,43.914473684210535,8445.486596298872,112.60648795065163,0
2048,33.17134414714648,1,1,184,0.005405405405405406,0.005405405405405406,0.9945945945945946,185,6150,4300,1850,0.6991869918699187,80,43,37,232.0034652706046,0.479968419506463,0.7783868813429022,0.13619380029371342,1089796.7835696358,7417.326045782848,1097214.1096154186,2010,0,316.8162162162162,61,124,44,37.71895687225537,0.5438626126126126,43.66599462365591,8502.943508955199,139.39251654024918,0
2049,33.14761833543108,2,2,184,0.010752688172043012,0.010752688172043012,0.989247311827957,186,5750,4500,1250,0.782608695652174,70,45,25,229.30520276953075,0.47973820594788336,0.7766056016033338,0.1357605479613324,1091709.3771682773,7116.9280193940795,1098826.3051876714,2011,0,316.05913978494624,64,122,39,37.46422624622747,0.5460349462365591,43.34935897435898,8507.357494261694,132.92746084783897,0
2050,33.507781082049334,1,0,185,0.005405405405405406,0.0,1.0,185,6150,4700,1450,0.7642276422764228,76,47,29,226.01327732937875,0.47973707403055227,0.7725271164884697,0.13452483567560136,1105264.2194440567,6810.877710289722,1112075.0971543465,2012,0,317.94594594594594,67,118,46,37.34748066638835,0.5477477477477477,43.15257352941176,8606.387337664224,128.45354235319738,0
2051,33.68920902134826,2,2,185,0.0106951871657754,0.0106951871657754,0.9893048128342246,187,5900,4200,1700,0.711864406779661,76,42,34,220.03237246566633,0.47955000670845077,0.7687833482701929,0.1319901248945171,1113735.8663133944,5711.588993007831,1119447.4553064022,2013,0,315.5347593582888,72,115,40,37.20750092489824,0.5501336898395721,42.86529680365295,8662.664762624048,120.31478836977846,0
2052,33.19635450323645,0,1,184,0.0,0.005405405405405406,0.9945945945945946,185,5250,3800,1450,0.7238095238095238,67,38,29,238.90188193637027,0.47899162749706226,0.7823675446918872,0.1389460582508455,1087660.1160811968,9718.809727786436,1097378.9258089832,2014,1,318.5027027027027,74,111,33,37.89833251948713,0.5391891891891891,44.013888888888935,8497.805692349431,114.8352120587761,8
2053,33.24758925006748,2,2,184,0.010752688172043012,0.010752688172043012,0.989247311827957,186,7150,5800,1350,0.8111888111888111,85,58,27,237.55551512522078,0.47926717039620265,0.7864759547324232,0.1394253396909974,1092238.5369180185,7543.457655435704,1099781.9945734541,2015,0,317.7258064516129,67,119,38,37.58422727544376,0.5423387096774194,43.67340686274512,8522.241282496654,127.1976310820396,0
2054,32.9215545589244,0,0,184,0.0,0.0,1.0,184,5500,3300,2200,0.6,77,33,44,240.1979450725368,0.4788282301813574,0.7867004338863661,0.14139275182107183,1082455.9893078348,9700.740852640458,1092156.7301604752,2016,1,321.9728260869565,66,118,38,37.40387918839171,0.5435348731884058,43.563432835820905,8442.290436798827,127.91349146664889,0
2055,33.2947286332247,3,2,185,0.016042780748663103,0.0106951871657754,0.9893048128342246,187,5950,4200,1750,0.7058823529411765,77,42,35,233.82005072333845,0.47898098633392755,0.7852486328185637,0.13882918836356897,1097458.0376036058,7971.538803841939,1105429.5764074477,2017,0,317.7914438502674,71,116,40,37.240155613155316,0.5461786987522281,43.24363425925925,8548.63352219093,120.40328904494268,0
2056,33.03459692827259,1,4,182,0.005376344086021506,0.021505376344086023,0.978494623655914,186,4400,3100,1300,0.7045454545454546,57,31,26,227.10850803211804,0.47891238012205756,0.776364681524113,0.13534800527968166,1090052.9038605008,7912.0577343672685,1097964.961594868,2018,0,320.21505376344084,75,111,45,37.27152581408168,0.5480510752688172,43.105811403508774,8486.395973500734,113.15194631334312,0
2057,32.77838450787353,0,4,178,0.0,0.02197802197802198,0.978021978021978,182,6100,4800,1300,0.7868852459016393,74,48,26,229.37215622763918,0.47858104142634533,0.7732829884445813,0.13718137099928976,1082696.7701776216,7168.098543268343,1089864.86872089,2019,1,324.6923076923077,77,105,36,37.07999930721536,0.5496794871794872,42.97542735042735,8424.85027027957,109.41363987376066,0
2058,32.23953981622425,0,3,175,0.0,0.016853932584269662,0.9831460674157303,178,5550,3900,1650,0.7027027027027027,72,39,33,263.2771299006736,0.4774613036670264,0.791811713925145,0.15306616732080286,1056195.9941863348,14464.449992393787,1070660.4441787286,2020,3,332.1629213483146,74,104,34,37.28861457768137,0.5409058988764045,44.02777777777781,8252.426650180803,111.51927905649734,8
2059,31.80824343224782,2,2,175,0.011299435028248588,0.011299435028248588,0.9887005649717514,177,5700,4200,1500,0.7368421052631579,72,42,30,235.09911210285458,0.4776793357301832,0.7760604449364976,0.133759323682969,1035411.0146892461,7584.84204299152,1042995.8567322376,2021,0,334.8813559322034,75,102,39,38.84785489184929,0.5358992467043315,44.84649122807018,8115.984919609734,108.21313226146312,8
2060,31.79939804619659,4,1,178,0.0223463687150838,0.00558659217877095,0.994413407821229,179,4550,3200,1350,0.7032967032967034,59,32,27,204.60433310905168,0.4780681794405039,0.7531015634419822,0.11568500773738327,1033188.0307595457,1928.9496019624198,1035116.9803615082,2022,0,331.64245810055866,70,109,40,39.869424460431645,0.5313081936685289,45.08509389671363,8106.140567087268,115.80200810124668,8
2061,32.307347291358624,0,2,176,0.0,0.011235955056179775,0.9887640449438202,178,5250,3600,1650,0.6857142857142857,69,36,33,235.38542869694925,0.47764314733701513,0.7767194152178696,0.13048704030094974,1043428.8767521563,8271.590693816092,1051700.4674459724,2023,1,334.37640449438203,77,101,40,39.86428940500585,0.5223548689138577,45.846688034188006,8211.019314928428,106.63661447958997,8
2062,31.80890233450671,8,4,180,0.043478260869565216,0.021739130434782608,0.9782608695652174,184,6350,4700,1650,0.7401574803149606,80,47,33,217.1473724557073,0.47806411855547637,0.7682652996973116,0.12282993853302086,1033630.8594354455,1740.045043108451,1035370.9044785539,2024,0,324.26630434782606,78,106,38,39.532796282886785,0.5324954710144927,45.06856540084389,8109.089105160255,103.96268083538789,8
2063,32.22372807339026,0,3,177,0.0,0.016666666666666666,0.9833333333333333,180,5150,4000,1150,0.7766990291262136,63,40,23,220.06864863061628,0.4773316263190565,0.7688494730485249,0.1235026122242862,1044619.2504066105,4827.589354102143,1049446.8397607126,2025,1,332.3666666666667,69,111,41,39.768460347145094,0.5292824074074074,45.37202380952382,8205.062664639616,118.9139516614437,7
2064,32.409138302213314,3,6,174,0.016666666666666666,0.03333333333333333,0.9666666666666667,180,4900,3600,1300,0.7346938775510204,62,36,26,213.66591748649492,0.4773393854748604,0.7619933010178208,0.12075264598921848,1052852.5927084796,4091.7430398185124,1056944.335748298,2026,0,322.0833333333333,76,104,38,39.656529738527425,0.5322916666666666,45.10281385281386,8260.998158689184,108.69734419327874,0
2065,32.05656429779157,0,1,173,0.0,0.005747126436781609,0.9942528735632183,174,6100,4300,1800,0.7049180327868853,79,43,36,210.46668447940206,0.4767381181759795,0.7507954922415174,0.11935853697373483,1042485.5488680622,2981.6954175901474,1045467.2442856523,2027,1,332.37931034482756,75,99,40,39.60231140610166,0.5341834291187739,44.969846491228076,8175.390513829615,109.00520685106153,0
2066,31.949797146878108,4,0,177,0.022598870056497175,0.0,1.0,177,4700,3300,1400,0.7021276595744681,61,33,28,205.12396890898594,0.4772820899674713,0.7497777360477571,0.11744759279428077,1041987.6036169701,2647.326561575308,1044634.9301785454,2028,0,327.22033898305085,66,111,43,39.36633793957103,0.5371351224105461,44.60509950248757,8159.815263242652,123.63356459458564,0
2067,31.81036214110605,1,1,177,0.0056179775280898875,0.0056179775280898875,0.9943820224719101,178,5400,3800,1600,0.7037037037037037,70,38,32,218.86889635603947,0.47754131488182144,0.763531286998262,0.12104789982140185,1026643.7135764069,3940.0753082669844,1030583.788884674,2029,0,326.37640449438203,79,99,39,40.3768621019544,0.5264513108614233,45.937500000000014,8081.82013147479,102.30152065157962,8
2068,31.869244041400936,1,1,177,0.0056179775280898875,0.0056179775280898875,0.9943820224719101,178,6450,4400,2050,0.6821705426356589,85,44,41,230.29580615616314,0.4780220434203009,0.7767743169597034,0.12400649550182447,1020059.1018660845,4933.066638236649,1024992.1685043211,2030,0,327.36516853932585,73,105,39,41.16084344052522,0.5164442883895131,46.98761261261264,8063.3135191461715,110.45634957734481,7
2069,31.697082420384426,7,3,181,0.03804347826086957,0.016304347826086956,0.9836956521739131,184,5800,4500,1300,0.7758620689655172,71,45,26,221.51837936077692,0.479679580462501,0.7763440195401046,0.12158200589762816,1020592.4035303609,2615.9950435928067,1023208.3985739537,2031,0,317.54891304347825,69,115,39,40.61376053089385,0.5211163949275363,46.23511904761902,8043.606346946607,116.5740050282117,0
2070,31.643713990420864,2,0,183,0.01092896174863388,0.0,1.0,183,6050,4400,1650,0.7272727272727273,77,44,33,222.6741601484176,0.4798559819051622,0.7758375197775689,0.12213161551981397,1018656.1394388789,2715.6800659162645,1021371.8195047951,2032,0,320.0655737704918,67,116,35,40.61217097319489,0.5203779599271403,46.26225490196078,8029.204634456654,119.8388751411441,8
2071,31.260629613935123,2,1,184,0.010810810810810811,0.005405405405405406,0.9945945945945946,185,5550,3900,1650,0.7027027027027027,72,39,33,239.2005278999623,0.4801948687818253,0.7924233447226676,0.12808734358067767,998833.8031923709,5234.314601588704,1004068.1177939597,2033,0,317.5945945945946,74,111,34,41.16154332179548,0.5112049549549549,47.20833333333335,7902.426661156058,106.78954947508187,8
2072,31.273886980930264,3,3,184,0.016042780748663103,0.016042780748663103,0.983957219251337,187,5650,4300,1350,0.7610619469026548,70,43,27,190.6387885172819,0.4805850248212677,0.7439967788900947,0.10178864082709702,998347.1619897591,-4985.261303720999,993361.9006860381,2034,0,315.1764705882353,71,116,49,42.50650109743295,0.508801247771836,47.32349537037039,7902.176448523579,111.29825983836027,8
2073,31.182177532322005,9,4,189,0.046632124352331605,0.02072538860103627,0.9792746113989638,193,6500,4900,1600,0.7538461538461538,81,49,32,185.14034617290565,0.4815515705958549,0.745205678533942,0.10100274593664711,1002138.0305935112,-7992.763620576779,994145.2669729344,2035,0,305.37823834196894,74,119,41,41.778400167999735,0.5146804835924007,46.472222222222214,7905.548176041723,106.83173210867194,0
2074,31.48858059769345,5,2,192,0.02577319587628866,0.010309278350515464,0.9896907216494846,194,5950,4800,1150,0.8067226890756303,71,48,23,212.69370303101456,0.4818858723714901,0.7762251658838966,0.11511437820533502,1009484.1315962429,-1807.816379949547,1007676.3152162933,2036,0,301.4020618556701,69,125,37,41.40000587682177,0.5095038659793815,46.78571428571427,7973.358444201636,115.55591948118314,8
2075,31.09389000571978,4,5,191,0.02040816326530612,0.025510204081632654,0.9744897959183674,196,6950,5500,1450,0.7913669064748201,84,55,29,208.05947708422724,0.48210143031571606,0.7702632643144209,0.11444816082794573,1001853.6276822228,-4460.971621900626,997392.6560603221,2037,0,294.5051020408163,75,121,38,40.866955078019544,0.5193452380952381,46.14857456140347,7893.228300382805,105.24304400510407,8
2076,31.181162370797995,9,6,194,0.045,0.03,0.97,200,6650,5100,1550,0.7669172932330827,82,51,31,226.3698898902665,0.48362384840871026,0.7942157982146569,0.1251921652814479,1006326.5520099272,-1089.5938455723826,1005236.9581643548,2038,0,287.6,78,122,39,40.18763839872672,0.5191145833333333,45.93881856540084,7921.922950428989,101.56311474908959,8
2077,31.71267891246244,3,4,193,0.015228426395939087,0.02030456852791878,0.9796954314720813,197,6200,4100,2100,0.6612903225806451,83,41,42,224.31332074596747,0.4839633188300701,0.7901123632872833,0.1251141831876836,1026139.7403416908,435.36254108971025,1026575.1028827806,2039,0,291.74111675126903,64,133,41,39.90264478602325,0.5215207275803723,45.60897435897434,8067.420914365819,126.05345178696592,8
2078,31.42087898571793,3,2,194,0.015306122448979591,0.01020408163265306,0.9897959183673469,196,6750,5100,1650,0.7555555555555555,84,51,33,241.90890303156507,0.4840277777777778,0.8049395998375604,0.1340973454901673,1014784.7411377735,3147.0927083616616,1017931.8338461352,2040,0,292.60714285714283,68,128,36,39.700277200277164,0.5154124149659864,45.848429951690804,7985.6657265181,117.4362606840897,8
2079,31.014955956459556,3,6,191,0.015228426395939087,0.030456852791878174,0.9695431472081218,197,5450,3700,1750,0.6788990825688074,72,37,35,236.04968110094543,0.4842751821540799,0.8014422522100044,0.13193357571988382,1004195.5468955926,2558.007721538658,1006753.5546171312,2041,0,284.7208121827411,64,133,39,39.52206268236875,0.518242385786802,45.52884615384614,7892.411628727876,123.31893169887306,0
2080,31.541162703181996,3,2,192,0.015463917525773196,0.010309278350515464,0.9896907216494846,194,4800,3600,1200,0.75,60,36,24,283.09551031541514,0.4845494364617275,0.8234939644631583,0.15427065762902512,1013326.6768197888,13773.646538104065,1027100.3233578928,2042,0,286.5154639175258,57,137,38,39.33978083227058,0.5086984536082475,46.51580459770113,7995.1862498690425,140.266425436299,8
2081,31.195033822629192,7,1,198,0.035175879396984924,0.005025125628140704,0.9949748743718593,199,5450,3300,2150,0.6055045871559633,76,33,43,244.80411458325315,0.48510545149992385,0.8104856827028155,0.1322532552710884,999507.6625629041,3686.7176705777406,1003194.3802334818,2043,0,280.0603015075377,58,141,42,40.66030827172547,0.511463567839196,46.85734463276837,7896.793696130964,136.15161545053385,8
2082,30.888762132510827,4,2,200,0.019801980198019802,0.009900990099009901,0.9900990099009901,202,6900,5000,1900,0.7246376811594203,88,50,38,233.71693934656832,0.4852162455051476,0.8047702236202037,0.1280336240996237,993982.723458296,-837.8800219923105,993144.8434363038,2044,0,276.6089108910891,69,133,41,40.38034764586267,0.5147483498349835,46.3095238095238,7836.184774331005,113.5678952801595,0
2083,30.630455471633223,1,4,197,0.004975124378109453,0.01990049751243781,0.9800995024875622,201,8250,5900,2350,0.7151515151515152,106,59,47,234.95039920513508,0.4848714759535655,0.8080469200565104,0.12966218981597422,987910.6510720538,-2027.9996303232333,985882.6514417306,2045,0,278.96019900497515,71,130,39,40.05417497389155,0.5169983416252073,46.02141203703703,7779.479829347805,109.57013844151838,0
2084,31.018692997941372,2,4,195,0.010050251256281407,0.020100502512562814,0.9798994974874372,199,7050,5100,1950,0.723404255319149,90,51,39,204.61456701273525,0.4845016327428388,0.7702651570438648,0.11425419520405275,1004024.256511007,-5762.402296743435,998261.8542142635,2046,0,282.63819095477385,73,126,42,40.35978561549104,0.52428810720268,45.56587837837838,7892.213906781957,108.11251927098571,8
2085,31.04721470755493,7,1,201,0.034653465346534656,0.0049504950495049506,0.995049504950495,202,7100,5400,1700,0.7605633802816901,88,54,34,195.06758893955967,0.48430393412475575,0.7633979902452959,0.11062011313298252,1009646.5709273677,-8110.1355456209485,1001536.4353817467,2047,0,278.9950495049505,80,122,45,39.996932412216566,0.5286716171617162,44.971707818930035,7917.918143846716,98.97397679808395,0
2086,30.918413458134527,1,4,198,0.0049504950495049506,0.019801980198019802,0.9801980198019802,202,5350,3300,2050,0.616822429906542,74,33,41,202.61570564419293,0.48428289657323936,0.7711800036247067,0.11562441166402217,1007347.8647783471,-4929.1003097525645,1002418.7644685946,2048,0,279.990099009901,69,133,46,39.56001515681474,0.5304764851485149,44.73214285714288,7892.477149714928,114.38372680746272,0
2087,30.999428280985224,3,3,198,0.014925373134328358,0.014925373134328358,0.9850746268656716,201,6900,4900,2000,0.7101449275362319,89,49,40,213.00872001120803,0.4844558457711443,0.7865305422145716,0.11702069095549845,998416.4757620293,-4565.7168919657215,993850.7588700636,2049,0,281.2636815920398,76,125,33,40.792401790949334,0.5167910447761195,46.198593073593074,7867.698511628294,103.5223488372144,8
2088,31.166964716787643,3,2,199,0.014925373134328358,0.009950248756218905,0.9900497512437811,201,6550,4300,2250,0.6564885496183206,88,43,45,209.99296496792402,0.4844506633499171,0.7845036144584545,0.11625321539491061,1006181.5923323254,-4491.788825997857,1001689.8035063276,2050,0,282.1243781094527,78,123,37,40.563324857730954,0.5191749585406302,45.89926160337551,7919.548748117229,101.53267625791318,0
2089,31.449675849486095,8,1,206,0.03864734299516908,0.004830917874396135,0.9951690821256038,207,5300,3500,1800,0.660377358490566,71,35,36,194.53780299185968,0.4844675828213186,0.7749795625010547,0.10946064391776289,1020332.3541728709,-7001.357099539524,1013330.9970733314,2051,0,274.231884057971,75,132,43,40.31594700026902,0.5237520128824477,45.27138157894736,8011.13247892953,106.8150997190604,0
2090,31.973601768652678,4,4,206,0.01904761904761905,0.01904761904761905,0.9809523809523809,210,6950,5400,1550,0.7769784172661871,85,54,31,211.90100826332747,0.485207336523126,0.7936638876486188,0.11739063236660088,1032441.0172249402,-5194.941495524108,1027246.0757294161,2052,0,271.2761904761905,79,131,40,40.487406278287324,0.51875,45.87239583333332,8125.37481404677,102.85284574742747,8
2091,31.586532387947905,3,7,202,0.014354066985645933,0.03349282296650718,0.9665071770334929,209,7450,5400,2050,0.7248322147651006,95,54,41,202.3782601006629,0.4855654214206846,0.7819984035755021,0.11214979334073831,1020038.7608535821,-7963.266068643511,1012075.4947849385,2053,0,273.4593301435407,76,133,42,40.71715639305861,0.5178429027113238,45.86038961038958,8027.389034631829,105.62353992936617,8
2092,31.760674727620824,1,2,201,0.0049261083743842365,0.009852216748768473,0.9901477832512315,203,6450,4700,1750,0.7286821705426356,82,47,35,201.53444449992068,0.4851149831731942,0.7757291719360049,0.1122396954211629,1027221.8024140818,-5645.884934454014,1021575.9174796278,2054,0,282.26600985221677,68,135,42,40.541589996240646,0.520628078817734,45.66727053140098,8077.779093240195,118.79086901823815,0
2093,31.730278057448842,7,3,205,0.03365384615384615,0.014423076923076924,0.9855769230769231,208,6100,3800,2300,0.6229508196721312,84,38,46,225.37852005807426,0.48577095333209463,0.8023086432560476,0.124251429459525,1023058.5519487738,-1584.9155258060418,1021473.6364229678,2055,0,274.2307692307692,72,136,37,40.33841874578555,0.5138721955128205,46.061643835616415,8057.534650547321,111.9102034798239,8
2094,32.099221400366424,3,3,205,0.014423076923076924,0.014423076923076924,0.9855769230769231,208,6650,4000,2650,0.6015037593984962,93,40,53,222.29680391432484,0.48553192354143443,0.800068664522076,0.12366960968784675,1037830.9903677269,-2108.697567603209,1035722.2928001237,1980,0,265.21153846153845,66,142,39,40.05614657210399,0.517177483974359,45.708955223880594,8162.544546399143,123.67491736968398,0
2095,31.799338416026547,3,3,205,0.014423076923076924,0.014423076923076924,0.9855769230769231,208,6600,4800,1800,0.7272727272727273,84,48,36,204.13838903043666,0.4851932173603369,0.7882759171290574,0.11297377244734351,1026490.3468029114,-6290.782849672047,1020199.5639532394,1981,0,259.6923076923077,78,130,42,40.72554488842759,0.5185797275641026,45.91244725738395,8079.816076962407,103.58738560208215,7
2096,32.06492167972388,5,4,206,0.023809523809523808,0.01904761904761905,0.9809523809523809,210,6550,4800,1750,0.732824427480916,83,48,35,192.3148941699456,0.4849809182046024,0.7776108667841648,0.10754010813255593,1038340.2957988753,-8612.339180209694,1029727.9566186656,1982,0,257.96190476190475,70,140,46,40.616352473192684,0.5213789682539682,45.5105633802817,8160.183853528345,116.57405505040492,0
2097,31.899260578637744,2,3,205,0.009615384615384616,0.014423076923076924,0.9855769230769231,208,6700,5100,1600,0.7611940298507462,83,51,32,191.7996282589245,0.4846701582435278,0.774202228523899,0.10782461621396995,1034642.2604040445,-8611.199814706139,1026031.0605893384,1983,0,261.25961538461536,72,136,46,40.42033167124211,0.5232371794871795,45.30536529680366,8124.570520378222,112.8412572274753,0
2098,31.873337165248092,3,2,206,0.014423076923076924,0.009615384615384616,0.9903846153846154,208,6750,4700,2050,0.6962962962962963,88,47,41,212.0915422136673,0.48495273597175775,0.7963442827176659,0.11791082108405387,1030311.1364921195,-4645.944420293921,1025665.1920718256,1984,0,261.4855769230769,63,145,42,40.342945845602344,0.5222355769230769,45.735677083333336,8104.252493416441,128.63892846692764,8
2099,32.2431849764864,2,3,205,0.009615384615384616,0.014423076923076924,0.9855769230769231,208,7200,5400,1800,0.75,90,54,36,217.7860519999329,0.48521837839093274,0.7975645438112795,0.12152750159943279,1043446.513999221,-3350.380648603439,1040096.1333506176,1985,0,262.22115384615387,68,140,41,40.05113141862487,0.5244891826923077,45.591787439613526,8202.931057121814,120.6313390753208,8
2100,32.38460468678398,1,2,204,0.0048543689320388345,0.009708737864077669,0.9902912621359223,206,6450,4300,2150,0.6666666666666666,86,43,43,216.05206754177522,0.4851956547478096,0.792582469801689,0.12124850533641605,1049834.5007000756,-2286.217109412184,1047548.2835906635,1986,0,265.4514563106796,69,137,42,39.87073373853077,0.526243932038835,45.37202380952382,8246.026351124434,119.50762827716571,0
2101,32.47329818219033,5,8,201,0.023923444976076555,0.03827751196172249,0.9617224880382775,209,7050,5100,1950,0.723404255319149,90,51,39,210.68309319196513,0.4853382637099742,0.7918006667403086,0.1197573410527854,1056768.0458156515,-4321.367864225999,1052446.6779514255,1987,0,261.11483253588517,80,129,42,39.506775716638096,0.5319477671451356,44.88168724279836,8284.533041901912,103.5566630237739,8
2102,32.038210271256325,2,3,200,0.009852216748768473,0.014778325123152709,0.9852216748768473,203,6300,4400,1900,0.6984126984126984,82,44,38,222.4975843458302,0.4852155782080671,0.7985100920187964,0.1238447620478427,1036020.1270380071,-797.6048800764283,1035222.5221579307,1988,0,268.54679802955667,64,139,38,40.03074652887178,0.523758210180624,45.68910256410258,8147.666006323228,127.30728134880044,8
2103,32.05731168520398,5,5,200,0.024390243902439025,0.024390243902439025,0.975609756097561,205,5850,3800,2050,0.6495726495726496,79,38,41,211.70229312543026,0.48527319464371116,0.7904989858468014,0.11919580472859916,1040249.4501693263,-2805.361195336858,1037444.0889739894,1989,0,262.780487804878,70,135,43,39.85328841280808,0.5273882113821138,45.24647887323946,8166.71302966382,116.66732899519742,0
2104,32.38324268816851,4,5,199,0.0196078431372549,0.024509803921568627,0.9754901960784313,204,6100,4200,1900,0.6885245901639344,80,42,38,210.60209186992856,0.485020444959593,0.7893643802114361,0.11965422254869738,1053687.0065478908,-2518.262448969884,1051168.7440989208,1990,0,264.7549019607843,76,128,43,39.52743013204647,0.5302287581699346,44.8998917748918,8260.968714431787,108.6969567688393,0
2105,32.4554160333405,1,4,196,0.005,0.02,0.98,200,5700,3700,2000,0.6491228070175439,77,37,40,215.707956933072,0.48399968592964826,0.7912322274881518,0.12301183489967035,1057209.9534162923,-90.28017985286124,1057119.6732364395,1991,0,270.715,61,139,45,39.25229287344214,0.53265625,44.75806451612902,8283.98320528406,135.80300336531243,0
2106,31.987408299348537,1,3,194,0.005076142131979695,0.015228426395939087,0.9847715736040609,197,6300,4700,1600,0.746031746031746,79,47,32,201.17605215973666,0.48402590731724165,0.7723428857800207,0.11354754816220802,1038749.164180561,-3905.708793185723,1034843.4553873752,1992,0,272.6345177664975,77,120,40,40.025317036105434,0.5352686125211505,45.15224358974359,8151.919238467789,105.8690810190622,8
2107,32.4129269576605,4,5,193,0.020202020202020204,0.025252525252525252,0.9747474747474747,198,6300,3900,2400,0.6190476190476191,87,39,48,202.40242355319984,0.4842374677400058,0.7744460358918202,0.11604262221780086,1057507.1811339979,-3091.5967227135457,1054415.5844112844,1993,0,271.9040404040404,65,133,46,39.38465400061784,0.539246632996633,44.554924242424214,8279.722582224294,127.3803474188353,0
2108,32.239121441035444,1,2,192,0.005154639175257732,0.010309278350515464,0.9896907216494846,194,6800,5100,1700,0.75,85,51,34,202.3259656106331,0.48383277246585826,0.7695877523895638,0.11677818181095001,1053924.8947906273,-2952.7255960804628,1050972.1691945468,1994,0,277.1701030927835,67,127,46,39.12802540138988,0.5417740549828178,44.301470588235276,8243.495942000018,123.0372528656719,0
2109,31.84796666047899,3,7,188,0.015384615384615385,0.035897435897435895,0.9641025641025641,195,5350,3600,1750,0.6728971962616822,71,36,35,222.1661837262128,0.48392149088025377,0.7883113228953946,0.12887463429703244,1042678.6279872586,1979.5863265622947,1044658.2143138209,1995,0,276.63589743589745,68,127,34,38.42735988200591,0.5384081196581196,44.11231884057969,8149.502338392449,119.84562262341836,8
2110,31.566212647726235,5,2,191,0.025906735751295335,0.010362694300518135,0.9896373056994818,193,6850,5600,1250,0.8175182481751825,81,56,25,214.43817990809399,0.4834923269286126,0.7787095437675788,0.1254052605618398,1035914.8286697064,-1022.0619200527981,1034892.7667496536,1996,0,274.25906735751295,71,122,40,38.31413297191473,0.5416666666666667,43.80787037037035,8087.015242562694,113.90162313468583,0
2111,31.728795495275904,0,3,188,0.0,0.015706806282722512,0.9842931937172775,191,6400,4800,1600,0.75,80,48,32,211.9551506544352,0.48272021677229726,0.7667181284721167,0.12271745166574125,1038194.929246437,-589.8474725799297,1037605.0817738571,1997,1,277.8219895287958,71,120,43,38.761876484560574,0.5394851657940662,44.18402777777779,8116.732667064103,114.32017840935357,8
2112,31.755106502915265,0,3,185,0.0,0.015957446808510637,0.9840425531914894,188,6050,4200,1850,0.6942148760330579,79,42,37,215.61263286159615,0.482011723935222,0.764924691596699,0.12537682401634273,1040379.6563931257,1213.7993781129298,1041593.4557712385,1998,2,283.1914893617021,72,116,41,38.501890666517994,0.5411679964539007,44.021118721461185,8128.636637497101,112.89773107634863,0
2113,31.989100995315326,2,1,186,0.0106951871657754,0.0053475935828877,0.9946524064171123,187,6500,4500,2000,0.6923076923076923,85,45,40,199.59220706366503,0.48196145515879857,0.7492203575932319,0.11401586959098288,1042550.3534865057,-2283.014794524671,1040267.338691981,1999,0,285.58288770053474,73,114,39,39.59740447703594,0.5379344919786097,44.69313063063065,8167.03722905457,111.87722231581603,8
2114,31.9834349014836,4,0,190,0.021052631578947368,0.0,1.0,190,6600,5000,1600,0.7575757575757576,82,50,32,195.19825457364684,0.4818875893437297,0.7444201530358725,0.11256619116186944,1045297.4085551036,-3791.954067937201,1041505.4544871664,2000,0,281.9947368421053,81,109,41,39.343800722117315,0.5412280701754386,44.33434959349596,8177.065686321948,100.9514282261969,0
2115,31.512497674319693,1,1,190,0.005235602094240838,0.005235602094240838,0.9947643979057592,191,6350,4200,2150,0.6614173228346457,85,42,43,193.10741079870766,0.48186598695692107,0.7438216234027757,0.11192938708093929,1031455.0344449251,-4713.677788609597,1026741.3566563155,2001,0,281.5130890052356,84,107,37,39.20135230066741,0.5427028795811518,44.14215686274511,8062.719686819226,95.98475817641936,0
2116,31.237698866435817,1,3,188,0.005235602094240838,0.015706806282722512,0.9842931937172775,191,5050,4000,1050,0.7920792079207921,61,40,21,229.64030823671192,0.4817523192798751,0.7897312848317732,0.13273068788257053,1021613.152858509,3670.7118642215323,1025283.8647227305,2002,0,281.69633507853405,68,123,44,38.375095921138076,0.5389397905759162,44.24818840579711,7989.098075125156,117.48673639889935,8
2117,31.54613079451853,4,1,191,0.020833333333333332,0.005208333333333333,0.9947916666666666,192,6300,4600,1700,0.7301587301587301,80,46,34,217.76574690053496,0.4819713723458406,0.7805434044423138,0.12548600774434132,1030776.229055116,193.55108150085107,1030969.7801366168,2003,0,280.7864583333333,67,125,42,38.79584132310639,0.5345594618055556,44.36274509803921,8064.366279088923,120.36367580729735,8
2118,31.293677471818604,7,4,194,0.03535353535353535,0.020202020202020204,0.9797979797979798,198,6000,3500,2500,0.5833333333333334,85,35,50,211.67541531979597,0.48307845801500626,0.7789728476832054,0.12384320921041221,1027100.8986446527,-2117.5981408111893,1024983.3005038415,2004,0,273.020202020202,74,124,41,38.36836612999403,0.538510101010101,43.791666666666686,8017.700948925571,108.34731012061582,0
2119,31.316941037014505,1,2,193,0.005128205128205128,0.010256410256410256,0.9897435897435898,195,8000,6200,1800,0.775,98,62,36,213.90249618560193,0.48240043175610187,0.7786107067766457,0.12559915801667373,1028947.5206267169,-2981.111378791963,1025966.4092479249,2005,0,278.2102564102564,66,129,42,38.17346959404819,0.5399038461538461,43.65671641791044,8027.887497174967,121.63465904810556,0
2120,31.086322220967833,3,1,195,0.015306122448979591,0.00510204081632653,0.9948979591836735,196,6100,4200,1900,0.6885245901639344,80,42,38,208.15244429951508,0.4821712018140589,0.7727914429137079,0.123191388276919,1023711.4624069226,-2682.3913685137695,1021029.0710384088,2006,0,277.6683673469388,69,127,42,38.02113533573003,0.5428358843537415,43.36309523809522,7977.897515220364,115.6217031191357,0
2121,31.556853986978833,0,3,192,0.0,0.015384615384615385,0.9846153846153847,195,5300,3500,1800,0.660377358490566,71,35,36,229.5843345038188,0.4820700061679443,0.7928455609201246,0.1332847136475592,1033391.6416881559,3150.1064677567,1036541.7481559126,2007,1,277.8205128205128,68,127,37,38.206652115777885,0.5378205128205128,44.082125603864725,8075.9629949768105,118.76416169083545,8
2122,31.155687734589687,2,2,192,0.010309278350515464,0.010309278350515464,0.9896907216494846,194,6550,4800,1750,0.732824427480916,83,48,35,231.24098013076522,0.4819615449673273,0.7895099588932879,0.1313592679492469,1013696.2692591044,1531.623771674862,1015227.8930307792,2008,0,280.1958762886598,81,113,37,39.00717718241123,0.5366731099656357,44.905995934959336,7947.629133616522,98.11887819279657,8
2123,31.11693396858251,2,0,194,0.010309278350515464,0.0,1.0,194,6600,4600,2000,0.696969696969697,86,46,40,230.08219536429408,0.48175900949023376,0.7912187678163867,0.1322791551312661,1016061.1392200439,1355.5155072185325,1017416.6547272624,2009,0,278.7216494845361,66,128,37,38.5698677779806,0.5395725945017182,44.44962686567164,7951.944086467509,120.48400131011377,0
2124,30.817715212814043,1,2,193,0.005128205128205128,0.010256410256410256,0.9897435897435898,195,5950,4100,1850,0.6890756302521008,78,41,37,224.13593439357473,0.48191580756013747,0.7830254744107275,0.12682722482649145,1001527.0585705955,-54.35938136653385,1001472.6991892289,2010,0,278.2871794871795,82,113,37,39.340992254930875,0.5366452991452991,45.05522088353411,7856.815597804965,95.81482436347518,8
2125,31.22734160386007,2,3,192,0.010256410256410256,0.015384615384615385,0.9846153846153847,195,5950,4500,1450,0.7563025210084033,74,45,29,198.56434068052366,0.48199951537580404,0.7667672136793129,0.11395925925222854,1019137.2275081022,-4477.137671375509,1014660.0898367267,2011,0,278.85641025641024,67,128,46,39.44292880841027,0.5388888888888889,44.515931372549005,7978.088285373415,119.07594455781216,8
2126,31.335722436073457,3,4,191,0.015384615384615385,0.020512820512820513,0.9794871794871794,195,5650,4100,1550,0.7256637168141593,72,41,31,208.80367643763358,0.4821570182394925,0.7753783541339316,0.11822585189416034,1018553.9410783224,-2114.4384905615157,1016439.5025877608,2012,0,279.0974358974359,86,109,39,39.707286530484424,0.5381410256410256,45.031130268199206,7989.633731755011,92.90271781110478,6
2127,30.890775625742698,3,2,192,0.015463917525773196,0.010309278350515464,0.9896907216494846,194,5900,3700,2200,0.6271186440677966,81,37,44,206.21444837650608,0.4817651300678383,0.7736583491667115,0.1176361298629826,1006340.415009134,-3195.6132879814186,1003144.8017211526,2013,0,280.66494845360825,67,127,42,39.481998539678706,0.5412371134020619,44.74571078431372,7885.0029756702,117.68661157716716,0
2128,31.430695089658855,4,6,190,0.02040816326530612,0.030612244897959183,0.9693877551020408,196,6350,4400,1950,0.6929133858267716,83,44,39,224.61649792585536,0.48148111808826094,0.7945526038859954,0.13121957780318488,1031150.6729185946,772.6905969727109,1031923.3635155673,2014,0,271.7959183673469,74,122,39,38.09360823437983,0.5451743197278911,43.84722222222222,8051.059854702468,108.79810614462795,7
2129,31.415595363786768,1,2,189,0.005235602094240838,0.010471204188481676,0.9895287958115183,191,6100,4300,1800,0.7049180327868853,79,43,36,236.96085601372403,0.48118627721135304,0.7921033861784907,0.13264379468703041,1017635.229996051,3927.94304191775,1021563.1730379688,2015,0,278.78010471204186,65,126,42,39.43897139372896,0.5290139616055847,45.470328282828305,7996.201174744193,123.01847961144912,8
2130,30.95931264323394,5,2,192,0.02577319587628866,0.010309278350515464,0.9896907216494846,194,6300,4500,1800,0.7142857142857143,81,45,36,228.72317652819234,0.48163103377668576,0.786425751798943,0.12946874349454296,1006235.7364907134,929.886797268262,1007165.6232879817,2016,0,275.19072164948454,74,120,36,39.21017867843331,0.5329145189003437,45.04166666666667,7893.334752664528,106.66668584681796,8
2131,30.633014069205814,5,1,196,0.025380710659898477,0.005076142131979695,0.9949238578680203,197,6750,5400,1350,0.8,81,54,27,227.4489298705605,0.48163243723885496,0.7890606640991706,0.1304311676245348,999500.9612508009,-682.9151917816971,998818.0460590192,2017,0,271.8578680203046,67,130,40,38.736307667706114,0.536008883248731,44.54656862745099,7825.308557262208,116.79565010839116,0
2132,30.275000987452998,1,1,196,0.005076142131979695,0.005076142131979695,0.9949238578680203,197,6500,4800,1700,0.7384615384615385,82,48,34,229.03678750143015,0.4816604941468973,0.7919277996767147,0.13225027407340664,989838.0679989625,-558.1337517790489,989279.9342471834,2018,0,272.83756345177665,69,128,40,38.428916433892,0.5384412013536379,44.28571428571429,7741.750252505852,112.19927902182394,0
2133,30.61938140972824,1,2,195,0.005076142131979695,0.01015228426395939,0.9898477157360406,197,5800,4300,1500,0.7413793103448276,73,43,30,222.76561705610533,0.48165294036396283,0.7856982367659278,0.12674219826150548,996711.5864833317,-793.3856820141591,995918.2008013176,2019,0,273.8172588832487,75,122,43,39.16254834550925,0.5326247884940778,44.84649122807018,7812.642603118166,104.16856804157555,8
2134,30.995965027683837,2,1,196,0.01015228426395939,0.005076142131979695,0.9949238578680203,197,6450,4600,1850,0.7131782945736435,83,46,37,207.9228490376464,0.4817489813184157,0.7798818040163946,0.11795818216135738,1008103.0081738915,-3928.470083412568,1004174.5380904789,2020,0,274.78680203045684,75,122,41,39.653195758096885,0.5333650592216582,44.95614035087719,7905.330554209708,105.40440738946278,8
2135,30.730104925641875,4,1,199,0.02,0.005,0.995,200,6100,4700,1400,0.7704918032786885,75,47,28,202.89883558636237,0.4815871021775544,0.7778507167276432,0.11621203317524653,1002308.1375159413,-5426.569199855923,996881.5683160854,2021,0,271.175,67,133,42,39.4103365721026,0.5364583333333333,44.59252450980393,7848.698520607047,117.14475403891115,0
2136,31.04488832068562,3,1,201,0.01485148514851485,0.0049504950495049506,0.995049504950495,202,5600,3800,1800,0.6785714285714286,74,38,36,217.70506879076254,0.48196825279542876,0.7888628291799229,0.12317798211338624,1008884.3872992254,-2072.1510122191994,1006812.2362870062,2022,0,269.18811881188117,81,121,34,39.50822786386965,0.5318688118811881,45.05843495934959,7914.632414987795,97.71151129614562,8
2137,31.438444461360096,1,1,201,0.0049504950495049506,0.0049504950495049506,0.995049504950495,202,6800,4900,1900,0.7205882352941176,87,49,38,218.67915254441974,0.4815551984302908,0.7909201009531359,0.12464636881774177,1023936.1856142944,-2417.3005340598793,1021518.8850802345,2023,0,270.1782178217822,67,135,38,39.195138847208085,0.5339830858085808,44.776348039215705,8023.83460739465,119.75872548350225,0
2138,31.944719932133612,3,3,201,0.014705882352941176,0.014705882352941176,0.9852941176470589,204,5950,4100,1850,0.6890756302521008,78,41,37,210.6466154811711,0.4814209448147075,0.7854650478507383,0.1213172182214593,1043631.1683867183,-2782.5253137352756,1040848.643072983,2024,0,268.5049019607843,73,131,41,38.99896974870127,0.5366115196078431,44.38344594594597,8165.59922927391,111.8575236886837,0
2139,31.690635457043054,0,3,198,0.0,0.014925373134328358,0.9850746268656716,201,6950,4700,2250,0.6762589928057554,92,47,45,230.8185833685493,0.48088101160862357,0.801488637865917,0.13224666041630712,1033738.0150919807,571.1888435495212,1034309.2039355303,2025,1,272.2089552238806,63,138,38,38.68451167187067,0.5337893864013268,44.58007812500001,8094.41963260706,128.48285131122316,8
2140,31.368368643301462,3,3,198,0.014925373134328358,0.014925373134328358,0.9850746268656716,201,6200,4300,1900,0.6935483870967742,81,43,38,218.7310868925809,0.4809784411276949,0.7839298563517192,0.1246738528041729,1021648.6653435705,-1706.7354014089751,1019941.9299421615,2026,0,272.8805970149254,70,131,42,39.194474783475144,0.5365360696517413,44.77699530516434,8005.929297518714,114.37041853598163,8
2141,31.29660019072813,3,3,198,0.014925373134328358,0.014925373134328358,0.9850746268656716,201,6250,4700,1550,0.752,78,47,31,207.29179613058346,0.4812790215588723,0.7724531284661609,0.11883411887067673,1021055.9160492643,-4118.697042477695,1016937.2190067866,2027,0,273.4577114427861,75,126,40,39.26357291051846,0.5354995854063018,44.55866228070177,7994.445418785675,106.592605583809,8
2142,31.195277864788725,6,1,203,0.029411764705882353,0.004901960784313725,0.9950980392156863,204,6850,4500,2350,0.656934306569343,92,45,47,205.43089925957435,0.4814239632634663,0.7738224334644619,0.11944038259117153,1021998.406054207,-5659.989680486346,1016338.4163737206,2028,0,270.0,82,122,39,38.767609662025286,0.5401858660130718,44.0261044176707,7985.176798823222,97.38020486369783,0
2143,31.046130571657468,3,0,206,0.014563106796116505,0.0,1.0,206,6400,4300,2100,0.671875,85,43,42,200.05522013151682,0.4817906898729181,0.7716985598989881,0.11735197964415783,1019755.5271498249,-6798.516707142153,1012957.0104426828,2029,0,266.05825242718447,73,133,42,38.566152240773306,0.5430319579288025,43.693693693693696,7957.319051924821,109.00437057431262,0
2144,31.17171292424933,0,1,205,0.0,0.0048543689320388345,0.9951456310679612,206,7150,5600,1550,0.7832167832167832,87,56,31,230.41740699083394,0.4816426908201121,0.8057630072193191,0.1317987567987568,1016311.1568685805,-1514.843707697457,1014796.313160883,2030,1,267.05825242718447,62,144,40,38.75898407148408,0.5316039644012944,44.64285714285714,7959.919550299372,128.38579919837696,8
2145,31.507268884153255,0,4,201,0.0,0.01951219512195122,0.9804878048780488,205,7400,5200,2200,0.7027027027027027,96,52,44,218.64621279068533,0.4813526223497529,0.7988244865430281,0.12401207976429215,1024659.0691990417,-3592.43502360007,1021066.6341754416,2031,2,269.3414634146341,71,134,37,39.38904016337648,0.5296747967479675,44.96527777777778,8035.447567850892,113.17531785705481,8
2146,31.896287723398515,0,3,198,0.0,0.014925373134328358,0.9850746268656716,201,5600,4100,1500,0.7321428571428571,71,41,30,221.13197626988415,0.4809660033167496,0.7979289145501929,0.1256642553004765,1037910.3056070331,103.03141395251623,1038013.3370209855,2032,3,275.1592039800995,72,129,38,39.25028899578625,0.5317164179104478,44.891552511415526,8137.012441765396,113.01406169118606,0
2147,31.41923698601431,0,5,193,0.0,0.025252525252525252,0.9747474747474747,198,5950,4000,1950,0.6722689075630253,79,40,39,227.08934422221103,0.48063438958109006,0.8002225047679583,0.1298951048951049,1024381.3410826011,975.2173959834508,1025356.5584785845,2033,4,280.23737373737373,62,136,37,38.84396853146851,0.5335648148148149,44.642857142857146,8023.126587500093,129.40526754032408,0
2148,30.969004356972423,2,0,195,0.010256410256410256,0.0,1.0,195,5550,3700,1850,0.6666666666666666,74,37,37,215.35430149127183,0.48020971010661734,0.7837107021708294,0.12024132186641684,1002391.0845386173,-1376.1536336213726,1001014.9309049959,2034,0,283.96923076923076,66,129,40,40.0897494653223,0.5245726495726496,45.56902985074628,7879.473823100992,119.3859670166817,8
2149,30.657343044005664,1,2,194,0.00510204081632653,0.01020408163265306,0.9897959183673469,196,5700,4100,1600,0.7192982456140351,73,41,32,217.88437476074807,0.4802323172858887,0.7788865162215004,0.12159621485775157,992160.2060332263,-1664.7587691911267,990495.4472640352,2035,0,283.515306122449,71,125,42,40.044130888067464,0.5264136904761905,45.58738425925925,7799.614835486676,109.85373007727713,8
2150,30.89055761551252,5,0,199,0.02512562814070352,0.0,1.0,199,5950,3800,2150,0.6386554621848739,81,38,43,211.22103435643376,0.4809167893338748,0.7755509685597535,0.11920257175573684,1003093.511053486,-3375.110207811238,999718.4008456748,2036,0,279.79899497487435,76,123,37,39.77410464663623,0.5291561976549414,45.1569264069264,7872.244647741129,103.58216641764643,0
2151,31.24217024264013,0,5,194,0.0,0.02512562814070352,0.9748743718592965,199,6050,4900,1150,0.8099173553719008,72,49,23,232.12699970932897,0.4809802378897856,0.7913333928022754,0.12743548105201383,1006020.0801169676,854.8845689781447,1006874.9646859457,2037,1,280.79899497487435,76,123,37,40.334861488707666,0.5227701005025125,46.22564935064936,7928.461466202489,104.32186139740116,8
2152,31.260941871613877,3,0,197,0.015228426395939087,0.0,1.0,197,5200,3000,2200,0.5769230769230769,74,30,44,211.93916335017826,0.48108316930833245,0.7746306364033817,0.11554102776187139,1004449.2308945598,-2023.5740752953698,1002425.6568192644,2038,0,283.2994923857868,74,123,39,41.12734220907296,0.5215736040609137,46.5,7924.64876445412,107.08984816829893,8
2153,30.98441216510708,5,5,197,0.024752475247524754,0.024752475247524754,0.9752475247524752,202,5350,3500,1850,0.6542056074766355,72,35,37,212.9007641198078,0.4817645477234291,0.779690680588982,0.11705390758208296,998175.8330923065,-3247.5204817443764,994928.3126105621,2039,0,277.26237623762376,80,122,36,40.76358631404732,0.5231538778877888,46.16769547325104,7864.844744275788,98.31055930344735,8
2154,31.050905274217676,1,2,196,0.005050505050505051,0.010101010101010102,0.98989898989899,198,5750,4200,1550,0.7304347826086957,73,42,31,214.08797891285414,0.4814878907518501,0.7846882716219112,0.11592166326263932,995593.9090200741,-2721.0624399890953,992872.846580085,2040,0,283.24242424242425,67,131,39,41.346371967818015,0.5213594276094276,46.76776960784312,7863.089998285697,117.35955221321936,8
2155,31.064372168691538,5,5,196,0.024875621890547265,0.024875621890547265,0.9751243781094527,201,6750,4500,2250,0.6666666666666666,90,45,45,205.17896563854697,0.4819558457711443,0.7788469620946274,0.11250202505531731,999913.4243189724,-5917.759574027263,993995.6647449451,2041,0,279.88557213930346,77,124,36,41.06811542712774,0.5247201492537313,46.27403846153845,7881.837698089863,102.3615285466216,0
2156,30.7399019901919,7,8,195,0.034482758620689655,0.03940886699507389,0.9605911330049262,203,6800,4600,2200,0.6764705882352942,90,46,44,197.75096409871267,0.48215200214602744,0.7636645678264808,0.10846182017652584,989561.1462528581,-8262.665858773886,981298.4803940842,2042,0,275.83251231527095,84,119,27,41.244566529823715,0.5263752052545156,46.26225490196079,7799.873415526029,92.85563589911939,8
2157,30.34618537546935,5,3,197,0.025,0.015,0.985,200,6250,4600,1650,0.736,79,46,33,211.24652134854426,0.48170540201005024,0.7778059600732952,0.11707189630481302,980003.2897698012,-4845.542825200027,975157.7469446012,2043,0,278.875,84,116,35,40.4891784807278,0.5294791666666667,45.857843137254896,7712.245003878462,91.81244052236264,0
2158,30.640201276139695,5,2,200,0.024752475247524754,0.009900990099009901,0.9900990099009901,202,7100,5200,1900,0.7323943661971831,90,52,38,199.46279831112818,0.4821021747697158,0.7646159499153489,0.111126062675985,991091.7464669312,-7962.813373328745,983128.9330936024,2044,0,277.0049504950495,80,122,34,40.580021572791296,0.5284137788778878,45.653292181069936,7793.234321495455,97.41542901869319,8
2159,30.977354175421848,5,6,199,0.024390243902439025,0.02926829268292683,0.9707317073170731,205,6400,4900,1500,0.765625,79,49,30,195.67592102425513,0.48262693288697595,0.7726671116713679,0.10777003674598479,998480.021777748,-8324.30042286421,990155.7213548839,2045,0,272.3609756097561,81,124,35,41.131891979786914,0.5213922764227642,46.10010162601626,7865.147077034505,97.10058119795686,8
2160,31.37888709020259,7,2,204,0.03398058252427184,0.009708737864077669,0.9902912621359223,206,6750,5100,1650,0.7555555555555555,84,51,33,208.27386184539753,0.48311182808430025,0.7850106235933274,0.11575600405031662,1014241.3815391192,-5702.006124687367,1008539.3754144318,2046,0,270.5145631067961,71,135,38,40.45109252304543,0.5264461974110033,45.74652777777777,7978.190997153058,112.36888728384588,8
2161,31.736795409846962,5,1,208,0.023923444976076555,0.004784688995215311,0.9952153110047847,209,6150,4100,2050,0.6666666666666666,82,41,41,209.7082111319362,0.48339544227702125,0.7890324601258292,0.11765515269709796,1028746.2607500738,-4802.692389887039,1023943.5683601868,2047,0,267.555023923445,73,136,40,40.04335286746277,0.5296052631578947,45.38288288288286,8080.731353790938,110.69495005193065,8
2162,31.897204881624468,5,5,208,0.023474178403755867,0.023474178403755867,0.9765258215962441,213,6100,4700,1400,0.7704918032786885,75,47,28,207.8594158365417,0.48379414326630643,0.7881915626085565,0.11757862194061977,1036506.7113831143,-5610.464092250372,1030896.247290864,2048,0,263.5023474178404,82,131,37,39.76876466630564,0.5331083724569641,45.06777108433734,8131.62553665205,99.16616508112256,8
2163,32.10873830569722,3,4,207,0.014218009478672985,0.018957345971563982,0.981042654028436,211,6500,4800,1700,0.7384615384615385,82,48,34,211.74510620574702,0.48325998645903856,0.7916046039268778,0.12064546748932123,1045641.82769069,-4418.092028492586,1041223.7356621975,2049,0,266.1516587677725,82,129,42,39.387755102040764,0.5359399684044234,44.79166666666667,8194.417588433163,99.93192181016053,0
2164,32.19794859054676,1,4,204,0.004807692307692308,0.019230769230769232,0.9807692307692307,208,6750,4200,2550,0.6222222222222222,93,42,51,213.48439082325586,0.4829669500185805,0.7908430944544227,0.12241504050345722,1050541.289591086,-3495.1665513937696,1047046.1230396923,2050,0,270.21153846153845,72,136,37,39.09560849811943,0.5385616987179487,44.54908675799088,8224.995371974452,114.2360468329785,0
2165,31.869226255003365,2,3,203,0.009708737864077669,0.014563106796116505,0.9854368932038835,206,6650,4300,2350,0.6466165413533834,90,43,47,191.4640148406358,0.4828987094482595,0.7707216446722427,0.10917171926855178,1038074.0903462976,-8099.233392051125,1029974.8569542465,2051,0,273.08252427184465,72,134,41,39.876260226235075,0.5346379449838188,44.763127853881294,8134.201627044059,112.97502259783415,8
2166,32.17519403541722,3,3,203,0.014563106796116505,0.014563106796116505,0.9854368932038835,206,5450,3600,1850,0.6605504587155964,73,36,37,191.21581855545554,0.48324601389217775,0.7698119250575788,0.10763398657536793,1043995.0661289528,-6724.325772459033,1037270.7403564937,2052,0,273.6407766990291,73,133,45,40.38508914921444,0.5274575242718447,45.256193693693696,8196.431397226148,112.27988215378285,8
2167,32.02082355852861,3,3,203,0.014563106796116505,0.014563106796116505,0.9854368932038835,206,7050,5400,1650,0.7659574468085106,87,54,33,206.5671853778499,0.4835281987528613,0.7870747035284613,0.11404067630482707,1032871.2459482255,-5578.538773352857,1027292.7071748726,2053,0,273.34466019417476,77,129,42,40.76028138528136,0.5163329288025891,46.006944444444414,8133.066817035923,105.62424437708991,8
2168,31.966269421177337,3,2,204,0.014563106796116505,0.009708737864077669,0.9902912621359223,206,7450,5300,2150,0.7114093959731543,96,53,43,207.76359508582564,0.48336342647407055,0.7883439368748089,0.11586325640062306,1034290.807966342,-5672.404674537907,1028618.403291804,2054,0,273.9854368932039,66,140,43,40.33049138247161,0.5189623786407767,45.615671641791046,8131.717976823752,123.20784813369322,0
2169,31.71275703881529,4,2,206,0.019230769230769232,0.009615384615384616,0.9903846153846154,208,6950,5600,1350,0.8057553956834532,83,56,27,206.59358918809613,0.48393032717081635,0.7865503620371908,0.11655795899933127,1029704.3079760851,-6003.938242555212,1023700.3697335299,2055,0,271.8942307692308,71,137,36,39.90315468755913,0.5230869391025641,45.16782407407407,8081.430880811514,113.82297015227485,8
2170,32.13095459507216,0,2,204,0.0,0.009708737864077669,0.9902912621359223,206,7000,5100,1900,0.7285714285714285,89,51,38,214.3825550824465,0.48386859657431525,0.7931921987902157,0.12179756151387353,1045466.3762884702,-3374.049399698211,1042092.3268887721,2056,1,275.4757281553398,75,131,39,39.4324450175514,0.5261427993527508,44.901315789473685,8196.564239631076,109.28752319508101,8
2171,31.668141043589028,0,2,202,0.0,0.00980392156862745,0.9901960784313726,204,7700,5600,2100,0.7272727272727273,98,56,42,232.21896778992448,0.4837994824366528,0.8018479317370426,0.126216423425715,1016583.0612297339,-1286.026169702085,1015297.0350600318,2057,2,278.9901960784314,68,136,34,40.734355139815705,0.5116932189542484,46.618357487922694,8024.125592928691,118.0018469548337,8
2172,31.907536029808185,5,2,205,0.024154589371980676,0.00966183574879227,0.9903381642512077,207,6600,4900,1700,0.7424242424242424,83,49,34,242.0186983794757,0.484607312039773,0.8113683310629836,0.12988962184345612,1020228.3046138916,1382.8652665110349,1021611.1698804026,2058,0,275.85990338164254,76,131,35,40.99830150323654,0.5086050724637681,47.11850649350652,8068.825365330217,106.16875480697654,8
2173,32.184866874072355,5,7,203,0.023809523809523808,0.03333333333333333,0.9666666666666667,210,6400,4600,1800,0.71875,82,46,36,220.8852445168189,0.48460497835497834,0.7916115385632316,0.12047677933821692,1034292.1810007627,-2708.0237395623044,1031584.1572612005,2059,0,272.5047619047619,73,137,39,40.88099204145846,0.5152281746031746,46.48085585585587,8159.479904308072,111.77369731928866,8
2174,31.96458081150833,7,2,208,0.03333333333333333,0.009523809523809525,0.9904761904761905,210,6950,5200,1750,0.7482014388489209,87,52,35,209.10166179884908,0.4846173198146882,0.7809709325600238,0.1154913708485829,1031198.0225052233,-5824.955970094102,1025373.0665351292,2060,0,266.0952380952381,79,131,39,40.678183309411516,0.5192956349206349,45.989583333333336,8119.336490506577,102.77641127223515,0
2175,32.299709637600934,3,6,205,0.014218009478672985,0.02843601895734597,0.9715639810426541,211,7000,4400,2600,0.6285714285714286,96,44,52,187.54546102482556,0.4846723839614835,0.7623660229808957,0.10464147267243919,1045241.2057518488,-9993.951237025554,1035247.2545148232,2061,0,265.6350710900474,78,133,42,40.824759856259284,0.527794233807267,45.5959915611814,8217.175603215528,105.34840516942985,7
2176,32.08240988240382,5,5,205,0.023809523809523808,0.023809523809523808,0.9761904761904762,210,6150,4400,1750,0.7154471544715447,79,44,35,226.14931243774902,0.48434723171565275,0.8045278497589783,0.1258922393993862,1037486.7685497019,-1224.6161258442653,1036262.1524238576,2062,0,267.44761904761907,62,148,41,39.9331968012483,0.5215277777777778,45.68452380952384,8159.053346581624,131.59763462228426,8
2177,32.38241043029022,1,2,204,0.0048543689320388345,0.009708737864077669,0.9902912621359223,206,6100,4400,1700,0.7213114754098361,78,44,34,224.55434782181902,0.4844082997868813,0.8004457301666574,0.1256128072475639,1048734.8242508438,-200.40710046392905,1048534.4171503799,2063,0,271.0728155339806,64,142,47,39.78181474718219,0.5236144822006472,45.49679487179491,8241.42724428596,128.77230069196813,0
2178,32.2378984437556,8,4,208,0.03773584905660377,0.018867924528301886,0.9811320754716981,212,6700,5200,1500,0.7761194029850746,82,52,30,220.90312117199545,0.4849930325792125,0.7995032867689602,0.12362023697070199,1044182.4524882269,-2967.3674344646697,1041215.0850537623,2064,0,264.33962264150944,70,142,41,39.858821381907575,0.5186713836477987,45.48122065727698,8205.150560479311,117.21643657827588,8
2179,32.06625881231198,0,1,207,0.0,0.004807692307692308,0.9951923076923077,208,6550,4500,2050,0.6870229007633588,86,45,41,217.94755841056187,0.4848051568499938,0.7983178621546212,0.12271451075088206,1040545.9277405723,-2793.111126977888,1037752.8166135944,2065,1,270.0192307692308,77,131,42,39.693419305235224,0.5215845352564102,45.2457264957265,8169.0164677305565,106.0911229575397,8
2180,32.025262071921546,2,5,204,0.009569377990430622,0.023923444976076555,0.9760765550239234,209,5650,4100,1550,0.7256637168141593,72,41,31,218.59944953251633,0.48512740001226845,0.801221651829229,0.12395740644307636,1041434.0117285545,-1918.61966233967,1039515.3920662148,2066,0,269.622009569378,79,130,39,39.399103100854354,0.5236742424242424,44.97395833333333,8167.275819539771,103.38323822202241,0
2181,32.241729642285705,2,0,206,0.009708737864077669,0.0,1.0,206,7100,5400,1700,0.7605633802816901,88,54,34,230.1624494107446,0.48466877811982,0.809763508447058,0.12797307213315867,1042258.8601013658,-322.2295678037394,1041936.630533562,2067,0,274.2281553398058,60,146,38,39.87855383926571,0.5160295307443366,45.73087431693989,8198.07640665359,136.63460677755984,8
2182,32.70068369713443,8,5,209,0.037383177570093455,0.02336448598130841,0.9766355140186916,214,7150,5200,1950,0.7272727272727273,91,52,39,214.59969884214107,0.4853985674169628,0.8033051491406797,0.12152258605987513,1062960.7786355945,-4327.787404758694,1058632.991230836,2068,0,264.9392523364486,70,144,37,39.554682854786435,0.5205899532710281,45.026408450704224,8337.81076837587,119.11158240536957,0
2183,32.48725887190643,2,1,210,0.009478672985781991,0.004739336492890996,0.995260663507109,211,7150,5300,1850,0.7412587412587412,90,53,37,227.25537893640822,0.4850842548709848,0.8046893868832332,0.12736724330244162,1052740.8394320074,-1501.7963226092224,1051239.043109398,2069,0,269.49763033175356,65,146,43,39.63758007852864,0.522018167456556,45.42297979797981,8270.509558141597,127.2386085867938,8
2184,32.20920484404574,2,6,206,0.009433962264150943,0.02830188679245283,0.9716981132075472,212,6450,4700,1750,0.7286821705426356,82,47,35,221.11886031087843,0.48510900101344306,0.7991922677769863,0.12496942329929434,1046369.5040786585,-2575.5935588135553,1043793.910519845,2070,0,269.1933962264151,73,139,39,39.46506148295413,0.5244202044025157,45.101351351351354,8210.082788794776,112.46688751773667,0
2185,32.41674629027227,5,5,206,0.023696682464454975,0.023696682464454975,0.976303317535545,211,7900,5500,2400,0.6962025316455697,103,55,48,222.95690474818986,0.48481061460919284,0.8077059535300235,0.12606749937610248,1053260.7204619583,-3133.649974590507,1050127.070487368,2071,0,271.07582938388623,74,137,37,39.39979023646074,0.525227093206951,45.08333333333334,8263.568908495261,111.66985011480082,8
2186,31.993854279674228,2,1,207,0.009615384615384616,0.004807692307692308,0.9951923076923077,208,6950,4800,2150,0.6906474820143885,91,48,43,198.8381038889925,0.48482693081877865,0.7769393425774758,0.11096911859252705,1035419.7694572932,-7373.819262387149,1028045.9501949061,2072,0,275.53846153846155,75,133,41,40.52791545451275,0.5246394230769231,45.58662280701751,8139.664516712003,108.52886022282671,8
2187,31.574128012452935,3,3,207,0.014285714285714285,0.014285714285714285,0.9857142857142858,210,7500,5400,2100,0.72,96,54,42,201.31600328008918,0.4850307587149692,0.782301320079098,0.11196788946476813,1020771.6100326802,-8400.467841287988,1012371.1421913923,2073,0,273.8952380952381,72,138,38,40.600098204264874,0.5241071428571429,45.71917808219176,8028.695222344582,111.50965586589697,7
2188,31.960320502296376,1,3,205,0.004807692307692308,0.014423076923076924,0.9855769230769231,208,6600,4900,1700,0.7424242424242424,83,49,34,199.6615869917177,0.48505967035178993,0.7778639037322401,0.11174549941037315,1035226.2767658868,-6861.015737079306,1028365.2610288075,2074,0,277.25,75,133,39,40.395126548196,0.5263922275641026,45.476973684210506,8134.637496267001,108.46183328356001,0
2189,32.21120610553238,1,3,203,0.0048543689320388345,0.014563106796116505,0.9854368932038835,206,6850,4800,2050,0.7007299270072993,89,48,41,198.16125663362405,0.4848291104270266,0.774671330142743,0.11153126653567903,1045128.9053317808,-6629.188555066266,1038499.7167767145,2075,0,280.59223300970876,79,127,41,40.21246507190076,0.5290250809061489,45.26041666666665,8205.469221987401,103.86669901249876,0
2190,32.55874814713519,4,4,203,0.01932367149758454,0.01932367149758454,0.9806763285024155,207,7200,5100,2100,0.7083333333333334,93,51,42,193.23333461540864,0.48463076309741565,0.7696319754803791,0.10959836623553426,1058854.599343225,-7678.798979209503,1051175.8003640154,2076,0,279.7391304347826,83,124,39,40.03715679600632,0.5321054750402576,44.96527777777776,8303.611289607863,100.04350951334774,0
2191,32.65736432172908,1,4,200,0.004901960784313725,0.0196078431372549,0.9803921568627451,204,6600,5000,1600,0.7575757575757576,82,50,32,197.2536419882668,0.48417930390547026,0.7670574812336706,0.11474328397362692,1070055.042291469,-5185.54915601937,1064869.4931354495,2077,0,284.6127450980392,84,120,38,38.95780474571947,0.541156045751634,44.0073529411765,8360.045138683889,99.5243468890939,8
2192,32.14254557639723,0,0,200,0.0,0.0,1.0,200,7700,5900,1800,0.7662337662337663,95,59,36,200.8111110689577,0.4832333542713568,0.7666725962204846,0.11743190696745481,1054817.6332551572,-5336.179818180114,1049481.453436977,2078,1,291.09,87,113,41,38.664589397649735,0.5444270833333333,43.809185606060645,8234.624927911627,94.65086124036353,0
2193,32.298817704264856,4,1,203,0.0196078431372549,0.004901960784313725,0.9950980392156863,204,6050,4400,1650,0.7272727272727273,77,44,33,207.5831326782482,0.48341463021990405,0.7812914213120639,0.11919776783432182,1054269.9736164017,-3080.2672376182677,1051189.7063787833,2079,0,286.3627450980392,73,131,43,39.192227700953126,0.5346200980392157,44.49605855855859,8252.47522733835,113.04760585394999,8
2194,31.94484661048632,2,2,203,0.00975609756097561,0.00975609756097561,0.9902439024390244,205,6000,3900,2100,0.65,81,39,42,206.52083847383176,0.4833363223338116,0.7825264236354315,0.1195566045060675,1045226.9822379497,-3827.7694465488885,1041399.2127914008,2080,0,285.6341463414634,75,130,42,38.905557936848155,0.5366869918699186,44.18859649122809,8171.856046300988,108.95808061734651,0
2195,32.25609472342777,4,1,206,0.01932367149758454,0.004830917874396135,0.9951690821256038,207,6850,5000,1850,0.7299270072992701,87,50,37,205.13380979834378,0.483576442630896,0.7846377039252928,0.12024694596466347,1059282.6906156365,-4791.061204115279,1054491.6294115211,2081,0,282.8309178743961,68,139,43,38.46263352183477,0.5401066827697263,43.71980676328499,8266.59818878178,121.56762042326147,0
2196,32.17054622572398,0,1,205,0.0,0.0048543689320388345,0.9951456310679612,206,6850,5200,1650,0.7591240875912408,85,52,33,201.5158510954239,0.4833145867866446,0.7793755504049367,0.1185736687683283,1057636.4435327258,-5423.898386393389,1052212.5451463324,2082,1,285.15533980582524,72,134,41,38.411472825078796,0.5412621359223301,43.57876712328765,8249.211125517353,114.57237674329657,0
2197,31.695876147196895,1,1,205,0.0048543689320388345,0.0048543689320388345,0.9951456310679612,206,7350,5700,1650,0.7755102040816326,90,57,33,216.33231854041304,0.48321888073249664,0.7953522246531135,0.12681288329296111,1040888.848912125,-3514.420394395594,1037374.4285177294,2083,0,285.8203883495146,67,139,37,38.1751842996613,0.539745145631068,43.71936274509804,8123.039337356068,121.23939309486668,8
2198,31.479592556052847,1,2,204,0.0048543689320388345,0.009708737864077669,0.9902912621359223,206,6750,4900,1850,0.725925925925926,86,49,37,212.85225854841877,0.4828932828163233,0.7930621780509761,0.1255697204947857,1035700.804468669,-3859.7489176859403,1031841.0555509831,2084,0,286.59708737864077,69,137,38,38.02210233205711,0.5414644012944984,43.482142857142854,8075.077626208905,117.03011052476674,0
2199,31.665470723713817,1,3,202,0.004878048780487805,0.014634146341463415,0.9853658536585366,205,6850,4300,2550,0.6277372262773723,94,43,51,210.00867870981384,0.48290690259843777,0.7892658391604481,0.12446855835727988,1043216.2162071757,-4033.108165135934,1039183.1080420398,2085,0,288.2731707317073,70,135,37,37.91914342325864,0.5435467479674796,43.309859154929576,8128.2141399955535,116.11734485707933,0
2200,31.7047513412512,1,6,197,0.0049261083743842365,0.029556650246305417,0.9704433497536946,203,6100,4300,1800,0.7049180327868853,79,43,36,190.82544383802224,0.48238265944821085,0.7647876051926792,0.11100442095381904,1038842.8412142594,-7052.470749467245,1031790.3704647921,2086,0,291.3990147783251,80,123,43,39.12220770956828,0.5380747126436782,44.00720164609055,8116.188016961802,101.45235021202252,8
2201,31.986231202705216,1,3,195,0.005050505050505051,0.015151515151515152,0.9848484848484849,198,6100,3900,2200,0.639344262295082,83,39,44,196.8501559125018,0.4821298860004444,0.7660427128133809,0.11525778691467273,1050066.2202359347,-4358.860165620629,1045707.3600703141,2087,0,297.6161616161616,79,119,44,38.7189919033826,0.5400883838383839,43.76302083333336,8196.05525830782,103.74753491528887,0
2202,31.95609695163142,0,2,193,0.0,0.010256410256410256,0.9897435897435898,195,5800,4200,1600,0.7241379310344828,74,42,32,206.63072339029569,0.4817880429993832,0.7715285647172221,0.1208952508584746,1048851.2644345767,-1455.0209002112706,1047396.2435343654,2088,1,302.2307692307692,76,119,40,38.49651072742311,0.5407051282051283,43.790584415584426,8187.452924336439,107.72964374126893,8
2203,31.84465672310395,4,5,192,0.02030456852791878,0.025380710659898477,0.9746192893401016,197,6350,4100,2250,0.6456692913385826,86,41,45,224.40442540444107,0.48187739562830206,0.7920661104917259,0.1324128438274406,1047776.0285479154,1275.1155277683633,1049051.1440756838,2089,0,299.497461928934,67,130,38,37.71771368286955,0.5464255499153976,43.47426470588235,8168.973981082994,121.9249847922835,8
2204,31.91607465181594,0,4,188,0.0,0.020833333333333332,0.9791666666666666,192,5150,3700,1450,0.7184466019417476,66,37,29,223.68657400064788,0.48143054192117507,0.7865741012975809,0.1327290257311589,1051824.2479430006,3505.7924946354988,1055330.0404376362,2090,1,306.4791666666667,68,124,38,37.524133639107774,0.5480143229166667,43.26690821256038,8193.912523079427,120.49871357469746,0
2205,31.831060026651677,2,6,184,0.010526315789473684,0.031578947368421054,0.968421052631579,190,4750,3000,1750,0.631578947368421,65,30,35,251.89190238226558,0.4813863362108976,0.8019477776457695,0.14491962695499191,1039595.4750838266,9623.136385372121,1049218.6114691987,2091,0,309.6736842105263,64,126,38,37.985301187191716,0.5357456140350877,44.42307692307693,8135.284379888485,127.11381843575758,8
2206,31.701202101553818,2,0,186,0.010752688172043012,0.0,1.0,186,4900,3400,1500,0.6938775510204082,64,34,30,248.0395571968649,0.48095817591785334,0.7944876299296979,0.14339925167232226,1036844.1192128488,9335.671242345634,1046179.7904551944,2092,0,314.241935483871,65,121,44,37.895389797387644,0.5382504480286738,44.239267676767675,8107.922665020191,124.7372717695414,0
2207,31.441121982215652,3,2,187,0.015873015873015872,0.010582010582010581,0.9894179894179894,189,6900,5200,1700,0.7536231884057971,86,52,34,210.82176067979492,0.48109802431610943,0.7712535184726215,0.12003732904714214,1023691.521749631,-1536.7101983527173,1022154.8115512783,2093,0,310.23809523809524,79,110,41,39.43791033098615,0.5345017636684304,44.81770833333334,8023.217559993026,101.55971594927881,8
2208,31.59916223792104,1,1,187,0.005319148936170213,0.005319148936170213,0.9946808510638298,188,5950,3800,2150,0.6386554621848739,81,38,43,209.72892913392943,0.48092608658550456,0.7690854461537702,0.11987105150166437,1030007.421408576,-345.5293015958464,1029661.8921069801,2094,0,312.1808510638298,69,119,42,39.31766522904767,0.5365137411347518,44.67261904761905,8068.1313344977625,116.92943963040236,0
2209,31.53559993176133,3,0,190,0.015789473684210527,0.0,1.0,190,6150,4400,1750,0.7154471544715447,79,44,35,205.31333258444897,0.4811960456697299,0.7669029864992258,0.11857622408140235,1031115.6893511876,-1809.6403078391513,1029306.0490433484,2095,0,309.86842105263156,72,118,43,39.027653776761,0.5393640350877194,44.277968036529685,8064.347693737093,112.00482907968185,0
2210,31.226125804097574,4,1,193,0.020618556701030927,0.005154639175257732,0.9948453608247423,194,5950,4100,1850,0.6890756302521008,78,41,37,196.6983761630007,0.48167610348450046,0.7630484211265585,0.11101704248994797,1014018.6565572051,-4858.835371241781,1009159.8211859633,2096,0,304.4587628865979,71,123,41,40.14056438641306,0.5287800687285223,45.1533564814815,7957.873351261314,112.08272325720161,8
2211,31.40425197626179,0,6,187,0.0,0.031088082901554404,0.9689119170984456,193,6000,4200,1800,0.7,78,42,36,213.9012950839016,0.48178882412204954,0.7771920940176273,0.11975013204562353,1017304.8926772674,-1079.433192228717,1016225.4594850388,2097,1,304.92746113989637,67,126,38,40.02116433959235,0.5233700345423143,45.4656862745098,7993.459724840156,119.30536902746502,8
2212,31.669363996825634,4,1,190,0.020942408376963352,0.005235602094240838,0.9947643979057592,191,6250,4100,2150,0.656,84,41,43,209.77964941854972,0.481221870120327,0.7713789094147747,0.1187020829679628,1029200.0170896198,-1268.956246674853,1027931.0608429449,2098,0,308.62303664921467,70,121,39,39.70753965970343,0.5273232984293194,45.05575117370892,8073.922214977095,115.34174592824421,0
2213,31.608224643118742,0,3,187,0.0,0.015789473684210527,0.9842105263157894,190,6500,4900,1600,0.7538461538461538,81,49,32,220.0112673623548,0.4810214192889632,0.7719763315703942,0.1234096524220838,1024513.4688105107,580.9013405604319,1025094.3701510711,2099,1,311.0684210526316,72,118,43,39.789296456126564,0.5261513157894737,45.390981735159805,8047.739045478966,111.77415340943008,8
2214,32.1044736243293,2,3,186,0.010582010582010581,0.015873015873015872,0.9841269841269842,189,5050,3300,1750,0.6534653465346535,68,33,35,220.95316036441866,0.480927989793238,0.7740365406269296,0.12493451341123032,1043114.590120355,3245.8930618655,1046360.4831822205,2100,0,313.24867724867727,74,115,35,39.45086902037701,0.5308090828924162,45.08333333333333,8183.965401401935,110.5941270459721,8
2215,32.374922141254416,3,2,187,0.015873015873015872,0.010582010582010581,0.9894179894179894,189,4850,3000,1850,0.6185567010309279,67,30,37,222.41783667079147,0.48078023565612216,0.7779007471218526,0.12646042713567832,1053648.3330997804,4220.036571967623,1057868.369671748,2101,0,313.9259259259259,77,112,38,39.19728852596313,0.5329034391534391,44.87179487179486,8259.755777063605,107.26955554628059,0
2216,32.757081596456956,1,3,185,0.005319148936170213,0.015957446808510637,0.9840425531914894,188,6700,4900,1800,0.7313432835820896,85,49,36,221.57240167000504,0.4810143835096901,0.7764652269247745,0.12664596246856402,1067765.4325049405,3017.4702600664414,1070782.902765007,2102,0,313.6276595744681,68,120,38,39.01350539033091,0.5350177304964538,44.67089371980678,8363.836368370752,122.99759365251106,0
2217,32.517264636046775,4,1,188,0.021164021164021163,0.005291005291005291,0.9947089947089947,189,5450,3900,1550,0.7155963302752294,70,39,31,225.21911007951158,0.4814463019250253,0.7846283343260627,0.12767051806637636,1057332.7349280384,4376.307523686031,1061709.0424517244,2103,0,312.21693121693124,74,115,39,39.24271099976404,0.5295414462081129,44.98611111111113,8292.354110867467,112.05883933604686,8
2218,32.45569685797279,2,1,189,0.010526315789473684,0.005263157894736842,0.9947368421052631,190,6900,5100,1800,0.7391304347826086,87,51,36,221.26222207045947,0.4815423976608187,0.7823950833379425,0.12643443894149864,1057856.055620553,1912.7162994590608,1059768.771920012,2104,0,310.82105263157894,65,125,41,39.0319460757042,0.5322916666666666,44.68118686868687,8286.550001127309,127.48538463272783,0
2219,32.59209197058555,1,2,188,0.005263157894736842,0.010526315789473684,0.9894736842105263,190,7200,5300,1900,0.7361111111111112,91,53,38,211.42176391649977,0.48161549707602336,0.7758533613631049,0.12114249111834098,1063167.1381067587,-244.6656646823485,1062922.4724420763,2105,0,311.8,67,123,42,39.17701211466955,0.5327302631578947,44.57720588235295,8324.763197266308,124.250196974124,8
2220,32.43975332992923,5,3,190,0.025906735751295335,0.015544041450777202,0.9844559585492227,193,5800,3900,1900,0.6724137931034483,77,39,38,243.06202480425128,0.48140651986183075,0.8002231906596091,0.13758971849378412,1054363.122991367,6855.1271106432205,1061218.2501020103,2106,0,307.24870466321244,66,127,38,38.84332377990529,0.530332469775475,45.04042288557215,8270.825790695131,125.31554228325956,8
2221,32.351202086126825,5,1,194,0.02564102564102564,0.005128205128205128,0.9948717948717949,195,6500,4600,1900,0.7076923076923077,84,46,38,235.6116593194231,0.4820964402149969,0.7863139436199076,0.131551107402364,1047127.6490620784,3843.0965829524866,1050970.7456450309,2107,0,297.63589743589745,70,125,38,39.57456367969862,0.5219551282051282,45.56924882629107,8231.140648145689,117.58772354493841,8
2222,32.53282428873516,3,0,197,0.015228426395939087,0.0,1.0,197,7300,5900,1400,0.8082191780821918,87,59,28,247.05547182369287,0.48249680582893056,0.8002236695018667,0.13674447818453034,1050213.6115687175,5192.203864355481,1055405.815433073,2108,0,295.5939086294416,84,113,37,39.629352753930746,0.5223667512690355,45.906862745098074,8266.367387287291,98.40913556294394,8
2223,32.64451764354915,8,2,203,0.03902439024390244,0.00975609756097561,0.9902439024390244,205,5550,3800,1750,0.6846846846846847,73,38,35,223.70379819788587,0.48329447632711625,0.7964529591934117,0.12551524485713741,1058190.3691734576,794.2409601052577,1058984.610133563,2109,0,285.01951219512193,68,137,45,39.68449839914619,0.5265243902439025,45.3804347826087,8311.932889131962,122.23430719311709,8
2224,32.169072166705426,2,4,201,0.00975609756097561,0.01951219512195122,0.9804878048780488,205,6750,5000,1750,0.7407407407407407,85,50,35,222.66748910000686,0.48304738562091504,0.7951272122132587,0.12576893733487748,1044876.5658160243,-1217.9917340614575,1043658.5740819628,2110,0,285.7170731707317,71,134,37,39.44917078200985,0.5291158536585365,45.124421296296305,8199.11088485027,115.48043499789112,0
2225,32.27997311189769,1,4,198,0.0049504950495049506,0.019801980198019802,0.9801980198019802,202,6600,5000,1600,0.7575757575757576,82,50,32,222.1795640627506,0.4828518299591153,0.7844484506438445,0.1214417300241575,1038034.3869752026,-873.994483940477,1037160.3924912622,2111,0,290.41089108910893,84,118,39,40.76251973196742,0.5200082508250825,46.39705882352944,8186.296122274722,97.4559062175562,8
2226,32.4661485570311,12,4,206,0.05714285714285714,0.01904761904761905,0.9809523809523809,210,6250,4600,1650,0.736,79,46,33,211.3460892455992,0.48448203842940685,0.7913049557172258,0.11681395206932228,1047606.9499134003,-3968.4736138583994,1043638.4762995419,2112,0,279.66190476190474,80,130,39,40.59293898282207,0.5179563492063493,45.96193415637861,8247.637584819886,103.09546981024857,8
2227,32.60094540522267,7,1,212,0.03286384976525822,0.004694835680751174,0.9953051643192489,213,6750,5100,1650,0.7555555555555555,84,51,33,199.9057179694125,0.4850204476333894,0.7846508191956929,0.11225945908022003,1057053.6606845343,-7087.785805732328,1049965.874878802,2113,0,276.3286384976526,74,139,42,40.256567584765016,0.5218603286384976,45.34722222222223,8301.92130562165,112.18812575164392,0
2228,32.58787095103786,2,4,210,0.009345794392523364,0.018691588785046728,0.9813084112149533,214,7750,6000,1750,0.7741935483870968,95,60,35,187.61302097971827,0.48505440744153394,0.7733800092988463,0.10291199577474044,1049083.2277447893,-11185.665276729596,1037897.5624680597,2114,0,276.0093457943925,75,139,45,41.497697563874,0.5132398753894081,46.25822368421049,8268.904261465977,110.25205681954637,8
2229,32.77075498717265,3,3,210,0.014084507042253521,0.014084507042253521,0.9859154929577465,213,7100,4800,2300,0.676056338028169,94,48,46,196.93425794037563,0.485282502140727,0.7828099236450401,0.10897371284883184,1057808.7880259117,-8036.242257461949,1049772.5457684498,2115,0,278.1267605633803,86,127,43,40.91338375508536,0.5222026604068857,45.917145593869726,8326.486968184736,96.81961590912483,8
2230,32.421567662233464,6,3,213,0.027777777777777776,0.013888888888888888,0.9861111111111112,216,7950,5800,2150,0.7295597484276729,101,58,43,189.609030690024,0.48550100488084985,0.7783889784168687,0.10644231388840775,1051133.2705079543,-11289.127890590471,1039844.1426173638,2116,0,274.85648148148147,76,140,48,40.53164125449357,0.5265239197530864,45.35984848484847,8255.832901869837,108.62938028776101,0
2231,32.12054038565356,4,4,213,0.018433179723502304,0.018433179723502304,0.9815668202764977,217,7250,5300,1950,0.7310344827586207,92,53,39,185.23594477006347,0.4854159555100415,0.7733444277917996,0.10479032890982182,1043790.9634941254,-11980.478946942461,1031810.4845471829,2117,0,274.01382488479265,83,134,39,40.34216201316598,0.529857910906298,45.06448412698409,8188.666533336537,98.65863293176551,0
2232,32.24900903200034,2,3,212,0.009302325581395349,0.013953488372093023,0.986046511627907,215,6100,4300,1800,0.7049180327868853,79,43,36,203.67760787845603,0.4850557849742809,0.7901059888866029,0.11393846381319549,1044425.1591023747,-6554.796397190528,1037870.3627051841,2118,0,276.06511627906974,73,142,43,40.311808628318595,0.5252906976744186,45.49549549549549,8207.51806445052,112.43175430754137,8
2233,32.354414411855466,0,5,207,0.0,0.02358490566037736,0.9764150943396226,212,5650,3700,1950,0.6548672566371682,76,37,39,212.0238666177612,0.48497114295508065,0.795746244960148,0.11703518820095193,1043582.4352863533,-3797.123387241359,1039785.311899112,2119,1,280.47641509433964,86,126,35,40.62779899118467,0.5209807389937107,46.01293103448277,8217.602884562884,95.5535219135219,8
2234,31.99977925323406,6,1,212,0.028169014084507043,0.004694835680751174,0.9953051643192489,213,6050,4000,2050,0.6611570247933884,81,40,41,205.62024299397984,0.4850315203590516,0.7909391619426098,0.11481575199617482,1035780.4107148199,-6054.516052082997,1029725.8946627369,2120,0,279.61971830985914,73,140,41,40.33419778699861,0.5240121283255086,45.56587837837837,8141.8357263823855,111.5319962518135,0
2235,32.364773816098726,7,5,214,0.0319634703196347,0.0228310502283105,0.9771689497716896,219,6950,4600,2350,0.6618705035971223,93,46,47,201.29430057537786,0.4862175861924511,0.7896645298523097,0.11140540030163279,1044758.8025504819,-8689.201514126657,1036069.6010363552,2121,0,272.29680365296804,80,139,42,40.795816884300024,0.5191685692541856,45.91049382716047,8223.549396328117,102.79436745410146,8
2236,32.69717860950756,6,1,219,0.02727272727272727,0.004545454545454545,0.9954545454545455,220,7050,5300,1750,0.75177304964539,88,53,35,197.710967198168,0.486596703334717,0.7879677347075968,0.11127163261102427,1060879.0032576555,-9100.517237140224,1051778.4860205152,2122,0,271.8772727272727,72,148,44,40.22611845544852,0.5234375,45.262557077625566,8329.195669762099,115.68327319114026,0
2237,32.794578977677666,4,6,217,0.017937219730941704,0.026905829596412557,0.9730941704035875,223,7700,5500,2200,0.7142857142857143,99,55,44,224.0061880993979,0.48702345843601447,0.8114108372449502,0.12341239740151647,1057157.1809358313,-4938.049935331447,1052219.1310005,2123,0,267.8116591928251,85,138,38,40.39990101607597,0.5170964125560538,46.08769379844963,8326.947179131063,97.96408446036544,8
2238,32.493697024947544,2,5,214,0.0091324200913242,0.0228310502283105,0.9771689497716896,219,7000,5000,2000,0.7142857142857143,90,50,40,215.68463111830766,0.48641046318405873,0.7996535926393724,0.12158540977491411,1054795.7282136725,-5299.354491013392,1049496.3737226592,2124,0,271.54794520547944,73,146,42,39.704240557611904,0.5255422374429224,45.19988738738739,8279.397661156763,113.41640631721593,8
2239,32.20039173183832,4,5,213,0.01834862385321101,0.022935779816513763,0.9770642201834863,218,6700,4300,2400,0.6417910447761194,91,43,48,209.64866472956137,0.4864979248580166,0.7941078557299919,0.1193301435904749,1048309.5596759171,-6344.660118141849,1041964.8995577754,2125,0,273.3165137614679,80,138,40,39.48064711218627,0.5281441131498471,44.83024691358025,8216.566007499176,102.70707509373969,0
2240,32.34123480571897,4,3,214,0.018433179723502304,0.013824884792626729,0.9861751152073732,217,6900,4800,2100,0.6956521739130435,90,48,42,204.54267154078323,0.486649812254651,0.7880640598622062,0.11745811606539387,1055671.1329138996,-7114.041241060699,1048557.0916728389,2126,0,274.778801843318,76,141,42,39.267860609590365,0.5310099846390168,44.49404761904765,8263.378000211305,108.72865789751718,0
2241,32.502766604557685,2,3,213,0.009259259259259259,0.013888888888888888,0.9861111111111112,216,6700,5000,1700,0.746268656716418,84,50,34,209.05043886590377,0.48632554550674706,0.7983153099316402,0.11837213283601776,1056505.785004354,-5727.400396094431,1050778.3846082597,2127,0,276.43981481481484,78,138,40,39.6988286704246,0.5297067901234568,45.029008438818586,8287.26262964578,106.24695679033051,8
2242,32.52007767080858,2,8,207,0.009302325581395349,0.037209302325581395,0.9627906976744186,215,7800,5700,2100,0.7307692307692307,99,57,42,182.49196587978702,0.48615971165688615,0.7669138552243708,0.10348985285514982,1057547.33237125,-12201.2216609295,1045346.1107103205,2128,0,278.6093023255814,86,129,43,40.31719483568074,0.5330426356589147,44.97126436781606,8293.554291046647,96.43667780286798,8
2243,32.65062516301733,3,3,207,0.014285714285714285,0.014285714285714285,0.9857142857142858,210,6100,4100,2000,0.6721311475409836,81,41,40,180.7409569755702,0.4857788410419989,0.758361904761905,0.10334703310857095,1064416.2831812038,-9623.276471489433,1054793.0067097144,2129,0,285.3809523809524,76,134,45,40.04128035320092,0.535218253968254,44.656385281385326,8337.128651947507,109.69906120983562,0
2244,32.620133397042544,1,2,206,0.004807692307692308,0.009615384615384616,0.9903846153846154,208,6500,5100,1400,0.7846153846153846,79,51,28,178.02026978929626,0.4855372460671374,0.7533547792316675,0.10244385446186274,1065441.5933385196,-10165.960021827292,1055275.6333166922,2130,0,289.03365384615387,79,129,47,39.864114745189944,0.5373597756410257,44.41406250000004,8337.247375658293,105.534776907067,0
2245,33.023145469812484,1,3,204,0.004830917874396135,0.014492753623188406,0.9855072463768116,207,6900,5100,1800,0.7391304347826086,87,51,36,203.227052160297,0.4852150852836796,0.7824870231050969,0.1175215376623282,1080161.3093580334,-4396.400248311694,1075764.9091097217,2131,0,291.2705314009662,75,132,45,39.03177080542304,0.5364834943639292,44.22971491228073,8446.33933130723,112.61785775076306,8
2246,33.40185192694117,2,1,205,0.009708737864077669,0.0048543689320388345,0.9951456310679612,206,8050,5800,2250,0.7204968944099379,103,58,45,202.13651368629948,0.48491001657589394,0.7772464905507517,0.11657045563713736,1091663.4482360238,-5116.991290960987,1086546.4569450628,2132,0,293.58252427184465,74,132,43,39.16537646675361,0.5360032362459547,44.33333333333336,8539.740142654686,115.40189381965791,8
2247,33.298030487005825,0,0,205,0.0,0.0,1.0,205,7250,5400,1850,0.7448275862068966,91,54,37,206.14098619608723,0.4846494898772517,0.7805646570343563,0.11956935767859651,1090127.576056842,-3306.0052784179043,1086821.5707784242,2133,1,295.67317073170733,76,129,36,38.84042646929249,0.5380081300813009,44.11525974025978,8520.457882328497,112.11128792537497,0
2248,32.926399423992365,3,2,206,0.014423076923076924,0.009615384615384616,0.9903846153846154,208,7050,5300,1750,0.75177304964539,88,53,35,184.6991295483255,0.4848235437569677,0.7599623503338921,0.10404288941937491,1068608.4823026694,-9175.788698148137,1059432.6936045212,2134,0,292.3942307692308,85,123,46,40.522091217394035,0.5304987980769231,45.22771317829456,8388.734078055375,98.69098915359265,8
2249,33.00506704608692,5,8,203,0.023696682464454975,0.037914691943127965,0.9620853080568721,211,7500,5900,1600,0.7866666666666666,91,59,32,184.24300970470986,0.4847748815165877,0.7633757869476123,0.10575316587641208,1077194.917436669,-10006.873274570105,1067188.044162099,2135,0,283.7914691943128,77,134,39,39.804015733626066,0.5308056872037914,44.51121794871796,8432.42438112569,109.51200494968428,8
2250,33.0257786276662,1,4,200,0.004901960784313725,0.0196078431372549,0.9803921568627451,204,6700,4500,2200,0.6716417910447762,89,45,44,211.02738851816179,0.4840344183650472,0.7852692482685995,0.11833718748466826,1070369.6253925667,-2324.538640848733,1068045.0867517178,2136,0,291.5147058823529,69,135,40,40.02906608607556,0.5258374183006536,45.401785714285715,8408.304263999122,121.8594820869438,8
2251,33.19350748599672,3,3,200,0.014778325123152709,0.014778325123152709,0.9852216748768473,203,6100,4100,2000,0.6721311475409836,81,41,40,230.6198627535504,0.4837625388154579,0.7931725265288112,0.12864489715801908,1074088.8658064844,2841.2453634815465,1076930.111169966,2137,0,283.30049261083747,72,131,38,39.738169359060635,0.5270935960591133,45.60502283105022,8444.261579057486,117.28141082024285,8
2252,32.637755361325574,4,1,203,0.0196078431372549,0.004901960784313725,0.9950980392156863,204,5900,3500,2400,0.5932203389830508,83,35,48,233.58299766455676,0.48395493254773175,0.8076918698631685,0.1295903246990062,1054354.853516454,2555.8734573095294,1056910.7269737637,2138,0,282.09313725490193,59,145,39,39.87866550554379,0.5218545751633987,45.81597222222222,8295.996115367496,140.61010365029654,7
2253,32.516606792201856,4,2,205,0.01932367149758454,0.00966183574879227,0.9903381642512077,207,6650,5000,1650,0.7518796992481203,83,50,33,220.1850908713297,0.4840532808029642,0.7989715787094245,0.12260064112994497,1051602.4884213803,-1740.562105284328,1049861.926316096,2139,0,278.9661835748792,65,142,38,40.075658847379074,0.5224436392914653,45.67550505050505,8269.769599898058,127.22722461381628,8
2254,32.623396379588826,4,3,206,0.019138755980861243,0.014354066985645933,0.9856459330143541,209,6700,5200,1500,0.7761194029850746,82,52,30,219.70350910114536,0.48412771439087227,0.8019007668611131,0.1196892251073399,1047996.7165004595,-2450.288771674427,1045546.4277287851,2140,0,277.22966507177034,71,138,39,40.95890410958901,0.5148524720893142,46.527777777777764,8269.124776770748,116.46654615170068,8
2255,33.03253889954471,5,3,208,0.023696682464454975,0.014218009478672985,0.985781990521327,211,6500,4500,2000,0.6923076923076923,85,45,40,215.10083945343067,0.4847419694576092,0.8003057186132383,0.11846747276038871,1064721.1943275388,-2895.5154632574627,1061825.6788642814,2141,0,274.5308056872038,77,134,34,40.63902622904832,0.518562401263823,46.100427350427346,8386.947510124774,108.92139623538667,0
2256,33.192278421092574,4,2,210,0.018867924528301886,0.009433962264150943,0.9905660377358491,212,7100,5100,2000,0.7183098591549296,91,51,40,213.29210670406226,0.4844322856120898,0.8005335187257872,0.11842676544090058,1072527.7512064541,-3747.6592893210855,1068780.091917133,2142,0,274.188679245283,64,148,40,40.36305658870746,0.5216194968553459,45.785256410256395,8437.9665479774,131.84322731214687,0
2257,33.00306172057894,3,3,210,0.014084507042253521,0.014084507042253521,0.9859154929577465,213,6650,4700,1950,0.706766917293233,86,47,39,208.44075060040217,0.48487650219978146,0.7958929591336685,0.1169381182600082,1069775.7761550478,-4653.026848823108,1065122.7493062248,2143,0,270.99530516431923,71,142,42,40.07762041403863,0.5245989827856026,45.38483796296294,8403.079907703494,118.35323813666892,0
2258,32.597804920266384,2,7,205,0.009433962264150943,0.0330188679245283,0.9669811320754716,212,6950,4600,2350,0.6618705035971223,93,46,47,200.16401212005988,0.4848169841127903,0.7838085637303864,0.11029489537595118,1050866.5403671074,-7280.867415478591,1043585.6729516288,2144,0,272.75943396226415,83,129,36,40.99881161685224,0.5221108490566038,46.0813492063492,8277.190644188664,99.72518848420077,8
2259,32.68959421346937,1,2,204,0.0048543689320388345,0.009708737864077669,0.9902912621359223,206,5800,4300,1500,0.7413793103448276,73,43,30,201.52160000000038,0.4841423948220065,0.7807475728155351,0.11146106194690264,1055041.0420084316,-4477.288229758695,1050563.753778673,2145,0,280.43689320388347,81,125,39,40.81500000000004,0.5237661812297735,45.93495934959349,8305.283082690374,102.53435904556017,0
2260,32.49461957467763,2,3,203,0.009708737864077669,0.014563106796116505,0.9854368932038835,206,6900,5200,1700,0.7536231884057971,86,52,34,199.788285610947,0.48410835503986105,0.7799704396603435,0.1112057784822425,1050782.720772424,-6113.184333454368,1044669.5364389697,2146,0,277.6504854368932,71,135,40,40.60781469260819,0.5256371359223301,45.6886574074074,8263.750331071788,116.39084973340546,0
2261,32.45728020236333,3,3,203,0.014563106796116505,0.014563106796116505,0.9854368932038835,206,6400,4200,2200,0.65625,86,42,44,189.44421803842647,0.48406444865419523,0.7643121900805927,0.10576400058488046,1050530.8435832155,-7796.601162426299,1042734.2424207892,2147,0,274.65533980582524,75,131,42,40.75294268167861,0.5255865695792881,45.57291666666663,8258.011134819953,110.10681513093272,8
2262,32.87004153469302,4,2,205,0.01932367149758454,0.00966183574879227,0.9903381642512077,207,6050,4500,1550,0.743801652892562,76,45,31,186.94690977673454,0.4843698700811407,0.7624421841884688,0.10549485111198459,1067346.037670301,-7542.591319019299,1059803.4463512818,2148,0,274.0048309178744,81,126,39,40.39590706677966,0.5286332528180354,45.16006097560974,8376.599380430296,103.41480716580612,0
2263,32.913856011095916,1,3,203,0.0048543689320388345,0.014563106796116505,0.9854368932038835,206,7400,5200,2200,0.7027027027027027,96,52,44,188.82265597086567,0.48411723498302944,0.7662288577760252,0.10738014107371217,1071250.6362096423,-8144.721932083344,1063105.914277559,2149,0,276.126213592233,85,121,44,40.04680181035573,0.5314016990291262,44.864341085271306,8397.498340815426,98.7940981272403,0
2264,33.10775751305654,0,5,198,0.0,0.024630541871921183,0.9753694581280788,203,6250,4200,2050,0.672,83,42,41,191.33270882792695,0.4838428116210636,0.759279661027028,0.1050073257805437,1065991.69093446,-6058.184437089176,1059933.5064973708,2150,1,280.0344827586207,84,119,43,41.38244313517172,0.5217056650246306,46.23774509803924,8401.49920126063,100.01784763405513,8
2265,32.92000576766315,4,2,200,0.019801980198019802,0.009900990099009901,0.9900990099009901,202,6700,4000,2700,0.5970149253731343,94,40,54,179.32360468695177,0.48408894061047897,0.747626405351006,0.09812426458713079,1058974.181845566,-9120.186488207097,1049853.9953573588,2151,0,280.65841584158414,85,117,42,41.80569815195073,0.5233601485148515,46.3541666666667,8350.022296277153,98.23555642679004,8
2266,32.978319832460116,2,3,199,0.009900990099009901,0.01485148514851485,0.9851485148514851,202,7300,4900,2400,0.6712328767123288,97,49,48,240.84307885761018,0.4838180179958294,0.7961329140248978,0.13070603278412496,1058143.5606433342,3269.3106037394355,1061412.8712470736,2152,0,280.94554455445547,73,129,37,40.576841149885176,0.5190284653465347,46.67792792792795,8354.136313414367,114.44022347142968,8
2267,32.59992407135456,8,4,203,0.03864734299516908,0.01932367149758454,0.9806763285024155,207,6900,4800,2100,0.6956521739130435,90,48,42,236.9212025495761,0.48446465143911327,0.8049915109951387,0.1310869020392512,1052261.0723141353,1560.5917297546293,1053821.6640438898,2153,0,274.8309178743961,82,125,37,39.90151889355396,0.5237520128824477,45.921184738955844,8282.95008564982,101.01158641036366,0
2268,32.88547240834121,6,5,204,0.028708133971291867,0.023923444976076555,0.9760765550239234,209,6050,4200,1850,0.6942148760330579,79,42,37,210.29974619322203,0.48465103974972396,0.7902411537144269,0.11628237536709642,1061268.2917763721,-3213.1095193029023,1058055.1822570693,2154,0,272.8468899521531,82,127,40,40.60354196512375,0.5218301435406698,45.94628514056225,8354.676430246636,101.88629792983703,8
2269,32.893564834344716,3,3,204,0.014492753623188406,0.014492753623188406,0.9855072463768116,207,7300,5200,2100,0.7123287671232876,94,52,42,233.0168426533892,0.48429267701640005,0.802595929293537,0.1277030352753267,1058631.6009791133,635.7986386513603,1059267.3996177646,2155,0,276.1111111111111,76,131,36,40.38149639188084,0.5157004830917875,46.29329004329006,8345.318112869367,109.80681727459694,8
2270,33.0589775599893,9,4,209,0.04225352112676056,0.018779342723004695,0.9812206572769953,213,6850,4800,2050,0.7007299270072993,89,48,41,231.6491408476046,0.4855039566539699,0.8067260604753674,0.12921283258599822,1069720.039420642,109.94561585180782,1069829.9850364937,2156,0,268.8732394366197,68,145,37,39.71388938341942,0.5209311424100156,45.60688405797104,8409.976311343342,123.67612222563739,0
2271,32.768273529901634,3,4,208,0.014150943396226415,0.018867924528301886,0.9811320754716981,212,5800,4200,1600,0.7241379310344828,74,42,32,239.2774567540066,0.48527154311603926,0.8145966580220363,0.1346988090158454,1063265.6954592129,2683.1022926523365,1065948.7977518651,2157,0,271.12735849056605,69,143,39,39.15745419319665,0.5227004716981132,45.25297619047621,8347.620157118887,120.98000227708532,0
2272,32.97929918728559,1,1,208,0.004784688995215311,0.004784688995215311,0.9952153110047847,209,7200,5400,1800,0.75,90,54,36,215.7434402332347,0.48538331186357503,0.8002734107997256,0.12292358803986732,1073992.2057925542,-2658.6453477263967,1071333.560444828,2158,0,274.8181818181818,74,135,43,39.285714285714306,0.5307515948963317,44.7916666666667,8416.591980088588,113.7377294606566,8
2273,33.09774975626034,1,5,204,0.004784688995215311,0.023923444976076555,0.9760765550239234,209,7600,5700,1900,0.75,95,57,38,205.55794956552606,0.4852970494417863,0.789762429506178,0.11527752697431944,1072723.118169276,-5298.647075516999,1067424.471093759,2159,0,275.66028708133973,71,138,43,40.1657858847596,0.5287579744816586,45.39930555555557,8426.71007249237,118.68605735904745,8
2274,32.85529440386524,4,5,203,0.019230769230769232,0.02403846153846154,0.9759615384615384,208,6100,4500,1600,0.7377049180327869,77,45,32,218.65843838574455,0.48501854174408526,0.797069793191171,0.1240877367413497,1068676.098742322,-964.9906217671141,1067711.108120555,2160,0,276.27403846153845,81,127,36,39.367093335989644,0.53515625,44.94410569105689,8379.936496961409,103.45600613532604,8
2275,32.96663288122818,2,2,203,0.00975609756097561,0.00975609756097561,0.9902439024390244,205,6500,4700,1800,0.7230769230769231,83,47,36,220.6416681431041,0.48508090227961104,0.7981795534537519,0.1259230183679094,1074110.9314686186,-101.2744620043859,1074009.6570066141,2161,0,279.1658536585366,65,140,43,39.09618317464245,0.5371951219512194,44.728535353535335,8415.440660053378,129.46831784697505,0
2276,33.15734572241771,3,4,202,0.014563106796116505,0.019417475728155338,0.9805825242718447,206,6300,4100,2200,0.6507936507936508,85,41,44,216.60151408249374,0.48483947036072306,0.7961037859838063,0.12462750433389654,1082940.7778552608,-586.6775709756857,1082354.1002842851,2162,0,278.7330097087379,69,137,44,38.88373362445415,0.5392900485436893,44.41964285714284,8474.36626164466,122.81690234267623,0
2277,32.6280551504014,3,2,203,0.014634146341463415,0.00975609756097561,0.9902439024390244,205,7100,5000,2100,0.704225352112676,92,50,42,214.21465939705396,0.4845000398533397,0.7928267144528025,0.1245293915113817,1068892.751375622,-2305.5006664183534,1066587.2507092038,2163,0,279.4682926829268,73,132,39,38.548311702595676,0.5420223577235772,44.03153153153152,8351.753305952947,114.40757953360202,0
2278,32.95997017599531,3,2,204,0.014563106796116505,0.009708737864077669,0.9902912621359223,206,7150,5600,1550,0.7832167832167832,87,56,31,205.96971195223043,0.4843944865419528,0.7826802633065064,0.1187620722425034,1077170.7310034183,-3977.0909623701077,1073193.6400410482,2164,0,279.0388349514563,75,131,39,39.073529280365975,0.538379854368932,44.33936403508775,8426.566936579575,112.354225821061,8
2279,33.20808518900396,4,4,204,0.019230769230769232,0.019230769230769232,0.9807692307692307,208,7100,5100,2000,0.7183098591549296,91,51,40,200.1906460357657,0.4844233865972996,0.7764844092895411,0.11658025053021996,1088451.978029657,-5120.419067866624,1083331.5589617903,2165,0,277.1298076923077,81,127,35,38.84039320267926,0.5415665064102564,43.96595528455289,8502.400368195942,104.96790578019682,0
2280,32.9585628687498,2,3,203,0.009708737864077669,0.014563106796116505,0.9854368932038835,206,6700,5100,1600,0.7611940298507462,83,51,32,201.97526093652903,0.48421244770700134,0.779445505297027,0.11852602457376202,1082699.2207053534,-4164.308476452081,1078534.9122289014,2166,0,280.71844660194176,72,134,40,38.50159587299817,0.5437904530744336,43.678652968036516,8447.983230755572,117.33310042716072,0
2281,32.58097231038096,2,4,201,0.00975609756097561,0.01951219512195122,0.9804878048780488,205,5900,3600,2300,0.6101694915254238,82,36,46,216.43493474635162,0.48415829746532757,0.7958415849474616,0.122780188654534,1059635.0633541555,-1031.5908415992872,1058603.4725125562,2167,0,282.99024390243903,74,131,40,39.43834068507324,0.5306910569105692,44.95833333333334,8309.5054796601,112.29061459000135,8
2282,32.68583409071466,4,6,199,0.01951219512195122,0.02926829268292683,0.9707317073170731,205,7500,5400,2100,0.72,96,54,42,202.64447113641123,0.48420811413996495,0.7824567349214502,0.11387904662602875,1060035.7312164684,-5537.923972387921,1054497.8072440804,2168,0,282.4682926829268,72,133,43,40.15867790975645,0.5233739837398375,45.31963470319635,8324.440166253935,115.61722453130466,8
2283,32.75667425119495,5,4,200,0.024509803921568627,0.0196078431372549,0.9803921568627451,204,6250,4300,1950,0.688,82,43,39,184.60780010529774,0.4845596284490808,0.753979529102903,0.10417488264169789,1063664.8095612528,-7777.835891495553,1055886.9736697574,2169,0,283.09313725490193,81,123,40,40.45551692338365,0.5250204248366013,45.16006097560974,8347.708868816291,103.05813418291717,8
2284,33.08683141629319,3,2,201,0.014778325123152709,0.009852216748768473,0.9901477832512315,203,7550,5600,1950,0.7417218543046358,95,56,39,183.75564573109102,0.48450633240663965,0.7526838826248676,0.10445993090980155,1076761.1978713577,-8577.810157393298,1068183.3877139643,2170,0,284.5566502463054,83,120,47,40.190470114551445,0.5288895730706076,44.87847222222221,8441.162980250452,101.70075879819822,0
2285,32.721738554737456,3,2,202,0.014705882352941176,0.00980392156862745,0.9901960784313726,204,6850,5100,1750,0.7445255474452555,86,51,35,209.07471979671024,0.4849324068707943,0.785092021552279,0.11940771990821258,1066361.1299754574,-3060.1691096555187,1063300.960865802,2171,0,283.6078431372549,68,136,42,39.36343208562472,0.5336499183006536,44.70108695652175,8353.824285917368,122.85035714584365,8
2286,33.120091789221874,2,8,196,0.00980392156862745,0.0392156862745098,0.9607843137254902,204,6200,4400,1800,0.7096774193548387,80,44,36,205.84012820289982,0.4849791928265559,0.7823881831249357,0.1184033169880892,1081636.5659351007,-2471.158119794981,1079165.4078153057,2172,0,284.3872549019608,71,133,43,39.169320218888615,0.5358455882352942,44.42997685185185,8464.50262524021,119.21834683436914,0
2287,32.856658618922445,4,4,196,0.02,0.02,0.98,200,6250,4400,1850,0.704,81,44,37,205.39441650802135,0.48430224036850916,0.7789960900348725,0.11960906851787122,1076929.2055652991,-2010.9508404936519,1074918.2547248055,2173,0,289.555,76,124,44,38.70766406002326,0.5392187500000001,43.96645021645022,8412.406940228988,110.689565003013,0
2288,32.59516077990223,3,3,196,0.01507537688442211,0.01507537688442211,0.9849246231155779,199,7550,5700,1850,0.7549668874172185,94,57,37,200.33694709272328,0.4844064599089725,0.7724030375636599,0.11778098376135791,1071334.3844879824,-4424.428019243334,1066909.956468739,2174,0,291.7437185929648,66,133,46,38.47363713540721,0.5423994974874372,43.61007462686566,8357.070839884424,126.6222854527943,0
2289,32.80663864687757,0,5,191,0.0,0.025510204081632654,0.9744897959183674,196,5850,4100,1750,0.7008547008547008,76,41,35,219.80878541216126,0.48414824263038553,0.7858874338255786,0.12810875785064088,1075549.687460643,2233.0540902306852,1077782.7415508737,2175,1,296.51020408163265,72,124,40,38.30697966007245,0.5359800170068028,43.93550228310502,8400.61544689238,116.67521454017194,8
2290,32.960088670160495,2,1,192,0.010362694300518135,0.0051813471502590676,0.9948186528497409,193,5700,3900,1800,0.6842105263157895,75,39,36,218.058284331016,0.4832843084340817,0.7814657710978121,0.12767302303690373,1082030.9019445598,2889.1604142343376,1084920.062358794,2176,0,301.73056994818654,75,118,43,38.17626147811359,0.5381584628670121,43.76370614035087,8445.570966127314,112.60761288169752,0
2291,33.40951815679537,2,3,191,0.010309278350515464,0.015463917525773196,0.9845360824742269,194,7050,4900,2150,0.6950354609929078,92,49,43,212.19265600956345,0.48325076117728755,0.7762848322394906,0.1251805956294604,1099196.718327605,798.2942277857851,1099995.0125553908,2177,0,299.82474226804123,69,125,44,38.0390223150404,0.5408075601374571,43.48214285714283,8570.138005756473,124.20489863415177,0
2292,33.230396823431235,2,1,192,0.010362694300518135,0.0051813471502590676,0.9948186528497409,193,6500,5000,1500,0.7692307692307693,80,50,30,204.63985510449297,0.4827974327144502,0.7669154993345095,0.12159740185068824,1095581.0936117829,-260.0887496129799,1095321.00486217,2178,0,301.76683937823833,73,120,44,37.96024741439169,0.5436096718480139,43.21509009009006,8533.06445457527,116.89129389829137,0
2293,33.34593181591086,3,3,192,0.015384615384615385,0.015384615384615385,0.9846153846153847,195,5700,4500,1200,0.7894736842105263,69,45,24,202.28014864818587,0.48273966869327695,0.7663002140637365,0.12111012694646633,1101786.725704179,-126.08346919261203,1101660.6422349864,2179,0,299.62051282051283,77,118,42,37.73545595442186,0.5457799145299145,42.935363247863215,8572.059849418558,111.3254525898514,0
2294,32.85843110229818,1,4,189,0.0051813471502590676,0.02072538860103627,0.9792746113989638,193,5650,4200,1450,0.7433628318584071,71,42,29,241.69707142920709,0.482346538572251,0.7988486828779697,0.14425797899647766,1084706.0425973504,8184.054771468538,1092890.097368819,2180,0,301.99481865284974,69,124,34,36.840203374452216,0.5441493955094991,43.05059523809522,8442.954313145532,122.36165671225409,8
2295,33.25822398360488,2,2,189,0.010471204188481676,0.010471204188481676,0.9895287958115183,191,5900,4100,1800,0.6949152542372882,77,41,36,243.38107901888415,0.48176150454670713,0.7982771037909364,0.14612989394020146,1099775.3077858724,9432.900217449844,1109208.2080033221,2181,0,305.7434554973822,75,116,37,36.5726984846062,0.5478839441535777,42.831688596491205,8552.961302143285,114.03948402857714,0
2296,32.81491440440956,0,1,188,0.0,0.005291005291005291,0.9947089947089947,189,7300,5500,1800,0.7534246575342466,91,55,36,218.6441958493566,0.48138766933093174,0.7741267627460093,0.12646651212002977,1073424.299784095,1839.5985662905196,1075263.8983503855,2182,1,309.67724867724866,72,117,43,38.62842863784286,0.5400683421516754,44.22089041095891,8393.369587600488,116.57457760556233,8
2297,32.63168549699716,2,1,189,0.010526315789473684,0.005263157894736842,0.9947368421052631,190,6300,4400,1900,0.6984126984126984,82,44,38,207.78518046099015,0.48099589250905045,0.7617377229206455,0.11965201693379525,1066028.8723066726,1.0003217739877073,1066029.8726284467,2183,0,308.9947368421053,74,116,41,39.07766880388324,0.5359100877192983,44.38888888888892,8341.021387315848,112.71650523399795,8
2298,33.09350121362901,3,4,188,0.015625,0.020833333333333332,0.9791666666666666,192,6000,4300,1700,0.7166666666666667,77,43,34,214.27185810021737,0.48151973349331006,0.7738336436621478,0.12399862597594971,1082694.6299561649,1998.1980231672405,1084692.827979332,2184,0,306.640625,75,117,40,38.721277840290064,0.5381944444444444,44.202302631578966,8465.241408305395,112.86988544407194,8
2299,32.95348368737307,4,5,187,0.020833333333333332,0.026041666666666668,0.9739583333333334,192,7250,5400,1850,0.7448275862068966,91,54,37,211.5143102650524,0.48158904159394994,0.7732469512195106,0.12388695315524595,1081929.8062202074,118.72734357424179,1082048.5335637815,2185,0,307.2552083333333,79,113,42,38.32994579945803,0.5417751736111112,43.75000000000003,8444.330194889424,106.89025563151169,0
2300,33.04894323461027,2,0,189,0.010582010582010581,0.0,1.0,189,6550,4400,2150,0.6717557251908397,87,44,43,215.09724613703244,0.4808857743254906,0.7707009006770842,0.12227675172083816,1075528.1839456384,1918.6301018936283,1077446.814047532,2186,0,312.6507936507937,83,106,40,39.39087841669498,0.533179012345679,44.87847222222219,8431.49688945475,101.58429987294879,8
2301,32.499774734587135,2,1,190,0.010471204188481676,0.005235602094240838,0.9947643979057592,191,6750,4600,2150,0.6814814814814815,89,46,43,212.00983830392033,0.48097731239092495,0.7697455849624528,0.12162669671119711,1060537.2352889066,18.865553777816785,1060556.1008426845,2187,0,310.36649214659684,67,124,41,39.1150611620795,0.5362129144851657,44.53125000000002,8302.676826726609,123.92054965263596,0
2302,32.688150819811014,2,0,192,0.010416666666666666,0.0,1.0,192,6200,4700,1500,0.7580645161290323,77,47,30,210.57555647433472,0.48115217332024435,0.7693595434667868,0.12201238993093572,1069827.8785444899,455.92017125286884,1070283.7987157428,2188,0,309.6822916666667,71,121,45,38.767624217748626,0.5390082465277778,44.15509259259262,8363.096919813972,117.79009746216862,0
2303,32.16063198520301,2,1,193,0.010309278350515464,0.005154639175257732,0.9948453608247423,194,6400,4300,2100,0.671875,85,43,42,213.83768219467566,0.4807107214714314,0.7800990362153615,0.12409320612399709,1053039.2984887855,-164.1034302500375,1052875.1950585356,2189,0,307.47938144329896,74,120,39,38.62505653550431,0.5404317010309279,44.09722222222223,8229.995060102314,111.21614946084208,8
2304,31.86007738864607,0,1,192,0.0,0.0051813471502590676,0.9948186528497409,193,6550,4600,1950,0.7022900763358778,85,46,39,186.21743342213114,0.48025848265687965,0.738730701843999,0.10763546994431658,1041976.1150117415,-6343.1764350701305,1035632.9385766714,2190,1,310.04663212435236,87,106,39,39.48459532845809,0.5437715889464594,44.24715909090908,8148.305303729697,93.65868165206548,8
2305,32.12385649970193,1,8,185,0.0051813471502590676,0.04145077720207254,0.9585492227979274,193,5800,4700,1100,0.8103448275862069,69,47,22,183.8322787927359,0.48015503562176165,0.7352014495678234,0.10658222363679512,1051549.7369235298,-5738.243119489183,1045811.4938040406,2191,0,309.2538860103627,89,104,36,39.428263672140034,0.5454447322970639,44.131944444444436,8219.468699524401,92.3535808935326,0
2306,32.00947483459351,3,2,186,0.015957446808510637,0.010638297872340425,0.9893617021276596,188,6500,4700,1800,0.7230769230769231,83,47,36,180.5901959633484,0.47947185402207304,0.7250164172747224,0.10541494187478127,1049892.0468947736,-6179.957902182195,1043712.0889925914,2192,0,317.2925531914894,89,99,40,39.25199022398965,0.5480385638297872,43.87731481481483,8198.352646003746,92.11632186521064,0
2307,31.9336198305472,2,3,185,0.010638297872340425,0.015957446808510637,0.9840425531914894,188,6250,4300,1950,0.688,82,43,39,179.85939929947878,0.47882473830925015,0.7247093059588625,0.10570103017519449,1049472.8373783883,-6098.489177600692,1043374.3482007876,2193,0,317.1223404255319,82,106,40,39.013343613341185,0.5508089539007093,43.62449799196788,8186.997814990208,99.84143676817327,0
2308,31.619330614016498,0,3,182,0.0,0.016216216216216217,0.9837837837837837,185,6050,4600,1450,0.7603305785123967,75,46,29,205.7175453648598,0.4782327164120643,0.7515921225543793,0.11747869920738944,1030404.5477168912,-655.5411421782765,1029749.0065747129,2194,1,322.45405405405404,71,114,38,39.452992179530746,0.5409346846846848,44.70486111111113,8072.26140067908,113.69382254477577,8
2309,31.210809308370024,2,3,181,0.010869565217391304,0.016304347826086956,0.9836956521739131,184,7250,5500,1750,0.7586206896551724,90,55,35,239.0213147210387,0.47850711768432724,0.7715492690336054,0.13502209751888666,1013787.7013192096,4413.373843467502,1018201.0751626771,2195,0,324.29347826086956,72,112,37,39.02768446982421,0.5343070652173914,45.119863013698634,7955.015351970688,110.48632433292623,8
2310,31.55236427837666,1,2,180,0.005494505494505495,0.01098901098901099,0.989010989010989,182,5600,4000,1600,0.7142857142857143,72,40,32,233.83988215162162,0.4779777082953878,0.7640348163841371,0.1328468022109139,1026628.6284174646,6013.3434965243505,1032641.9719139889,2196,0,328.5769230769231,74,108,41,38.937587339612705,0.53628663003663,44.902777777777786,8048.920481957581,108.76919570212947,0
2311,31.178503024925277,6,1,185,0.03225806451612903,0.005376344086021506,0.9946236559139785,186,5450,3900,1550,0.7155963302752294,70,39,31,223.0133941803043,0.479083115373438,0.7523007391535299,0.1285070748388603,1018757.2268907203,2789.3014029229853,1021546.5282936433,2197,0,322.241935483871,72,114,45,38.662550004651635,0.5403225806451613,44.36358447488586,7970.360754730861,110.69945492681751,0
2312,31.68540484497153,2,3,184,0.0106951871657754,0.016042780748663103,0.983957219251337,187,6000,3900,2100,0.65,81,39,42,218.97658833491116,0.47885759875797823,0.749519924023768,0.127028484366575,1037366.267811138,2031.7852358007613,1039398.0530469387,2198,0,321.4812834224599,74,113,38,38.50774352294111,0.5424465240641712,44.11111111111113,8107.943039774418,109.56679783478944,0
2313,31.39204041691638,2,2,184,0.010752688172043012,0.010752688172043012,0.989247311827957,186,6600,4700,1900,0.7121212121212122,85,47,38,222.6856548666492,0.47911278213697567,0.7561497956730419,0.13038234631168225,1030554.1998419282,2097.9273734751323,1032652.1272154034,2199,0,323.9462365591398,75,111,45,38.05769145047696,0.5450828853046594,43.763706140350884,8043.780093122984,107.25040124163979,0
2314,31.58406011938203,1,1,184,0.005405405405405406,0.005405405405405406,0.9945945945945946,185,6300,4400,1900,0.6984126984126984,82,44,38,225.23309162147433,0.4785399529964747,0.7599779063782792,0.1321326556569566,1037450.6557109082,3433.6437180983294,1040884.2994290065,2200,0,326.6702702702703,69,116,45,37.91753754451152,0.5466779279279279,43.69047619047616,8095.295409170114,117.32312187203064,0
2315,31.385798625828105,1,4,181,0.005405405405405406,0.021621621621621623,0.9783783783783784,185,6000,4100,1900,0.6833333333333333,79,41,38,221.38163827978198,0.47879577947512725,0.75661407600494,0.13057539742849306,1032555.0154535521,2717.7441870222083,1035272.7596405743,2201,0,327.1945945945946,71,114,43,37.810913705583715,0.5485923423423423,43.4895833333333,8050.784282927188,113.39132792855195,0
2316,31.270157606721142,3,1,183,0.016304347826086956,0.005434782608695652,0.9945652173913043,184,6500,5100,1400,0.7846153846153846,79,51,28,227.65383920852324,0.478820186901085,0.7723713044435176,0.1318477015224897,1023281.7211133271,3290.8024806711865,1026572.5235939983,2202,0,325.6358695652174,73,111,36,38.34828142768059,0.543365036231884,44.17229729729732,7999.772583678966,109.58592580382145,8
2317,31.40172421250584,1,2,182,0.005434782608695652,0.010869565217391304,0.9891304347826086,184,5800,4300,1500,0.7413793103448276,73,43,30,226.63834357682617,0.4787242862516829,0.771677464093901,0.13216325878244156,1029659.3463313065,4072.0577401850655,1033731.4040714916,2203,0,324.625,75,109,39,38.11059373438954,0.5453464673913043,43.914473684210535,8041.527072182843,107.22036096243791,0
2318,31.29862537441386,3,2,183,0.016216216216216217,0.010810810810810811,0.9891891891891892,185,5700,4200,1500,0.7368421052631579,72,42,30,225.5939337322907,0.47892430473952213,0.7729881521600475,0.1326226086714905,1028703.4799620339,3713.8529377462046,1032417.3328997801,2204,0,323.65405405405403,67,118,42,37.828177590567805,0.5478040540540541,43.61213235294116,8024.587820030061,119.76996746313525,0
2319,31.403666039571473,3,2,184,0.016129032258064516,0.010752688172043012,0.989247311827957,186,5500,3900,1600,0.7090909090909091,71,39,32,225.07918177127922,0.47899169330620944,0.7683799415657973,0.13149874442576948,1030284.2411293167,3679.1067970461627,1033963.3479263629,2205,0,322.5483870967742,76,110,41,38.07917436845349,0.545866935483871,43.84469696969698,8044.215590628899,105.8449419819592,8
2320,31.37798238692333,0,1,183,0.0,0.005434782608695652,0.9945652173913043,184,5750,4000,1750,0.6956521739130435,75,40,35,230.69897457702353,0.4785009305456562,0.783140425601268,0.13605629281797507,1032265.6241368287,5078.524195895592,1037344.1483327243,2206,1,326.82065217391306,64,120,38,37.576013161731,0.5465353260869565,43.493589743589745,8048.653623158579,125.76021286185279,8
2321,31.02877304904766,2,1,184,0.010810810810810811,0.005405405405405406,0.9945945945945946,185,6550,4600,1950,0.7022900763358778,85,46,39,226.16172557063018,0.47836981002741874,0.7810179726049709,0.1345510245302826,1023357.3629457165,2738.8534158424836,1026096.216361559,2207,0,325.9351351351351,69,116,39,37.36112318210787,0.5490427927927928,43.16964285714285,7969.130863891552,115.49465020132683,0
2322,31.342833467007786,1,5,180,0.005405405405405406,0.02702702702702703,0.972972972972973,185,6850,4800,2050,0.7007299270072993,89,48,41,241.5393076407944,0.4781592734038386,0.7962946311882488,0.1422275877565945,1030643.0764404347,5938.1630216398435,1036581.2394620745,2208,0,326.9135135135135,62,123,37,37.35735009671179,0.5465653153153154,43.551587301587276,8037.819892084783,129.64225632394812,8
2323,31.58245303780153,2,1,181,0.01098901098901099,0.005494505494505495,0.9945054945054945,182,5400,3900,1500,0.7222222222222222,69,39,30,237.61648254343152,0.47807446926922065,0.7893713429427731,0.14074207042957032,1040290.9114506907,7638.05344016248,1047928.9648908532,2209,0,330.7857142857143,64,118,39,37.23451028138528,0.5491643772893773,43.333333333333314,8106.162946369018,126.6587960370159,0
2324,31.11762357822348,3,4,180,0.016304347826086956,0.021739130434782608,0.9782608695652174,184,5550,4100,1450,0.7387387387387387,70,41,29,217.9621537531999,0.4783592450700879,0.7721945985185399,0.1304178978179906,1027977.2047566789,2462.025111591779,1030439.2298682707,2210,0,326.8641304347826,74,110,38,37.35579780623546,0.5541779891304348,42.958333333333314,7998.525827252485,108.08818685476331,8
2325,30.94118590440427,0,0,180,0.0,0.0,1.0,180,5750,3900,1850,0.6782608695652174,76,39,37,219.87381188639563,0.47763358679908957,0.767801846567933,0.12641087952879373,1010324.1944594433,2678.7663753699235,1013002.9608348133,2211,1,334.89444444444445,69,111,38,38.83051641142104,0.5432291666666667,44.44940476190476,7907.038475243066,114.59476051076908,8
2326,30.951411009598996,2,1,181,0.01098901098901099,0.005494505494505495,0.9945054945054945,182,5300,3800,1500,0.7169811320754716,68,38,30,220.1663832509507,0.4777380193471354,0.7715560064306017,0.1251769014690889,1007311.6605012324,2655.233019813126,1009966.8935210455,2212,0,332.2032967032967,76,106,40,39.25579299008432,0.5396634615384616,44.872835497835496,7896.545728220064,103.9019174765798,8
2327,31.03640528751792,4,2,183,0.021621621621621623,0.010810810810810811,0.9891891891891892,185,5900,4500,1400,0.7627118644067796,73,45,28,208.64604477551214,0.477459116725421,0.7630342019594512,0.11994048870956683,1013395.1645246341,-611.8214254611166,1012783.343099173,2213,0,327.77837837837836,70,115,42,39.12236383817507,0.5428490990990991,44.45422535211268,7931.222231484563,113.30317473549376,0
2328,31.153654947626052,5,5,183,0.026595744680851064,0.026595744680851064,0.973404255319149,188,6300,4300,2000,0.6825396825396826,83,43,40,190.2469201996072,0.4777106563128153,0.7422474855034744,0.1090541089013049,1016368.2268899559,-5227.815009090007,1011140.4118808659,2214,0,323.38829787234044,76,112,43,39.70205310171947,0.5420545212765957,44.561688311688314,7957.837022741823,104.70838187818188,8
2329,31.055507360844693,2,5,180,0.010810810810810811,0.02702702702702703,0.972972972972973,185,6450,4900,1550,0.7596899224806202,80,49,31,219.30036854056712,0.47729142185663925,0.7755928950578275,0.12888932020249763,1020635.8964249415,1315.1656463442646,1021951.0620712858,2215,0,329.35675675675674,64,121,37,37.9994113847564,0.5489301801801802,43.62179487179486,7961.955236519108,124.40555057061107,7
2330,31.24625946787443,1,3,178,0.0055248618784530384,0.016574585635359115,0.9834254143646409,181,6050,4300,1750,0.7107438016528925,78,43,35,217.7124666749333,0.4768249948843872,0.7692799190846997,0.1286022477568211,1028407.1400007072,2529.411039133515,1030936.5510398408,2216,0,334.3756906077348,65,116,39,37.848589238845165,0.5515078268876612,43.43434343434343,8016.717075596064,123.33410885532406,0
2331,31.19943549704416,4,1,181,0.02197802197802198,0.005494505494505495,0.9945054945054945,182,5400,3700,1700,0.6851851851851852,71,37,34,213.13899251053482,0.47674005322485985,0.7669051552858663,0.12752164245356634,1030656.0110253537,2134.5967629739753,1032790.6077883276,2217,0,332.032967032967,69,113,40,37.48281277137732,0.5550022893772895,42.96130952380952,8019.462043756587,116.22408759067518,0
2332,31.20801734447607,1,2,180,0.005494505494505495,0.01098901098901099,0.989010989010989,182,5050,3300,1750,0.6534653465346535,68,33,35,240.80485147773652,0.47642763544006633,0.789256849454625,0.13777307273372566,1017566.686416622,7556.998958249215,1025123.6853748712,2218,0,333.0274725274725,65,117,32,38.48449732179644,0.5398923992673993,44.633838383838366,7969.4716009094145,122.60725539860638,7
2333,31.703047352604724,1,2,179,0.0055248618784530384,0.011049723756906077,0.988950276243094,181,6000,4300,1700,0.7166666666666667,77,43,34,249.17466228373885,0.4762750665029671,0.7842882698665323,0.1367388626176244,1020732.6945088219,8668.144887241335,1029400.8393960632,2219,0,335.8066298342541,73,108,31,39.9185365470313,0.5239986187845305,46.241554054054056,8044.916027947713,110.20432914996867,8
2334,31.76925112803385,5,3,181,0.02717391304347826,0.016304347826086956,0.9836956521739131,184,6550,4700,1850,0.7175572519083969,84,47,37,236.83149690943216,0.4777504306248515,0.7789112615823219,0.1313338301043219,1026157.8424254716,5255.299577395701,1031413.1420028673,2220,0,330.91847826086956,67,117,38,39.81386612021856,0.5276834239130435,45.83333333333334,8074.684661708629,120.51768151803924,0
2335,31.94830575183425,6,3,184,0.03208556149732621,0.016042780748663103,0.983957219251337,187,6100,4100,2000,0.6721311475409836,81,41,40,220.77915758330732,0.4789510378931631,0.769392063045313,0.12227007157640561,1031523.7057431412,2047.7869562364122,1033571.4926993777,2221,0,326.18716577540107,80,107,42,40.27443910256408,0.5259024064171123,45.88477366255144,8118.55094722537,101.48188684031712,8
2336,31.480527816200812,6,2,188,0.031578947368421054,0.010526315789473684,0.9894736842105263,190,5400,4000,1400,0.7407407407407407,68,40,28,213.9726906848586,0.4795623317553142,0.7663335719238615,0.12016175207194994,1020732.4499161784,281.77375558224276,1021014.2236717606,2222,0,321.6684210526316,76,114,45,39.897427043490566,0.5304824561403509,45.34632034632033,8016.632245835519,105.48200323467788,0
2337,31.444533188715248,1,5,184,0.005291005291005291,0.026455026455026454,0.9735449735449735,189,6950,5100,1850,0.7338129496402878,88,51,37,215.9630396430369,0.47921709069758717,0.7660135932440721,0.12225418558110118,1022027.1922585659,-605.9801924005387,1021421.2120661654,2223,0,322.2116402116402,79,110,37,39.532848594726154,0.533344356261023,45.039062499999986,8017.127661044672,101.48262862081863,0
2338,31.383570341943066,3,3,184,0.016042780748663103,0.016042780748663103,0.983957219251337,187,5600,4300,1300,0.7678571428571429,69,43,26,217.9806207908344,0.478909110076093,0.7694265799471083,0.12429674049614357,1022268.1064496959,1566.9272917153994,1023835.0337414113,2224,0,326.2834224598931,68,119,42,39.19776818280397,0.535650623885918,44.761473429951714,8010.296252585066,117.79847430272156,0
2339,30.939258444130374,3,1,186,0.016042780748663103,0.0053475935828877,0.9946524064171123,187,6100,4400,1700,0.7213114754098361,78,44,34,208.79226720388166,0.4788599946332394,0.7573810371792222,0.11998119742171864,1010114.9861038892,-1319.1603829499418,1008795.8257209392,2225,0,326.4438502673797,73,114,40,39.132592868029185,0.5384358288770054,44.46790540540543,7905.9735154321925,108.30100706071497,0
2340,31.332518856239204,0,3,183,0.0,0.016129032258064516,0.9838709677419355,186,6500,4600,1900,0.7076923076923077,84,46,38,209.79564084915074,0.4782639494333043,0.754909483317391,0.12125476869417119,1024699.6758156711,-704.4949668664176,1023995.1808488047,2226,1,329.1720430107527,74,112,43,38.88447648528298,0.5403785842293907,44.250000000000036,8013.291697483255,108.28772564166562,0
2341,31.516050037407922,4,6,181,0.0213903743315508,0.03208556149732621,0.9679144385026738,187,6250,4700,1550,0.752,78,47,31,237.4607848655496,0.4793140129952274,0.786137675223429,0.13394632622027633,1023256.1332984647,4946.6409063082865,1028202.774204773,2227,0,325.32085561497325,75,112,37,39.12435456110155,0.5318070409982174,45.17543859649123,8031.0636279535265,107.08084837271369,8
2342,31.378433850487426,3,3,181,0.016304347826086956,0.016304347826086956,0.9836956521739131,184,5500,3600,1900,0.6545454545454545,74,36,38,238.298343973837,0.4792675170270056,0.782349517148456,0.1354422274600479,1021110.5132814973,6365.788865851104,1027476.3021473484,2228,0,330.42391304347825,77,107,41,38.80580493465252,0.5341372282608696,44.885149572649574,8005.1044584116125,103.96239556378717,0
2343,31.625918505026572,3,2,182,0.016304347826086956,0.010869565217391304,0.9891304347826086,184,6150,3800,2350,0.6178861788617886,85,38,47,231.80231500623552,0.4794481814762018,0.7770416074599191,0.13294044809310449,1031927.2278266228,4890.62406563548,1036817.8518922583,2229,0,330.6847826086956,66,118,42,38.62135597346477,0.537307518115942,44.54291044776118,8079.06509571035,122.41007720773257,0
2344,31.345941761364735,3,3,182,0.016216216216216217,0.016216216216216217,0.9837837837837837,185,6900,5000,1900,0.7246376811594203,88,50,38,227.46782578194143,0.4803417547982765,0.7699975010033855,0.12768679934189148,1016239.9061363552,2332.3763843359957,1018572.2825206913,2230,0,329.1189189189189,72,113,41,39.5702577752872,0.5274774774774775,45.36244292237441,7981.854034411406,110.85908381126953,7
2345,31.61739071544262,3,2,183,0.016216216216216217,0.010810810810810811,0.9891891891891892,185,6000,4300,1700,0.7166666666666667,77,43,34,223.82793764858812,0.48057065217391304,0.7781544738024382,0.1261211740815275,1026215.1802171489,2939.125474335552,1029154.3056914844,2231,0,327.18918918918916,75,110,35,39.5137917585669,0.5299549549549549,45.21655701754385,8055.587664601988,107.40783552802651,8
2346,31.71948195330728,0,1,182,0.0,0.00546448087431694,0.994535519125683,183,6650,4600,2050,0.6917293233082706,87,46,41,228.10567803822488,0.4799523108949339,0.7791647236542549,0.12901657149841964,1030696.4365141034,3771.5419005262197,1034467.9784146297,2232,1,330.0327868852459,77,106,36,39.25706558751111,0.5323315118397085,45.07211538461537,8086.180435452466,105.0153303305515,0
2347,32.02457996181573,2,2,182,0.010869565217391304,0.010869565217391304,0.9891304347826086,184,6050,4300,1750,0.7107438016528925,78,43,35,229.85545128218737,0.47979033024471374,0.7821859568526977,0.1306113602716912,1042060.4888624197,5054.656786161501,1047115.1456485812,2233,0,329.2173913043478,80,104,39,39.030809430189365,0.5345335144927537,44.89454732510287,8169.644967882417,102.12056209853021,0
2348,31.568476936717115,2,2,182,0.010869565217391304,0.010869565217391304,0.9891304347826086,184,5850,4600,1250,0.7863247863247863,71,46,25,222.5913946205659,0.4796845301734379,0.7733357226729431,0.12279483547492925,1018045.2396313107,2671.621935271811,1020716.8615665825,2234,0,330.1576086956522,76,108,38,40.38324100214844,0.5242866847826086,46.036255411255375,8017.248613812015,105.49011333963178,8
2349,31.501751427459258,3,3,182,0.016216216216216217,0.016216216216216217,0.9837837837837837,185,6800,5000,1800,0.7352941176470589,86,50,36,220.2301344104902,0.47973095377986685,0.7719174179600636,0.12261102251787231,1018744.394627513,1071.6429917500236,1019816.037619263,2235,0,328.6702702702703,67,118,40,40.079257519174426,0.5274211711711712,45.68014705882352,8011.520790420919,119.57493717046148,0
2350,31.87565305084455,5,3,184,0.026737967914438502,0.016042780748663103,0.983957219251337,187,5400,3700,1700,0.6851851851851852,71,37,34,219.18890372341988,0.48023163322024803,0.7741774728369584,0.12036602084468878,1026506.5324902968,2199.768304295179,1028706.3007945919,2236,0,325.9732620320856,70,117,35,40.65209850849811,0.5242869875222816,46.21478873239435,8089.569343801436,115.56527634002052,8
2351,31.891330005290435,4,1,187,0.02127659574468085,0.005319148936170213,0.9946808510638298,188,6400,4900,1500,0.765625,79,49,30,213.7264459732976,0.4807530483179732,0.7698509766516404,0.1187083031249286,1030597.7660117276,53.19955154160971,1030650.9655632692,2237,0,325.1170212765957,67,121,38,40.33853539005384,0.5272052304964538,45.772058823529434,8107.667168624438,121.00995774066325,0
2352,32.07980786806857,5,3,189,0.026041666666666668,0.015625,0.984375,192,7150,5000,2150,0.6993006993006993,93,50,43,204.51887860887115,0.48116864819662597,0.7683752166569375,0.11578754296009018,1042707.0443581486,-2899.3449140600596,1039807.6994440885,2238,0,319.0625,76,116,43,39.82066111317452,0.5346137152777778,45.035173160173166,8179.222658137035,107.621350764961,8
2353,32.10814423007536,3,4,188,0.015625,0.020833333333333332,0.9791666666666666,192,6950,5300,1650,0.762589928057554,86,53,33,221.481054939975,0.4807715468659104,0.777712856855648,0.12687606730668194,1047306.2530727055,1041.6987551555449,1048347.951827861,2239,0,320.0364583333333,70,122,42,38.92933731594769,0.5383572048611112,44.58626760563384,8200.86095806027,117.15515654371814,8
2354,31.819982113544192,2,1,189,0.010526315789473684,0.005263157894736842,0.9947368421052631,190,5150,2700,2450,0.5242718446601942,76,27,49,234.9933063742317,0.48022138680033416,0.7916300509133327,0.1308302774119722,1029035.750280999,5213.302667164283,1034249.0529481632,2240,0,321.1,67,123,38,39.70380074689796,0.5304824561403509,45.68014705882354,8092.453171707459,120.78288315981281,8
2355,32.10599935643057,4,6,187,0.02072538860103627,0.031088082901554404,0.9689119170984456,193,4850,3600,1250,0.7422680412371134,61,36,25,228.8740514030163,0.4806857638888889,0.7900122203182693,0.1288522974473343,1041800.5499294632,4238.222523249701,1046038.7724527129,2241,0,316.7150259067358,74,119,42,39.41943354050811,0.533786701208981,45.25000000000002,8179.003336050742,110.52707210879382,0
2356,32.58861324270579,5,2,190,0.026041666666666668,0.010416666666666666,0.9895833333333334,192,6500,5000,1500,0.7692307692307693,80,50,30,205.42801155920324,0.48027957297120416,0.7668354144174854,0.1152479303611866,1056341.660682776,-1499.566623758064,1054842.094059018,2242,0,313.359375,71,121,47,40.15432931795368,0.5310872395833333,45.38483796296297,8297.55504135388,116.86697241343494,8
2357,32.92125286636049,3,6,187,0.015544041450777202,0.031088082901554404,0.9689119170984456,193,5700,3900,1800,0.6842105263157895,75,39,36,205.31570637051146,0.48072736758779505,0.7662943495762133,0.11603354947310078,1069489.293801802,-383.4100374767322,1069105.8837643252,2243,0,312.6373056994819,76,117,37,39.869374270247306,0.5331930051813472,45.10281385281385,8391.534720075279,110.4149305273063,0
2358,32.97094787880398,6,4,189,0.031088082901554404,0.02072538860103627,0.9792746113989638,193,6450,5100,1350,0.7906976744186046,78,51,27,203.74843815077028,0.4808409344415659,0.7653589933382676,0.11608922638822974,1073720.2400310396,-1296.2356165610418,1072424.0044144785,2244,0,309.4922279792746,82,111,46,39.59183673469388,0.5365932642487047,44.79166666666667,8414.46065656978,102.61537386060706,0
2359,33.329864181329924,4,1,192,0.02072538860103627,0.0051813471502590676,0.9948186528497409,193,5850,4000,1850,0.6837606837606838,77,40,37,214.48580462161198,0.4805868145509499,0.7735467799043343,0.12365322561742624,1089209.2506370447,2273.984504838044,1091483.2351418827,2245,0,309.94300518134713,69,124,48,38.86180636398913,0.5394537996545768,44.3452380952381,8520.938491595973,123.49186219704308,0
2360,32.89240659503593,5,5,192,0.025380710659898477,0.025380710659898477,0.9746192893401016,197,6900,5500,1400,0.7971014492753623,83,55,28,186.83283127965683,0.4809191443074692,0.7494343605734997,0.10665090464559926,1071761.492735794,-6251.953171131793,1065509.5395646621,2246,0,304.5939086294416,72,125,46,39.95085708962182,0.535427241962775,44.72031963470322,8396.76304202621,116.6217089170307,7
2361,32.805994467065446,2,2,192,0.010309278350515464,0.010309278350515464,0.9896907216494846,194,6650,5000,1650,0.7518796992481203,83,50,33,184.25185902346718,0.48022107526307356,0.7402233192061622,0.10587012223889011,1071033.5602913422,-5982.01508795926,1065051.5452033828,2247,0,310.1082474226804,77,117,47,39.7629873523571,0.5372100515463918,44.47115384615387,8382.877913098748,108.86854432595776,0
2362,33.2012110609564,3,2,193,0.015384615384615385,0.010256410256410256,0.9897435897435898,195,5450,3800,1650,0.6972477064220184,71,38,33,202.26729622672528,0.4806172349986783,0.7691992756475861,0.11292294195057762,1074609.3340658806,-978.33509969846,1073630.9989661821,2248,0,307.6717948717949,67,128,43,40.42668884339817,0.5251068376068376,45.57291666666667,8447.287293373556,126.07891482647099,8
2363,33.013442644063,5,1,197,0.025252525252525252,0.005050505050505051,0.9949494949494949,198,6850,5100,1750,0.7445255474452555,86,51,35,238.75698325880447,0.4817180903792579,0.806161142499561,0.13314988889582183,1068179.1413453368,4557.0458735186385,1072736.1872188554,2249,0,303.80808080808083,61,137,40,39.54129791075006,0.5235164141414141,45.61491935483871,8398.12726938438,137.67421753089147,8
2364,32.55127645615924,5,3,199,0.024752475247524754,0.01485148514851485,0.9851485148514851,202,5850,4300,1550,0.7350427350427351,74,43,31,212.9833576926464,0.4821678529793278,0.7874808684698842,0.11706077779949174,1048546.7688072466,-1585.3976963316863,1046961.3711109149,2250,0,298.74257425742576,71,131,36,40.774623803009575,0.5166563531353136,46.18055555555554,8262.146906059836,116.3682662825329,8
2365,32.13849635007691,3,1,201,0.01485148514851485,0.0049504950495049506,0.995049504950495,202,6100,4100,2000,0.6721311475409836,81,41,40,211.9810211596784,0.48177224438861793,0.7862623957492718,0.11743193163456991,1037757.3520972984,-2503.0273572907427,1035254.3247400076,2251,0,299.68811881188117,77,125,42,40.48639576435963,0.5193894389438944,45.873397435897395,8167.246888963759,106.06814141511376,0
2366,32.11275254908073,6,1,206,0.028985507246376812,0.004830917874396135,0.9951690821256038,207,6450,4700,1750,0.7286821705426356,82,47,35,205.9180922737165,0.48276347263261576,0.785375200019788,0.11257404656969405,1032715.826206891,-5319.025441320588,1027396.8007655704,2252,0,293.39130434782606,72,135,41,41.167548153566266,0.5163043478260869,46.38984018264839,8144.120306147405,113.11278202982507,8
2367,32.29257874110563,6,6,206,0.02830188679245283,0.02830188679245283,0.9716981132075472,212,6100,4000,2100,0.6557377049180327,82,40,42,186.95437333443007,0.4834398007392173,0.7691322322335081,0.10244387074561677,1039242.7956995617,-9641.80287753324,1029600.9928220285,2253,0,287.02830188679246,84,128,46,41.5559688274885,0.5193101415094339,46.299019607843164,8192.65888600949,97.53165340487489,8
2368,31.920875269009098,3,5,204,0.014354066985645933,0.023923444976076555,0.9760765550239234,209,6150,4900,1250,0.7967479674796748,74,49,25,186.66275918040222,0.4831625337381917,0.7671303255460429,0.10309946461890815,1029792.9075488416,-9505.202898504644,1020287.7046503369,2254,0,291.99043062200957,86,123,43,41.24754497603897,0.5218799840510366,45.98898467432952,8108.253937165143,94.28202252517607,0
2369,32.199886330397185,6,5,205,0.02857142857142857,0.023809523809523808,0.9761904761904762,210,5850,4000,1850,0.6837606837606838,77,40,37,189.5135390252049,0.48380135945925423,0.7691639199849547,0.10396233024518345,1036617.1526374168,-8559.402957890383,1028057.7496795264,2255,0,291.3285714285714,78,132,47,41.44646816323703,0.5192460317460317,46.25527426160337,8170.551325714165,104.75065802197648,8
2370,32.31641389475451,2,2,205,0.00966183574879227,0.00966183574879227,0.9903381642512077,207,5700,3800,1900,0.6666666666666666,76,38,38,229.25545346086784,0.4840278754905179,0.8027469643167902,0.12513309525106453,1038753.5831713697,527.9847488104851,1039281.5679201803,2256,0,290.09178743961354,68,139,38,40.63957527041776,0.5148450080515298,46.45229468599032,8193.75258699274,120.49636157342263,8
2371,32.38663569434924,3,4,204,0.014423076923076924,0.019230769230769232,0.9807692307692307,208,7450,5700,1750,0.7651006711409396,92,57,35,233.1088927027431,0.48440693515421773,0.8064604107979201,0.12889039520744164,1045160.1085739962,-322.7768786475781,1044837.3316953486,2257,0,289.59615384615387,72,136,38,40.02529862203248,0.5184294871794872,45.94748858447487,8227.906134449073,114.27647408957046,0
2372,32.833793174490005,1,3,202,0.004878048780487805,0.014634146341463415,0.9853658536585366,205,6650,4700,1950,0.706766917293233,86,47,39,229.06843602526064,0.4842210664753706,0.7985232316091275,0.1248953516312117,1055028.8923577573,684.7636667709457,1055713.6560245282,2258,0,294.69756097560975,73,132,36,40.68793149721437,0.515548780487805,46.494932432432435,8323.532957198633,114.0209994136799,8
2373,32.370578661892765,6,2,206,0.028846153846153848,0.009615384615384616,0.9903846153846154,208,6950,4900,2050,0.7050359712230215,90,49,41,205.29179958716466,0.48455838520376565,0.7800842992623829,0.11183806992435086,1039875.178971514,-5854.4306325825755,1034020.7483389314,2259,0,291.3173076923077,74,134,42,41.32420091324202,0.5119691506410257,46.52777777777778,8205.042508049206,110.87895281147576,8
2374,32.51343555253295,3,4,205,0.014354066985645933,0.019138755980861243,0.9808612440191388,209,7350,5700,1650,0.7755102040816326,90,57,33,204.09868274923178,0.48480822905165005,0.7794891016567811,0.11082726357041184,1043410.3378945761,-6558.264893757021,1036852.0730008191,2260,0,290.1578947368421,75,134,39,41.48497799899017,0.5102173046251994,46.65570175438599,8237.093513610504,109.82791351480671,8
2375,32.649302567588826,8,10,203,0.03755868544600939,0.046948356807511735,0.9530516431924883,213,5050,3400,1650,0.6732673267326733,67,34,33,214.18468602689416,0.48522344760386216,0.7937887942589645,0.11854792589657127,1053966.4620433282,-2501.304848874635,1051465.1571944535,2261,0,285.2535211267606,83,130,35,40.46547096144461,0.5197574334898278,45.9077380952381,8295.935139011614,99.95102577122425,8
2376,32.573043952774924,1,2,202,0.004901960784313725,0.00980392156862745,0.9901960784313726,204,7000,5000,2000,0.7142857142857143,90,50,40,213.8556572054122,0.48424973437650926,0.7891834894877503,0.11733161733161712,1048673.8814452272,-2947.0315778764375,1045726.8498673508,2262,0,297.55392156862746,74,130,43,40.823412698412675,0.5165441176470589,46.24999999999997,8265.409903016569,111.69472841914282,8
2377,32.183420508248574,4,2,204,0.019417475728155338,0.009708737864077669,0.9902912621359223,206,6000,3900,2100,0.65,81,39,42,211.55209983265954,0.4848217104743863,0.789365243053811,0.11665587219343679,1037742.5818141781,-3292.675546289498,1034449.9062678886,2263,0,295.626213592233,75,131,43,40.680321675302245,0.5142091423948221,46.052631578947334,8172.894944857775,108.97193259810366,8
2378,32.52241207184844,1,3,202,0.004878048780487805,0.014634146341463415,0.9853658536585366,205,6950,5000,1950,0.7194244604316546,89,50,39,207.24416252181473,0.48452195919018015,0.7837767573513026,0.11468957056835406,1049822.9580268885,-4436.064053508997,1045386.8939733795,2264,0,297.98536585365855,77,128,44,40.647666351308715,0.5161585365853658,45.913461538461505,8263.50710575564,107.31827410072259,0
2379,32.288862541775494,4,2,204,0.019417475728155338,0.009708737864077669,0.9902912621359223,206,8400,6300,2100,0.75,105,63,42,197.81543053655417,0.4844161930696977,0.7746626059792057,0.11054975157500363,1045402.1364304216,-8240.665259636598,1037161.471170785,2265,0,297.40291262135923,72,134,44,40.49993925120092,0.5190635113268609,45.53367579908675,8216.428163634155,114.11705782825214,0
2380,32.40185858179923,5,2,207,0.023923444976076555,0.009569377990430622,0.9904306220095693,209,7150,5300,1850,0.7412587412587412,90,53,37,204.74249733924813,0.48479672739541163,0.7883264878828953,0.11534703181787671,1051621.9321274683,-5887.659871899319,1045734.272255569,2266,0,289.85645933014354,69,140,47,40.006850748593344,0.5235745614035088,45.22321428571429,8255.241380639667,119.6411794295604,8
2381,32.06118641053218,2,5,204,0.009569377990430622,0.023923444976076555,0.9760765550239234,209,6650,4800,1850,0.7218045112781954,85,48,37,200.48029785751436,0.484844650963072,0.7836879970448176,0.1139401460770051,1043308.3845018308,-6617.444863566139,1036690.9396382647,2267,0,290.5693779904306,75,134,41,39.77310884865417,0.5262161084529506,44.88760964912281,8179.205902675933,109.05607870234577,0
2382,31.578576822909667,4,0,208,0.019230769230769232,0.0,1.0,208,6250,4000,2250,0.64,85,40,45,212.26929638112676,0.48443983804038154,0.7876063347246038,0.12002931579222945,1026040.2810770429,-4290.630295416548,1021749.6507816263,2268,0,292.8076923076923,78,130,40,39.67061932102277,0.5259415064102564,45.08175105485232,8049.955507875956,103.20455779328148,8
2383,31.791354164414074,4,0,212,0.018867924528301886,0.0,1.0,212,7250,4600,2650,0.6344827586206897,99,46,53,203.10477822208992,0.48472430251274257,0.7820590221998218,0.11586644014764963,1035690.2015866475,-7579.274259990422,1028110.9273266571,2269,0,288.2641509433962,65,147,47,39.55995331725712,0.5285475628930818,44.74431818181819,8114.9237831608225,124.84498127939727,0
2384,31.95172256887138,2,5,209,0.009345794392523364,0.02336448598130841,0.9766355140186916,214,7800,5700,2100,0.7307692307692307,99,57,42,223.4691439197166,0.48475183917628306,0.7987208442891247,0.12803434216682216,1042251.0000522766,-4017.8122537698255,1038233.1877985068,2270,0,286.5607476635514,73,141,35,38.87268072012491,0.532904984423676,44.58051801801802,8161.092426973131,111.79578667086481,8
2385,31.951408615026818,3,8,204,0.014150943396226415,0.03773584905660377,0.9622641509433962,212,6300,4300,2000,0.6825396825396826,83,43,40,231.13129511735838,0.48434006974872573,0.8053491594409976,0.1334863642775212,1044709.6933560002,-406.97911059340095,1044302.7142454068,2271,0,289.75943396226415,70,142,41,38.36763721552883,0.534689465408805,44.27816901408454,8170.6727136138825,116.72389590876975,8
2386,31.721103084087453,6,5,205,0.02857142857142857,0.023809523809523808,0.9761904761904762,210,6600,4800,1800,0.7272727272727273,84,48,36,231.9919123921435,0.4848446874762664,0.8018828136767593,0.135461240665914,1040527.6578160801,-321.19975326585063,1040206.4580628143,2272,0,290.2857142857143,80,130,37,37.92363307727071,0.5368055555555555,43.86574074074075,8124.861241329357,101.56076551661695,8
2387,31.81995890220996,4,6,203,0.019138755980861243,0.028708133971291867,0.9712918660287081,209,6300,4200,2100,0.6666666666666666,84,42,42,221.11395819662553,0.48449480891915103,0.7959748320290032,0.1283806681857067,1042039.5302273614,-2018.1029748151414,1040021.4272525462,2273,0,292.47846889952154,72,137,40,38.41940804757919,0.5365829346092503,44.07819634703196,8143.421274416893,113.10307325579018,8
2388,31.962934506505007,0,3,200,0.0,0.014778325123152709,0.9852216748768473,203,6650,4500,2150,0.6766917293233082,88,45,43,220.0496108708765,0.48374831325497086,0.7887890735378056,0.12787350829227107,1046988.2822952614,-1172.1271789118355,1045816.1551163496,2274,1,301.2118226600985,73,130,41,38.413341674457826,0.5388444170771757,44.04560810810812,8181.053464692886,112.06922554373817,0
2389,31.82596583742103,2,3,199,0.009900990099009901,0.01485148514851485,0.9851485148514851,202,7250,5600,1650,0.7724137931034483,89,56,33,235.04842460600568,0.48313147546097895,0.8008798930229786,0.13504513356691267,1039009.7479799886,1193.5208825957352,1040203.2688625843,2275,0,303.470297029703,68,134,36,38.46855429516716,0.5333642739273927,44.474637681159415,8132.34145175404,119.59325664344176,8
2390,31.733367888737877,1,1,199,0.005,0.005,0.995,200,7450,5700,1750,0.7651006711409396,92,57,35,232.42868743130126,0.4827617252931324,0.7969120009178532,0.13434008220498778,1037818.5807201121,793.7621017182655,1038612.3428218303,2276,0,306.53,70,130,38,38.3044353296619,0.5363541666666667,44.2488262910798,8115.846083281647,115.94065833259496,0
2391,31.39583500625543,1,1,199,0.005,0.005,0.995,200,6300,3700,2600,0.5873015873015873,89,37,52,230.22052948778187,0.48265232412060305,0.8025085548828641,0.1315199686502386,1023233.5397790698,813.8734635191672,1024047.413242589,2277,0,307.315,61,139,37,38.81311968061772,0.5308854166666667,44.69086021505378,8015.64362827721,131.40399390618379,8
2392,31.878757235654344,2,3,198,0.009950248756218905,0.014925373134328358,0.9850746268656716,201,6250,4100,2150,0.656,84,41,43,210.5574183271032,0.4828358208955224,0.7785394583661318,0.11715630712046465,1030750.2132589339,-3043.5792312177546,1027706.6340277161,2278,0,306.6666666666667,71,130,38,40.34871565113499,0.52337271973466,45.703124999999986,8106.668343910509,114.17842737902126,8
2393,31.841970940660808,5,3,200,0.024630541871921183,0.014778325123152709,0.9852216748768473,203,7650,5100,2550,0.6666666666666666,102,51,51,232.92768677228827,0.48307259913183437,0.8043840728361407,0.13452142952679727,1041125.9148739391,251.41019805384713,1041377.3250719929,2279,0,304.3497536945813,64,139,41,38.32239247143365,0.5343288177339902,44.27884615384616,8142.665549681495,127.22914921377335,8
2394,31.52042274350609,2,6,196,0.009900990099009901,0.0297029702970297,0.9702970297029703,202,7600,5700,1900,0.75,95,57,38,238.1478415430787,0.48264812488711556,0.8072372066634852,0.13902365491072538,1033875.1328734322,1243.0262637741653,1035118.1591372064,2280,0,306.76237623762376,66,136,40,37.77480170774146,0.5374896864686469,43.87437810945273,8073.187877433429,122.32102844596105,0
2395,31.092610225708476,2,2,196,0.010101010101010102,0.010101010101010102,0.98989898989899,198,6050,4300,1750,0.7107438016528925,78,43,35,238.50359874335908,0.4821480455998222,0.8038490129399221,0.14027150548889675,1022058.428237291,3102.922652115006,1025161.350889406,2281,0,313.80808080808083,60,138,40,37.48099123099123,0.539246632996633,43.596311475409834,7972.25994772904,132.87099912881732,0
2396,30.739524004685475,2,3,195,0.010101010101010102,0.015151515151515152,0.9848484848484849,198,7350,5500,1850,0.7482993197278912,92,55,37,212.97830093280498,0.4819643131825873,0.7798943613364488,0.12139838224830427,1001176.2983486803,-4304.234608700606,996872.0637399796,2282,0,313.77777777777777,65,133,35,39.34016397666605,0.5298821548821548,44.77588383838384,7845.467845324641,120.69950531268678,7
2397,30.89031755140478,3,1,197,0.015151515151515152,0.005050505050505051,0.9949494949494949,198,7250,5400,1850,0.7448275862068966,91,54,37,203.0200582971859,0.48205297475602044,0.7688295530672804,0.1138677718275515,1001214.5016785661,-6196.674700246178,995017.8269783199,2283,0,314.1161616161616,75,123,39,40.22573930519667,0.5233585858585859,45.394736842105246,7864.837429206307,104.8644990560841,8
2398,31.151506762063207,7,2,202,0.03431372549019608,0.00980392156862745,0.9901960784313726,204,5800,3600,2200,0.6206896551724138,80,36,44,189.51592562759265,0.4827948420747609,0.7654897964253728,0.10890416580936077,1017044.538313629,-8050.772583400734,1008993.7657302283,2284,0,305.71078431372547,73,131,42,39.62516526194018,0.5351307189542484,44.467905405405425,7960.209772687733,109.04396948887305,8
2399,31.01937328413402,3,3,202,0.014634146341463415,0.014634146341463415,0.9853658536585366,205,6850,5300,1550,0.7737226277372263,84,53,31,193.2501698931147,0.4827684122429459,0.7709534482346831,0.11196276639104594,1015182.5454558554,-8613.160123626016,1006569.3853322294,2285,0,303.14146341463413,78,127,39,39.21461887337013,0.5378048780487805,44.15875527426163,7936.0350716252215,101.74403937981053,0
2400,30.78015603508875,2,3,201,0.00980392156862745,0.014705882352941176,0.9852941176470589,204,6800,4900,1900,0.7205882352941176,87,49,38,205.93561677900328,0.48245476351460126,0.7765147601080993,0.11707481501258055,1001709.7671318735,-6342.456254429577,995367.310877444,2286,0,305.48039215686276,85,119,40,39.62255099780024,0.5313521241830066,44.876453488372064,7852.742569853057,92.38520670415362,8
2401,31.05491140298942,2,2,201,0.009852216748768473,0.009852216748768473,0.9901477832512315,203,6550,4900,1650,0.7480916030534351,82,49,33,207.6485152316169,0.4819863759774992,0.7772335271032362,0.11913558294355552,1013415.7984312512,-5063.142828697139,1008352.6556025541,2287,0,307.72906403940885,74,129,38,39.22293501504116,0.5338669950738917,44.52777777777781,7933.667227036,107.21171928427027,0
2402,30.761932849087877,4,3,202,0.01951219512195122,0.014634146341463415,0.9853658536585366,205,7000,4900,2100,0.7,91,49,42,198.2569155536101,0.481938466443488,0.7684295434671504,0.1147929202248021,1006574.9688753673,-8087.9102794594855,998487.0585959079,2288,0,299.05853658536586,81,124,35,39.11014003376702,0.5370426829268293,44.18191056910571,7869.458888655171,97.15381344018729,0
2403,30.43867972898323,0,3,199,0.0,0.01485148514851485,0.9851485148514851,202,7350,5200,2150,0.7074829931972789,95,52,43,202.59697640095138,0.48192874324745905,0.7729985551617606,0.11581804459303122,992239.6819412494,-7545.048114731999,984694.6338265174,2289,1,304.3069306930693,73,129,38,39.491967124244255,0.5360457920792079,44.6649774774775,7772.060974155836,106.46658868706625,8
2404,30.975999351267934,1,0,200,0.005,0.0,1.0,200,5550,4200,1350,0.7567567567567568,69,42,27,200.88606551566014,0.48162060301507537,0.7684187536400682,0.1153583192275554,1011107.6007064107,-4926.5144562217265,1006181.086250189,2290,0,308.31,76,124,40,39.361289070083465,0.5375,44.49404761904764,7914.552215197531,104.13884493680962,0
2405,30.968917149925975,3,2,201,0.014778325123152709,0.009852216748768473,0.9901477832512315,203,6600,4400,2200,0.6666666666666666,88,44,44,210.54628000904108,0.48170897754800107,0.788597371712711,0.12123513235177599,1011691.7767445886,-4598.411978138094,1007093.3647664505,2291,0,304.7389162561576,64,139,41,39.00927377220479,0.5348419540229885,44.39102564102563,7915.933149700605,123.68645546407195,8
2406,31.238987200954206,2,3,200,0.009852216748768473,0.014778325123152709,0.9852216748768473,203,6100,4200,1900,0.6885245901639344,80,42,38,207.51007869460872,0.4815016908094751,0.7854912172042061,0.12032460909322298,1022620.4217265609,-4259.191162561637,1018361.2305639993,2292,0,303.64039408866995,68,135,40,38.81780144354634,0.5370997536945813,44.12741545893718,7993.200393553294,117.54706461107786,0
2407,30.991703010578117,0,4,196,0.0,0.02,0.98,200,6550,4600,1950,0.7022900763358778,85,46,39,208.13063932151664,0.4810756909547738,0.7832521489971342,0.12114341748367088,1015657.184651239,-4272.1241654092855,1011385.0604858297,2293,1,308.09,70,130,41,38.65627984718242,0.5390104166666667,43.984741784037546,7934.348848805553,113.34784069722218,0
2408,30.832658127034303,0,3,193,0.0,0.015306122448979591,0.9846938775510204,196,7000,5000,2000,0.7142857142857143,90,50,40,230.71533450292438,0.48047161172161174,0.7976649441951638,0.13135432762952173,1003857.7805611156,121.07672710424595,1003978.8572882198,2294,2,314.4438775510204,71,125,37,38.9332218316514,0.5300807823129252,44.820601851851855,7867.859144164226,110.8149175234398,8
2409,30.913541008403786,2,2,193,0.010256410256410256,0.010256410256410256,0.9897435897435898,195,6200,4600,1600,0.7419354838709677,78,46,32,223.0831683325072,0.48040906687813906,0.7898435724738444,0.12817059427006217,1009222.1746353009,-171.90394618666278,1009050.2706891142,2295,0,316.63589743589745,68,127,36,38.774296939619525,0.5331196581196581,44.474637681159436,7899.193766730749,116.16461421662866,0
2410,30.651642313713076,3,2,194,0.015306122448979591,0.01020408163265306,0.9897959183673469,196,5850,4200,1650,0.717948717948718,75,42,33,245.34452248168878,0.48052066980638414,0.806574923547402,0.1407502786868633,1000228.7173349055,4030.127405400839,1004258.8447403064,2296,0,315.15816326530614,59,137,39,38.26346415222565,0.531781462585034,44.53124999999999,7830.536747331371,132.72096181917578,8
2411,30.672694656356295,2,3,193,0.01020408163265306,0.015306122448979591,0.9846938775510204,196,6050,3800,2250,0.628099173553719,83,38,45,245.2232212592119,0.48035441740798884,0.8047035920133614,0.14177474977436536,1003212.6948918684,3952.2097299036413,1007164.904621772,2297,0,312.53061224489795,63,133,42,37.966409995333265,0.5347045068027211,44.23828124999999,7844.901104003614,124.52223974608911,0
2412,30.94601522111452,3,1,195,0.015306122448979591,0.00510204081632653,0.9948979591836735,196,6900,4800,2100,0.6956521739130435,90,48,42,237.36767465285556,0.48018271411128555,0.7987316764136121,0.13851832993092777,1014927.5539901153,2082.1986863487455,1017009.752676464,2298,0,312.80102040816325,67,129,36,37.808593516358606,0.5379464285714286,43.88786764705881,7925.649946106192,118.29328277770436,0
2413,30.68991014812577,1,4,192,0.00510204081632653,0.02040816326530612,0.9795918367346939,196,6400,4800,1600,0.75,80,48,32,218.75926406116207,0.4798496642246642,0.7831941629327346,0.126224373329319,1003188.8630868514,-1708.6285193531294,1001480.2345674983,2299,0,313.7908163265306,73,123,40,38.719674447625344,0.5357674319727892,44.313063063063076,7847.009120644124,107.49327562526197,7
2414,30.64249153494487,1,4,189,0.0051813471502590676,0.02072538860103627,0.9792746113989638,193,5950,3500,2450,0.5882352941176471,84,35,49,218.45549498972923,0.4794657635290731,0.7801064974043961,0.1268033936397892,1003401.371702199,-710.2913342843067,1002691.0803679146,2300,0,317.56476683937825,76,117,36,38.49766964458777,0.5377806563039724,44.088203463203484,7841.77505907137,103.18125077725487,0
2415,31.17842781948024,2,2,189,0.010471204188481676,0.010471204188481676,0.9895287958115183,191,6950,4800,2150,0.6906474820143885,91,48,43,218.97003022649136,0.4793423348948287,0.78019997087727,0.12821028968646092,1023549.6267326641,-324.66145920665986,1023224.9652734575,2301,0,321.35078534031413,81,110,38,38.15187439062683,0.5415030541012216,43.76270325203254,7989.076061315287,98.63056865821342,0
2416,31.303082725113402,0,3,186,0.0,0.015873015873015872,0.9841269841269842,189,5550,3700,1850,0.6666666666666666,74,37,37,218.84854623657617,0.47903063904836957,0.7771260006253613,0.1284896065941126,1028460.11278863,1665.4001092193757,1030125.5128978493,2302,1,322.64550264550263,69,120,35,38.050766283524865,0.5427138447971782,43.660714285714285,8024.209866410766,116.29289661464878,0
2417,30.93728323748601,3,2,187,0.015873015873015872,0.010582010582010581,0.9894179894179894,189,5850,3900,1950,0.6666666666666666,78,39,39,218.74404925851837,0.4787714829824759,0.7770434247067755,0.12995308427671842,1019922.2115394386,970.382896167876,1020892.5944356065,2303,0,323.33862433862436,74,115,39,37.60536113515076,0.5466269841269842,43.222222222222214,7944.006840203329,107.35144378653148,0
2418,31.01232772368167,4,5,186,0.020942408376963352,0.02617801047120419,0.9738219895287958,191,6350,4700,1650,0.7401574803149606,80,47,33,220.9649595161453,0.4788348489023606,0.78103129081928,0.13265194522498697,1025466.6914323017,768.4411914983475,1026235.1326238,2304,0,320.5759162303665,80,111,34,37.154531513060284,0.550174520069808,42.83693415637857,7975.225276369032,99.6903159546129,0
2419,31.19717096190682,1,2,185,0.0053475935828877,0.0106951871657754,0.9893048128342246,187,6700,5000,1700,0.746268656716418,84,50,34,211.46120091715082,0.4782023268740536,0.7684362729711258,0.12749911173748432,1032856.7202392324,-418.1755125722266,1032438.5447266602,2305,0,327.3422459893048,67,120,41,37.236327737429065,0.5520833333333333,42.67769607843139,8027.727907752958,119.816834444074,8
2420,31.2466171538624,0,1,184,0.0,0.005405405405405406,0.9945945945945946,185,6000,4500,1500,0.75,75,45,30,224.2533672475916,0.4778777418723071,0.77474114459039,0.13070499605685995,1024418.5737726265,2945.8629278974154,1027364.4367005238,2306,1,330.2756756756757,84,101,35,38.19145329823719,0.5468468468468468,43.93382352941177,8001.201782229847,95.25240216940294,8
2421,31.063300725399376,1,0,185,0.005405405405405406,0.0,1.0,185,4900,3400,1500,0.6938775510204082,64,34,30,223.72836636527714,0.47763782804543675,0.7730782433576684,0.13119324760545784,1020216.774247222,3750.286448156734,1023967.0606953787,2307,0,331.2162162162162,71,114,36,37.97258679085523,0.5485360360360361,43.70659722222222,7961.319044422014,112.13125414678892,0
2422,31.58184496633606,2,3,184,0.0106951871657754,0.016042780748663103,0.983957219251337,187,4700,3200,1500,0.6808510638297872,62,32,30,225.39493687619782,0.4776608590650336,0.784965871049085,0.1320170344560589,1036896.1208674024,4642.2271420166,1041538.348009419,2308,0,328.6631016042781,65,122,41,37.97425474254744,0.5462901069518716,43.75000000000001,8092.847772623629,124.50535034805583,8
2423,31.205866278240173,0,3,181,0.0,0.016304347826086956,0.9836956521739131,184,5500,3200,2300,0.5818181818181818,78,32,46,225.9258419071895,0.47715522788469156,0.7828871650533014,0.1329252197065353,1025895.9157912456,4055.279696856869,1029951.1954881025,2309,1,331.625,61,123,41,37.78884375136506,0.5481770833333333,43.58198924731183,8001.746154880741,131.17616647345477,0
2424,31.66011503594573,2,1,182,0.01092896174863388,0.00546448087431694,0.994535519125683,183,5700,4100,1600,0.7192982456140351,73,41,32,220.20814618090242,0.4768259973178006,0.7751619801073173,0.1305514075975899,1043126.9747306916,3641.0114673477055,1046767.9861980394,2310,0,328.4808743169399,66,117,43,37.64636706841905,0.5506033697632058,43.29912935323383,8127.1790945040375,123.13907718945511,0
2425,31.71374991427197,3,4,181,0.016216216216216217,0.021621621621621623,0.9783783783783784,185,5150,3800,1350,0.7378640776699029,65,38,27,213.53343802293443,0.47698663337250297,0.7702788577994011,0.12746368141499834,1046954.4527764242,2561.9567509540298,1049516.4095273782,2311,0,325.87567567567567,73,112,39,37.55934772287351,0.5529842342342342,43.046171171171174,8148.969466992131,111.6297187259196,0
2426,31.883304879453966,4,2,183,0.021621621621621623,0.010810810810810811,0.9891891891891892,185,5100,3600,1500,0.7058823529411765,66,36,30,201.065741591454,0.47660840188014103,0.7522492128961649,0.1171295111999238,1045133.7319315111,-71.88222538914943,1045061.849706122,2312,0,325.572972972973,81,104,43,38.80502910630414,0.5465653153153154,43.95325203252034,8163.616528839905,100.78538924493711,8
2427,32.34945449837409,2,2,183,0.010810810810810811,0.010810810810810811,0.9891891891891892,185,6050,4100,1950,0.6776859504132231,80,41,39,219.06337955917516,0.4767981296513905,0.7687053189722981,0.12588013466783793,1056147.3317022389,3222.6407590197286,1059369.9724612585,2313,0,325.25945945945944,70,115,43,38.87114600677498,0.545777027027027,44.46889671361504,8266.291798682276,118.08988283831823,8
2428,32.06130364675567,3,2,184,0.016129032258064516,0.010752688172043012,0.989247311827957,186,5650,4200,1450,0.7433628318584071,71,42,29,202.94269976347945,0.4768417611159546,0.7581388590390834,0.11490456773085253,1042131.1117822268,-551.4197334797263,1041579.6920487471,2314,0,323.02150537634407,77,109,42,39.85766289545356,0.5392025089605734,45.03205128205128,8174.604824036574,106.16369901346201,8
2429,32.02868637061172,6,2,188,0.031578947368421054,0.010526315789473684,0.9894736842105263,190,6450,4600,1850,0.7131782945736435,83,46,37,194.60162969669506,0.47744186856028964,0.7519111608809259,0.11153995848469131,1044886.6994429567,-3782.6690879998714,1041104.0303549569,2315,0,317.08947368421053,68,122,47,39.59441489361702,0.5433662280701754,44.56521739130436,8181.240540319322,120.31236088704884,0
2430,31.63559669424809,2,2,188,0.010526315789473684,0.010526315789473684,0.9894736842105263,190,5100,3100,2000,0.6078431372549019,71,31,40,191.6634741341172,0.47716397475169403,0.7483508505146517,0.11073421867686009,1034499.1736766112,-3444.8588768530894,1031054.314799758,2316,0,318.0263157894737,74,116,48,39.36236173717846,0.5452850877192983,44.26388888888892,8090.364471266606,109.32924961171089,0
2431,32.11411295282208,4,4,188,0.020833333333333332,0.020833333333333332,0.9791666666666666,192,5550,3800,1750,0.6846846846846847,73,38,35,188.93704644960584,0.4776924492801047,0.747937639821028,0.11020207086509155,1053086.133075426,-4156.60327193802,1048929.5298034882,2317,0,315.2291666666667,79,113,39,39.067690326079585,0.5480143229166667,43.906250000000036,8224.223614011871,104.1040963798971,0
2432,32.37609758997843,0,5,183,0.0,0.026595744680851064,0.973404255319149,188,6700,4700,2000,0.7014925373134329,87,47,40,195.04512650984714,0.4770362811468882,0.7517908477747348,0.11416213573978316,1062759.674405208,-2842.780971214172,1059916.893433994,2318,1,313.531914893617,80,108,42,38.778190457070224,0.5498116134751774,43.775720164609076,8295.542288872615,103.69427861090769,0
2433,32.43984885832809,4,1,186,0.0213903743315508,0.0053475935828877,0.9946524064171123,187,6150,4500,1650,0.7317073170731707,78,45,33,193.97042815728926,0.4758160351139478,0.7483555019288963,0.11439673282662063,1067202.315711832,-2148.8619781854977,1065053.4537336463,2319,0,315.8449197860963,72,115,46,38.517676346239426,0.5525289661319073,43.49315068493147,8321.043422906672,115.57004754037045,0
2434,32.11659636702903,0,1,185,0.0,0.005376344086021506,0.9946236559139785,186,6150,4400,1750,0.7154471544715447,79,44,35,191.0354486615879,0.47538385159352897,0.7433513046134941,0.1130401578886524,1057583.3248529357,-2942.819007941442,1054640.5058449942,2320,1,318.1505376344086,73,113,46,38.46738842265003,0.5542114695340502,43.3699324324324,8242.084295710882,112.9052643248066,0
2435,32.07282867416783,2,2,185,0.0106951871657754,0.0106951871657754,0.9893048128342246,187,5450,3200,2250,0.5871559633027523,77,32,45,189.66094684116902,0.47499904164989554,0.7426534580613484,0.11271749425092728,1057472.5938730459,-2737.7493174905653,1054734.8445555554,2321,0,317.39572192513367,74,113,50,38.337998269241176,0.5561497326203209,43.20833333333331,8236.03512995395,111.29777202640474,0
2436,32.29999876734143,3,4,184,0.015957446808510637,0.02127659574468085,0.9787234042553191,188,6150,4300,1850,0.6991869918699187,80,43,37,189.57985087815828,0.4746813014374028,0.7429659871862033,0.11364431497996604,1067599.4352705842,-3270.931652759662,1064328.5036178245,2322,0,315.218085106383,79,109,43,38.01634930281239,0.5593417553191489,42.89062499999997,8304.632495571848,105.12193032369429,0
2437,31.831297490881607,3,3,184,0.016042780748663103,0.016042780748663103,0.983957219251337,187,6750,5300,1450,0.7851851851851852,82,53,29,200.13440639905576,0.47447554290533417,0.7584489813591986,0.12056877653796784,1053600.0589307712,-1977.6755247759743,1051622.3834059953,2323,0,317.01604278074865,69,118,43,37.55904183535761,0.5614973262032086,42.708333333333336,8189.927583591419,118.6946026607452,8
2438,31.785233279949686,1,2,183,0.005405405405405406,0.010810810810810811,0.9891891891891892,185,5700,3800,1900,0.6666666666666666,76,38,38,220.9145038453687,0.4742276243634939,0.7726043293052585,0.1326628873654561,1051117.2065531488,3741.4072338034193,1054858.6137869523,2324,0,318.34594594594597,79,106,38,37.14416358665383,0.5584459459459459,42.825520833333314,8174.350813962009,103.47279511344315,8
2439,31.4102748550499,0,3,180,0.0,0.01639344262295082,0.9836065573770492,183,4600,3100,1500,0.6739130434782609,61,31,30,220.28275375662355,0.47375723092936206,0.7703250635152077,0.13257225780914214,1039363.7867316448,4590.783419231455,1043954.5701508762,2325,1,322.44262295081967,83,100,39,37.07866353338153,0.5597677595628415,42.745535714285694,8080.433430902851,97.35461964943194,0
2440,31.4576531892002,2,0,182,0.01098901098901099,0.0,1.0,182,5850,4400,1450,0.7521367521367521,73,44,29,216.6399165673107,0.47313017323376444,0.7667052180122407,0.13167117670492942,1043846.6905488516,2977.7719899134045,1046824.462538765,2326,0,324.72527472527474,70,112,38,36.80460637469864,0.5624427655677655,42.385563380281695,8103.9456037143045,115.77065148163292,0
2441,31.442271486385227,2,0,184,0.010869565217391304,0.0,1.0,184,5850,4200,1650,0.717948717948718,75,42,33,213.13428917695518,0.4732004088461234,0.7661924578969022,0.13032566738201073,1045114.7258457289,1899.9568402996974,1047014.6826860285,2327,0,322.1847826086956,72,112,44,36.67077130259931,0.5644814311594203,42.16609589041097,8106.883611408344,112.59560571400478,0
2442,31.16660322723567,1,5,180,0.005405405405405406,0.02702702702702703,0.972972972972973,185,6600,5300,1300,0.803030303030303,79,53,26,214.6538289690224,0.47334386016451235,0.7693844912584953,0.13197495049545493,1037542.5935381098,942.4980842813093,1038485.0916223911,2328,0,321.43783783783783,75,110,39,36.429450405467634,0.565990990990991,41.96820175438598,8041.974675931211,107.22632901241614,0
2443,31.535553291212107,0,3,177,0.0,0.016666666666666666,0.9833333333333333,180,6050,4600,1450,0.7603305785123967,75,46,29,232.74238741393663,0.47269682391889095,0.7760396902722966,0.13960963694122208,1042527.6336376794,6478.074079566484,1049005.707717246,2329,1,330.85555555555555,78,102,39,36.881976137975805,0.5575231481481482,42.86656118143456,8108.845262815405,103.95955465147955,8
2444,31.546760018854506,0,0,177,0.0,0.0,1.0,177,5100,3700,1400,0.7254901960784313,65,37,28,268.4477258771151,0.47245495206300286,0.8003669404158658,0.1531731141769423,1027782.0810851885,14681.152472913582,1042463.2335581022,2330,2,335.10169491525426,56,121,35,37.88436068155785,0.5376059322033898,44.736842105263165,8052.725583760241,143.7986711385757,8
2445,31.970205864671055,1,1,177,0.0056179775280898875,0.0056179775280898875,0.9943820224719101,178,6850,5000,1850,0.7299270072992701,87,50,37,249.89155470814498,0.4724622558666074,0.7896657859867104,0.14190801826594443,1040097.0206525391,9532.292307634458,1049629.3129601735,2331,0,334.2134831460674,73,105,36,38.54408099258688,0.5358731273408239,44.91835585585585,8155.01267558704,111.71250240530192,8
2446,31.719059793983586,3,4,176,0.016666666666666666,0.022222222222222223,0.9777777777777777,180,5450,3600,1850,0.6605504587155964,73,36,37,240.77542531449802,0.47313780260707633,0.7829602666555091,0.13770694999860783,1034119.5683862603,8348.115780849475,1042467.6841671098,2332,0,331.3333333333333,64,116,38,38.49917367474165,0.5387731481481481,44.6474358974359,8099.543249316261,126.55536327056657,0
2447,31.37043038460374,1,1,176,0.005649717514124294,0.005649717514124294,0.9943502824858758,177,5850,4400,1450,0.7521367521367521,73,44,29,247.4257309782976,0.4722810734463277,0.7941117694222692,0.1410427656670574,1021744.6664067233,9311.184191772076,1031055.8505984955,2333,0,336.79661016949154,56,121,37,38.45842880328419,0.5357815442561205,44.7733918128655,8006.5685444330375,142.9744382934471,8
2448,31.42078283688791,5,2,179,0.027624309392265192,0.011049723756906077,0.988950276243094,181,6200,4600,1600,0.7419354838709677,78,46,32,216.82017935486033,0.4733630038878658,0.7682631543438008,0.12582399384608803,1028814.3321234529,2213.541602771498,1031027.8737262244,2334,0,330.2486187845304,65,116,39,38.548733604703756,0.540458103130755,44.097222222222214,8040.665607911926,123.70254781402963,8
2449,31.066815087357984,0,1,178,0.0,0.00558659217877095,0.994413407821229,179,5800,4200,1600,0.7241379310344828,74,42,32,207.56328887353388,0.4732479128742703,0.7562726148391898,0.11735134555762845,1009368.549775052,301.57117536401574,1009670.120950416,2335,1,334.6480446927374,73,106,38,39.79622241242845,0.5320065176908753,45.08727477477479,7919.326497986603,108.48392462995346,8
2450,30.778320818487686,3,0,181,0.016574585635359115,0.0,1.0,181,4450,2900,1550,0.651685393258427,60,29,31,213.8028318013156,0.47362006343359936,0.7653911013455956,0.12222269303468891,1003307.9454523681,2252.0159812953666,1005559.9614336635,2336,0,331.9171270718232,65,116,39,39.20627807310338,0.5347605893186004,44.665404040404056,7858.770110503405,120.90415554620623,0
2451,31.050419767187243,2,1,182,0.01092896174863388,0.00546448087431694,0.994535519125683,183,5750,3900,1850,0.6782608695652174,76,39,37,219.72886089460354,0.47330936367821613,0.7738548244441241,0.12598841880071832,1013082.7832170022,2170.7051896411704,1015253.4884066434,2337,0,329.27868852459017,64,119,43,38.93833647009619,0.5362021857923498,44.55128205128204,7931.789921297483,123.93421752027317,8
2452,30.70737207217164,2,4,180,0.010869565217391304,0.021739130434782608,0.9782608695652174,184,6050,4300,1750,0.7107438016528925,78,43,35,224.6055998257015,0.473619278134157,0.7784652738883426,0.12296931777337475,987964.6694643036,1530.4794383259368,989495.1489026296,2338,0,328.4728260869565,72,112,36,40.635254354877986,0.5186820652173914,46.33276255707761,7789.454242679687,108.18686448166233,8
2453,31.17050468401611,11,9,182,0.05759162303664921,0.04712041884816754,0.9528795811518325,191,6250,4500,1750,0.72,80,45,35,213.45145953903335,0.47534904013961604,0.7706222995499503,0.12038714811443725,1011996.3996366173,-1247.5782898633943,1010748.8213467539,2339,0,316.81151832460733,74,117,36,39.741397321996345,0.5265597731239092,45.18055555555556,7942.850686633939,107.33582008964783,8
2454,31.230716684948423,4,3,183,0.021505376344086023,0.016129032258064516,0.9838709677419355,186,6150,3700,2450,0.6016260162601627,86,37,49,220.85245740774394,0.47547951176983433,0.7736763011749783,0.12523267514416594,1015590.472547447,1509.130316399186,1017099.6028638461,2340,0,323.6290322580645,73,113,40,39.342364905889504,0.5282258064516129,44.97466216216217,7964.624073496786,109.10443936296967,0
2455,30.84928379218543,4,2,185,0.0213903743315508,0.0106951871657754,0.9893048128342246,187,6250,4600,1650,0.736,79,46,33,222.46051586431327,0.4752338374254883,0.7787028839229861,0.12628397705079492,1003518.934534821,998.6679712446385,1004517.6025060656,2341,0,322.8663101604278,73,114,36,39.25818616629878,0.5289104278074866,44.93243243243245,7868.651778074358,107.78975038458024,8
2456,30.715805497831564,2,1,186,0.0106951871657754,0.0053475935828877,0.9946524064171123,187,6300,4600,1700,0.7301587301587301,80,46,34,222.66651094223252,0.4756111877791194,0.7805184239551608,0.12535355710796664,996680.864261012,685.4901135777482,997366.3543745897,2342,0,316.9197860962567,67,120,37,39.5788234115053,0.5257909982174689,45.251225490196084,7824.813808654102,116.7882658008075,8
2457,30.861977930240457,4,2,188,0.021052631578947368,0.010526315789473684,0.9894736842105263,190,6000,3700,2300,0.6166666666666667,83,37,46,217.9954238881625,0.47600598719019777,0.7807174824731604,0.12431810762519484,1005309.2848425695,-169.43526240782467,1005139.8495801616,2343,0,300.8578947368421,60,130,41,39.19334426083273,0.5298245614035088,44.757513661202175,7877.287980247657,131.28813300412762,0
2458,31.191298139330005,2,1,189,0.010526315789473684,0.005263157894736842,0.9947368421052631,190,6200,4300,1900,0.6935483870967742,81,43,38,209.89366779957342,0.47640687366564555,0.7717304051495633,0.12055875960388686,1018205.0702685601,-1457.0406458420694,1016748.029622718,2344,0,301.1736842105263,67,123,43,39.1222022382094,0.5321820175438596,44.485294117647044,7969.835370159664,118.95276671880096,0
2459,30.826212000756627,2,4,187,0.010471204188481676,0.020942408376963352,0.9790575916230366,191,6150,4300,1850,0.6991869918699187,80,43,37,236.34295943654797,0.4768531275833563,0.7968006168236308,0.13267770729120654,999410.5582831319,2890.729807353774,1002301.2880904857,2345,0,299.75392670157066,65,126,41,39.3416077848023,0.525359947643979,45.3598484848485,7849.591294510877,120.76294299247502,8
2460,31.14899746496596,2,3,186,0.010582010582010581,0.015873015873015872,0.9841269841269842,189,5500,4000,1500,0.7272727272727273,70,40,30,235.86055022093817,0.47610369995121765,0.7941369623474099,0.13573296909303062,1017400.6492584267,4692.935385846594,1022093.5846442734,2346,0,303.83597883597884,65,124,37,38.3845868840311,0.5354938271604939,44.412878787878796,7961.28259071433,122.4812706263743,8
2461,30.968020537656322,0,3,183,0.0,0.016129032258064516,0.9838709677419355,186,6350,4600,1750,0.7244094488188977,81,46,35,226.59878008945083,0.47562784558752297,0.7857047880334871,0.12985228999999737,1010220.5450511229,2232.948625977073,1012453.4936770999,2347,2,309.66129032258067,61,125,41,38.785313753864365,0.5336581541218638,44.573252688172055,7910.060756619462,129.67312715769611,8
2462,31.416034707116445,2,1,184,0.010810810810810811,0.005405405405405406,0.9945945945945946,185,6000,4200,1800,0.7,78,42,36,248.20185800265213,0.4752729631805719,0.8021339563308201,0.14067243468126472,1021467.6670872718,7706.034572139292,1029173.7016594111,2348,0,309.6216216216216,61,124,37,38.66396538850093,0.5277027027027027,44.99327956989249,8011.299979580237,131.33278655049568,8
2463,30.981158388200893,1,3,182,0.005405405405405406,0.016216216216216217,0.9837837837837837,185,6200,4300,1900,0.6935483870967742,81,43,38,215.38053110118608,0.4755336858597728,0.7708561360254511,0.12126678151883934,1005328.621919645,105.6425040555041,1005434.2644237005,2349,0,309.3891891891892,70,115,34,39.75958400522153,0.5309121621621622,45.24647887323945,7892.559187980075,112.7508455425725,8
2464,31.484907043821238,5,2,185,0.026737967914438502,0.0106951871657754,0.9893048128342246,187,7000,5300,1700,0.7571428571428571,87,53,34,211.29219142455716,0.4751739405439595,0.7692523139252381,0.12063344169649631,1025951.082039485,-1044.9095162962312,1024906.1725231888,2350,0,304.96256684491976,66,121,35,39.319935038570875,0.5348150623885918,44.713930348258714,8037.658172567561,121.78269958435699,0
2465,31.153806221616406,1,1,185,0.005376344086021506,0.005376344086021506,0.9946236559139785,186,6000,4300,1700,0.7166666666666667,77,43,34,206.56562904060968,0.47536932093383705,0.7646612610426211,0.11450794954379977,1006165.7725669849,-1632.1468541141126,1004533.6257128707,2351,0,303.6290322580645,72,114,44,40.597687758501294,0.5208333333333333,45.847602739726014,7917.814535005817,109.96964631952522,8
2466,31.61921733633916,1,3,183,0.005376344086021506,0.016129032258064516,0.9838709677419355,186,5800,4300,1500,0.7413793103448276,73,43,30,217.94501619606254,0.4754922260970648,0.7746075149877976,0.12039269702419075,1020100.4071581586,1465.1599519385954,1021565.5671100972,2352,0,304.4139784946237,75,111,42,40.44795095235526,0.5195452508960574,45.98410087719296,8031.783921249581,107.09045228332775,8
2467,31.969203761597072,3,3,183,0.016129032258064516,0.016129032258064516,0.9838709677419355,186,6050,4200,1850,0.6942148760330579,79,42,37,269.7108804575262,0.4759226968904388,0.8165774040098954,0.14748369995326852,1028173.9476490443,12211.940136782883,1040385.8877858273,2353,0,304.6666666666667,58,128,38,39.540259890938614,0.5116487455197133,46.380649717514125,8108.008687064654,139.79325322525264,8
2468,31.78685593854384,5,1,187,0.026595744680851064,0.005319148936170213,0.9946808510638298,188,6600,4900,1700,0.7424242424242424,83,49,34,240.54985002639333,0.47675005688929345,0.79550271769729,0.1310984438844211,1021250.7888861111,4932.344821177778,1026183.1337072889,2354,0,300.90425531914894,65,123,36,40.41434478965607,0.5154033687943262,46.511994949494934,8057.586698689246,123.96287228752686,8
2469,32.0650689264688,4,3,188,0.020942408376963352,0.015706806282722512,0.9842931937172775,191,6300,4700,1600,0.746031746031746,79,47,32,235.04598396227289,0.47797602645356846,0.7895006559588049,0.12915548090012172,1032807.5545511415,4051.453580628292,1036859.0081317697,2355,0,297.13612565445027,72,119,36,40.22436798410822,0.5181064572425829,46.190068493150676,8138.4329479894295,113.03379094429764,8
2470,32.466733762513655,5,2,191,0.025906735751295335,0.010362694300518135,0.9896373056994818,193,6400,4600,1800,0.71875,82,46,36,240.83681813416572,0.47787695200057567,0.7961378627385107,0.13415434926484907,1050119.8951921018,5581.506843489928,1055701.4020355917,2356,0,295.0259067357513,65,128,41,39.53427189988624,0.5218588082901554,45.65972222222223,8257.59808369489,127.03997051838292,0
2471,32.897162299136475,3,3,191,0.015463917525773196,0.015463917525773196,0.9845360824742269,194,5950,4200,1750,0.7058823529411765,77,42,35,236.42656540484813,0.4778090112707654,0.7987291707190542,0.1333043400686918,1067956.3713280666,5748.651375064255,1073705.0227031307,2357,0,294.3041237113402,64,130,43,39.16797693920336,0.5231958762886597,45.192307692307715,8382.450008914637,130.9757813892912,8
2472,33.14492801801207,3,1,193,0.015463917525773196,0.005154639175257732,0.9948453608247423,194,5700,4100,1600,0.7192982456140351,73,41,32,228.3523877330141,0.4774606947634564,0.7911916149056784,0.12979456195582384,1078608.6868590324,4760.573814766536,1083369.2606737989,2358,0,295.10309278350513,67,127,45,39.057934029862736,0.5256658075601375,44.88357843137258,8455.815429105036,126.20620043440353,0
2473,33.40221885726241,2,5,190,0.010256410256410256,0.02564102564102564,0.9743589743589743,195,5850,4300,1550,0.7350427350427351,74,43,31,227.58370074298637,0.47734271742003703,0.791556989449723,0.13032245315804097,1089393.4148510972,4735.636983370441,1094129.0518344676,2359,0,294.55897435897435,59,136,43,38.78822253189224,0.5274038461538462,44.60069444444444,8530.9035001595,144.59158474846612,0
2474,33.32421548994222,0,3,187,0.0,0.015789473684210527,0.9842105263157894,190,6500,4800,1700,0.7384615384615385,82,48,34,256.0267550622061,0.4774360670194004,0.8107117022243007,0.1436008077962742,1080109.0751234794,10807.364323420974,1090916.4394469003,2360,1,302.60526315789474,63,127,36,38.87528234140937,0.5229714912280702,45.39388020833333,8484.549200995534,134.67538414278627,8
2475,33.65848839524709,4,0,191,0.020942408376963352,0.0,1.0,191,6550,4900,1650,0.7480916030534351,82,49,33,261.9941159732757,0.4778761366767705,0.813853482517422,0.14548273948413662,1087626.473720974,12240.347298331635,1099866.8210193056,2361,0,301.91623036649213,59,132,36,39.120868332991876,0.5173974694589878,45.78125000000001,8556.618846729236,145.02743808015654,8
2476,33.46144224811105,4,3,192,0.020512820512820513,0.015384615384615385,0.9846153846153847,195,4950,3100,1850,0.6262626262626263,68,31,37,239.3576618285602,0.47871508502951804,0.8032446326612313,0.13062702889926345,1075507.2490844722,7536.180084105141,1083043.4291685773,2362,0,296.7025641025641,64,131,40,40.389619282388395,0.5109508547008548,46.45833333333333,8483.869836656477,132.56046619775745,8
2477,33.188442373880406,4,5,191,0.02040816326530612,0.025510204081632654,0.9744897959183674,196,6900,5100,1800,0.7391304347826086,87,51,36,231.18970329620416,0.4794092316413745,0.7980663432743007,0.12742316204930268,1069990.72559224,3374.1676758718054,1073364.8932681119,2363,0,294.6734693877551,69,127,37,40.200861462728525,0.514296343537415,46.071428571428555,8427.49375993888,122.13759072375187,0
2478,33.51555406190191,4,2,193,0.020512820512820513,0.010256410256410256,0.9897435897435898,195,6300,5000,1300,0.7936507936507936,76,50,26,233.71362718367862,0.4797019561194819,0.7989338622698818,0.13006215754930253,1083728.0808084153,5356.404129308213,1089084.4849377235,2364,0,292.6307692307692,60,135,38,39.7533071447757,0.5174145299145299,45.6967213114754,8523.115285004136,142.0519214167356,0
2479,33.42444648485046,4,2,195,0.02030456852791878,0.01015228426395939,0.9898477157360406,197,7350,5500,1850,0.7482993197278912,92,55,37,224.5994774247509,0.4802587278566249,0.7926478471592304,0.12665590510033561,1085125.5513028079,1993.7263525711091,1087119.277655379,2365,0,289.0761421319797,65,132,42,39.46313358108806,0.5212034686971235,45.18623737373738,8517.008972504913,131.03090726930634,0
2480,33.26679482793811,3,3,195,0.015151515151515152,0.015151515151515152,0.9848484848484849,198,6600,4400,2200,0.6666666666666666,88,44,44,221.21575411420406,0.4807022210258251,0.7941932276129156,0.12631550456817006,1084056.6828212652,1762.083318569777,1085818.766139835,2366,0,288.1818181818182,62,136,42,39.06155548359238,0.5261468855218856,44.708994708994716,8492.713494433952,136.97924991022504,8
2481,32.83512456618188,4,5,194,0.020100502512562814,0.02512562814070352,0.9748743718592965,199,7000,5100,1900,0.7285714285714285,89,51,38,228.1124216203007,0.4805043737204541,0.7941909890505385,0.13236053982238932,1075084.8609483966,2248.0422156527,1077332.9031640494,2367,0,287.6934673366834,73,126,37,38.264561215321706,0.5356993299832495,44.10191441441442,8402.4455164502,115.10199337603014,8
2482,32.56643054962732,2,3,193,0.01020408163265306,0.015306122448979591,0.9846938775510204,196,6600,4600,2000,0.696969696969697,86,46,40,227.5016285079524,0.4798796441653585,0.7920009550326235,0.13281801827138665,1068206.2580435746,2803.732657459912,1071009.9907010344,2368,0,292.85714285714283,76,120,40,38.044793922428234,0.5382653061224489,43.87175324675325,8341.182759687428,109.75240473272932,0
2483,32.07036086133375,0,0,193,0.0,0.0,1.0,193,6650,5200,1450,0.7819548872180451,81,52,29,234.93119418403631,0.4790632196315487,0.7964278836957419,0.1354240385549113,1048012.1150825784,3992.1475431373456,1052004.2626257157,2369,1,298.1761658031088,65,128,42,38.34372556282666,0.5330310880829016,44.34974747474746,8198.795852775918,126.1353208119372,8
2484,31.645838722096347,1,3,191,0.005154639175257732,0.015463917525773196,0.9845360824742269,194,6750,5000,1750,0.7407407407407407,85,50,35,258.74434732687854,0.4790309011270766,0.8124454930185152,0.15010991249716596,1036095.4931821715,8066.770430348459,1044162.26361252,2370,0,297.6340206185567,63,131,36,37.487013950727224,0.5354381443298969,44.10807291666668,8097.91465476563,128.5383278534227,8
2485,31.644109940894257,2,3,190,0.010362694300518135,0.015544041450777202,0.9844559585492227,193,5350,3600,1750,0.6728971962616822,71,36,35,252.37276484204082,0.4792948510362694,0.8069723307129915,0.14732774372812793,1037932.093615203,8439.15843679119,1046371.2520519942,2371,0,298.0,66,127,39,37.410464975112305,0.5376187392055267,43.87437810945273,8104.86733778437,122.80102026946015,0
2486,31.225620290557778,1,5,186,0.005235602094240838,0.02617801047120419,0.9738219895287958,191,5700,4200,1500,0.7368421052631579,72,42,30,254.99273015603208,0.47915059244971064,0.8060968767267886,0.14949176658313496,1025478.3921285208,8397.906984973804,1033876.2991134946,2372,0,300.67015706806285,59,132,37,37.180203676105336,0.5395397033158813,43.71527777777777,8002.64942238217,135.63812580308763,0
2487,31.31250059384572,1,3,184,0.0053475935828877,0.016042780748663103,0.983957219251337,187,5600,3900,1700,0.6964285714285714,73,39,34,220.46515871021617,0.47840957008414314,0.7795941438340959,0.128610411817059,1026843.6210110013,2276.6483753528364,1029120.2693863541,2373,0,306.427807486631,75,112,37,38.254671750958856,0.5438391265597148,43.90076754385966,8019.1073683663535,106.92143157821805,8
2488,31.426271920884997,1,1,184,0.005405405405405406,0.005405405405405406,0.9945945945945946,185,5850,4000,1850,0.6837606837606838,77,40,37,223.4267165293056,0.47752521543282417,0.7811853105683968,0.13137096794385733,1032950.1564646199,3307.7323594644654,1036257.8888240844,2374,0,310.53513513513514,64,121,36,37.877237118986585,0.5460022522522523,43.605769230769226,8057.5148150999785,125.89866898593716,0
2489,31.11805461908919,0,2,182,0.0,0.010869565217391304,0.9891304347826086,184,6350,4700,1650,0.7401574803149606,80,47,33,221.15446703782706,0.47666211293260474,0.7686313606532269,0.13022676513120787,1023257.518583565,2109.594232959225,1025367.1128165242,2375,1,313.1576086956522,67,117,38,37.87937050753639,0.5493659420289856,43.55085784313723,7980.19841265577,119.10743899486224,8
2490,31.296803624122077,1,0,183,0.00546448087431694,0.0,1.0,183,6150,4300,1850,0.6991869918699187,80,43,37,224.62932386457354,0.4762517764566945,0.775714835930102,0.12841833574216904,1020224.9075644882,3084.486235201618,1023309.3937996898,2376,0,311.40437158469945,64,119,39,38.92785413920796,0.540983606557377,44.66346153846154,7991.2175022938645,124.86277347334163,8
2491,31.526497585678154,3,1,185,0.016129032258064516,0.005376344086021506,0.9946236559139785,186,6450,4600,1850,0.7131782945736435,83,46,37,235.36874588057782,0.476560835028577,0.7899940703253086,0.136807579239122,1032763.000927003,4966.0264640100995,1037729.0273910131,2377,0,307.36559139784947,68,118,35,38.01226285264918,0.5449148745519714,44.036835748792264,8069.622079788225,118.67091293806213,8
2492,31.88780527399267,1,0,186,0.005376344086021506,0.0,1.0,186,6600,4700,1900,0.7121212121212122,85,47,38,236.54285097803862,0.47628233071781456,0.7906432301060695,0.13822533727449327,1046232.2294855664,5695.750869524962,1051927.9803550914,2378,0,308.36021505376345,71,115,38,37.77744832260248,0.5467069892473118,43.83680555555555,8168.482062808353,115.0490431381458,0
2493,32.16128823051428,1,2,185,0.0053475935828877,0.0106951871657754,0.9893048128342246,187,7100,5400,1700,0.7605633802816901,88,54,34,202.61318206625168,0.47638864930136277,0.750570105634246,0.11395972017193781,1043295.9215449296,-2222.8986998081355,1041073.0228451214,2379,0,307.70588235294116,79,108,44,40.12562621408852,0.5309714795008913,45.286458333333314,8191.9156297567315,103.69513455388268,8
2494,32.539002743155436,6,2,189,0.031413612565445025,0.010471204188481676,0.9895287958115183,191,6350,4600,1750,0.7244094488188977,81,46,35,211.7795714885897,0.47675897859832833,0.7737421642053846,0.11740434464319402,1050919.7372304995,-37.33367608442768,1050882.403554415,2380,0,302.16230366492147,84,107,40,40.46311699374769,0.5263961605584642,45.84558823529414,8269.931101596872,98.4515607332961,8
2495,32.36877584922225,5,4,190,0.02577319587628866,0.020618556701030927,0.979381443298969,194,6700,4900,1800,0.7313432835820896,85,49,36,200.49766594065463,0.477457912682727,0.7646115494644936,0.11271442013778776,1049870.83724376,-3400.6695186927705,1046470.1677250672,2381,0,296.37113402061857,72,122,41,40.19879731824378,0.5296928694158076,45.30536529680367,8244.153540707346,114.50213250982425,0
2496,31.95596363574939,2,4,188,0.010416666666666666,0.020833333333333332,0.9791666666666666,192,6600,5000,1600,0.7575757575757576,82,50,32,198.44606312868524,0.47723342513816175,0.7583445340501793,0.11225963425162859,1038432.2335267696,-3785.442286136931,1034646.7912406327,2382,0,300.1614583333333,75,117,38,40.00672043010751,0.5323893229166667,45.06578947368421,8146.668361087432,108.62224481449908,0
2497,31.903484099498428,2,1,189,0.010526315789473684,0.005263157894736842,0.9947368421052631,190,5700,4100,1600,0.7192982456140351,73,41,32,199.7686295379079,0.4769794857514156,0.7564310024794048,0.11354994947885728,1038215.6116822201,-2219.4180178765964,1035996.1936643436,2383,0,303.38421052631577,79,111,42,39.78637140815597,0.5342105263157895,44.882812499999986,8139.12713491497,103.02692575841735,0
2498,32.05706417311803,3,4,188,0.015625,0.020833333333333332,0.9791666666666666,192,6550,5300,1250,0.8091603053435115,78,53,25,220.74967203219128,0.4772322889397906,0.7846976501542375,0.12554710449632683,1043390.9624769947,1115.6425536298148,1044506.6050306245,2384,0,301.0625,74,118,42,39.22892850662312,0.5289171006944444,44.861111111111114,8179.003734169148,110.52707748877226,8
2499,32.338063949739166,3,3,188,0.015706806282722512,0.015706806282722512,0.9842931937172775,191,5800,3700,2100,0.6379310344827587,79,37,42,195.66640799630318,0.4771217966381924,0.7570505845150921,0.11266384977299211,1056409.9556303478,-2659.211722055059,1053750.7439082928,2385,0,302.62303664921467,72,119,43,39.390735778484895,0.537685427574171,44.39212328767124,8265.863863180348,114.80366476639372,7
2500,32.12201430042546,5,4,189,0.025906735751295335,0.02072538860103627,0.9792746113989638,193,6750,5200,1550,0.7703703703703704,83,52,31,188.29404580261334,0.47765993811168683,0.7503964214155312,0.10956049821027561,1052595.5793814717,-5710.50395286298,1046885.0754286088,2386,0,298.3160621761658,79,114,43,39.177019225878645,0.5415587219343696,43.997395833333364,8223.3193119879,104.09264951883418,0
2501,32.2560782708064,2,1,190,0.010471204188481676,0.005235602094240838,0.9947643979057592,191,7150,5400,1750,0.7552447552447552,89,54,35,187.57460237057919,0.4768336088913383,0.7477718901909673,0.11004035937434689,1059524.6281264098,-5602.017835470979,1053922.6102909388,2387,0,302.24083769633506,69,122,48,38.88276048923981,0.5443935427574171,43.690476190476154,8267.540061553034,119.81942118192804,0
2502,32.5159505709172,1,3,188,0.005235602094240838,0.015706806282722512,0.9842931937172775,191,7250,5300,1950,0.7310344827586207,92,53,39,215.51967608230348,0.4766303848626803,0.7741061766988362,0.12498053855136058,1064451.300848002,432.03991282983225,1064883.340760832,2388,0,303.2041884816754,77,114,36,38.609298886569235,0.5433027923211169,44.12393162393164,8320.05359159691,108.05264404671313,8
2503,32.93008427793567,2,3,187,0.010526315789473684,0.015789473684210527,0.9842105263157894,190,6200,4400,1800,0.7096774193548387,80,44,36,216.62541218150622,0.47666098115659516,0.7753490760852104,0.12670397176228754,1080722.1041751015,2622.374254119715,1083344.4784292213,2389,0,304.9947368421053,79,111,39,38.25218540353733,0.5457785087719298,43.802083333333364,8436.618987664953,106.79264541348041,0
2504,32.7371838977748,1,2,186,0.005319148936170213,0.010638297872340425,0.9893617021276596,188,6700,4900,1800,0.7313432835820896,85,49,36,199.61979902334375,0.4764555362764061,0.7604383259312311,0.11325163472228879,1064744.8927462243,-1791.1676997734658,1062953.7250464507,2390,0,307.9255319148936,82,106,43,39.863612505330835,0.5338541666666667,44.95481927710843,8349.460983566494,101.8226949215426,8
2505,33.019021850658966,1,2,185,0.0053475935828877,0.0106951871657754,0.9893048128342246,187,5550,3700,1850,0.6666666666666666,74,37,37,200.74968763015357,0.4762137504072988,0.7614100185528745,0.11438063597532032,1075285.800014002,222.65769319021638,1075508.4577071923,2391,0,310.24064171122996,79,108,44,39.66836734693876,0.5362076648841354,44.79166666666667,8426.729534803608,106.66746246586845,0
2506,33.29169076541788,3,3,185,0.015957446808510637,0.015957446808510637,0.9840425531914894,188,6300,4500,1800,0.7142857142857143,81,45,36,194.40185574775995,0.476385017256419,0.7526024209046249,0.10868591555762301,1078002.282729082,-1986.8711474290071,1076015.411581653,2392,0,308.73936170212767,75,113,44,40.57091659036645,0.5295877659574468,45.51809210526316,8472.132983025132,112.96177310700176,8
2507,33.3057126744198,2,4,183,0.0106951871657754,0.0213903743315508,0.9786096256684492,187,7300,5400,1900,0.7397260273972602,92,54,38,188.02393180228998,0.4761239050850057,0.7434342696120648,0.10573677701964587,1080367.3390465737,-4073.0170243371113,1076294.3220222367,2393,0,310.5882352941176,78,109,43,40.50361512312125,0.5317513368983957,45.29272151898734,8483.207433172041,108.7590696560518,0
2508,33.34532663783472,2,1,184,0.010810810810810811,0.005405405405405406,0.9945945945945946,185,6050,4600,1450,0.7603305785123967,75,46,29,192.93933295152343,0.47596455150802974,0.7419973309155365,0.10686180591239919,1076659.7631222194,-1503.996697490731,1075155.7664247286,2394,0,314.2810810810811,86,99,41,40.97827538007289,0.529786036036036,45.88122605363985,8473.673522047471,98.53108746566826,8
2509,32.95050203949021,3,0,187,0.016042780748663103,0.0,1.0,187,7800,6100,1700,0.782051282051282,95,61,34,204.66457810304354,0.4761430720870949,0.7589990075952922,0.11380096472654416,1065185.2232137776,-1598.8631378712344,1063586.3600759064,2395,0,311.7967914438503,69,118,45,40.52514338385906,0.5279077540106951,45.729166666666664,8378.351612332868,121.4253856859836,8
2510,32.83092788054785,2,2,187,0.010582010582010581,0.010582010582010581,0.9894179894179894,189,5950,3900,2050,0.6554621848739496,80,39,41,208.46458689084,0.47598760741491236,0.7605519032874926,0.1162505365330765,1062257.314029534,538.6064281878239,1062795.920457722,2396,0,309.4867724867725,76,113,39,40.31389597957881,0.5297067901234568,45.6168831168831,8351.633764418546,109.8899179528756,8
2511,33.16224186786641,3,4,186,0.015789473684210527,0.021052631578947368,0.9789473684210527,190,6900,5200,1700,0.7536231884057971,86,52,34,206.57298163022637,0.47638308734799967,0.7611480425200936,0.11635492583500538,1076235.4963378445,-435.76491704098316,1075799.7314208036,2397,0,308.7631578947368,82,108,39,39.9680829228243,0.5324561403508772,45.230923694779115,8448.713728886645,103.03309425471518,0
2512,32.7897307324488,2,2,186,0.010638297872340425,0.010638297872340425,0.9893617021276596,188,6600,5100,1500,0.7727272727272727,81,51,30,207.66102467016003,0.47645612887321276,0.7621365128955917,0.11782555194752792,1066486.031468467,93.51641823037926,1066579.5478866976,2398,0,307.01063829787233,84,104,36,39.654606316868495,0.5352393617021276,44.95098039215683,8362.988676516135,99.55938900614447,0
2513,32.98886561297771,1,1,186,0.0053475935828877,0.0053475935828877,0.9946524064171123,187,6350,4400,1950,0.6929133858267716,83,44,39,224.62110135005565,0.4759765587564449,0.7750138268414748,0.1263951336359999,1070287.9985728166,4331.853800234696,1074619.8523730512,2399,0,309.57754010695186,71,116,41,39.54730362923838,0.5306929590017826,45.26909722222223,8403.28351920862,118.35610590434676,7
2514,32.5340720136602,1,1,186,0.0053475935828877,0.0053475935828877,0.9946524064171123,187,7900,6000,1900,0.759493670886076,98,60,38,218.93346969209773,0.47607119582926033,0.7758119977217941,0.12456870249961133,1059055.2200425277,1072.526783887669,1060127.7468264154,2400,0,309.96256684491976,78,109,40,39.25819940399288,0.5359291443850267,44.84440928270042,8301.250363084626,106.42628670621315,8
2515,32.86206468112675,0,2,184,0.0,0.010752688172043012,0.989247311827957,186,6000,4400,1600,0.7333333333333333,76,44,32,216.9712895215471,0.47543652523491237,0.7712398128350528,0.12151232644282925,1064644.5743723628,2999.4612367381656,1067644.035609101,2401,1,312.5698924731183,70,116,38,39.928914505283394,0.5280577956989247,45.45187793427231,8364.976851783314,119.4996693111902,7
2516,33.21457970391297,6,4,186,0.031578947368421054,0.021052631578947368,0.9789473684210527,190,5750,4200,1550,0.7304347826086957,73,42,31,198.25862114999387,0.4763500185649308,0.7537418474139244,0.11197886311475672,1078826.0451849895,-972.687164184581,1077853.3580208048,2402,0,306.6684210526316,77,113,38,40.072428172212064,0.5286732456140351,45.12553418803419,8465.548259203773,109.94218518446459,8
2517,33.554728419519556,3,0,189,0.015873015873015872,0.0,1.0,189,6600,4900,1700,0.7424242424242424,83,49,34,201.83021931263482,0.47632650380877334,0.7589612552064042,0.11484122114660128,1092290.9687681303,-308.5348440635862,1091982.4339240666,2403,0,309.0846560846561,80,109,43,39.69326982846969,0.5315255731922399,44.843106995884774,8561.720249121498,107.02150311401871,0
2518,33.135265597354525,5,2,192,0.02577319587628866,0.010309278350515464,0.9896907216494846,194,6500,4800,1700,0.7384615384615385,82,48,34,199.2158272080152,0.4771680198707334,0.7633435619291387,0.11368681816605952,1079582.0651412357,-2286.0331707900787,1077296.0319704455,2404,0,302.0927835051546,68,126,43,39.64592327557317,0.5375859106529209,44.731280193236735,8458.396829493815,124.38818866902669,8
2519,33.51224936656525,0,2,190,0.0,0.010416666666666666,0.9895833333333334,192,5750,4200,1550,0.7304347826086957,73,42,31,204.2246210240865,0.4768715459569517,0.7679655635891727,0.11329525013681162,1082584.0458874751,68.06329961850133,1082652.1091870936,2405,1,305.9114583333333,69,123,44,40.62743935757077,0.5305989583333333,45.81845238095239,8518.19540818902,123.45210736505825,8
2520,33.44952406129984,6,4,192,0.030612244897959183,0.02040816326530612,0.9795918367346939,196,6550,4600,1950,0.7022900763358778,85,46,39,200.44005857079466,0.47711058782487353,0.7659153537118661,0.11264132963145598,1084806.1518428859,-2262.278277330818,1082543.873565555,2406,0,300.59183673469386,76,120,46,40.21444190658309,0.5341198979591837,45.319264069264065,8518.94940446469,112.09143953243014,0
2521,33.23540033732894,3,3,192,0.015384615384615385,0.015384615384615385,0.9846153846153847,195,6000,4300,1700,0.7166666666666667,77,43,34,198.70217062643206,0.4776533174729051,0.7631868226583021,0.11251255851839889,1080320.120146319,-2067.6094311035904,1078252.5107152155,2407,0,297.2769230769231,78,117,38,39.96267949182054,0.5370192307692307,45.02900843881857,8474.062978941598,108.64183306335381,0
2522,33.18550982707675,1,5,188,0.0051813471502590676,0.025906735751295335,0.9740932642487047,193,5950,4300,1650,0.7226890756302521,76,43,33,202.28696059245442,0.47706399323546345,0.7655461434996906,0.11497434716446492,1079916.0064678693,-859.4146712945931,1079056.5917965746,2408,0,301.33678756476684,77,116,40,39.72450880315482,0.5384283246977548,44.88514957264958,8466.116375890077,109.94956332324774,0
2523,32.73057175327431,2,0,190,0.010526315789473684,0.0,1.0,190,6300,4400,1900,0.6984126984126984,82,44,38,203.7855690047308,0.476050659055045,0.763918254960654,0.11648483759159373,1066916.1478427658,-815.577146305015,1066100.5706964608,2409,0,306.96315789473687,67,123,42,39.4658427325814,0.540296052631579,44.66911764705885,8357.125765679837,124.73322038328115,0
2524,32.28507482687864,0,4,186,0.0,0.021052631578947368,0.9789473684210527,190,6400,4700,1700,0.734375,81,47,34,226.28881114298807,0.4760500789009561,0.7833036040489132,0.12858034767730375,1050526.2427667251,3144.466910038542,1053670.7096767637,2410,1,307.96315789473687,79,111,41,39.12311147407106,0.537390350877193,44.89583333333334,8236.057109481879,104.25388746179594,8
2525,32.709058858356705,2,2,186,0.010638297872340425,0.010638297872340425,0.9893617021276596,188,6650,5000,1650,0.7518796992481203,83,50,33,221.4214810637721,0.47596012534607657,0.7766892388241118,0.12642452305899252,1065860.6398808619,2950.888298000133,1068811.528178862,2411,0,311.71276595744683,64,124,43,39.05890353630468,0.5397273936170213,44.71153846153847,8350.245314320877,130.4725830362637,0
2526,33.08760224552931,3,2,187,0.015873015873015872,0.010582010582010581,0.9894179894179894,189,6650,4800,1850,0.7218045112781954,85,48,37,237.73723690138686,0.4760075424969042,0.7812392735469658,0.13400652619759768,1074049.8272293832,6618.327643984984,1080668.154873368,2412,0,310.5026455026455,75,114,40,39.145373856912336,0.5315806878306879,45.20285087719297,8430.626723470232,112.40835631293642,8
2527,33.02873165010207,5,4,188,0.026041666666666668,0.020833333333333332,0.9791666666666666,192,5800,3900,1900,0.6724137931034483,77,39,38,216.25391424375405,0.47613188081733565,0.7762139990557118,0.12368378439411104,1076821.8549845025,2373.3882167238685,1079195.2432012265,2413,0,306.3333333333333,71,121,35,39.12488196411708,0.5400390625,44.64699074074075,8433.986018870122,118.78853547704398,8
2528,33.04566534158575,1,1,188,0.005291005291005291,0.005291005291005291,0.9947089947089947,189,6300,4200,2100,0.6666666666666666,84,42,42,225.84650057828455,0.4754540508086607,0.7750716087729836,0.12971300964920646,1078717.2578360927,4624.903559137123,1083342.1613952299,2414,0,312.1375661375661,71,118,39,38.717194666213686,0.5423280423280423,44.487847222222236,8443.569091402609,118.92350832961421,8
2529,33.139774550574415,4,5,187,0.020833333333333332,0.026041666666666668,0.9739583333333334,192,5750,4100,1650,0.7130434782608696,74,41,33,233.86225474929972,0.47565751799738215,0.7849365172313607,0.13242576411744772,1077222.1927912273,6234.322174428446,1083456.5149656557,2415,0,308.2239583333333,74,118,37,39.06493989904488,0.5315212673611112,45.027777777777786,8449.721961103427,114.18543190680307,8
2530,32.80781179122368,3,1,189,0.015789473684210527,0.005263157894736842,0.9947368421052631,190,6650,4600,2050,0.6917293233082706,87,46,41,227.89758803744735,0.4750174046226678,0.7791436633541884,0.13035742035742046,1069653.92748523,4104.310021733514,1073758.2375069633,2416,0,312.2105263157895,69,121,38,38.82332944832945,0.5347587719298246,44.64285714285716,8377.709082401801,121.41607365799712,0
2531,33.04523774809281,1,2,188,0.005263157894736842,0.010526315789473684,0.9894736842105263,190,5350,3700,1650,0.6915887850467289,70,37,33,250.67197799638902,0.4753776803118908,0.7996658605475462,0.1404058564376628,1070624.7389560149,10325.12420119421,1080949.863157209,2417,0,313.09473684210525,69,121,34,39.06548384582408,0.5302083333333334,45.44642857142856,8411.783287483246,121.90990271714848,8
2532,33.138155597238594,3,1,190,0.015706806282722512,0.005235602094240838,0.9947643979057592,191,6250,4100,2150,0.656,84,41,43,236.00099129825435,0.4757428584550381,0.7883281650795901,0.1326948969941116,1074877.920102691,6284.450933767752,1081162.3710364588,2418,0,312.42931937172773,77,114,41,39.288179879753905,0.5331588132635253,45.299145299145266,8440.316553826498,109.61450069904544,8
2533,32.80564397522443,4,5,189,0.020618556701030927,0.02577319587628866,0.9742268041237113,194,6600,4400,2200,0.6666666666666666,88,44,44,227.02231217054356,0.47630001068319,0.787338390641781,0.13088780679822784,1072095.2369093096,3277.9079100358017,1075373.1448193453,2419,0,308.5618556701031,71,123,37,38.53919085884593,0.5437070446735395,44.343171296296305,8386.986902288663,118.12657608857272,8
2534,32.7049905492369,1,2,188,0.005263157894736842,0.010526315789473684,0.9894736842105263,190,5800,3700,2100,0.6379310344827587,79,37,42,226.26083918463428,0.4757025666016894,0.7835745590226784,0.13115724290306305,1070514.6016506334,4643.106425775514,1075157.7080764088,2420,0,315.89473684210526,74,116,37,38.3497539174176,0.5462171052631579,44.1388888888889,8367.935220806168,113.08020568656984,0
2535,32.65535245009639,2,4,186,0.010526315789473684,0.021052631578947368,0.9789473684210527,190,6350,5000,1350,0.7874015748031497,77,50,27,227.45124474070818,0.4756381694978186,0.7870607325562649,0.13441451166943963,1074922.5583396663,4548.49477884483,1079471.053118511,2421,0,316.2526315789474,68,122,39,37.581882011453615,0.5495614035087719,43.41787439613527,8378.779743989116,123.21734917631053,8
2536,32.91363738288569,2,4,184,0.010638297872340425,0.02127659574468085,0.9787234042553191,188,5700,3900,1800,0.6842105263157895,75,39,36,210.37302886430345,0.47494322922592636,0.760548291747664,0.12532661054471989,1085942.8159302436,2390.6158721351476,1088333.4318023787,2422,0,318.6170212765957,80,108,41,37.71579057154781,0.5532468971631206,43.11985596707819,8454.859911563028,105.68574889453785,8
2537,32.90005129918505,3,4,183,0.016042780748663103,0.0213903743315508,0.9786096256684492,187,5850,4100,1750,0.7008547008547008,76,41,35,197.90158528878735,0.47506373028194665,0.7521172719132772,0.11583868664081406,1079971.2914597748,-504.39387074620754,1079466.8975890286,2423,0,320.4919786096257,85,102,40,38.70347609593144,0.545565953654189,43.77422480620156,8429.841148049449,99.17460174175822,8
2538,33.04503795145672,3,3,183,0.016129032258064516,0.016129032258064516,0.9838709677419355,186,5550,3900,1650,0.7027027027027027,72,39,33,234.60819185627378,0.47529303497045433,0.7879827592104807,0.13343517787724166,1075562.6678314554,7717.162545609658,1083279.830377065,2424,0,320.98387096774195,76,110,38,38.873497702368326,0.5328181003584229,44.859307359307365,8431.13387127266,110.93597199042972,8
2539,32.985651817989925,4,1,186,0.0213903743315508,0.0053475935828877,0.9946524064171123,187,6200,4800,1400,0.7741935483870968,76,48,28,244.44982541234128,0.47578968048607523,0.7936658333178155,0.14140366650601843,1079033.8000794004,9153.924808684644,1088187.7248880852,2425,0,319.7165775401069,68,119,40,37.9654085266285,0.5374331550802138,44.21799516908211,8437.136152660034,124.07553165676521,0
2540,33.01497576133678,4,5,185,0.021052631578947368,0.02631578947368421,0.9736842105263158,190,6400,4800,1600,0.75,80,48,32,242.41854848448259,0.4765200037129862,0.7958033545401972,0.14177434390802005,1083472.4119692042,8130.761886511205,1091603.1738557154,2426,0,315.55263157894734,73,117,37,37.595695970696006,0.5405701754385965,43.80630630630631,8458.228587504644,115.8661450343102,0
2541,32.85794113488951,2,2,185,0.0106951871657754,0.0106951871657754,0.9893048128342246,187,6550,4800,1750,0.732824427480916,83,48,35,213.19177178029676,0.47597176700592264,0.7700857074872947,0.12234128022509254,1072320.0166784085,1771.960854229717,1074091.9775326382,2427,0,320.524064171123,68,119,43,39.073302605920965,0.53475935828877,44.519927536231904,8394.549182151839,123.44925267870352,6
2542,33.263962573177395,2,1,186,0.0106951871657754,0.0053475935828877,0.9946524064171123,187,6050,4600,1450,0.7603305785123967,75,46,29,213.8909415340536,0.47566150115960365,0.7717275473040062,0.12393340137903722,1088673.2231447562,3121.468144269118,1091794.6912890254,2428,0,320.98395721925135,71,116,43,38.68280177938624,0.5381016042780749,44.1550925925926,8510.415424538063,119.86500597940935,0
2543,33.47684089943029,0,2,184,0.0,0.010752688172043012,0.989247311827957,186,5900,4100,1800,0.6949152542372882,77,41,36,234.18326754976144,0.4753893005909135,0.7874752013352162,0.13555030796580458,1095305.1017967027,8200.425540535098,1103505.5273372377,2429,1,323.5698924731183,67,119,42,38.203697327185274,0.5408266129032258,44.194240196078425,8563.568722113749,127.81445853901117,8
2544,33.89920757450138,4,0,188,0.02127659574468085,0.0,1.0,188,6600,4900,1700,0.7424242424242424,83,49,34,215.54172864479452,0.4757675313839269,0.7743572465691044,0.12218467674118805,1102268.0492290717,3316.952152152008,1105585.0013812238,2430,0,319.6755319148936,74,114,41,39.48949766715685,0.5326906028368794,44.98611111111112,8644.7687538253,116.82119937601756,8
2545,33.64087051284431,2,1,189,0.010526315789473684,0.005263157894736842,0.9947368421052631,190,5550,3900,1650,0.7027027027027027,72,39,33,217.1521833175373,0.47639933166248954,0.7772225130538661,0.12393794916856839,1096095.7224406407,4053.9158505998175,1100149.6382912404,2431,0,317.3,63,127,45,39.18324407039022,0.5349780701754385,44.72656250000001,8587.620656306168,136.3114389889868,0
2546,33.214595271351406,0,1,188,0.0,0.005291005291005291,0.9947089947089947,189,5200,3200,2000,0.6153846153846154,72,32,40,220.95617450289492,0.47601926901572295,0.7796970412268145,0.12653174822323562,1083285.5124773448,4871.724546280584,1088157.2370236255,2432,1,319.70899470899474,64,125,44,38.956124113697705,0.5365410052910053,44.599358974358985,8483.028923710399,132.54732693297498,0
2547,33.1972646957113,2,0,190,0.010526315789473684,0.0,1.0,190,5550,4000,1550,0.7207207207207207,71,40,31,217.41256289507606,0.4761591478696742,0.7783463108291411,0.12578608359486604,1086012.8967686435,3672.569444715437,1089685.466213359,2433,0,318.87894736842105,69,121,44,38.65014204820912,0.5390350877192982,44.21130952380953,8491.48486390748,123.06499802764465,0
2548,32.71863327727918,1,2,189,0.005235602094240838,0.010471204188481676,0.9895287958115183,191,6100,4800,1300,0.7868852459016393,74,48,26,217.04138283315226,0.47608960227794617,0.7793675252587156,0.12625559040294282,1072066.8063390036,2236.5724274678105,1074303.3787664715,2434,0,318.2041884816754,72,119,40,38.45073857302116,0.5413394415357766,44.0068493150685,8375.74601875556,116.32980581604946,0
2549,32.99479621170721,3,4,188,0.015625,0.020833333333333332,0.9791666666666666,192,5700,3800,1900,0.6666666666666666,76,38,38,214.81922136294432,0.4761244955279232,0.7793445121951219,0.1258226867982967,1083286.1803101592,2442.138753493564,1085728.3190636528,2435,0,317.5260416666667,77,115,43,38.24525745257454,0.5432400173611112,43.75000000000002,8454.916529250024,109.80411076948083,0
2550,32.536489412811775,1,2,187,0.005291005291005291,0.010582010582010581,0.9894179894179894,189,6850,5200,1650,0.7591240875912408,85,52,33,208.76885132710225,0.4755384817441555,0.7699726414882402,0.12305776579313552,1070213.7830937507,35.46043418307818,1070249.2435279337,2436,0,322.2275132275132,65,124,41,38.15861331610363,0.5459104938271605,43.513257575757585,8345.178179412964,128.38735660635328,0
2551,32.15786044757543,4,1,190,0.020942408376963352,0.005235602094240838,0.9947643979057592,191,7250,5400,1850,0.7448275862068966,91,54,37,204.03434396672648,0.47591163773307615,0.7669580114187449,0.12206146256634495,1062285.0322868056,-2101.4740663377324,1060183.5582204678,2437,0,318.70680628272254,72,119,39,37.72078961490773,0.5493564572425829,42.96518264840183,8265.689786560743,114.80124703556586,0
2552,31.841927548192114,2,1,191,0.010416666666666666,0.005208333333333333,0.9947916666666666,192,5900,4300,1600,0.7288135593220338,75,43,32,204.5440667722683,0.47600349040139617,0.7682884462678654,0.12112343013567897,1048763.6861883118,-1396.3221087934385,1047367.3640795184,2438,0,317.7604166666667,68,124,44,38.09261219928237,0.5450303819444444,43.342391304347835,8172.472980779222,120.18342618792974,8
2553,31.916174672360434,2,1,192,0.010362694300518135,0.0051813471502590676,0.9948186528497409,193,6650,4400,2250,0.6616541353383458,89,44,45,214.96546625063456,0.4764500575705239,0.7725595249043291,0.12448242054102737,1044380.6647087253,-348.8446935478287,1044031.8200151775,2439,0,316.86528497409324,77,116,42,38.67804691306469,0.5352979274611399,44.177350427350454,8164.880368906803,106.03740738840004,8
2554,31.79017126949883,0,5,187,0.0,0.026041666666666668,0.9739583333333334,192,6350,5000,1350,0.7874015748031497,77,50,27,214.00203303355678,0.4762119828025015,0.7702634648006783,0.12404542622741652,1040556.2003247715,-213.7715289648604,1040342.4287958066,2440,1,318.5572916666667,79,113,36,38.665182357930476,0.5370551215277778,44.14062500000003,8133.8133521569935,102.95966268553157,0
2555,31.65465929545384,0,2,185,0.0,0.0106951871657754,0.9893048128342246,187,6700,5000,1700,0.746268656716418,84,50,34,225.3891406528997,0.4755812393383551,0.7848393708364338,0.125531302840456,1023808.6736753447,2051.0714305342226,1025859.7451058789,2441,2,326.37433155080214,61,126,36,39.9328951424671,0.5238970588235294,45.66532258064516,8050.87756072883,131.98159935621032,8
2556,31.51228908069846,3,1,187,0.015957446808510637,0.005319148936170213,0.9946808510638298,188,5650,4000,1650,0.7079646017699115,73,40,33,195.87760475412875,0.47602412580119086,0.7473406948013752,0.10826430342230116,1016828.1276305004,-3415.2283826225985,1013412.8992478778,2442,0,325.47340425531917,80,108,47,40.985897370996526,0.5215536347517731,45.96193415637858,8005.320968365668,100.06651210457085,8
2557,31.664920507170407,3,2,188,0.015789473684210527,0.010526315789473684,0.9894736842105263,190,6200,4100,2100,0.6612903225806451,83,41,42,191.22130251824672,0.47687041678269754,0.748092071051262,0.10440617965434121,1017912.2156926857,-5270.700053201901,1012641.5156394838,2443,0,322.89473684210526,78,112,44,41.59126365054602,0.5173245614035088,46.43987341772153,8028.961252015942,102.93540066687105,8
2558,32.01099129590625,4,3,189,0.020833333333333332,0.015625,0.984375,192,5900,4300,1600,0.7288135593220338,75,43,32,184.48545866316744,0.4780798929246655,0.7424272751534564,0.10150763782832432,1031487.0949956432,-6241.126034918071,1025245.9689607251,2444,0,319.5208333333333,81,111,42,41.45483053109153,0.5199110243055556,46.13821138211382,8126.367505810352,100.32552476309077,0
2559,31.628172689393928,4,2,191,0.02072538860103627,0.010362694300518135,0.9896373056994818,193,4800,3100,1700,0.6458333333333334,65,31,34,206.26290718058715,0.47826262953367876,0.7694812075681294,0.11163389403895854,1013959.2777855332,-1571.5623202456313,1012387.7154652876,2445,0,318.7461139896373,69,124,40,41.562842814605844,0.5166234887737479,46.78571428571427,8008.705155992928,116.06819066656416,8
2560,31.479105880547312,11,3,199,0.054455445544554455,0.01485148514851485,0.9851485148514851,202,6900,5400,1500,0.782608695652174,84,54,30,192.63049798155234,0.48049151930118383,0.7624640496561137,0.10637513366026335,1015481.095003446,-8177.474195726678,1007303.6208077193,2446,0,304.3267326732673,82,120,39,41.10360360360359,0.5221740924092408,45.99648594377511,7995.803513007024,97.50979893911004,0
2561,31.99476223944073,5,3,201,0.024509803921568627,0.014705882352941176,0.9852941176470589,204,5750,3700,2050,0.6434782608695652,78,37,41,204.1215075826968,0.48074129076918126,0.7784434054159381,0.11450881949966923,1037075.4759465447,-4212.118074550084,1032863.3578719946,2447,0,302.3186274509804,76,128,41,40.18970387687512,0.5257352941176471,45.38690476190473,8146.285445190859,107.18796638409025,0
2562,32.176151529967356,1,8,194,0.0049504950495049506,0.039603960396039604,0.9603960396039604,202,7350,4900,2450,0.6666666666666666,98,49,49,218.93396635145547,0.48036221532601026,0.7933812974911427,0.12398260505437204,1045924.7124306356,-1952.3108405111952,1043972.4015901244,2448,0,305.91089108910893,75,127,34,39.44239504381013,0.5331064356435644,45.024671052631575,8204.12482061379,109.3883309415172,8
2563,32.006964230763494,2,1,195,0.01020408163265306,0.00510204081632653,0.9948979591836735,196,6650,4800,1850,0.7218045112781954,85,48,37,221.22932740162938,0.47893990929705216,0.7897458876827141,0.12626162508708522,1042851.1730884585,291.85272047193257,1043143.0258089304,2449,0,310.3265306122449,64,132,35,39.08018917278758,0.5356079931972789,44.727564102564095,8170.495724869083,127.66399570107941,0
2564,32.03299785261809,3,3,195,0.015151515151515152,0.015151515151515152,0.9848484848484849,198,6800,4800,2000,0.7058823529411765,88,48,40,246.00518884980022,0.47920779281819886,0.8085319039784891,0.13907818102300598,1040743.6476468291,4805.667516717674,1045549.3151635468,2450,0,307.69191919191917,69,129,36,38.81834987351625,0.5309869528619529,45.089285714285715,8165.554363323633,118.34136758440047,8
2565,32.45956538833748,2,4,193,0.01015228426395939,0.02030456852791878,0.9796954314720813,197,6300,4400,1900,0.6984126984126984,82,44,38,243.34790176796145,0.4788623571255914,0.8052817084313704,0.13854793146502536,1056830.3375924344,5735.489035568902,1062565.8266280033,2451,0,310.11167512690355,72,125,40,38.6104587224366,0.533576565143824,44.82020547945205,8283.025226022233,115.04201702808658,0
2566,32.77987687681874,4,1,196,0.02030456852791878,0.005076142131979695,0.9949238578680203,197,6950,5400,1550,0.7769784172661871,85,54,31,236.1295659604309,0.47867782899962014,0.7989389671535401,0.13625918743106089,1071533.671481527,4254.156151783845,1075787.8276333108,2452,0,310.8578680203046,66,131,40,38.27209757185131,0.5368020304568528,44.3097014925373,8381.49650367163,126.99237126775196,0
2567,32.51266991852603,0,5,191,0.0,0.025510204081632654,0.9744897959183674,196,6550,5000,1550,0.7633587786259542,81,50,31,228.3148856989,0.4784335208442351,0.790754631827131,0.12933147135285744,1056953.034822651,2513.622266927836,1059466.6570895787,2453,1,313.13775510204084,74,122,37,39.192176407574884,0.5322597789115646,45.01388888888889,8290.279264364166,112.03080086978602,8
2568,32.29627148395976,3,2,192,0.015463917525773196,0.010309278350515464,0.9896907216494846,194,5950,4200,1750,0.7058823529411765,77,42,35,209.2646514590836,0.47821908997026513,0.7697920282553086,0.1183254286161439,1049346.3429930415,-831.7806547392825,1048514.5623383023,2454,0,310.70103092783506,74,120,38,39.74882859322223,0.5321628006872852,45.08333333333334,8232.857872452762,111.2548361142265,8
2569,31.877668441554093,2,4,190,0.010309278350515464,0.020618556701030927,0.979381443298969,194,5850,4300,1550,0.7350427350427351,74,43,31,211.85270181746938,0.478776618948418,0.7748360139825212,0.11873723848997159,1032993.9675725035,-881.4874017238535,1032112.4801707796,2455,0,308.9020618556701,75,119,40,40.02884856968522,0.5300150343642611,45.422149122807,8115.348322826516,108.20464430435355,8
2570,31.70964248178382,4,1,193,0.020618556701030927,0.005154639175257732,0.9948453608247423,194,5550,4200,1350,0.7567567567567568,69,42,27,206.92906487233603,0.4782964318145398,0.7703529863213723,0.1171888765845126,1030772.5847116036,-1690.638589917699,1029081.9461216859,2456,0,309.72680412371136,80,114,39,39.74693599636863,0.5330756013745704,45.02314814814813,8085.224813352932,101.06531016691164,0
2571,31.649778702054434,3,4,192,0.015306122448979591,0.02040816326530612,0.9795918367346939,196,6250,4100,2150,0.656,84,41,43,207.47016114032823,0.4784100819815105,0.7750031841829379,0.11840009470008368,1031190.5026220302,-2661.7480509261436,1028528.7545711041,2457,0,307.55102040816325,67,129,40,39.434309489518355,0.5358205782312926,44.73039215686276,8079.2265975955515,120.58547160590375,0
2572,31.904167274016245,2,0,194,0.010309278350515464,0.0,1.0,194,6150,4100,2050,0.6666666666666666,82,41,41,205.17562404818514,0.4780187801577551,0.7703727155742162,0.11802108104237104,1041926.8807858882,-2194.4004044349763,1039732.4803814532,2458,0,310.7783505154639,71,123,40,39.186302953108786,0.5380691580756014,44.429976851851876,8153.748768742779,114.84153195412365,0
2573,31.889725482852853,5,2,197,0.02512562814070352,0.010050251256281407,0.9899497487437185,199,5650,3600,2050,0.6371681415929203,77,36,41,200.04996037831052,0.47822234065952657,0.7694730498772087,0.11646394747684805,1045150.0555233418,-3633.5545606331107,1041516.5009627086,2459,0,303.94472361809045,77,122,42,38.855291412376346,0.541352596314908,43.97702991452993,8164.502233330325,106.03249653675746,0
2574,32.38609871794753,3,1,199,0.015,0.005,0.995,200,6550,5000,1550,0.7633587786259542,81,50,31,192.51556496510997,0.47778213986599666,0.7580856774747693,0.11000551975981797,1055580.7157523755,-5906.856428131318,1049673.8593242443,2460,0,303.3,75,125,41,39.76674898003002,0.5336979166666667,44.682017543859644,8268.753384291746,110.25004512388995,8
2575,32.31498573452046,4,2,201,0.019704433497536946,0.009852216748768473,0.9901477832512315,203,5300,4100,1200,0.7735849056603774,65,41,24,188.40780780546913,0.4781088946333057,0.7563371518664137,0.10866653980216245,1056179.9520962655,-6101.490115491437,1050078.461980774,2461,0,298.60591133004925,80,123,47,39.5116568583069,0.5363300492610837,44.32870370370371,8262.01429254118,103.27517865676475,0
2576,32.099329880234215,2,5,198,0.009852216748768473,0.024630541871921183,0.9753694581280788,203,6900,5000,1900,0.7246376811594203,88,50,38,209.71962737722367,0.4781718935440342,0.7783954475181736,0.11626402115130031,1036724.0139364521,-4015.7252208453156,1032708.2887156068,2462,0,297.81773399014776,88,115,34,40.51490904904447,0.5248871100164203,45.84503745318354,8158.203983488876,92.70686344873722,8
2577,31.796804601596254,2,0,200,0.01,0.0,1.0,200,6250,4800,1450,0.768,77,48,29,205.79567743532152,0.47744242043551094,0.7784045296557907,0.11522232561491723,1030048.3606044973,-3854.099967651117,1026194.2606368462,2463,0,302.84,72,128,40,40.22405351870537,0.5296875,45.46232876712328,8093.484595937119,112.40950827690443,8
2578,31.710204352499694,3,3,200,0.014778325123152709,0.014778325123152709,0.9852216748768473,203,5900,3900,2000,0.6610169491525424,79,39,40,198.14776864598244,0.4780245573818465,0.7668886789850309,0.11071257302113507,1026602.6989654705,-5816.1931828100605,1020786.5057826604,2464,0,299.3497536945813,74,129,42,40.49963157032911,0.5268370279146142,45.54166666666664,8068.925749196427,109.03953715130307,8
2579,31.75506698395516,2,1,201,0.009900990099009901,0.0049504950495049506,0.995049504950495,202,7000,5000,2000,0.7142857142857143,90,50,40,196.83488621873778,0.4782081752951415,0.7641084506857068,0.11057644682386523,1029743.5748562539,-6862.108121738784,1022881.4667345152,2465,0,301.7178217821782,76,126,45,40.32005312084991,0.5287747524752475,45.332792207792195,8086.974242058357,106.40755581655733,0
2580,31.3413595027639,4,8,197,0.01951219512195122,0.03902439024390244,0.9609756097560975,205,7250,5300,1950,0.7310344827586207,92,53,39,214.80772343623565,0.4788777299537701,0.7916076580120637,0.12151531800224989,1018460.2261160156,-4495.3754835330565,1013964.8506324826,2466,0,298.1463414634146,75,130,36,39.589605734767,0.5259654471544715,45.065789473684205,7989.984741658548,106.53312988878064,8
2581,31.19760739795672,2,3,196,0.010050251256281407,0.01507537688442211,0.9849246231155779,199,6350,4600,1750,0.7244094488188977,81,46,35,198.54769641656011,0.4775920850041453,0.7707316822029213,0.11014475776263122,1007808.2739328033,-6130.39775621863,1001677.8761765846,2467,0,307.91959798994975,71,128,40,40.77215787276829,0.5236076214405361,45.818865740740726,7929.843234587667,111.68793288151645,8
2582,30.97165895500968,3,0,199,0.01507537688442211,0.0,1.0,199,5850,4000,1850,0.6837606837606838,77,40,37,216.53606579138886,0.47782790213694737,0.7819369452151945,0.12078864145584711,1002193.3974035605,-2247.7969128254917,999945.6004907349,2468,0,308.66331658291455,72,127,41,40.09645407972479,0.5249162479061977,45.60502283105022,7879.034472744169,109.43103434366901,8
2583,30.846476526917478,7,5,201,0.03398058252427184,0.024271844660194174,0.9757281553398058,206,7000,5100,1900,0.7285714285714285,89,51,38,187.11054624312763,0.4791479201199779,0.7643833382973044,0.10628247931136958,1003613.1358020867,-10642.679588658355,992970.4562134283,2469,0,299.1407766990291,79,127,44,40.13582980280057,0.5299352750809061,44.908854166666686,7868.663042172453,99.60332964775257,8
2584,31.101214122205675,0,1,200,0.0,0.004975124378109453,0.9950248756218906,201,5700,3500,2200,0.6140350877192983,79,35,44,190.7538525614315,0.4788215174129353,0.7620266016854484,0.10868533459895602,1012831.1510880054,-7259.711187146411,1005571.439900859,2470,1,306.44776119402985,81,120,48,39.92346938775513,0.5316645936981759,44.79166666666669,7937.289020771308,97.99122247865813,0
2585,30.970706710336387,2,3,199,0.009900990099009901,0.01485148514851485,0.9851485148514851,202,6800,4700,2100,0.6911764705882353,89,47,42,214.27898322842492,0.4786648440963499,0.7836183842432054,0.12188596369705158,1008079.1238888536,-3997.966063859219,1004081.1578249944,2471,0,305.91089108910893,81,121,33,39.387965728985144,0.5335189768976898,44.85518292682925,7902.015298235554,97.55574442266116,8
2586,30.979214532975178,2,1,200,0.009950248756218905,0.004975124378109453,0.9950248756218906,201,5750,3500,2250,0.6086956521739131,80,35,45,196.65800763471654,0.47839655887230514,0.7598839005143476,0.11072485918083769,1005264.2135546377,-6411.348523172985,998852.8650314647,2472,0,307.78109452736317,86,115,31,40.236718835675426,0.5299543946932006,45.24664750957854,7892.058759795398,91.76812511389998,7
2587,30.986461897320808,7,4,203,0.033816425120772944,0.01932367149758454,0.9806763285024155,207,6850,4800,2050,0.7007299270072993,89,48,41,197.78943339431308,0.47898882947954285,0.7732913222363222,0.11317584523141741,1010378.3457442673,-8281.567896271466,1002096.7778479959,2473,0,299.7632850241546,76,131,37,39.57836697215306,0.5345209339774557,44.629329004329016,7913.033566500635,104.11886271711361,0
2588,31.005753965854876,2,3,202,0.00975609756097561,0.014634146341463415,0.9853658536585366,205,6100,4500,1600,0.7377049180327869,77,45,32,209.88037430123453,0.4788408656145385,0.7869794921320228,0.11792289271703264,1005491.0746270946,-4893.431380142988,1000597.6432469515,2474,0,301.5658536585366,71,134,43,39.98188045598288,0.5236788617886179,45.326967592592595,7896.329384562266,111.21590682482065,8
2589,30.921425470817056,1,3,200,0.0049261083743842365,0.014778325123152709,0.9852216748768473,203,6500,4000,2500,0.6153846153846154,90,40,50,215.29637145862654,0.47847571087157975,0.7896525614022869,0.1218577462455832,1004977.6984547847,-3826.3896251683163,1001151.3088296164,2475,0,305.4679802955665,73,130,42,39.555957376325104,0.5257081280788177,45.045045045045065,7883.570638055202,107.99411832952332,0
2590,31.270160674350528,2,3,199,0.009900990099009901,0.01485148514851485,0.9851485148514851,202,6200,4600,1600,0.7419354838709677,78,46,32,210.3737127218139,0.4779608557870712,0.7847858680895714,0.12001549055275959,1018716.7143009529,-3737.756520148279,1014978.9577808046,2476,0,307.2722772277228,64,138,42,39.3736658714214,0.5279496699669968,44.74358974358974,7981.908961875873,124.71732752931051,0
2591,31.116629705428263,1,2,198,0.005,0.01,0.99,200,5900,3700,2200,0.6271186440677966,81,37,44,215.829401208028,0.4783673576214405,0.7871493808483212,0.12124354181176156,1009031.7154381867,-2344.257811413518,1006687.4576267732,2477,0,308.685,72,128,38,39.837461011187656,0.5263020833333334,45.33390410958903,7924.350604348979,110.06042506040248,8
2592,31.31775514456172,1,3,196,0.005025125628140704,0.01507537688442211,0.9849246231155779,199,6550,4900,1650,0.7480916030534351,82,49,33,216.76653909006734,0.47830799621000625,0.7909751061984143,0.12055501842769405,1012467.5032466466,-2456.184676012447,1010011.3185706341,2478,0,310.964824120603,64,135,39,40.20923930169535,0.5261725293132329,45.72115384615386,7963.442642287862,124.42879128574785,8
2593,31.565604213202395,3,3,196,0.01507537688442211,0.01507537688442211,0.9849246231155779,199,7100,5500,1600,0.7746478873239436,87,55,32,228.6720697130701,0.47789558059658566,0.7949536943726114,0.13088584223654748,1029353.3677285326,176.8730129206947,1029530.2407414534,2479,0,311.7035175879397,65,134,37,38.77818377520965,0.533605527638191,44.61805555555557,8061.285381531405,124.01977510048314,6
2594,31.56908590841862,2,3,195,0.010101010101010102,0.015151515151515152,0.9848484848484849,198,5400,4200,1200,0.7777777777777778,66,42,24,223.1910704451343,0.4782715052385103,0.7890686520629091,0.12490290085605286,1022525.3823657561,643.7069295068895,1023169.0892952629,2480,0,310.76262626262627,61,137,45,39.79986302726259,0.5200968013468014,45.48051075268819,8034.947621415249,131.72045281008604,8
2595,31.956398957844087,3,1,197,0.015151515151515152,0.005050505050505051,0.9949494949494949,198,6750,5000,1750,0.7407407407407407,85,50,35,216.75834485200164,0.47852573962980055,0.7823838286689915,0.12231993978826086,1037684.597949747,-1364.6408139992054,1036319.9571357478,2481,0,311.42424242424244,67,131,42,39.635429189709065,0.5236742424242424,45.15931372549023,8143.790641279093,121.54911404894168,0
2596,32.2542433738103,3,0,200,0.015,0.0,1.0,200,6300,4100,2200,0.6507936507936508,85,41,44,214.41392229315275,0.478890284757119,0.7818186522539083,0.12202509609039741,1050018.021362329,-1272.303512241121,1048745.7178500877,2482,0,309.26,70,130,46,39.36460249923335,0.5260416666666667,44.83568075117374,8230.132053364347,117.5733150480621,0
2597,31.970373118287498,0,1,199,0.0,0.005,0.995,200,7000,5200,1800,0.7428571428571429,88,52,36,237.44790112949312,0.4786494974874372,0.8033210953458847,0.134444946331932,1039184.3025984323,2350.4263077426535,1041534.7289061749,2483,1,310.26,73,127,35,38.976782329450316,0.5286458333333333,45.030968468468465,8151.455071671466,111.66376810508856,8
2598,32.18541789084514,1,0,200,0.005,0.0,1.0,200,7150,5900,1250,0.8251748251748252,84,59,25,250.58142569119966,0.4783186767169179,0.8172811280936243,0.140191118194393,1042398.1091931594,5091.120867886466,1047489.2300610458,2484,0,311.25,63,137,35,39.11402709385859,0.5226041666666666,45.49153645833333,8191.461255845457,130.02319453722947,8
2599,31.935338019665004,8,6,202,0.038461538461538464,0.028846153846153848,0.9711538461538461,208,7200,5000,2200,0.6944444444444444,94,50,44,214.08048455287553,0.47881199290846027,0.7929724825773243,0.12121412368572154,1038045.500608422,-4354.94324836339,1033690.5573600585,2485,0,300.24038461538464,73,135,38,39.5725790868437,0.5279947916666667,45.030968468468465,8142.522206506078,111.54140008912435,8
2600,31.79086933970418,5,2,205,0.024154589371980676,0.00966183574879227,0.9903381642512077,207,6900,5300,1600,0.7681159420289855,85,53,32,221.99622782250196,0.47915298688304175,0.8002907017766681,0.1273687854601732,1037435.701709021,-2238.637522441315,1035197.0641865797,2486,0,302.0,66,141,43,38.85596701557937,0.5322564412238325,44.52736318407961,8121.697216884643,123.05601843764612,0
2601,32.07790688760512,1,2,204,0.0048543689320388345,0.009708737864077669,0.9902912621359223,206,7050,5300,1750,0.75177304964539,88,53,35,246.14334545962276,0.47886178861788614,0.8076612175049658,0.14192841523182592,1048348.7487324799,3358.813644284711,1051707.5623767646,2487,0,304.19417475728153,68,138,35,38.045837023914984,0.5313511326860841,44.338768115942045,8201.077191147266,120.60407634040097,8
2602,31.7580098510147,7,5,206,0.03317535545023697,0.023696682464454975,0.976303317535545,211,7300,5000,2300,0.684931506849315,96,50,46,234.24411334356006,0.4797412171819755,0.8025502132219593,0.1368576405130325,1041919.3476774736,-687.3052455575835,1041232.042431916,2488,0,295.49289099526067,77,134,36,37.843167283596635,0.5356437598736177,43.84348290598293,8135.021193273471,105.64962588666846,0
2603,31.754310406123224,3,6,203,0.014354066985645933,0.028708133971291867,0.9712918660287081,209,7050,5600,1450,0.7943262411347518,85,56,29,223.11407136105913,0.4794618758434548,0.8020724984397758,0.12829059103260862,1036915.4447431571,-2579.914693238329,1034335.5300499188,2489,0,298.69856459330146,68,141,37,38.742640398550726,0.5321471291866029,44.444444444444436,8114.990437120359,119.33809466353469,8
2604,31.36693630367778,3,4,202,0.014563106796116505,0.019417475728155338,0.9805825242718447,206,7700,5800,1900,0.7532467532467533,96,58,38,217.92419384237434,0.478636830057621,0.7946949505997534,0.12617339867455363,1026354.5687173264,-4166.5016031677305,1022188.0671141586,2490,0,303.94174757281553,71,135,35,38.609178825924644,0.5346885113268609,44.18402777777778,8024.163306157855,113.0163845937726,0
2605,31.853299424125,4,5,201,0.019417475728155338,0.024271844660194174,0.9757281553398058,206,6450,5100,1350,0.7906976744186046,78,51,27,214.45336063501227,0.4788257755150367,0.7922907102180059,0.12490208698655926,1044085.7507641255,-2868.4603915005855,1041217.2903726249,2491,0,304.79126213592235,73,133,38,38.47030943610605,0.5363572006472492,43.96114864864865,8155.682196303642,111.72167392196769,0
2606,31.62408517921979,5,1,205,0.024271844660194174,0.0048543689320388345,0.9951456310679612,206,6550,4600,1950,0.7022900763358778,85,46,39,210.68234093368417,0.47887165522140657,0.7889460471987684,0.12407016114605923,1039921.4677774913,-3931.382156289105,1035990.0856212022,2492,0,302.59708737864077,66,140,43,38.144892391633796,0.5389360841423948,43.5478855721393,8110.063511057683,122.87975016754065,0
2607,31.86310410835627,0,2,203,0.0,0.00975609756097561,0.9902439024390244,205,6450,4800,1650,0.7441860465116279,81,48,33,209.2123766802054,0.4788498326159732,0.7888460238399195,0.12234650105792799,1045651.3226785887,-3697.360320722726,1041953.962357866,2493,1,304.8780487804878,70,135,40,38.448846065742735,0.5363821138211382,43.80868544600937,8163.050527290413,116.61500753272018,8
2608,31.412533329831472,2,3,202,0.00975609756097561,0.014634146341463415,0.9853658536585366,205,6900,5200,1700,0.7536231884057971,86,52,34,201.47105168366278,0.4791019049896381,0.7810088160892508,0.11874483528493686,1033215.3366794464,-6267.40390070055,1026947.9327787459,2494,0,305.70243902439023,66,139,42,38.34939686003513,0.5392784552845529,43.51679104477611,8056.787349848093,122.07253560375898,0
2609,31.255238561875935,0,4,198,0.0,0.019801980198019802,0.9801980198019802,202,6450,4600,1850,0.7131782945736435,83,46,37,203.07407690288318,0.4786125067730654,0.778835366769999,0.12010623379245632,1029076.8884152115,-5054.2321645981065,1024022.6562506134,2495,1,306.2722772277228,68,134,43,38.17655018237439,0.5411509900990099,43.387681159420275,8020.479243278456,117.94822416585964,0
2610,31.198398913084084,2,2,198,0.01,0.01,0.99,200,6500,4400,2100,0.676923076923077,86,44,42,203.8571030337578,0.4784432579564489,0.7765548762565408,0.12120982802192407,1028777.2520946839,-4555.289944189689,1024221.9621504942,2496,0,309.915,68,132,46,37.95619990986226,0.5433333333333333,43.19142512077294,8012.016363382735,117.8237700497461,0
2611,31.557222848697467,2,3,197,0.01,0.015,0.985,200,6300,4400,1900,0.6984126984126984,82,44,38,216.03808833394427,0.4786542085427136,0.7887312326227987,0.12386030675468983,1029588.8989826819,-1813.9164987861232,1027774.9824838958,2497,0,310.76,65,135,40,39.0363376583256,0.5361979166666666,44.55492424242425,8061.137181284242,124.01749509668065,8
2612,31.518810991151657,2,4,195,0.010050251256281407,0.020100502512562814,0.9798994974874372,199,6000,4200,1800,0.7,78,42,36,212.99895056018406,0.47856390538551347,0.7838786601029584,0.12303821732358956,1030624.2502926829,-1895.6232531560404,1028728.6270395268,2498,0,311.90452261306535,71,128,43,38.8238289205703,0.5384212730318259,44.270833333333364,8060.279269091452,113.52506012804862,0
2613,31.638424977687045,4,6,193,0.020100502512562814,0.03015075376884422,0.9698492462311558,199,6100,4300,1800,0.7049180327868853,79,43,36,212.41577655294344,0.478837791651862,0.782183688370427,0.12410438653859426,1037995.9975118288,-1802.6548259350016,1036193.3426858938,2499,0,311.7035175879397,77,122,42,38.402314356220586,0.5419807370184255,43.843482905982945,8104.3887486247595,105.25180193019168,0
2614,31.606151805681513,1,2,192,0.005154639175257732,0.010309278350515464,0.9896907216494846,194,5550,3500,2050,0.6306306306306306,76,35,41,212.07248787665884,0.47859467086872143,0.7772877658695849,0.12431431471664905,1037938.7155138846,-326.35086749342736,1037612.3646463911,2500,0,318.4742268041237,68,126,44,38.284808945962936,0.5437070446735395,43.71980676328502,8100.030692228996,119.1180984151323,0
2615,32.06785125785284,1,3,190,0.0051813471502590676,0.015544041450777202,0.9844559585492227,193,6350,4400,1950,0.6929133858267716,83,44,39,208.6019864698562,0.47844253742084053,0.7712685343331382,0.12481544273306802,1059363.8274920383,-752.9202381704417,1058610.9072538677,2501,0,312.3264248704663,78,115,38,37.59693153448924,0.5521373056994818,42.95886075949365,8242.75702031355,105.67637205530191,7
2616,31.618312631373666,1,2,189,0.005235602094240838,0.010471204188481676,0.9895287958115183,191,7300,5200,2100,0.7123287671232876,94,52,42,206.80547870326697,0.47786235877652244,0.7677843087934724,0.1244129320451555,1046131.9345405566,-2230.8368981134654,1043901.0976424431,2502,0,315.94240837696333,80,111,44,37.43990484760621,0.5548647469458987,42.75977366255142,8133.501897702712,101.6687737212839,0
2617,31.48750760131032,2,3,188,0.010471204188481676,0.015706806282722512,0.9842931937172775,191,6250,4300,1950,0.688,82,43,39,202.80747807264885,0.47762009736382843,0.7625549929071707,0.1231646797828261,1044599.3335850576,-2079.4887118488737,1042519.8448732088,2503,0,315.5183246073298,70,121,44,37.19088777505646,0.5575916230366492,42.41490610328639,8110.712602057018,115.86732288652883,0
2618,31.563903926410447,2,5,185,0.010526315789473684,0.02631578947368421,0.9736842105263158,190,5650,4000,1650,0.7079646017699115,73,40,33,219.41908968444406,0.47756602153531974,0.7753593287531966,0.132931461617248,1046418.2035957434,2270.825932441796,1048689.0295281853,2504,0,317.36315789473684,70,120,41,36.85295709646172,0.5582785087719297,42.502934272300465,8127.612643961697,116.10875205659568,8
2619,31.35345544124195,0,3,182,0.0,0.016216216216216217,0.9837837837837837,185,6400,4200,2200,0.65625,86,42,44,222.22890266453862,0.4767969056012534,0.7744830992872758,0.1297160265377187,1028364.6675618971,2306.4703222528005,1030671.1378841499,2505,1,326.1135135135135,80,105,36,38.186843074245175,0.5463963963963965,43.878600823045275,8030.290876643215,100.37863595804018,8
2620,31.72973382504749,1,3,180,0.00546448087431694,0.01639344262295082,0.9836065573770492,183,5800,3900,1900,0.6724137931034483,77,39,38,223.16267867027548,0.4759665425649032,0.7731435540513398,0.13108555379245537,1042623.6578170726,4134.937664691659,1046758.5954817643,2506,0,330.39344262295083,67,116,37,37.921832984762446,0.5488387978142076,43.64276960784313,8134.146684469495,121.40517439506709,0
2621,31.426355984171348,1,0,181,0.0055248618784530384,0.0,1.0,181,6200,4500,1700,0.7258064516129032,79,45,34,226.89225741538283,0.4753964599959075,0.7733823314185362,0.12807749857840248,1020566.2807528529,3911.7174564069855,1024477.9982092599,2507,0,333.7403314917127,78,103,33,39.365277490342145,0.5375805709023941,45.1476793248945,8009.079752928018,102.6805096529233,8
2622,31.090736586578334,0,1,180,0.0,0.0055248618784530384,0.994475138121547,181,4900,3200,1700,0.6530612244897959,66,32,34,231.6000820669173,0.4753184468999386,0.7785581190442323,0.13118577583509167,1010712.1319442478,5716.202540863199,1016428.334485111,2508,1,334.7403314917127,78,103,35,39.110387147929806,0.5389042357274402,45.01582278481011,7927.6458875428425,101.63648573772875,0
2623,31.523341403551015,1,1,180,0.0055248618784530384,0.0055248618784530384,0.994475138121547,181,5500,3800,1700,0.6909090909090909,72,38,34,211.0787172011659,0.47508057090239414,0.7631976547525086,0.12026578073089708,1026577.9989953084,1637.7534269739413,1028215.7524222824,2509,0,335.5303867403315,75,106,45,39.404761904761884,0.5375805709023941,44.79166666666667,8045.019420697928,107.2669256093057,7
2624,31.672337280304586,3,2,181,0.01639344262295082,0.01092896174863388,0.9890710382513661,183,6500,4800,1700,0.7384615384615385,82,48,34,205.0472726835883,0.4754023299105266,0.7594758038670364,0.11819771255974182,1035005.2912176762,-654.9975645467093,1034350.2936531295,2510,0,332.8306010928962,65,118,42,39.107708770630076,0.5404143897996356,44.349747474747446,8097.041023774783,124.56986190422742,0
2625,32.02141649394086,2,1,182,0.01092896174863388,0.00546448087431694,0.994535519125683,183,6250,4900,1350,0.784,76,49,27,198.58324896031746,0.475457375047539,0.7518572192797464,0.11541835875840717,1048955.2143454049,-1189.0131042849207,1047766.20124112,2511,0,331.56830601092895,71,112,41,38.95640214032704,0.542691256830601,44.039351851851826,8196.222520410849,115.43975380860351,0
2626,32.27518535108505,0,1,181,0.0,0.005494505494505495,0.9945054945054945,182,6800,5100,1700,0.75,85,51,34,216.50403688055718,0.4749559832432761,0.7640960194615276,0.12259657955130399,1049118.3602827643,2227.672033345919,1051346.0323161103,2512,1,334.3131868131868,74,108,39,39.507526237426,0.5374313186813187,45.027777777777786,8229.275731600286,111.20642880540927,8
2627,31.857408486032465,5,2,184,0.026881720430107527,0.010752688172043012,0.989247311827957,186,6200,4400,1800,0.7096774193548387,80,44,36,206.26622140382617,0.4759705269785915,0.7573070222862974,0.11818711149579049,1039198.0525405817,-529.7088824478751,1038668.3436581338,2513,0,328.0806451612903,72,114,43,39.30912476722535,0.5408266129032258,44.57762557077626,8137.09491866413,113.01520720366847,0
2628,31.367870903279787,2,1,185,0.010752688172043012,0.005376344086021506,0.9946236559139785,186,5450,3600,1850,0.6605504587155964,73,36,37,213.47134506156678,0.47600443185120606,0.7688611744014076,0.12013345569364285,1017728.1095903192,801.1576922420586,1018529.2672825613,2514,0,328.4301075268817,76,110,47,39.82729244114002,0.5333221326164874,45.2651515151515,7990.489841839234,105.13802423472676,7
2629,31.592917858817334,6,3,188,0.031413612565445025,0.015706806282722512,0.9842931937172775,191,6550,4600,1950,0.7022900763358778,85,46,39,208.2412672459158,0.4771195003214843,0.7713377326546227,0.11884898409029736,1029360.7107758243,-1878.924226977093,1027481.7865488472,2515,0,320.7958115183246,64,127,40,39.41173854814068,0.5370309773123909,44.72756410256411,8064.801098927923,126.0125171707488,0
2630,31.30822665559698,3,2,189,0.015706806282722512,0.010471204188481676,0.9895287958115183,191,6400,4600,1800,0.71875,82,46,36,197.15365375122852,0.47697483236888033,0.7607297853509776,0.11388522822570998,1023738.4155758999,-4233.246176743389,1019505.1693991565,2516,0,321.5235602094241,73,118,44,39.2290393754243,0.5416121291448517,44.27083333333334,8006.426712446957,109.67707825269804,8
2631,31.2078205143247,3,8,184,0.015625,0.041666666666666664,0.9583333333333334,192,6450,4800,1650,0.7441860465116279,81,48,33,201.34845915158374,0.4769329006689936,0.7665713919534962,0.11748213714187251,1023471.0542588688,-3635.1360477456938,1019835.9182111231,2517,0,319.9739583333333,79,113,38,38.73655879810871,0.5444878472222222,43.893229166666686,7992.534136670001,101.17131818569622,0
2632,31.03967575018729,1,5,180,0.005405405405405406,0.02702702702702703,0.972972972972973,185,5700,3800,1900,0.6666666666666666,76,38,38,214.1030652696636,0.47508445945945943,0.7662542610177767,0.12187405253811506,1010542.594578025,572.0534169423313,1011114.6479949674,2518,0,332.95675675675676,86,99,39,39.36426661036032,0.5405405405405406,44.82758620689652,7920.468984530466,92.09847656430775,8
2633,30.634337190355463,4,2,182,0.021739130434782608,0.010869565217391304,0.9891304347826086,184,6450,4800,1650,0.7441860465116279,81,48,33,209.15307714057144,0.47552553555872334,0.7594292880281017,0.11817334607178606,995122.7618761088,-1623.4024441976944,993499.3594319111,2519,0,330.3097826086956,77,107,39,39.78112228858846,0.5367413949275363,45.112179487179475,7808.319439304519,101.40674596499375,8
2634,30.86917811898331,1,3,180,0.00546448087431694,0.01639344262295082,0.9836065573770492,183,6200,4600,1600,0.7419354838709677,78,46,32,208.35144526339099,0.47572134150003004,0.7545300430523163,0.1168538785644354,1000518.6928255368,-1108.0968673526181,999410.5959581842,2520,0,331.79234972677597,80,103,42,40.091381284304774,0.535462204007286,45.396090534979386,7859.413431065131,98.24266788831413,7
2635,30.59388003869383,2,2,180,0.01098901098901099,0.01098901098901099,0.989010989010989,182,6150,4100,2050,0.6666666666666666,82,41,41,223.18077258189558,0.4749793829559023,0.7600757859094096,0.1258328027139736,993176.2878477125,1781.570246373968,994957.8580940865,2521,0,334.36813186813185,82,100,38,39.506476875338606,0.5374885531135531,45.19327309236945,7795.5264360641995,95.06739556175853,8
2636,30.521177801390998,1,1,180,0.0055248618784530384,0.0055248618784530384,0.994475138121547,181,5900,4000,1900,0.6779661016949152,78,40,38,225.14401616953563,0.47425695723347655,0.7624973257386505,0.1278777196612079,993009.4899647539,2614.028933024887,995623.5188977787,2522,0,337.1325966850829,86,95,42,39.16823124462176,0.5398250460405156,44.91139846743292,7785.604562483571,90.53028561027408,0
2637,31.072423209522025,2,3,179,0.01098901098901099,0.016483516483516484,0.9835164835164835,182,4550,2800,1750,0.6153846153846154,63,28,35,246.4496632507443,0.47430964523505964,0.794347565436246,0.1395206869097076,1009950.8766314203,8830.410689121694,1018781.287320542,2523,0,336.25274725274727,67,115,37,38.7532043579268,0.5333104395604396,45.03676470588237,7922.325549927797,118.24366492429547,8
2638,30.913083299243095,2,2,179,0.011049723756906077,0.011049723756906077,0.988950276243094,181,6100,4700,1400,0.7704918032786885,75,47,28,242.28735751053745,0.4739257213014119,0.7886637314847389,0.13846126693143174,1007603.5931559083,6525.922400773555,1014129.5155566818,2524,0,338.9779005524862,63,118,37,38.49159866981151,0.5366597605893186,44.677734375,7892.798465417098,125.28251532408092,0
2639,30.836629755904536,1,5,175,0.005555555555555556,0.027777777777777776,0.9722222222222222,180,5600,3900,1700,0.6964285714285714,73,39,34,237.3646552024309,0.4741872284295469,0.7850262294396724,0.13661959169337998,1007243.9035564465,6216.820374485169,1013460.7239309318,2525,0,341.21666666666664,64,116,39,38.34017806759042,0.5388310185185186,44.40705128205127,7881.625127835257,123.1503926224259,0
2640,30.69807711063804,2,0,177,0.011299435028248588,0.0,1.0,177,5400,3600,1800,0.6666666666666666,72,36,36,262.5851840627109,0.4738219054956343,0.8022926152751015,0.14447415904008074,989169.5407182862,11148.253183747496,1000317.7939020337,2526,0,345.2542372881356,67,110,35,39.47371067664333,0.5252471751412429,46.13970588235293,7793.022884152754,116.31377439033962,8
2641,30.751442374723755,1,0,178,0.0056179775280898875,0.0,1.0,178,5250,3400,1850,0.6476190476190476,71,34,37,259.0661477787896,0.47384625150764936,0.8015270792044036,0.14344401878957855,992817.0831697515,10591.059437152235,1003408.1426069037,2527,0,344.30898876404495,69,109,38,39.30980128054967,0.5272705992509363,45.89285714285713,7814.161160577102,113.24871247213191,0
2642,30.38196978031231,3,1,180,0.016574585635359115,0.0055248618784530384,0.994475138121547,181,4950,3800,1150,0.7676767676767676,61,38,23,217.6128049002522,0.47459458768160423,0.7530191407881024,0.11874341194822623,976485.5732612016,1349.152908400204,977834.7261696018,2528,0,339.585635359116,75,106,44,40.94654377049768,0.5241137200736647,46.463815789473685,7702.928686899911,102.70571582533215,8
2643,30.93552810264207,6,3,183,0.03225806451612903,0.016129032258064516,0.9838709677419355,186,5850,4500,1350,0.7692307692307693,72,45,27,233.4029297398377,0.47558183183183184,0.7813770493179601,0.12926737395212898,998838.3184240483,3576.357971317374,1002414.6763953656,2529,0,331.36021505376345,83,103,41,39.9517697963433,0.5277217741935484,45.88293650793652,7861.245559019641,94.7138019158993,8
2644,31.1037944019068,6,5,184,0.031746031746031744,0.026455026455026454,0.9735449735449735,189,5700,4100,1600,0.7192982456140351,73,41,32,206.00375236701325,0.4756944444444444,0.7682070391156908,0.1144189516158956,1005147.8260635554,-2087.155229472192,1003060.6708340832,2530,0,325.9100529100529,67,122,39,40.534867839640064,0.5271715167548501,45.77205882352942,7907.453613573018,118.02169572497041,8
2645,30.719902465958327,2,3,183,0.010752688172043012,0.016129032258064516,0.9838709677419355,186,5250,4000,1250,0.7619047619047619,65,40,25,204.09868274923136,0.47604499660951277,0.7554490602741564,0.11082726357041173,985852.8718167688,-2207.7454955298604,983645.1263212389,2531,0,328.8709677419355,75,111,39,41.48497799899014,0.5229614695340502,46.65570175438599,7782.712132411973,103.7694950988263,8
2646,30.688570039296664,1,1,183,0.005434782608695652,0.005434782608695652,0.9945652173913043,184,5550,4200,1350,0.7567567567567568,69,42,27,193.76845954381696,0.4759753405401124,0.7447495292493864,0.10482145208465117,983689.9189679516,-4228.383946559425,979461.5350213922,2532,0,333.0,73,111,39,41.89848918663483,0.5190217391304348,46.80461711711713,7770.204241227918,106.44115398942353,8
2647,30.97005944595574,4,3,184,0.0213903743315508,0.016042780748663103,0.983957219251337,187,6300,4700,1600,0.746031746031746,79,47,32,188.90089809777749,0.4766929254595289,0.7364235794802607,0.1029662536413321,995057.3033077725,-6106.556349281754,988950.7469584907,2533,0,328.50267379679144,78,109,42,41.71727351538792,0.521780303030303,46.50580168776372,7850.730390934873,100.65038962737016,8
2648,30.56255166696241,8,2,190,0.041666666666666664,0.010416666666666666,0.9895833333333334,192,6650,5200,1450,0.7819548872180451,81,52,29,200.88685837140522,0.4777378972149506,0.7640027322404364,0.11140089418777939,987181.0308399936,-5387.660814141651,981793.370025852,2534,0,320.8645833333333,66,126,40,40.72745901639341,0.5252278645833333,45.833333333333336,7767.981882019622,117.69669518211549,8
2649,30.48137630073373,5,2,193,0.02564102564102564,0.010256410256410256,0.9897435897435898,195,5600,4200,1400,0.75,70,42,28,191.83826726822048,0.4781941140188563,0.7571636845593102,0.10786690179677527,988710.5690262667,-6665.4955216448,982045.0735046219,2535,0,315.64102564102564,71,124,46,40.41187399413046,0.5289529914529915,45.29803240740742,7763.666518727129,109.34741575672012,0
2650,30.639409542974462,1,2,192,0.005154639175257732,0.010309278350515464,0.9896907216494846,194,6250,4400,1850,0.704,81,44,37,199.03527029686128,0.47810613749265535,0.7630589211562722,0.10815302782797703,983482.5141570026,-5900.458392504863,977582.0557644977,2536,0,315.96907216494844,75,119,42,41.585298784665895,0.5164304123711341,46.62828947368421,7763.159605419767,103.50879473893023,8
2651,30.81838501171696,7,7,192,0.035175879396984924,0.035175879396984924,0.964824120603015,199,6450,4700,1750,0.7286821705426356,82,47,35,196.19723865877666,0.47855333062619493,0.76684963277928,0.10807475010864848,993405.7363472326,-7269.307532176782,986136.4288150559,2537,0,308.93467336683415,83,116,39,41.11217948717951,0.5203098827470687,46.09375000000001,7824.980569381279,94.27687432989492,0
2652,30.91061365208131,0,2,190,0.0,0.010416666666666666,0.9895833333333334,192,6850,4800,2050,0.7007299270072993,89,48,41,200.9789478124703,0.47748793357329844,0.7646863761839624,0.11068137703379635,996302.9551935142,-5202.81607255058,991100.1391209636,2538,1,320.4322916666667,80,112,41,41.000607810363135,0.5214301215277778,46.10339506172839,7848.09986282203,98.10124828527537,0
2653,30.972592000104726,6,1,195,0.030612244897959183,0.00510204081632653,0.9948979591836735,196,6350,5000,1350,0.7874015748031497,77,50,27,202.49583007769309,0.4783174167102739,0.7723060667028172,0.11247595968591342,1000922.5200499072,-5013.472691807366,995909.0473580998,2539,0,312.8112244897959,65,131,43,40.6221546229617,0.5209396258503401,45.770202020202035,7874.155807097358,121.14085857072858,8
2654,31.07959426913907,2,4,193,0.01015228426395939,0.02030456852791878,0.9796954314720813,197,6500,4400,2100,0.676923076923077,86,44,42,201.30245680733998,0.47855588936082044,0.7721165570229309,0.11282300486178877,1007129.3662413757,-5352.476850558092,1001776.8893908176,2540,0,312.1015228426396,70,127,45,40.29782830029193,0.523477157360406,45.42253521126762,7912.164315699881,113.03091879571258,0
2655,31.56511543780087,1,2,192,0.005154639175257732,0.010309278350515464,0.9896907216494846,194,6050,4300,1750,0.7107438016528925,78,43,35,201.9838000716035,0.4786970514395599,0.7694786021112872,0.11394555103447304,1024878.9743542103,-3448.2100292898144,1021430.7643249205,2541,0,317.0360824742268,73,121,38,40.02461608573167,0.5268470790378007,45.171734234234236,8043.683625710998,110.18744692754792,0
2656,31.234730382207875,6,3,195,0.030303030303030304,0.015151515151515152,0.9848484848484849,198,5800,4200,1600,0.7241379310344828,74,42,32,195.91757690602634,0.47905503854107917,0.7681129435873204,0.11216032651503366,1018623.7945697894,-5486.738877813046,1013137.0556919763,2542,0,311.520202020202,68,130,43,39.60697818762191,0.5309869528619529,44.61050724637681,7977.021948608246,117.30914630306245,0
2657,30.934392572908457,2,3,194,0.01015228426395939,0.015228426395939087,0.9847715736040609,197,6350,4400,1950,0.6929133858267716,83,44,39,222.02242358100898,0.47915371732449324,0.7874112859584756,0.12613154585708108,1006517.5855538954,-1056.105255684054,1005461.4802982114,2543,0,313.994923857868,83,114,36,39.239554469884766,0.5290291878172588,44.90327380952379,7891.262272039874,95.07544906072137,8
2658,30.899635580903748,1,6,189,0.005128205128205128,0.03076923076923077,0.9692307692307692,195,6950,5000,1950,0.7194244604316546,89,50,39,224.32119602024608,0.4786412899814962,0.7856593566270988,0.12674700090405044,1003749.1028878327,-917.5601471904129,1002831.5427406422,2544,0,317.74871794871797,74,121,37,39.3934130703284,0.527190170940171,45.111111111111114,7875.973780288138,106.43207811200186,8
2659,31.159118953139306,2,3,188,0.010471204188481676,0.015706806282722512,0.9842931937172775,191,5800,4200,1600,0.7241379310344828,74,42,32,220.8020336726855,0.4783893634610086,0.7821265146877538,0.12215430338326047,1005719.5174444257,412.98295120800776,1006132.5003956337,2545,0,324.27748691099475,78,113,40,40.31561921566588,0.525414485165794,45.92563291139239,7916.733427057476,101.49658239817276,8
2660,30.83146717611794,3,3,188,0.015706806282722512,0.015706806282722512,0.9842931937172775,191,5950,4100,1850,0.6890756302521008,78,41,37,216.30156788613348,0.4787820336180766,0.7754582825618295,0.1211660645322039,998930.5143042878,-935.9527093361094,997994.5615949518,2546,0,324.15706806282725,71,120,41,39.93659420289859,0.5295593368237348,45.44270833333334,7848.374782462333,110.54048989383568,8
2661,30.903756443804596,2,2,188,0.010526315789473684,0.010526315789473684,0.9894736842105263,190,6400,4500,1900,0.703125,83,45,38,208.0719286652951,0.47869326093010306,0.7640757206367403,0.11748061203102067,1003664.1714071195,-2633.1320246129826,1001031.0393825065,2547,0,319.44736842105266,77,113,39,39.83594459582195,0.5326754385964912,45.13888888888889,7876.165704775215,102.28786629578201,0
2662,31.301001745802484,4,4,188,0.020833333333333332,0.020833333333333332,0.9791666666666666,192,7250,5100,2150,0.7034482758620689,94,51,43,202.27559807076452,0.47866162649069227,0.759471789423984,0.11568905722453074,1020493.4031332749,-4365.817310789109,1016127.5858224857,2548,0,317.03125,71,121,43,39.48182247403212,0.53662109375,44.64699074074077,7992.804988620052,112.5747181495782,0
2663,31.4733500606329,1,1,188,0.005291005291005291,0.005291005291005291,0.9947089947089947,189,6250,4700,1550,0.752,78,47,31,208.82565857525196,0.4781359056625014,0.7666476553154269,0.11724569098778127,1020432.3181372305,-1431.5098267043018,1019000.8083105262,2549,0,322.43386243386243,73,116,43,40.037083103003475,0.5303681657848325,45.35472972972973,8014.5397325007025,109.78821551370825,8
2664,31.22010132459204,1,2,187,0.005291005291005291,0.010582010582010581,0.9894179894179894,189,6200,4900,1300,0.7903225806451613,75,49,26,203.6197032143569,0.4785369526061016,0.7602763336292351,0.11476692223417154,1013406.9003823578,-2730.0775417526984,1010676.822840605,2550,0,323.29100529100526,77,112,37,40.017547652742095,0.5322971781305115,45.205662393162385,7954.705037017763,103.30785762360732,0
2665,31.546048504226842,2,1,188,0.010582010582010581,0.005291005291005291,0.9947089947089947,189,4800,3300,1500,0.6875,63,33,30,203.7995450680257,0.47871988629967355,0.7508146360059074,0.11575444701877505,1026353.7580177564,-765.9142074248948,1025587.8438103315,2551,0,324.18518518518516,86,103,37,39.71270437299535,0.5359347442680775,44.911398467432925,8047.037396821685,93.57020228862424,8
2666,32.063751059644346,1,1,188,0.005291005291005291,0.005291005291005291,0.9947089947089947,189,5650,4000,1650,0.7079646017699115,73,40,33,244.89820893656523,0.4786342827122969,0.7981806174855484,0.1357046313243495,1035431.1766779579,7265.048129102225,1042696.2248070601,2552,0,325.1746031746032,70,119,41,39.638898510564566,0.5241953262786596,45.86267605633801,8148.5958898937315,116.40851271276759,8
2667,32.12667962818903,5,3,190,0.025906735751295335,0.015544041450777202,0.9844559585492227,193,7250,5700,1550,0.7862068965517242,88,57,31,228.52841749868503,0.479254371761658,0.7881437684463033,0.1284754913090421,1042025.7093560701,1776.4972704177217,1043802.2066264879,2553,0,319.3834196891192,64,129,44,39.48397093059839,0.5274179620034543,45.304487179487204,8182.521143121976,127.85189286128087,0
2668,31.743447751941964,3,2,191,0.015544041450777202,0.010362694300518135,0.9896373056994818,193,6050,3900,2150,0.6446280991735537,82,39,43,221.0944519253814,0.4792701137017847,0.7811666046689709,0.12521664349431758,1031885.2553550757,978.8209965228034,1032864.0763515985,2554,0,318.8497409326425,67,126,40,39.38401171522983,0.5297927461139896,45.021446078431396,8093.898404275079,120.80445379515044,0
2669,31.335623431224278,5,6,190,0.025510204081632654,0.030612244897959183,0.9693877551020408,196,6950,4700,2250,0.6762589928057554,92,47,45,220.09041031817577,0.4802857360893075,0.7834270335682145,0.12644654872431754,1022990.7439368046,-1119.9094830505383,1021870.834453754,2555,0,314.8724489795918,65,131,40,38.8521721227095,0.5333227040816326,44.476010101010104,8007.003525118707,123.18466961721089,0
2670,31.398118242605527,3,2,191,0.015544041450777202,0.010362694300518135,0.9896373056994818,193,5750,4300,1450,0.7478260869565218,72,43,29,222.4226558404418,0.48011905404432925,0.781284772282163,0.1287650120675194,1027344.5556893628,1350.940907929472,1028695.4965972923,2556,0,316.1761658031088,68,125,37,38.49795908330878,0.5367012089810017,44.18780193236716,8032.021642828374,118.11796533571138,0
2671,31.415084261468813,1,3,189,0.005208333333333333,0.015625,0.984375,192,4750,3200,1550,0.6736842105263158,63,32,31,225.0276722144231,0.4801517506544503,0.7828551779693149,0.13067561069469436,1028833.0026171758,3153.1791352635973,1031986.1817524394,2557,0,318.8177083333333,67,125,39,38.31259601763731,0.5377604166666667,44.07169117647058,8040.009386586369,120.00014009830402,0
2672,31.405945939516204,0,2,187,0.0,0.010582010582010581,0.9894179894179894,189,6200,4400,1800,0.7096774193548387,80,44,36,241.85113113725865,0.4794410672070246,0.7980683428371573,0.13632679631485745,1019465.0185111938,5311.75357635947,1024776.7720875533,2558,1,323.2645502645503,70,119,31,39.04015757854933,0.527336860670194,45.20246478873238,8002.157616367014,114.31653737667163,8
2673,31.368539175498288,1,1,187,0.005319148936170213,0.005319148936170213,0.9946808510638298,188,5350,3900,1450,0.7289719626168224,68,39,29,263.2824908057894,0.47912933306784994,0.8144249182686714,0.1450578326056007,1011202.3647057328,10296.375457685954,1021498.7401634187,2559,0,324.8031914893617,65,123,36,39.40074382562571,0.5174534574468085,46.08585858585859,7964.915692162511,122.53716449480785,7
2674,31.654625514960475,1,3,185,0.005319148936170213,0.015957446808510637,0.9840425531914894,188,6600,4900,1700,0.7424242424242424,83,49,34,238.1004099453442,0.47901555448098,0.7906931640095567,0.13165892303779478,1021557.6515491446,4446.65912333119,1026004.3106724758,2560,0,325.7659574468085,83,105,37,39.89587909405964,0.5249889184397163,45.944940476190496,8042.017769407236,96.89178035430405,8
2675,31.379373337418315,3,2,186,0.015957446808510637,0.010638297872340425,0.9893617021276596,188,4650,2700,1950,0.5806451612903226,66,27,39,241.01424720414283,0.4792668155269845,0.7948366662357367,0.13472498230378185,1016032.5647474563,6725.664745500568,1022758.2294929569,2561,0,326.0,63,125,38,39.39085651849486,0.5276484929078014,45.52408854166667,7985.294631030857,126.75070842906122,0
2676,30.95026122443649,6,4,188,0.03125,0.020833333333333332,0.9791666666666666,192,5750,4100,1650,0.7130434782608696,74,41,33,214.81474229580346,0.48000802156050026,0.7769351869043193,0.1217886528426525,1006419.8493038453,-911.2358860825989,1005508.6134177627,2562,0,319.890625,76,116,38,39.50287783141478,0.5321723090277778,44.98106060606061,7892.902791421171,103.85398409764699,8
2677,31.225692191141334,1,0,189,0.005291005291005291,0.0,1.0,189,7000,4800,2200,0.6857142857142857,92,48,44,218.73280985176586,0.47958178543284924,0.7795369355471649,0.12498365356248095,1017752.3240221773,-276.8348866928468,1017475.4891354844,2563,0,325.26984126984127,66,123,39,39.09821174846749,0.5347773368606702,44.68283582089553,7972.455179771823,120.79477545108823,0
2678,31.496469688176543,0,2,187,0.0,0.010582010582010581,0.9894179894179894,189,4900,2900,2000,0.5918367346938775,69,29,40,205.78201837616425,0.4793753987016398,0.764427976073027,0.11570490915232239,1021630.5840095556,-653.3592775388947,1020977.2247320168,2564,1,326.26984126984127,75,114,43,40.05750103140859,0.5309193121693121,45.298793859649116,8022.188818741557,106.96251758322076,8
2679,31.861782294537903,6,8,185,0.031088082901554404,0.04145077720207254,0.9585492227979274,193,6650,4400,2250,0.6616541353383458,89,44,45,207.45046193692806,0.4800302245250432,0.7689068543134552,0.11698759673862294,1034399.8671075853,-2332.653948207167,1032067.2131593782,2565,0,319.03108808290153,81,112,35,39.89932823171643,0.5294689119170984,45.18546747967478,8118.845160647002,100.23265630428398,8
2680,31.506571306916133,2,1,186,0.0106951871657754,0.0053475935828877,0.9946524064171123,187,5000,3400,1600,0.68,66,34,32,222.67520201938103,0.47945896344852706,0.7803864067621187,0.1266592892220331,1025514.9122236229,3271.3480506565597,1028786.2602742795,2566,0,328.9197860962567,80,107,38,39.174542170698906,0.5320298573975044,44.855967078189295,8038.713666785173,100.48392083481465,0
2681,31.414528303250247,2,2,186,0.010638297872340425,0.010638297872340425,0.9893617021276596,188,5500,3200,2300,0.5818181818181818,78,32,46,226.1268884999465,0.47970948534152535,0.7848384991251849,0.12957930419133673,1024780.2222396437,3246.072610266889,1028026.2948499105,2567,0,328.06382978723406,66,122,38,38.79813642542659,0.5343528368794326,44.57400497512438,8024.087150094818,121.57707803173966,0
2682,31.563141625408047,0,2,184,0.0,0.010752688172043012,0.989247311827957,186,6400,4800,1600,0.75,80,48,32,206.5105679986628,0.4793458781362007,0.7611471240119632,0.11657232062728222,1025008.3743003105,-1264.987683971539,1023743.386616339,2568,1,332.4731182795699,78,108,36,39.88470957505518,0.5316980286738351,45.147679324894504,8043.939891032238,103.1274345004133,8
2683,31.20399978518238,1,1,184,0.005405405405405406,0.005405405405405406,0.9945945945945946,185,5950,4100,1850,0.6890756302521008,78,41,37,202.54912526011265,0.47932824128476303,0.7559195623066481,0.11305851761580636,1009907.3846331164,-2038.8285297668208,1007868.5561033495,2569,0,333.84324324324325,69,116,44,40.4271095318867,0.5268581081081081,45.580357142857146,7938.9104810604695,115.05667363855753,8
2684,31.078793543023053,5,2,187,0.026455026455026454,0.010582010582010581,0.9894179894179894,189,6650,4700,1950,0.706766917293233,86,47,39,190.57505723090247,0.4798538406694435,0.7455191409081905,0.10763909343745987,1009454.6499165961,-5974.6244640289115,1003480.0254525673,2570,0,327.6666666666667,77,112,39,40.268262597153104,0.5306988536155203,45.12553418803419,7921.190902358367,102.87260912153722,0
2685,30.88954039500258,1,2,186,0.005319148936170213,0.010638297872340425,0.9893617021276596,188,5900,3600,2300,0.6101694915254238,82,36,46,195.11456323831476,0.47963126256305233,0.7489052723949456,0.11082891877071088,1005014.2508905701,-4281.416677840958,1000732.8342127291,2571,0,330.3085106382979,79,109,41,39.931654416143495,0.53302304964539,44.908854166666664,7879.648253626235,99.74238295729411,0
2686,30.567836345595556,1,0,187,0.0053475935828877,0.0,1.0,187,6050,4300,1750,0.7107438016528925,78,43,35,192.35897707769573,0.479585944837368,0.7450996784190369,0.10976890266234329,995919.2264334775,-5135.199270249037,990784.0271632285,2572,0,332.67379679144386,70,117,40,39.82269095925055,0.5348150623885918,44.7329812206573,7802.9604544750655,111.47086363535807,0
2687,30.71379457606884,1,3,185,0.005319148936170213,0.015957446808510637,0.9840425531914894,188,6100,4200,1900,0.6885245901639344,80,42,38,210.64839308182277,0.47976993021580006,0.7670953200200339,0.11760198859482392,994100.1933763486,-1818.8783405883096,992281.3150357603,2573,0,331.8989361702128,67,121,43,40.21345104060045,0.5287012411347518,45.572916666666686,7814.42117208839,116.63315182221478,8
2688,31.140165779437048,3,1,187,0.015957446808510637,0.005319148936170213,0.9946808510638298,188,6050,4400,1650,0.7272727272727273,77,44,33,209.1631812970821,0.48007274718398,0.7663311740205523,0.118038972387855,1011193.1080860075,-1349.1265214091,1009843.9815645984,2574,0,332.4840425531915,73,115,37,39.82729415230519,0.5357380319148937,45.15765765765767,7935.832788160625,108.71003819398116,8
2689,31.60445540734683,3,5,185,0.015789473684210527,0.02631578947368421,0.9736842105263158,190,5800,4100,1700,0.7068965517241379,75,41,34,222.55589848779,0.4800827299730808,0.7786068584604657,0.12811648936408615,1032372.6122415608,2152.122858321732,1034524.7350998826,2575,0,329.9684210526316,71,119,40,38.71253608422486,0.5447916666666667,44.401041666666686,8078.065880810176,113.77557578605882,8
2690,32.04493593874043,1,1,185,0.005376344086021506,0.005376344086021506,0.9946236559139785,186,6100,4500,1600,0.7377049180327869,77,45,32,223.1224048974272,0.47979935580742034,0.7756409671518951,0.12893542828937035,1047946.4166144462,3464.0649357315274,1051410.4815501778,2576,0,335.96774193548384,71,115,45,38.55015226942729,0.5464269713261649,44.256365740740755,8195.288376578665,115.42659685322063,0
2691,32.27880160483236,3,6,182,0.015957446808510637,0.031914893617021274,0.9680851063829787,188,5800,4200,1600,0.7241379310344828,74,42,32,206.76809771317755,0.4799364499184587,0.7637499592714494,0.11740831983191657,1050107.6899349107,25.75388836376942,1050133.4438232745,2577,0,333.34574468085106,87,101,38,39.6476731325506,0.5422761524822695,44.92187499999998,8233.616190607569,94.63926655870769,8
2692,31.873485219310005,2,2,182,0.010869565217391304,0.010869565217391304,0.9891304347826086,184,5750,4500,1250,0.782608695652174,70,45,25,206.47928767493042,0.4792842223014176,0.7610971125909536,0.11787862101901052,1038594.757676465,339.6611495909474,1038934.418826056,2578,0,339.875,68,116,39,39.445101517839525,0.5448369565217391,44.716183574879246,8136.784949555179,119.65860219934086,0
2693,31.810335404282174,3,3,182,0.016216216216216217,0.016216216216216217,0.9837837837837837,185,5850,3900,1950,0.6666666666666666,78,39,39,216.41566428487036,0.47902590090090086,0.7702583388082123,0.12376984060012004,1037082.895977155,2038.1967702746097,1039121.0927474296,2579,0,337.25945945945944,72,113,38,39.12277638073945,0.5396959459459459,44.648972602739725,8122.8018273349,112.81669204631805,7
2694,32.190207869361636,0,4,178,0.0,0.02197802197802198,0.978021978021978,182,5900,4100,1800,0.6949152542372882,77,41,36,222.7812684946557,0.47884033553923055,0.7677059600535459,0.12495624219315675,1043359.0999389364,4188.172755967858,1047547.2726949042,2580,1,342.54945054945057,70,112,41,39.72102973377899,0.5331959706959707,45.393192488262926,8195.846058757394,117.08351512510562,8
2695,32.0430579925873,3,0,181,0.016574585635359115,0.0,1.0,181,6450,4200,2250,0.6511627906976745,87,42,45,230.31619168318355,0.47803100061387355,0.7703275677064707,0.13040322454375256,1041538.0490648404,5326.61539074937,1046864.6644555898,2581,0,345.3646408839779,77,104,39,39.159726587052155,0.5355087476979743,45.03205128205128,8169.952767020244,106.1032826885746,8
2696,32.49321220017196,3,3,181,0.016304347826086956,0.016304347826086956,0.9836956521739131,184,6150,5000,1150,0.8130081300813008,73,50,23,226.92360890247366,0.4781327957947256,0.7780019662241804,0.12873228505031536,1056785.8345508806,5011.931082659656,1061797.7656335402,2582,0,340.7173913043478,68,116,34,39.170218223432386,0.5327785326086957,44.957729468599034,8287.142616390474,121.86974435868345,8
2697,32.158507985991356,1,0,182,0.005494505494505495,0.0,1.0,182,6200,4500,1700,0.7258064516129032,79,45,34,225.07607680688642,0.47803083196729607,0.7768095943164681,0.12566939600630153,1040892.4137712552,4255.996173936881,1045148.409945192,2583,0,342.467032967033,66,116,42,39.84239739280985,0.527014652014652,45.56902985074627,8182.1203854283085,123.97152099133801,8
2698,31.659033563076626,8,5,185,0.042105263157894736,0.02631578947368421,0.9736842105263158,190,5950,4600,1350,0.773109243697479,73,46,27,219.1523470920169,0.47918581175160124,0.7802793470736655,0.12446797158936979,1030013.4130554188,1195.9714014708948,1031209.3844568897,2584,0,329.0052631578947,76,114,40,39.3231376396549,0.5316337719298245,44.913419913419915,8075.794600451481,106.26045526909843,0
2699,31.371280943626825,4,0,189,0.021164021164021163,0.0,1.0,189,6550,4300,2250,0.6564885496183206,88,43,45,216.94432543847978,0.4796099290780142,0.7751343375931077,0.12435705145021174,1023466.542717988,57.05174376150717,1023523.5944617495,2585,0,331.16402116402116,67,122,43,39.02030234882558,0.5345568783068784,44.56188725490197,8013.420798636313,119.60329550203451,0
2700,31.36167860182271,0,8,181,0.0,0.042328042328042326,0.9576719576719577,189,5800,3900,1900,0.6724137931034483,77,39,38,225.66012838131059,0.47963924537506103,0.7792235434386077,0.1270224368061142,1017598.7653651532,2326.293606592627,1019925.0589717458,2586,1,332.16402116402116,73,116,40,39.50764169015123,0.5302028218694885,45.25619369369369,7989.1933791833435,109.44100519429237,8
2701,31.76001224562967,8,5,184,0.042328042328042326,0.026455026455026454,0.9735449735449735,189,6600,5000,1600,0.7575757575757576,82,50,32,213.11984323819,0.47963572741941535,0.762503514906762,0.12090441064405566,1032947.2236262426,-371.6899254905329,1032575.5337007521,2587,0,331.33862433862436,81,108,38,39.52133245338778,0.5340608465608465,44.95680894308942,8100.174871131923,100.00215890286324,8
2702,31.850111416226817,3,2,185,0.016042780748663103,0.0106951871657754,0.9893048128342246,187,5750,3500,2250,0.6086956521739131,80,35,45,218.0145439834258,0.4792229697353037,0.7663722515438678,0.12454848357641728,1038042.8291722242,2111.686807449699,1040154.5159796738,2588,0,331.5668449197861,71,116,39,39.12427277535371,0.5364861853832442,44.69039351851853,8131.639412068243,114.53013256434144,0
2703,32.03086279892207,0,0,185,0.0,0.0,1.0,185,5400,3900,1500,0.7222222222222222,69,39,30,220.15598750747972,0.47879945162553855,0.7631841625671507,0.12646428750746178,1045638.8282094729,3640.72976012436,1049279.5579695974,2589,1,335.81081081081084,73,112,40,38.856599823710894,0.5385135135135135,44.481981981982,8184.462577787678,112.11592572311888,0
2704,31.869226744551977,5,4,186,0.02631578947368421,0.021052631578947368,0.9789473684210527,190,5300,3000,2300,0.5660377358490566,76,30,46,227.01747301754276,0.4794265756985055,0.7759538565217972,0.13246565998079005,1045176.5282835602,4154.666861636418,1049331.1951451965,2590,0,327.94736842105266,80,110,39,38.07734956900161,0.5421052631578948,43.891460905349795,8161.981103623363,102.02476379529205,0
2705,31.926935876743983,1,2,185,0.0053475935828877,0.0106951871657754,0.9893048128342246,187,5900,4000,1900,0.6779661016949152,78,40,38,231.23763814610615,0.47918942748164756,0.7787409689166398,0.13549641034205356,1048355.2840935115,5183.839966354424,1053539.124059866,2591,0,333.1229946524064,65,122,42,37.808387735829704,0.5440619429590018,43.73421717171715,8181.781215762134,125.87355716557128,0
2706,32.21865655941404,1,4,182,0.005376344086021506,0.021505376344086023,0.978494623655914,186,6550,4900,1650,0.7480916030534351,82,49,33,213.33247511586643,0.4787549646420614,0.760227661409977,0.12366302254828594,1054595.6966565968,1245.9020428590466,1055841.5986994558,2592,0,335.8709677419355,74,112,35,38.68054047696598,0.5428987455197133,44.13888888888892,8243.501265799043,111.39866575404112,8
2707,32.21974851838208,0,1,181,0.0,0.005494505494505495,0.9945054945054945,182,5700,4400,1300,0.7719298245614035,70,44,26,211.80100949987747,0.4778322506223059,0.7544325783762391,0.12326124323353618,1055856.03109,2626.2746542795776,1058482.3057442794,2593,1,342.7197802197802,77,105,36,38.568075117370924,0.5452152014652014,43.99038461538464,8248.565425980094,107.1242263114298,0
2708,31.79672921821848,1,1,181,0.005494505494505495,0.005494505494505495,0.9945054945054945,182,5250,3300,1950,0.6285714285714286,72,33,39,236.33850651802706,0.4775685295367616,0.7814103400404766,0.13520933366626967,1036743.0621117491,7354.46138848349,1044097.5235002326,2594,0,343.4725274725275,66,116,38,38.600963977676344,0.5404647435897436,44.636194029850756,8119.733790566539,123.02626955403846,8
2709,31.901918344270474,2,1,182,0.01092896174863388,0.00546448087431694,0.994535519125683,183,5400,3800,1600,0.7037037037037037,70,38,32,226.40860678056214,0.47746527152264856,0.7748964471151034,0.12673469821780498,1033382.9611614662,4793.359301468003,1038176.3204629342,2595,0,342.5464480874317,68,115,36,39.70825919335707,0.5348360655737705,45.47101449275363,8119.962911902197,119.41121929267938,8
2710,31.749516401771363,3,1,184,0.016216216216216217,0.005405405405405406,0.9945945945945946,185,6200,4600,1600,0.7419354838709677,78,46,32,243.46027207715917,0.47817151390520957,0.7929032030726948,0.13702964079486277,1030154.9672397382,6960.361721164785,1037115.328960903,2596,0,339.7891891891892,68,117,35,39.057746631899164,0.5350788288288288,45.259661835748794,8087.882544738683,118.93944918733357,8
2711,31.461220594588568,6,2,188,0.031578947368421054,0.010526315789473684,0.9894736842105263,190,5850,4300,1550,0.7350427350427351,74,43,31,239.04824446101105,0.47938538475819176,0.7951350135166919,0.13643866344671246,1025086.0929620218,5159.006188793969,1030245.0991508157,2597,0,331.79473684210524,62,128,34,38.6232376881059,0.5393092105263158,44.72552910052913,8031.2464411351875,129.5362329215353,0
2712,31.37681904014494,2,2,188,0.010526315789473684,0.010526315789473684,0.9894736842105263,190,6700,5300,1400,0.7910447761194029,81,53,28,246.07815992631976,0.47922120115102573,0.8006230462566499,0.1387420590193739,1018591.5864737305,5430.628663177491,1024022.215136908,2598,0,332.62631578947367,69,121,33,38.923219743425044,0.5323464912280702,45.193452380952394,7995.018934886959,115.86983963604288,8
2713,31.525588805071283,2,1,189,0.010526315789473684,0.005263157894736842,0.9947368421052631,190,6400,4800,1600,0.75,80,48,32,254.72719700124952,0.47878202450570867,0.8059935553168638,0.14513526340768867,1026651.1870792116,7903.195836538597,1034554.3829157501,2599,0,333.60526315789474,62,128,33,38.29081632653064,0.5378837719298246,44.791666666666664,8045.59297629423,129.76762864990692,8
2714,32.01584651678041,2,4,187,0.010471204188481676,0.020942408376963352,0.9790575916230366,191,6000,4200,1800,0.7,78,42,36,255.98565223645423,0.47883714521906856,0.8096171213065575,0.1476894753362821,1046500.442767171,9377.819681498222,1055878.2624486692,2600,0,332.25130890052355,67,124,35,37.771665867832965,0.5412303664921466,44.316789215686256,8185.914433388162,122.17782736400243,0
2715,32.49850982057208,0,2,185,0.0,0.0106951871657754,0.9893048128342246,187,5500,4200,1300,0.7636363636363637,68,42,26,261.30206867574765,0.47835686082839785,0.8086555564309152,0.15118579150199707,1063168.4339168977,12661.622226648082,1075830.0561435458,2601,1,339.96256684491976,67,120,36,37.52570168084004,0.5423351158645277,44.20955882352941,8312.808164581997,124.07176365047756,0
2716,32.010578075695435,4,7,182,0.021164021164021163,0.037037037037037035,0.962962962962963,189,5550,3700,1850,0.6666666666666666,74,37,37,259.904839722546,0.47841265150662315,0.8115805890967773,0.15183999842371423,1050185.4545191186,11239.656447147607,1061425.1109662664,2602,0,337.30687830687833,75,114,37,37.18837506911371,0.544973544973545,43.84594298245611,8199.63944156615,109.32852588754868,0
2717,31.771364408556035,0,2,180,0.0,0.01098901098901099,0.989010989010989,182,6200,4800,1400,0.7741935483870968,76,48,28,262.3018414161062,0.47791130370550255,0.8065650903132364,0.1534604890907916,1042774.6478127219,12104.342060661373,1054878.9898733832,2603,1,349.9340659340659,73,109,37,37.07185273702908,0.546875,43.79222972972971,8140.070433560327,111.50781415836065,0
2718,31.722816275817642,2,2,180,0.01098901098901099,0.01098901098901099,0.989010989010989,182,5150,3600,1550,0.6990291262135923,67,36,31,285.9987976940279,0.47792395219881406,0.8080152087704606,0.16576975455945236,1038336.2194483631,17842.582072878828,1056178.801521242,2604,0,350.0,68,114,32,36.825018684603904,0.5449290293040293,44.14251207729469,8116.520082164217,119.36058944359142,8
2719,31.49070497346382,1,1,180,0.0055248618784530384,0.0055248618784530384,0.994475138121547,181,5350,3800,1550,0.7102803738317757,69,38,31,255.06733231522776,0.4780386740331492,0.7962417630124206,0.14759704410607272,1030236.9627794621,11005.958749739642,1041242.9215292018,2605,0,351.9171270718232,70,111,36,37.68031258961854,0.5417817679558011,44.20481220657275,8055.170792434543,115.0738684633506,8
2720,31.22659177462256,0,1,179,0.0,0.005555555555555556,0.9944444444444445,180,6250,4700,1550,0.752,78,47,31,248.06804987635604,0.47794847920546246,0.788354804600677,0.14208035470671448,1018495.9777063061,8281.262199303468,1026777.2399056096,2606,1,353.0,62,118,36,38.257428626917864,0.5388888888888889,44.59325396825399,7975.482194818074,128.6368095938399,8
2721,31.528313306869073,2,2,179,0.011049723756906077,0.011049723756906077,0.988950276243094,181,6900,5200,1700,0.7536231884057971,86,52,34,243.56604207547355,0.47830980151422137,0.7852710337894142,0.14117500961337598,1031969.8402563742,7170.561906500578,1039140.4021628748,2607,0,352.01657458563534,68,113,35,37.910692510424035,0.5418968692449355,44.142512077294676,8066.7550411355,118.62875060493381,0
2722,31.523910811427385,2,2,179,0.011049723756906077,0.011049723756906077,0.988950276243094,181,6200,4300,1900,0.6935483870967742,81,43,38,241.79260423757623,0.477877532228361,0.7853077577131613,0.14168213757285014,1035123.484093587,7657.040585292298,1042780.5246788793,2608,0,352.8729281767956,64,117,38,37.537651387238654,0.5454650092081031,43.73397435897436,8078.507336306651,126.22667712979143,0
2723,31.895033466423556,1,1,179,0.005555555555555556,0.005555555555555556,0.9944444444444445,180,5900,4500,1400,0.7627118644067796,73,45,28,247.5878159871734,0.4775534088557831,0.7774463736557604,0.14416599855829695,1045380.8497611948,9864.712293437917,1055245.5620546327,2609,0,353.5777777777778,70,110,38,37.631081313391775,0.5460069444444444,43.97007042253521,8166.083172279301,116.65833103256143,8
2724,31.816994177102597,1,1,179,0.005555555555555556,0.005555555555555556,0.9944444444444445,180,5150,3800,1350,0.7378640776699029,65,38,27,249.57492878233893,0.47722623111938756,0.7802137575195562,0.1459654120400339,1044169.6045279618,10969.710937349868,1055139.3154653118,2610,0,354.53333333333336,75,105,40,37.41083529495684,0.5477430555555556,43.804824561403514,8151.360405131617,108.68480540175489,0
2725,32.120748173160635,0,0,179,0.0,0.0,1.0,179,6150,4500,1650,0.7317073170731707,78,45,33,217.95371064809444,0.4767094553595715,0.7445611164636379,0.1215941936681471,1039414.444246341,3358.8470049430325,1042773.2912512841,2611,1,357.4972067039106,75,104,39,40.05559371801087,0.530377094972067,45.600328947368396,8171.507769216425,108.95343692288567,8
2726,32.35550172004206,3,1,181,0.016483516483516484,0.005494505494505495,0.9945054945054945,182,5350,3800,1550,0.7102803738317757,69,38,31,227.41936454945096,0.4774761955355878,0.7704027914465188,0.12556664433246992,1043702.372778593,5721.626079212631,1049423.9988578055,2612,0,352.5879120879121,79,103,36,40.226211530903456,0.5230654761904762,46.002604166666686,8218.213177771666,104.0280149085021,8
2727,32.693863629999605,6,1,186,0.03208556149732621,0.0053475935828877,0.9946524064171123,187,6200,4400,1800,0.7096774193548387,80,44,36,244.49448629709062,0.4784215494604489,0.7989851692402778,0.1367314740757457,1058737.9417081869,8171.117836236457,1066909.0595444234,2613,0,343.3850267379679,66,121,37,39.28462337344978,0.5282419786096257,45.5068407960199,8320.36464178271,126.06613093610166,7
2728,32.954176640382435,3,3,186,0.015873015873015872,0.015873015873015872,0.9841269841269842,189,5450,4000,1450,0.7339449541284404,69,40,29,236.30497624877768,0.47906347330106197,0.7942517369514925,0.13306985375007102,1069405.4611240414,7291.166418245843,1076696.627542287,2614,0,339.7037037037037,71,118,40,39.220060291139006,0.5302579365079365,45.24016203703703,8395.400701106677,118.24508029727714,0
2729,32.748132086443135,3,5,184,0.015873015873015872,0.026455026455026454,0.9735449735449735,189,6050,4400,1650,0.7272727272727273,77,44,33,235.49446678387352,0.4790411929153064,0.7945868773191647,0.13374950800231045,1065446.7779107038,6331.364170135301,1071778.142080839,2615,0,339.4179894179894,76,113,36,38.90627209729881,0.533013668430335,44.9134199134199,8353.609018154351,109.91590813360989,0
2730,32.30744505933117,2,3,183,0.010752688172043012,0.016129032258064516,0.9838709677419355,186,5800,4100,1700,0.7068965517241379,75,41,34,242.53608611285537,0.47817010558946044,0.7988922192083894,0.13843726427266495,1052676.1088811022,8062.3886785068335,1060738.4975596091,2616,0,345.53225806451616,60,126,38,38.531980957477664,0.5344982078853047,44.72336065573773,8247.336000545502,137.45560000909168,0
2731,32.45773176347877,3,0,186,0.016129032258064516,0.0,1.0,186,6400,4800,1600,0.75,80,48,32,232.9325947608333,0.4780054247796183,0.7895233722669461,0.13413817129467148,1060358.100258277,5798.392733765819,1066156.4929920428,2617,0,345.1666666666667,66,120,38,38.433388074529134,0.5370743727598566,44.387437810945286,8296.603978907899,125.70612089254392,0
2732,32.235119408627924,2,2,186,0.010638297872340425,0.010638297872340425,0.9893617021276596,188,5600,3700,1900,0.6607142857142857,75,37,38,225.6081407771346,0.47828962339287745,0.7854787736085873,0.13097634254979418,1055602.785354999,4430.5163606212145,1060033.30171562,2618,0,342.4840425531915,68,120,37,38.30841002044991,0.5393395390070922,44.08212560386474,8249.543239961671,121.31681235237751,0
2733,31.859613125419365,2,2,186,0.010638297872340425,0.010638297872340425,0.9893617021276596,188,6400,4900,1500,0.765625,79,49,30,229.03522533297078,0.4777989532370008,0.7827084774856665,0.13261866757019822,1042503.7000925597,3754.013972231248,1046257.714064791,2619,0,343.42021276595744,74,114,41,38.32138914526668,0.539561170212766,44.18055555555557,8150.308529959748,110.13930445891552,8
2734,32.340470920627894,1,2,185,0.0053475935828877,0.0106951871657754,0.9893048128342246,187,6250,4500,1750,0.72,80,45,35,224.4657784212185,0.47755424261591245,0.7769980283168398,0.13057380648831052,1059674.3110792772,3922.1238218759154,1063596.4349011532,2620,0,345.951871657754,76,111,40,38.26086860786701,0.5416666666666667,44.00703463203465,8278.933052368036,108.93332963642153,0
2735,32.46182365855541,0,2,183,0.0,0.010810810810810811,0.9891891891891892,185,5600,4200,1400,0.75,70,42,28,223.51738006319945,0.4772326674500587,0.7742885936784234,0.13031151604475125,1064343.941351167,4979.873851390689,1069323.8152025577,2621,1,350.2108108108108,77,108,41,38.199858757062174,0.5438063063063063,43.92361111111113,8312.70657923081,107.95722830169882,0
2736,32.12292985085725,0,2,181,0.0,0.01092896174863388,0.9890710382513661,183,6450,4900,1550,0.7596899224806202,80,49,31,242.438818595063,0.4765732900978803,0.7839783846634834,0.14172094697738294,1054055.8661325378,8058.811783673802,1062114.6779162115,2622,2,354.9781420765027,84,99,36,37.61281732363824,0.5491803278688525,43.82352941176472,8229.138794146105,97.96593802554887,8
2737,32.127505519003066,1,1,181,0.005494505494505495,0.005494505494505495,0.9945054945054945,182,5850,4300,1550,0.7350427350427351,74,43,31,244.53228407178682,0.4758059619938073,0.7877848980592561,0.14390441623511074,1056263.0369063448,9408.082599062138,1065671.119505407,2623,0,357.8626373626374,64,118,36,37.303267504114324,0.5511675824175823,43.57371794871795,8238.33679182,128.7240123721875,0
2738,32.46058178410043,3,4,180,0.016304347826086956,0.021739130434782608,0.9782608695652174,184,5500,3500,2000,0.6363636363636364,75,35,40,223.34450456248905,0.47599328324225865,0.7673155897917012,0.1298051724536451,1063330.1768152942,5197.790305431325,1068527.9671207254,2624,0,354.9402173913044,85,99,36,38.32398731781185,0.5467051630434783,44.04069767441862,8308.587866540856,97.74809254753949,8
2739,32.38764584607995,0,1,179,0.0,0.005555555555555556,0.9944444444444445,180,5600,4200,1400,0.75,70,42,28,211.30687133522778,0.47602032898820607,0.7559355983177056,0.12260983982138678,1060435.065824806,3215.4432027217003,1063650.5090275276,2625,1,357.68333333333334,76,104,35,38.6944253541975,0.5452546296296297,44.101731601731636,8287.942489508318,109.05187486195155,8
2740,31.882803915359965,1,1,179,0.005555555555555556,0.005555555555555556,0.9944444444444445,180,6550,5400,1150,0.8244274809160306,77,54,23,214.69381224920318,0.47570414338919925,0.7601120832618493,0.12557196785075453,1046346.3533204852,2378.817505485867,1048725.170825971,2626,0,358.3,78,102,39,38.30234602847834,0.5475115740740741,43.8027426160338,8168.286920826105,104.72162719007828,0
2741,32.06357574068452,0,1,178,0.0,0.00558659217877095,0.994413407821229,179,5900,4200,1700,0.711864406779661,76,42,34,222.56678298854928,0.47546973406147347,0.7690502414158518,0.12886135745918564,1049149.2421275147,5001.1543390391125,1054150.3964665537,2627,1,361.29050279329607,71,108,44,38.49041398031899,0.5458566108007449,44.18402777777778,8202.37480102407,115.52640564822634,8
2742,32.00888028612671,1,1,178,0.00558659217877095,0.00558659217877095,0.994413407821229,179,5750,3900,1850,0.6782608695652174,76,39,37,219.09319696486824,0.47520688176092735,0.766784547589662,0.12770854481319271,1049436.113158352,4434.862608449786,1053870.9757668017,2628,0,362.2067039106145,74,105,36,38.320248232720445,0.5482425512104283,43.930555555555564,8196.496192157221,110.76346205617867,0
2743,31.53519842746862,2,3,177,0.011111111111111112,0.016666666666666666,0.9833333333333333,180,5500,3900,1600,0.7090909090909091,71,39,32,209.37765527739668,0.4757856145251396,0.7520955031552348,0.11904053546522352,1026304.8694664632,1477.061433732315,1027781.9309001955,2629,0,361.1333333333333,88,92,38,39.53181866837936,0.5402199074074074,44.87359550561796,8045.461789816921,91.42570215701046,8
2744,31.0819380780998,1,1,177,0.0056179775280898875,0.0056179775280898875,0.9943820224719101,178,6400,4800,1600,0.75,80,48,32,207.55596238182343,0.4759199305952306,0.747467236003305,0.11868531550562857,1013290.9279082251,62.914742952586494,1013353.8426511777,2630,0,363.2977528089888,75,103,35,39.35475934872073,0.5427200374531835,44.654605263157904,7936.629747738498,105.82172996984664,0
2745,31.14368583005816,0,1,176,0.0,0.005649717514124294,0.9943502824858758,177,5200,3700,1500,0.7115384615384616,67,37,30,206.53403069989054,0.47539350068481423,0.7452228110988666,0.11870194291114701,1016835.9935069429,1402.2472599433004,1018238.2407668862,2631,1,366.2316384180791,78,99,37,39.18429652562777,0.544903483992467,44.462025316455694,7958.394401193658,102.03069745120075,0
2746,30.9869660518923,1,1,176,0.005649717514124294,0.005649717514124294,0.9943502824858758,177,5850,4200,1650,0.717948717948718,75,42,33,203.62444361970563,0.4750805191747988,0.7424980139043758,0.11756296274489608,1013080.7559991318,7.601056430709832,1013088.3570555625,2632,0,367.2090395480226,80,97,38,39.08324532287266,0.5466690207156308,44.29012345679012,7923.673263578002,99.04591579472502,0
2747,31.315808854116945,2,2,176,0.011235955056179775,0.011235955056179775,0.9887640449438202,178,6050,4400,1650,0.7272727272727273,77,44,33,244.77285599653888,0.47527653462832475,0.7882459898034475,0.13794145681125417,1016467.4524264818,8110.728271591106,1024578.1806980729,2633,0,365.13483146067415,66,112,35,38.97491050362055,0.5332982209737828,45.21144278606965,7978.909755927668,120.89257205951012,8
2748,31.32337694551357,3,1,178,0.01675977653631285,0.00558659217877095,0.994413407821229,179,5050,3500,1550,0.693069306930693,66,35,31,215.47976276354396,0.47582543468708804,0.7548615085608856,0.12355921566281104,1022006.1293081472,3194.3276572414015,1025200.4569653886,2634,0,363.21787709497204,72,107,37,39.04463653967897,0.5422486033519553,44.549086757990864,8001.585246555129,111.13312842437679,8
2749,31.41531823314234,5,4,179,0.0273224043715847,0.02185792349726776,0.9781420765027322,183,5600,4000,1600,0.7142857142857143,72,40,32,198.90224743497163,0.4767634460257411,0.742557044924985,0.114010538947597,1024891.4416312544,-1429.357776534761,1023462.0838547196,2635,0,356.1311475409836,72,111,42,39.4826639107685,0.5441142987249545,44.56335616438359,8024.623454501795,111.45310353474716,7
2750,31.837832358937668,1,2,178,0.005555555555555556,0.011111111111111112,0.9888888888888889,180,5350,3700,1650,0.6915887850467289,70,37,33,197.2065377135643,0.47610891268363337,0.7359792474983142,0.11329804260690324,1039382.6056014873,-355.3909979251048,1039027.2146035623,2636,0,360.60555555555555,75,105,46,39.437333494251625,0.5465856481481481,44.47642543859652,8135.316730642549,108.47088974190066,0
2751,32.129137177935974,2,2,178,0.011111111111111112,0.011111111111111112,0.9888888888888889,180,6800,4400,2400,0.6470588235294118,92,44,48,198.40950601665054,0.47623629215807983,0.7328648058011302,0.11472650758584921,1050894.271927068,-1098.5173262442213,1049795.7546008239,2637,0,359.49444444444447,81,99,47,39.15805768020925,0.5489583333333333,44.232723577235795,8217.581909814126,101.45162851622378,0
2752,31.676099604269503,2,2,178,0.011111111111111112,0.011111111111111112,0.9888888888888889,180,6200,4300,1900,0.6935483870967742,81,43,38,196.18730249928052,0.4764050537968136,0.7325160075329549,0.11437797280096482,1038581.9679774817,-1448.6810556204218,1037133.2869218612,2638,0,359.3722222222222,83,97,39,38.89971751412431,0.5514467592592592,43.923611111111136,8111.501200746163,97.72893012947183,0
2753,31.99289427089972,1,2,177,0.00558659217877095,0.0111731843575419,0.9888268156424581,179,5950,4100,1850,0.6890756302521008,78,41,37,210.09864028619225,0.4760490553009855,0.7504707452114918,0.12129406037141016,1045951.048075954,2200.5786013351735,1048151.6266772891,2639,0,362.3631284916201,72,107,42,38.91985212053569,0.5440526070763501,44.29223744292238,8180.831411736926,113.6226584963462,8
2754,32.13500888934897,3,0,180,0.016666666666666666,0.0,1.0,180,5350,3900,1450,0.7289719626168224,68,39,29,227.29220378993307,0.4764205721084213,0.7733819396500627,0.12994067753803365,1047549.0362361141,6269.945804825326,1053818.9820409394,2640,0,359.0444444444444,64,116,43,38.85986108495994,0.5423032407407408,44.66346153846153,8205.241933237121,128.20690520683002,8
2755,31.79702635832958,2,1,181,0.01098901098901099,0.005494505494505495,0.9945054945054945,182,5300,3700,1600,0.6981132075471698,69,37,32,225.45273792150635,0.4767982362940926,0.7755149266671568,0.12739019681530148,1032909.4804775148,4874.454079747268,1037783.9345572621,2641,0,356.0879120879121,71,111,39,39.36338782305973,0.5370306776556777,45.1099537037037,8104.7455205591805,114.15134535998845,8
2756,31.756645349343763,4,2,183,0.021621621621621623,0.010810810810810811,0.9891891891891892,185,5300,3500,1800,0.660377358490566,71,35,36,224.15015812438838,0.4771494320407364,0.777406604615581,0.12804149236486362,1034967.3052849582,4097.617026639094,1039064.9223115973,2642,0,351.15675675675675,63,122,44,38.971322623145895,0.5398648648648648,44.694010416666664,8107.661766761166,128.69304391684392,0
2757,31.584090747765593,1,1,183,0.005434782608695652,0.005434782608695652,0.9945652173913043,184,5550,3900,1650,0.7027027027027027,72,39,33,225.13570204794027,0.47716945830363505,0.7754576659038905,0.12932908993910844,1031064.2491407215,4075.8747173657302,1035140.1238580872,2643,0,352.9021739130435,66,118,45,38.7280701754386,0.5427989130434783,44.48072139303482,8070.344083325976,122.27794065645418,0
2758,31.245780978904197,0,3,180,0.0,0.01639344262295082,0.9836065573770492,183,6000,4300,1700,0.7166666666666667,77,43,34,222.7558691748642,0.47714125582978045,0.7721469008795945,0.1283304835659816,1020889.1890922708,2881.811729494161,1023771.0008217649,2644,1,355.40437158469945,66,117,41,38.677624376596484,0.5446265938069217,44.371890547263675,7987.299920011538,121.01969575775058,0
2759,31.140967643003766,3,5,178,0.01639344262295082,0.0273224043715847,0.9726775956284153,183,5850,4100,1750,0.7008547008547008,76,41,35,249.08764756251506,0.47665835985508115,0.7867340896630763,0.14440318811650438,1019349.0966756156,8331.453707181077,1027680.5503827967,2645,0,356.24590163934425,72,111,33,37.76199970256354,0.5463911657559198,44.13527397260276,7967.875154205248,110.66493269729511,8
2760,31.22289272435561,0,2,176,0.0,0.011235955056179775,0.9887640449438202,178,6250,4600,1650,0.736,79,46,33,231.57545401826624,0.4759893618146808,0.7716184435079132,0.13310280849464148,1019441.9060511099,5365.544447806511,1024807.4504989164,2646,1,364.32022471910113,68,110,37,38.541851282960195,0.5432467228464419,44.45954106280193,7978.712336128731,117.33400494306957,8
2761,30.92776973795403,1,1,176,0.005649717514124294,0.005649717514124294,0.9943502824858758,177,6000,4400,1600,0.7333333333333333,76,44,32,261.7080374055663,0.4755606916623866,0.7863715018555877,0.14632213554048584,1001471.3596098121,11018.620808273838,1012489.9804180859,2647,0,367.3276836158192,68,109,36,38.856261493741485,0.5324270244821092,45.5163043478261,7870.613141194039,115.74431089991234,8
2762,30.696371133654985,1,3,174,0.005649717514124294,0.01694915254237288,0.9830508474576272,177,6150,4200,1950,0.6829268292682927,81,42,39,234.05413285281116,0.4752129344290361,0.7647148496634306,0.12821834372990693,987791.6909982923,4689.3455351631865,992481.0365334555,2648,0,368.2542372881356,69,108,40,40.371793367745944,0.5276600753295668,46.30952380952379,7787.377010216475,112.86053637994891,8
2763,30.37750391732022,3,1,176,0.01694915254237288,0.005649717514124294,0.9943502824858758,177,4700,2900,1800,0.6170212765957447,65,29,36,242.49879269020343,0.47570113208354736,0.7707334932339522,0.13442786926685912,981095.2427548968,7482.882376432587,988578.1251313293,2649,0,368.8135593220339,73,104,39,39.68424028431642,0.5308380414312618,45.84740990990989,7720.5213010587495,105.76056576792807,0
2764,30.824273355537628,3,2,177,0.01675977653631285,0.0111731843575419,0.9888268156424581,179,5050,3300,1750,0.6534653465346535,68,33,35,234.6979340183874,0.4762399828426757,0.7628634532934899,0.13126965612370847,998233.0881752694,6006.648692706309,1004239.7368679757,2650,0,365.6536312849162,65,114,37,39.52887596899225,0.5330540037243947,45.50189393939396,7844.719189678769,120.68798753351952,0
2765,30.93081737475507,3,3,177,0.016666666666666666,0.016666666666666666,0.9833333333333333,180,5600,4200,1400,0.75,70,42,28,229.48315016017122,0.4769074591351128,0.7587637473369029,0.12935520509028534,1004041.9214963119,4482.140607568984,1008524.0621038809,2651,0,364.40555555555557,70,110,33,39.35529068539951,0.5357638888888889,45.20246478873239,7881.096029157438,112.58708613082055,0
2766,30.965016087186306,1,3,175,0.0056179775280898875,0.016853932584269662,0.9831460674157303,178,5250,4000,1250,0.7619047619047619,65,40,25,216.2580594291125,0.47630543917560675,0.7604615262869971,0.1229646087189209,1007778.4833281038,2738.0438277897924,1010516.5271558936,2652,0,369.4943820224719,79,99,39,39.35239529107547,0.5445341760299626,44.86979166666665,7900.1110053688235,100.00140513125093,8
2767,31.47186351041621,1,1,175,0.005681818181818182,0.005681818181818182,0.9943181818181818,176,5900,4500,1400,0.7627118644067796,73,45,28,218.61800691649267,0.4755330086580087,0.76058022367401,0.12481598308653746,1025526.0521293808,3739.692311493028,1029265.7444408737,2653,0,374.2556818181818,66,110,37,39.1329171741778,0.5466382575757576,44.713930348258714,8034.328340190228,121.73224757863981,0
2768,31.12910424758678,2,0,177,0.011299435028248588,0.0,1.0,177,5550,3900,1650,0.7027027027027027,72,39,33,220.15663547390392,0.47588437339496664,0.7621484819323538,0.12660641905975384,1016538.6671453953,3809.5465575715543,1020348.2137029668,2654,0,372.9039548022599,70,107,42,38.813221195246605,0.5486699623352166,44.43955399061034,7955.36776538609,113.648110934087,0
2769,31.513003953206024,1,2,176,0.0056179775280898875,0.011235955056179775,0.9887640449438202,178,5500,4100,1400,0.7454545454545455,69,41,28,217.59604230082235,0.4758048731458558,0.7608203583037707,0.12574061375704076,1030547.8110379879,3748.625016728696,1034296.4360547166,2655,0,371.80337078651684,73,105,43,38.691884999266115,0.5502106741573034,44.25675675675678,8059.237835330105,110.40051829219321,0
2770,31.81787013137382,3,5,174,0.01675977653631285,0.027932960893854747,0.9720670391061452,179,5400,3900,1500,0.7222222222222222,69,39,30,218.45065478151628,0.4756907392295943,0.7621460870837942,0.12748790987434308,1043542.6039402863,4392.513024633115,1047935.1169649195,2656,0,370.55307262569835,76,103,38,38.290438587224514,0.5529562383612663,43.88528138528141,8149.02485561652,107.2240112581121,0
2771,32.05813663133421,5,3,176,0.027932960893854747,0.01675977653631285,0.9832402234636871,179,5700,3800,1900,0.6666666666666666,76,38,38,214.53255754804312,0.4746929466658297,0.7589573998209285,0.12612678811139996,1053683.53013122,3709.8845130600757,1057393.41464428,2657,0,370.9608938547486,66,113,44,38.10967598488065,0.5551094040968343,43.61007462686566,8219.383258509497,124.53610997741661,0
2772,32.19936248421012,2,1,177,0.011235955056179775,0.0056179775280898875,0.9943820224719101,178,5750,4100,1650,0.7130434782608696,74,41,33,213.29039063460795,0.4743726062760532,0.7581830512776786,0.1261485755047688,1060162.1129400737,3874.478240999768,1064036.5911810736,2658,0,368.80898876404495,68,110,43,37.9143869867043,0.5575842696629214,43.387681159420275,8262.753072261497,121.51107459208085,0
2773,32.16069450579756,0,2,175,0.0,0.011299435028248588,0.9887005649717514,177,5250,3400,1850,0.6476190476190476,71,34,37,223.0737192836316,0.4741268618387262,0.7635189669087974,0.12710014238253445,1047333.8149471034,6076.529886353051,1053410.3448334564,2659,1,369.23728813559325,76,101,40,39.09863945578233,0.5435499058380414,44.79166666666667,8207.677243667096,107.995753206146,8
2774,31.83814794575857,4,2,177,0.0223463687150838,0.0111731843575419,0.9888268156424581,179,6200,4500,1700,0.7258064516129032,79,45,34,217.3299717606323,0.4741358567154186,0.7624244039622685,0.12775087285786157,1046404.0134887748,3482.990940345417,1049887.00442912,2660,0,365.7709497206704,69,110,37,38.04408023294059,0.5542946927374302,43.616071428571416,8162.789448771916,118.30129635901328,8
2775,32.05619352414396,2,3,176,0.0111731843575419,0.01675977653631285,0.9832402234636871,179,4950,3500,1450,0.7070707070707071,64,35,29,213.5348506698714,0.4738128491620112,0.7567618952350106,0.12627416046025258,1055402.3524266612,4323.036744411413,1059725.3891710725,2661,0,366.6145251396648,72,107,38,37.91381675285916,0.5561568901303537,43.39326484018263,8225.835161881821,114.24771058169196,0
2776,31.793049591838074,2,0,178,0.011235955056179775,0.0,1.0,178,6350,4600,1750,0.7244094488188977,81,46,35,216.14969259134372,0.47380194777714296,0.7592562216936862,0.1287500342826693,1048928.4629107125,3395.1129616919607,1052323.5758724045,2662,0,369.5056179775281,74,104,35,37.572654771559854,0.5583450374531835,43.12499999999998,8166.839613903357,110.36269748518049,0
2777,31.974213886877155,2,1,179,0.011111111111111112,0.005555555555555556,0.9944444444444445,180,5900,4600,1300,0.7796610169491526,72,46,26,217.47323499339447,0.4737779329608938,0.7625792043211816,0.13044329179323336,1057012.5496718753,4074.387721151408,1061086.9373930267,2663,0,366.3888888888889,77,103,38,37.27666978290225,0.560300925925926,42.86858974358972,8221.574708572765,106.77369751393202,0
2778,32.27275394495713,1,4,176,0.005555555555555556,0.022222222222222223,0.9777777777777777,180,5350,3500,1850,0.6542056074766355,72,35,37,215.31121473276227,0.47350118973722327,0.7600350133307636,0.12997582753239517,1068829.9572806593,4676.215288973024,1073506.1725696323,2664,0,367.02777777777777,69,111,41,37.092548424400114,0.5622685185185186,42.63392857142857,8305.911896994543,120.37553473905135,0
2779,32.517931370504144,1,4,173,0.005649717514124294,0.022598870056497175,0.9774011299435028,177,5200,3800,1400,0.7307692307692307,66,38,28,228.67920678661898,0.47302340138674887,0.7707550392893749,0.1391567647119407,1079398.2176253565,8767.185642691464,1088165.403268048,2665,0,373.7005649717514,70,107,40,36.4494362828835,0.5640889830508475,42.341549295774655,8378.519817030441,119.69314024329202,0
2780,32.13446525711038,2,0,175,0.011428571428571429,0.0,1.0,175,6250,4200,2050,0.672,83,42,41,228.3298605151477,0.47269978106185,0.7687213119867731,0.13975191161967956,1068411.8627213868,7540.066317580871,1075951.9290389677,2666,0,376.45714285714286,73,102,38,36.243278836181034,0.5666666666666667,42.13119369369371,8286.476197142565,113.51337256359677,0
2781,31.952267806720997,1,2,174,0.005681818181818182,0.011363636363636364,0.9886363636363636,176,5650,4000,1650,0.7079646017699115,73,40,33,226.65715139608523,0.47249661796536796,0.7695510529826557,0.13968405841851794,1064399.1430122538,7400.735540718488,1071799.8785529723,2667,0,375.3125,76,100,38,36.03271313766598,0.5685961174242424,41.88311688311689,8247.419774786771,108.51868124719435,0
2782,31.456822258965737,1,0,175,0.005714285714285714,0.0,1.0,175,5600,3900,1700,0.6964285714285714,73,39,34,226.17371889721096,0.472204433497537,0.7693466893466887,0.14029134193260834,1049785.2616470454,6886.767334039006,1056672.0289810845,2668,0,376.25142857142856,63,112,40,35.80720143220145,0.5708333333333333,41.65039062500002,8126.857742782645,128.99774194893087,0
2783,31.663267281273345,1,0,176,0.005681818181818182,0.0,1.0,176,6600,4800,1800,0.7272727272727273,84,48,36,220.83065054047157,0.47211309523809525,0.7648800121106809,0.13169745014097514,1045009.769548641,4354.037446114777,1049363.8069947558,2669,0,375.10795454545456,69,107,39,37.4067839559803,0.5544507575757576,43.08035714285713,8134.915321594981,117.89732350137653,8
2784,32.089023255578915,1,3,174,0.005649717514124294,0.01694915254237288,0.9830508474576272,177,5350,3600,1750,0.6728971962616822,71,36,35,226.5033183826686,0.4722997988358158,0.7737804463297446,0.13070433593408315,1048950.5202389176,6768.154730668279,1055718.6749695858,2670,0,373.9830508474576,66,111,39,38.518231383517794,0.540430790960452,44.309701492537314,8204.851935031884,124.315938409574,8
2785,32.21072548711399,5,5,174,0.027932960893854747,0.027932960893854747,0.9720670391061452,179,5300,3700,1600,0.6981132075471698,69,37,32,218.56019172546928,0.47350291883748663,0.7686840987462895,0.12736330638345927,1055969.8655158486,5058.595252692196,1061028.4607685409,2671,0,369.76536312849163,70,109,42,38.34429133482304,0.5427723463687151,43.940727699530505,8247.854928500572,117.8264989785796,0
2786,32.62345886241164,1,2,173,0.005714285714285714,0.011428571428571429,0.9885714285714285,175,6050,4500,1550,0.743801652892562,76,45,31,220.6624592286002,0.47275725232621785,0.7658335157710383,0.12882860575610552,1070085.0257670893,6175.518673893159,1076260.5444409824,2672,0,378.66857142857145,68,107,45,38.218962434673266,0.5449404761904761,43.8707729468599,8355.8213022294,122.8797250327853,0
2787,32.114338309274736,2,1,174,0.011428571428571429,0.005714285714285714,0.9942857142857143,175,5050,3400,1650,0.6732673267326733,67,34,33,232.74755685537377,0.47312671045429666,0.7735373357724935,0.1341813096233329,1049486.255756889,8803.072396141997,1058289.328153031,2673,0,379.01714285714286,69,106,39,38.39493597206054,0.5425595238095238,44.345238095238095,8210.183514186605,118.98816687226963,8
2788,31.785167455257533,1,1,174,0.005714285714285714,0.005714285714285714,0.9942857142857143,175,5500,4300,1200,0.7818181818181819,67,43,24,238.90315251064797,0.47316912972085384,0.7761457334611701,0.1358647699392615,1034525.8589119848,8930.297809571755,1043456.1567215566,2674,0,378.98857142857145,72,103,39,38.76771066368383,0.5360714285714285,44.863013698630134,8109.57183361878,112.63294213359417,8
2789,31.823834134795597,3,2,175,0.01694915254237288,0.011299435028248588,0.9887005649717514,177,5000,3000,2000,0.6,70,30,40,235.60007061646044,0.4738406308851224,0.7768420969280887,0.13521807343570708,1038612.1746069584,8539.420336103143,1047151.5949430616,2675,0,375.6723163841808,63,114,42,38.49574494064683,0.5387829566854991,44.51497395833334,8130.513092673954,129.05576337577705,0
2790,32.14212041640099,2,3,174,0.011299435028248588,0.01694915254237288,0.9830508474576272,177,6050,4600,1450,0.7603305785123967,75,46,29,231.60443185485315,0.4742031009244992,0.7743590784532632,0.1341121363375883,1051761.2811237145,7268.5147923180575,1059029.7959160325,2676,0,375.08474576271186,67,110,42,38.25399201596805,0.541313559322034,44.17892156862745,8222.63190799474,122.72584937305584,0
2791,31.805697278953602,4,2,176,0.02247191011235955,0.011235955056179775,0.9887640449438202,178,5300,3900,1400,0.7358490566037735,67,39,28,231.838404822939,0.4739242789733173,0.7773966569789574,0.1358511696162849,1044380.4101002963,7525.497661195982,1051905.9077614923,2677,0,373.2191011235955,62,116,40,37.79222315418201,0.5447097378277154,43.733465608465615,8150.735815583705,131.46348089651136,0
2792,32.0354657088903,1,0,177,0.005649717514124294,0.0,1.0,177,5900,4400,1500,0.7457627118644068,74,44,30,239.1631511649126,0.47405597286423556,0.7823586931931992,0.1405233162736004,1052755.083360321,9056.044628266882,1061811.1279885878,2678,0,376.31073446327684,61,116,40,37.50102398584444,0.5461982109227872,43.63239247311828,8212.855699797667,134.63697868520765,0
2793,31.972758851850976,2,3,176,0.0111731843575419,0.01675977653631285,0.9832402234636871,179,5600,3900,1700,0.6964285714285714,73,39,34,227.73225829322348,0.4744863264494801,0.7610446662128001,0.13236002344690276,1047361.290872429,6303.59040385688,1053664.881276286,2679,0,373.0949720670391,71,108,41,38.210302208154346,0.5441108007448789,44.03935185185186,8183.768078804238,115.26433913808786,8
2794,32.2654873539886,1,1,176,0.005649717514124294,0.005649717514124294,0.9943502824858758,177,6100,4400,1700,0.7213114754098361,78,44,34,230.44891536685475,0.4744304806539976,0.7619738226502946,0.13461726260170617,1058515.7907876833,7286.7631771423,1065802.5539648256,2680,0,375.05649717514126,72,105,44,37.946934246931434,0.54655131826742,43.849885844748876,8264.808268999037,114.78900373609774,0
2795,32.419958559168286,1,1,176,0.005649717514124294,0.005649717514124294,0.9943502824858758,177,5600,4200,1400,0.75,70,42,28,227.99172632206637,0.474308765622325,0.760291046469149,0.13376055516532293,1064929.7979154338,7559.036607709637,1072488.8345231435,2681,0,375.40677966101697,66,111,45,37.84410509927613,0.548728813559322,43.68781094527362,8309.630547363908,125.90349314187739,0
2796,32.893603978440126,1,2,175,0.005649717514124294,0.011299435028248588,0.9887005649717514,177,4850,3500,1350,0.7216494845360825,62,35,27,226.0262326995046,0.4740653355589796,0.7718855017013739,0.13031352554756712,1074969.7880248763,8344.2742906094,1083314.0623154857,2682,0,376.3728813559322,71,106,38,38.564656310716224,0.543373352165725,44.34317129629628,8409.474477763504,118.44330250371132,8
2797,32.469933146111856,2,2,175,0.011299435028248588,0.011299435028248588,0.9887005649717514,177,6050,4200,1850,0.6942148760330579,79,42,37,243.12157294214043,0.47357178779318615,0.7907268214488445,0.13890877385682734,1058282.3709708878,10008.254929476148,1068290.625900364,2683,0,377.3050847457627,58,119,37,38.478493880091264,0.5371939736346516,44.685734463276845,8290.03713322607,142.9316747107943,8
2798,32.34027492018512,0,1,174,0.0,0.005714285714285714,0.9942857142857143,175,6200,4600,1600,0.7419354838709677,78,46,32,263.89540112538697,0.47303366174055833,0.8000246544524401,0.1462387485853831,1044376.7973251336,13921.246771232501,1058298.044096366,2684,1,382.54857142857145,75,100,33,39.15412756624598,0.529047619047619,45.86074561403508,8218.933354852954,109.58577806470605,8
2799,32.1937315258259,4,2,176,0.02247191011235955,0.011235955056179775,0.9887640449438202,178,5150,3500,1650,0.6796116504854369,68,35,33,251.49631825108492,0.47375235404896426,0.7939388867780015,0.14070199426479627,1042665.1789968285,11695.290737262185,1054360.4697340906,2685,0,376.7977528089888,60,118,36,39.09101583467529,0.5314840823970037,45.49180327868853,8193.568556367993,136.55947593946655,0
2800,32.57194647825894,3,1,178,0.01675977653631285,0.00558659217877095,0.994413407821229,179,5800,3700,2100,0.6379310344827587,79,37,42,245.29175478178982,0.47424832088381147,0.7886604359645859,0.13826781037699812,1057318.1257822048,10270.283687142191,1067588.409469347,2686,0,374.93854748603354,65,114,41,38.95203584407003,0.5337523277467411,45.202020202020215,8299.266160748328,127.68101785766657,0
2801,32.36616727294563,2,2,178,0.011111111111111112,0.011111111111111112,0.9888888888888889,180,5950,4600,1350,0.773109243697479,73,46,27,243.8145552210883,0.47449953445065174,0.7912881934828762,0.13821261521245706,1052421.5897501956,9369.14036200304,1061790.7301121987,2687,0,373.80555555555554,58,122,40,38.768260177236236,0.5309027777777777,44.9858757062147,8253.829803856423,142.30741041131762,8
2802,32.19144966573497,3,2,179,0.016574585635359115,0.011049723756906077,0.988950276243094,181,5600,4200,1400,0.75,70,42,28,228.25812307015158,0.4742313791692245,0.7814981552180729,0.12948934624402808,1046971.5271864228,5995.951140692829,1052967.4783271158,2688,0,372.707182320442,68,113,43,39.13618247109428,0.5308471454880295,44.95772946859905,8210.18041444639,120.73794727127043,8
2803,32.221835544386515,2,2,179,0.011049723756906077,0.011049723756906077,0.988950276243094,181,5150,3300,1850,0.6407766990291263,70,33,37,218.15669140694996,0.47434648045835887,0.7667450815663517,0.12284380214943984,1045624.0007979145,4271.97449395442,1049895.975291869,2689,0,371.44198895027625,73,108,42,39.684403433160234,0.5320557090239411,45.24211711711713,8208.766605888368,112.44885761490914,8
2804,32.56078294703917,7,4,182,0.03763440860215054,0.021505376344086023,0.978494623655914,186,5300,3700,1600,0.6981132075471698,69,37,32,211.97884104878844,0.4750242177661532,0.7681516028626851,0.1208286865914688,1060494.1097097888,2460.4624630697062,1062954.5721728585,2690,0,362.18279569892474,65,121,42,39.3656726032198,0.5356182795698925,44.775883838383855,8310.297049188328,127.85072383366658,0
2805,32.16096808983565,3,4,181,0.016216216216216217,0.021621621621621623,0.9783783783783784,185,5050,3200,1850,0.6336633663366337,69,32,37,219.69151925842237,0.4752044163728946,0.7789307599272839,0.12485009104798958,1046534.121658752,3932.934228597991,1050467.0558873499,2691,0,365.02162162162165,73,112,40,39.28565680810756,0.5351914414414414,44.8902027027027,8204.578050282817,112.3914801408605,8
2806,32.45985580951301,2,2,181,0.01092896174863388,0.01092896174863388,0.9890710382513661,183,5800,4300,1500,0.7413793103448276,73,43,30,209.3722737970499,0.4746354510698773,0.7573484994873234,0.11799274101417222,1053604.9598136756,1719.1332240077718,1055324.0930376833,2692,0,369.8469945355191,76,107,45,39.87646454992741,0.5327299635701275,45.21103896103896,8270.412937180301,108.82122285763553,8
2807,32.90902374792633,5,0,186,0.026881720430107527,0.0,1.0,186,5850,4400,1450,0.7521367521367521,73,44,29,206.303271931668,0.47518163324614937,0.7600400790225137,0.11782900377015802,1072475.7150620045,1201.0498169097918,1073676.7648789142,2693,0,364.8225806451613,67,119,44,39.43282731309249,0.5359543010752688,44.69975490196082,8401.681828782872,125.39823625049063,0
2808,32.876803416428935,2,1,187,0.010638297872340425,0.005319148936170213,0.9946808510638298,188,6400,4500,1900,0.703125,83,45,38,204.95052511192014,0.475713605074525,0.7606870725441945,0.11798178322425318,1073934.386392913,20.683285395542953,1073955.0696783087,2694,0,361.9308510638298,71,117,42,39.162527593819014,0.5382867907801419,44.40104166666671,8403.276706569102,118.35600995167749,0
2809,32.770969135729224,1,1,187,0.005319148936170213,0.005319148936170213,0.9946808510638298,188,6400,4600,1800,0.71875,82,46,36,210.01533024165258,0.47545286247961466,0.7599044811875162,0.11939101979712435,1066490.472892384,795.8697728136967,1067286.3426651978,2695,0,362.50531914893617,84,104,41,39.51948634194764,0.5382867907801419,44.87745098039213,8360.613179750075,99.53110928273898,8
2810,32.63452119174415,3,3,187,0.015789473684210527,0.015789473684210527,0.9842105263157894,190,6550,4200,2350,0.6412213740458015,89,42,47,200.2362648199911,0.4757878492527616,0.7505354965825368,0.1148285718716014,1064813.6863376955,-1907.136943706585,1062906.549393989,2696,0,359.6684210526316,71,119,45,39.430596458439524,0.5408991228070175,44.54571759259262,8336.628192746392,117.4172984893858,0
2811,32.18100430934754,2,5,184,0.010582010582010581,0.026455026455026454,0.9735449735449735,189,5600,4100,1500,0.7321428571428571,71,41,30,217.84066456398259,0.47545287815677884,0.7664264772503859,0.12258488305918627,1044090.9915641147,2089.095093518692,1046180.0866576334,2697,0,362.4867724867725,80,109,36,39.71837977921378,0.5341159611992945,45.26748971193415,8197.548011311143,102.46935014138928,8
2812,32.61189961818993,1,2,183,0.005405405405405406,0.010810810810810811,0.9891891891891892,185,6200,4400,1800,0.7096774193548387,80,44,36,221.29698978126243,0.47511506071288684,0.7640468555722799,0.12519952983515203,1059781.1130115478,3705.274027298079,1063486.3870388458,2698,0,370.54594594594596,80,105,31,39.42002118644065,0.5367117117117117,45.061728395061714,8314.021322415048,103.92526653018811,0
2813,32.85805989467121,2,1,184,0.010810810810810811,0.005405405405405406,0.9945945945945946,185,6400,4400,2000,0.6875,84,44,40,231.38609228732057,0.4751468860164512,0.7834040387886538,0.130426545046128,1066598.7003555987,5959.221062803508,1072557.921418402,2699,0,370.8378378378378,75,110,39,39.3071992110454,0.5356418918918919,45.20285087719299,8372.139986868691,111.62853315824921,7
2814,33.18733337384769,2,3,183,0.010752688172043012,0.016129032258064516,0.9838709677419355,186,5650,3800,1850,0.672566371681416,75,38,37,228.2942356299469,0.4755327908553715,0.7820361594159797,0.12934095940727994,1078938.6744610178,6413.095995533326,1085351.770456551,2700,0,369.8010752688172,81,105,39,39.186292947408624,0.5376344086021505,45.00762195121951,8462.517058095085,104.4755192357418,0
2815,33.60514028187137,4,2,185,0.0213903743315508,0.0106951871657754,0.9893048128342246,187,6250,4200,2050,0.672,83,42,41,222.76774171520856,0.47618619784179556,0.779173671529894,0.12748922149448155,1095818.753446818,5172.613806904613,1100991.3672537226,2701,0,365.54545454545456,67,120,43,38.93418961070123,0.540719696969697,44.62316176470589,8581.974473637849,128.0891712483261,0
2816,33.508514759155524,2,3,184,0.0106951871657754,0.016042780748663103,0.983957219251337,187,5550,3500,2050,0.6306306306306306,76,35,41,216.92457089331822,0.47628562666513335,0.7758399228168191,0.12576235681479725,1096859.7917809288,4637.167932442539,1101496.9597133715,2702,0,363.0053475935829,75,112,40,38.58340475680311,0.5461229946524064,44.13377192982457,8573.697279658943,114.31596372878592,8
2817,33.124272102398436,1,3,182,0.005405405405405406,0.016216216216216217,0.9837837837837837,185,5900,4200,1700,0.711864406779661,76,42,34,198.2411832626662,0.4756352820211516,0.746703295223474,0.11220249712582378,1076566.649840296,-216.03069490695725,1076350.619145389,2703,0,367.34054054054053,81,104,41,39.99148812489618,0.5365427927927928,45.045731707317074,8445.17455659473,104.26141427894727,8
2818,32.86080737368902,1,2,181,0.00546448087431694,0.01092896174863388,0.9890710382513661,183,5250,3900,1350,0.7428571428571429,66,39,27,207.87873035996137,0.47544736684080946,0.7492544660315856,0.11692774715149201,1066005.642111422,2469.979887735514,1068475.6219991576,2704,0,372.07650273224044,73,110,46,39.98935018881829,0.5348360655737705,45.284346846846844,8370.162013329144,114.65975360724855,8
2819,33.130839303440766,5,2,184,0.026881720430107527,0.010752688172043012,0.989247311827957,186,5650,4000,1650,0.7079646017699115,73,40,33,235.15514184735937,0.4761939358713552,0.7843383660199159,0.13303615466260088,1076636.0443398973,7785.300344945895,1084421.3446848432,2705,0,366.02150537634407,72,114,38,39.06780570170529,0.5365143369175627,45.062785388127864,8446.283889772752,117.309498469066,7
2820,32.935055450993545,2,1,185,0.010752688172043012,0.005376344086021506,0.9946236559139785,186,5850,4700,1150,0.8034188034188035,70,47,23,242.52639332599557,0.47640160321611935,0.7899096049919221,0.13848400565655938,1073246.375113778,9008.114501308559,1082254.4896150867,2706,0,366.9516129032258,62,124,44,38.51751403281519,0.5392585125448028,44.7089947089947,8408.023415399131,135.61328089353438,0
2821,32.450450388137654,2,2,185,0.0106951871657754,0.0106951871657754,0.9893048128342246,187,7200,5300,1900,0.7361111111111112,91,53,38,241.96485967678657,0.47615145765050887,0.7888287835424457,0.13957482505061533,1060649.2169417792,6727.9677887223415,1067377.1847305016,2707,0,363.98930481283423,68,119,42,38.13720280270824,0.5419451871657754,44.32367149758455,8296.812013488836,122.01194137483583,0
2822,32.448166658672505,1,3,183,0.005376344086021506,0.016129032258064516,0.9838709677419355,186,6050,4000,2050,0.6611570247933884,81,40,41,230.2485939056034,0.476169718105202,0.7831400939784559,0.12961610256724893,1052878.8603167334,5234.775428172635,1058113.635744906,2708,0,366.78494623655916,69,117,38,39.387461787098154,0.5314740143369175,45.252976190476204,8266.073884372276,119.79817223727936,8
2823,32.85944098444702,2,1,184,0.010810810810810811,0.005405405405405406,0.9945945945945946,185,6300,4400,1900,0.6984126984126984,82,44,38,241.95397887807925,0.47582990599294944,0.790842614235636,0.13775706395807122,1069856.0140494534,8471.183885181596,1078327.197934635,2709,0,369.7243243243243,74,111,36,38.645249369545894,0.5338400900900901,44.81944444444445,8385.090405656196,113.31203250886752,8
2824,32.72678623421647,5,5,184,0.026455026455026454,0.026455026455026454,0.9735449735449735,189,6200,4500,1700,0.7258064516129032,79,45,34,237.77408268827895,0.47667712672145296,0.790233167370777,0.13710956866068755,1069571.0021318744,6863.252780378301,1076434.2549122528,2710,0,362.85185185185185,70,119,41,38.25784746929878,0.5372023809523809,44.336854460093925,8367.033112051942,119.5290444578849,0
2825,33.15947437374316,4,5,183,0.02127659574468085,0.026595744680851064,0.973404255319149,188,6650,5200,1450,0.7819548872180451,81,52,29,238.179564669405,0.47648279572951036,0.7895737263095421,0.13895153586306752,1087428.8143357893,7550.664321493501,1094979.478657283,2711,0,365.06382978723406,76,112,33,37.799002517915994,0.5423869680851063,43.898809523809554,8492.180862680425,111.739221877374,0
2826,33.23086090064828,3,0,186,0.016129032258064516,0.0,1.0,186,6050,4200,1850,0.6942148760330579,79,42,37,243.09434631266558,0.47562602925506153,0.794116923959475,0.14244586835477932,1091175.2650932122,9801.707556076792,1100976.972649289,2712,0,369.9569892473118,63,123,37,37.504035672700354,0.5435707885304659,43.733723958333336,8515.948972667762,135.1737932169486,0
2827,33.076475191805,2,1,187,0.010638297872340425,0.005319148936170213,0.9946808510638298,188,6050,4800,1250,0.7933884297520661,73,48,25,244.88083589534642,0.4761331636136079,0.7995857093711909,0.13824507861523208,1074184.7157636613,8959.450220442279,1083144.1659841037,2713,0,367.01063829787233,67,121,37,38.90305994670514,0.530751329787234,45.14399509803923,8429.738323622265,125.81698990480993,8
2828,33.27159635496666,3,1,189,0.015789473684210527,0.005263157894736842,0.9947368421052631,190,5500,3700,1800,0.6727272727272727,73,37,36,237.00833335800488,0.4765461106469879,0.7947540335404886,0.13474484913194704,1082803.5685590196,7826.6938276549035,1090630.2623866745,2714,0,359.9421052631579,74,116,41,38.82832489520387,0.5333881578947368,44.875000000000014,8488.416020060908,114.70832459541766,0
2829,33.48407598080472,3,2,190,0.015625,0.010416666666666666,0.9895833333333334,192,6750,5000,1750,0.7407407407407407,85,50,35,245.6084645047477,0.4768715459569517,0.80403898844406,0.1423510481975863,1095967.302624872,8685.76926902137,1104653.0718938934,2715,0,357.078125,65,127,39,37.86054479468676,0.5347222222222222,44.144570707070734,8567.082634545912,131.80127130070633,8
2830,33.65863235308927,0,3,187,0.0,0.015789473684210527,0.9842105263157894,190,7100,5400,1700,0.7605633802816901,88,54,34,245.87114785920647,0.47623572820941246,0.8008506965848845,0.14316302083891133,1103176.3089713992,9147.84507557649,1112324.1540469758,2716,1,361.7736842105263,65,125,34,37.67594419101633,0.5367324561403508,43.97095959595962,8617.587342673884,132.57826681036744,0
2831,33.759740849878796,1,2,186,0.005319148936170213,0.010638297872340425,0.9893617021276596,188,6200,4400,1800,0.7096774193548387,80,44,36,248.40301880511964,0.4755328630485076,0.8023145433552286,0.14501032359303898,1107325.140940002,11212.581561660478,1118537.7225016623,2717,0,366.59574468085106,66,122,36,37.512140342357654,0.5382313829787234,43.874378109452756,8646.734620038962,131.01113060665094,0
2832,33.436615978827334,0,0,186,0.0,0.0,1.0,186,5100,3300,1800,0.6470588235294118,69,33,36,248.85980567122587,0.4750756805192289,0.8015560800769281,0.14576074332171904,1097792.0207111167,12339.2617883186,1110131.2824994354,2718,1,371.23118279569894,67,119,37,37.3729674796748,0.5399305555555556,43.75000000000003,8568.13284457457,127.88257976976969,0
2833,33.324240523285404,2,2,186,0.010638297872340425,0.010638297872340425,0.9893617021276596,188,5500,3600,1900,0.6545454545454545,74,36,38,244.75576681154567,0.4755269370804414,0.8008906497883594,0.14457081209039757,1096786.8126390683,10588.979471253064,1107375.7921103213,2719,0,368.27127659574467,62,126,38,37.156290949711064,0.5425531914893618,43.43584656084655,8549.805558859425,137.900089659023,0
2834,33.00849475570067,6,0,192,0.03125,0.0,1.0,192,6600,4800,1800,0.7272727272727273,84,48,36,207.68885509824764,0.47662555900959863,0.7687254329365532,0.12258142603270758,1086151.2101295409,116.30025907579966,1086267.5103886167,2720,0,360.1197916666667,72,120,45,38.13665776690027,0.5474717881944444,43.464611872146094,8467.847013669842,117.60898630097002,8
2835,33.17853822433131,4,6,190,0.02040816326530612,0.030612244897959183,0.9693877551020408,196,5950,4100,1850,0.6890756302521008,78,41,37,225.82521791255996,0.4768952773417059,0.7931066470475345,0.13003293233593258,1083875.620302156,3803.2896289690925,1087678.9099311251,2721,0,353.75,64,132,39,38.61873040752353,0.5374681122448979,44.39102564102564,8480.732126251352,132.51143947267738,8
2836,33.06704958824541,4,1,193,0.020618556701030927,0.005154639175257732,0.9948453608247423,194,7300,5400,1900,0.7397260273972602,92,54,38,229.7469636646344,0.4765242463899721,0.7941615901053927,0.13397883760436075,1084271.8284051295,3721.632072635863,1087993.4604777654,2722,0,357.4896907216495,69,125,38,38.03018527127276,0.5412908075601375,43.91369047619047,8468.018695894556,122.72490863615299,0
2837,33.257530724234485,3,1,195,0.015306122448979591,0.00510204081632653,0.9948979591836735,196,6500,4800,1700,0.7384615384615385,82,48,34,224.74719408384175,0.47733843537414966,0.7914758065236223,0.13214738545194366,1093141.803511052,3436.110614971938,1096577.9141260239,2723,0,354.8265306122449,64,132,41,37.84338083630227,0.5435799319727892,43.60576923076923,8527.039007324163,133.23498448944005,0
2838,33.63957418290291,1,0,196,0.00510204081632653,0.0,1.0,196,5950,4200,1750,0.7058823529411765,77,42,35,230.12146290079494,0.4768625719518577,0.7950289638216104,0.1321931577341687,1098165.6104430424,5392.295356499553,1103557.9057995419,2724,0,354.5816326530612,66,130,42,38.60067437379579,0.5377869897959184,44.48072139303483,8595.559727860844,130.23575345243702,8
2839,33.62429500810248,2,0,198,0.010101010101010102,0.0,1.0,198,7650,5900,1750,0.7712418300653595,94,59,35,225.16077123465487,0.4772171802628655,0.7922589678216161,0.13035510339749576,1100197.2101292252,2294.250468582499,1102491.4605978078,2725,0,351.989898989899,73,125,42,38.426454538784654,0.540719696969697,44.18637387387388,8601.552831957317,117.82949084873037,0
2840,33.1802214698728,3,6,195,0.014925373134328358,0.029850746268656716,0.9701492537313433,201,6250,4700,1550,0.752,78,47,31,225.35322451895672,0.47734038142620233,0.7973714913183729,0.13171367165927478,1088701.5112786582,2618.4792210614314,1091319.9904997195,2726,0,347.7213930348259,78,123,41,38.05622040354131,0.5435323383084577,43.82911392405064,8499.806734133565,108.97188120684056,0
2841,33.61371981370191,1,2,194,0.00510204081632653,0.01020408163265306,0.9897959183673469,196,6500,5000,1500,0.7692307692307693,80,50,30,231.34291621214038,0.4764286804465376,0.7995737654044386,0.13580603588490256,1104330.3995848012,5395.803020333142,1109726.2026051343,2727,0,357.08673469387753,61,135,42,37.73588899084574,0.5446960034013606,43.665994623655905,8616.33943544437,141.25146615482575,0
2842,33.298400376476714,1,2,193,0.005128205128205128,0.010256410256410256,0.9897435897435898,195,6200,4400,1800,0.7096774193548387,80,44,36,216.1455396588245,0.47561569301260026,0.7819335479636176,0.12695326326977693,1094143.1268800914,2098.8313246981124,1096241.9582047896,2728,0,359.7128205128205,69,126,42,38.10485236353786,0.5470085470085471,43.64583333333332,8536.183679844678,123.7128069542707,8
2843,32.95271974884312,0,3,190,0.0,0.015544041450777202,0.9844559585492227,193,6000,4300,1700,0.7166666666666667,77,43,34,214.55427185469728,0.4753559927317214,0.7787435603710589,0.12125041644998676,1070500.172995877,1336.0770274914448,1071836.2500233685,2729,1,363.8756476683938,79,114,35,39.635267674703734,0.5346502590673575,45.10416666666666,8399.510960981135,106.32292355672323,8
2844,32.70824799607486,2,0,192,0.010416666666666666,0.0,1.0,192,5300,3400,1900,0.6415094339622641,72,34,38,218.65397019009473,0.47588589386998253,0.7828127193510208,0.12265432462131533,1060184.117399098,2662.6932803589616,1062846.810679457,2730,0,363.7083333333333,67,125,44,39.821924573330925,0.5313042534722222,45.38909313725491,8327.876684172206,124.29666692794338,8
2845,32.419040368349044,3,1,194,0.015384615384615385,0.005128205128205128,0.9948717948717949,195,6450,4800,1650,0.7441860465116279,81,48,33,212.33568973741228,0.4759229888095868,0.7801525590841711,0.11991858264363967,1052957.0031723124,-733.9296935132916,1052223.073478799,2731,0,359.0974358974359,70,125,42,39.717289316140885,0.5333867521367521,45.129107981220685,8262.669737074006,118.03813910105723,0
2846,32.78649780763382,1,3,192,0.005128205128205128,0.015384615384615385,0.9846153846153847,195,5600,3800,1800,0.6785714285714286,74,38,36,216.53539141851869,0.4758491937615649,0.7839560685482123,0.12286836781633695,1066400.5338950073,1582.6914031746837,1067983.225298182,2732,0,359.84615384615387,72,123,43,39.4258653164746,0.535042735042735,44.94863013698631,8362.241178847726,116.1422385951073,0
2847,32.95990530964184,4,2,194,0.02040816326530612,0.01020408163265306,0.9897959183673469,196,6750,5000,1750,0.7407407407407407,85,50,35,186.79199216807817,0.47659220739577884,0.7506577216521981,0.10456500180130492,1067672.803781527,-6063.453999594427,1061609.3497819328,2733,0,357.8979591836735,79,117,43,40.71431007434691,0.5310905612244898,45.46874999999998,8389.325898344718,106.19399871322427,8
2848,32.50050856474088,8,7,195,0.039603960396039604,0.034653465346534656,0.9653465346534653,202,6950,5000,1950,0.7194244604316546,89,50,39,178.17554650433908,0.4774913592105479,0.7454468622630992,0.10105271104449495,1056944.4005145342,-9685.670762724854,1047258.7297518094,2734,0,347.84653465346537,88,114,42,40.42316811993268,0.5347050330033003,44.967228464419435,8288.694775581624,94.18971335888209,0
2849,32.79786953104929,1,0,196,0.00510204081632653,0.0,1.0,196,7700,5800,1900,0.7532467532467533,96,58,38,182.9619286194898,0.47727193441479154,0.7455137429071363,0.10405392856708133,1067496.1113405665,-7837.770535065247,1059658.3408055012,2735,0,356.39285714285717,88,108,45,40.19383534412889,0.5368835034013606,44.86189138576776,8367.986398728199,95.09075453100226,0
2850,33.08813462929529,0,0,196,0.0,0.0,1.0,196,6550,4400,2150,0.6717557251908397,87,44,43,191.45982285035765,0.4772523111808826,0.7535977298487453,0.10793426438258787,1074106.5663857711,-4620.349415474764,1069486.2169702963,2736,1,357.39285714285717,81,115,44,40.319739422341875,0.5316751700680272,45.19817073170732,8430.917230619993,104.0853979088888,8
2851,32.70519183524844,4,3,197,0.02,0.015,0.985,200,6100,3900,2200,0.639344262295082,83,39,44,206.05127430612046,0.47766593383584594,0.7794274809160286,0.1159196432752842,1061012.1935628997,-2375.4170924061928,1058636.7764704935,2737,0,351.225,74,126,41,40.02919392948018,0.5283854166666666,45.27777777777779,8330.739142478602,112.57755597944056,8
2852,32.53313447824623,3,4,196,0.015,0.02,0.98,200,6300,4700,1600,0.746031746031746,79,47,32,223.30544837662472,0.47828569932998327,0.7977242461105063,0.12398890146443334,1051235.330529514,649.3153666485641,1051884.6458961626,2738,0,351.98,63,137,39,40.10773470345945,0.5213020833333333,45.78450520833334,8270.426878511216,131.27661711922565,8
2853,32.21616403802375,3,3,196,0.01507537688442211,0.01507537688442211,0.9849246231155779,199,5600,3900,1700,0.6964285714285714,73,39,34,217.76905268493218,0.47876376833663264,0.7908062453473128,0.1223292091156222,1044676.5861698978,99.64610646970777,1044776.2322763675,2739,0,352.63819095477385,68,131,42,39.78933250340864,0.5246021775544389,45.33514492753625,8204.324745734073,120.65183449608931,0
2854,32.64613339254594,5,5,196,0.024875621890547265,0.024875621890547265,0.9751243781094527,201,5900,4100,1800,0.6949152542372882,77,41,36,212.84430908757946,0.4793480514096186,0.7880869428867128,0.12069171667416881,1061618.3539253145,-908.1149888144155,1060710.2389365002,2740,0,349.97512437810946,73,128,41,39.54659297897001,0.5275704809286899,44.974662162162176,8325.591197533184,114.04919448675594,0
2855,32.48870423440641,3,1,198,0.01507537688442211,0.005025125628140704,0.9949748743718593,199,4850,3300,1550,0.6804123711340206,64,33,31,230.44260889142976,0.4793823917567636,0.7975959833591364,0.1299875298698261,1054836.0543696596,3965.8344643373393,1058801.888833997,2741,0,354.3969849246231,75,124,35,39.303194922547355,0.5243404522613065,45.17543859649123,8278.919807100943,110.38559742801257,8
2856,32.65923082446294,2,3,197,0.01,0.015,0.985,200,6050,4400,1650,0.7272727272727273,77,44,33,228.8978920533977,0.47938599246231156,0.799055497382199,0.12996283407312414,1062456.1617919446,2588.7951666639065,1065044.9569586085,2742,0,353.35,77,123,37,39.08660558464222,0.5265104166666666,44.925213675213676,8330.54632408176,108.18891329976313,0
2857,32.735306710571365,1,1,197,0.005050505050505051,0.005050505050505051,0.9949494949494949,198,5750,4000,1750,0.6956521739130435,75,40,35,216.59977449059164,0.4791340862089593,0.7866554142460893,0.11943930421909678,1055537.949845969,375.8563805793169,1055913.8062265483,2743,0,357.67676767676767,75,123,40,40.55213730569946,0.5189920033670034,46.05263157894734,8313.044993605557,110.84059991474076,8
2858,32.82085823198584,6,2,201,0.029556650246305417,0.009852216748768473,0.9901477832512315,203,6650,5300,1350,0.7969924812030075,80,53,27,206.6208588221067,0.4801837942414931,0.78221527343516,0.11586316803511847,1063719.8398827612,-3292.6586274621327,1060427.1812552991,2744,0,349.807881773399,74,129,43,40.14226810684995,0.5231937602627258,45.402777777777764,8356.099336812918,112.92026130828268,0
2859,33.16514347476179,3,1,203,0.014705882352941176,0.004901960784313725,0.9950980392156863,204,6400,4200,2200,0.65625,86,42,44,204.13742596593738,0.48050736099037317,0.7806648403216412,0.11511397014274054,1076698.8303940454,-3241.0944445652012,1073457.7359494802,2745,0,348.96078431372547,78,126,44,39.98555411815437,0.5255821078431373,45.18723628691981,8450.901867744828,108.34489574031831,0
2860,32.736151201277195,1,4,200,0.004901960784313725,0.0196078431372549,0.9803921568627451,204,7600,5300,2300,0.6973684210526315,99,53,46,201.34706202405096,0.4803036156991532,0.7783314454928059,0.11445051623017481,1065321.9866490865,-5500.1095757165895,1059821.87707337,2746,0,349.9264705882353,80,124,39,39.744954968578824,0.5282883986928104,44.881687242798336,8351.591660634434,104.39489575793043,0
2861,32.46452417915408,4,0,204,0.0196078431372549,0.0,1.0,204,6350,5000,1350,0.7874015748031497,77,50,27,201.36551366145824,0.47993737724975044,0.7797389187137727,0.11544204670265606,1059174.0058499407,-4493.776451032218,1054680.2293989086,2747,0,350.87745098039215,70,134,43,39.41318227940191,0.5304330065359477,44.556924882629126,8292.837888545399,118.46911269350569,0
2862,32.33520354258927,2,2,204,0.009708737864077669,0.009708737864077669,0.9902912621359223,206,5950,4600,1350,0.773109243697479,73,46,27,194.1793688399526,0.4802579130160234,0.7726218539885814,0.10958510935311651,1050004.7702562944,-6372.147286538588,1043632.6229697558,2748,0,348.4611650485437,76,130,37,40.20839968857276,0.5266990291262136,45.15692640692641,8240.402656051097,108.42635073751444,8
2863,32.375669198611554,0,1,203,0.0,0.004901960784313725,0.9950980392156863,204,7500,5000,2500,0.6666666666666666,100,50,50,198.31516439291028,0.48013508564345275,0.7743865397617924,0.11239449334956,1052658.6195127282,-6548.366564343761,1046110.2529483844,2749,1,352.77941176470586,76,128,39,39.937444739168846,0.5285437091503268,44.99458874458875,8255.9708386611,108.6311952455408,0
2864,32.71769831821585,3,3,203,0.014563106796116505,0.014563106796116505,0.9854368932038835,206,7150,5100,2050,0.7132867132867133,92,51,41,216.62828094714052,0.4806994435235614,0.7973067864469054,0.12164067386872031,1060814.1035015064,-2389.5328707974786,1058424.570630709,2750,0,350.33009708737865,68,138,39,39.833807604141924,0.5210861650485437,45.35024154589371,8331.553973907965,122.52285255747007,8
2865,33.068333222192656,3,1,205,0.014563106796116505,0.0048543689320388345,0.9951456310679612,206,7450,5500,1950,0.738255033557047,94,55,39,193.96968602724158,0.48108670771173734,0.7701883165204833,0.10671981944115276,1065538.581612035,-7313.563174960338,1058225.0184370745,2751,0,350.0485436893204,77,129,38,41.21638653620214,0.5201254045307444,46.14049145299145,8394.71082025453,109.02221844486402,8
2866,32.581994525284564,6,3,208,0.02843601895734597,0.014218009478672985,0.985781990521327,211,6800,5000,1800,0.7352941176470589,86,50,36,196.84528130059468,0.48167644624990597,0.7791022670516274,0.11035783501557873,1055909.7940391202,-7429.827912863122,1048479.9661262571,2752,0,342.3222748815166,73,138,42,40.3995724132847,0.5245359399684044,45.41103603603605,8295.01623007178,113.63035931605178,0
2867,32.31908468235215,4,0,212,0.018867924528301886,0.0,1.0,212,6700,4200,2500,0.6268656716417911,92,42,50,178.20911713617394,0.48245057602313035,0.7581567274519476,0.10005154916139843,1047838.8587512238,-11753.112416194079,1036085.7463350297,2753,0,340.99056603773585,82,130,44,40.81844504682107,0.5283510220125787,45.356425702811215,8229.8472415276,100.36399075033657,8
2868,32.6849313849429,6,4,214,0.027522935779816515,0.01834862385321101,0.981651376146789,218,7050,4800,2250,0.6808510638297872,93,48,45,185.06686122653696,0.4828972540481123,0.7732937525313335,0.10559499862363336,1064857.35387174,-11236.038372991925,1053621.315498748,2754,0,332.57798165137615,76,142,46,40.013492147614286,0.5324445718654434,44.73755411255414,8343.235528983945,109.77941485505191,0
2869,33.1214471755832,1,3,212,0.004651162790697674,0.013953488372093023,0.986046511627907,215,7050,5100,1950,0.723404255319149,90,51,39,194.82614660662566,0.4824386003042817,0.781002365084984,0.11108766321608027,1078859.3350096585,-8011.998605896049,1070847.3364037625,2755,0,332.0232558139535,73,142,39,39.79083939995588,0.5321705426356589,44.76351351351353,8453.801804443652,115.80550417046099,8
2870,32.58886933836752,3,1,214,0.013953488372093023,0.004651162790697674,0.9953488372093023,215,6550,4300,2250,0.6564885496183206,88,43,45,210.82236405618167,0.48308067086865175,0.7967402875864014,0.11684014326482806,1052437.913587512,-5174.510207024741,1047263.4033804872,2756,0,332.6372093023256,88,127,37,40.498833317982296,0.5221899224806201,45.85674157303373,8282.24144210344,94.11638002390272,8
2871,32.42793525476062,1,3,212,0.004651162790697674,0.013953488372093023,0.986046511627907,215,7100,4800,2300,0.676056338028169,94,48,46,208.53092430411317,0.4830046004491777,0.7954868562319244,0.11628028738096371,1049198.459410094,-6341.935096152461,1042856.5243139415,2757,0,333.6139534883721,72,143,39,40.31466782595686,0.5244186046511627,45.619292237442906,8249.041121384347,114.5700155747826,0
2872,32.60081902573769,3,3,212,0.013953488372093023,0.013953488372093023,0.986046511627907,215,6950,4900,2050,0.7050359712230215,90,49,41,202.07864708144618,0.48300278924871404,0.7887493000010566,0.11375322307576982,1057818.3961407803,-7197.497930001571,1050620.8982107788,2758,0,333.7720930232558,80,135,40,40.106769650159,0.5276162790697674,45.254629629629605,8304.907717088907,103.81134646361133,0
2873,32.635569901238014,5,2,215,0.02304147465437788,0.009216589861751152,0.9907834101382489,217,6800,4500,2300,0.6617647058823529,91,45,46,212.56669088041562,0.4829473530750412,0.8017723101775807,0.11890851859552962,1056937.546773316,-5266.056643026333,1051671.4901302897,2759,0,330.55299539170505,67,150,43,40.08642309698646,0.5185291858678955,45.49632352941177,8305.872523577955,123.96824662056649,8
2874,32.56459500717667,2,3,214,0.009216589861751152,0.013824884792626729,0.9861751152073732,217,7500,5600,1900,0.7466666666666667,94,56,38,209.92554317258046,0.48282023382829836,0.7979056949844288,0.11835568577271502,1057142.3496132782,-6515.763609339188,1050626.586003939,2760,0,331.47926267281105,74,143,46,39.84542497910532,0.5212653609831029,45.19444444444443,8297.639722245287,112.1302665168282,0
2875,32.19060751213555,3,2,215,0.013824884792626729,0.009216589861751152,0.9907834101382489,217,6750,4900,1850,0.725925925925926,86,49,37,227.8080619136146,0.48282112277407974,0.8097389723943349,0.12738388867623285,1042401.4718060021,-2656.5081943951186,1039744.963611607,2761,0,332.35023041474653,67,150,44,39.71419219888039,0.5195852534562212,45.51164215686274,8192.134843736329,122.27066930949744,8
2876,31.804563764110238,3,0,218,0.013761467889908258,0.0,1.0,218,8100,6000,2100,0.7407407407407407,102,60,42,234.6733439650242,0.4834283706083795,0.8159266142192036,0.13054286016337024,1028274.972218797,-3438.254750774833,1024836.7174680221,2762,0,331.197247706422,68,150,37,39.745112008232425,0.5167717889908257,45.71256038647341,8087.501087600701,118.93383952353972,8
2877,31.43600960665644,6,6,218,0.026785714285714284,0.026785714285714284,0.9732142857142857,224,7000,4900,2100,0.7,91,49,42,229.5874372058081,0.4844905275731369,0.818311994609165,0.129448235871359,1020522.2700755507,-4940.181480380383,1015582.0885951703,2763,0,323.29910714285717,77,147,31,39.3422431865828,0.5203218005952381,45.192307692307665,8010.137063234511,104.02775406798065,0
2878,31.785793047835526,8,7,219,0.035398230088495575,0.030973451327433628,0.9690265486725663,226,7050,5100,1950,0.723404255319149,90,51,39,219.82992669957287,0.4845927564732875,0.8146346355690308,0.12535736636391387,1035384.9228223293,-6728.281662024629,1028656.6411603047,2764,0,316.32300884955754,64,162,39,39.148667880538305,0.5243362831858407,44.75961538461541,8113.018042834603,126.76590691929067,0
2879,32.211258720196085,2,2,219,0.00904977375565611,0.00904977375565611,0.9909502262443439,221,7450,5900,1550,0.7919463087248322,90,59,31,224.54057248571246,0.48381753050870696,0.8154454837906422,0.12905702552773082,1051706.865126444,-4419.8276834707485,1047287.0374429732,2765,0,323.81900452488685,65,156,40,38.722322586622184,0.5259238310708899,44.46022727272728,8231.257732618305,126.63473434797393,0
2880,32.48441060806773,2,4,217,0.00904977375565611,0.01809954751131222,0.9819004524886877,221,7300,5400,1900,0.7397260273972602,92,54,38,224.80090589096798,0.48371126422597016,0.8144869014862364,0.13048925795195263,1063722.1282238867,-3674.860391800046,1060047.2678320867,2766,0,324.7556561085973,70,151,36,38.33450381241763,0.5285162141779789,44.08744131455401,8313.16863609931,118.75955194427586,0
2881,32.514429834618035,4,2,219,0.01809954751131222,0.00904977375565611,0.9909502262443439,221,7050,5100,1950,0.723404255319149,90,51,39,218.8079787235417,0.483842383107089,0.809832953769859,0.12860683883780694,1068599.9247745974,-4486.362079188326,1064113.5626954092,2767,0,324.0542986425339,63,158,39,38.00998814965297,0.5316270739064857,43.619791666666664,8336.056294838912,132.31835388633195,0
2882,32.02419079578692,1,2,218,0.004545454545454545,0.00909090909090909,0.990909090909091,220,7550,5400,2150,0.7152317880794702,97,54,43,219.7748111472555,0.4834941884599419,0.8108611860580366,0.1302398468069342,1054994.6176222377,-5177.7514301403,1049816.8661920973,2768,0,325.42727272727274,66,154,40,37.67337976983645,0.5340909090909092,43.31467661691542,8220.139770498163,124.54757228027519,0
2883,32.09565754774584,2,4,216,0.00909090909090909,0.01818181818181818,0.9818181818181818,220,6800,4600,2200,0.6764705882352942,90,46,44,220.06456992901997,0.48345829874083296,0.8119257203564378,0.13125615102594257,1059316.4046836824,-4176.39819690615,1055140.0064867763,2769,0,326.3818181818182,67,153,38,37.42199300421333,0.5359375,43.07598039215684,8246.145349123632,123.0767962555766,0
2884,31.862726917416413,0,4,212,0.0,0.018518518518518517,0.9814814814814815,216,7700,5900,1800,0.7662337662337663,95,59,36,210.10436338063562,0.4830399440137812,0.7958527299628302,0.12416724277331605,1048841.4239385228,-6826.768067231453,1042014.6558712914,2770,1,333.2453703703704,74,142,38,38.025738876258494,0.5415702160493827,43.416666666666664,8175.444681560425,110.47898218324899,8
2885,31.9130043347821,3,4,211,0.013953488372093023,0.018604651162790697,0.9813953488372094,215,7050,4800,2250,0.6808510638297872,93,48,45,221.67179507323766,0.48306799246540605,0.8069313919967176,0.12878803699969354,1045285.6819787284,-3707.929302284081,1041577.7526764444,2771,0,326.7581395348837,71,144,39,38.380214515855535,0.5359011627906977,44.053819444444464,8168.011569540411,115.04241647240016,8
2886,31.683089586944615,1,2,210,0.0047169811320754715,0.009433962264150943,0.9905660377358491,212,7850,5800,2050,0.7388535031847133,99,58,41,216.3200169920977,0.4825763249277177,0.7964146712919882,0.1212044316312504,1026594.7606317919,-5835.400787226659,1020759.3598445653,2772,0,332.0566037735849,72,140,37,39.9270132660688,0.5224547955974843,45.43378995433789,8065.444038685648,112.02005609285622,8
2887,31.73689480808296,3,2,211,0.014084507042253521,0.009389671361502348,0.9906103286384976,213,7000,5100,1900,0.7285714285714285,89,51,38,232.2306627758355,0.48278283432249686,0.8089905667310671,0.13138357370190976,1031342.236777058,-1698.1417609103582,1029644.0950161476,2773,0,331.4131455399061,76,137,35,39.141792694790844,0.5246478873239437,45.06222943722943,8090.933206957827,106.4596474599714,8
2888,31.586565018674914,5,2,214,0.023148148148148147,0.009259259259259259,0.9907407407407407,216,7000,4900,2100,0.7,91,49,42,226.36515774507328,0.48317587209302326,0.8081541775335814,0.1299385955641987,1030917.374937764,-3527.2451600149634,1027390.1297777491,2774,0,327.5462962962963,69,147,40,38.7255009027899,0.5284047067901234,44.50892857142859,8070.0853393695315,116.95775854158741,0
2889,31.377549625332342,2,3,213,0.009259259259259259,0.013888888888888888,0.9861111111111112,216,6150,4200,1950,0.6829268292682927,81,42,39,228.64725028843273,0.48324720068906113,0.8129153585164741,0.13074857684589689,1022934.511876451,-2571.7673268618128,1020362.7445495891,2775,0,328.30555555555554,67,149,38,38.81537834703143,0.5322145061728395,44.65379901960785,8012.13809290236,119.58415064033373,8
2890,30.91893869458301,0,2,211,0.0,0.009389671361502348,0.9906103286384976,213,7100,5000,2100,0.704225352112676,92,50,42,231.00341128247143,0.48277083886969613,0.8132144383998783,0.13273744070282134,1009435.225082161,-3063.4039074663237,1006371.8211746947,2776,1,333.90610328638496,67,146,37,38.567144755510284,0.533744131455399,44.46997549019608,7900.717162443915,117.92115167826739,0
2891,31.438479596537054,4,4,211,0.018604651162790697,0.018604651162790697,0.9813953488372094,215,7650,5500,2150,0.7189542483660131,98,55,43,198.73275641566795,0.4831494964862711,0.7809141008367768,0.11563244147252183,1030192.0682327567,-9703.418128509045,1020488.6501042476,2777,0,330.5348837209302,83,132,35,38.910417877672316,0.5396317829457364,43.998015873015895,8048.313154649245,96.96762836926801,8
2892,31.49249595822724,1,1,211,0.0047169811320754715,0.0047169811320754715,0.9952830188679245,212,7100,5500,1600,0.7746478873239436,87,55,32,213.89428484573148,0.4826541029538884,0.7976439856778261,0.12283486415803949,1027983.3028232412,-5524.04932185387,1022459.2535013873,2778,0,336.1132075471698,72,140,40,39.02683923452102,0.5341981132075472,44.492009132420094,8046.58436969203,111.75811624572265,8
2893,31.467034910493112,1,0,212,0.0047169811320754715,0.0,1.0,212,5850,3700,2150,0.6324786324786325,80,37,43,205.99719133199912,0.48271371724939643,0.7825823145378685,0.1184918511316077,1027646.3500818221,-5911.547640112606,1021734.8024417096,2779,0,337.061320754717,74,138,42,39.16589678097207,0.5368514150943396,44.43055555555557,8042.012630388696,108.67584635660401,8
2894,31.156851057500713,5,7,210,0.02304147465437788,0.03225806451612903,0.967741935483871,217,5400,3200,2200,0.5925925925925926,76,32,44,187.8662161799882,0.4829793551231723,0.7771722020812113,0.10911080957670811,1020417.7033936188,-10459.597428073368,1009958.1059655454,2780,0,330.2718894009217,78,139,37,39.25832904001376,0.5384024577572964,44.066455696202546,7974.083320491711,102.23183744220142,8
2895,31.636783240884615,2,2,210,0.009433962264150943,0.009433962264150943,0.9905660377358491,212,6800,4800,2000,0.7058823529411765,88,48,40,192.5658967600687,0.4819750588691168,0.7782805111119513,0.11219433390890472,1037097.0480498277,-9258.095383012693,1027838.952666815,2781,0,338.8207547169811,78,134,40,39.01709236658253,0.5397012578616351,43.9477848101266,8100.668430310412,103.8547234655181,0
2896,31.288583775215926,2,2,210,0.009433962264150943,0.009433962264150943,0.9905660377358491,212,7200,5200,2000,0.7222222222222222,92,52,40,191.35435256791567,0.48212223166115237,0.7781868384721582,0.11207897793263666,1027267.7602761361,-10285.568563693272,1016982.1917124428,2782,0,339.4811320754717,78,134,45,38.84654471544719,0.5412735849056604,43.750000000000014,8017.699592399111,102.79102041537321,0
2897,31.481961921155147,2,3,209,0.009433962264150943,0.014150943396226415,0.9858490566037735,212,7300,5100,2200,0.6986301369863014,95,51,44,189.02298451042628,0.4820891643566127,0.7753487879016892,0.11147890976244765,1035689.8644052503,-10546.16216058442,1025143.7022446658,2783,0,340.0,72,140,45,38.644581664441496,0.5434846698113207,43.493150684931486,8075.338862652418,112.15748420350582,0
2898,31.063526745522715,3,0,212,0.014150943396226415,0.0,1.0,212,5900,4300,1600,0.7288135593220338,75,43,32,227.3089828372901,0.48223307699186263,0.8077054162436956,0.13488599007943722,1023744.2227954824,-1758.748406161214,1021985.4743893212,2784,0,340.32547169811323,72,140,41,37.429019378983234,0.5412735849056604,43.26484018264841,7975.09950350238,110.7652708819775,8
2899,30.977781028612174,1,3,210,0.004694835680751174,0.014084507042253521,0.9859154929577465,213,7000,5400,1600,0.7714285714285715,86,54,32,233.71191067579312,0.48204557533882536,0.816114034096509,0.13657961947585337,1016393.1413237677,-2091.363388690308,1014301.7779350774,2785,0,339.7230046948357,73,140,40,37.847565666556754,0.5398082942097027,43.83445945945945,7935.4400219409235,108.70465783480716,8
2900,31.38729954052786,4,1,213,0.018691588785046728,0.004672897196261682,0.9953271028037384,214,6100,4400,1700,0.7213114754098361,78,44,34,229.6902241301511,0.48216538326532404,0.8108910984983191,0.13595178130946778,1033652.9891486594,-1416.0026499288224,1032236.9864987306,2786,0,337.2710280373832,71,143,39,37.46459073228482,0.5446359034267914,43.359375,8055.256171143282,113.45431226962368,8
2901,31.128447968423156,1,5,209,0.004672897196261682,0.02336448598130841,0.9766355140186916,214,6300,4000,2300,0.6349206349206349,86,40,46,222.1123920679871,0.48188475348456267,0.8066476570072771,0.12908785944570336,1019689.8553770754,-3802.849410947978,1015887.0059661274,2787,0,338.2570093457944,67,147,37,38.35588854310051,0.5361662772585669,44.0410539215686,7967.604735054817,118.91947365753458,8
2902,30.872489740056842,1,1,209,0.004761904761904762,0.004761904761904762,0.9952380952380953,210,5600,4000,1600,0.7142857142857143,72,40,32,219.82751345171937,0.4813506303637882,0.8012152288026386,0.12865364128523718,1013371.112908348,-3046.629609111645,1010324.4832992363,2788,0,345.54285714285714,69,141,40,38.14733612111354,0.5379464285714286,43.77976190476188,7910.1566717901005,114.63995176507392,0
2903,30.907292635071954,3,2,210,0.014150943396226415,0.009433962264150943,0.9905660377358491,212,7900,5900,2000,0.7468354430379747,99,59,40,211.34416676869864,0.481562416167397,0.7948489377839327,0.12464244142891154,1016782.8225963335,-7321.776314730641,1009461.0462816028,2789,0,343.1509433962264,68,144,41,38.07223922468757,0.5404874213836478,43.49335748792269,7927.925862960524,116.58714504353712,0
2904,30.72353853989465,1,2,209,0.004739336492890996,0.009478672985781991,0.990521327014218,211,8100,5700,2400,0.7037037037037037,105,57,48,183.76794975081793,0.48116301812984275,0.7640959501082305,0.10595437474032145,1004064.2267440081,-13397.035126622399,990667.1916173857,2790,0,345.563981042654,80,131,42,39.64338112005367,0.5371741706161137,44.34156378600825,7854.731818069827,98.18414772587283,8
2905,30.804165574244745,2,2,209,0.009478672985781991,0.009478672985781991,0.990521327014218,211,6200,4000,2200,0.6451612903225806,84,40,44,184.1048424157759,0.4813473256601219,0.7642982071974307,0.10675567483426758,1008393.5344251334,-11269.973450314605,997123.5609748188,2791,0,346.54502369668245,82,129,37,39.415751095415615,0.5391488941548184,44.12650602409639,7881.9694744942735,96.12157895724724,0
2906,30.525960727108906,2,1,210,0.009478672985781991,0.004739336492890996,0.995260663507109,211,6800,4800,2000,0.7058823529411765,88,48,40,185.34431562711578,0.48088749717896634,0.7665455505416194,0.10809768807311917,1000983.4877561356,-11894.6801015588,989088.8076545768,2792,0,347.06635071090045,84,127,40,39.16281842688748,0.5412717219589258,43.909313725490215,7817.414231794102,93.06445514040598,0
2907,30.985163233546558,1,2,209,0.004739336492890996,0.009478672985781991,0.990521327014218,211,7050,4800,2250,0.6808510638297872,93,48,45,187.40830129430873,0.4804003987060859,0.7693268685465491,0.10980964707812312,1017419.1490705541,-11115.441113677443,1006303.7079568766,2793,0,347.91469194312793,72,139,42,38.933125452419354,0.5431970774091628,43.735730593607286,7940.390218482591,110.28319747892488,0
2908,30.871529394619547,1,3,207,0.004761904761904762,0.014285714285714285,0.9857142857142858,210,5850,3800,2050,0.6495726495726496,79,38,41,189.0137154746843,0.4800955988455988,0.7717459959092301,0.1109226895351096,1014147.3518760857,-9512.448196618074,1004634.9036794676,2794,0,350.45238095238096,71,139,44,38.83281829128334,0.5427083333333333,43.67766203703701,7913.062590921154,111.45158578762188,8
2909,30.765004664336256,2,1,208,0.009569377990430622,0.004784688995215311,0.9952153110047847,209,6400,4400,2000,0.6875,84,44,40,182.38833291130717,0.4796478192859772,0.7625501290067593,0.10788039560319808,1012959.1838107452,-11249.612631512266,1001709.571179233,2795,0,346.90909090909093,76,133,44,38.70437731737748,0.5461024720893142,43.384740259740234,7894.769662848888,103.8785481953801,0
2910,30.47275914158094,0,0,208,0.0,0.0,1.0,208,6750,4400,2350,0.6518518518518519,91,44,47,224.21842425463075,0.4795881139291465,0.8022424336358003,0.1329203976461712,1003987.786099452,-3327.488125977261,1000660.2979734747,2796,1,348.5769230769231,71,137,40,37.5458514155817,0.549629407051282,43.30150462962962,7822.311421427506,110.17340030179585,8
2911,30.4109570844134,1,4,205,0.004784688995215311,0.019138755980861243,0.9808612440191388,209,6750,4600,2150,0.6814814814814815,89,46,43,221.4695853131463,0.47952034259600046,0.7976603745299655,0.12797654069845313,994502.7258525282,-4499.57874252952,990003.1471099987,2797,0,347.9043062200957,77,132,39,38.593559617058325,0.5408193779904307,44.25747863247862,7777.374841967344,101.00486807749797,8
2912,30.717540126960778,0,3,202,0.0,0.014634146341463415,0.9853658536585366,205,5700,3900,1800,0.6842105263157895,75,39,36,224.36823269348372,0.479377889367129,0.7974945192608838,0.13001955843743945,1005368.1090445217,-1585.4668334584421,1003782.6422110633,2798,1,353.5609756097561,77,128,33,38.410194174757244,0.5433943089430895,44.150641025641015,7859.062950752039,102.06575260716933,0
2913,30.811459837393784,2,2,202,0.00980392156862745,0.00980392156862745,0.9901960784313726,204,6950,5100,1850,0.7338129496402878,88,51,37,221.06818519822448,0.4796113847837986,0.7953941442235992,0.12666979106512727,1005082.202326173,-3311.6603113435303,1001770.5420148295,2799,0,356.21078431372547,67,137,39,38.93062052696812,0.5381944444444444,44.57720588235295,7869.949162510804,117.46192779866871,8
2914,31.044400353626294,2,3,201,0.00980392156862745,0.014705882352941176,0.9852941176470589,204,5950,4400,1550,0.7394957983193278,75,44,31,236.76392567320673,0.4792220048939116,0.8107738463575103,0.13475866332552772,1010663.5794297762,1107.7353201458345,1011771.314749922,2800,0,356.7843137254902,77,127,38,38.79026665619932,0.5331903594771241,44.831730769230774,7921.54590754191,102.87721957846637,8
2915,31.47024754502788,3,1,203,0.014705882352941176,0.004901960784313725,0.9950980392156863,204,4800,2800,2000,0.5833333333333334,68,28,40,227.57856302486908,0.47917521893814996,0.8041176470588234,0.13078270276319345,1027465.0411306389,1165.803523759777,1028630.8446543987,2801,0,356.62745098039215,63,141,41,38.65074309978769,0.5359987745098039,44.466145833333336,8041.7136467600585,127.64624836127076,0
2916,31.98371555677625,1,2,202,0.004901960784313725,0.00980392156862745,0.9901960784313726,204,5600,4000,1600,0.7142857142857143,72,40,32,222.07012974445038,0.4788431895746805,0.7988888808193186,0.12806386727413138,1045309.7288282964,26.413420807131843,1045336.1422491035,2802,0,357.6127450980392,65,139,42,38.65638568224373,0.5373263888888888,44.33396464646464,8177.149752276172,125.80230388117188,0
2917,32.0190260817583,1,3,200,0.0049261083743842365,0.014778325123152709,0.9852216748768473,203,6850,4900,1950,0.7153284671532847,88,49,39,221.72693211925937,0.4786382887057179,0.7957495244525348,0.1284447274826138,1047858.8430052516,-982.2946892817117,1046876.5483159699,2803,0,360.0295566502463,67,136,38,38.49102099674671,0.5391522988505747,44.16360294117648,8191.632270089554,122.26316821029185,0
2918,32.510845070717444,0,4,196,0.0,0.02,0.98,200,6550,4700,1850,0.7175572519083969,84,47,37,208.370457005709,0.47836526381909544,0.7798415672913122,0.11738335725753438,1055138.611515376,-2578.0570628345117,1052560.5544525415,2804,2,365.44,71,129,43,39.916950596252136,0.5319270833333334,45.225694444444436,8282.927975916273,116.66095740727145,8
2919,32.76686468975126,4,1,199,0.02,0.005,0.995,200,5800,3800,2000,0.6551724137931034,78,38,40,205.22079465107439,0.47875418760469013,0.7671911262798645,0.11431500538548375,1059827.4765016295,-2300.2726158588594,1057527.2038857706,2805,0,365.85,77,123,38,40.44013083048916,0.5273958333333333,45.6597222222222,8333.933467098137,108.23290217010567,8
2920,33.228264838866494,7,1,205,0.03398058252427184,0.0048543689320388345,0.9951456310679612,206,5850,4100,1750,0.7008547008547008,76,41,35,214.77622715110573,0.47928111926750333,0.7876356721480158,0.12016208984540126,1076180.3287171049,-822.4098527808183,1075357.918864324,2806,0,355.40776699029124,75,131,42,40.02442466835404,0.5278114886731391,45.49067982456139,8456.90309474931,112.7587079299908,8
2921,33.36959264526061,4,1,208,0.019138755980861243,0.004784688995215311,0.9952153110047847,209,6150,4100,2050,0.6666666666666666,82,41,41,184.53344630934507,0.47931618819776717,0.7511944895728788,0.10400809803382012,1083175.8918778005,-7973.563942518255,1075202.3279352821,2807,0,350.82775119617224,92,117,45,40.50429341773637,0.5342902711323764,45.20609318996416,8502.368878745387,92.41705302984116,8
2922,33.55501611420319,2,3,207,0.009523809523809525,0.014285714285714285,0.9857142857142858,210,6450,4300,2150,0.6666666666666666,86,43,43,206.50683448059652,0.47957773220931116,0.7779995620462552,0.11547227317141863,1086582.3574282057,-3572.6633930075786,1083009.694035198,2808,0,350.1190476190476,80,130,41,40.25647666211867,0.5288690476190476,45.51183127572015,8539.354602417228,106.74193253021535,8
2923,33.670685937657865,5,3,209,0.02358490566037736,0.014150943396226415,0.9858490566037735,212,6250,4100,2150,0.656,84,41,43,199.736625681915,0.4797125100599124,0.7747566398269456,0.11265574078005657,1093179.5561160806,-4980.400839384297,1088199.1552766962,2809,0,347.49056603773585,85,127,41,40.08956016097858,0.5315448113207547,45.17926356589146,8579.988986875522,100.9410469044179,0
2924,33.42528679144379,2,3,208,0.009478672985781991,0.014218009478672985,0.985781990521327,211,7700,5500,2200,0.7142857142857143,99,55,44,198.09828042098397,0.479598284811555,0.7725851412948144,0.11254250778112164,1087570.9830569895,-6810.811684130276,1080760.1713728593,2810,0,350.09478672985784,93,118,35,39.849044309296254,0.5344589257503949,44.902482269503544,8526.707689927258,91.685028923949,0
2925,33.14870917487426,2,3,207,0.009523809523809525,0.014285714285714285,0.9857142857142858,210,6850,5500,1350,0.8029197080291971,82,55,27,197.71635511913868,0.4794737791448318,0.7722295941195279,0.11285525939607613,1080088.9873055315,-6139.748445125668,1073949.2388604057,2811,0,352.72857142857146,75,135,38,39.67589485458614,0.5362599206349206,44.72313596491229,8462.098524973055,112.82798033297406,0
2926,33.4846132859843,0,4,203,0.0,0.01932367149758454,0.9806763285024155,207,7650,5800,1850,0.7581699346405228,95,58,37,204.08508709332816,0.47906993105389056,0.782797454824006,0.11488267946097493,1086495.4004256846,-4702.498315525136,1081792.9021101594,2812,1,358.512077294686,80,127,42,40.05565651976373,0.532055152979066,45.254629629629605,8530.050213246628,106.62562766558285,8
2927,33.64955786612886,2,2,203,0.00975609756097561,0.00975609756097561,0.9902439024390244,205,6450,4700,1750,0.7286821705426356,82,47,35,209.37282605016003,0.47889068228917586,0.7886611431933985,0.11918397789936144,1095518.1012996412,-1575.6558283583026,1093942.4454712828,2813,0,360.85853658536587,88,117,42,39.48414518545694,0.5353658536585366,44.826779026217196,8586.466065043696,97.57347801186019,0
2928,33.69835739559174,2,0,205,0.00975609756097561,0.0,1.0,205,6950,4600,2350,0.6618705035971223,93,46,47,180.17349161714696,0.4789753706360593,0.7488903839223655,0.10444902413795915,1103052.8103201461,-8201.824745302654,1094850.9855748436,2814,0,361.74634146341464,88,117,42,39.52624918042783,0.5439532520325203,44.13623595505617,8622.188565367851,97.97941551554376,8
2929,34.03022237092698,2,7,200,0.00966183574879227,0.033816425120772944,0.966183574879227,207,5850,4500,1350,0.7692307692307693,72,45,27,180.35250514945497,0.47926828791645165,0.7520496532136378,0.10506774382559975,1115523.9021459585,-7012.493938776342,1108511.408207182,2815,0,359.24154589371983,92,115,38,39.33371609798773,0.5457930756843801,43.9516129032258,8713.3835506204,94.71069076761304,0
2930,34.17418885419999,0,4,196,0.0,0.02,0.98,200,6150,4300,1850,0.6991869918699187,80,43,37,185.57141611784348,0.47824329983249586,0.7525633406318424,0.10845919878039226,1121306.4525314444,-4533.5147403329065,1116772.9377911114,2816,1,368.05,90,110,42,39.0763476175581,0.5470833333333334,43.830128205128204,8754.397577474147,97.27108419415718,0
2931,34.42753166039676,0,1,195,0.0,0.00510204081632653,0.9948979591836735,196,5250,3400,1850,0.6476190476190476,71,34,37,204.93407869839248,0.47774289202860637,0.7718886699275873,0.12154090384463626,1134427.592788975,2046.5747156485077,1136474.1675046235,2817,2,374.1326530612245,73,123,43,38.02451746449523,0.5524022108843538,43.285472972972954,8838.047506906703,121.06914393022882,8
2932,34.556866468381074,1,3,193,0.00510204081632653,0.015306122448979591,0.9846938775510204,196,7100,5000,2100,0.704225352112676,92,50,42,200.74588579851553,0.4776000784929357,0.76706125062479,0.1195480980537004,1140040.3685342968,-528.3172745036172,1139512.051259793,2818,0,373.34183673469386,75,121,46,37.97672882983829,0.5543154761904762,43.1332236842105,8876.510889308178,118.35347852410904,0
2933,34.428915615849185,0,2,191,0.0,0.010362694300518135,0.9896373056994818,193,5450,3400,2050,0.6238532110091743,75,34,41,234.82562517374907,0.47758347725964306,0.7953684240127676,0.13627282342760075,1127309.9721586357,8894.25379535061,1136204.2259539864,2819,1,378.2901554404145,68,125,44,38.087969244685674,0.5401014680483592,44.09722222222222,8810.455141972512,129.5655167937134,7
2934,33.88184310718409,0,1,190,0.0,0.005235602094240838,0.9947643979057592,191,5100,3500,1600,0.6862745098039216,67,35,32,238.91669907703618,0.4773847249012584,0.79917343868778,0.13428766189502378,1098885.1190365897,9208.401061019613,1108093.5200976094,2820,2,381.9633507853403,65,126,39,39.22759032038173,0.5306500872600349,45.3125,8629.281916360951,132.75818332863003,8
2935,34.07530459562679,3,2,191,0.015544041450777202,0.010362694300518135,0.9896373056994818,193,5700,4100,1600,0.7192982456140351,73,41,32,234.08264281806458,0.4777498920552677,0.7974642073874372,0.13265700733031574,1107898.8372987239,7567.977561989261,1115466.8148607132,2821,0,378.5284974093264,70,123,38,39.027889649617414,0.5335168393782384,44.997065727699535,8689.302658107244,124.13289511581777,0
2936,33.6227531767825,2,4,189,0.010362694300518135,0.02072538860103627,0.9792746113989638,193,5950,4400,1550,0.7394957983193278,75,44,31,230.98653220012966,0.47790168933506044,0.7952485656573776,0.13172665764194383,1095239.7810339006,6047.1277897301225,1101286.9088236308,2822,0,377.20725388601034,60,133,43,38.861755982248376,0.5361075129533679,44.757513661202196,8581.955118397702,143.03258530662836,0
2937,33.43326528404296,2,2,189,0.010471204188481676,0.010471204188481676,0.9895287958115183,191,6650,4700,1950,0.706766917293233,86,47,39,224.98073204489316,0.47780150638376045,0.7872398701838668,0.1291088131842943,1091101.691148434,4245.371441999285,1095347.0625904333,2823,0,379.151832460733,64,127,40,38.77140572073767,0.5393215532286213,44.51923076923078,8541.556332663691,133.46181769787017,0
2938,33.81228013993697,4,5,188,0.02072538860103627,0.025906735751295335,0.9740932642487047,193,6000,4000,2000,0.6666666666666666,80,40,40,225.75699372201728,0.47798264788428324,0.7897886207675546,0.1327257962021308,1111338.538148582,5578.489475968724,1116917.0276245507,2824,0,375.54404145077723,66,127,40,37.821892749580584,0.5478195164075993,43.610074626865654,8669.12798177391,131.35042396627136,7
2939,33.91398125986515,4,2,190,0.020833333333333332,0.010416666666666666,0.9895833333333334,192,6200,4500,1700,0.7258064516129032,79,45,34,236.90201896629563,0.4773237529086678,0.7973487317266299,0.14105435492849977,1118773.418469036,8407.93632022752,1127181.3547892636,2825,0,377.9270833333333,69,123,41,37.054812872950585,0.5515407986111112,43.139880952380935,8711.14926378764,126.24854005489333,0
2940,33.3680359924858,0,0,190,0.0,0.0,1.0,190,5250,3700,1550,0.7047619047619048,68,37,31,237.83865973126092,0.4774987236610044,0.7934581230795246,0.13798781159672607,1092495.4449120231,8717.530476076645,1101212.9753881,2826,1,380.9894736842105,75,115,32,38.02021960364219,0.541173245614035,44.10635964912281,8538.668201476294,113.84890935301725,8
2941,33.361885163247514,1,1,190,0.005235602094240838,0.005235602094240838,0.9947643979057592,191,6550,4700,1850,0.7175572519083969,84,47,37,236.04771072455,0.4773342059336824,0.794724182098898,0.13777015424019456,1094211.5069267233,6907.224251702765,1101118.731178426,2827,0,379.9895287958115,78,113,35,37.83624639621087,0.543466404886562,43.8818565400844,8544.584090333887,109.54594987607547,0
2942,33.2156053074068,1,4,187,0.005235602094240838,0.020942408376963352,0.9790575916230366,191,6300,4600,1700,0.7301587301587301,80,46,34,200.47303997169337,0.47692775787636627,0.7610622081367078,0.11604899004707757,1086787.9558283302,-925.6629380943073,1085862.292890236,2828,0,380.5497382198953,77,114,42,39.06241842860872,0.5393215532286213,44.19070512820514,8496.860572427604,110.3488386029559,8
2943,33.31274158204893,3,4,186,0.015789473684210527,0.021052631578947368,0.9789473684210527,190,6500,4500,2000,0.6923076923076923,85,45,40,197.24412621396016,0.4767625081221572,0.7575187195908237,0.11528456329978426,1093049.7295849181,-1380.4722359233324,1091669.2573489947,2829,0,382.6736842105263,78,112,38,38.77629366550001,0.5421052631578948,43.829113924050645,8533.754528692629,109.40710934221319,0
2944,33.58321041631496,2,1,187,0.010638297872340425,0.005319148936170213,0.9946808510638298,188,6450,4200,2250,0.6511627906976745,87,42,45,216.46897026976137,0.4765592407175636,0.7785462922232766,0.12356210166329856,1094254.2350468126,3324.417494781783,1097578.6525415943,2830,0,387.0691489361702,59,129,44,39.19625045339133,0.5334663120567376,44.72222222222222,8573.047325720403,145.305886876617,7
2945,33.49874582772528,1,2,186,0.005319148936170213,0.010638297872340425,0.9893617021276596,188,5500,3400,2100,0.6181818181818182,76,34,42,219.71068190871645,0.4767820571168506,0.7790244506106128,0.12311138668235834,1085444.7354949268,4596.760601963153,1090041.49609689,2831,0,387.1489361702128,69,119,39,39.83840679254107,0.5304742907801419,45.431547619047606,8527.723882066883,123.59020118937511,8
2946,32.944032579553,2,1,187,0.010638297872340425,0.005319148936170213,0.9946808510638298,188,5650,3800,1850,0.672566371681416,75,38,37,200.06506227702494,0.47737643171388483,0.7607695879015299,0.10828303612689638,1056154.8786664638,-990.0616850822844,1055164.8169813815,2832,0,386.0851063829787,68,120,42,41.71846121743276,0.5205562943262412,46.78442028985505,8341.942307621362,122.67562217090239,8
2947,33.07638234443948,8,4,191,0.041025641025641026,0.020512820512820513,0.9794871794871794,195,5000,3100,1900,0.62,69,31,38,226.41701133317855,0.47871508502951804,0.7916889546953718,0.12641809588766495,1070601.766485004,4480.490459111155,1075082.256944115,2833,0,373.16923076923075,66,129,41,39.80827986556678,0.5289529914529915,45.56902985074626,8415.656048923367,127.50994013520253,8
2948,33.363263405575076,4,3,192,0.020512820512820513,0.015384615384615385,0.9846153846153847,195,6100,4600,1500,0.7540983606557377,76,46,30,232.90408597562651,0.4789232531500573,0.79926066546565,0.13044599794206158,1080908.9330285054,5249.621413978926,1086158.5544424844,2834,0,367.51794871794874,64,131,42,39.52011458071011,0.525267094017094,45.44871794871796,8492.661473303795,132.6978355203718,8
2949,33.4391310277634,1,1,192,0.0051813471502590676,0.0051813471502590676,0.9948186528497409,193,6550,4900,1650,0.7480916030534351,82,49,33,233.14282298088077,0.4784594037852619,0.7970691740204019,0.13117486303979234,1084857.746608006,5435.359515373537,1090293.1061233797,2835,0,372.30051813471505,66,127,41,39.33486938476564,0.5276878238341969,45.27363184079602,8517.828401101922,129.05800607730185,0
2950,33.561833351794014,4,5,191,0.02040816326530612,0.025510204081632654,0.9744897959183674,196,6150,4400,1750,0.7154471544715447,79,44,35,228.10484243295562,0.4787311398918542,0.7956538599557783,0.1294748349031881,1091723.9719721852,4455.504921399337,1096179.4768935845,2836,0,367.56632653061223,71,125,36,39.118217054263546,0.5304528061224489,44.9363425925926,8560.403964006517,120.56906991558473,0
2951,33.0332277700478,4,3,192,0.020512820512820513,0.015384615384615385,0.9846153846153847,195,7350,5600,1750,0.7619047619047619,91,56,35,185.77460113757044,0.4783967750462596,0.7470347191178643,0.10628587793983353,1077072.0896719082,-6331.472428957941,1070740.6172429502,2837,0,370.2769230769231,72,123,41,39.890664580539436,0.5346688034188034,44.63470319634707,8435.540013881016,117.16027797056967,8
2952,32.99048405933738,2,2,192,0.010309278350515464,0.010309278350515464,0.9896907216494846,194,6100,4400,1700,0.7213114754098361,78,44,34,196.73925533542928,0.4786007914463259,0.7642596811073155,0.11042931846065548,1069531.8804963108,-2816.21885473072,1066715.66164158,2838,0,373.10309278350513,68,126,45,40.35567478903578,0.5253973367697595,45.36533816425122,8400.520752247066,123.53706988598627,8
2953,32.539148851943814,2,1,193,0.010309278350515464,0.005154639175257732,0.9948453608247423,194,5250,3700,1550,0.7047619047619048,68,37,31,241.96896099627162,0.4788433888859214,0.8009001577209449,0.13559509037230513,1054378.7404803268,6975.385666116195,1061354.126146443,2839,0,371.2680412371134,71,123,37,39.26839433204516,0.5282968213058419,45.428240740740726,8283.548368038211,116.66969532448185,8
2954,32.40391340853537,3,4,192,0.015306122448979591,0.02040816326530612,0.9795918367346939,196,6250,4500,1750,0.72,80,45,35,260.03146755004303,0.4792647828362114,0.8114952288288722,0.146991340126631,1052758.9680151062,9300.091885887294,1062059.0599009935,2840,0,368.4540816326531,68,128,31,38.46523048070278,0.5315688775510203,45.09359903381642,8259.964944189593,121.47007270867049,8
2955,32.04776322153145,1,3,190,0.0051813471502590676,0.015544041450777202,0.9844559585492227,193,5700,4400,1300,0.7719298245614035,70,44,26,251.11341972008904,0.4790868325417386,0.8066940344979774,0.1425193382119978,1042439.3977771839,8054.104405355868,1050493.5021825398,2841,0,373.65284974093265,69,124,35,38.5355892648775,0.5322215025906736,44.9404761904762,8174.087226444196,118.4650322673072,8
2956,32.49844615874121,4,0,194,0.020618556701030927,0.0,1.0,194,5700,4000,1700,0.7017543859649122,74,40,34,228.5448101879202,0.47955226305574844,0.7876707496275053,0.1251584577223317,1045673.6232526469,3296.6559489581223,1048970.279201605,2842,0,372.27319587628864,65,129,43,40.524935709989826,0.5221756872852233,46.322601010101,8244.121292762733,126.83263527327281,8
2957,32.23178183950776,6,4,196,0.03,0.02,0.98,200,5850,4100,1750,0.7008547008547008,76,41,35,220.76689207555918,0.4809081867671692,0.7924437627811844,0.12408621864936657,1045368.9107591377,306.5691001416235,1045675.4798592794,2843,0,362.075,71,129,41,39.68984321745057,0.53046875,45.312500000000014,8209.03193724967,115.62016813027705,8
2958,32.462793964898346,3,4,195,0.01507537688442211,0.020100502512562814,0.9798994974874372,199,6000,4100,1900,0.6833333333333333,79,41,38,218.97289929381492,0.480887180007783,0.7894095761848952,0.12371114781632188,1054491.2912187674,381.00306365048436,1054872.294282418,2844,0,364.79396984924625,73,126,34,39.53414655473944,0.532715661641541,45.11542792792794,8274.265348006986,113.34610065762995,0
2959,32.92610844427078,3,4,194,0.015151515151515152,0.020202020202020204,0.9797979797979798,198,6400,4600,1800,0.71875,82,46,36,223.46113843042247,0.48095058025261067,0.7900244605553748,0.12595082347896525,1068785.5580202574,1766.4075066400906,1070551.9655268975,2845,0,367.550505050505,72,126,43,39.51181208930705,0.5272516835016835,45.20547945205479,8389.392014567611,116.51933353566126,8
2960,32.5681046848874,3,3,194,0.015228426395939087,0.015228426395939087,0.9847715736040609,197,5750,4200,1550,0.7304347826086957,73,42,31,223.98384138017155,0.4800763579543492,0.7920910741993334,0.12747546313049735,1060245.6137347182,2345.5770741559177,1062591.190808874,2846,0,370.3502538071066,72,125,39,39.11917943555902,0.5300338409475465,44.83447488584475,8310.257533892076,115.42024352627884,0
2961,32.68135223805189,2,3,193,0.01020408163265306,0.015306122448979591,0.9846938775510204,196,5650,4100,1550,0.7256637168141593,72,41,31,202.39370471700505,0.4799652232687947,0.7707492177789192,0.11554954056556786,1064928.29572486,-1743.0433940553007,1063185.2523308047,2847,0,373.14285714285717,67,129,44,39.54826732673269,0.5355548469387755,44.71507352941181,8343.05660305057,124.5232328813518,7
2962,32.75146611790432,1,1,193,0.005154639175257732,0.005154639175257732,0.9948453608247423,194,6300,4300,2000,0.6825396825396826,83,43,40,201.53168827969813,0.47950774976407956,0.7671728950621408,0.11597319791214553,1069729.6142888998,-1983.1169659130574,1067746.4973229868,2848,0,376.71649484536084,68,126,43,39.263388462295744,0.5381765463917525,44.41425120772951,8370.807991789337,123.10011752631378,0
2963,33.172537335655875,3,3,193,0.015306122448979591,0.015306122448979591,0.9846938775510204,196,5200,3200,2000,0.6153846153846154,72,32,40,194.30954754144935,0.4796076443397872,0.7612172488776561,0.11274667298934102,1086132.4012012563,-2190.8209104945536,1083941.5802907618,2849,0,373.41326530612247,73,123,42,39.129570291728534,0.5402317176870748,44.101914414414466,8488.788798210822,116.2847780576825,0
2964,33.442803503654496,4,0,197,0.02030456852791878,0.0,1.0,197,6550,4600,1950,0.7022900763358778,85,46,39,212.9948738743244,0.47939975482578817,0.7782670787817951,0.12339550201396977,1094477.5673169233,673.6222817893668,1095151.1895987126,2850,0,371.83248730964465,70,127,45,38.711554268455856,0.5384412013536379,44.16079812206575,8555.9801569356,122.22828795622286,7
2965,33.568845656988984,4,3,198,0.01990049751243781,0.014925373134328358,0.9850746268656716,201,6400,4900,1500,0.765625,79,49,30,221.6422055030941,0.47980721393034825,0.776817977438093,0.12860894854351507,1099115.0879187428,2122.058437607475,1101237.1463563503,2851,0,365.41293532338307,88,113,36,38.42932446030007,0.5436359867330016,44.10112359550562,8590.229885819374,97.61624870249288,8
2966,33.52105755104236,2,3,197,0.01,0.015,0.985,200,5200,3700,1500,0.7115384615384616,67,37,30,222.10465772813103,0.4795665829145728,0.7790257533756593,0.1292970529606294,1098598.764845561,3600.780529314161,1102199.5453748752,2852,0,368.2,90,110,37,38.292590688247024,0.5449999999999999,43.97893772893773,8582.096762667283,95.35663069630314,0
2967,33.14494171690918,0,1,196,0.0,0.005076142131979695,0.9949238578680203,197,5850,4200,1650,0.717948717948718,75,42,33,240.13743221273717,0.47906199281743156,0.8023878431200004,0.1398040066218953,1086293.2897446293,6921.936245840451,1093215.2259904698,2853,1,374.74619289340103,68,129,34,37.82836546966213,0.5396044839255499,43.97644927536232,8485.885666924258,124.79243627829791,8
2968,33.33434424715104,2,0,198,0.010101010101010102,0.0,1.0,198,6350,5000,1350,0.7874015748031497,77,50,27,237.22866248512645,0.4791885650070929,0.8019597589096761,0.13912717268517114,1094844.9400505098,5995.72015135804,1100840.6602018678,2854,0,373.74747474747477,64,134,38,37.62179807832596,0.5422453703703703,43.701923076923066,8543.528326036618,133.49263009432215,0
2969,33.37315171154444,2,4,196,0.01,0.02,0.98,200,5950,4200,1750,0.7058823529411765,77,42,35,239.3728165356628,0.4792273869346733,0.8061494106403315,0.13726548613544914,1088898.6342335683,6180.546599665409,1095079.1808332338,2855,0,371.0,63,137,40,38.43268822342574,0.5364583333333333,44.547526041666686,8525.254168500853,135.32149473810878,7
2970,33.27424336137278,3,2,197,0.01507537688442211,0.010050251256281407,0.9899497487437185,199,6300,4500,1800,0.7142857142857143,81,45,36,204.6909421479255,0.4793929665160821,0.7700901492386565,0.11882583864479936,1089611.9107595999,-1493.2622822032317,1088118.6484773967,2856,0,373.64824120603015,80,119,37,38.84600083752096,0.541352596314908,44.0843621399177,8515.399214137335,106.44249017671669,7
2971,33.61354118043215,2,1,198,0.010050251256281407,0.005025125628140704,0.9949748743718593,199,6850,5000,1850,0.7299270072992701,87,50,37,218.13491370097535,0.4793337478638986,0.7819367212236732,0.1276789678359841,1103384.6434934814,1487.3427974865153,1104871.986290968,2857,0,374.51256281407035,82,117,39,38.185940765412795,0.544179229480737,43.77510040160644,8612.626214102724,105.03202700125273,0
2972,33.04883273899684,2,3,197,0.01,0.015,0.985,200,6700,5300,1400,0.7910447761194029,81,53,28,214.5682090385247,0.47931585008375205,0.7861303426351121,0.1262874427833804,1086595.047839401,-70.24932699420924,1086524.7985124069,2858,0,373.6,68,132,42,38.066643117861744,0.5453645833333334,43.56884057971012,8474.750496748136,124.62868377570788,8
2973,33.47102773725898,2,2,197,0.010050251256281407,0.010050251256281407,0.9899497487437185,199,5750,3900,1850,0.6782608695652174,76,39,37,198.85920373593143,0.4791518620036208,0.7665629255113973,0.11161348299112184,1085093.8910871474,-2393.8185679372405,1082700.0725192102,2859,0,375.9849246231156,75,124,44,40.30371945311656,0.5276905360134003,45.36732456140351,8522.817342417728,113.6375645655697,8
2974,33.81350764094326,1,2,196,0.005050505050505051,0.010101010101010102,0.98989898989899,198,5950,4300,1650,0.7226890756302521,76,43,33,201.99520202508762,0.47914316600864826,0.7699986749431755,0.11412613751816514,1098386.0926652665,-1176.2558621066123,1097209.83680316,2860,0,378.84343434343435,80,118,37,39.96457702657247,0.5295664983164983,45.11316872427983,8618.617816917369,107.73272271146712,0
2975,33.25959180475565,3,1,198,0.01507537688442211,0.005025125628140704,0.9949748743718593,199,6500,4900,1600,0.7538461538461538,81,49,32,202.81015244474597,0.4799026699152327,0.7725038148756065,0.11423115672242068,1079382.58578908,-2518.050645982914,1076864.5351430972,2861,0,377.59798994974875,77,122,44,40.06542564344498,0.5269053601340034,45.23237179487177,8473.467319168245,110.04503011906812,8
2976,33.616994853446236,4,2,200,0.019801980198019802,0.009900990099009901,0.9900990099009901,202,5550,3700,1850,0.6666666666666666,74,37,37,200.55865393457975,0.48058798417155146,0.7748175100905077,0.11405164207222028,1094128.4348163991,-2062.6147763352674,1092065.820040064,2862,0,372.3712871287129,84,118,40,39.74824679379409,0.529496699669967,44.865196078431346,8576.865390366316,102.10554036150377,0
2977,33.22863176048895,5,1,204,0.024390243902439025,0.004878048780487805,0.9951219512195122,205,7500,5300,2200,0.7066666666666667,97,53,44,192.62405438062558,0.48112446197991393,0.7693121792658055,0.11060801047335533,1084620.1570038912,-6715.213578991652,1077904.9434248996,2863,0,367.6048780487805,73,132,42,39.574438047490524,0.5326727642276423,44.49605855855859,8490.04638351126,116.30200525357891,0
2978,32.78003999250477,2,0,206,0.009708737864077669,0.0,1.0,206,6550,5100,1450,0.7786259541984732,80,51,29,188.79828016155565,0.4809288420554108,0.7661873129425489,0.10917465765863966,1072200.679414612,-7264.071147693578,1064936.6082669185,2864,0,366.7281553398058,77,129,47,39.401890142021735,0.5350930420711975,44.23076923076926,8384.125613467644,108.88474822685252,0
2979,32.630585345110816,1,5,202,0.004830917874396135,0.024154589371980676,0.9758454106280193,207,5700,3800,1900,0.6666666666666666,76,38,38,188.43080831524804,0.48067632850241543,0.7667762882779523,0.10936199544803717,1068463.7373072957,-6833.702864730723,1061630.034442565,2865,0,365.951690821256,78,129,42,39.27074745809288,0.5368357487922706,44.09282700421944,8350.400848864932,107.056421139294,0
2980,32.998252181699584,2,1,203,0.00980392156862745,0.004901960784313725,0.9950980392156863,204,7500,5700,1800,0.76,93,57,36,204.16851525282422,0.48065627112914133,0.7731894968574984,0.11817026185845268,1079628.0234141056,-4214.789886840119,1075413.2335272655,2866,0,367.9852941176471,83,121,39,38.97372503393448,0.5411049836601307,44.19642857142857,8441.070758979395,101.69964769854693,8
2981,33.43551430893811,4,0,207,0.01932367149758454,0.0,1.0,207,5450,3700,1750,0.6788990825688074,72,37,35,212.7669760911026,0.4809479699201101,0.7860512919704303,0.12097868650531973,1088180.2173004614,-544.2371445646695,1087635.9801558966,2867,0,363.6183574879227,92,115,38,39.44174934878687,0.5335144927536232,44.8700716845878,8530.400368828272,92.72174313943773,8
2982,33.39887562568903,5,5,207,0.02358490566037736,0.02358490566037736,0.9764150943396226,212,6100,4200,1900,0.6885245901639344,80,42,38,196.04503834686756,0.4812573586396018,0.7749149874667225,0.11426154395846938,1094973.612481159,-5567.171230464331,1089406.4412506947,2868,0,356.0188679245283,78,134,39,38.91456402334367,0.5387676886792453,43.934599156118175,8552.296474827095,109.64482660034737,8
2983,33.4574730368366,0,5,202,0.0,0.024154589371980676,0.9758454106280193,207,7250,4900,2350,0.6758620689655173,96,49,47,203.95705630222812,0.48066264871879055,0.7798221633280007,0.11904032036101278,1097346.6220646172,-3887.6826441010753,1093458.9394205161,2869,1,365.512077294686,78,129,40,38.65814627951678,0.5397041062801933,43.881856540084414,8569.065879054837,109.8598189622415,0
2984,33.151547966031856,0,4,198,0.0,0.019801980198019802,0.9801980198019802,202,5500,3600,1900,0.6545454545454545,74,36,38,198.73011845039844,0.47972441833735613,0.7732864326324309,0.11689657780605327,1089785.0161999417,-2585.3789290236014,1087199.637270918,2870,2,369.73762376237624,71,131,43,38.495234535161465,0.5459467821782178,43.59085648148145,8500.360020283244,119.72338056736963,7
2985,33.049473998361684,1,1,198,0.005025125628140704,0.005025125628140704,0.9949748743718593,199,7400,5900,1500,0.7972972972972973,89,59,30,195.44252969900612,0.4795388981946771,0.7648324940232036,0.11565947933262206,1088333.9336199143,-4658.652571211191,1083675.2810487032,2871,0,375.70854271356785,75,124,44,38.35051271095919,0.5481574539363484,43.36622807017541,8481.611172496148,113.08814896661531,0
2986,32.93880988957021,0,1,197,0.0,0.005050505050505051,0.9949494949494949,198,7600,5300,2300,0.6973684210526315,99,53,46,197.45765805671277,0.47886436274761146,0.7659008178508955,0.11741220669234916,1086187.5110943886,-4304.791569770673,1081882.7195246178,2872,1,378.5858585858586,77,121,43,38.11817472698905,0.5500841750841751,43.18910256410255,8459.045328210901,109.85773153520651,0
2987,32.78213765305384,3,3,197,0.015,0.015,0.985,200,5200,3400,1800,0.6538461538461539,70,34,36,202.5157924321559,0.47895938023450585,0.7749425991975043,0.11798517465592787,1074626.6553635867,-1674.2262640655172,1072952.4290995211,2873,0,375.115,72,128,39,38.764350200624136,0.5387500000000001,43.94977168949769,8393.873830570681,116.58158098014835,8
2988,32.55354604998304,3,2,198,0.015,0.01,0.99,200,6500,4300,2200,0.6615384615384615,87,43,44,196.26879401996246,0.4789038944723618,0.7679150220571163,0.11532465154760865,1069792.3488168693,-4506.629169186363,1065285.719647683,2874,0,375.5,69,131,42,38.59922800092869,0.5422916666666666,43.630952380952344,8345.721597456884,120.95248691966499,0
2989,32.37219600322491,4,2,200,0.019801980198019802,0.009900990099009901,0.9900990099009901,202,6450,4100,2350,0.6356589147286822,88,41,47,190.5425636780176,0.4789875909232714,0.7633045224020363,0.11302916389680502,1066765.8207322417,-6197.141134719272,1060568.6795975224,2875,0,372.28712871287127,74,128,47,38.386126740243796,0.5456373762376238,43.27777777777774,8310.662096161153,112.30624454271829,0
2990,32.51006573259279,0,3,197,0.0,0.015,0.985,200,6500,4700,1800,0.7230769230769231,83,47,36,192.94511868611943,0.47877826633165826,0.764151616740566,0.1148849653889591,1072468.5506124166,-5114.485642991723,1067354.0649694249,2876,1,372.225,74,126,47,38.182879131970736,0.5477083333333334,43.138888888888864,8350.571606368983,112.8455622482295,0
2991,32.72301080850499,3,4,196,0.015,0.02,0.98,200,6700,4600,2100,0.6865671641791045,88,46,42,204.59447573974302,0.4785552763819096,0.7759248982611899,0.11892878880097406,1071982.0545484954,-2835.678709447222,1069146.3758390483,2877,0,372.105,76,124,38,38.79716981132077,0.5367708333333333,44.034090909090935,8375.975209790688,110.21020012882484,8
2992,32.50280200886425,1,0,197,0.005076142131979695,0.0,1.0,197,6350,5000,1350,0.7874015748031497,77,50,27,217.9723057009298,0.4776990745536793,0.7858080313330107,0.1253840694261319,1061482.330112147,524.7501910682936,1062007.0803032152,2878,0,377.8781725888325,68,129,42,38.85861539370311,0.5349513536379018,44.42934782608698,8306.762306885064,122.158269218898,8
2993,32.03786079631352,1,3,195,0.005050505050505051,0.015151515151515152,0.9848484848484849,198,5050,3500,1550,0.693069306930693,66,35,31,213.88461182451098,0.4778185834657916,0.782221173732975,0.1234331194616248,1047304.2526097379,150.45270631913127,1047454.7053160571,2879,0,376.9646464646465,72,126,45,38.837616496456285,0.536300505050505,44.306506849315106,8191.872540084875,113.77600750117882,0
2994,31.73285382181483,2,2,195,0.01015228426395939,0.01015228426395939,0.9898477157360406,197,6400,4600,1800,0.71875,82,46,36,209.87252698724637,0.4774692237301012,0.7761732525661549,0.12186246729495931,1039208.7426852055,-2179.7270210827724,1037029.0156641228,2880,0,378.47715736040607,79,118,34,38.70436911727298,0.5386527072758037,44.07552083333337,8121.214086820025,102.80017831417753,0
2995,31.4835058581353,2,5,192,0.01015228426395939,0.025380710659898477,0.9746192893401016,197,7350,5600,1750,0.7619047619047619,91,56,35,218.99644928862023,0.47715412307054805,0.7830985418331957,0.12234162542965751,1019213.1453765773,-2109.1880188487703,1017103.9573577285,2881,0,377.1928934010152,72,125,37,39.97553555406012,0.5293464467005076,45.547945205479444,8011.042757737834,111.26448274635881,8
2996,31.251967678029768,5,4,193,0.025380710659898477,0.02030456852791878,0.9796954314720813,197,6050,4400,1650,0.7272727272727273,77,44,33,210.2121159843279,0.47784691287682585,0.7727809251564643,0.11879654683917991,1015249.6382932685,-2766.4450564098643,1012483.1932368587,2882,0,377.96446700507613,79,118,35,39.74594741860782,0.5324661590524535,45.10416666666666,7965.996344597775,100.83539676706044,0
2997,31.727744947026483,1,0,194,0.005154639175257732,0.0,1.0,194,6600,5200,1400,0.7878787878787878,80,52,28,192.9393558452959,0.47699163595249544,0.7555742807460768,0.10921736624314803,1031222.7182897311,-5607.310600029345,1025615.4076897018,2883,0,384.58762886597935,87,107,40,40.12106914589037,0.5351696735395188,45.040246212121176,8089.298039938389,92.98043724067114,8
2998,31.790390599066065,3,1,196,0.015228426395939087,0.005076142131979695,0.9949238578680203,197,6150,4800,1350,0.7804878048780488,75,48,27,187.5332135626336,0.4777379225801996,0.7534328087346671,0.10675814447234733,1035007.7652702838,-6730.333543317265,1028277.4317269665,2884,0,379.71573604060916,94,103,45,40.03917440128335,0.5373307952622673,44.82456140350874,8112.126864270356,86.29922196032294,0
2999,31.700259097568352,4,1,199,0.02,0.005,0.995,200,5950,4200,1750,0.7058823529411765,77,42,35,182.86755128684698,0.47810929648241207,0.7514425499973196,0.10536492737259792,1035779.7348598817,-8067.899242726571,1027711.8356171551,2885,0,374.965,75,125,43,39.69207415152003,0.5404166666666667,44.36677631578949,8103.63942473615,108.04852566314867,0
3000,31.4814440429539,3,1,201,0.01485148514851485,0.0049504950495049506,0.995049504950495,202,6850,4900,1950,0.7153284671532847,88,49,39,180.17488894856046,0.47820868840615405,0.7504828656126383,0.10479119503518157,1031474.7244734729,-10080.831212948724,1021393.8932605241,2886,0,372.2227722772277,82,120,39,39.40132127273621,0.5429558580858086,44.0135542168675,8058.822968676407,98.27832888629764,0
3001,31.038128920276865,3,5,199,0.014705882352941176,0.024509803921568627,0.9754901960784313,204,6250,4800,1450,0.768,77,48,29,220.61770043642895,0.4789760013200683,0.7900655927847926,0.1261315774215275,1011808.4086408198,-2405.4311206838365,1009402.977520136,2887,0,367.578431372549,71,133,39,39.02823814380419,0.5322201797385622,44.66145833333335,7925.230574565524,111.62296583895105,8
3002,30.738174190425543,4,1,202,0.019704433497536946,0.0049261083743842365,0.9950738916256158,203,7250,5300,1950,0.7310344827586207,92,53,39,238.47935213017132,0.47899900827521175,0.8130334282927261,0.1356128853158142,1000424.9275776113,-133.8622832834335,1000291.0652943279,2888,0,370.2807881773399,69,134,40,38.78165402935743,0.5265804597701149,44.86607142857144,7842.351138316183,113.65726287414758,8
3003,30.831975669960734,4,2,204,0.019417475728155338,0.009708737864077669,0.9902912621359223,206,6850,4600,2250,0.6715328467153284,91,46,45,230.3393239289274,0.47997967479674797,0.8058968735880463,0.130249643377012,1001787.7301072424,-1899.7783053606836,999887.9518018817,2889,0,365.20388349514565,71,135,35,39.209231933409,0.52417071197411,45.08101851851851,7859.655834848194,110.69937795560837,8
3004,30.39320627980054,1,2,203,0.004878048780487805,0.00975609756097561,0.9902439024390244,205,7150,5400,1750,0.7552447552447552,89,54,35,217.2703778799639,0.4799547664594293,0.7970243628237301,0.11951886278554537,979287.5469026278,-5595.9649262648745,973691.581976363,2890,0,367.85853658536587,72,133,36,40.63179220535881,0.513109756097561,46.147260273972584,7715.398683185627,107.15831504424483,8
3005,30.19227906309351,5,4,204,0.02403846153846154,0.019230769230769232,0.9807692307692307,208,6900,4800,2100,0.6956521739130435,90,48,42,214.5743685755358,0.48040536355753743,0.792506154511506,0.11708544748997823,970388.8570151808,-6855.884746646383,963532.9722685344,2891,0,363.5,75,133,35,41.02357912567125,0.512520032051282,46.463815789473685,7654.835226276094,102.06446968368125,8
3006,30.127784289852865,7,2,209,0.03317535545023697,0.009478672985781991,0.990521327014218,211,6450,4100,2350,0.6356589147286822,88,41,47,211.01295325657242,0.4809260513051982,0.7918091901916329,0.11656392396050883,971985.0005489836,-7629.714902613314,964355.2856463703,2892,0,359.01895734597156,82,129,39,40.623867753623166,0.5165383096366509,45.9839357429719,7652.941190093184,93.32855109869736,0
3007,30.174997182782814,9,4,214,0.04128440366972477,0.01834862385321101,0.981651376146789,218,7000,5300,1700,0.7571428571428571,87,53,34,214.2798356360571,0.48241854451161936,0.803413932339708,0.11847944700820938,973787.571806353,-8867.391833780086,964920.179972573,2893,0,348.42201834862385,72,146,42,40.50365554557029,0.5159594801223242,45.94748858447487,7666.0338162423295,106.47269189225457,7
3008,30.764135734689386,5,5,214,0.0228310502283105,0.0228310502283105,0.9771689497716896,219,6650,4700,1950,0.706766917293233,86,47,39,221.041251392121,0.4828671121165152,0.8092728770493394,0.12092849445258881,989565.0295363493,-6703.061507481132,982861.9680288682,2894,0,347.662100456621,68,151,43,40.75526258357633,0.5083713850837139,46.36171497584539,7802.962627996878,114.7494504117188,8
3009,30.498574111393626,6,5,215,0.02727272727272727,0.022727272727272728,0.9772727272727273,220,7450,5400,2050,0.7248322147651006,95,54,41,251.67513056454976,0.48376963124394634,0.828436857260388,0.13941956141713496,984799.9596343974,-1880.0683158101492,982919.8913185872,2895,0,345.6136363636364,76,144,37,39.478196255877926,0.5092329545454546,45.873917748917734,7750.483153172707,101.98004148911457,8
3010,30.673935406601,3,2,216,0.013761467889908258,0.009174311926605505,0.9908256880733946,218,6900,5200,1700,0.7536231884057971,86,52,34,244.05369480384186,0.4840788342564016,0.8234904366226152,0.13452488374728974,988949.4939557726,-2228.644405140737,986720.8495506318,2896,0,349.55045871559633,70,148,37,39.87077266774519,0.5105122324159022,46.068075117370896,7789.091461523626,111.27273516462323,7
3011,30.62473802899699,8,2,222,0.03571428571428571,0.008928571428571428,0.9910714285714286,224,7300,4800,2500,0.6575342465753424,98,48,50,253.91861599131974,0.48526710642216525,0.8404811130978989,0.14094688436044228,989484.5343351489,-1850.2912993607351,987634.2430357882,2897,0,341.0,54,170,37,39.34072790940247,0.5104631696428572,45.79545454545455,7784.947610325714,144.16569648751323,8
3012,30.490859134201308,2,5,219,0.008928571428571428,0.022321428571428572,0.9776785714285714,224,6800,4400,2400,0.6470588235294118,92,44,48,219.64851412920305,0.4852779501654922,0.8146980923324518,0.1201440717207353,980718.0552623833,-8517.347276387532,972200.7079859958,2898,0,341.89285714285717,69,155,41,40.798081436282544,0.5083240327380952,46.36904761904759,7733.425641120882,112.07863248001277,8
3013,30.96807056470849,5,3,221,0.022321428571428572,0.013392857142857142,0.9866071428571429,224,6400,4400,2000,0.6875,84,44,40,215.4545923976013,0.48577884769378604,0.8112721454845746,0.119397230440487,1000069.2120183387,-8106.099111040018,991963.1129072987,2899,0,342.70982142857144,77,147,42,40.38448064459623,0.5118117559523809,45.86004273504271,7870.224129893138,102.21070298562516,0
3014,30.93694993801369,4,2,223,0.017777777777777778,0.008888888888888889,0.9911111111111112,225,6000,3900,2100,0.65,81,39,42,206.89018783637314,0.4861210317460318,0.8030807361704364,0.11562801744595187,1001649.7720583109,-9553.69810251913,992096.0739557918,2829,0,328.3466666666667,68,157,44,40.26669534092706,0.5141203703703704,45.531400966183575,7872.482309105661,115.77179866331855,0
3015,30.873281552241046,2,4,221,0.008888888888888889,0.017777777777777778,0.9822222222222222,225,7550,6000,1550,0.7947019867549668,91,60,31,200.06612011703294,0.48602926587301587,0.7966647996714087,0.11268077314099405,1001926.0593443091,-12459.7081325672,989466.3512117419,2830,0,329.2888888888889,72,153,36,40.13701411448416,0.5163888888888889,45.23401826484019,7865.4618840427,109.24252616725973,0
3016,30.62301557110051,5,8,218,0.022123893805309734,0.035398230088495575,0.9646017699115044,226,6700,4900,1800,0.7313432835820896,85,49,36,195.80946211617865,0.48672361520812846,0.793807937108181,0.1114471356196553,996941.1539353025,-12857.89777728894,984083.2561580136,2831,0,326.8274336283186,76,150,42,39.83582511575305,0.5194966814159292,44.8322510822511,7814.005948350925,102.81586774145954,0
3017,30.61569839873339,1,5,214,0.0045662100456621,0.0228310502283105,0.9771689497716896,219,7250,5200,2050,0.7172413793103448,93,52,41,231.13821036211868,0.48583619594207755,0.820386400351103,0.1299156147897418,992954.7006298124,-5148.045505154633,987806.6551246578,2832,0,336.648401826484,63,156,40,39.42569870483979,0.5201198630136986,45.31249999999997,7797.43568592736,123.7688204115454,8
3018,31.170354644737966,6,5,215,0.02727272727272727,0.022727272727272728,0.9772727272727273,220,7000,5200,1800,0.7428571428571429,88,52,36,226.22267226062155,0.4858780441400305,0.815893681067138,0.1289511675163641,1015216.4127660885,-5067.006036242645,1010149.4067298458,2833,0,332.9318181818182,61,159,43,39.00109439799879,0.5238162878787879,44.77486559139785,7955.457953767045,130.41734350437778,0
3019,31.25764722271493,2,3,214,0.009216589861751152,0.013824884792626729,0.9861751152073732,217,8150,6000,2150,0.7361963190184049,103,60,43,218.00697563333205,0.48588887466575637,0.8076848185889531,0.12307503254884575,1015120.1357959799,-7289.345858124041,1007830.7899378558,2834,0,334.31336405529953,73,144,37,39.5875333701556,0.5196812596006144,45.14358108108109,7966.212035012031,109.12619226043878,8
3020,31.640606085284634,4,3,215,0.01834862385321101,0.013761467889908258,0.9862385321100917,218,6300,4500,1800,0.7142857142857143,81,45,36,214.95774543979417,0.4858395340971547,0.8076701072736634,0.12252745361038564,1030526.209445609,-5596.081880190763,1024930.1275654183,2835,0,333.60550458715596,64,154,41,39.28939574699653,0.5222668195718654,44.77564102564104,8075.453405677007,126.17895946370324,0
3021,31.318182883730525,3,4,214,0.013761467889908258,0.01834862385321101,0.981651376146789,218,7800,5700,2100,0.7307692307692307,99,57,42,206.61475355758557,0.4858373321213659,0.7966774113563102,0.11698365583990017,1017976.4711758366,-9334.208456116667,1008642.26271972,2836,0,334.4633027522936,77,141,38,39.76403729310706,0.5213589449541285,45.03205128205129,7985.132847438367,103.70302399270606,8
3022,31.428306034414955,4,7,211,0.01834862385321101,0.03211009174311927,0.9678899082568807,218,6700,4700,2000,0.7014925373134329,87,47,40,211.35605390104922,0.48574749150918134,0.8021007343022784,0.12126405997563014,1025604.1247547251,-6946.471865440308,1018657.6528892849,2837,0,334.3256880733945,66,152,42,39.1277943443687,0.5247993119266054,44.52736318407961,8029.072213269708,121.65260929196528,0
3023,31.390801065504327,2,6,207,0.009389671361502348,0.028169014084507043,0.971830985915493,213,7150,5000,2150,0.6993006993006993,93,50,43,197.42591824857507,0.4851708521569669,0.7824672887044395,0.11223109743376437,1021566.439293111,-9413.261534126077,1012153.1777589848,2838,0,342.4788732394366,83,130,39,39.841712033571504,0.5272398278560251,44.87847222222222,8008.469125999754,96.48757983132234,8
3024,31.81629259911834,4,3,208,0.018957345971563982,0.014218009478672985,0.985781990521327,211,7400,5100,2300,0.6891891891891891,97,51,46,198.2184233001526,0.48460561949898445,0.7815456210744876,0.11386268416912639,1038634.2422356305,-8424.711623700685,1030209.5306119298,2839,0,345.4691943127962,73,138,41,39.41714411635087,0.5313981042654028,44.48198198198201,8129.63602560811,111.3648770631248,0
3025,31.972455472385587,3,2,209,0.014218009478672985,0.009478672985781991,0.990521327014218,211,7400,5700,1700,0.7702702702702703,91,57,34,216.6125061344648,0.48452851124652074,0.8003553617504753,0.12321331593629935,1040685.4839518768,-4514.901844685037,1036170.5821071917,2840,0,345.77725118483414,81,130,41,39.32842710148535,0.5266093996840442,44.85518292682927,8157.606302881926,100.71118892446823,8
3026,31.956489961117015,0,5,204,0.0,0.023923444976076555,0.9760765550239234,209,6650,4400,2250,0.6616541353383458,89,44,45,219.2885687693494,0.4842293123543124,0.8016060804112004,0.12560922621139742,1042332.7714624827,-2735.667672920482,1039597.1037895622,2841,1,349.9856459330144,66,143,42,38.98869308497685,0.5284090909090908,44.58955223880597,8162.021409845007,123.66699105825768,0
3027,32.11396235704681,4,2,206,0.019230769230769232,0.009615384615384616,0.9903846153846154,208,5350,4000,1350,0.7476635514018691,67,40,27,227.8946355834181,0.48444951535984143,0.7993012329661238,0.1286433270022281,1042896.1964115748,584.0897265095882,1043480.2861380845,2842,0,341.4182692307692,78,130,35,39.33973165011036,0.5298477564102564,45.147679324894504,8184.317832766333,104.92715170213248,8
3028,32.06482885850315,2,0,208,0.009615384615384616,0.0,1.0,208,6000,3900,2100,0.65,81,39,42,230.03580921767167,0.48438951597918994,0.8076625145205549,0.1290389870066459,1039328.7432266221,216.5656982643536,1039545.3089248865,2843,0,342.32211538461536,67,141,41,39.53213053767321,0.523838141025641,45.389093137254896,8164.055154062197,121.85156946361488,8
3029,31.773197741838253,3,4,207,0.014218009478672985,0.018957345971563982,0.981042654028436,211,7900,5800,2100,0.7341772151898734,100,58,42,226.60933649535673,0.4845576619273302,0.8074590575227116,0.1285735326318572,1033415.6554855015,-3263.6727973033767,1030151.9826881981,2844,0,338.4407582938389,77,134,41,39.172295528327574,0.5273499210110584,44.951923076923066,8103.6929817524715,105.24276599678534,0
3030,31.390586005098765,2,4,205,0.009569377990430622,0.019138755980861243,0.9808612440191388,209,5900,4500,1400,0.7627118644067796,73,45,28,226.29362381792302,0.4841775549012391,0.8058025277500247,0.12936979936458437,1023282.060688245,-1387.5588597970154,1021894.501828448,2845,0,342.58851674641147,64,145,43,38.88535848030294,0.5291068580542264,44.66346153846153,8015.163570821124,125.23693079408007,0
3031,31.687477838052768,6,3,208,0.02843601895734597,0.014218009478672985,0.985781990521327,211,6200,4100,2100,0.6612903225806451,83,41,42,212.6753937892111,0.4844739712630708,0.7943812148108822,0.1231072581355892,1036775.5049289027,-4300.672243647403,1032474.8326852553,2846,0,338.09478672985784,72,139,43,38.75195236235845,0.5327310426540284,44.19235159817352,8105.899189537291,112.58193318801793,0
3032,31.693686547570852,1,7,202,0.004784688995215311,0.03349282296650718,0.9665071770334929,209,6500,4300,2200,0.6615384615384615,87,43,44,211.30659536608204,0.4839312277634646,0.7900030423743585,0.12301727117410223,1038725.0988643451,-4402.10716753524,1034322.9916968099,2847,0,342.1291866028708,77,132,39,38.56709570010258,0.5347388357256778,43.977029914529936,8114.311762867055,105.38067224502669,0
3033,32.12047034967514,2,2,202,0.00980392156862745,0.00980392156862745,0.9901960784313726,204,6200,4700,1500,0.7580645161290323,77,47,30,248.73654484044172,0.4836913213561287,0.8187391040332226,0.14628982455069406,1055845.6559779977,5525.480070551144,1061371.1360485489,2848,0,349.8186274509804,60,144,36,37.21861471861473,0.539828431372549,43.59631147540982,8235.807074801405,137.2634512466901,8
3034,32.416603131481516,2,4,200,0.00980392156862745,0.0196078431372549,0.9803921568627451,204,6800,4800,2000,0.7058823529411765,88,48,40,243.28551706719168,0.4837069166747159,0.8145649781420969,0.14416219485257878,1067900.2303892751,4360.9319452855,1072261.1623345606,2849,0,344.8970588235294,64,140,39,37.072589540280106,0.5425347222222222,43.317307692307686,8320.780967258634,130.01220261341615,0
3035,31.92492526501975,0,2,198,0.0,0.01,0.99,200,7050,5200,1850,0.7375886524822695,89,52,37,219.24545639120214,0.48325062814070346,0.7888261040621636,0.1248777902033244,1039553.5868145768,-1466.5198831456619,1038087.0669314311,2850,1,350.96,82,118,40,39.209165273269726,0.5310416666666666,44.80421686746986,8147.1063044541625,99.35495493236783,7
3036,32.031361641032746,1,2,197,0.005025125628140704,0.010050251256281407,0.9899497487437185,199,5350,3500,1850,0.6542056074766355,72,35,37,216.25647539627428,0.48320728220225706,0.7900276761136242,0.12272936351427849,1041888.2727811838,-86.98287432559891,1041801.2899068582,2851,0,352.9899497487437,68,131,39,39.426852125875506,0.5241310720268006,44.942632850241566,8169.834766383619,120.14462891740617,8
3037,31.733173641700642,1,1,197,0.005050505050505051,0.005050505050505051,0.9949494949494949,198,6550,4900,1650,0.7480916030534351,82,49,33,229.8915929366091,0.482746244167564,0.8005145457506693,0.13160266270588636,1034861.7694720612,1431.2041306261817,1036292.9736026874,2852,0,354.74747474747477,63,135,38,38.74148928260365,0.5271464646464646,44.61263020833335,8104.251751496201,128.6389166904159,8
3038,31.950222253166356,4,3,198,0.01990049751243781,0.014925373134328358,0.9850746268656716,201,6950,5000,1950,0.7194244604316546,89,50,39,220.9176680024154,0.4832431592039801,0.7944212109105349,0.1278718938638591,1045356.7450573648,-962.4451302663524,1044394.2999270984,2853,0,350.39303482587064,67,134,40,38.5430390043316,0.5297989220563848,44.19424019607843,8173.050879375384,121.98583402052812,0
3039,31.740095000647162,2,3,197,0.01,0.015,0.985,200,5700,3600,2100,0.631578947368421,78,36,42,214.34620991329018,0.48309935092127304,0.7872571476341754,0.12483005662038851,1040351.6362941924,-1100.9139566499343,1039250.7223375425,2854,0,352.93,72,128,38,38.47600735662934,0.5324479166666667,43.964041095890416,8126.60565919824,112.86952304441999,0
3040,31.43425144890106,2,2,197,0.010050251256281407,0.010050251256281407,0.9899497487437185,199,6300,4100,2200,0.6507936507936508,85,41,44,221.45164476190837,0.4832030522985297,0.794495049009712,0.12483837208722462,1020409.3860490851,-905.7326257879195,1019503.6534232971,2855,0,355.58793969849245,68,131,37,39.55667140656473,0.5209380234505863,45.19927536231886,8009.470047623107,117.78632422975159,8
3041,31.894072226171772,2,0,199,0.010050251256281407,0.0,1.0,199,5500,3900,1600,0.7090909090909091,71,39,32,219.81764508305903,0.48312374160364113,0.7936363799600354,0.12481819325151111,1037591.5103065264,316.18447075117274,1037907.6947772776,2856,0,356.38693467336685,71,128,41,39.31480772502979,0.5232935510887773,44.92187500000001,8135.480142066486,114.5842273530491,0
3042,31.81430883690393,2,1,200,0.009950248756218905,0.004975124378109453,0.9950248756218906,201,6400,4400,2000,0.6875,84,44,40,204.38670509628898,0.48340796019900495,0.7715470424915911,0.11450214296658297,1030802.7967172379,-4463.52255498468,1026339.2741622532,2857,0,353.83084577114425,73,128,43,40.23630465236308,0.5239427860696517,45.4391891891892,8098.676252907828,110.94077058777846,8
3043,31.754614669594137,2,1,201,0.009900990099009901,0.0049504950495049506,0.995049504950495,202,5700,4500,1200,0.7894736842105263,69,45,24,213.93071563845112,0.4834475518447367,0.7821814223447938,0.12160686561469028,1033389.0541732656,-1885.2680215542987,1031503.7861517112,2858,0,352.91089108910893,81,121,41,39.42280162326347,0.5309921617161717,44.880589430894304,8101.2185773559195,100.0150441648879,7
3044,32.03109149814511,2,4,199,0.009852216748768473,0.019704433497536946,0.9802955665024631,203,6750,4900,1850,0.725925925925926,86,49,37,214.6852417881149,0.483583703197906,0.784545078204447,0.12264650248737058,1043941.2410742487,-2526.2444494778338,1041414.9966247708,2859,0,352.1625615763547,71,132,42,39.209273058687984,0.5329946633825944,44.69039351851853,8177.845365563787,115.18092064174347,0
3045,31.627085244916014,2,2,199,0.009950248756218905,0.009950248756218905,0.9900497512437811,201,8050,5700,2350,0.7080745341614907,104,57,47,197.159831391561,0.4836380597014925,0.7675729410217169,0.11344692883859606,1032976.8829067444,-7517.6903869450125,1025459.1925197993,2860,0,356.30348258706465,77,124,40,39.378679416170286,0.5397491708126037,44.41773504273505,8083.322080892154,104.97820884275525,8
3046,31.165392497028765,2,3,198,0.009950248756218905,0.014925373134328358,0.9850746268656716,201,6100,3900,2200,0.639344262295082,83,39,44,196.97463002655735,0.48369713930348257,0.7661390124413907,0.11401201853534967,1019675.4762030826,-6129.960065548461,1013545.5161375342,2861,0,357.25373134328356,81,120,37,39.15589669099997,0.5414075456053068,44.19461382113823,7972.275263118307,98.4231513965223,0
3047,31.343117179727557,3,0,201,0.014925373134328358,0.0,1.0,201,6550,4800,1750,0.732824427480916,83,48,35,198.2855078562438,0.48320169983416256,0.7704407208334436,0.11221794628512664,1018651.3459986676,-6353.240106041996,1012298.1058926256,2862,0,358.2089552238806,84,117,38,39.993711145292565,0.53518864013267,45.04901960784311,7990.958453517715,95.13045777997279,8
3048,31.6828488491131,2,0,203,0.009852216748768473,0.0,1.0,203,6550,5000,1550,0.7633587786259542,81,50,31,211.45858847240734,0.4833916581313304,0.7825190330528127,0.11915137014590954,1028339.774591358,-3659.744558975879,1024680.0300323821,2863,0,355.66995073891627,75,128,35,39.82894229562284,0.5295053366174056,45.216557017543835,8072.265313269727,107.6302041769297,7
3049,31.593248079220327,8,1,210,0.037914691943127965,0.004739336492890996,0.995260663507109,211,6800,4900,1900,0.7205882352941176,87,49,38,226.95919789308277,0.4842200782366659,0.7965933038179027,0.1268505030740842,1022913.996079896,-2568.0519872198793,1020345.9440926762,2864,0,343.1469194312796,71,140,42,39.75407214736481,0.523054897314376,45.529513888888886,8039.549196548116,113.23308727532557,8
3050,31.87405980339606,6,8,208,0.027777777777777776,0.037037037037037035,0.962962962962963,216,6100,4800,1300,0.7868852459016393,74,48,26,223.34453911587295,0.4851066788687913,0.8001964829551031,0.12657981245743286,1036349.3518876209,-3007.406327924875,1033341.945559696,2865,0,336.1574074074074,76,140,36,39.2991821396994,0.5264756944444444,44.994588744588754,8128.057728544609,106.9481280071659,0
3051,32.294928184784176,3,4,207,0.014218009478672985,0.018957345971563982,0.981042654028436,211,6200,4300,1900,0.6935483870967742,81,43,38,249.801121418859,0.48466392086060334,0.8176349956447488,0.14308502817669555,1053367.558273351,4226.479464585713,1057594.0377379367,2866,0,343.5924170616114,61,150,42,38.20988466429854,0.5233511058451816,44.590053763440864,8248.445871389273,135.2204241211356,8
3052,31.829970809080706,1,1,207,0.004807692307692308,0.004807692307692308,0.9951923076923077,208,6150,4000,2150,0.6504065040650406,83,40,43,249.8849873549283,0.48471951257277346,0.8098881416022092,0.13953570769479787,1030290.8988355666,3740.84564548481,1034031.7444810515,2867,0,345.125,65,143,38,39.2070772077828,0.5177283653846154,45.56502525252527,8098.657819021339,124.59473567725136,8
3053,31.677201368486582,3,3,207,0.014285714285714285,0.014285714285714285,0.9857142857142858,210,6400,4500,1900,0.703125,83,45,38,244.73519543318315,0.4855215690742007,0.8091783068173715,0.1378997859796451,1028151.7985363547,1924.986269954783,1030076.7848063095,2868,0,342.7047619047619,70,140,35,38.981702752504866,0.5200396825396825,45.217136150234744,8070.808083408722,115.29725833441032,0
3054,31.485976244415802,3,4,206,0.014285714285714285,0.01904761904761905,0.9809523809523809,210,7200,5200,2000,0.7222222222222222,92,52,40,242.87517556576222,0.48523913951545533,0.808973381268838,0.1375293791806379,1023464.7891288757,514.8380690105569,1023979.6271978862,2869,0,343.4809523809524,74,136,38,38.835135454116305,0.5228670634920635,45.02777777777779,8028.0493318748295,108.48715313344364,0
3055,31.493865977890888,2,3,205,0.009615384615384616,0.014423076923076924,0.9855769230769231,208,7850,5900,1950,0.7515923566878981,98,59,39,217.73349769480575,0.4850291867954912,0.7931847055448555,0.11998995160691382,1015314.5459554467,-5236.402529741681,1010078.143425705,2870,0,346.4230769230769,76,132,39,40.54808204581778,0.512119391025641,46.07683982683981,7997.021975175984,105.22397335757874,8
3056,31.768417116887175,5,2,208,0.023809523809523808,0.009523809523809525,0.9904761904761905,210,7200,5200,2000,0.7222222222222222,92,52,40,255.56825700612572,0.48559751651856914,0.8248824751284574,0.14142061989322607,1025458.1411591889,3214.9099537589555,1028673.0511129479,2871,0,342.43333333333334,74,136,38,39.42310320323601,0.5127976190476191,45.91666666666666,8071.825315782398,109.07872048354592,7
3057,31.287174422477456,1,3,206,0.004784688995215311,0.014354066985645933,0.9856459330143541,209,7550,5500,2050,0.7284768211920529,96,55,41,248.42150613270292,0.48553091645196905,0.818773449859681,0.1383497323437092,1011901.8658682851,925.6371154984536,1012827.5029837835,2872,0,344.1387559808612,62,147,38,39.34983530533523,0.5154505582137161,45.66798941798943,7957.329976298775,128.3440318757867,0
3058,31.14945014087255,5,2,209,0.023696682464454975,0.009478672985781991,0.990521327014218,211,6600,4900,1700,0.7424242424242424,83,49,34,239.99367496044212,0.48606785526216806,0.8163002188450181,0.13567959247763664,1012037.4156349917,-223.4842848577955,1011813.931350134,2873,0,341.2417061611374,69,142,37,38.97158980346372,0.5195003949447077,45.08928571428573,7940.328585017098,115.077225869813,0
3059,31.383444602735604,3,4,208,0.014150943396226415,0.018867924528301886,0.9811320754716981,212,6800,4800,2000,0.7058823529411765,88,48,40,238.34072747276767,0.4861303615607023,0.817763265086193,0.13623307730050546,1022995.7554032225,-435.68949112832206,1022560.0659120942,2874,0,340.45283018867923,59,153,38,38.58458840461462,0.5226022012578616,44.67013888888891,8013.130551604762,135.81577206109768,0
3060,31.06331802265226,3,2,209,0.014218009478672985,0.009478672985781991,0.990521327014218,211,7250,5800,1450,0.8,87,58,29,238.604665233447,0.4861205145565335,0.8176459164385854,0.13806741232727754,1016247.4609199576,-953.7229585705209,1015293.737961387,2875,0,342.3744075829384,63,148,41,38.10235853058453,0.52586887835703,44.20572916666667,7945.818783268287,126.12410767092518,0
3061,31.303976384355227,1,4,206,0.004761904761904762,0.01904761904761905,0.9809523809523809,210,6150,4100,2050,0.6666666666666666,82,41,41,236.60747241217362,0.48578501177185385,0.816211754570082,0.13795262577348333,1026401.727936833,420.8637053241755,1026822.5916421572,2876,0,344.04761904761904,66,144,37,37.86199987857445,0.5285218253968254,43.921019900497505,8016.290345564581,121.45894462976638,0
3062,31.242475726794957,1,1,206,0.004830917874396135,0.004830917874396135,0.9951690821256038,207,5750,3600,2150,0.6260869565217392,79,36,43,235.7376138812724,0.48563720432124824,0.8128051233060622,0.13813905988493266,1025892.9351465626,1218.3105258210026,1027111.2456723837,2877,0,348.719806763285,59,148,41,37.69145326649052,0.5302938808373592,43.73263888888888,8006.426809083667,135.70214930650283,0
3063,31.23680246685377,3,2,207,0.014354066985645933,0.009569377990430622,0.9904306220095693,209,7000,5200,1800,0.7428571428571429,88,52,36,221.4923654575973,0.4852567936449515,0.8001956388871916,0.12941548279320858,1024838.233992352,-3401.231068329186,1021437.0029240228,2878,0,346.35406698564594,79,130,39,38.16742277910504,0.5356858054226475,43.84114583333335,8001.583527739811,101.28586743974444,8
3064,31.501329674850812,4,1,210,0.018957345971563982,0.004739336492890996,0.995260663507109,211,6300,4100,2200,0.6507936507936508,85,41,44,221.52935332148232,0.4849826976604228,0.8045061337018176,0.1310214317243757,1037179.4238127773,-2546.862592881591,1034632.5612198957,2879,0,343.71090047393363,68,143,39,37.7029650547123,0.5383096366508688,43.38768115942029,8083.629254425035,118.87690080036816,0
3065,31.694990838310723,2,1,211,0.009433962264150943,0.0047169811320754715,0.9952830188679245,212,7700,5600,2100,0.7272727272727273,98,56,42,212.629410012594,0.4851872447762973,0.7992461207882287,0.12144214349794012,1032911.4659726899,-6174.528878996715,1026736.9370936932,2880,0,342.8679245283019,67,145,35,39.27132085283411,0.5331662735849056,44.69975490196079,8091.738929400839,120.77222282687819,8
3066,32.107260413527094,3,4,210,0.014018691588785047,0.018691588785046728,0.9813084112149533,214,7850,5600,2250,0.7133757961783439,101,56,45,201.82990076806814,0.48532269682477,0.7892462650780936,0.11645610919794173,1049519.0737157227,-8285.133899551967,1041233.9398161707,2881,0,340.6261682242991,73,141,39,39.15253615209576,0.5358742211838006,44.313063063063076,8209.407068571343,112.45763107631977,0
3067,31.905216181015376,1,3,208,0.004739336492890996,0.014218009478672985,0.985781990521327,211,6750,4600,2150,0.6814814814814815,89,46,43,177.94813869980774,0.4850409990220417,0.7588652854087146,0.10287885414133115,1043521.5320170929,-11811.45713687712,1031710.0748802158,2882,0,345.5118483412322,80,131,47,39.687458098685994,0.5346563981042654,44.23868312757203,8160.120105556029,102.00150131945036,8
3068,31.75248935414682,4,5,207,0.018867924528301886,0.02358490566037736,0.9764150943396226,212,6550,4300,2250,0.6564885496183206,88,43,45,178.95886139277155,0.48465118185340844,0.7602524029563176,0.1044076573251304,1041302.510879601,-11679.937657510161,1029622.5732220908,2883,0,344.54716981132077,84,128,41,39.31386974830131,0.5373427672955975,43.89705882352944,8131.905913271648,96.80840372942438,0
3069,31.368608057013585,1,6,202,0.004807692307692308,0.028846153846153848,0.9711538461538461,208,7200,5200,2000,0.7222222222222222,92,52,40,187.20478888496132,0.48413016381766383,0.7671791448888128,0.10946466214576767,1029390.7762714309,-10258.623409595633,1019132.1528618352,2884,0,352.1057692307692,82,126,42,39.01680301768482,0.538261217948718,43.81275100401609,8036.237402959646,98.00289515804447,0
3070,31.71050124827514,1,3,200,0.0049261083743842365,0.014778325123152709,0.9852216748768473,203,6100,4200,1900,0.6885245901639344,80,42,38,224.96030205984323,0.48388650441398817,0.8023712939410865,0.12989332907960027,1036764.2894030951,-53.83845820408669,1036710.4509448911,2885,0,360.32512315270935,65,138,42,38.53408015471343,0.5298132183908046,44.286616161616166,8108.799577407741,124.75076272934986,8
3071,31.955220936601012,1,1,200,0.004975124378109453,0.004975124378109453,0.9950248756218906,201,6350,4700,1650,0.7401574803149606,80,47,33,227.42461370218084,0.48364842454394696,0.8031889399677317,0.13197790574685636,1046313.5007301712,1041.4887429872228,1047354.9894731585,2886,0,364.2835820895522,65,136,39,38.27736318407961,0.5323383084577115,44.09722222222223,8177.4298021788145,125.80661234121253,0
3072,31.487051008669212,4,0,204,0.0196078431372549,0.0,1.0,204,5750,4200,1550,0.7304347826086957,73,42,31,226.75392592062883,0.48386035448662224,0.7974385578565497,0.12961366382870426,1026381.1894986798,-2.80715801828228,1026378.3823406616,2887,0,359.88235294117646,67,137,38,38.8793896488281,0.5301266339869282,44.6691176470588,8039.616516735518,119.99427636918684,7
3073,31.79224105199176,1,3,202,0.004878048780487805,0.014634146341463415,0.9853658536585366,205,7100,5200,1900,0.7323943661971831,90,52,38,235.47563798254632,0.4839271480950103,0.8101563154806801,0.13435962873121746,1035779.7647444255,680.1801825210323,1036459.9449269465,2888,0,359.1219512195122,56,149,39,38.726016609392865,0.5290650406504065,44.73684210526315,8115.387847482097,144.91764013360887,7
3074,31.898267012934816,1,2,201,0.0049261083743842365,0.009852216748768473,0.9901477832512315,203,5850,3700,2150,0.6324786324786325,80,37,43,230.97255295543636,0.483687346567169,0.8001371444706074,0.12894867670712104,1032437.5038516484,1242.9452063108147,1033680.4490579593,2889,0,363.064039408867,63,140,43,39.69634936881613,0.5216030377668308,45.57291666666668,8115.783039488905,128.8219530077604,8
3075,32.31171750377256,5,2,204,0.024271844660194174,0.009708737864077669,0.9902912621359223,206,6750,4700,2050,0.6962962962962963,88,47,41,224.14074580112197,0.483960849317231,0.7973268635240827,0.12690288487546636,1050261.07867098,-868.7397081589979,1049392.338962821,2890,0,352.47087378640776,68,138,38,39.31836797126335,0.5251820388349515,45.03321256038649,8238.414808593252,121.15315894990077,0
3076,32.55232702959532,4,1,207,0.019230769230769232,0.004807692307692308,0.9951923076923077,208,6650,4300,2350,0.6466165413533834,90,43,47,215.10331009372342,0.4838011349560263,0.7899971848405962,0.12295411428814097,1061105.9171081928,-2600.520973998241,1058505.3961341945,2891,0,348.77403846153845,67,141,37,39.17686585073195,0.5285456730769231,44.66911764705883,8311.614383108092,124.05394601653869,0
3077,32.07109150811453,3,2,208,0.014285714285714285,0.009523809523809525,0.9904761904761905,210,6400,4500,1900,0.703125,83,45,38,213.95430048749773,0.4840325244930508,0.7975248540465918,0.12126791322588289,1042781.3820550536,-3778.4877682048027,1039002.8942868488,2892,0,346.37619047619046,72,138,42,39.53542051368137,0.5308035714285715,44.991438356164394,8178.402915832148,113.58892938655761,8
3078,31.83309764943863,3,4,207,0.014218009478672985,0.018957345971563982,0.981042654028436,211,7800,5800,2000,0.7435897435897436,98,58,40,209.18388734589416,0.48427179718648916,0.7937121078660967,0.11954913354534703,1037605.9107667181,-6589.912410548573,1031015.9983561696,2893,0,345.3127962085308,62,149,40,39.33495769114537,0.5334715639810427,44.675925925925895,8127.756182252442,131.09284164923295,0
3079,31.6174237277536,2,5,204,0.009569377990430622,0.023923444976076555,0.9760765550239234,209,5900,3700,2200,0.6271186440677966,81,37,44,206.04697390067395,0.48394943871917556,0.7874945152403583,0.11880211917330502,1033283.1531708072,-5119.0266213220475,1028164.1265494851,2894,0,349.0956937799043,66,143,46,39.07301548690504,0.5364832535885167,44.340796019900466,8083.2853821389335,122.47402094149899,0
3080,32.0058150654609,5,5,204,0.023923444976076555,0.023923444976076555,0.9760765550239234,209,7000,5300,1700,0.7571428571428571,87,53,34,210.94140890278842,0.4839446463624095,0.7922325349199721,0.11845375655378128,1037749.3900884034,-5019.136313348425,1032730.2537750549,2895,0,349.48325358851673,72,137,42,39.97651201016102,0.5269637161084529,45.34817351598174,8150.339264529341,113.1991564517964,8
3081,32.220435958503316,3,2,205,0.014492753623188406,0.00966183574879227,0.9903381642512077,207,6150,4500,1650,0.7317073170731707,78,45,33,207.61622277416,0.48341619373700423,0.7877675450981809,0.11755067986964039,1047303.6005490387,-4062.556471246007,1043241.0440777927,2896,0,352.7632850241546,77,130,41,39.73850303792163,0.5303442028985508,45.03205128205129,8215.178463137652,106.69062939139808,0
3082,32.28272417591615,2,1,206,0.00966183574879227,0.004830917874396135,0.9951690821256038,207,6100,4000,2100,0.6557377049180327,82,40,42,210.16971271288432,0.48357155699388704,0.7908777031923131,0.11984865787247029,1051571.8714040783,-3298.288378011126,1048273.5830260672,2897,0,353.7294685990338,64,143,43,39.395235553881236,0.5324074074074074,44.759615384615365,8239.854935093173,128.74773336083084,0
3083,32.73137245557393,0,2,204,0.0,0.009708737864077669,0.9902912621359223,206,6950,5200,1750,0.7482014388489209,87,52,35,226.057671125106,0.4834754124240272,0.8065385085942804,0.12625793400138552,1059537.8168865484,-246.66972912964047,1059291.1471574188,2898,1,356.42233009708735,63,143,42,39.80475329964395,0.5215412621359223,45.556640625,8328.28036455057,132.19492642143763,8
3084,32.367398329368406,2,3,203,0.009708737864077669,0.014563106796116505,0.9854368932038835,206,6200,4500,1700,0.7258064516129032,79,45,34,229.66056140164443,0.4835814784118715,0.8049206719538775,0.12848821006386466,1048295.7912443577,750.4399864322468,1049046.23123079,2899,0,357.3203883495146,69,137,39,39.64600508682686,0.5235133495145632,45.491071428571445,8237.791869452241,119.38828796307597,8
3085,32.527474585883844,2,3,202,0.00975609756097561,0.014634146341463415,0.9853658536585366,205,7250,5300,1950,0.7310344827586207,92,53,39,224.55843373279404,0.48318687230989954,0.7961171673582566,0.12656816550925007,1055843.0039138065,-830.3097546775198,1055012.694159129,2900,0,359.81463414634146,82,123,36,39.484205168620505,0.5319105691056911,45.20582329317269,8287.811107462527,101.07086716417716,8
3086,32.460208361953576,2,3,201,0.00980392156862745,0.014705882352941176,0.9852941176470589,204,7450,5300,2150,0.7114093959731543,96,53,43,222.25569075611966,0.4834976375607714,0.7927347305139234,0.12678472399812657,1057462.8970579244,-1244.5706730846568,1056218.3263848398,2901,0,362.3970588235294,68,136,38,39.07321977762007,0.5374285130718954,44.7463768115942,8285.585793839236,121.84684990940053,8
3087,32.71218597586183,5,3,203,0.024271844660194174,0.014563106796116505,0.9854368932038835,206,6400,4600,1800,0.71875,82,46,36,214.35476242537874,0.4836100915620807,0.7935452118431023,0.12153861839751569,1063741.151283846,-1996.4036468906588,1061744.7476369552,2902,0,359.41747572815535,83,123,39,39.51115365912953,0.5345368122977346,44.977678571428555,8342.337606567404,100.5100916453904,8
3088,33.14023011133873,3,3,203,0.014563106796116505,0.014563106796116505,0.9854368932038835,206,7400,5800,1600,0.7837837837837838,90,58,32,202.70450162000287,0.48291696266477224,0.7756755222671448,0.11347471579828412,1073519.7849104714,-5078.541404102403,1068441.243506369,2903,0,360.13592233009706,76,130,40,40.30859686420407,0.5277103559870551,45.46807359307357,8435.246611807817,110.99008699747128,8
3089,33.52823890002192,7,5,205,0.03333333333333333,0.023809523809523808,0.9761904761904762,210,6700,4700,2000,0.7014925373134329,87,47,40,219.3121800284726,0.48272575377838534,0.7962916753309772,0.12388849334815208,1089062.3151710113,-931.0738945981302,1088131.2412764132,2904,0,354.1666666666667,72,138,39,39.53003116485648,0.5237103174603175,45.11986301369862,8545.682123747001,118.69002949648613,8
3090,33.41632974390675,1,1,205,0.0048543689320388345,0.0048543689320388345,0.9951456310679612,206,7200,5500,1700,0.7638888888888888,89,55,34,220.31913092438273,0.4822144604941195,0.7917645668011402,0.12227067558318035,1079611.8457159929,-828.1712832369903,1078783.674432756,2905,0,361.84466019417476,69,137,41,40.203137805877496,0.5207322006472492,45.80357142857141,8494.311676866258,123.10596633139505,8
3091,33.11631819389937,3,0,208,0.014423076923076924,0.0,1.0,208,7150,4400,2750,0.6153846153846154,99,44,55,228.50512916151683,0.48247776151988103,0.802509222256379,0.1266315477278389,1069449.3932333582,124.93434649893788,1069574.327579857,2906,0,358.9567307692308,79,129,40,40.052131365918655,0.5223858173076923,45.859375,8416.201803496455,106.53420004425892,8
3092,33.4514260259893,4,3,209,0.018867924528301886,0.014150943396226415,0.9858490566037735,212,7150,5100,2050,0.7132867132867133,92,51,41,235.21835527401603,0.4832437255953978,0.8155284111536825,0.1280899141181896,1074462.5916336037,996.6647215023922,1075459.2563551061,2907,0,353.16509433962267,65,147,41,40.58179992527554,0.511694182389937,46.543560606060595,8478.479333196978,130.4381435876458,8
3093,32.99255763928894,4,2,211,0.018779342723004695,0.009389671361502348,0.9906103286384976,213,6750,4600,2150,0.6814814814814815,89,46,43,224.61606984824033,0.48362989783565125,0.8090652697711651,0.12382101940880322,1063730.838373919,-1563.7919416155473,1062167.0464323035,2908,0,350.15962441314554,71,142,40,40.36102248556669,0.5147691705790297,46.064814814814795,8377.971233865688,117.99959484317871,0
3094,33.19118036987631,6,4,213,0.027649769585253458,0.018433179723502304,0.9815668202764977,217,7350,5100,2250,0.6938775510204082,96,51,45,211.63665681268435,0.4842478807532571,0.8036186447080147,0.11736214605067073,1072086.6506624138,-5371.433088059548,1066715.2175743543,2909,0,344.6175115207373,71,146,40,40.45423497267758,0.5148809523809523,45.83333333333334,8436.091677343584,118.81819263864203,8
3095,33.20383271593731,5,2,216,0.022935779816513763,0.009174311926605505,0.9908256880733946,218,6800,4500,2300,0.6617647058823529,91,45,46,201.48777539324507,0.48469230471117125,0.7949858675279109,0.11311872744518456,1076517.808288802,-7018.964327335284,1069498.8439614666,2910,0,343.8302752293578,69,149,45,40.22640057659344,0.5184919724770642,45.357142857142875,8455.118830879792,122.53795407072163,0
3096,33.17349859144952,6,4,218,0.02702702702702703,0.018018018018018018,0.9819819819819819,222,8350,5600,2750,0.6706586826347305,111,56,55,188.02677842013443,0.4849378507466742,0.7798232036164681,0.10617498101322753,1077415.958456271,-12233.3896626053,1065182.5687936659,2911,0,338.55855855855856,78,144,38,40.342339662338105,0.5249155405405406,45.13449367088607,8454.78051521792,108.39462198997334,8
3097,33.45681453840267,4,4,218,0.018018018018018018,0.018018018018018018,0.9819819819819819,222,7000,4400,2600,0.6285714285714286,96,44,52,210.09217018475985,0.48523721685486393,0.8018142606125429,0.11599875747168091,1079225.2199429877,-6052.6462848102765,1073172.5736581774,2912,0,339.490990990991,85,137,37,40.66662692735656,0.5188626126126126,46.00290697674421,8497.933634572539,99.97568981850046,7
3098,33.09706716749733,4,4,218,0.018018018018018018,0.018018018018018018,0.9819819819819819,222,6700,4300,2400,0.6417910447761194,91,43,48,208.0430193346191,0.4848062145856264,0.8040549255241634,0.11684899915500152,1073195.2884765984,-6445.842369928074,1066749.4461066704,2913,0,339.8288288288288,73,149,42,40.04264321117311,0.526417042042042,45.340653153153156,8428.4775074211,115.45859599206986,8
3099,32.63422604589664,5,2,221,0.02242152466367713,0.008968609865470852,0.9910313901345291,223,7500,4900,2600,0.6533333333333333,101,49,52,197.30375897483998,0.4849041866979087,0.7892403861965511,0.11065778527433011,1057726.6767181777,-10361.31014310801,1047365.3665750697,2914,0,337.39461883408075,80,143,40,40.372659696265636,0.5271393871449925,45.3960905349794,8308.80153365042,103.86001917063024,8
3100,32.55549530956587,0,7,214,0.0,0.03167420814479638,0.9683257918552036,221,6750,4700,2050,0.6962962962962963,88,47,41,202.5156560633032,0.4846333813245578,0.7961357234709967,0.11183629288954615,1050210.9649525734,-8413.167485551072,1041797.7974670223,2915,1,341.42986425339365,76,145,41,40.851685662547965,0.5159785067873304,45.995670995670984,8269.236741509823,108.80574659881347,8
3101,32.43525529803669,2,6,210,0.009259259259259259,0.027777777777777776,0.9722222222222222,216,6450,4600,1850,0.7131782945736435,83,46,37,202.6453766874727,0.4842265109101349,0.7921485943775102,0.11273167737976031,1048680.5412327081,-7147.947339415003,1041532.5938932932,2916,0,349.7962962962963,67,149,45,40.55773092369478,0.5183738425925926,45.71078431372549,8247.93563032183,123.10351687047508,0
3102,32.32785117026699,3,5,208,0.014084507042253521,0.023474178403755867,0.9765258215962441,213,6800,4300,2500,0.6323529411764706,93,43,50,201.85005429240775,0.48415492957746475,0.7887585316096621,0.11341099603285205,1048365.598507074,-7077.469404610842,1041288.1291024633,2917,0,349.1079812206573,71,142,42,40.18639105076786,0.5221537558685446,45.326967592592595,8233.031888747255,115.95819561615852,0
3103,31.97514816820465,2,2,208,0.009523809523809525,0.009523809523809525,0.9904761904761905,210,6150,4000,2150,0.6504065040650406,83,40,43,203.6116829004948,0.4840054682159945,0.7857046883247747,0.11501935104265183,1038614.9119206653,-5855.173979656662,1032759.7379410086,2918,0,353.6666666666667,72,138,38,39.93020565072967,0.5242063492063492,45.11986301369864,8149.830145269312,113.19208535096267,0
3104,32.36210834950368,5,0,213,0.023474178403755867,0.0,1.0,213,7750,5700,2050,0.7354838709677419,98,57,41,196.85756247104916,0.484396684087755,0.7824121029832771,0.1125641924149877,1055015.4433056796,-8812.446292305962,1046202.9970133736,2919,0,349.6244131455399,68,145,43,39.62915336407711,0.5279244913928012,44.65579710144929,8263.476760620577,121.52171706794967,0
3105,32.164465014703474,8,2,219,0.03619909502262444,0.00904977375565611,0.9909502262443439,221,7300,5400,1900,0.7397260273972602,92,54,38,222.77424400199038,0.4854226655697244,0.8132767028472552,0.12521448887008443,1043185.6335152077,-5021.021827982366,1038164.6116872253,2920,0,337.9321266968326,71,150,41,39.63871847307433,0.5230957767722473,45.31250000000001,8191.887183432305,115.37869272439866,8
3106,32.02793119576805,2,5,216,0.00904977375565611,0.02262443438914027,0.9773755656108597,221,6800,4800,2000,0.7058823529411765,88,48,40,199.17600764592885,0.485857157548334,0.7861396725143306,0.11111830110958978,1036410.9243266577,-9714.36196239836,1026696.5623642593,2921,0,336.0135746606335,75,146,44,40.5332978646984,0.5213989441930618,45.60032894736839,8147.895160699632,108.63860214266175,8
3107,31.697043855078842,6,4,218,0.02702702702702703,0.018018018018018018,0.9819819819819819,222,7550,5600,1950,0.7417218543046358,95,56,39,193.71297545536694,0.48621811857105973,0.7827058326150902,0.10775179497135043,1024781.7976828463,-12247.293755671648,1012534.5039271747,2922,0,334.7927927927928,78,144,41,40.788825512055986,0.5227102102102101,45.71466244725735,8060.093496112736,103.33453200144534,8
3108,31.62807934382303,5,7,216,0.02242152466367713,0.03139013452914798,0.968609865470852,223,7250,5000,2250,0.6896551724137931,95,50,45,201.71263323125385,0.4859915969781441,0.7896166627575112,0.11316301416895662,1025205.0171183321,-10490.639279034098,1014714.377839298,2923,0,334.21973094170403,78,145,45,40.24911531158292,0.5257380418535127,45.38502109704639,8052.982754868389,103.24336865215884,8
3109,31.697837551674013,3,7,212,0.0136986301369863,0.0319634703196347,0.9680365296803652,219,6900,4600,2300,0.6666666666666666,92,46,46,203.9298204556411,0.4856852107857512,0.7877580165728428,0.11553720818532533,1030514.3364797749,-8669.479276943093,1021844.8572028318,2924,0,332.716894977169,81,138,40,39.80756696391505,0.5283961187214612,45.007621951219505,8082.706976305273,99.78650588031202,0
3110,31.503895799341407,2,1,213,0.009345794392523364,0.004672897196261682,0.9953271028037384,214,6450,4200,2250,0.6511627906976745,87,42,45,208.35383833872316,0.4855114592017317,0.7902780751774425,0.11859164013720506,1025630.6996378662,-6511.181402483887,1019119.5182353824,2925,0,338.23364485981307,79,135,43,39.51417946624484,0.5304711838006231,44.83072916666668,8038.826119527288,101.75729265224415,0
3111,31.238943504357707,2,2,213,0.009302325581395349,0.009302325581395349,0.9906976744186047,215,6700,5200,1500,0.7761194029850746,82,52,30,220.34434926044483,0.48534648264869956,0.8061649502776225,0.12512311268677673,1016292.7973871978,-4913.124980327856,1011379.6724068699,2926,0,337.6279069767442,72,143,42,39.29954967554265,0.5276162790697674,44.92009132420093,7968.426856220053,110.67259522527851,8
3112,30.952566165972453,2,2,213,0.009302325581395349,0.009302325581395349,0.9906976744186047,215,5900,3900,2000,0.6610169491525424,79,39,40,217.24524566679446,0.4851028761863363,0.8038358987337211,0.12394058028839477,1008382.2053187867,-5086.75201589941,1003295.4533028873,2927,0,338.5348837209302,62,153,43,39.19670617955697,0.5294573643410853,44.74206349206348,7900.8881691514725,127.43368014760439,0
3113,31.504267736736576,2,1,214,0.009302325581395349,0.004651162790697674,0.9953488372093023,215,6350,5000,1350,0.7874015748031497,77,50,27,205.83856302104266,0.4849172281388104,0.7910597214521033,0.11556133498740447,1021415.3753225172,-7300.665379202654,1014114.7099433145,2928,0,339.4186046511628,69,146,45,40.11561087735705,0.5275678294573644,45.35714285714287,8022.336748676153,116.26574998081381,7
3114,31.732389837680188,3,3,214,0.013824884792626729,0.013824884792626729,0.9861751152073732,217,7250,5100,2150,0.7034482758620689,94,51,43,203.30030645035498,0.48511282499857766,0.7888979362416724,0.11541298695396615,1032261.3288495116,-8678.191101608347,1023583.1377479032,2929,0,337.2672811059908,74,143,44,39.74498593338782,0.5304339477726574,44.93055555555559,8093.963046791707,109.37787901069873,0
3115,31.77043147033172,5,1,218,0.0228310502283105,0.0045662100456621,0.995433789954338,219,7050,4900,2150,0.6950354609929078,92,49,43,197.89156127753523,0.48500446846243,0.7855113907409392,0.11253494712474708,1034028.5504286345,-9924.895150026288,1024103.6552786082,2930,0,334.5981735159817,84,135,43,39.81629361000366,0.534341704718417,44.86519607843136,8105.742803686687,96.49693813912722,8
3116,32.13182371528918,4,0,222,0.018018018018018018,0.0,1.0,222,6650,4500,2150,0.6766917293233082,88,45,43,196.09724151500228,0.48505420012772954,0.785195628591024,0.11272797094564221,1049165.827378785,-9902.295071842731,1039263.5323069423,2931,0,330.9864864864865,73,149,41,39.442638904190126,0.537302927927928,44.45382882882886,8211.164523189258,112.48170579711312,0
3117,32.525073730790304,4,4,222,0.017699115044247787,0.017699115044247787,0.9823008849557522,226,7600,5300,2300,0.6973684210526315,99,53,46,210.95414732721832,0.48524541134054405,0.8004822714434154,0.1208899597044909,1061021.1644842846,-8034.636990016945,1052986.5274942676,2932,0,326.1106194690266,75,151,40,39.184016598697895,0.5331397492625369,44.57236842105264,8307.802549986414,110.77070066648552,8
3118,32.371653135467355,1,3,220,0.004484304932735426,0.013452914798206279,0.9865470852017937,223,6550,5000,1550,0.7633587786259542,81,50,31,210.61445163917026,0.4850312756702891,0.7990287822892606,0.12137036934472736,1057763.861104912,-6593.928885931209,1051169.9322189807,2933,0,330.90582959641256,74,149,37,38.97698667101307,0.5351270553064276,44.361111111111136,8275.453439047447,111.83045187901956,0
3119,31.971082980287786,2,6,216,0.009009009009009009,0.02702702702702703,0.972972972972973,222,6450,4600,1850,0.7131782945736435,83,46,37,214.76974539845617,0.48467500305735595,0.8029186887454602,0.12378398432819376,1044722.5365881005,-5975.041360988572,1038747.495227112,2934,0,333.036036036036,73,149,41,38.86481792485732,0.5361298798798799,44.35529279279282,8173.238147593048,111.96216640538422,8
3120,32.45438139755533,5,4,217,0.02262443438914027,0.01809954751131222,0.9819004524886877,221,7350,4900,2450,0.6666666666666666,98,49,49,217.67535747888354,0.4844097079391197,0.8067777942916159,0.1239455251720298,1056697.282955365,-5546.6082371453585,1051150.6747182196,2935,0,335.3348416289593,85,136,39,39.261162268210896,0.5309671945701357,44.81589147286821,8281.842384734662,97.43343982040778,8
3121,32.45207640440193,2,4,215,0.0091324200913242,0.0182648401826484,0.9817351598173516,219,7200,5200,2000,0.7222222222222222,92,52,40,210.66950656334095,0.4842085235920852,0.7982637826034182,0.12082457855377444,1058894.379122718,-6384.648729504136,1052509.730393214,2936,0,338.06392694063925,74,145,41,39.15993856358398,0.5339136225266362,44.541666666666686,8290.15335147455,112.02909934425067,0
3122,32.6348516057977,2,3,214,0.009216589861751152,0.013824884792626729,0.9861751152073732,217,7050,5000,2050,0.7092198581560284,91,50,41,208.564859147011,0.484133206747454,0.7948021432382504,0.11635624738886848,1056050.6237910683,-6398.990079380727,1049651.6337116875,2937,0,338.52073732718895,75,142,40,40.294445791354605,0.5247695852534562,45.6003289473684,8302.295513366342,110.69727351155122,8
3123,32.814290842845246,5,1,218,0.0228310502283105,0.0045662100456621,0.995433789954338,219,6800,4900,1900,0.7205882352941176,87,49,38,202.46158071701868,0.4840575384357589,0.7900950110371749,0.11412834290788879,1065194.2932427404,-7467.815923865859,1057726.4773188746,2938,0,336.0913242009132,83,136,45,40.04218985740006,0.5283485540334856,45.200892857142826,8361.05200828292,100.73556636485446,0
3124,33.10468825612685,5,2,221,0.02242152466367713,0.008968609865470852,0.9910313901345291,223,6600,4600,2000,0.696969696969697,86,46,40,204.78316198300456,0.48467694151550655,0.7934953218765028,0.11438679522902825,1071653.9530983584,-7308.662986586826,1064345.2901117716,2939,0,329.8340807174888,77,146,42,40.34223613079302,0.524103139013453,45.552884615384585,8423.392432478357,109.39470691530333,8
3125,33.146543391523466,2,1,222,0.008968609865470852,0.004484304932735426,0.9955156950672646,223,6800,4400,2400,0.6470588235294118,92,44,48,200.47690673320045,0.48490671164437976,0.7879038413034296,0.11257296362499988,1074723.2053795743,-8308.563238222809,1066414.6421413515,2940,0,329.60538116591925,83,140,42,40.244551984416795,0.5261117339312407,45.34970238095236,8440.77713969407,101.69611011679602,0
3126,33.27508258246565,2,4,220,0.008928571428571428,0.017857142857142856,0.9821428571428571,224,7150,5400,1750,0.7552447552447552,89,54,35,202.078447693872,0.48459896500640615,0.7927960146774728,0.11445379314065561,1081693.5778775034,-8232.608180417305,1073460.9696970861,2941,0,329.08482142857144,86,138,37,39.86654379539189,0.5288783482142857,45.01915708812257,8484.508604839319,98.65707680045719,0
3127,33.573534818126156,1,2,219,0.004524886877828055,0.00904977375565611,0.9909502262443439,221,7000,4600,2400,0.6571428571428571,94,46,48,202.28280927878563,0.48425287947346773,0.7919007797534352,0.11515149463793825,1093052.851812079,-6978.839689053017,1086074.012123026,2942,0,332.89592760180994,91,130,38,39.663895298102354,0.5311085972850679,44.825634057971,8567.10545964794,94.14401604008727,0
3128,33.23262241068658,4,4,219,0.017937219730941704,0.017937219730941704,0.9820627802690582,223,7550,5800,1750,0.7682119205298014,93,58,35,207.1553506430325,0.48451029504841164,0.8014351815843856,0.11560859540011784,1075503.6876706139,-7590.7312925440765,1067912.9563780697,2943,0,330.7937219730942,71,152,38,40.31709079708084,0.5248038116591929,45.587384259259245,8454.798395427106,119.08166754122684,8
3129,33.64186474680846,3,3,219,0.013513513513513514,0.013513513513513514,0.9864864864864865,222,6600,4400,2200,0.6666666666666666,88,44,44,208.65567998435148,0.48451958746076396,0.801382609074917,0.11761398092507858,1092041.627883935,-5427.862312531915,1086613.765571403,2944,0,333.1936936936937,75,147,42,39.88636363636364,0.5290915915915916,45.20285087719298,8571.851228661852,114.29134971549135,8
3130,33.54093175935701,4,7,216,0.017937219730941704,0.03139013452914798,0.968609865470852,223,6900,4600,2300,0.6666666666666666,92,46,46,211.09571300937372,0.48468956624786225,0.8030804714289768,0.11906347324658212,1088969.5071174146,-5524.641089916467,1083444.8660274982,2945,0,332.31390134529147,77,146,39,39.799789930646554,0.5278400597907325,45.178952991453,8546.935348561607,110.99916037092996,8
3131,33.38904773724272,3,5,214,0.0136986301369863,0.0228310502283105,0.9771689497716896,219,6600,4200,2400,0.6363636363636364,90,42,48,212.39831436521177,0.4840488109700753,0.8033897444777522,0.12085838593224471,1086908.205140881,-4228.5058716720405,1082679.699269209,2946,0,339.2511415525114,82,137,39,39.42235174528222,0.530726788432268,44.8418674698795,8519.48706759386,103.89618375114463,0
3132,33.114089205052316,3,3,214,0.013824884792626729,0.013824884792626729,0.9861751152073732,217,6250,4600,1650,0.736,79,46,33,244.25994322517494,0.48383718780224155,0.812359396084221,0.13764336775764915,1074815.8517140504,2856.8917834387794,1077672.7434974893,2947,0,341.4147465437788,73,144,40,38.990561694290975,0.5264496927803379,45.213963963963984,8437.00752549902,115.5754455547811,8
3133,33.33842850289689,3,4,213,0.013824884792626729,0.018433179723502304,0.9815668202764977,217,7650,5200,2450,0.6797385620915033,101,52,49,238.8526748140472,0.48372695852534564,0.8091198665385395,0.13581536874852027,1085031.0830806708,782.5152900400499,1085813.5983707109,2948,0,342.2764976958525,80,137,38,38.77495085437778,0.5295698924731183,44.86882716049382,8505.672364570086,106.32090455712607,0
3134,32.83665261110675,2,4,211,0.009302325581395349,0.018604651162790697,0.9813953488372094,215,6000,3600,2400,0.6,84,36,48,229.30332652531368,0.48336050134028835,0.8039339533298724,0.12902983924995834,1065349.6126628378,-142.35798079136111,1065207.2546820466,2949,0,346.1488372093023,71,144,40,39.42803288464813,0.526453488372093,45.26909722222222,8364.510163827495,117.81000230742951,8
3135,32.96469761155958,3,1,213,0.014018691588785047,0.004672897196261682,0.9953271028037384,214,6800,4200,2600,0.6176470588235294,94,42,52,222.65925463082112,0.4833336075643895,0.797272030752443,0.1263944950299853,1072326.9342921898,-1847.2968179897107,1070479.6374742,2950,0,347.69158878504675,80,134,42,39.25382760243354,0.5294489875389408,44.933127572016446,8408.202320314678,105.10252900393348,0
3136,33.209822719157884,1,4,210,0.004672897196261682,0.018691588785046728,0.9813084112149533,214,7450,5700,1750,0.7651006711409396,92,57,35,211.1046228275725,0.48328104661196675,0.7972751218055503,0.11970022017320603,1079935.36350386,-4654.1304818722965,1075281.2330219878,2951,0,348.54672897196264,78,136,39,39.59259690122882,0.5266744548286604,44.97626582278479,8469.29300120291,108.58067950260141,8
3137,33.17619257991793,3,3,210,0.014084507042253521,0.014084507042253521,0.9859154929577465,213,7400,5200,2200,0.7027027027027027,96,52,44,213.54857839736746,0.48330232970147935,0.7987602663269109,0.12238208897956773,1082275.806063307,-3776.3080362631476,1078499.4980270439,2952,0,350.7276995305164,65,148,40,39.11605083209752,0.5294405320813771,44.570707070707066,8474.171412774485,130.37186788883824,0
3138,32.984584217177655,4,2,212,0.018691588785046728,0.009345794392523364,0.9906542056074766,214,6350,4800,1550,0.7559055118110236,79,48,31,237.23242926778354,0.4837518099249704,0.8111879653005649,0.13459688480388918,1072806.2165798377,1750.88497856314,1074557.1015584008,2953,0,348.9485981308411,70,144,37,38.90251092959043,0.5231697819314642,44.9530516431925,8412.617547409312,120.1802506772759,8
3139,32.94829773048237,1,2,211,0.004694835680751174,0.009389671361502348,0.9906103286384976,213,7250,5300,1950,0.7310344827586207,92,53,39,241.12695557497355,0.4834481205893643,0.8136718508812248,0.1378923787730979,1074159.533559789,1951.763625821286,1076111.2971856103,2954,0,351.3755868544601,66,147,36,38.494606470206215,0.5260661189358373,44.651741293532346,8413.29045282095,127.47409777001438,0
3140,33.33585198484799,1,3,209,0.0047169811320754715,0.014150943396226415,0.9858490566037735,212,7050,4200,2850,0.5957446808510638,99,42,57,225.97090194425076,0.4833201064115175,0.8043006141758413,0.12812174416649177,1084013.5329225154,-458.89684914474765,1083554.6360733707,2955,0,353.97641509433964,77,135,40,39.215891635246514,0.5270243710691824,44.978632478632505,8501.354560665895,110.40720208657007,8
3141,33.63994370130749,1,2,208,0.004761904761904762,0.009523809523809525,0.9904761904761905,210,6250,4500,1750,0.72,80,45,35,232.56885724977863,0.48330959975696813,0.8090945071994573,0.12855038795671428,1085498.9201817072,2240.648682505258,1087739.5688642126,2956,0,358.12380952380954,73,137,41,40.051843796752934,0.5191468253968254,45.96002252252249,8545.89054022369,117.06699370169439,8
3142,34.00240402337205,5,1,212,0.023474178403755867,0.004694835680751174,0.9953051643192489,213,7300,5800,1500,0.7945205479452054,88,58,30,237.50703489687936,0.48404881595653587,0.8191047080261669,0.1319330985756646,1098861.1099237283,2297.448796295337,1101158.5587200236,2957,0,351.98591549295776,62,151,39,39.728987816510596,0.5216158059467919,45.767195767195744,8644.526525518611,139.42784718578406,8
3143,34.34151761810974,2,1,213,0.009345794392523364,0.004672897196261682,0.9953271028037384,214,7350,5400,1950,0.7346938775510204,93,54,39,231.5902584156143,0.4839419434572127,0.8156325639231499,0.129548604927734,1112182.3534806096,1364.1197295720995,1113546.4732101818,2958,0,351.10747663551405,64,150,40,39.602748567470556,0.5240459501557633,45.49679487179487,8740.026302775648,136.5629109808695,0
3144,33.72753867716566,1,3,211,0.004672897196261682,0.014018691588785047,0.985981308411215,214,6850,4900,1950,0.7153284671532847,88,49,39,231.28403717679276,0.4838240241030816,0.8147699006697728,0.12997207552206846,1093815.7459725316,946.4243312144581,1094762.1703037461,2959,0,351.8738317757009,68,146,40,39.42970756767437,0.5262850467289719,45.320048309178745,8589.727920950858,126.31952824927733,0
3145,33.71182012493438,5,2,214,0.023148148148148147,0.009259259259259259,0.9907407407407407,216,6650,4500,2150,0.6766917293233082,88,45,43,221.13117730105526,0.48394747703129487,0.8003816501303191,0.12624335611616658,1098496.7414946116,-1267.6244583845855,1097229.117036227,2960,0,348.912037037037,68,148,42,39.07106248767986,0.5336130401234568,44.71618357487924,8606.082100130465,126.56003088427154,8
3146,33.38147431790382,3,1,216,0.013824884792626729,0.004608294930875576,0.9953917050691244,217,6100,4100,2000,0.6721311475409836,81,41,40,220.32037990332353,0.48384874409740003,0.8039459261965654,0.12341729017507083,1081549.9994904092,-1842.4986455667267,1079707.5008448425,2961,0,348.2903225806452,71,146,41,39.83429241261722,0.526833717357911,45.44270833333333,8497.497694205977,119.68306611557713,8
3147,32.93322407184903,5,1,220,0.02262443438914027,0.004524886877828055,0.995475113122172,221,5750,3700,2050,0.6434782608695652,78,37,41,200.4461191572505,0.484065199506376,0.7923971522712367,0.11304200899538767,1069196.923570657,-7086.725211078314,1062110.1983595786,2962,0,342.9321266968326,76,145,44,40.076294506972445,0.5293174962292609,45.18398268398266,8391.91299536451,110.41990783374355,8
3148,32.44699388975678,3,4,219,0.013452914798206279,0.017937219730941704,0.9820627802690582,223,7150,5200,1950,0.7272727272727273,91,52,39,198.3648920169516,0.4841130368036198,0.7928724941086838,0.11279887803671534,1056033.8815853752,-9853.99062261531,1046179.8909627598,2963,0,340.8340807174888,82,141,39,39.806024234672904,0.5318105381165918,44.86696787148591,8278.299934548939,100.95487725059681,0
3149,32.57007825790073,2,3,218,0.00904977375565611,0.013574660633484163,0.9864253393665159,221,7900,5800,2100,0.7341772151898734,100,58,42,197.37318716348238,0.4839117989853284,0.790891791001741,0.11310040958686406,1062470.281693715,-10159.370847125609,1052310.9108465894,2964,0,343.841628959276,71,150,42,39.533241291418854,0.5353978129713424,44.57465277777778,8319.22354807925,117.17216264900351,0
3150,32.99647342421269,1,4,215,0.0045662100456621,0.0182648401826484,0.9817351598173516,219,6500,4400,2100,0.676923076923077,86,44,42,198.30698798895142,0.48365345677460797,0.790654505614135,0.11415736581299515,1077843.456710694,-7551.222115220286,1070292.2345954736,2965,0,347.2009132420091,71,148,41,39.33233571064699,0.5372907153729072,44.401041666666686,8433.864235902323,118.78682022397639,0
3151,32.819923130411674,3,2,216,0.013761467889908258,0.009174311926605505,0.9908256880733946,218,8000,6000,2000,0.75,100,60,40,211.93803550354914,0.48327775546442314,0.794144050911322,0.12164119073596884,1071129.9314886485,-6197.365310248735,1064932.5661783998,2966,0,349.04128440366975,74,144,43,39.09916644015589,0.5358849388379205,44.51388888888891,8385.03452755452,113.31127739938542,8
3152,33.170447735795065,1,3,214,0.004608294930875576,0.013824884792626729,0.9861751152073732,217,6750,4300,2450,0.6370370370370371,92,43,49,202.3042897174042,0.4829891335267679,0.7875733458545955,0.11502175543566437,1079531.3386407075,-6471.235861722854,1073060.1027789847,2967,0,351.5437788018433,89,128,42,39.71135016407323,0.5350422427035331,44.87268518518516,8462.687262038482,95.08637373076947,8
3153,33.33130542695351,4,3,215,0.01834862385321101,0.013761467889908258,0.9862385321100917,218,5550,3700,1850,0.6666666666666666,74,37,37,202.59677324570728,0.4829774059668259,0.7905867647497355,0.11633451538066626,1087971.541708614,-5066.095253335095,1082905.446455279,2968,0,350.7844036697248,73,145,46,39.31963114979891,0.5375095565749235,44.49605855855859,8516.279909975203,116.6613686297973,0
3154,33.4253229712644,4,4,215,0.0182648401826484,0.0182648401826484,0.9817351598173516,219,7350,5600,1750,0.7619047619047619,91,56,35,206.8199910307099,0.4829779509306969,0.7870146864113585,0.11605542833761236,1083538.2175175273,-6330.527114319087,1077207.6904032081,2969,0,349.54794520547944,81,138,43,40.10988325683495,0.5316305175038052,45.37601626016257,8510.88889273396,105.0727023794316,8
3155,33.13740686661466,3,5,213,0.013761467889908258,0.022935779816513763,0.9770642201834863,218,6800,4700,2100,0.6911764705882353,89,47,42,215.2248276554621,0.482735188630054,0.7983072706272392,0.12357290666510326,1081609.1023021692,-3842.1734732869018,1077766.9288288823,2970,0,350.908256880734,74,144,39,39.00100565340293,0.5370317278287462,44.50000000000003,8466.607454420113,114.41361424892044,7
3156,33.42102982092349,1,1,213,0.004672897196261682,0.004672897196261682,0.9953271028037384,214,7700,5600,2100,0.7272727272727273,98,56,42,212.90748266914974,0.4823925379901423,0.791690050519009,0.12287524671540886,1092535.3051730338,-3978.211689687011,1088557.0934833467,2971,0,357.2102803738318,76,138,38,38.86070842812552,0.5389408099688473,44.30465367965372,8545.601794443752,112.4421288742599,0
3157,33.747050129952555,0,2,211,0.0,0.009389671361502348,0.9906103286384976,213,6650,4800,1850,0.7218045112781954,85,48,37,256.1330403679013,0.4824100525585378,0.8253387421069496,0.14228763824616847,1090627.4019371788,6619.14247334303,1097246.5444105219,2972,1,359.30046948356807,60,153,41,39.2532296704281,0.5243544600938967,45.76502732240437,8579.680367737936,142.99467279563225,8
3158,33.22185539830988,5,3,213,0.023148148148148147,0.013888888888888888,0.9861111111111112,216,6800,4500,2300,0.6617647058823529,91,45,46,245.22400750110629,0.48306955211024977,0.8198075089763801,0.13794265212207074,1077739.0724626465,2857.4988779632467,1080596.5713406098,2973,0,355.13425925925924,67,149,42,39.035562505011626,0.527391975308642,45.28186274509805,8462.209123209233,126.30162870461542,0
3159,32.89711846462986,3,7,209,0.013888888888888888,0.032407407407407406,0.9675925925925926,216,7700,5600,2100,0.7272727272727273,98,56,42,239.7734557322276,0.4833010335917313,0.8143844606363928,0.13591163717287372,1069662.0342438933,395.3124832447065,1070057.3467271382,2974,0,356.037037037037,73,143,36,38.874245602414085,0.5303819444444444,44.988738738738746,8389.135671526405,114.91966673323842,0
3160,32.54806254423268,1,3,207,0.004761904761904762,0.014285714285714285,0.9857142857142858,210,6600,4500,2100,0.6818181818181818,87,45,42,250.7548731726293,0.48293793195108986,0.821822932898616,0.1424450228060727,1059000.6829099867,4509.916386564529,1063510.5992965512,2975,0,366.9095238095238,72,138,38,38.5092110906006,0.531795634920635,44.90582191780823,8302.821262888838,115.31696198456719,0
3161,32.08420366347059,6,5,208,0.028169014084507043,0.023474178403755867,0.9765258215962441,213,6100,4700,1400,0.7704918032786885,75,47,28,239.43562715397206,0.4826721070658753,0.8162346215437759,0.13803704948004158,1048501.46521601,1509.7211791707323,1050011.1863951806,2976,0,362.50704225352115,62,151,42,38.22395227008149,0.5353579812206573,44.345238095238095,8202.47944848846,132.2980556207816,0
3162,32.37709824224546,2,4,206,0.009523809523809525,0.01904761904761905,0.9809523809523809,210,6500,4300,2200,0.6615384615384615,87,43,44,225.30127269787076,0.4824404761904762,0.8014383181060469,0.12853400726521347,1054784.6433415401,-971.1354865960102,1053813.507854944,2977,0,365.4714285714286,63,147,43,38.99186220748581,0.5342757936507936,44.74283854166668,8264.486193573197,131.18232053290788,7
3163,31.890817749226382,4,5,205,0.01904761904761905,0.023809523809523808,0.9761904761904762,210,6850,5500,1350,0.8029197080291971,82,55,27,224.50457610362255,0.48231990962254123,0.7996709535395683,0.12923162574032057,1041710.9154586735,-2076.226500486823,1039634.6889581867,2978,0,366.3333333333333,66,144,41,38.66471512570969,0.5367559523809524,44.40298507462687,8151.197820231373,123.50299727623292,0
3164,31.729065556011143,3,3,205,0.014423076923076924,0.014423076923076924,0.9855769230769231,208,7350,5200,2150,0.7074829931972789,95,52,43,218.2616057460574,0.4825285674470457,0.7932089429105689,0.12678698133146474,1039213.2793990964,-3585.9281851449077,1035627.3512139515,2979,0,368.25961538461536,73,135,36,38.473490265097354,0.5396634615384616,44.05968468468471,8120.74704306587,111.24311017898451,0
3165,31.539110063758258,0,5,200,0.0,0.024390243902439025,0.975609756097561,205,6550,4300,2250,0.6564885496183206,88,43,45,219.52270005795924,0.4822184361549498,0.7925285712445063,0.12802109402640804,1034181.4665350004,-2144.73842326691,1032036.7281117334,2980,1,373.49756097560976,76,129,38,38.29063215354815,0.5417682926829268,43.91233766233769,8076.776968438165,106.27338116366006,0
3166,31.385326156790956,3,2,201,0.014778325123152709,0.009852216748768473,0.9901477832512315,203,7100,5400,1700,0.7605633802816901,88,54,34,236.64762819404763,0.48184920092994526,0.8031711509453803,0.1376477032631662,1028350.675005414,971.3496383563402,1029322.0246437704,2981,0,377.5911330049261,75,128,36,37.95248389284506,0.5432060755336617,44.0104166666667,8034.316565657762,107.12422087543683,8
3167,31.74172445546404,0,2,199,0.0,0.009950248756218905,0.9900497512437811,201,6250,4700,1550,0.752,78,47,31,235.03794116282478,0.48158685737976786,0.7967544092010517,0.13349567987365724,1032716.36543449,2095.505667375235,1034811.8711018653,2982,1,382.1442786069652,77,124,35,38.91631982618711,0.5326492537313433,44.91185897435896,8096.937484292404,105.15503226353772,8
3168,31.64534433155653,0,3,196,0.0,0.01507537688442211,0.9849246231155779,199,5150,3900,1250,0.7572815533980582,64,39,25,230.80342814931413,0.48174162056071607,0.7972352279729875,0.12895646636354724,1024497.9527339946,2341.5279245920724,1026839.4806585866,2983,2,385.40201005025125,67,132,38,39.669307988682185,0.5257537688442211,45.54227941176471,8052.402185837717,120.18510725130922,8
3169,31.4969465121739,6,4,198,0.0297029702970297,0.019801980198019802,0.9801980198019802,202,6050,4100,1950,0.6776859504132231,80,41,39,233.1271821331795,0.4821452760947737,0.8059346615834722,0.12901331492919854,1016720.9456412827,955.0578146264788,1017676.0034559092,2984,0,380.3514851485148,77,125,38,39.990013665510325,0.5233601485148515,45.91346153846152,8002.950111386444,103.93441703099279,8
3170,31.97867349909909,3,4,197,0.014925373134328358,0.01990049751243781,0.9800995024875622,201,6300,4600,1700,0.7301587301587301,80,46,34,234.46804820307017,0.48257048092868987,0.8009035030879454,0.12796870582649456,1027873.7693996689,1700.7113020544039,1029574.4807017233,2985,0,376.3681592039801,66,135,39,40.51040900171695,0.5153399668325042,46.455223880597,8108.02561292454,122.8488729230991,8
3171,32.068870220073926,5,4,198,0.024752475247524754,0.019801980198019802,0.9801980198019802,202,5850,3800,2050,0.6495726495726496,79,38,41,228.83232853227474,0.4821262909873077,0.7956413803548523,0.12630228521590112,1034344.6134728995,1088.29728116343,1035432.9107540629,2986,0,375.01485148514854,73,129,36,40.204361340501364,0.5191831683168318,46.016328828828804,8144.969388806161,111.57492313433097,0
3172,31.709256145287817,3,4,197,0.014925373134328358,0.01990049751243781,0.9800995024875622,201,6650,4800,1850,0.7218045112781954,85,48,37,239.96634245584522,0.48249896351575455,0.8062333004707587,0.1342340783565085,1026934.0894878847,2435.923479526223,1029370.0129674108,2987,0,377.56716417910445,64,137,36,39.38957454400438,0.5222844112769486,45.49679487179487,8070.107321206977,126.09542689385901,0
3173,31.68379724058243,1,1,197,0.005050505050505051,0.005050505050505051,0.9949494949494949,198,7600,5800,1800,0.7631578947368421,94,58,36,237.64528401945793,0.4818291843989813,0.8018448207443123,0.13362786040090627,1027723.5652121454,1646.7317096660154,1029370.2969218114,2988,0,382.6818181818182,65,133,36,39.24381377287563,0.5246738215488216,45.29671717171717,8069.967169642029,124.15334107141584,0
3174,31.359813813283722,4,1,200,0.01990049751243781,0.004975124378109453,0.9950248756218906,201,6800,5200,1600,0.7647058823529411,84,52,32,219.55335427406337,0.48254664179104473,0.7933989276406774,0.12087124160276838,1010680.5307268349,-2620.339875886624,1008060.1908509482,2989,0,377.90547263681594,69,132,39,40.541964617158,0.5194340796019901,46.11607142857142,7961.752730185019,115.3877207273191,8
3175,31.080844272949275,6,1,205,0.02912621359223301,0.0048543689320388345,0.9951456310679612,206,6050,4400,1650,0.7272727272727273,77,44,33,212.84275047402735,0.4831424145552135,0.7930567503932675,0.11914318073219901,1006791.7460712304,-4392.335122329948,1002399.4109489004,2990,0,369.69417475728153,65,141,44,40.05284874227486,0.5234122168284789,45.4703282828283,7910.997089486347,121.70764753055919,0
3176,30.923333453792676,2,1,206,0.00966183574879227,0.004830917874396135,0.9951690821256038,207,6450,4600,1850,0.7131782945736435,83,46,37,209.0005065513265,0.48322565389365724,0.7906650904155175,0.11795846041768464,1004181.0005134639,-5875.1324446936505,998305.8680687702,2991,0,368.7632850241546,68,139,38,39.827690895089155,0.5257648953301127,45.15398550724638,7880.688285529512,115.8924747871987,0
3177,31.26776558665803,0,1,205,0.0,0.0048543689320388345,0.9951456310679612,206,7100,5100,2000,0.7183098591549296,91,51,40,209.09404084503137,0.48294014918304523,0.7902379616051449,0.11842476753914002,1016433.9513093729,-5793.943573728229,1010640.0077356447,2992,1,371.52912621359224,72,134,40,39.68849683809948,0.5277609223300971,45.01997716894977,7972.655583161996,110.73132754391662,0
3178,30.91081494058193,2,4,203,0.00966183574879227,0.01932367149758454,0.9806763285024155,207,6350,4800,1550,0.7559055118110236,79,48,31,211.23851189723456,0.4828680252646061,0.793624971681401,0.12055959355109444,1007136.4278566317,-5200.799940413794,1001935.6279162179,2993,0,370.7149758454106,64,143,41,39.33522715382842,0.5299416264090178,44.727564102564095,7890.679025457193,123.29185977276865,0
3179,31.22702505719263,1,2,202,0.004901960784313725,0.00980392156862745,0.9901960784313726,204,6250,4200,2050,0.672,83,42,41,209.7990960263012,0.4824763957307061,0.7810514875183454,0.1205423433317025,1019466.4030648203,-4273.374041563123,1015193.0290232572,2994,0,376.6372549019608,71,133,43,39.11245423319367,0.5331392973856209,44.47337962962963,7979.336177085311,112.38501657866635,8
3180,31.29899304434373,2,0,204,0.00980392156862745,0.0,1.0,204,5700,3700,2000,0.6491228070175439,77,37,40,209.30918983486734,0.48225152129817445,0.7822253824847094,0.12134248570737159,1024521.8020312794,-3611.634329734955,1020910.1677015445,2995,0,377.44607843137254,72,132,42,38.77979012139123,0.5352328431372548,44.13527397260274,8008.308280224423,111.22650389200587,0
3181,31.30135794322781,0,1,203,0.0,0.004901960784313725,0.9950980392156863,204,6850,4800,2050,0.7007299270072993,89,48,41,211.24219928561294,0.48206840207347307,0.7845236595708953,0.12300512103040045,1025928.9295264839,-4306.103323218265,1021622.8262032656,2996,1,378.44607843137254,75,129,44,38.56084939329052,0.5371732026143791,43.969298245614034,8014.108640069835,106.8547818675978,0
3182,30.88550331500994,2,8,197,0.00975609756097561,0.03902439024390244,0.9609756097560975,205,6150,4400,1750,0.7154471544715447,79,44,35,207.32742577551602,0.4821845608161964,0.7820115675426007,0.12134899209848872,1013825.107400181,-5111.250059226863,1008713.8573409541,2997,0,377.5609756097561,78,127,46,38.464152772059826,0.5391768292682927,43.77637130801688,7913.5957333501165,101.45635555577073,0
3183,30.93245290514022,2,1,198,0.010050251256281407,0.005025125628140704,0.9949748743718593,199,6850,5100,1750,0.7445255474452555,86,51,35,216.07663473552614,0.4823581290289833,0.7865859911803907,0.12311343141907934,1007335.3329161505,-3117.6742426572746,1004217.6586734932,2998,0,382.0,78,121,42,39.27721088435376,0.5326633165829145,44.79166666666668,7894.21975183269,101.20794553631654,8
3184,31.302997037747968,2,2,198,0.01,0.01,0.99,200,6350,4800,1550,0.7559055118110236,79,48,31,223.66882421047092,0.48239216917922945,0.7952897133427042,0.12468298578901281,1012706.371231013,-1047.8313352611153,1011658.5398957519,2999,0,381.075,66,134,39,39.94178228714627,0.5272916666666667,45.63121890547265,7962.5052010975805,120.6440181984482,7
3185,31.276580114725718,3,2,199,0.014925373134328358,0.009950248756218905,0.9900497512437811,201,6650,5100,1550,0.7669172932330827,82,51,31,208.7845328358227,0.4827518656716418,0.783372985632238,0.11562343439114803,1009825.1655982638,-4682.824910942065,1005142.3406873217,3000,0,375.90547263681594,78,123,44,40.58057025736821,0.5225953565505804,45.88607594936707,7947.814503836896,101.89505774149866,8
3186,31.600359031045496,6,1,204,0.02926829268292683,0.004878048780487805,0.9951219512195122,205,6300,5000,1300,0.7936507936507936,76,50,26,198.42942669062464,0.48320281364578355,0.776937300386618,0.11146899522025772,1024717.8047048004,-6633.166698550078,1018084.6380062503,3001,0,367.65365853658534,72,133,45,40.28057936908161,0.5261178861788618,45.33390410958905,8047.540063171671,111.77138976627322,0
3187,31.18816690704459,3,6,201,0.014492753623188406,0.028985507246376812,0.9710144927536232,207,6150,4300,1850,0.6991869918699187,80,43,37,198.98261438552197,0.48365461282303834,0.7793139327771998,0.11277276852577017,1014048.3126418358,-7194.40312745982,1006853.909514376,3002,0,365.07729468599035,76,131,43,39.92042440318305,0.5284319645732689,44.99458874458877,7953.15132843337,104.64672800570223,0
3188,30.990370690849215,1,2,200,0.0049504950495049506,0.009900990099009901,0.9900990099009901,202,5850,4100,1750,0.7008547008547008,76,41,35,232.550308128509,0.48315199990148266,0.8042596215927442,0.13230404535898851,1008776.1855645871,668.242557149641,1009444.4281217367,3003,0,370.55940594059405,73,129,38,38.914404722498084,0.5320235148514851,44.84797297297299,7907.255900089184,108.31857397382444,8
3189,30.61267950473638,3,2,201,0.014778325123152709,0.009852216748768473,0.9901477832512315,203,6550,4800,1750,0.732824427480916,83,48,35,195.43902921810727,0.4830634541286641,0.7662289927785411,0.1118845849708146,998332.8146296429,-8127.360774440243,990205.4538552026,3004,0,369.6453201970443,74,129,40,39.61981545935755,0.5356116584564861,44.61111111111112,7818.13820462631,105.65051627873392,8
3190,30.291837591810303,2,1,202,0.009852216748768473,0.0049261083743842365,0.9950738916256158,203,6150,4700,1450,0.7642276422764228,76,47,29,234.63827668361967,0.4830075679981791,0.8049537104214288,0.13417445742844702,987539.3863070246,-407.09204794436573,987132.2942590803,3005,0,369.935960591133,67,136,34,38.66239976403304,0.5356629720853858,44.65379901960782,7734.905649783737,115.44635298184683,7
3191,30.251555736126857,1,4,199,0.0049261083743842365,0.019704433497536946,0.9802955665024631,203,7000,4400,2600,0.6285714285714286,96,44,52,233.8540307329672,0.482663106212099,0.8041605411961061,0.13458774593323428,988108.684195173,-1385.3602797423464,986723.3239154306,3006,0,370.9162561576355,70,133,35,38.43314103667989,0.5380747126436782,44.41021126760562,7731.988739422879,110.45698199175541,0
3192,30.03591821088306,1,0,200,0.005,0.0,1.0,200,6150,4300,1850,0.6991869918699187,80,43,37,216.47781926038104,0.4819577051926298,0.7894365119836819,0.12376472407277181,979137.4565483375,-3757.691730051927,975379.7648182856,3007,0,375.725,63,137,45,39.13394526602074,0.5358333333333334,44.661458333333336,7669.327553586162,121.73535799343115,8
3193,30.11575452393223,2,3,199,0.009900990099009901,0.01485148514851485,0.9851485148514851,202,6600,5100,1500,0.7727272727272727,81,51,30,194.03740792264745,0.4820934518825017,0.7650562634118083,0.10917609199753915,977047.4103591215,-9083.25061527622,967964.1597438453,3008,0,372.9950495049505,77,125,38,40.32976827094474,0.5264026402640264,45.2724358974359,7671.312790992033,99.62743884405238,8
3194,30.019885366845454,3,3,199,0.01485148514851485,0.01485148514851485,0.9851485148514851,202,6000,4700,1300,0.7833333333333333,73,47,26,217.11885231921443,0.48282822685253596,0.7855268517358065,0.11932096927455976,966973.3304920001,-4410.372052057652,962562.9584399424,3009,0,371.7524752475247,82,120,34,40.67393113792196,0.5205239273927393,46.1847389558233,7619.505040902152,92.92079318173357,8
3195,30.072835838733916,3,1,201,0.01485148514851485,0.0049504950495049506,0.995049504950495,202,5400,3600,1800,0.6666666666666666,72,36,36,215.10031045797442,0.48344498628967375,0.786000811044012,0.11887948129687036,970356.6117129471,-4055.1983131193124,966301.4133998278,3010,0,369.5247524752475,86,116,38,40.500738401596216,0.523102310231023,45.965038314176255,7639.551700076858,88.8319965125216,0
3196,29.852090212879727,6,1,206,0.028985507246376812,0.004830917874396135,0.9951690821256038,207,6300,3800,2500,0.6031746031746031,88,38,50,207.8945420451645,0.4837718681112518,0.7840273393605379,0.11635440685471006,966941.473258867,-7495.629046474024,959445.844212393,3011,0,361.0869565217391,72,135,41,40.18519556726655,0.5264694041867954,45.476598173515995,7598.055552613265,105.5285493418509,0
3197,29.518378693818438,2,2,206,0.009615384615384616,0.009615384615384616,0.9903846153846154,208,7200,4900,2300,0.6805555555555556,95,49,46,207.99329786491202,0.48345517078533384,0.7841917662888791,0.11720777178896732,958109.0964988812,-8943.945860965363,949165.1506379158,3012,0,360.2980769230769,78,130,38,39.91422139419344,0.5285957532051282,45.213607594936704,7520.881217044471,96.4215540646727,0
3198,30.08738453377144,3,4,205,0.014354066985645933,0.019138755980861243,0.9808612440191388,209,6050,4200,1850,0.6942148760330579,79,42,37,203.2896292338754,0.48358042724819045,0.78110883672396,0.11533366402263592,978562.7596576026,-8063.667881425688,970499.0917761769,3013,0,359.48325358851673,82,127,41,39.77001525440411,0.5305522328548644,44.954819277108435,7673.642425894871,93.58100519383989,0
3199,29.925001225987355,2,2,205,0.00966183574879227,0.00966183574879227,0.9903381642512077,207,6850,4800,2050,0.7007299270072993,89,48,41,206.01367112478908,0.4833517033284868,0.7835271781125728,0.11756090075107355,974975.2561829741,-8078.353643582388,966896.9025393917,3014,0,363.7536231884058,70,137,43,39.474131655076,0.5329106280193237,44.73298122065731,7638.865849926033,109.12665499894332,0
3200,30.42175883378294,3,3,205,0.014423076923076924,0.014423076923076924,0.9855769230769231,208,7650,5700,1950,0.7450980392156863,96,57,39,201.80939545596772,0.4836356527932615,0.773252740208844,0.11465626322358002,989858.0770828703,-9297.46797534006,980560.6091075302,3015,0,362.6105769230769,85,123,41,39.75253430511369,0.5329527243589743,44.90067829457362,7760.570043584043,91.3008240421652,8
3201,30.45672987238141,2,4,203,0.00966183574879227,0.01932367149758454,0.9806763285024155,207,7500,5900,1600,0.7866666666666666,91,59,32,204.96368766622618,0.48349631818395006,0.7766058842482326,0.11749948468272764,993655.0305845182,-8167.360132659883,985487.6704518583,3016,0,364.5169082125604,75,132,41,39.323042424567674,0.5356280193236715,44.558662280701775,7779.907821156458,103.73210428208611,0
3202,30.555737928186335,3,2,204,0.014563106796116505,0.009708737864077669,0.9902912621359223,206,6250,4300,1950,0.688,82,43,39,207.59322241817435,0.4834038795485042,0.7781952285720202,0.1199984130293647,999336.5096824501,-5958.902734977447,993377.6069474727,3017,0,361.92233009708735,79,127,45,38.93548688185184,0.5381775889967637,44.24479166666669,7814.789119602095,98.921381260786,0
3203,30.736613534258073,1,4,201,0.004878048780487805,0.01951219512195122,0.9804878048780488,205,6600,4200,2400,0.6363636363636364,90,42,48,203.96965216267355,0.4828929539295393,0.7726052538234209,0.11845997642321744,1006645.6540779425,-6534.967217330749,1000110.6868606118,3018,0,364.6341463414634,81,124,37,38.84733665889049,0.5399390243902439,44.06758130081303,7866.495844444894,97.11723264746783,0
3204,31.157112200705363,1,5,197,0.0049504950495049506,0.024752475247524754,0.9752475247524752,202,7350,5100,2250,0.6938775510204082,96,51,45,198.82471295338013,0.4823474418337356,0.7701187396989999,0.11309976414199041,1014158.540111625,-7422.043874617353,1006736.4962370077,3019,0,370.7524752475247,83,119,40,39.78073106520857,0.5341893564356436,44.85367063492063,7949.622811625899,95.7785880918783,8
3205,30.986369444777253,3,1,199,0.015,0.005,0.995,200,6450,4500,1950,0.6976744186046512,84,45,39,196.37017170987022,0.4815473199329983,0.7660911759908646,0.11262352878888915,1011069.1231468956,-6741.236535418759,1004327.8866114768,3020,0,373.45,74,126,42,39.525226988528246,0.5370833333333334,44.5416666666667,7915.726294413797,106.9692742488351,0
3206,31.012926485358133,4,2,201,0.019704433497536946,0.009852216748768473,0.9901477832512315,203,6250,4400,1850,0.704,81,44,37,222.61524253015338,0.48165207530605275,0.7955011328729877,0.12751475607689586,1011556.3271804252,-1812.4285783634514,1009743.8986020617,3021,0,368.86699507389164,66,137,42,38.903726361496666,0.5310960591133005,44.589552238805986,7921.025440010342,120.01553696985367,8
3207,30.653417729174453,0,2,199,0.0,0.009950248756218905,0.9900497512437811,201,7050,5000,2050,0.7092198581560284,91,50,41,221.6974404350247,0.48112873134328354,0.793179954791118,0.12739011380973653,1000766.5505804677,-2876.5234526642844,997890.0271278034,3022,1,373.1592039800995,67,134,42,38.80494025138382,0.5334784411276949,44.469975490196084,7832.868583645217,116.90848632306295,0
3208,30.589508039420174,3,5,197,0.01485148514851485,0.024752475247524754,0.9752475247524752,202,5950,4000,1950,0.6722689075630253,79,40,39,201.423126200548,0.48077475658013563,0.7716339493924467,0.11537715346997067,997748.9566858058,-6156.0571962017,991592.899489604,3023,0,367.6237623762376,71,131,41,39.44455458630722,0.5364067656765676,44.589120370370395,7812.893155785986,110.04074867304206,7
3209,30.68417341805514,1,2,196,0.005050505050505051,0.010101010101010102,0.98989898989899,198,6900,5000,1900,0.7246376811594203,88,50,38,197.3283599119316,0.48072785810729973,0.7628810994517614,0.11374951403417603,1002716.9449202312,-6927.101960597323,995789.8429596339,3024,0,375.27272727272725,72,126,39,39.3046020317035,0.5376157407407407,44.349315068493176,7844.429950882989,108.95041598448596,0
3210,31.213345509372186,4,4,196,0.02,0.02,0.98,200,6150,4100,2050,0.6666666666666666,82,41,41,215.5805730299835,0.4807474874371859,0.7856752202447821,0.12322116362474252,1017445.0757953308,-2281.7215067012758,1015163.3542886295,3025,0,372.165,68,132,37,39.166494215495,0.5336458333333334,44.670893719806784,7969.675612922925,117.2011119547489,8
3211,31.657449645684938,2,0,198,0.010101010101010102,0.0,1.0,198,7000,4700,2300,0.6714285714285714,93,47,46,209.48500189933702,0.4807470859184057,0.7769755508296068,0.12052958140118998,1033944.936135838,-3280.8086179546267,1030664.1275178834,3026,0,373.67676767676767,72,126,39,39.06665829192488,0.5362478956228955,44.42066210045664,8090.99002003233,112.37486138933792,0
3212,31.875350404167776,4,3,199,0.019801980198019802,0.01485148514851485,0.9851485148514851,202,5600,3900,1700,0.6964285714285714,73,39,34,202.14056184003687,0.48085377567607507,0.7727512661913971,0.11731839868244197,1043732.8310234455,-3803.8518252054823,1039928.97919824,3027,0,367.25742574257424,81,121,34,38.9200690824853,0.5391914191419143,44.092987804878064,8157.12568460319,100.70525536547149,0
3213,32.38044356915317,2,5,196,0.009950248756218905,0.024875621890547265,0.9751243781094527,201,7150,5200,1950,0.7272727272727273,91,52,39,207.19992674160363,0.4810199004975124,0.7786807588850015,0.12096308572345049,1062099.1291992434,-3336.6276475190466,1058762.5015517243,3028,0,368.1044776119403,84,117,36,38.56559011164277,0.5418739635157546,43.87254901960785,8293.520472981652,98.7323865831149,0
3214,32.336209074510144,2,3,195,0.010101010101010102,0.015151515151515152,0.9848484848484849,198,6400,4600,1800,0.71875,82,46,36,207.34433247398323,0.4804746919277376,0.7764662103632136,0.12190347552230872,1062830.153965139,-1925.6382385756074,1060904.5157265635,3029,0,372.45454545454544,73,125,38,38.29311701621464,0.5444549663299663,43.60923423423423,8290.705406575544,113.57130693939101,0
3215,32.33554953181915,2,2,195,0.01015228426395939,0.01015228426395939,0.9898477157360406,197,5700,4400,1300,0.7719298245614035,70,44,26,209.06950174254501,0.4803029714423841,0.7774538213616715,0.12375828427824917,1064910.156667813,-571.952828977021,1064338.203838836,3030,0,375.2182741116751,73,124,41,37.99020952172005,0.5465313028764806,43.35585585585585,8298.72943502429,113.68122513731905,0
3216,32.56994366619625,0,3,192,0.0,0.015384615384615385,0.9846153846153847,195,7150,4800,2350,0.6713286713286714,95,48,47,206.85984727454925,0.48017887038505597,0.7668719631253347,0.11921410594532464,1064262.6511630232,-2119.3581040815625,1062143.2930589416,3031,1,379.16410256410256,76,119,39,39.070575576370175,0.5383547008547008,44.35876623376627,8326.220582523225,109.55553398056875,8
3217,32.465033972924516,3,3,192,0.015384615384615385,0.015384615384615385,0.9846153846153847,195,5750,4000,1750,0.6956521739130435,75,40,35,187.23428088149996,0.4805379328575205,0.7515793587649877,0.10648587429700111,1056669.5334585002,-5181.047954701778,1051488.4855037984,3032,0,379.73846153846154,89,106,45,40.08403647250949,0.5379807692307692,44.86111111111109,8283.092695591944,93.06845725384207,8
3218,32.351456798942614,4,2,194,0.02040816326530612,0.01020408163265306,0.9897959183673469,196,5600,4200,1400,0.75,70,42,28,198.7505206164084,0.4811671463457177,0.7699500208246544,0.11324157570004757,1053546.1123896197,-2921.432333833653,1050624.6800557862,3033,0,378.56632653061223,81,115,45,39.71938775510206,0.5372023809523809,44.79166666666669,8256.36137056355,101.93038729090803,8
3219,31.87082587914268,2,4,192,0.01020408163265306,0.02040816326530612,0.9795918367346939,196,7100,5500,1600,0.7746478873239436,87,55,32,204.61456701273488,0.48117913832199544,0.7682945211279533,0.11425419520405267,1031606.4013342438,-4083.6605726855323,1027522.7407615583,3034,0,379.4540816326531,73,123,36,40.35978561549101,0.5283801020408163,45.56587837837838,8109.025587915317,111.08254230020982,8
3220,31.38854064494218,3,1,194,0.015384615384615385,0.005128205128205128,0.9948717948717949,195,6150,4400,1750,0.7154471544715447,79,44,35,198.41937236951117,0.4816140188562869,0.7637967794422929,0.10925018454562216,1011645.8835116529,-5003.971746683761,1006641.9117649691,3035,0,381.38461538461536,74,121,36,41.07346371261848,0.5215277777777778,46.1111111111111,7969.201708188075,107.69191497551452,8
3221,31.012918203621663,4,6,192,0.020202020202020204,0.030303030303030304,0.9696969696969697,198,5100,3300,1800,0.6470588235294118,69,33,36,192.08823255454962,0.48226287836059406,0.7609166277583379,0.10672321198902833,1002306.3411655994,-6193.749289456489,996112.5918761429,3036,0,376.56060606060606,70,128,39,40.87632485044339,0.5242529461279462,45.7599765258216,7884.725052091552,112.6389293155936,0
3222,31.424886894190603,5,2,195,0.025380710659898477,0.01015228426395939,0.9898477157360406,197,6150,4600,1550,0.7479674796747967,77,46,31,189.06745957067736,0.482705074415553,0.7580787476773276,0.1062689514138638,1019198.9988913002,-7010.526896528736,1012188.4719947714,3037,0,378.5939086294416,73,124,45,40.497188139059354,0.527760152284264,45.312500000000014,8003.5258808641975,109.63734083375613,0
3223,31.08336352626846,5,4,196,0.025,0.02,0.98,200,5300,3200,2100,0.6037735849056604,74,32,42,203.9541183162544,0.4825795644891122,0.7758846477013572,0.11629991510559302,1012492.886650604,-3999.581200339407,1008493.3054502646,3038,0,373.805,67,133,40,39.55532549113751,0.5307291666666667,44.7610294117647,7933.685708864653,118.41321953529332,8
3224,31.58915535191861,4,4,196,0.02,0.02,0.98,200,6050,4300,1750,0.7107438016528925,78,43,35,203.4010750265322,0.4822084380234506,0.7747523832364043,0.1167823246253881,1031069.0338533971,-4105.890017530313,1026963.1438358668,3039,0,374.765,67,133,45,39.30372774147128,0.5325520833333333,44.50061274509803,8071.009836315098,120.46283337783728,0
3225,31.767057132626043,1,3,194,0.005076142131979695,0.015228426395939087,0.9847715736040609,197,5400,4100,1300,0.7592592592592593,67,41,26,217.69235729203695,0.4822464518802445,0.7739249041823921,0.12459354392246931,1035903.4472499733,301.65267175920235,1036205.0999217326,3040,0,380.10659898477155,72,125,41,39.061015812706096,0.5357973773265652,44.62043378995437,8112.657270299843,112.67579542083115,8
3226,31.573113164781113,3,3,194,0.015228426395939087,0.015228426395939087,0.9847715736040609,197,6450,4000,2450,0.6201550387596899,89,40,49,221.9332552614239,0.48191300631927897,0.78724678270002,0.12721681098261475,1030051.1806218459,-129.47767974387716,1029921.702942102,3041,0,380.2741116751269,67,130,42,38.892866066966526,0.5387584602368867,44.56188725490198,8064.976440299143,120.37278269103199,8
3227,31.362972755369068,4,3,195,0.020202020202020204,0.015151515151515152,0.9848484848484849,198,5750,4100,1650,0.7130434782608696,74,41,33,222.16669447620376,0.482019326086585,0.7919539914100198,0.12696884145453524,1022282.0998622058,73.40698971573329,1022355.5068519216,3042,0,377.84343434343435,62,136,41,39.003475370202494,0.5390888047138047,44.67592592592593,8007.72197897503,129.15680611250048,8
3228,31.228232881016012,3,2,196,0.015151515151515152,0.010101010101010102,0.98989898989899,198,6400,4400,2000,0.6875,84,44,40,216.00471056708537,0.48221267240937293,0.7865461629506574,0.12451403209130436,1020492.6141440365,-1913.757649193752,1018578.8564948428,3043,0,378.24747474747477,65,133,40,38.82758159443553,0.5416140572390573,44.34974747474748,7983.505621949149,122.82316341460229,0
3229,31.749210956611655,0,1,195,0.0,0.00510204081632653,0.9948979591836735,196,6600,4500,2100,0.6818181818181818,87,45,42,230.949073156681,0.4816588173731031,0.7942031641238692,0.13164262487807124,1034063.4415098188,1963.1986803802483,1036026.640190199,3044,1,382.98979591836735,64,132,40,38.88125811042742,0.5381590136054422,44.775641025641036,8103.172014342923,126.61206272410817,7
3230,31.353301687664768,1,1,195,0.00510204081632653,0.00510204081632653,0.9948979591836735,196,7250,5400,1850,0.7448275862068966,91,54,37,226.55065684257326,0.48145331850688994,0.7886151388177125,0.13011095578759968,1023457.9240510635,-76.98701109883586,1023380.9370399646,3045,0,383.9591836734694,68,128,40,38.70113244707041,0.5405505952380952,44.48973429951692,8011.090444802653,117.81015360003902,0
3231,31.52503956430233,2,2,195,0.01015228426395939,0.01015228426395939,0.9898477157360406,197,5600,4100,1500,0.7321428571428571,71,41,30,222.27227124751693,0.4814338806588625,0.7869030939201138,0.12859207315628637,1031294.5128708628,845.634740181812,1032140.1476110447,3046,0,382.81218274111677,71,126,41,38.52752639517348,0.5427241962774958,44.212962962962976,8063.696462628286,113.5731896144829,0
3232,31.428528400528663,3,3,195,0.015151515151515152,0.015151515151515152,0.9848484848484849,198,7000,5100,1900,0.7285714285714285,89,51,38,225.18282457466591,0.48144890102377413,0.7928818629241223,0.13090928718903955,1029605.0518480211,-230.12524570330515,1029374.9266023178,3047,0,381.54545454545456,77,121,37,38.26645406166851,0.5441393097643097,44.03044871794873,8044.746312138554,104.47722483296823,8
3233,31.3080354494664,1,2,194,0.00510204081632653,0.01020408163265306,0.9897959183673469,196,7100,5100,2000,0.7183098591549296,91,51,40,211.14822260235576,0.48118894993894995,0.7737253912165585,0.12397291907980583,1028633.2190881569,-2861.1848159594583,1025772.0342721975,3048,0,386.0612244897959,68,128,38,38.24683451118963,0.5462372448979591,43.659420289855056,8025.519956701945,118.02235230444037,8
3234,31.237559715956145,1,3,192,0.005128205128205128,0.015384615384615385,0.9846153846153847,195,6000,4600,1400,0.7666666666666667,74,46,28,211.76462168358364,0.4811976826152084,0.7819357048071585,0.12080667465568219,1017648.8347107716,-1899.595902146847,1015749.2388086247,3049,0,388.97435897435895,65,130,39,39.33890589253695,0.5384615384615384,44.74431818181817,7973.564603632534,122.67022467126976,8
3235,31.755661220495856,3,3,192,0.015384615384615385,0.015384615384615385,0.9846153846153847,195,6050,3900,2150,0.6446280991735537,82,39,43,204.35432061941356,0.48126927482597587,0.7746499935080358,0.11785873053246493,1037885.618078967,-2630.717927362683,1035254.9001516043,3050,0,384.9076923076923,69,126,42,39.10563752594921,0.5411324786324787,44.33035714285713,8118.958562936567,117.66606612951547,0
3236,31.43672944540842,2,3,191,0.010309278350515464,0.015463917525773196,0.9845360824742269,194,6200,4300,1900,0.6935483870967742,81,43,38,204.8960460455662,0.4811402747360362,0.7605516473326102,0.11541235466348453,1020241.6257471982,-3191.3049746597326,1017050.3207725385,3051,0,387.5927835051546,75,119,41,40.01013198479305,0.5322701890034365,45.23026315789474,8009.12728798317,106.7883638397756,8
3237,31.930609870499698,2,3,190,0.010362694300518135,0.015544041450777202,0.9844559585492227,193,5700,4300,1400,0.7543859649122807,71,43,28,206.02308899184098,0.4812817087651122,0.7699967616580314,0.11747699542513507,1040083.502647971,-1443.7567950021466,1038639.7458529689,3052,0,390.45595854922277,69,124,41,39.50341068097016,0.5369170984455959,44.76190476190477,8149.908043137087,118.11460932082734,8
3238,32.22778205815774,2,1,191,0.010416666666666666,0.005208333333333333,0.9947916666666666,192,6900,5700,1200,0.8260869565217391,81,57,24,194.26099437755033,0.48170379762943577,0.7547563977320608,0.11098259435844235,1050363.4173809357,-4491.071616355221,1045872.3457645805,3053,0,393.28125,70,122,41,39.72926962418116,0.5378689236111112,44.68896713615026,8228.108324179357,117.54440463113367,8
3239,32.182740484412996,4,2,193,0.020512820512820513,0.010256410256410256,0.9897435897435898,195,6850,5000,1850,0.7299270072992701,87,50,37,185.41476729233273,0.48179795576702794,0.7462272346806413,0.10697345291775161,1051954.1023221458,-6840.434983144834,1045113.667339001,3054,0,388.18461538461537,78,117,44,39.576242414866044,0.5409188034188035,44.31698312236288,8228.580178444798,105.4946176723692,0
3240,32.418568093158946,4,5,192,0.02030456852791878,0.025380710659898477,0.9746192893401016,197,5350,3500,1850,0.6542056074766355,72,35,37,213.13689044056127,0.48171984529852546,0.7844738405499583,0.12445169882452818,1063406.1696501097,580.2168549064554,1063986.3865050161,3055,0,384.53299492385787,80,117,41,38.40657478535926,0.5425655668358714,43.86574074074074,8303.50592478712,103.793824059839,8
3241,32.565678562572586,3,2,193,0.015384615384615385,0.010256410256410256,0.9897435897435898,195,5850,3800,2050,0.6495726495726496,79,38,41,210.75585059836445,0.48123402942990573,0.7809940454490218,0.12401848260310164,1070646.6439545143,279.0088273836973,1070925.652781898,3056,0,388.94871794871796,65,130,43,38.172111261566236,0.544818376068376,43.5763888888889,8350.608895298583,128.47090608151666,0
3242,32.60207317373751,2,3,192,0.010256410256410256,0.015384615384615385,0.9846153846153847,195,6400,4600,1800,0.71875,82,46,36,195.95960339927416,0.4812549563838224,0.7610997086427174,0.11397123248632524,1068190.2856625933,-3535.571053319801,1064654.7146092735,3057,0,389.85128205128206,78,117,40,38.99741595412247,0.5414529914529915,44.013713080168806,8345.683657633777,106.99594432863817,8
3243,32.64201428543167,4,2,194,0.02040816326530612,0.01020408163265306,0.9897959183673469,196,6600,4500,2100,0.6818181818181818,87,45,42,193.12765256621032,0.4811197235304378,0.7524316992465299,0.11268904775950744,1070515.8208896618,-4450.758495317878,1066065.062394344,3058,0,386.4948979591837,87,109,38,38.94589264805569,0.5441645408163265,43.89204545454546,8359.879510885434,96.09056909063717,8
3244,32.578971318831144,2,1,195,0.01020408163265306,0.00510204081632653,0.9948979591836735,196,5850,4600,1250,0.7863247863247863,71,46,25,193.58993025934714,0.4813312183847898,0.7551553915167402,0.11368403890540145,1070445.6046508153,-3604.5020098448467,1066841.1026409704,3059,0,387.4234693877551,74,122,37,38.69015369056001,0.5462903911564626,43.65277777777777,8351.5288004398,112.85849730324055,0
3245,32.95213159194982,4,6,193,0.020100502512562814,0.03015075376884422,0.9698492462311558,199,5600,4300,1300,0.7678571428571429,69,43,26,218.07116981348122,0.4816464477268498,0.7859045287697972,0.12717182680891995,1080508.1947671743,1725.5372051863524,1082233.7319723608,3060,0,382.54773869346735,82,117,39,38.32863677203301,0.5430799832495812,43.913152610441784,8438.607494148342,102.90984748961392,7
3246,32.70586578589967,1,2,192,0.005154639175257732,0.010309278350515464,0.9896907216494846,194,5900,3900,2000,0.6610169491525424,79,39,40,202.6620376268017,0.48107072271780354,0.7702631121099388,0.11489122096539539,1063486.6367709413,-1594.3262406253093,1061892.310530316,3061,0,384.5257731958763,75,119,41,39.815337346375735,0.5322164948453608,44.98355263157895,8340.533700828537,111.20711601104716,8
3247,33.16131960911819,3,4,191,0.015384615384615385,0.020512820512820513,0.9794871794871794,195,7200,5600,1600,0.7777777777777778,88,56,32,196.74645829567652,0.4813485769671337,0.763691901213756,0.11245089045427178,1080927.5588991337,-3666.266222480623,1077261.292676653,3062,0,383.3538461538462,69,126,43,39.64914325678983,0.535309829059829,44.67261904761907,8466.992884721038,122.71004180755126,0
3248,33.37159755006816,1,3,189,0.005208333333333333,0.015625,0.984375,192,6000,3900,2100,0.65,81,39,42,201.65137964569655,0.48082153959424084,0.7658676006792806,0.11602554255996142,1089938.383840837,-442.484233938766,1089495.8996068982,3063,0,387.9739583333333,69,123,47,39.2658296943231,0.5374891493055556,44.41964285714287,8529.124820274148,123.61050464165432,0
3249,33.267809776825366,6,4,191,0.03076923076923077,0.020512820512820513,0.9794871794871794,195,6200,4600,1600,0.7419354838709677,78,46,32,190.73697390436095,0.48077253502511236,0.7545153716747071,0.11108969883847951,1090452.013462284,-3602.0965528569973,1086849.9169094271,3064,0,382.5897435897436,78,117,43,39.077359494627,0.5414529914529915,43.960970464135045,8517.857730042191,109.20330423131014,0
3250,33.2384923746605,2,1,192,0.010362694300518135,0.0051813471502590676,0.9948186528497409,193,6350,4500,1850,0.7086614173228346,82,45,37,191.13002774048448,0.4807633491652274,0.7515641098385863,0.11186863551364808,1091062.6178846732,-3243.034315419112,1087819.583569254,3065,0,386.1139896373057,78,115,48,38.879168382050246,0.5438795336787565,43.7763713080169,8516.487128486375,109.18573241649199,0
3251,33.20053476125802,0,1,191,0.0,0.005208333333333333,0.9947916666666666,192,6400,4500,1900,0.703125,83,45,38,190.98584606600187,0.48064088405322863,0.7501608331398504,0.11222046916865867,1091054.0439953413,-3124.824060763466,1087929.2199345778,3066,1,388.9583333333333,69,123,44,38.73466643448652,0.54541015625,43.63095238095237,8511.58947718678,123.35636923459103,0
3252,33.090169934357995,1,2,190,0.005208333333333333,0.010416666666666666,0.9895833333333334,192,5300,3400,1900,0.6415094339622641,72,34,38,201.80403921172444,0.48069371727748694,0.7603773705732233,0.11532672224897417,1078567.0271870885,-168.1634706128225,1078398.8637164757,3067,0,389.7135416666667,72,120,42,39.5250004657315,0.5363498263888888,44.67751141552511,8448.664535323442,117.34256299060335,8
3253,33.45818607625895,2,3,189,0.010416666666666666,0.015625,0.984375,192,6150,4200,1950,0.6829268292682927,81,42,39,213.0612341954315,0.480569871655032,0.7687741204451626,0.11924494029563444,1083743.6187968508,1630.750594455918,1085374.3693913068,3068,0,389.1927083333333,75,117,42,40.05407467241068,0.5296223958333333,45.47697368421051,8515.878775166208,113.54505033554943,8
3254,33.47065505753615,4,1,192,0.02072538860103627,0.0051813471502590676,0.9948186528497409,193,6000,4300,1700,0.7166666666666667,77,43,34,223.09284478504094,0.4805755703080023,0.7871667600188217,0.12622280769013694,1087706.6951242688,3931.916181401984,1091638.6113056708,3069,0,387.89637305699483,69,124,40,39.37198420110512,0.5301705526770293,45.05952380952383,8533.024738775492,123.66702519964481,8
3255,33.46271574963944,4,1,195,0.02040816326530612,0.00510204081632653,0.9948979591836735,196,5950,4100,1850,0.6890756302521008,78,41,37,216.26261685509348,0.48062750741322174,0.7845545709343413,0.12394857425578311,1091651.838522365,2066.696658704042,1093718.535181069,3070,0,382.9030612244898,64,132,44,39.04325344542739,0.5332695578231292,44.567307692307686,8547.471575857404,133.55424337277194,0
3256,33.690361084104595,5,6,194,0.025,0.03,0.97,200,6450,4200,2250,0.6511627906976745,87,42,45,204.17803385279933,0.48103695561139026,0.7775631987663139,0.11750429669303707,1100418.6737090512,-1513.735757435602,1098904.9379516155,3071,0,376.21,73,127,43,39.193045381946376,0.5344270833333333,44.41159909909914,8610.86551526034,117.95706185288138,8
3257,33.11447956351909,3,2,195,0.015228426395939087,0.01015228426395939,0.9898477157360406,197,5650,4200,1450,0.7433628318584071,71,42,29,205.75432427102436,0.480789650885735,0.7653922262887238,0.1172766408550947,1078516.7125751106,-668.1045178197646,1077848.6080572908,3072,0,382.1827411167513,71,126,44,39.525879579766865,0.5339467005076142,44.77719907407412,8451.570225405778,119.03620035782785,8
3258,33.245742932637505,1,3,193,0.00510204081632653,0.015306122448979591,0.9846938775510204,196,6050,4400,1650,0.7272727272727273,77,44,33,216.93357652923552,0.48063077795220654,0.7792433409615764,0.12070406694062612,1074949.5773769177,1388.5312817931153,1076338.1086587107,3073,0,384.6326530612245,71,125,36,40.186571940604225,0.5277423469387755,45.70312500000001,8454.28853482307,119.07448640595874,8
3259,32.74063114025098,4,3,194,0.02030456852791878,0.015228426395939087,0.9847715736040609,197,5700,3900,1800,0.6842105263157895,75,39,36,204.46325186198894,0.48079504644497395,0.772481896421461,0.11510942190462249,1062393.5778569423,-1655.9108628153122,1060737.666994127,3074,0,383.6345177664975,74,123,43,40.04129865881585,0.5277072758037225,45.25,8340.675782978939,112.7118349051208,8
3260,32.69975832560813,2,3,193,0.01020408163265306,0.015306122448979591,0.9846938775510204,196,5450,3700,1750,0.6788990825688074,72,37,35,198.6855075653773,0.48064440519797663,0.7654014802088567,0.11284840559043369,1063885.9780913831,-2374.2548902449835,1061511.7232011382,3075,0,386.4948979591837,77,119,40,39.84362729700014,0.5293898809523809,44.911858974358985,8341.320563267134,108.32883848398876,8
3261,32.597104740510375,3,2,194,0.015306122448979591,0.01020408163265306,0.9897959183673469,196,5800,3900,1900,0.6724137931034483,77,39,38,199.29275528218795,0.48068637711494855,0.7696008898162507,0.11164366908864663,1056152.3134186207,-2903.2990922290555,1053249.0143263917,3076,0,386.63775510204084,68,128,41,40.367641244613125,0.5248724489795918,45.44082125603866,8297.892212175238,122.02782664963586,7
3262,32.39265783205128,6,2,198,0.03,0.01,0.99,200,6000,4500,1500,0.75,75,45,30,226.2624818598573,0.4815174832495812,0.7999454293776302,0.12525458876432882,1045737.27465108,1322.2222271830701,1047059.4968782631,3077,0,379.675,76,124,43,40.15166640046851,0.5227604166666666,45.90097402597401,8230.942803834087,108.30187899781693,8
3263,32.2611972042526,7,5,200,0.03414634146341464,0.024390243902439025,0.975609756097561,205,5600,3700,1900,0.6607142857142857,75,37,38,214.40943732001796,0.4821566634783995,0.7936283253525782,0.12093884180861908,1047437.0583213653,-1683.9219394363327,1045753.1363819289,3078,0,371.23414634146343,72,133,36,39.71329376189944,0.5270325203252033,45.176940639269404,8220.896970227492,114.17912458649295,0
3264,32.70398872445346,2,6,196,0.009900990099009901,0.0297029702970297,0.9702970297029703,202,7050,5000,2050,0.7092198581560284,91,50,41,216.8307314198049,0.48128171026057825,0.7931036065304511,0.12020410712601819,1056247.1151979244,-1644.6330903151647,1054602.4821076093,3079,0,377.31188118811883,83,119,42,40.33488859071316,0.5218646864686469,45.84573412698412,8311.858245382837,100.14287042629924,7
3265,32.30003397013066,5,0,201,0.024875621890547265,0.0,1.0,201,6950,5300,1650,0.762589928057554,86,53,33,194.70320529521655,0.4814334577114428,0.7673680218809711,0.10729597512012473,1041297.3321866678,-6601.214351579436,1034696.1178350884,3080,0,379.8457711442786,80,121,36,41.13372583776484,0.5216625207296849,46.07767489711936,8201.69972659765,102.52124658247062,8
3266,31.897873770164274,5,3,203,0.024271844660194174,0.014563106796116505,0.9854368932038835,206,6600,4800,1800,0.7272727272727273,84,48,36,195.9373761630548,0.4818868892572421,0.7756939915836838,0.10936912096266392,1032367.6562053893,-7344.118041502578,1025023.5381638868,3081,0,371.6019417475728,73,133,43,40.59491534801376,0.5249797734627832,45.579954954954964,8115.4584814463715,111.17066412940235,0
3267,31.743926990244493,5,4,204,0.02403846153846154,0.019230769230769232,0.9807692307692307,208,6800,5100,1700,0.75,85,51,34,187.15572544440326,0.4823011504397374,0.7670616902655218,0.10549406509900273,1030430.3248475343,-9829.813006649787,1020600.5118408845,3082,0,368.69711538461536,80,128,37,40.43452110567138,0.5283453525641026,45.20318930041151,8088.251356194848,101.1031419524356,0
3268,32.09888284339668,4,3,205,0.019230769230769232,0.014423076923076924,0.9855769230769231,208,6800,4300,2500,0.6323529411764706,93,43,50,193.3777077381249,0.48201857271150744,0.7720311471551062,0.11047382351747183,1046150.6625390202,-7939.556585896515,1038211.1059531237,3083,0,362.7548076923077,71,137,40,39.7532748720274,0.53125,44.69039351851854,8195.153147242827,115.42469221468771,8
3269,32.435764552241885,2,4,203,0.00966183574879227,0.01932367149758454,0.9806763285024155,207,6650,4600,2050,0.6917293233082706,87,46,41,233.33723208301257,0.4820443068649063,0.8103859864703138,0.1312266824163653,1052166.4614682575,1051.9219619164032,1053218.3834301739,3084,0,365.3478260869565,70,137,37,39.34717182189969,0.5263687600644122,45.290492957746494,8261.697599640163,118.02425142343091,8
3270,32.73950486706554,5,6,202,0.02403846153846154,0.028846153846153848,0.9711538461538461,208,6800,4800,2000,0.7058823529411765,88,48,40,228.48969178602772,0.481943573485693,0.8081678334828015,0.12985888956376626,1065381.6578985748,285.745329546658,1065667.4032281216,3085,0,364.5,75,133,39,39.058554504915925,0.5294971955128205,44.887609649122815,8352.25334554129,111.36337794055054,0
3271,32.60476551875422,1,2,201,0.0049261083743842365,0.009852216748768473,0.9901477832512315,203,8050,5800,2250,0.7204968944099379,103,58,45,235.8974678675251,0.48124664683217094,0.8086386019034053,0.131655942621603,1055201.568738586,1133.875631054263,1056335.4443696402,3086,0,373.3349753694581,62,141,37,39.58373952037432,0.5218082922824302,45.58531746031744,8295.131068734605,133.79243659249363,8
3272,32.61950574490102,3,1,203,0.014705882352941176,0.004901960784313725,0.9950980392156863,204,6100,3900,2200,0.639344262295082,83,39,44,209.54688211167598,0.48172077739141633,0.7885461857949052,0.11639245438120298,1054144.8353065944,-2721.447293475238,1051423.388013119,3087,0,372.20098039215685,65,139,42,40.44289586954727,0.520578022875817,45.770202020202035,8292.85035572707,127.58231316503185,8
3273,32.830254927383145,1,4,200,0.004901960784313725,0.0196078431372549,0.9803921568627451,204,7200,5200,2000,0.7222222222222222,92,52,40,236.58305435222084,0.48175347725297013,0.8077333478764317,0.1304762509546468,1058643.3503831225,2091.415460661224,1060734.7658437837,3088,0,371.9264705882353,72,132,36,40.03928564739372,0.5182802287581699,46.04737442922372,8337.329436966817,115.79624218009468,7
3274,32.503399834521254,3,3,200,0.014778325123152709,0.014778325123152709,0.9852216748768473,203,6350,4500,1850,0.7086614173228346,82,45,37,209.57659721087902,0.4819203287323806,0.7836467750698439,0.11674871109408129,1051326.0551362897,-2883.332561079743,1048442.7225752099,3089,0,374.32512315270935,70,133,42,40.32684875403783,0.5260673234811166,45.657276995305175,8267.00322082251,118.10004601175014,8
3275,32.59768963016414,4,1,203,0.0196078431372549,0.004901960784313725,0.9950980392156863,204,6100,4200,1900,0.6885245901639344,80,42,38,232.17763333694313,0.4821433602176503,0.8062920405617748,0.12892310434491117,1053341.1855559668,2012.4527117428333,1055353.6382677096,3090,0,373.36764705882354,60,144,42,39.87973287655898,0.5174121732026145,45.78210382513661,8286.916077941481,138.11526796569134,8
3276,32.78600757504895,4,2,205,0.01932367149758454,0.00966183574879227,0.9903381642512077,207,7550,5400,2150,0.7152317880794702,97,54,43,228.04663480849075,0.4823354908306365,0.804657591040081,0.1282556820483181,1063538.7799223806,-442.7120500746487,1063096.0678723059,3091,0,368.8792270531401,66,141,42,39.48058454902438,0.5211855877616747,45.28917910447761,8350.950903327537,126.52955914132632,0
3277,33.03159043344659,1,6,200,0.0048543689320388345,0.02912621359223301,0.970873786407767,206,6050,3500,2550,0.5785123966942148,86,35,51,228.21247808508025,0.48243843239403267,0.8039933091644293,0.129219847967936,1073688.9124192414,1755.84147913372,1075444.7538983752,3092,0,363.7378640776699,69,137,38,39.2110229173962,0.5234627831715211,45.029761904761884,8422.072477480217,122.05902141275676,0
3278,33.43885195681911,5,2,203,0.024390243902439025,0.00975609756097561,0.9902439024390244,205,7050,5600,1450,0.7943262411347518,85,56,29,229.33865833445344,0.4830035469472342,0.8053283944039005,0.13107407261033055,1089961.717958878,1944.0716065210281,1091905.789565399,3093,0,364.03414634146344,61,144,43,38.81844826829854,0.5263719512195122,44.674059139784944,8537.806337160284,139.96403831410302,0
3279,33.38658388400707,3,1,205,0.014563106796116505,0.0048543689320388345,0.9951456310679612,206,7000,4600,2400,0.6571428571428571,94,46,48,223.30376206227265,0.48310146815060384,0.8017356718997841,0.12896337789459533,1091629.5902514502,552.9988563289344,1092182.589107779,3094,0,362.57766990291265,64,142,42,38.568496584571,0.5294296116504854,44.27884615384613,8537.655753799647,133.40087115311948,0
3280,33.216290369674766,1,3,203,0.0048543689320388345,0.014563106796116505,0.9854368932038835,206,6000,4600,1400,0.7666666666666667,74,46,28,212.2990594013511,0.4831231746783487,0.786077720897159,0.1202560126559383,1079818.6003628063,-1351.105363778836,1078467.4949990276,3095,0,363.50485436893206,83,123,36,39.60157085886584,0.5317556634304207,45.014880952380935,8469.659754231758,102.044093424479,8
3281,33.6088947308333,0,4,199,0.0,0.019704433497536946,0.9802955665024631,203,7000,4500,2500,0.6428571428571429,95,45,50,194.23104155202668,0.4824365133557691,0.7680180051411312,0.10962906722974901,1091409.0475292474,-5202.896787818123,1086206.1507414293,3096,1,369.7241379310345,80,123,42,40.20180484768966,0.5325328407224958,45.15174897119339,8565.168041164077,107.06460051455096,8
3282,33.844708412352645,2,1,200,0.009950248756218905,0.004975124378109453,0.9950248756218906,201,6600,4300,2300,0.6515151515151515,89,43,46,195.2404723558611,0.4823880597014925,0.7664722123433583,0.11092046049562129,1101222.3626192983,-3799.3651506746282,1097422.9974686236,3097,0,371.86567164179104,84,117,39,39.921414616961286,0.535084991708126,44.901960784313694,8633.718753817711,102.78236611687751,0
3283,33.92618887089524,0,1,199,0.0,0.005,0.995,200,6100,4500,1600,0.7377049180327869,77,45,32,194.41208539598293,0.4823885050251256,0.7651700198356461,0.11098030562316823,1105454.6893453414,-3117.249706720577,1102337.439638621,3098,1,374.215,71,129,42,39.75636393690372,0.5371354166666666,44.71932870370372,8660.700269487108,121.98169393643813,0
3284,34.11385994855042,3,2,200,0.01485148514851485,0.009900990099009901,0.9900990099009901,202,5850,3900,1950,0.6666666666666666,78,39,39,192.5620107957356,0.48216323498021446,0.7650864014015333,0.11091048490860064,1114522.62241623,-3327.0565500386965,1111195.5658661912,3099,0,371.470297029703,75,127,45,39.45822162645217,0.5396039603960396,44.38048245614037,8720.168421607308,116.26891228809744,0
3285,33.68131038180822,1,3,198,0.004975124378109453,0.014925373134328358,0.9850746268656716,201,6650,4800,1850,0.7218045112781954,85,48,37,190.0239488295109,0.48246475953565504,0.7608324730332452,0.11005506433403558,1102187.1303451522,-4961.609828549248,1097225.520516603,3100,0,372.0348258706468,78,123,43,39.31059512765007,0.5414075456053068,44.17194092827006,8616.624261970555,110.46954182013532,0
3286,33.485900914620025,3,2,199,0.014925373134328358,0.009950248756218905,0.9900497512437811,201,5950,4200,1750,0.7058823529411765,77,42,35,196.35134245651648,0.4825860281923715,0.7700778981532561,0.11361294918690845,1095489.5178521082,-3129.832504539266,1092359.685347569,3101,0,370.5771144278607,81,120,44,39.184793404847106,0.5436878109452736,44.207317073170735,8565.448435172622,105.74627697743978,8
3287,33.238505792822245,5,10,194,0.024509803921568627,0.049019607843137254,0.9509803921568627,204,6200,4600,1600,0.7419354838709677,78,46,32,196.0151239038902,0.4829261445957693,0.7695363074061647,0.11591158694298437,1094322.0578063934,-4099.265249663844,1090222.7925567296,3102,0,366.04411764705884,78,126,42,38.364121405203576,0.5510110294117647,43.39398734177216,8529.200438213544,109.3487235668403,8
3288,33.23777197840726,4,1,197,0.020202020202020204,0.005050505050505051,0.9949494949494949,198,5500,3800,1700,0.6909090909090909,72,38,34,196.4562272040433,0.48263141140679217,0.7629714041967417,0.11709208024601732,1096788.5332117912,-2005.8125449110157,1094782.7206668803,3103,0,375.9191919191919,81,117,49,38.05521559610342,0.5544507575757576,43.10213414634146,8538.712686983357,105.41620601214021,0
3289,33.284348068930576,1,3,195,0.005050505050505051,0.015151515151515152,0.9848484848484849,198,6650,4500,2150,0.6766917293233082,88,45,43,195.65853898507171,0.4822169452562854,0.7616250129677058,0.11725150052222263,1100036.284513205,-3203.7015483160512,1096832.582964889,3104,0,376.8989898989899,85,113,40,37.871792455793205,0.5566603535353536,42.90213178294573,8557.334933516462,100.67452862960543,0
3290,33.352039428426956,0,1,194,0.0,0.005128205128205128,0.9948717948717949,195,5350,3900,1450,0.7289719626168224,68,39,29,202.32085733053512,0.48172746497488766,0.763670099135187,0.11823995877640116,1094307.1568695488,-69.76756784219924,1094237.3893017066,3105,1,383.55897435897435,87,108,42,38.650064306948224,0.5467948717948719,43.832859848484865,8543.696558600757,98.20340871954893,8
3291,33.19451923627052,3,5,192,0.015228426395939087,0.025380710659898477,0.9746192893401016,197,5750,3800,1950,0.6608695652173913,77,38,39,202.1723298720892,0.48182451914776064,0.7656199595847484,0.11922278947990946,1091999.819145906,-995.570468674523,1091004.2486772316,3106,0,380.5431472081218,73,124,44,38.310833058939735,0.5491751269035533,43.496621621621614,8514.506327749441,116.63707298286906,0
3292,32.996813169235246,0,0,192,0.0,0.0,1.0,192,6450,4500,1950,0.6976744186046512,84,45,39,200.09440050628245,0.4810186700116346,0.7571669553294376,0.11834008142618621,1086407.9034761582,-1373.172369730405,1085034.7311064277,3107,1,390.8802083333333,74,118,46,38.25424424478605,0.5513237847222222,43.38888888888887,8467.348890483154,114.42363365517775,0
3293,33.08182630910663,1,4,189,0.0051813471502590676,0.02072538860103627,0.9792746113989638,193,6000,4200,1800,0.7,78,42,36,196.5319059006554,0.4805924366724237,0.7544681207564579,0.1171059490037454,1091558.9301942477,-1694.768609208988,1089864.1615850388,3108,0,389.8497409326425,79,114,45,38.06330993292447,0.5533246977547496,43.11197916666665,8498.324886098455,107.57373273542348,0
3294,33.399922211887144,0,0,189,0.0,0.0,1.0,189,5050,3300,1750,0.6534653465346535,68,33,35,205.20181520447568,0.48016107546249387,0.7583626840553814,0.12028407073797807,1096838.4406324483,2164.6478007645264,1099003.0884332128,3109,1,396.037037037037,70,119,44,38.46175864437829,0.550870811287478,43.72065727699527,8559.710111461834,122.28157302088334,8
3295,32.86400120806733,4,3,190,0.02072538860103627,0.015544041450777202,0.9844559585492227,193,5650,3800,1850,0.672566371681416,75,38,37,195.26869311363498,0.48032707253886014,0.751502420322083,0.11567560499543528,1082548.1735844624,-1972.4465823221226,1080575.7270021404,3110,0,388.80829015544043,78,115,42,38.31605962532967,0.5534866148531952,43.328059071729946,8435.266976743618,108.14444841978998,0
3296,32.869702923012944,4,2,192,0.020618556701030927,0.010309278350515464,0.9896907216494846,194,5850,4500,1350,0.7692307692307693,72,45,27,213.11907568745067,0.4805888663354878,0.7758029929761749,0.12346508129662628,1075715.6987067994,1201.107082174709,1076916.805788974,3111,0,387.2680412371134,80,114,41,38.70911665158674,0.5435996563573884,44.16152263374486,8409.334747304787,105.11668434130983,8
3297,32.49133545371539,2,0,194,0.010309278350515464,0.0,1.0,194,6650,4900,1750,0.7368421052631579,84,49,35,210.7190314571245,0.4799812599042074,0.7734033400923412,0.12272823251044512,1065002.0499194192,-566.7599082252809,1064435.2900111938,3112,0,388.2474226804124,83,111,38,38.56558055246121,0.5457474226804124,43.960813492063515,8319.055098125826,100.22957949549188,0
3298,32.35356397986352,2,1,195,0.01020408163265306,0.00510204081632653,0.9948979591836735,196,6550,5000,1550,0.7633587786259542,81,50,31,202.66213145871245,0.47999574829931974,0.7686463580343086,0.11542930096126675,1053503.0365841507,-3048.9658215260015,1050454.0707626247,3113,0,385.2755102040816,76,120,43,39.63336248939783,0.5350233843537415,44.80519480519481,8256.461457198942,108.63765075261766,8
3299,31.956552427052703,3,2,196,0.015151515151515152,0.010101010101010102,0.98989898989899,198,6700,4300,2400,0.6417910447761194,91,43,48,200.62913516068014,0.4800110880377378,0.7677316644707952,0.11536175271739155,1043519.5206117879,-4427.916211273717,1039091.6044005142,3114,0,382.1868686868687,71,127,40,39.31725543478263,0.5377209595959596,44.444444444444464,8166.674509135732,115.02358463571453,0
3300,32.260250951808146,3,1,198,0.01507537688442211,0.005025125628140704,0.9949748743718593,199,6100,3900,2200,0.639344262295082,83,39,44,200.2199567178375,0.48021991269478703,0.7675389377233344,0.11590897246221299,1055546.9293607015,-3631.687897950498,1051915.241462751,3115,0,381.04522613065325,75,124,43,39.0667416773825,0.5397298994974875,44.1885964912281,8252.540073527303,110.03386764703072,0
3301,31.95843674451117,3,5,196,0.014925373134328358,0.024875621890547265,0.9751243781094527,201,6600,5000,1600,0.7575757575757576,82,50,32,197.53430523637786,0.4802352819237148,0.7681385719845637,0.1157922087601083,1049507.6714295463,-5337.246256783436,1044170.4251727628,3116,0,377.6517412935323,68,133,43,38.65739377159912,0.5432213930348259,43.71980676328501,8190.31434442662,120.44579918274441,0
3302,32.39014059545623,1,1,196,0.005076142131979695,0.005076142131979695,0.9949238578680203,197,5650,3800,1850,0.672566371681416,75,38,37,204.73856754338948,0.4794774508788287,0.7737986937598427,0.120273727038238,1064351.2852940375,-1467.248497186616,1062884.0367968509,3117,0,385.28426395939084,65,132,43,38.39083246116275,0.5446806260575296,43.63952020202021,8303.551983775193,127.74695359654143,0
3303,32.34414165287187,1,3,194,0.005076142131979695,0.015228426395939087,0.9847715736040609,197,5450,3300,2150,0.6055045871559633,76,33,43,202.70097069719225,0.4793609067992679,0.771363238643265,0.1198702802349398,1064889.6856100925,-1679.1654082810574,1063210.5202018113,3118,0,386.20304568527916,66,131,38,38.19095223669597,0.5467956852791878,43.3924129353234,8299.752145221588,125.75382038214526,0
3304,32.56326207116107,1,1,194,0.005128205128205128,0.005128205128205128,0.9948717948717949,195,7800,5500,2300,0.7051282051282052,101,55,46,213.9564287660022,0.4789232531500573,0.7800667624679718,0.1234938970603374,1064528.6221672927,-1247.4515363782025,1063281.1706309146,3119,0,389.96923076923076,69,126,40,38.82974209005026,0.539957264957265,44.30059523809527,8326.406728701866,120.67256128553429,8
3305,32.61199398230167,3,5,192,0.015228426395939087,0.025380710659898477,0.9746192893401016,197,7300,5400,1900,0.7397260273972602,92,54,38,207.79393095670298,0.47904580613971476,0.7739427783800199,0.1209530332296754,1068771.7143029063,-2283.1448379326575,1066488.5694649736,3120,0,385.74619289340103,75,122,37,38.66312659492838,0.5429885786802031,43.98300438596494,8349.22472033193,111.32299627109239,0
3306,32.15692559268231,3,2,193,0.015384615384615385,0.010256410256410256,0.9897435897435898,195,5600,3800,1800,0.6785714285714286,74,38,36,221.6509100418483,0.47791655652480397,0.791894728038492,0.13054025506596553,1057468.5629267576,2277.7738626721593,1059746.33678943,3121,0,390.4923076923077,65,130,39,37.860470900773414,0.5469017094017095,43.54482323232323,8246.810037176363,126.87400057194405,8
3307,31.879813902757913,2,2,193,0.010256410256410256,0.010256410256410256,0.9897435897435898,195,6650,5100,1550,0.7669172932330827,82,51,31,227.1748106016984,0.47744955502687464,0.7968635181283596,0.13523975603839367,1051617.9520122467,2130.2218147455496,1053748.1738269923,3122,0,390.7128205128205,68,127,39,37.31106245836765,0.5497863247863248,43.14613526570048,8188.45340793361,120.41843246961191,0
3308,31.456231465343993,1,1,193,0.005154639175257732,0.005154639175257732,0.9948453608247423,194,5900,4200,1700,0.711864406779661,76,42,34,228.8612256411676,0.4772954391681356,0.797307052846296,0.13684684192242808,1038961.9936590944,2855.623052682229,1041817.6167117767,3123,0,393.19072164948454,71,123,36,37.10110000938173,0.5513853092783505,42.98321759259259,8084.779397885349,113.87013236458237,0
3309,31.39660120273397,1,3,191,0.005154639175257732,0.015463917525773196,0.9845360824742269,194,6050,3900,2150,0.6446280991735537,82,39,43,227.9421678471955,0.4768358394316543,0.79654399758794,0.13691654195712583,1038337.7611339266,2486.192046094135,1040823.9531800207,3124,0,394.0103092783505,76,118,38,36.954263321235075,0.5538552405498282,42.81655844155844,8074.685950557029,106.24586777048722,0
3310,31.18715018070576,2,1,192,0.010362694300518135,0.0051813471502590676,0.9948186528497409,193,5450,3800,1650,0.6972477064220184,71,38,33,210.98641705209837,0.4768391083765113,0.7753097193633915,0.12452770209332209,1026219.4977374749,-746.325012673627,1025473.1727248012,3125,0,392.9637305699482,72,121,38,38.05206363332961,0.5476575993091537,43.46461187214609,8000.607676208947,111.1195510584576,8
3311,30.734785240272085,3,3,192,0.015384615384615385,0.015384615384615385,0.9846153846153847,195,5150,3700,1450,0.7184466019417476,66,37,29,205.3772108344695,0.47664111375451584,0.7713915934301043,0.12205435401285561,1013347.6651903845,-2526.296583515619,1010821.3686068689,3126,0,389.22564102564104,78,117,44,37.93549422336325,0.5498931623931624,43.20938818565399,7892.404305831965,101.1846705875893,0
3312,30.342553486669487,2,6,188,0.010309278350515464,0.030927835051546393,0.9690721649484536,194,5300,3700,1600,0.6981132075471698,69,37,32,200.5233438785661,0.47653593112903514,0.7655451992804414,0.11980470309106227,1001944.63743193,-3917.342184190642,998027.2952477394,3127,0,392.10309278350513,81,113,41,37.86002636348656,0.5515463917525774,43.0132113821138,7797.635379005589,96.26710344451345,0
3313,29.967523638655514,0,0,188,0.0,0.0,1.0,188,6050,4300,1750,0.7107438016528925,78,43,35,206.72036492968024,0.47590619903667464,0.7665892995138113,0.1237001128850194,990003.472393363,-2719.224181038969,987284.248212324,3128,1,403.9574468085106,79,109,41,37.64210061969165,0.5534131205673759,42.95572916666664,7702.980262378833,97.50607927061813,0
3314,29.903770628009344,2,0,190,0.010526315789473684,0.0,1.0,190,6450,4800,1650,0.7441860465116279,81,48,33,206.22037994169256,0.4762171632785668,0.7693489736070369,0.12459452438008026,990613.1215536802,-3593.077139594702,987020.0444140855,3129,0,400.69473684210527,68,122,42,37.294599217986274,0.555811403508772,42.602657004830924,7697.151105186601,113.1933986056853,0
3315,30.46296374338669,3,5,188,0.015544041450777202,0.025906735751295335,0.9740932642487047,193,6450,4600,1850,0.7131782945736435,83,46,37,207.26131259484802,0.4763387395653425,0.7746926845548476,0.12683437791742286,1012787.5252794921,-3067.6656261769704,1009719.8596533152,3130,0,395.4507772020725,72,121,36,36.79306623872501,0.5587219343696028,42.137557077625566,7855.254249525406,109.10075346563063,0
3316,30.461637278532127,0,1,187,0.0,0.005319148936170213,0.9946808510638298,188,6700,5000,1700,0.746268656716418,84,50,34,232.50229040369584,0.47529700951947507,0.7880452954548192,0.13502841487988773,997634.4868180869,2090.4606341842155,999724.9474522711,3131,1,404.1595744680851,71,117,35,38.117816091954026,0.541445035460993,44.06828703703704,7796.099008351178,109.80421138522786,8
3317,30.51869215113157,3,2,188,0.015789473684210527,0.010526315789473684,0.9894736842105263,190,5850,4200,1650,0.717948717948718,75,42,33,235.57779953538002,0.4755824747052817,0.7947617315387421,0.1386730986986639,1003450.2181756527,3428.1188682235274,1006878.3370438762,3132,0,396.9736842105263,66,124,37,37.522356614526515,0.5449561403508771,43.563432835820905,7826.10864957657,118.57740378146319,0
3318,30.817632243296856,2,2,188,0.010526315789473684,0.010526315789473684,0.9894736842105263,190,7700,6100,1600,0.7922077922077922,93,61,32,238.5753326896926,0.4758528265107212,0.7977130039449636,0.14184859454484935,1016212.9345902022,2788.6677906851264,1019001.6023808873,3133,0,394.2736842105263,70,120,40,37.065694507922004,0.5483552631578947,43.192488262910786,7914.199454029727,113.05999220042467,0
3319,31.235288195848085,6,2,192,0.030927835051546393,0.010309278350515464,0.9896907216494846,194,5750,4200,1550,0.7304347826086957,73,42,31,235.57169975732523,0.4762337971618325,0.7900899396177223,0.14148628674390895,1032975.7036276545,4117.968462317189,1037093.6720899716,3134,0,385.1185567010309,83,111,40,36.761506099619076,0.5552512886597938,42.81994047619048,8033.09327745157,96.78425635483819,7
3320,30.859044245898005,1,2,191,0.0051813471502590676,0.010362694300518135,0.9896373056994818,193,6700,4800,1900,0.7164179104477612,86,48,38,232.90850930203828,0.4758855965745538,0.7828979061750148,0.14064180724073866,1022098.8501560495,2311.1039098345564,1024409.954065884,3135,0,379.51295336787564,72,121,39,36.628180961357224,0.5576424870466321,42.62271689497717,7942.416967226916,110.3113467670405,0
3321,30.427385893187584,0,1,190,0.0,0.005235602094240838,0.9947643979057592,191,6450,4500,1950,0.6976744186046512,84,45,39,230.45787210986254,0.4754397446495821,0.7792793282161203,0.14004059832864107,1009600.7307222225,1884.0872165611845,1011484.8179387837,3136,1,384.27225130890054,75,116,39,36.45633812184089,0.5599367364746946,42.39309210526316,7838.304795263991,104.51073060351987,0
3322,30.424458168166602,0,3,187,0.0,0.015789473684210527,0.9842105263157894,190,6550,4200,2350,0.6412213740458015,89,42,47,217.80078272945536,0.4749199387357282,0.7572868125369627,0.13204543367112634,1008847.2223479981,-604.457063634246,1008242.7652843638,3137,2,386.9789473684211,80,110,42,36.86797752808989,0.5611842105263158,42.47685185185182,7835.002248167823,97.93752810209779,8
3323,30.881065887787045,2,1,188,0.010582010582010581,0.005291005291005291,0.9947089947089947,189,6050,4500,1550,0.743801652892562,76,45,31,211.5624748538927,0.47493456602499157,0.7488986697532929,0.12918151116291185,1026052.0080554028,-435.1795693990107,1025616.8284860038,3138,0,389.04761904761904,86,103,45,36.76372116426688,0.5638778659611994,42.217432950191544,7960.600437787945,92.56512136962728,0
3324,30.554826743004618,0,2,186,0.0,0.010638297872340425,0.9893617021276596,188,5350,4300,1050,0.8037383177570093,64,43,21,223.7339030082552,0.47463922706413325,0.7702496901098865,0.1378198224994685,1017718.0767531435,2589.6074948068444,1020307.6842479503,3139,1,392.09574468085106,84,104,36,36.12492679993036,0.5647163120567376,41.899509803921546,7886.2157602256775,93.8835209550676,8
3325,30.868141437654398,1,3,184,0.0053475935828877,0.016042780748663103,0.983957219251337,187,5150,3200,1950,0.6213592233009708,71,32,39,225.30325629435012,0.47410897399037816,0.7723704905936193,0.1393585937757995,1029333.8563431015,3832.453929624009,1033166.3102727255,3140,0,395.1550802139037,85,102,39,35.93302964213682,0.5661207664884136,41.75145348837207,7971.652659789545,93.78414893870054,0
3326,30.768677792486493,0,0,184,0.0,0.0,1.0,184,7100,5300,1800,0.7464788732394366,89,53,36,212.50184609036828,0.4739113110794329,0.7563108387833601,0.12705785226973712,1016236.9812805633,-709.5530825158048,1015527.4281980474,3141,1,401.82065217391306,78,106,36,37.52362080169639,0.5543478260869565,42.98523206751052,7908.004582425397,101.38467413365893,8
3327,30.89371313029176,2,1,185,0.010752688172043012,0.005376344086021506,0.9946236559139785,186,6150,4200,1950,0.6829268292682927,81,42,39,208.27756320909776,0.4739943572604863,0.7555596055322698,0.12539159417690485,1022373.9380438995,-762.48949914594,1021611.4485447536,3142,0,398.48924731182797,85,101,41,37.3742545511613,0.5568436379928315,42.73255813953486,7947.946546601161,93.50525348942541,0
3328,30.504720514855325,0,3,182,0.0,0.016216216216216217,0.9837837837837837,185,6450,5000,1450,0.7751937984496124,79,50,29,240.94568818907834,0.4736976106541324,0.7870403029320134,0.13884020597965074,996741.3911420414,4582.10808705171,1001323.4992290931,3143,1,401.43783783783783,72,113,39,38.20413526839707,0.5411599099099099,44.36358447488585,7798.117409013035,108.30718623629215,8
3329,30.99596052100236,3,3,182,0.016216216216216217,0.016216216216216217,0.9837837837837837,185,6150,4700,1450,0.7642276422764228,76,47,29,236.8848025959957,0.4742117117117117,0.7828221244500295,0.13764927718416087,1015297.8139762951,4951.724447984588,1020249.5384242797,3144,0,398.23783783783784,76,109,37,37.984496124031,0.5442004504504505,44.04761904761908,7933.489895256633,104.38802493758728,0
3330,30.68667799155652,3,3,182,0.016216216216216217,0.016216216216216217,0.9837837837837837,185,6050,4300,1750,0.7107438016528925,78,43,35,237.95359904818372,0.47435492557775166,0.7875631729290244,0.1393728222996515,1007505.9707774796,4897.93436180754,1012403.9051392871,3145,0,399.1297297297297,78,107,38,37.65243902439029,0.546509009009009,43.75000000000003,7863.461235336426,100.81360558123623,0
3331,30.889771836918666,5,1,186,0.026737967914438502,0.0053475935828877,0.9946524064171123,187,5350,3800,1550,0.7102803738317757,69,38,31,198.28960540656868,0.47436173883042954,0.7548311208200298,0.1158473828563217,1013424.5185117788,-2559.6904229914708,1010864.8280887873,3146,0,392.32085561497325,76,111,46,38.7654035736291,0.5415552584670231,43.844696969696976,7912.578865422835,104.1128798081952,8
3332,31.2635425595114,2,1,187,0.010638297872340425,0.005319148936170213,0.9946808510638298,188,5900,4000,1900,0.6779661016949152,78,40,38,221.01403043324942,0.4745935971100239,0.7817830216759794,0.12774475228828677,1022458.3577782864,1695.5285205481619,1024153.8862988346,3147,0,389.6755319148936,68,120,44,38.59571453869311,0.5389516843971631,44.24818840579711,7995.707646447518,117.58393597716938,7
3333,31.159618229595097,2,4,185,0.010582010582010581,0.021164021164021163,0.9788359788359788,189,6300,4500,1800,0.7142857142857143,81,45,36,234.2937586632798,0.47458277046043,0.7860334748512245,0.13290339134193202,1013390.2871098879,3386.2038719672137,1016776.4909818552,3148,0,388.4391534391534,73,116,39,38.985171284542055,0.5326829805996472,44.96058558558559,7946.930786652659,108.86206557058436,8
3334,31.23303842122732,1,6,180,0.005376344086021506,0.03225806451612903,0.967741935483871,186,6500,4700,1800,0.7230769230769231,83,47,36,231.6572735225916,0.4746119102973942,0.7813657650101355,0.13043371162092432,1013508.0344232195,3257.3015895443027,1016765.3360127638,3133,0,376.78494623655916,77,109,40,39.344158453903624,0.5318660394265233,45.24572649572646,7956.750012330746,103.33441574455514,8
3335,30.779051627538223,2,3,179,0.01098901098901099,0.016483516483516484,0.9835164835164835,182,6250,4500,1750,0.72,80,45,35,245.5630783677968,0.4741856900006071,0.7909661629430602,0.13780383148647965,997772.4377124844,6353.21426304381,1004125.6519755282,3134,0,384.9835164835165,67,115,36,39.121094533349364,0.5290750915750916,45.37377450980393,7837.153740087953,116.97244388190975,8
3336,31.00540876677957,4,3,180,0.02185792349726776,0.01639344262295082,0.9836065573770492,183,5350,3600,1750,0.6728971962616822,71,36,35,259.5925060314671,0.4747355331371725,0.8021914144502047,0.14286774624158452,999158.9254542695,9924.833876476161,1009083.7593307457,3135,0,378.25136612021856,66,117,34,39.5384234592851,0.5192395264116576,46.12873134328357,7871.3824588423795,119.2633705885209,8
3337,31.520456026993827,4,1,183,0.021739130434782608,0.005434782608695652,0.9945652173913043,184,5100,3700,1400,0.7254901960784313,65,37,28,256.4375153319517,0.4754067424962382,0.8024931768758121,0.142896999284303,1019627.1132487472,10394.128697319833,1030021.2419460671,3136,0,376.33152173913044,60,124,39,39.12288799373392,0.5225883152173914,45.64549180327869,8017.370090882394,133.6228348480399,0
3338,31.187145939048317,4,3,184,0.0213903743315508,0.016042780748663103,0.983957219251337,187,5450,4000,1450,0.7339449541284404,69,40,29,244.13061351644845,0.4765060471891591,0.7942577441839764,0.1356019283628611,1007856.1299090175,6359.70706620065,1014215.8369752181,3137,0,371.0267379679144,65,122,37,39.56367436470492,0.5241755793226381,45.77020202020204,7928.701811650776,121.9800278715504,8
3339,31.235658378845567,2,2,184,0.010752688172043012,0.010752688172043012,0.989247311827957,186,5400,3400,2000,0.6296296296296297,74,34,40,237.9852383044589,0.4760092754044367,0.7880212177858741,0.13141127779693174,1007604.6589670798,5359.006976192588,1012963.6659432724,3138,0,373.88709677419354,68,118,37,39.95455671124319,0.5248095878136201,45.99939613526569,7933.8760903393,116.67464838734266,8
3340,31.420961169651008,5,1,188,0.026455026455026454,0.005291005291005291,0.9947089947089947,189,6400,4500,1900,0.703125,83,45,38,224.89620067618813,0.47642500656685055,0.7798831545229261,0.12417463417996036,1013559.3904359236,1389.1312137420464,1014948.5216496657,3139,0,364.92063492063494,73,116,40,40.28993940737453,0.5243606701940036,46.00225225225222,7980.853369160718,109.32675848165367,8
3341,31.029776200644193,2,2,188,0.010526315789473684,0.010526315789473684,0.9894736842105263,190,5900,4800,1100,0.8135593220338984,70,48,22,220.76818115836852,0.47663255360623785,0.7772454026632856,0.12281339836558032,1003239.2901310391,396.66266976846873,1003635.9528008075,3140,0,362.92105263157896,67,123,41,40.09688755020082,0.5266447368421052,45.71078431372549,7890.537452982438,117.76921571615578,0
3342,31.471294129561315,4,1,191,0.020833333333333332,0.005208333333333333,0.9947916666666666,192,6950,5500,1450,0.7913669064748201,84,55,29,232.19321082489944,0.476873818353694,0.7890930623471877,0.12938286543240302,1018026.6177831194,1925.7738176550079,1019952.3916007745,3141,0,359.7239583333333,66,126,36,39.74085676446617,0.5283203125,45.646766169154226,8004.825434695629,121.28523385902469,8
3343,31.860355361731486,4,2,193,0.020512820512820513,0.010256410256410256,0.9897435897435898,195,5650,4200,1450,0.7433628318584071,71,42,29,222.09758983200385,0.4772557053484889,0.7809515710460944,0.12474285928751201,1033094.0530277091,1239.539849445896,1034333.592877155,3142,0,355.1384615384615,73,122,42,39.68473043686545,0.5306623931623932,45.340653153153134,8113.537286726931,111.1443463935196,0
3344,31.71877209904534,1,8,186,0.005154639175257732,0.041237113402061855,0.9587628865979382,194,5950,4000,1950,0.6722689075630253,79,40,39,224.5573890558118,0.47666390684258314,0.7888390059226538,0.1244066366892246,1024223.8410621668,1249.406311527256,1025473.2473736941,3143,0,357.9226804123711,82,112,41,40.16432910267174,0.5264175257731959,45.87098393574299,8060.660344296851,98.30073590605916,8
3345,31.30916636553756,3,1,188,0.015873015873015872,0.005291005291005291,0.9947089947089947,189,6700,4800,1900,0.7164179104477612,86,48,38,254.44994665853062,0.47645315021201545,0.8071930581640112,0.14015063196338098,1009198.0741197314,6858.079225531585,1016056.153345263,3144,0,359.78306878306876,74,115,34,39.63666739602139,0.5218253968253967,46.097222222222236,7949.484310116587,107.42546365022415,8
3346,31.162068123862035,2,3,187,0.010526315789473684,0.015789473684210527,0.9842105263157894,190,6400,4400,2000,0.6875,84,44,40,258.82835396351754,0.4764828738512949,0.8145217537523488,0.1436627078013382,1006825.3136833132,7718.987733890638,1014544.3014172039,3145,0,358.86842105263156,58,132,35,39.21855466036947,0.524561403508772,45.79802259887004,7921.459336994423,136.57688512059352,0
3347,31.590299838469093,1,1,187,0.005319148936170213,0.005319148936170213,0.9946808510638298,188,5700,4100,1600,0.7192982456140351,73,41,32,233.91093863857512,0.47616101566351876,0.781693274529627,0.1292055921703683,1019151.3387940021,4378.129254413015,1023529.4680484151,3146,0,363.5531914893617,74,114,35,40.04444839338765,0.5237145390070922,45.98611111111111,8024.374913135563,108.43749882615626,7
3348,31.339449407363386,1,1,187,0.005319148936170213,0.005319148936170213,0.9946808510638298,188,5400,3700,1700,0.6851851851851852,71,37,34,256.03272886378164,0.4764312398073349,0.7993775547562123,0.1441790957007459,1017005.483419842,9077.337837882227,1026082.8212577242,3147,0,364.40425531914894,71,117,37,38.71747638518182,0.5322473404255319,45.24016203703703,7984.03305286836,112.4511697587093,8
3349,31.544853282229464,2,2,187,0.010582010582010581,0.010582010582010581,0.9894179894179894,189,5050,3500,1550,0.693069306930693,66,35,31,252.20046269899004,0.4769902247739127,0.7935238516314072,0.14034040075099385,1019983.7894366437,8598.076728277938,1028581.8661649217,3148,0,363.44444444444446,69,120,32,39.28593198353716,0.5318562610229277,45.699404761904745,8021.874966369297,116.259057483613,8
3350,31.47690151320812,2,2,187,0.010582010582010581,0.010582010582010581,0.9894179894179894,189,5900,3700,2200,0.6271186440677966,81,37,44,245.73345340766502,0.4773173946489549,0.7882438437545329,0.13767744887301742,1019897.3101146069,6424.577627129723,1026321.8877417366,3149,0,363.978835978836,75,114,33,39.18036262316264,0.5344466490299824,45.43585526315787,8012.890512675573,106.83854016900763,0
3351,31.06734545895923,8,2,193,0.041025641025641026,0.010256410256410256,0.9897435897435898,195,5800,4100,1700,0.7068965517241379,75,41,34,244.56565672977808,0.4783692395805798,0.7981848239745264,0.13975056972510053,1012604.3409153358,4729.649128676308,1017333.9900440121,3150,0,352.96923076923076,65,130,33,38.436965547794166,0.5395299145299146,44.681186868686844,7932.07776972191,122.03196568802939,0
3352,30.70453208252734,3,4,192,0.015306122448979591,0.02040816326530612,0.9795918367346939,196,6000,4600,1400,0.7666666666666667,74,46,28,249.34001994529308,0.4784378815628816,0.8013709209813402,0.14352091764679428,1002947.0481037862,4814.96739565402,1007762.0154994403,3151,0,352.1530612244898,69,127,37,38.031749728303026,0.5417198129251701,44.40476190476189,7847.932188236427,113.73814765560039,0
3353,31.017144951585912,0,2,190,0.0,0.010416666666666666,0.9895833333333334,192,6200,4300,1900,0.6935483870967742,81,43,38,246.23108657683593,0.477783913248982,0.7938716606939247,0.14247055989587143,1014716.2311579408,5370.936033034314,1020087.1671909752,3152,1,359.78125,74,118,36,37.90994733127006,0.5437282986111112,44.208333333333336,7933.927202407747,107.21523246496956,0
3354,30.893908867132346,1,5,186,0.005235602094240838,0.02617801047120419,0.9738219895287958,191,6150,4200,1950,0.6829268292682927,81,42,39,245.91496874661098,0.4773606135758244,0.7937156993099432,0.1430013862956846,1012172.946961731,5431.695723651769,1017604.6426853827,3153,0,359.5916230366492,80,111,34,37.725131876412945,0.5466841186736475,44.020061728395056,7908.220884777111,98.85276105971388,0
3355,31.24554891358802,6,6,186,0.03125,0.03125,0.96875,192,6100,3900,2200,0.639344262295082,83,39,44,241.01002465151072,0.47781629490255967,0.7944175053256088,0.14203558052587995,1027695.4315760708,5036.980259678805,1032732.4118357496,3154,0,355.3020833333333,67,125,39,37.33880079237091,0.55029296875,43.5202205882353,8013.851492956568,119.60972377547117,0
3356,31.277306175559577,2,1,187,0.010638297872340425,0.005319148936170213,0.9946808510638298,188,6350,5000,1350,0.7874015748031497,77,50,27,242.94989557841916,0.4776632485682861,0.7910861545270824,0.14410634823156548,1030663.7622216216,6129.930681640813,1036793.6929032624,3155,0,363.0531914893617,70,118,41,37.043519259343924,0.5518062943262412,43.28051643192489,8029.49388879023,114.70705555414614,0
3357,31.41255612725233,2,4,185,0.010582010582010581,0.021164021164021163,0.9788359788359788,189,6050,4300,1750,0.7107438016528925,78,43,35,234.87803212794302,0.4780491294232429,0.7920761629201525,0.13669965036296122,1029422.3749081391,4507.740329379525,1033930.1152375187,3156,0,362.037037037037,69,120,37,37.974937998914996,0.5394069664902998,43.98809523809524,8041.988327578116,116.55055547214661,8
3358,31.06320656922995,1,1,185,0.005376344086021506,0.005376344086021506,0.9946236559139785,186,7200,5200,2000,0.7222222222222222,92,52,40,250.4444219179628,0.4774133003971714,0.80254382466622,0.1425836967811825,1011357.484149183,6257.768094029288,1017615.2522432123,3157,0,368.78494623655916,69,117,39,38.43062359070057,0.5336021505376345,44.82142857142856,7926.664676326696,114.87919820763328,8
3359,31.05863018376264,0,2,183,0.0,0.010810810810810811,0.9891891891891892,185,6150,4100,2050,0.6666666666666666,82,41,41,244.21040333477853,0.47736731296513907,0.7910237469584742,0.1361445544983268,1004824.8723872437,5927.737473301264,1010752.6098605449,3158,1,371.36756756756756,65,120,38,39.416131517445336,0.5271396396396396,45.62815656565657,7900.441014389249,121.54524637521922,8
3360,30.79549793546279,6,3,186,0.031746031746031744,0.015873015873015872,0.9841269841269842,189,5400,3500,1900,0.6481481481481481,73,35,38,240.3832186085537,0.4782906957109085,0.7935883487404138,0.13613476364900867,1001056.8558965442,4927.453806114053,1005984.3097026582,3159,0,356.23809523809524,71,118,36,38.8939325162657,0.5308641975308642,45.023148148148145,7852.1391147945005,110.59350865907747,0
3361,31.09991738494742,4,2,188,0.021052631578947368,0.010526315789473684,0.9894736842105263,190,6750,5000,1750,0.7407407407407407,85,50,35,235.77358820321447,0.478175763482781,0.7925207408581696,0.1349600539370124,1014188.5484729119,3073.7746376136265,1017262.3231105256,3160,0,355.3421052631579,64,126,41,38.59408990127173,0.5335526315789474,44.61538461538461,7942.440439848106,124.10063187262665,0
3362,30.9657943373555,1,1,188,0.005291005291005291,0.005291005291005291,0.9947089947089947,189,6250,4400,1850,0.704,81,44,37,214.67436316597542,0.47826020676197983,0.7721089821591096,0.11952495686416026,1001429.9265050016,-1053.7336544378263,1000376.1928505638,3161,0,357.5132275132275,66,123,37,40.21821636711903,0.52744708994709,45.67786069651741,7875.287061107923,119.32253122890793,8
3363,30.773670810650724,2,2,188,0.010526315789473684,0.010526315789473684,0.9894736842105263,190,6850,5100,1750,0.7445255474452555,86,51,35,210.3578018180585,0.4788150932887775,0.7684564295184753,0.1179617053852889,997378.528721703,-2888.7290235146265,994489.7996981883,3162,0,356.61578947368423,69,121,39,40.046113643891125,0.5297149122807018,45.401785714285715,7834.921635408083,113.54958891895772,0
3364,30.86813101467487,4,6,186,0.020833333333333332,0.03125,0.96875,192,6100,4200,1900,0.6885245901639344,80,42,38,218.7547333205851,0.4791138334424084,0.7787511410868981,0.12522577495823456,1006647.8918761722,-458.2017729798836,1006189.6901031922,3163,0,353.859375,69,123,39,39.02638581361923,0.5386827256944444,44.61309523809523,7883.316435622744,114.25096283511223,8
3365,31.173688368697416,2,4,184,0.010638297872340425,0.02127659574468085,0.9787234042553191,188,5700,4400,1300,0.7719298245614035,70,44,26,219.18880667356575,0.47799865836082983,0.7751851316692555,0.1263230989537475,1018647.289752428,1355.216772419185,1020002.5065248471,3164,0,362.34574468085106,71,117,40,38.75424448217314,0.5402814716312057,44.35763888888888,7969.315299115769,112.24387745233479,0
3366,31.5777989793787,1,1,184,0.005405405405405406,0.005405405405405406,0.9945945945945946,185,5850,3800,2050,0.6495726495726496,79,38,41,219.10851800504477,0.4776060027418723,0.7722578797425421,0.1269752982492066,1033532.7738522311,2441.1668776810843,1035973.9407299121,3165,0,366.7081081081081,72,113,37,38.543641940881194,0.5427364864864865,44.14954337899543,8079.194287960329,112.2110317772268,0
3367,31.78165980037393,1,1,184,0.005405405405405406,0.005405405405405406,0.9945945945945946,185,5850,4400,1450,0.7521367521367521,73,44,29,235.9091810290785,0.4776696533490012,0.7898494340882902,0.13570704172558465,1037942.8169790066,6122.0479817063115,1044064.864960713,3166,0,366.9351351351351,62,123,37,38.398729809579244,0.541554054054054,44.42791005291004,8122.505217168961,131.0081486640155,8
3368,32.13875855984543,2,2,184,0.010752688172043012,0.010752688172043012,0.989247311827957,186,4950,3900,1050,0.7878787878787878,60,39,21,233.0998940426124,0.47772207691562535,0.7888068840916529,0.13490719756012273,1051488.5187170026,6870.372459991392,1058358.891176994,3167,0,365.5698924731183,64,122,40,38.235992774506116,0.5435707885304659,44.198717948717956,8221.13564314509,128.45524442414202,0
3369,32.491076093182514,2,6,180,0.010752688172043012,0.03225806451612903,0.967741935483871,186,6300,4900,1400,0.7777777777777778,77,49,28,232.58179477786203,0.477716022474087,0.7867844112643356,0.1356780456193828,1065491.4758606239,6062.78395523539,1071554.2598158594,3168,0,363.59139784946234,68,118,36,37.94456889098486,0.5460349462365591,43.90096618357488,8320.933195119987,122.36666463411746,0
3370,32.151356610760175,0,4,176,0.0,0.022222222222222223,0.9777777777777777,180,5900,4700,1200,0.7966101694915254,71,47,24,236.73607780248742,0.4768621973929237,0.7851279469104235,0.13821917812538725,1054613.76505053,8033.025266915299,1062646.7903174453,3169,2,374.18333333333334,69,111,36,37.805503911999374,0.5474537037037037,43.86904761904762,8234.957589053638,119.34721143555997,0
3371,32.39481259282033,0,1,175,0.0,0.005681818181818182,0.9943181818181818,176,6100,4500,1600,0.7377049180327869,77,45,32,244.19212211568785,0.476326433982684,0.7855907875817649,0.14291765791099376,1063350.6070202969,10632.368256258156,1073982.975276555,3170,3,375.5738636363636,72,104,37,37.521812578896544,0.5487097537878788,43.778538812785385,8300.2462174184,115.28119746414444,0
3372,32.4219391985412,1,2,174,0.005681818181818182,0.011363636363636364,0.9886363636363636,176,4900,3600,1300,0.7346938775510204,62,36,26,245.30713152469005,0.4762168560606061,0.7870608234894652,0.14426328070128241,1065734.7600410786,12186.467390365971,1077921.2274314445,3171,0,376.34090909090907,61,115,36,37.30908579603783,0.5506036931818181,43.598790322580626,8313.024430593669,136.27908902612572,0
3373,32.58435543907027,1,0,175,0.005714285714285714,0.0,1.0,175,5000,3200,1800,0.64,68,32,36,244.86369961207683,0.47597427476737825,0.7841001855287575,0.14503465284715286,1073292.4633235948,12562.072667034787,1085854.5359906296,3172,0,375.92571428571426,64,111,37,37.04849837662337,0.5525595238095238,43.33333333333332,8363.317896028011,130.67684212543767,0
3374,32.387223805914786,4,3,176,0.0223463687150838,0.01675977653631285,0.9832402234636871,179,5800,3700,2100,0.6379310344827587,79,37,42,238.4127390826084,0.4763380620592974,0.7824391272267315,0.14301589741240306,1070693.370690563,9453.387844785346,1080146.7585353483,3173,0,368.5027932960894,72,107,39,36.7348779134295,0.5558659217877095,42.86529680365295,8327.87918068753,115.66498862066015,0
3375,32.80218862194614,1,3,174,0.005649717514124294,0.01694915254237288,0.9830508474576272,177,5700,4000,1700,0.7017543859649122,74,40,34,238.7879464136513,0.4758897235062489,0.7815014950406942,0.14379991092594024,1085617.2715135538,10746.463771182365,1096363.7352847361,3174,0,373.20338983050846,73,104,42,36.57893117032333,0.5575564971751412,42.72240990990989,8439.268038334832,115.6064114840388,0
3376,32.55469191441565,2,0,176,0.011363636363636364,0.0,1.0,176,6450,4700,1750,0.7286821705426356,82,47,35,238.35671212715843,0.4753043831168831,0.7787536175295156,0.1451409025537374,1080818.4319049919,9874.06556706102,1090692.497472053,3175,0,374.8238636363636,63,113,43,36.175677951827545,0.5614346590909092,42.317708333333336,8388.76761700893,133.1550415398243,0
3377,32.525810865459704,0,2,174,0.0,0.011363636363636364,0.9886363636363636,176,5900,4500,1400,0.7627118644067796,73,45,28,234.49320382049171,0.4750453192640693,0.7749555059607884,0.14345991062630137,1081287.158930988,9610.898029537128,1090898.0569605252,3176,1,375.8238636363636,64,112,42,36.100968510461996,0.562795928030303,42.14743589743591,8386.863731173855,131.04474579959148,0
3378,32.709308339487706,4,3,175,0.02247191011235955,0.016853932584269662,0.9831460674157303,178,5800,4100,1700,0.7068965517241379,75,41,34,223.39618109920596,0.4751614771789501,0.7578756198860355,0.13560989127609702,1085000.7729479424,7077.005833251247,1092077.7787811935,3177,0,371.4157303370786,74,104,38,36.67655252988225,0.5620903558052435,42.43055555555554,8424.918377163855,113.85024834005209,8
3379,32.625694883814326,1,2,174,0.005681818181818182,0.011363636363636364,0.9886363636363636,176,5950,4200,1750,0.7058823529411765,77,42,35,223.1200897867568,0.474607683982684,0.7577479338842983,0.1363511659807956,1084270.6826316444,7234.514412384078,1091505.1970440284,3178,0,367.9318181818182,75,101,39,36.4351851851852,0.5651041666666667,42.18749999999999,8411.311962233363,112.15082616311152,0
3380,32.616172171181745,4,3,175,0.02247191011235955,0.016853932584269662,0.9831460674157303,178,5150,3700,1450,0.7184466019417476,66,37,29,218.77005755176523,0.4745643686916778,0.7562881368151779,0.13507015678135922,1087069.662421091,6813.658522127711,1093883.3209432187,3179,0,363.46629213483146,82,96,34,36.169003986000384,0.5682350187265918,41.8172690763052,8420.932403433066,102.69429760284227,0
3381,32.313922092216636,0,3,172,0.0,0.017142857142857144,0.9828571428571429,175,5650,4000,1650,0.7079646017699115,73,40,33,218.35858580463034,0.47427750410509034,0.7503549309685,0.1352420750438481,1077942.2132855484,6425.58745442874,1084367.800739977,3180,1,361.6514285714286,83,92,35,36.063751260262094,0.5699404761904762,41.70386904761902,8346.561052316158,100.5609765339296,0
3382,32.360551655355756,2,4,170,0.011494252873563218,0.022988505747126436,0.9770114942528736,174,5300,3600,1700,0.6792452830188679,70,36,34,213.11263576974795,0.4741621542311696,0.7440555500567219,0.13276301614871994,1081240.6340355775,5985.208284135388,1087225.842319713,3181,0,364.42528735632186,72,102,38,35.98637484360053,0.5720186781609196,41.49543378995436,8365.350367985568,116.18542177757733,0
3383,32.840699569470516,1,1,170,0.005847953216374269,0.005847953216374269,0.9941520467836258,171,5900,4200,1700,0.711864406779661,76,42,34,215.50086800619076,0.4732699805068226,0.74383913225252,0.13489639969669362,1098737.640729819,7255.783057670256,1105993.4237874893,3182,0,365.7543859649123,72,99,42,35.749714989702866,0.5744395711500975,41.32420091324203,8495.094203700983,117.98741949584698,0
3384,33.169721962455526,1,1,170,0.005847953216374269,0.005847953216374269,0.9941520467836258,171,6150,4700,1450,0.7642276422764228,76,47,29,213.75842173124894,0.47317681458548333,0.7448940609480146,0.13027593825085604,1101508.2074386834,6741.331189222114,1108249.5386279055,3183,0,366.70175438596493,73,98,37,36.77718301653194,0.565119395711501,42.286036036036045,8548.300530526989,117.100007267493,8
3385,32.64472591723003,1,2,169,0.005847953216374269,0.011695906432748537,0.9883040935672515,171,5700,3800,1900,0.6666666666666666,76,38,38,231.34819970544592,0.47266798532278403,0.7573988309092621,0.1365545333928364,1074201.7635778866,9802.928824831935,1084004.6924027186,3184,0,367.6900584795322,75,96,39,37.52721456429985,0.5561038011695907,43.46217105263159,8374.607113388107,111.66142817850809,8
3386,32.706826922208286,0,3,166,0.0,0.01775147928994083,0.9822485207100592,169,6300,4900,1400,0.7777777777777778,77,49,28,253.21362554975371,0.4726595519864751,0.7767922541577876,0.1460309402358468,1068958.3866980746,14034.9657315273,1082993.3524296018,3185,1,371.0118343195266,67,102,40,37.858248452166976,0.5418515779092703,44.33210784313727,8362.08549834036,124.80724624388598,8
3387,32.58746627957943,3,2,167,0.01775147928994083,0.011834319526627219,0.9881656804733728,169,5150,3800,1350,0.7378640776699029,65,38,27,250.25251609623322,0.47323042875927496,0.7753144841292738,0.1456302429867836,1067887.9972521693,14498.331644264777,1082386.328896434,3186,0,370.5443786982249,72,97,39,37.58592980695989,0.5457347140039448,43.992579908675815,8342.633169548188,115.86990513261372,0
3388,32.35334300439755,1,0,168,0.005952380952380952,0.0,1.0,168,6200,4100,2100,0.6612903225806451,83,41,42,247.6776347373387,0.4730776542153788,0.7723061645792444,0.14526110541292006,1062637.245673415,12838.295918438189,1075475.5415918531,3187,0,373.70238095238096,62,106,42,37.35242887555643,0.5481150793650793,43.700396825396815,8292.148973398895,133.74433828062735,0
3389,32.74445988646698,1,1,168,0.005917159763313609,0.005917159763313609,0.9940828402366864,169,5950,4600,1350,0.773109243697479,73,46,27,244.0236515891401,0.4735048605240913,0.767339812003756,0.1439606682133679,1077319.6196982595,12828.293505478443,1090147.913203738,3188,0,372.4852071005917,65,104,42,37.22203849545723,0.5502342209072979,43.48169191919191,8399.553449096378,129.22389921686735,0
3390,32.3926997490668,0,1,167,0.0,0.005952380952380952,0.9940476190476191,168,5600,4100,1500,0.7321428571428571,71,41,30,207.50724430792633,0.4733813622754491,0.7366277483458772,0.11756249017012639,1053100.6050803969,4505.200907848538,1057605.8059882454,3189,1,375.61309523809524,76,92,38,39.71685058446958,0.5398685515873016,45.008116883116884,8259.87550825433,108.68257247703066,8
3391,32.49751390714545,2,1,168,0.011834319526627219,0.005917159763313609,0.9940828402366864,169,5900,4300,1600,0.7288135593220338,75,43,32,215.21545115542352,0.47388202075702074,0.7487877639977705,0.12320811462593279,1059805.5601926171,5917.306354776272,1065722.8665473934,3190,0,372.97633136094674,68,101,39,39.11413075604422,0.5430843195266273,44.61050724637683,8299.523592499729,122.05181753676072,0
3392,32.16858894086306,3,1,170,0.017543859649122806,0.005847953216374269,0.9941520467836258,171,5200,3200,2000,0.6153846153846154,72,32,40,209.82930728285683,0.47406834078660703,0.7457796342912975,0.12129776277512692,1052102.7598634937,4752.398658507885,1056855.1585220017,3191,0,367.9590643274854,73,98,42,38.87614205514886,0.5460526315789473,44.242680180180194,8227.352089900665,112.70345328631048,0
3393,32.37435090733673,1,5,166,0.005847953216374269,0.029239766081871343,0.9707602339181287,171,5950,4400,1550,0.7394957983193278,75,44,31,208.57824341035982,0.4740769407178076,0.744111692397355,0.12117011321490055,1060369.0664180461,4083.9834480321497,1064453.0498660782,3192,0,368.87134502923976,77,94,38,38.71874728237242,0.5477582846003899,44.05715811965814,8285.983375255237,107.61017370461346,0
3394,31.870062618460445,1,1,166,0.005988023952095809,0.005988023952095809,0.9940119760479041,167,4650,2900,1750,0.6236559139784946,64,29,35,208.9780038007195,0.4733785441165861,0.7364497501172083,0.11791006116278266,1034830.0527535949,5201.343739487656,1040031.3964930826,3193,0,378.0179640718563,77,90,37,39.84011983370018,0.5411052894211577,45.165598290598275,8121.588339816495,105.47517324437007,8
3395,32.11461835211305,2,1,167,0.011904761904761904,0.005952380952380952,0.9940476190476191,168,5450,3900,1550,0.7155963302752294,70,39,31,207.62080357354938,0.4736969513354244,0.7394423780732948,0.1176090815429436,1044012.7929972225,4301.755004629898,1048314.5480018524,3194,0,374.7440476190476,74,94,39,39.7198467599906,0.5399305555555556,45.0138888888889,8188.781643422847,110.65921139760604,8
3396,31.70135387471837,6,0,173,0.03468208092485549,0.0,1.0,173,4300,2800,1500,0.6511627906976745,58,28,30,197.32348695655367,0.47511566294752877,0.7343714038354461,0.11076940630316776,1027773.16846366,1660.7570803269978,1029433.9255439871,3195,0,364.7456647398844,74,99,44,40.33648776408126,0.5363680154142583,45.361111111111114,8072.397526931769,109.08645306664553,8
3397,31.456330290460553,1,2,172,0.005747126436781609,0.011494252873563218,0.9885057471264368,174,6000,4400,1600,0.7333333333333333,76,44,32,197.79595545343994,0.47554426062498617,0.7355039079014423,0.11175647145601977,1021824.3039704239,-377.45709812478526,1021446.8468722991,3196,0,363.64367816091954,77,97,40,40.0706014880017,0.5385536398467433,45.11217948717948,8017.83546906689,104.12773336450506,0
3398,31.14753978852629,1,1,172,0.005780346820809248,0.005780346820809248,0.9942196531791907,173,5800,3900,1900,0.6724137931034483,77,39,38,219.952369690914,0.4750036407223193,0.761864365673758,0.12042553495980594,1002136.2241730507,3684.447451993755,1005820.6716250444,3197,0,366.728323699422,68,105,38,40.75202344819377,0.5254094412331407,46.33152173913045,7901.149019725392,116.1933679371381,8
3399,30.915155555528173,4,1,175,0.022727272727272728,0.005681818181818182,0.9943181818181818,176,4900,3100,1800,0.6326530612244898,67,31,36,225.28310423036768,0.47578125,0.7660634399607194,0.12444091028150389,997372.8128818797,4838.248672200787,1002211.0615540806,3198,0,359.83522727272725,81,95,36,40.263260985530465,0.5275213068181819,45.98577235772358,7852.889360878334,96.94925136886832,8
3400,30.48038474705024,5,4,176,0.027777777777777776,0.022222222222222223,0.9777777777777777,180,5700,3700,2000,0.6491228070175439,77,37,40,227.94283487110806,0.4768395665218291,0.7616431301930315,0.12720960809928322,986433.324218494,3270.081666738537,989703.4058852325,3199,0,352.77222222222224,71,109,37,39.78823097336745,0.5287615740740741,45.58738425925924,7754.5944122811825,109.21963960959413,8
3401,30.639193236657245,5,2,179,0.027624309392265192,0.011049723756906077,0.988950276243094,181,4600,2900,1700,0.6304347826086957,63,29,34,219.51199690726543,0.47663571720892167,0.7497670695360716,0.12378375664525405,994694.431134607,2869.4721781782555,997563.9033127852,3200,0,351.62983425414365,78,103,34,39.59379042690815,0.5326887661141805,45.18723628691979,7807.257506571651,100.09304495604681,0
3402,30.257719118966563,4,5,178,0.02185792349726776,0.0273224043715847,0.9726775956284153,183,6050,4600,1450,0.7603305785123967,75,46,29,223.59282846708004,0.4767346724313937,0.7744134900223156,0.12713516775925635,984759.0001833871,1387.010041883584,986146.0102252706,3201,0,348.76502732240436,79,104,42,39.16526317580211,0.5358037340619308,44.86979166666667,7719.658182513436,97.71719218371439,8
3403,30.2438107005228,1,3,176,0.00558659217877095,0.01675977653631285,0.9832402234636871,179,5850,4000,1850,0.6837606837606838,77,40,37,230.60761418786237,0.4761105182767351,0.7828372835680006,0.13151253466989768,985177.2749265205,3787.8761845810877,988965.1511111016,3202,0,357.1173184357542,59,120,39,38.870845236475745,0.5360800744878957,44.75694444444446,7719.522654845271,130.83936703127577,8
3404,30.690961387944814,5,2,179,0.027624309392265192,0.011049723756906077,0.988950276243094,181,5900,4200,1700,0.711864406779661,76,42,34,227.9343115809108,0.4773339983630039,0.7776256098901646,0.13019797482235543,1000224.2809310883,3497.0865801078376,1003721.3675111961,3203,0,354.1160220994475,64,117,40,38.876247567635446,0.5343577348066298,44.695512820512825,7835.540158194703,122.43031497179223,8
3405,31.11162771627843,2,0,181,0.011049723756906077,0.0,1.0,181,5150,3800,1350,0.7378640776699029,65,38,27,225.32933601134232,0.47732120933087785,0.7734806629834263,0.12956436820652184,1015929.0778957579,4433.724911373256,1020362.8028071311,3204,0,354.98342541436466,65,116,41,38.686028079710155,0.5366022099447514,44.44444444444444,7950.749305271149,122.3192200810946,0
3406,31.116706754719438,1,0,182,0.005494505494505495,0.0,1.0,182,5950,4100,1850,0.6890756302521008,78,41,37,225.026915386683,0.47742749883633867,0.7735768001453809,0.12995936461657853,1017414.1058104809,3439.111580286494,1020853.2173907674,3205,0,354.0274725274725,66,116,39,38.52418733787292,0.5383470695970696,44.27860696517413,7957.207597973022,120.56375148443972,0
3407,30.772104073321785,2,5,179,0.010869565217391304,0.02717391304347826,0.9728260869565217,184,5500,3900,1600,0.7090909090909091,71,39,32,249.52174016744166,0.4776749475330641,0.795822451948081,0.13936310696811757,996114.9052062042,7410.464910755603,1003525.3701169598,3206,0,351.16847826086956,63,121,37,39.20772564447003,0.5282495471014492,45.55664062499999,7829.757535453104,124.28186564211276,8
3408,30.621983733661093,5,7,177,0.02717391304347826,0.03804347826086957,0.9619565217391304,184,5850,4000,1850,0.6837606837606838,77,40,37,225.927936318129,0.4772987695018611,0.778774182404421,0.12739988305108077,994131.3812489354,2270.4102789329318,996401.7915278682,3207,0,352.0326086956522,70,114,38,39.43087382926455,0.5320991847826086,45.18779342723007,7802.855244809701,111.46936064013858,8
3409,31.0999282247322,1,2,176,0.0056179775280898875,0.011235955056179775,0.9887640449438202,178,4450,3000,1450,0.6741573033707865,59,30,29,226.92569324309557,0.476480670348505,0.7734268187526021,0.12854121499902343,1011018.4067295415,5835.210565726455,1016853.617295268,3208,0,363.3876404494382,69,109,41,39.228613461725516,0.5360486891385767,45.01488095238097,7930.018900755786,114.92781015588095,0
3410,31.6038869586492,2,1,177,0.011235955056179775,0.0056179775280898875,0.9943820224719101,178,6300,4600,1700,0.7301587301587301,80,46,34,208.4972894288147,0.47649125034384987,0.7537598105720522,0.11839518281764999,1028164.0387970755,973.8830354743122,1029137.9218325499,3209,0,362.7584269662921,80,98,38,39.60192420804972,0.5394428838951311,44.92026748971191,8061.511031697563,100.76888789621954,8
3411,31.198583722326852,4,2,179,0.022099447513812154,0.011049723756906077,0.988950276243094,181,5100,3700,1400,0.7254901960784313,65,37,28,200.26980551052267,0.47630576018006954,0.7483641678722779,0.11499833090229353,1018357.0909303973,-510.7646918215328,1017846.3262385757,3210,0,357.646408839779,73,108,40,39.37908609259359,0.5427601289134438,44.49605855855856,7971.361108445311,109.19672751294947,0
3412,31.279907949458977,2,0,181,0.011049723756906077,0.0,1.0,181,5450,4100,1350,0.7522935779816514,68,41,27,196.65048050984456,0.47605125844076124,0.7448080764391893,0.11365568126073425,1022974.7581649793,-1416.3044514828734,1021558.4537134964,3211,0,358.27624309392263,76,105,43,39.221215727761624,0.5445441988950277,44.25054112554113,7999.819531717035,105.26078331206625,0
3413,30.860723007253437,2,0,183,0.01092896174863388,0.0,1.0,183,5300,3800,1500,0.7169811320754716,68,38,30,198.98501212750608,0.47640690366100197,0.7508415120423473,0.11581214015190824,1011344.1783423249,-1651.5332814939675,1009692.645060831,3212,0,355.3497267759563,78,105,41,38.89307358192555,0.5468465391621129,43.9873417721519,7900.735731920265,101.2914837425675,0
3414,31.061354814090063,2,3,182,0.010810810810810811,0.016216216216216217,0.9837837837837837,185,6900,5200,1700,0.7536231884057971,86,52,34,197.6060270015999,0.47678099294947124,0.7485420861495897,0.11348086977199108,1013909.9217257034,-3829.057726055664,1010080.8639996478,3213,0,352.4972972972973,72,113,41,39.44301723816971,0.5363175675675675,44.49200913242013,7936.424362173272,110.22811614129544,8
3415,31.586097350867902,1,0,183,0.00546448087431694,0.0,1.0,183,5650,4000,1650,0.7079646017699115,73,40,33,222.363636363636,0.47683350347284775,0.7737357178340787,0.12479591836734703,1023962.0251026198,3288.3838800183853,1027250.4089826382,3214,0,357.1475409836066,71,112,40,39.70833333333335,0.5321607468123861,45.37037037037038,8042.756269896941,113.27825732249214,8
3416,31.48504148864609,5,5,183,0.026595744680851064,0.026595744680851064,0.973404255319149,188,6000,4500,1500,0.75,75,45,30,216.5199392277496,0.4775263587059582,0.7731685904506997,0.12291500875753386,1024208.2337266089,752.3009046090674,1024960.534631218,3215,0,348.6223404255319,81,107,38,39.40865871474345,0.5354609929078014,44.93140243902438,8030.845376658066,99.14623921800082,0
3417,31.74831352696083,1,2,182,0.005434782608695652,0.010869565217391304,0.9891304347826086,184,6100,4300,1800,0.7049180327868853,79,43,36,225.9701436258693,0.47688113764156176,0.7774521373540995,0.12896404738901998,1034415.942260813,3849.423808313213,1038265.3660691262,3216,0,357.08152173913044,65,119,39,38.96016240056057,0.536911231884058,44.72853535353537,8104.438494082492,124.68366913973065,0
3418,32.13050688651713,1,7,176,0.00546448087431694,0.03825136612021858,0.9617486338797814,183,5450,3600,1850,0.6605504587155964,73,36,37,225.6177060238691,0.4767346724313937,0.7758931148072925,0.12965918238490656,1049029.6781438696,5285.933906755701,1054315.6120506253,3217,0,359.91803278688525,66,117,42,38.69985600713881,0.5391051912568305,44.46517412935325,8210.463482381809,124.40096185426982,0
3419,32.121493793823674,1,2,175,0.005649717514124294,0.011299435028248588,0.9887005649717514,177,5500,3300,2200,0.6,77,33,44,223.23430675774506,0.476162579181647,0.765375088198645,0.12871886227246962,1049773.2269179022,5969.079712772084,1055742.3066306743,3218,0,366.3050847457627,68,109,40,38.63153232949516,0.5413724105461394,44.33876811594205,8212.220673285132,120.76795107772253,0
3420,32.511525178448665,3,1,177,0.016853932584269662,0.0056179775280898875,0.9943820224719101,178,5200,3900,1300,0.75,65,39,26,220.13975553456044,0.4759853943164265,0.7629100779222389,0.12830165355854856,1065874.535972238,6128.271955888647,1072002.8079281268,3219,0,365.0730337078652,72,106,38,38.29850469025728,0.5443000936329587,43.935502283105045,8325.047364829696,115.62565784485689,0
3421,32.1433884187891,1,1,177,0.0056179775280898875,0.0056179775280898875,0.9943820224719101,178,5350,3900,1450,0.7289719626168224,68,39,29,215.08354612953613,0.47614673924543477,0.7595785089445894,0.12593131521740322,1055219.8421063127,4442.085117295086,1059661.927223608,3220,0,366.0674157303371,75,103,40,38.25248506730858,0.5465238764044944,43.763706140350884,8236.3027205217,109.817369606956,8
3422,32.001899097858946,0,1,176,0.0,0.005649717514124294,0.9943502824858758,177,5100,3800,1300,0.7450980392156863,64,38,26,218.60325177561768,0.47611710323574735,0.7633165219467026,0.12617600521533198,1046177.0531138157,5239.541148742529,1051416.5942625583,3221,1,367.361581920904,69,108,42,38.71092310229105,0.5459628060263653,44.300595238095234,8182.866550573057,118.59226884888488,8
3423,32.35004751312715,3,4,175,0.01675977653631285,0.0223463687150838,0.9776536312849162,179,5600,4000,1600,0.7142857142857143,72,40,32,217.65980094696113,0.4759758228192413,0.7648625291056717,0.1268260458362261,1060506.4963977004,4765.926581776741,1065272.422979477,3222,0,364.22346368715085,74,105,39,38.37114431908585,0.5480679702048417,43.944444444444464,8283.409388222437,111.93796470570861,0
3424,32.80078150698865,0,1,174,0.0,0.005714285714285714,0.9942857142857143,175,6550,4700,1850,0.7175572519083969,84,47,37,224.23354667310716,0.47515736179529283,0.7690072213500785,0.13113915647334665,1076443.0696772027,6724.929461081145,1083167.9991382838,3223,1,373.2742857142857,73,102,42,38.06158424908424,0.5498809523809524,43.806306306306304,8403.353370315217,115.11442973034544,0
3425,33.07969938306566,1,4,171,0.005714285714285714,0.022857142857142857,0.9771428571428571,175,5350,3700,1650,0.6915887850467289,70,37,33,228.77073832160838,0.47498084291187737,0.7737227971757419,0.1346192751000061,1087545.8670223253,9409.73419146218,1096955.6012137874,3224,0,374.19428571428574,59,116,43,37.710167005190684,0.5520833333333333,43.576388888888886,8482.415970275686,143.76976220806247,0
3426,33.25081538211897,3,3,171,0.017241379310344827,0.017241379310344827,0.9827586206896551,174,5100,3400,1700,0.6666666666666666,68,34,34,218.00205617432124,0.474768426239674,0.7594894413258497,0.1292977712482181,1095669.5503058669,7871.642970854553,1103541.1932767215,3225,0,371.17241379310343,66,108,45,37.687111393733865,0.5547772988505747,43.28358208955224,8536.030217499196,129.33379117423024,0
3427,33.375963714898646,5,1,175,0.028409090909090908,0.005681818181818182,0.9943181818181818,176,4500,2900,1600,0.6444444444444445,61,29,32,202.20076519517795,0.47530167748917745,0.7436476208548319,0.11907676956311328,1097533.6638813212,4684.429332853855,1102218.093214175,3226,0,364.8068181818182,71,105,40,38.36196359396746,0.549124053030303,43.54745370370369,8559.350879778509,120.55423774335928,8
3428,33.2292212037234,0,0,175,0.0,0.0,1.0,175,5800,4400,1400,0.7586206896551724,72,44,28,228.58516169201727,0.4751751505199781,0.768609980723924,0.1310298236924852,1084080.570496917,8760.94649884251,1092841.5169957594,3227,1,367.8857142857143,67,108,38,38.72295102448774,0.544345238095238,44.56188725490197,8488.009552268515,126.68670973535097,8
3429,33.03342450939869,4,3,176,0.0223463687150838,0.01675977653631285,0.9832402234636871,179,5650,4000,1650,0.7079646017699115,73,40,33,229.89159293660904,0.4757692026028916,0.7742359513637849,0.13160266270588614,1077264.7112293683,8080.820095783241,1085345.5313251517,3228,0,360.64245810055866,63,116,40,38.74148928260363,0.5382332402234637,44.61263020833334,8436.31940066693,133.90983175661793,8
3430,32.87177765118336,4,5,175,0.022222222222222223,0.027777777777777776,0.9722222222222222,180,4650,3100,1550,0.6666666666666666,62,31,31,226.2063207731041,0.47532653114007867,0.7705164553592223,0.13072047508850734,1074993.2821512397,7984.0550422470915,1082977.3371934867,3229,0,357.18888888888887,67,113,45,38.47041279824298,0.5414930555555555,44.255514705882355,8406.775856104574,125.4742665090235,0
3431,32.953126004051455,2,4,173,0.011299435028248588,0.022598870056497175,0.9774011299435028,177,5400,3900,1500,0.7222222222222222,69,39,30,218.48175103724876,0.4749695043656908,0.7548479534508978,0.12341696969285121,1070375.2234820568,5971.490618649045,1076346.7141007057,3230,0,363.03389830508473,75,102,35,39.55196458019644,0.5355461393596987,45.120614035087705,8399.072521536982,111.9876336204931,8
3432,33.16316710579437,2,0,175,0.011428571428571429,0.0,1.0,175,5200,3700,1500,0.7115384615384616,67,37,30,244.19065243109276,0.47457991242474,0.7832218844984793,0.13919425977250618,1080124.515566158,12551.262032583636,1092675.7775987417,3231,0,367.6742857142857,60,115,39,38.542224229448216,0.5360119047619047,44.77459016393443,8464.0829160383,141.06804860063832,7
3433,33.165970126947464,1,2,174,0.005681818181818182,0.011363636363636364,0.9886363636363636,176,6050,4600,1450,0.7603305785123967,75,46,29,239.79993620747902,0.4748451028138528,0.7785741905771537,0.13739249357079125,1081862.9425750738,10636.132922947745,1092499.0754980214,3232,0,366.57954545454544,63,113,37,38.455110027825576,0.5379379734848485,44.58007812500001,8471.249498733516,134.46427775767486,0
3434,33.1881153598042,3,2,175,0.01694915254237288,0.011299435028248588,0.9887005649717514,177,6050,4300,1750,0.7107438016528925,78,43,35,233.5267734209073,0.4745414954631056,0.7717283932083279,0.1346535889643543,1084631.8412278914,9208.114846305769,1093839.956074197,3233,0,365.3276836158192,68,109,41,38.36839385887218,0.5407250470809792,44.33876811594205,8484.91445679782,124.77815377643853,0
3435,33.3796852715848,2,6,171,0.011299435028248588,0.03389830508474576,0.9661016949152542,177,6600,5300,1300,0.803030303030303,79,53,26,246.25613654236383,0.47419641328539636,0.7835615703698213,0.14140368092023778,1089548.9227545236,11661.621658284601,1101210.5444128083,3234,0,365.9717514124294,66,111,39,38.20433248144093,0.541960922787194,44.49626865671642,8528.634137954357,129.2217293629448,8
3436,32.91698353580349,3,3,171,0.017241379310344827,0.017241379310344827,0.9827586206896551,174,5650,4000,1650,0.7079646017699115,73,40,33,232.70688230132768,0.47354826921799215,0.766115160946842,0.13280550227686883,1072485.350832552,9464.944461217994,1081950.29529377,3235,0,372.92528735632186,66,108,38,38.789156871104616,0.5395114942528736,44.72947761194032,8402.735582623758,127.31417549429936,7
3437,32.80719565684538,0,1,170,0.0,0.005847953216374269,0.9941520467836258,171,5600,3700,1900,0.6607142857142857,75,37,38,233.9562629262483,0.47287438367159734,0.7637490968240237,0.13412077459449676,1070341.0167160644,10282.59686551454,1080623.613581579,3236,1,375.7076023391813,66,105,37,38.58224284844796,0.5415448343079923,44.558457711442806,8380.32065674708,126.9745554052588,0
3438,32.6474985579087,1,1,170,0.005847953216374269,0.005847953216374269,0.9941520467836258,171,5050,3400,1650,0.6732673267326733,67,34,33,231.41942942019003,0.47281705079692693,0.7616635690895832,0.1334156307865398,1066909.7613470966,10130.729642755607,1077040.4909898522,3237,0,376.6900584795322,69,102,39,38.428890182382624,0.5436159844054581,44.345238095238116,8346.488470608254,120.96360102330803,0
3439,32.905752288013844,2,1,171,0.011627906976744186,0.005813953488372093,0.9941860465116279,172,5750,4200,1550,0.7304347826086957,73,42,31,230.6187228827909,0.4728285507049277,0.7642691400274815,0.13415369288318038,1078197.9939880609,9580.528877662913,1087778.5228657238,3238,0,371.0755813953488,72,100,36,38.103167967298404,0.5466327519379846,44.00684931506851,8423.647203866589,116.99510005370263,0
3440,33.32359218561361,1,1,171,0.005813953488372093,0.005813953488372093,0.9941860465116279,172,4500,3300,1200,0.7333333333333333,57,33,24,234.44850394278652,0.47325921392628856,0.7658064260092312,0.13537798864032696,1089518.3004953573,12187.187113885146,1101705.4876092423,3239,0,371.1337209302326,73,99,41,38.28970787918823,0.544452519379845,44.284909909909935,8521.345377869668,116.73075860095435,8
3441,33.40106886967164,0,0,171,0.0,0.0,1.0,171,5850,4100,1750,0.7008547008547008,76,41,35,229.82325151338995,0.4727238848755877,0.763892422922273,0.13105603032057914,1088000.6379505189,9959.56885248638,1097960.2068030052,3240,1,374.046783625731,64,107,39,38.89359787363181,0.5402046783625731,44.7596153846154,8525.301664859971,133.20783851343705,8
3442,32.91566019324331,1,2,170,0.005813953488372093,0.011627906976744186,0.9883720930232558,172,5550,4200,1350,0.7567567567567568,69,42,27,223.62768187374564,0.4730906319416111,0.758933602328604,0.1282789028022894,1074076.731923473,8088.657942915127,1082165.3898663882,3241,0,372.8662790697674,68,104,36,38.82212011976522,0.5421511627906976,44.53502415458939,8408.798336202679,123.6587990618041,0
3443,33.14913578059078,3,0,173,0.017341040462427744,0.0,1.0,173,5600,4000,1600,0.7142857142857143,72,40,32,217.4967475275285,0.47263437065913877,0.7571955009684366,0.12573550621445112,1084186.0692598547,6961.388755734841,1091147.4580155895,3242,0,371.6184971098266,69,104,43,38.678397917030324,0.5444966281310212,44.24107142857143,8478.187450312706,122.87228188858994,8
3444,33.48000236404096,3,3,173,0.017045454545454544,0.017045454545454544,0.9829545454545454,176,5450,4200,1250,0.7706422018348624,67,42,25,210.6820895488425,0.47285308441558443,0.7537867485685246,0.1226240276808914,1097191.760702472,5581.730556114316,1102773.4912585863,3243,0,366.26704545454544,74,102,42,38.59235700464749,0.5467566287878788,43.98611111111113,8571.345605227363,115.82899466523463,0
3445,33.02731006393267,1,3,171,0.005747126436781609,0.017241379310344827,0.9827586206896551,174,5450,3800,1650,0.6972477064220184,71,38,33,231.85135730503126,0.47286655925409166,0.7642478851304741,0.13183431004799295,1074905.435533527,9593.656840600297,1084499.0923741274,3244,0,371.4597701149425,80,94,36,38.953576289127426,0.5369372605363985,44.868827160493794,8426.296352345084,105.32870440431354,8
3446,32.59791644990193,2,4,169,0.011560693641618497,0.023121387283236993,0.976878612716763,173,6000,4100,1900,0.6833333333333333,79,41,38,228.00754020707933,0.47257975982434913,0.7604335793030179,0.13049731202705797,1062997.239015206,7874.277142954852,1070871.5161581608,3245,0,374.32369942196533,72,101,36,38.797587118883996,0.540040944123314,44.62043378995434,8324.841762327276,115.6228022545455,0
3447,32.856602061855014,2,0,171,0.011695906432748537,0.0,1.0,171,6150,4500,1650,0.7317073170731707,78,45,33,206.80829820108502,0.47261495241371404,0.7395672761146059,0.11527532029637574,1062943.3533585593,3615.101198447839,1066558.4545570072,3246,0,376.62573099415204,67,104,40,40.37369517213692,0.5325901559454191,45.63419117647061,8357.596158656641,124.74024117397971,8
3448,33.03376428840149,3,2,172,0.017241379310344827,0.011494252873563218,0.9885057471264368,174,5150,3600,1550,0.6990291262135923,67,36,31,199.4332713743216,0.4732645117710894,0.7339992104020832,0.11203291136976765,1071199.4249650957,2776.5611230162035,1073975.986088112,3247,0,371.11494252873564,72,102,45,40.25501484843392,0.5348419540229885,45.33390410958904,8412.579783891288,116.84138588737899,0
3449,33.18022684433615,3,1,174,0.017142857142857144,0.005714285714285714,0.9942857142857143,175,5450,4000,1450,0.7339449541284404,69,40,29,195.8524585108261,0.47396414887794197,0.7316509386877568,0.11099101402966587,1078795.318816292,1806.9430840284303,1080602.2619003204,3248,0,369.85714285714283,75,100,43,40.00296739227808,0.5371428571428571,44.997258771929836,8461.048799874945,112.8139839983326,0
3450,32.84946967558686,1,2,173,0.005714285714285714,0.011428571428571429,0.9885714285714285,175,5350,3600,1750,0.6728971962616822,71,36,35,187.10671186389217,0.4738834154351396,0.7197731660231663,0.10650689752252224,1069463.1150030433,-329.254618413398,1069133.8603846298,3249,0,370.8514285714286,86,89,44,40.05313907657651,0.5442857142857143,44.82758620689652,8382.27846894277,97.46835429003221,7
3451,33.22424970825836,5,2,176,0.028089887640449437,0.011235955056179775,0.9887640449438202,178,5600,3800,1800,0.6785714285714286,74,38,36,180.43452326147772,0.47495384477030833,0.7149847225740746,0.10387354913169992,1085298.22357956,-2034.9464863782468,1083263.2770931816,3250,0,364.9157303370786,76,102,42,39.78743251825977,0.5473431647940075,44.39935064935068,8492.13979961904,111.73868157393474,0
3452,33.23363684620811,2,0,178,0.011235955056179775,0.0,1.0,178,6300,4800,1500,0.7619047619047619,78,48,30,188.18200473595434,0.4751370109397152,0.7276311909617512,0.10692426942713254,1081381.6439691067,-1200.6868706469995,1080180.9570984598,3251,0,365.0730337078652,88,90,42,40.09642442038296,0.5420177902621723,44.89700374531831,8478.000335907549,96.34091290804032,8
3453,32.97550187872026,5,1,182,0.0273224043715847,0.00546448087431694,0.994535519125683,183,6450,4700,1750,0.7286821705426356,82,47,35,183.7105903283188,0.476064122580516,0.7281746803103624,0.10376062096656988,1071056.5216083091,-3697.1148280684783,1067359.4067802406,3252,0,356.07103825136613,80,103,40,40.443724035857876,0.533754553734062,45.12602880658435,8404.597115925335,105.05746394906669,8
3454,33.15534212346079,4,5,181,0.021505376344086023,0.026881720430107527,0.9731182795698925,186,5800,4200,1600,0.7241379310344828,74,42,32,185.82749096724896,0.47626235106073816,0.7346885843826638,0.1060372563289678,1080208.1753117044,-2853.525011902863,1077354.6502998015,3253,0,351.2956989247312,72,114,46,39.99105595617415,0.5370183691756272,44.734589041095916,8463.412032628346,117.54738934206037,0
3455,33.13864342328659,1,0,182,0.005494505494505495,0.0,1.0,182,7050,5200,1850,0.7375886524822695,89,52,37,185.03807226188727,0.4750546414911056,0.7273788514410455,0.10616314102261963,1081414.2841349652,-3429.4371094390835,1077984.847025526,3254,0,357.14285714285717,74,108,44,39.80056902613175,0.5394917582417582,44.527777777777814,8466.002876776938,114.40544428076943,0
3456,33.1551070329172,2,2,182,0.010869565217391304,0.010869565217391304,0.9891304347826086,184,6050,4500,1550,0.743801652892562,76,45,31,205.365486555765,0.4752724815870753,0.7550650655945832,0.11865003538661963,1084186.3606032832,1680.8918924836357,1085867.2524957669,3255,0,354.25,76,108,42,39.01213587953168,0.5446105072463768,44.26406926406928,8478.952155712515,111.56515994358573,7
3457,32.865649688857665,3,2,183,0.016216216216216217,0.010810810810810811,0.9891891891891892,185,5750,4100,1650,0.7130434782608696,74,41,33,213.86899315472576,0.4753623188405797,0.767292546040971,0.12219933181041584,1071190.729645726,3068.896565201718,1074259.6262109277,3256,0,353.27027027027026,67,118,40,39.22402801943966,0.5406531531531531,44.68443627450982,8391.11187751521,125.2404757838091,8
3458,33.03207304509208,1,0,184,0.005434782608695652,0.0,1.0,184,5700,3700,2000,0.6491228070175439,77,37,40,216.6929078069356,0.47503984517304193,0.7678080961217573,0.12469371040121624,1078884.1871574312,4257.3103404133435,1083141.4974978445,3257,0,354.44565217391306,71,113,42,38.877174610362665,0.5426856884057971,44.415509259259274,8442.48556734084,118.90824742733578,0
3459,33.177363439338066,1,3,182,0.005405405405405406,0.016216216216216217,0.9837837837837837,185,6600,4900,1700,0.7424242424242424,83,49,34,213.75094696434476,0.47489595573834703,0.7665158488965191,0.12387733396409341,1085903.6149958477,2822.585203473813,1088726.2001993216,3258,0,353.5243243243243,75,110,40,38.678606185603805,0.5447072072072072,44.14747807017546,8488.51210693706,113.18016142582746,0
3460,33.49988196751479,1,5,178,0.00546448087431694,0.0273224043715847,0.9726775956284153,183,6550,5000,1550,0.7633587786259542,81,50,31,217.71939634396597,0.47440526231509833,0.7645767082700234,0.12496260935839996,1093329.831337493,4457.82217673026,1097787.6535142232,3259,0,358.10382513661204,70,113,39,38.950461314651065,0.5414389799635702,44.5129107981221,8558.78733248691,122.26839046409873,8
3461,33.20252474250013,2,2,178,0.011111111111111112,0.011111111111111112,0.9888888888888889,180,6500,4800,1700,0.7384615384615385,82,48,34,216.82806376597503,0.47487973308504033,0.7598607315315953,0.12538669036060965,1086028.665338249,4596.298539927897,1090624.9638781769,3260,0,360.72222222222223,75,105,41,38.68389734383653,0.5439814814814814,44.22971491228071,8492.219219021343,113.22958958695123,0
3462,33.11056565805141,2,3,177,0.011111111111111112,0.016666666666666666,0.9833333333333333,180,5550,4400,1150,0.7927927927927928,67,44,23,216.05807930594182,0.47504590833850613,0.7573305295527508,0.12549756521387734,1084437.311101578,5310.288512861592,1089747.5996144395,3261,0,360.8388888888889,79,101,36,38.53276353276356,0.5462384259259259,44.062500000000014,8474.235398107568,107.26880250769074,0
3463,33.10926909484239,2,1,178,0.0111731843575419,0.00558659217877095,0.994413407821229,179,5350,3800,1550,0.7102803738317757,69,38,31,216.69342896099403,0.4744209403050656,0.7563842857111553,0.12649540898844353,1085980.0278970625,5914.947205634311,1091894.9751026968,3262,0,362.7486033519553,82,97,39,38.325452436952844,0.5481843575418994,43.87550200803214,8480.094925797524,103.41579177801859,0
3464,33.504329808331136,3,2,179,0.016574585635359115,0.011049723756906077,0.988950276243094,181,5350,3400,1950,0.6355140186915887,73,34,39,222.08954612722408,0.4743989154900757,0.7663686099842635,0.13044448043415222,1100909.706353533,7350.107402222241,1108259.8137557553,3263,0,359.6685082872928,69,112,39,37.952475281051086,0.5515078268876612,43.64583333333333,8588.974547739876,124.47789199623008,7
3465,33.890810087289275,5,1,183,0.02717391304347826,0.005434782608695652,0.9945652173913043,184,5400,3900,1500,0.7222222222222222,69,39,30,209.357573461896,0.4745337372297458,0.7547031718211126,0.12426364155001365,1116999.5024462922,4570.461078060062,1121569.9635243523,3264,0,354.75,77,107,40,37.88074338968357,0.5543478260869565,43.25587606837606,8701.266345194106,113.00345902849489,0
3466,33.36804367167036,1,0,184,0.005434782608695652,0.0,1.0,184,6200,4500,1700,0.7258064516129032,79,45,34,204.6697169334528,0.4742664528391542,0.7500942294420554,0.12221092021616961,1101665.9323100743,2095.530904226345,1103761.4632143006,3265,0,354.66847826086956,82,102,35,37.775335775335776,0.5566123188405797,43.034638554216876,8574.431402829472,104.56623661987162,0
3467,33.748771838244984,1,5,180,0.005405405405405406,0.02702702702702703,0.972972972972973,185,6500,4700,1800,0.7230769230769231,83,47,36,203.18912549430024,0.474242312965139,0.7497406780308322,0.12192496139751248,1115805.7549241353,1843.9191129085152,1117649.6740370437,3266,0,353.74594594594595,85,100,39,37.628748626157936,0.5587837837837838,42.85368217054263,8678.372409471183,102.0984989349551,0
3468,33.372457919611485,1,4,177,0.0055248618784530384,0.022099447513812154,0.9779005524861879,181,5800,4100,1700,0.7068965517241379,75,41,34,202.64856990581373,0.4737031921424186,0.7417989351628289,0.11823403317021348,1094442.9552859506,2357.459946438181,1096800.4152323888,3267,0,360.6243093922652,85,96,39,38.70542470677261,0.5500690607734806,43.89534883720931,8546.841693947039,100.5510787523181,8
3469,32.809380929998795,3,0,180,0.016666666666666666,0.0,1.0,180,5450,4100,1350,0.7522935779816514,68,41,27,228.13300267310228,0.4736279226153528,0.7690873919803283,0.13302708106536024,1075797.8416955105,7634.998379048304,1083432.8400745587,3268,0,363.03333333333336,74,106,40,38.0745606898796,0.5481481481481482,43.91666666666669,8401.935633157258,113.53967071834133,8
3470,32.84277229099418,2,1,181,0.01098901098901099,0.005494505494505495,0.9945054945054945,182,5750,3900,1850,0.6782608695652174,76,39,37,229.0033689298034,0.4738530346265153,0.7747016367953277,0.1345716426407716,1079326.5405112586,7283.882790485421,1086610.423301744,3269,0,360.032967032967,67,115,39,37.756433237731024,0.5504807692307692,43.62745098039214,8419.985249112688,125.67142162854758,0
3471,33.03785805406248,1,5,177,0.005494505494505495,0.027472527472527472,0.9725274725274725,182,5750,4200,1550,0.7304347826086957,73,42,31,227.61798640874252,0.4739858438062858,0.7777352065261289,0.1305678496952118,1078064.191941777,6927.360117831155,1084991.5520596083,3270,0,360.07142857142856,68,114,38,38.72018181460034,0.5417811355311355,44.53502415458938,8440.015609765194,124.11787661419403,7
3472,32.53709463186227,2,0,179,0.0111731843575419,0.0,1.0,179,6000,4500,1500,0.75,75,45,30,208.69909361192595,0.47380761827045803,0.7559896226968028,0.11803687024709508,1057255.0539259913,2329.6342941965304,1059584.6882201878,3271,0,365.6480446927374,73,106,38,39.7528989508559,0.5336359404096834,45.073198198198206,8294.577474423239,113.6243489647019,8
3473,32.50248577982169,3,1,181,0.016483516483516484,0.005494505494505495,0.9945054945054945,182,6000,4500,1500,0.75,75,45,30,207.0443971339676,0.4745037996073908,0.7581514773862239,0.11846859883345998,1059803.565173043,1485.278046336659,1061288.8432193797,3272,0,360.6043956043956,70,112,43,39.342994752767275,0.53680173992674,44.63028169014086,8300.150637963301,118.57358054233288,0
3474,32.60254541409453,2,2,181,0.01092896174863388,0.01092896174863388,0.9890710382513661,183,5750,3700,2050,0.6434782608695652,78,37,41,196.99907029284802,0.4750733101142937,0.7470597506785399,0.113450089399067,1065102.4629620689,-385.16100596965134,1064717.3019560992,3273,0,357.5136612021858,76,107,40,39.35024697891856,0.5404713114754098,44.385822510822535,8333.67283007739,109.65358986943934,7
3475,32.13959304910193,5,2,184,0.026881720430107527,0.010752688172043012,0.989247311827957,186,5800,4100,1700,0.7068965517241379,75,41,34,187.1011357490525,0.475620580257677,0.7385658914728666,0.10872093023255827,1052758.4245285916,-3605.5406202631093,1049152.8839083284,3274,0,352.6182795698925,83,103,37,39.25872093023255,0.5434027777777778,44.04761904761907,8226.205363758298,99.11090799708792,0
3476,31.957239546869808,1,3,182,0.005405405405405406,0.016216216216216217,0.9837837837837837,185,6350,4800,1550,0.7559055118110236,79,48,31,188.997056634859,0.47492288484136314,0.7396557341655374,0.11036851017226557,1048307.3308476218,-3724.6000042106275,1044582.7308434112,3275,0,355.5189189189189,83,102,40,39.0206669087388,0.545045045045045,43.86160714285716,8185.475977686006,98.62019250224104,0
3477,31.78335098536219,2,0,184,0.010869565217391304,0.0,1.0,184,5600,3600,2000,0.6428571428571429,76,36,40,184.71541188165037,0.4748016403342045,0.7339858437003204,0.10862274903484079,1044724.3014303348,-3804.6640717052524,1040919.6373586295,3276,0,358.2391304347826,76,108,43,38.8651093054749,0.5471580615942029,43.601190476190474,8149.21335532426,107.22649151742448,0
3478,31.602343475231063,4,1,187,0.02127659574468085,0.005319148936170213,0.9946808510638298,188,5800,4100,1700,0.7068965517241379,75,41,34,198.08413161182833,0.4751654530284067,0.756165870603561,0.11286188894162323,1029150.7525503185,-2628.313376682034,1026522.4391736365,3277,0,351.59574468085106,80,108,43,39.73639455782315,0.5397828014184397,44.79166666666667,8065.181407741272,100.8147675967659,8
3479,31.585870684731177,3,2,188,0.015789473684210527,0.010526315789473684,0.9894736842105263,190,5950,4400,1550,0.7394957983193278,75,44,31,189.251409981177,0.47589111668059036,0.7470894767495309,0.10867714747079675,1031014.8047880229,-4925.798896479566,1026089.0058915433,3278,0,348.81052631578945,76,114,41,39.658561444379714,0.5412280701754386,44.494047619047635,8070.377971083884,106.1891838300511,8
3480,31.426797416330967,2,0,190,0.010526315789473684,0.0,1.0,190,5800,4100,1700,0.7068965517241379,75,41,34,181.7660530129364,0.47588241436925643,0.7363745789680327,0.10497916939318605,1027565.0949198385,-6444.709696511414,1021120.3852233271,3279,0,349.7473684210526,82,108,47,39.62893436722947,0.5432565789473685,44.27710843373495,8036.5515079714105,98.00672570696842,0
3481,31.01579993130278,0,4,186,0.0,0.021052631578947368,0.9789473684210527,190,6000,4000,2000,0.6666666666666666,80,40,40,208.56977732578167,0.4758928571428571,0.770136189756053,0.11875193811337871,1009835.4303692966,-1875.7698304380374,1007959.6605388585,3280,1,350.7473684210526,76,114,44,39.49641273038934,0.5332785087719298,44.81872294372296,7914.651435391868,104.14015046568248,8
3482,30.825607741938455,1,1,186,0.0053475935828877,0.0053475935828877,0.9946524064171123,187,6300,4300,2000,0.6825396825396826,83,43,40,228.27058792352048,0.4748828416997297,0.7845904149560745,0.1307541568482426,1005446.5051939315,2202.772973253604,1007649.2781671851,3281,0,357.2994652406417,66,121,39,38.75928293158022,0.5401069518716577,44.58955223880597,7873.182275879434,119.29064054362779,8
3483,30.541625005610946,5,4,187,0.02617801047120419,0.020942408376963352,0.9790575916230366,191,5400,3900,1500,0.7222222222222222,69,39,30,225.8829180929591,0.4756016349774961,0.786971221066058,0.13078132801963716,999349.6354594517,1547.2023705433694,1000896.8378299951,3282,0,350.6282722513089,71,120,35,38.4055819477435,0.5429210296684119,44.18402777777779,7813.035494056929,110.04275343742152,0
3484,30.688345402114347,1,1,187,0.005319148936170213,0.005319148936170213,0.9946808510638298,188,6800,5300,1500,0.7794117647058824,83,53,30,206.98623618873071,0.47464159745135964,0.7638286088532367,0.1180723282123482,999735.4841480651,-3013.7029903745233,996721.7811576906,3283,0,355.5425531914894,69,119,38,39.463638527759976,0.5364583333333333,44.747023809523824,7833.291498251032,113.52596374276858,8
3485,30.577813081045285,3,2,188,0.015789473684210527,0.010526315789473684,0.9894736842105263,190,6600,5100,1500,0.7727272727272727,81,51,30,207.9222339784303,0.4747836025248306,0.7671748523776796,0.11614345801588732,989863.2154936019,-3437.0857802995024,986426.1297133024,3284,0,352.7473684210526,73,117,36,40.26125802168622,0.5326206140350878,45.55180180180181,7780.469443313286,106.58177319607242,8
3486,30.380141778686067,1,1,188,0.005291005291005291,0.005291005291005291,0.9947089947089947,189,6450,4700,1750,0.7286821705426356,82,47,35,202.96348454282867,0.47471645277496344,0.7586059662617584,0.1139842008201098,985066.1807739804,-4263.507088963606,980802.6736850168,3285,0,355.16402116402116,80,109,39,40.176076490590134,0.535163139329806,45.3446502057613,7736.465631449824,96.7058203931228,0
3487,30.338219392958276,5,6,187,0.025906735751295335,0.031088082901554404,0.9689119170984456,193,6100,4000,2100,0.6557377049180327,82,40,42,197.08339359030208,0.4750085456246402,0.7557820038759486,0.111793085888228,986669.1979327457,-5808.777224078798,980860.4207086669,3286,0,348.6476683937824,91,102,39,39.935118386977486,0.5384283246977548,44.96150362318839,7737.413856729863,85.02652589813036,0
3488,30.686567504430315,4,0,191,0.020942408376963352,0.0,1.0,191,6300,4800,1500,0.7619047619047619,78,48,30,194.3206914581869,0.475153853219436,0.7532962378679988,0.11131774009601349,1000938.652300983,-5599.381795529431,995339.2705054536,3287,0,352.81675392670155,75,116,43,39.62285350147571,0.5412303664921466,44.586074561403514,7837.776664543034,104.50368886057379,0
3489,31.13231321674701,3,1,193,0.015463917525773196,0.005154639175257732,0.9948453608247423,194,6950,5300,1650,0.762589928057554,86,53,33,189.87869046478403,0.47565122945711585,0.7517227798227211,0.10960906683010166,1017784.01190206,-7098.900928808461,1010685.1109732515,3288,0,348.3453608247423,81,113,44,39.440970324738785,0.5434922680412371,44.29623983739838,7960.649552082087,98.27962409977886,0
3490,30.75900606682111,4,4,193,0.02030456852791878,0.02030456852791878,0.9796954314720813,197,6550,4900,1650,0.7480916030534351,82,49,33,199.95453326242338,0.47614946994026036,0.7588881456240362,0.11365434029124148,1000968.1931123661,-5920.374427137679,995047.8186852285,3289,0,343.98984771573606,90,107,41,39.782066526076456,0.5395516074450084,44.883241758241724,7847.137914505882,87.19042127228758,8
3491,30.76812447248789,4,2,195,0.02030456852791878,0.01015228426395939,0.9898477157360406,197,5800,4100,1700,0.7068965517241379,75,41,34,193.57816265706515,0.4758408439517939,0.7514162367547654,0.11096805324263402,1003802.353386304,-6337.156952128417,997465.1964341756,3290,0,344.16751269035535,80,117,43,39.61542818305391,0.5423011844331641,44.56018518518517,7859.404017451441,98.24255021814301,0
3492,30.69969495829122,2,4,193,0.01015228426395939,0.02030456852791878,0.9796954314720813,197,7000,5400,1600,0.7714285714285715,86,54,32,191.34654566999964,0.4759217773403778,0.7453615087648198,0.11036944933130181,1003407.3158754323,-8000.295241446203,995407.0206339861,3291,0,345.0304568527919,84,113,44,39.43374634520442,0.544945008460237,44.32598039215685,7849.11441072092,93.4418382228681,0
3493,31.092078911100458,4,4,193,0.02030456852791878,0.02030456852791878,0.9796954314720813,197,7000,5000,2000,0.7142857142857143,90,50,40,200.3999447863404,0.4752289875341,0.7599277732592631,0.11587744079058597,1016973.7036205996,-5639.705189053979,1011333.9984315456,3292,0,345.60913705583755,81,116,40,39.107148769908264,0.5447863790186125,44.232723577235795,7952.336341413888,98.17699186930726,8
3494,31.04381222038815,1,2,192,0.005154639175257732,0.010309278350515464,0.9896907216494846,194,5600,3500,2100,0.625,77,35,42,215.78166525383693,0.47511985203781854,0.7789692356004554,0.12397969328930668,1013485.0669820475,-661.7009073432082,1012823.3660747043,3293,0,351.7783505154639,71,123,41,38.959583663609266,0.5402169243986255,44.47337962962965,7932.520420088226,111.72563971955249,8
3495,30.886583491931855,2,3,191,0.010309278350515464,0.015463917525773196,0.9845360824742269,194,6400,4700,1700,0.734375,81,47,34,212.26396377855716,0.47513598810604846,0.7757314952987486,0.1228622779658548,1010554.686264145,-2299.1313357148547,1008255.5549284301,3294,0,352.7525773195876,74,120,38,38.7646143265646,0.5427405498281788,44.19444444444448,7900.959649366755,106.76972499144263,0
3496,31.086862515328782,2,2,191,0.010362694300518135,0.010362694300518135,0.9896373056994818,193,5300,3100,2200,0.5849056603773585,75,31,44,183.72242033316206,0.474962444228555,0.7445031708671466,0.10884434563679538,1024032.3278064663,-6272.460447199102,1017759.8673592672,3295,0,355.3056994818653,75,118,47,38.609416439721635,0.5535945595854923,43.32510964912278,7979.217027474745,106.38956036632993,8
3497,31.187489919957027,2,5,188,0.010362694300518135,0.025906735751295335,0.9740932642487047,193,5850,4100,1750,0.7008547008547008,76,41,35,179.64547200447433,0.4750130433218192,0.7380357877880812,0.10709572050830676,1029196.8831829655,-7471.888027012759,1021724.9951559526,3296,0,354.95336787564764,80,113,39,38.47893827902086,0.5555915371329879,43.09413580246911,8012.249050038283,100.15311312547854,0
3498,31.4881119465213,0,4,184,0.0,0.02127659574468085,0.9787234042553191,188,6550,4900,1650,0.7480916030534351,82,49,33,184.34005812271312,0.47363596067053515,0.7388657944441106,0.1101130565105885,1039710.5672118637,-5817.938721873423,1033892.6284899903,3297,2,365.09574468085106,79,109,40,38.283677881367375,0.55646054964539,43.020833333333314,8091.788767923706,102.42770592308489,0
3499,31.235887397740097,0,2,182,0.0,0.010869565217391304,0.9891304347826086,184,6550,4500,2050,0.6870229007633588,86,45,41,226.1912106256347,0.47311193276312663,0.7822321896280766,0.13221035550653318,1024920.1164220007,3015.584385611825,1027935.7008076125,3298,4,373.9130434782609,80,104,42,38.03275602409636,0.5506114130434783,43.827160493827165,8001.785969174173,100.02232461467716,8
3500,31.339280174836652,1,1,182,0.00546448087431694,0.00546448087431694,0.994535519125683,183,5800,4100,1700,0.7068965517241379,75,41,34,247.34964392775942,0.4728014471866931,0.7945405999706097,0.1459955713534007,1031237.0044041475,8615.221168898921,1039852.2255730465,3299,0,376.69945355191254,68,115,34,37.11773475352597,0.5556124772313297,43.46316425120772,8039.679770697432,118.23058486319754,7
3501,31.36816343753856,1,3,180,0.00546448087431694,0.01639344262295082,0.9836065573770492,183,6800,4900,1900,0.7205882352941176,87,49,38,250.84843715593726,0.4723648391681179,0.798717709292956,0.14496438003057194,1025828.8371899024,8065.512119716028,1033894.3493096185,3300,0,377.6174863387978,63,120,38,37.8392228303528,0.5470173041894353,44.25455729166668,8022.264845280673,127.33753722667736,8
3502,31.57851239565781,4,1,183,0.021739130434782608,0.005434782608695652,0.9945652173913043,184,6600,5200,1400,0.7878787878787878,80,52,28,243.4532008324863,0.47243815336184364,0.7937497199933028,0.14201308352262654,1035550.7975097933,7021.631255678731,1042572.428765472,3301,0,371.3967391304348,74,110,39,37.6680089303469,0.5501019021739131,43.902777777777786,8087.169306437997,109.28607170862158,0
3503,31.12211127752036,1,1,183,0.005434782608695652,0.005434782608695652,0.9945652173913043,184,5950,4500,1450,0.7563025210084033,74,45,29,217.66481243813163,0.472299561455611,0.7669898390541117,0.124709480583839,1015191.0698713191,1444.2747624815743,1016635.3446338007,3302,0,372.39130434782606,68,116,43,39.02072620525249,0.5409307065217391,44.580314009661855,7949.199889860652,116.8999983803037,8
3504,31.079632962429898,3,2,184,0.016129032258064516,0.010752688172043012,0.989247311827957,186,6050,4200,1850,0.6942148760330579,79,42,37,202.53962151309497,0.4726060738157512,0.7498243024808502,0.11477245219075265,1010476.5666909912,-2317.691726911504,1008158.8749640797,3303,0,367.93548387096774,79,107,38,39.83523965141609,0.5334901433691757,44.999999999999964,7925.306405419537,100.32033424581692,8
3505,31.39140905542127,3,1,186,0.016042780748663103,0.0053475935828877,0.9946524064171123,187,6800,5200,1600,0.7647058823529411,84,52,32,198.99768696762104,0.47265467770685987,0.7517754609225831,0.11072959576917404,1015007.204841842,-3803.182796200695,1011204.0220456412,3304,0,366.80748663101605,70,117,45,40.64080559241522,0.5276292335115864,45.7012910798122,7982.794793979108,114.03992562827298,8
3506,31.229176525300865,2,4,184,0.010638297872340425,0.02127659574468085,0.9787234042553191,188,6400,4900,1500,0.765625,79,49,30,208.35413737762147,0.47310677172222854,0.7658407819366868,0.11572440642299263,1009199.6651134273,-1945.8148667012842,1007253.8502467261,3305,0,365.82978723404256,67,121,42,40.47511448541818,0.5288120567375887,45.77205882352943,7939.329252663839,118.4974515322961,8
3507,31.36372938690339,3,2,185,0.016042780748663103,0.0106951871657754,0.9893048128342246,187,6900,5100,1800,0.7391304347826086,87,51,36,201.1482008456004,0.47372204013570235,0.7557758416817364,0.11274536761817051,1016360.790781337,-3412.1711048643633,1012948.6196764726,3306,0,367.90909090909093,72,115,44,40.29868000672612,0.5311942959001783,45.41952054794522,7984.593264722392,110.89712867669988,0
3508,31.635558341030247,3,3,185,0.015957446808510637,0.015957446808510637,0.9840425531914894,188,6250,4400,1850,0.704,81,44,37,198.03427013459975,0.47374025770849926,0.753130626763695,0.1119414769076634,1027785.3723011272,-3142.654788265661,1024642.7175128615,3307,0,366.9095744680851,78,110,42,40.046942892613274,0.5337433510638299,45.094936708860764,8064.064001170855,103.38543591244685,0
3509,32.05697714599017,2,2,185,0.0106951871657754,0.0106951871657754,0.9893048128342246,187,5800,4200,1600,0.7241379310344828,74,42,32,191.96679812547436,0.47376636382803367,0.7475857779081232,0.10770147160339925,1039124.9319285734,-3304.5027930639285,1035820.4291355095,3308,0,369.3368983957219,73,114,44,40.49507961079169,0.5302473262032086,45.382882882882896,8162.255104401355,111.81171375892268,8
3510,31.63591121171047,6,6,185,0.031413612565445025,0.031413612565445025,0.9685863874345549,191,5850,4400,1450,0.7521367521367521,73,44,29,199.7275061239645,0.47421810416092586,0.758741878526928,0.1138859201585919,1030480.8269725406,-2886.926864042388,1027593.9001084982,3309,0,361.9476439790576,70,121,44,39.66452549290109,0.5343041012216405,44.762323943662004,8074.6764576016985,115.3525208228814,0
3511,32.11285739750318,3,0,188,0.015957446808510637,0.0,1.0,188,6750,5100,1650,0.7555555555555555,84,51,33,196.7079300296169,0.47380129517958053,0.7515835427249213,0.11271919846390456,1047555.2553159427,-3137.514827030647,1044417.7404889121,3310,0,368.17021276595744,71,117,47,39.550233644859816,0.5365691489361701,44.57465277777779,8202.437751054995,115.52729226838021,0
3512,32.444752265207256,2,7,183,0.010526315789473684,0.03684210526315789,0.9631578947368421,190,5500,4200,1300,0.7636363636363637,68,42,26,198.8827903283362,0.47413847117794483,0.760981538949983,0.11349676347154365,1057084.409073353,-1452.820622182142,1055631.5884511708,3311,0,365.2842105263158,68,122,41,39.654424665365596,0.5375548245614035,44.73128019323672,8282.13037518705,121.7960349292213,8
3513,32.40777434570264,3,0,186,0.016129032258064516,0.0,1.0,186,6050,4400,1650,0.7272727272727273,77,44,33,197.70984867971197,0.4735747844618812,0.754028455625845,0.11411900279442327,1059452.4092511141,-1357.1648967210072,1058095.244354393,3312,0,371.36559139784947,71,115,42,39.24432311116142,0.5407706093189963,44.29976851851853,8286.675401995815,116.71373805627908,0
3514,32.65696589425827,0,1,185,0.0,0.005376344086021506,0.9946236559139785,186,6500,4600,1900,0.7076923076923077,84,46,38,204.54713368872444,0.4735747844618812,0.762097965547937,0.11738050672818887,1065761.1829249172,-100.32096720071695,1065660.8619577165,3313,1,372.36559139784947,68,118,43,39.294155882526695,0.5390905017921147,44.51992753623189,8343.204013111921,122.6941766634106,8
3515,32.24956005721987,2,1,186,0.0106951871657754,0.0053475935828877,0.9946524064171123,187,6400,4300,2100,0.671875,85,43,42,205.52987787269603,0.473644174189715,0.7650945578815846,0.1175909980191024,1051527.1637923426,-575.9500891875823,1050951.213703155,3314,0,371.0802139037433,65,122,40,39.38530078285946,0.5376002673796791,44.63383838383837,8235.446365622105,126.69917485572469,8
3516,32.700619696968246,2,3,185,0.010638297872340425,0.015957446808510637,0.9840425531914894,188,5900,4300,1600,0.7288135593220338,75,43,32,200.91716244792286,0.4741521124890962,0.7605785321539558,0.11176017161165741,1057231.0555905555,-1016.8272517845767,1056214.228338771,3315,0,369.20212765957444,69,119,40,40.605249297752785,0.52947695035461,45.71428571428572,8315.300437229089,120.511600539552,8
3517,32.860308184268604,1,1,185,0.005376344086021506,0.005376344086021506,0.9946236559139785,186,6450,4600,1850,0.7131782945736435,83,46,37,198.06562326220626,0.47414814007555944,0.7549359174045254,0.11098577831773118,1064766.0276288292,-1471.290621854373,1063294.7370069749,3316,0,371.01612903225805,74,112,40,40.388409987815315,0.5318660394265233,45.430555555555564,8365.230398742508,113.04365403706092,0
3518,33.02094484669303,3,3,185,0.015957446808510637,0.015957446808510637,0.9840425531914894,188,6850,5100,1750,0.7445255474452555,86,51,35,193.8994599743485,0.47454085599423523,0.7522960736610127,0.10945444473847445,1072353.0255693777,-2864.26548804775,1069488.7600813298,3317,0,368.01063829787233,81,107,39,40.20577875253382,0.5342420212765957,45.14735772357724,8415.475044643747,103.89475363757711,0
3519,32.93718948945687,5,3,187,0.02631578947368421,0.015789473684210527,0.9842105263157894,190,5450,3700,1750,0.6788990825688074,72,37,35,191.37537097498048,0.47547340573656366,0.751135820470358,0.1089390558223632,1072325.74749392,-2406.6524534656814,1069919.0950404543,3318,0,364.5736842105263,88,102,45,39.94339204354337,0.537061403508772,44.82677902621722,8404.688731848502,95.50782649827843,0
3520,33.362925614585706,2,2,187,0.010582010582010581,0.010582010582010581,0.9894179894179894,189,6100,4100,2000,0.6721311475409836,81,41,40,188.50139558360908,0.47534851213929225,0.7457047485371269,0.10793432164247423,1088087.234063669,-2878.807572457463,1085208.4264912116,3319,0,361.41269841269843,71,118,46,39.78932995336017,0.539021164021164,44.603587962963,8520.771497023828,120.01086615526519,0
3521,33.4160455350796,3,0,190,0.015789473684210527,0.0,1.0,190,6950,4500,2450,0.6474820143884892,94,45,49,181.90279146023303,0.4757025666016894,0.7370741238246421,0.10509397200986706,1092717.6992638456,-5196.320045180493,1087521.3792186652,3320,0,358.9,78,112,46,39.61233565351898,0.5425986842105264,44.26424050632913,8545.677784188714,109.55997159216301,0
3522,33.57240990879491,5,3,192,0.02564102564102564,0.015384615384615385,0.9846153846153847,195,6200,4500,1700,0.7258064516129032,79,45,34,215.32926857361585,0.4766069697770729,0.7781195331633921,0.12273768308696131,1093440.45237589,1889.9465677808953,1095330.3989436708,3321,0,350.6717948717949,66,129,43,39.28040224983753,0.5357905982905983,44.77611940298508,8568.48073791633,129.825465726005,7
3523,33.44045256333106,0,2,190,0.0,0.010416666666666666,0.9895833333333334,192,5250,3400,1850,0.6476190476190476,71,34,37,216.06952577539437,0.4758216986620128,0.7763943439694732,0.12346185637729723,1089938.9548949336,3450.51862165547,1093389.473516589,3322,1,356.9166666666667,66,126,45,39.16620996224579,0.5367838541666667,44.68283582089552,8537.92151733554,129.3624472323567,0
3524,32.93098083550842,2,4,188,0.010416666666666666,0.020833333333333332,0.9791666666666666,192,6350,4700,1650,0.7401574803149606,80,47,33,213.0544618600889,0.47606541321262363,0.7740779276693455,0.12256964087195374,1075503.4512152695,1078.1618054676665,1076581.6130207372,3323,0,354.125,70,122,44,38.97974071947951,0.5393337673611112,44.42488262910799,8416.339292173683,120.23341845962405,0
3525,33.15243276372564,2,2,188,0.010526315789473684,0.010526315789473684,0.9894736842105263,190,5850,3600,2250,0.6153846153846154,81,36,45,210.46537285355913,0.4752105959342801,0.769479742028397,0.12186613337282998,1084807.0780771247,1812.8652323366155,1086619.9433094612,3324,0,358.4789473684211,74,116,47,38.79644207973652,0.5423793859649123,44.18055555555557,8481.03693159813,114.60860718375851,0
3526,33.26316014504533,3,0,191,0.015706806282722512,0.0,1.0,191,5950,4300,1650,0.7226890756302521,76,43,33,203.6985445435889,0.4751687792780381,0.7634467333041184,0.11636996489351625,1084096.2033991532,15.763755527597368,1084111.9671546808,3325,0,357.42931937172773,71,120,42,39.489773993691045,0.5415030541012216,44.69039351851852,8492.40432696203,119.611328548761,7
3527,33.232986096488354,2,2,191,0.010362694300518135,0.010362694300518135,0.9896373056994818,193,6150,4200,1950,0.6829268292682927,81,42,39,197.89773194862732,0.4755887485607369,0.7583794496793637,0.11366608100714698,1084846.7544617073,-1812.2575560394807,1083034.496905668,3326,0,354.7150259067358,74,119,41,39.42954920186259,0.5438795336787565,44.48611111111113,8491.489516904163,114.74985833654274,0
3528,33.57646951523133,4,2,193,0.020512820512820513,0.010256410256410256,0.9897435897435898,195,6450,5000,1450,0.7751937984496124,79,50,29,184.29258364239385,0.47602762357917,0.7348680337127678,0.10623176533196964,1097223.1502122537,-5007.9821630274255,1092215.1680492263,3327,0,351.08717948717947,84,111,41,39.63905932921078,0.5433760683760684,44.35049019607843,8583.80797251521,102.18819014899059,8
3529,33.11365566105217,2,3,192,0.010256410256410256,0.015384615384615385,0.9846153846153847,195,6100,3900,2200,0.639344262295082,83,39,44,181.80892462974464,0.4758932505066526,0.7322424754263734,0.10536434497365389,1083814.5288735698,-5690.5692014805345,1078123.9596720892,3328,0,351.2923076923077,88,107,46,39.49632128697776,0.5457264957264958,44.14794007490637,8472.197012530449,96.27496605148237,0
3530,33.26884917362718,2,6,188,0.010309278350515464,0.030927835051546393,0.9690721649484536,194,5800,4100,1700,0.7068965517241379,75,41,34,203.03868344467898,0.4757714153446219,0.7655386890732889,0.11521390609319437,1082100.4355851926,-658.3504407740938,1081442.0851444185,3329,0,353.2061855670103,86,108,41,39.768761931587,0.5352233676975945,44.94731800766281,8485.30920853209,98.66638614572197,8
3531,33.70326644383863,1,4,185,0.005291005291005291,0.021164021164021163,0.9788359788359788,189,6350,4800,1550,0.7559055118110236,79,48,31,202.13693583661782,0.4750096157454313,0.759552744015942,0.11551696559963624,1098550.7770717593,261.5375876443268,1098812.3146594036,3330,0,362.04232804232805,72,117,43,39.51650086626055,0.5378637566137566,44.677511415525125,8605.201861866528,119.516692525924,0
3532,34.050264391139535,4,1,188,0.021164021164021163,0.005291005291005291,0.9947089947089947,189,5300,3400,1900,0.6415094339622641,72,34,38,193.50077989241268,0.4754810218019438,0.75491064332266,0.11206766009447834,1114257.6762401732,21.945870716418995,1114279.6221108895,3331,0,362.6878306878307,73,116,49,39.22201129819156,0.5436507936507937,44.17229729729732,8711.00091560492,119.32877966582082,8
3533,34.226662858710796,4,3,189,0.020833333333333332,0.015625,0.984375,192,6350,4800,1550,0.7559055118110236,79,48,31,203.18577796056354,0.4755399214659686,0.7583419003936447,0.12013802482406372,1126817.8727189894,1040.6732176549403,1127858.5459366443,3332,0,357.9322916666667,76,116,40,38.18448615211583,0.552734375,43.39826839826839,8782.620956493853,115.56080205912964,8
3534,33.94938521673336,2,4,187,0.010471204188481676,0.020942408376963352,0.9790575916230366,191,5750,4200,1550,0.7304347826086957,73,42,31,205.15617629950432,0.47502411132543404,0.7665875472066739,0.11935067161627061,1112418.1256208927,1693.8898197288654,1114112.0154406216,3333,0,360.75916230366494,81,110,38,38.75215032420274,0.5470658813263525,44.00406504065041,8690.904609852787,107.29511864015787,7
3535,34.01479424785707,1,0,188,0.005319148936170213,0.0,1.0,188,7000,4700,2300,0.6714285714285714,93,47,46,203.9130147399032,0.4737527022414381,0.7605518076457356,0.11943476577622927,1116774.787707966,944.9827494094143,1117719.7704573756,3334,0,365.70212765957444,82,106,42,38.52472899728999,0.5497562056737588,43.75000000000001,8716.291026013394,106.29623202455359,0
3536,33.4281314595635,1,0,189,0.005291005291005291,0.0,1.0,189,6100,4400,1700,0.7213114754098361,78,44,34,198.62541133433305,0.4737021088971443,0.754855121704739,0.11704252892986788,1099443.5745283451,-224.51355408407198,1099219.060974261,3335,0,364.76190476190476,73,116,41,38.4305250640322,0.5518077601410935,43.52477477477474,8573.487544949905,117.44503486232746,0
3537,33.413971820865505,1,1,189,0.005263157894736842,0.005263157894736842,0.9947368421052631,190,7150,5300,1850,0.7412587412587412,90,53,37,198.701068819239,0.47361923326835603,0.756226698171254,0.11797994048148255,1101395.0541981468,-1380.32510772131,1100014.7290904254,3336,0,363.83684210526314,75,115,38,38.141081246997224,0.5537280701754386,43.24287280701751,8579.275412832625,114.39033883776834,0
3538,33.46959964483186,2,3,188,0.010471204188481676,0.015706806282722512,0.9842931937172775,191,6450,4400,2050,0.6821705426356589,85,44,41,197.65442566297878,0.47401717644897584,0.7549107224892804,0.1180499373113778,1105093.8951348376,-964.6601706923057,1104129.2349641453,3337,0,362.8062827225131,81,110,39,37.94670810882066,0.555846422338569,43.02591463414632,8600.819756291898,106.18295995422096,0
3539,33.66580158431602,2,5,185,0.010526315789473684,0.02631578947368421,0.9736842105263158,190,6200,4500,1700,0.7258064516129032,79,45,34,197.8804411991734,0.4732618583495776,0.7545598549985171,0.11860812915242643,1112710.5890541428,-163.26754219525446,1112547.3215119475,3338,0,365.5157894736842,83,107,42,37.80672719818644,0.5574561403508772,42.89434523809521,8655.667959419869,104.28515613758877,0
3540,34.04710858205396,1,2,184,0.005376344086021506,0.010752688172043012,0.989247311827957,186,5450,3600,1850,0.6605504587155964,73,36,37,198.72270649245326,0.4723166715102199,0.7506349180077667,0.11991038853058548,1127456.445392012,2160.23925613226,1129616.684648144,3339,0,373.3440860215054,70,116,44,37.53551203846227,0.5598118279569892,42.649647887323944,8762.035382010095,125.17193402871565,0
3541,34.218822988477285,0,1,183,0.0,0.005434782608695652,0.9945652173913043,184,6650,5200,1450,0.7819548872180451,81,52,29,211.4046505877207,0.4717421002613447,0.7577413720093149,0.12161561080704152,1117550.1699259202,3801.0606374877434,1121351.230563408,3340,1,377.4021739130435,76,108,41,39.02346231208978,0.5443840579710144,44.42640692640695,8745.427541914463,115.0714150251903,8
3542,34.51601068072711,4,1,186,0.0213903743315508,0.0053475935828877,0.9946524064171123,187,6850,5300,1550,0.7737226277372263,84,53,31,216.7292430826019,0.47266426120790445,0.7640913559189262,0.12490923201205414,1127872.4084496864,4638.586675410519,1132510.995125097,3341,0,372.28877005347596,78,109,39,38.81599872773542,0.5428364527629234,44.3565400843882,8823.792392905325,113.12554349878621,7
3543,34.178723230348474,2,1,187,0.010638297872340425,0.005319148936170213,0.9946808510638298,188,6850,4800,2050,0.7007299270072993,89,48,41,189.7447535090905,0.4727826212690105,0.7457158219128663,0.10653574419599265,1108155.8883165198,-2396.6468243469026,1105759.241492173,3342,0,371.281914893617,75,113,42,40.52183693058472,0.534519060283688,45.35361842105264,8703.488197596564,116.04650930128751,8
3544,33.75761615572498,9,5,191,0.04591836734693878,0.025510204081632654,0.9744897959183674,196,6700,5800,900,0.8656716417910447,76,58,18,178.17004273543841,0.4750550540729112,0.7374984215178679,0.10128704726647077,1098598.586183783,-6752.528590108646,1091846.0575936742,3343,0,357.05102040816325,96,100,40,40.332060024413835,0.540125425170068,44.87757731958763,8612.324817563991,89.7117168496249,8
3545,33.768511442444854,1,3,189,0.005208333333333333,0.015625,0.984375,192,6150,4100,2050,0.6666666666666666,82,41,41,184.4868681313503,0.47432191681210006,0.7425307237701542,0.10537984951495458,1100520.4058398192,-3943.6874023937767,1096576.7184374256,3344,0,365.28125,75,117,45,39.98569504840645,0.5421006944444444,44.695723684210535,8621.24537607486,114.9499383476648,0
3546,33.9106221972355,3,0,192,0.015625,0.0,1.0,192,5950,4200,1750,0.7058823529411765,77,42,35,176.3979663658474,0.4746360756617219,0.7304684223988991,0.10146329336001417,1107439.7910128864,-5279.974598541489,1102159.816414345,3345,0,363.6510416666667,80,112,48,39.923409483553925,0.5445421006944444,44.43158436213992,8666.483988241538,108.33104985301922,0
3547,34.03765095331674,6,2,196,0.030303030303030304,0.010101010101010102,0.98989898989899,198,6250,4400,1850,0.704,81,44,37,238.26174196114508,0.4756741484216103,0.8039084837797317,0.13627737767511489,1109730.9453486768,7031.285629392717,1116762.2309780694,3346,0,353.6010101010101,63,135,38,38.56105392313087,0.5387731481481481,44.645182291666664,8691.678154404066,137.96314530800106,8
3548,33.494767596824126,0,0,196,0.0,0.0,1.0,196,6950,4500,2450,0.6474820143884892,94,45,49,238.3038116621619,0.47528726234083374,0.8010314177820026,0.13704317442122846,1093792.6009462602,5980.989194672639,1099773.5901409327,3347,1,358.1530612244898,67,129,38,38.34923025435073,0.5417198129251701,44.43933823529411,8559.944972699379,127.7603727268564,0
3549,33.770133823955334,1,1,196,0.005076142131979695,0.005076142131979695,0.9949238578680203,197,7050,5100,1950,0.723404255319149,90,51,39,221.1205235306569,0.4753131582582271,0.7910209284268437,0.12442154831501206,1095625.3082233777,2003.0483495583849,1097628.356572936,3348,0,357.3299492385787,73,124,38,39.63767315060417,0.5310384940778341,45.27027027027029,8602.257061912993,117.83913783442456,8
3550,33.18630125886623,3,5,194,0.01507537688442211,0.02512562814070352,0.9748743718592965,199,6300,4700,1600,0.746031746031746,79,47,32,218.45524305168837,0.4757118927973199,0.7909470352127306,0.1236445017817902,1078585.4054489848,1024.5273798723379,1079609.932828857,3349,0,354.70854271356785,77,122,35,39.47578920259107,0.5331867671691792,45.04540598290598,8460.999964383216,109.88311642056125,0
3551,33.18407741031488,3,3,194,0.015228426395939087,0.015228426395939087,0.9847715736040609,197,7050,5300,1750,0.75177304964539,88,53,35,213.20247784108494,0.47626601401982116,0.7838752006741112,0.11731315535508445,1069300.8822424244,-854.4804696514652,1068446.401772773,3350,0,358.89340101522845,78,119,37,40.72417285617823,0.5192470389170897,46.13660337552742,8424.22260523196,108.00285391323025,8
3552,33.21574986374929,4,0,198,0.020202020202020204,0.0,1.0,198,6250,4100,2150,0.656,84,41,43,206.44616491241837,0.4766376754003658,0.7791165108276892,0.11118047300826328,1063206.1012024295,-1951.0355790544668,1061255.0656233751,3351,0,357.4191919191919,77,121,44,41.75837467891202,0.5097327441077442,46.98183760683763,8404.187993036834,109.14529861086797,8
3553,33.27316325312436,5,3,200,0.024630541871921183,0.014778325123152709,0.9852216748768473,203,6650,4300,2350,0.6466165413533834,90,43,47,196.76842067884752,0.47732242436066263,0.7746844087130897,0.10748879213063163,1069777.4693671186,-5150.315374963831,1064627.1539921546,3352,0,349.5911330049261,70,133,46,41.43053787703463,0.5133928571428572,46.42018779342721,8437.402489245867,120.53432127494096,0
3554,33.44299669407644,4,4,200,0.0196078431372549,0.0196078431372549,0.9803921568627451,204,6150,4100,2050,0.6666666666666666,82,41,41,188.23264920146124,0.47801915306352427,0.7642624992782139,0.10381183460600266,1078404.909211459,-6351.797405453364,1072053.1118060057,3353,0,348.19607843137254,77,127,41,41.26678411162525,0.516186683006536,46.04700854700853,8492.949053613174,110.29803965731395,0
3555,33.07855399060377,4,4,200,0.0196078431372549,0.0196078431372549,0.9803921568627451,204,5150,3300,1850,0.6407766990291263,70,33,37,228.8876191477712,0.47814844328536016,0.8055139803748677,0.1278774671649653,1070875.3862606902,3072.0235130319284,1073947.409773722,3354,0,349.1372549019608,64,140,38,39.7207089473905,0.5196078431372548,45.544871794871796,8417.007696519344,131.51574525811475,8
3556,33.259410097816385,4,0,204,0.0196078431372549,0.0,1.0,204,6500,4400,2100,0.676923076923077,86,44,42,228.77957446808543,0.47911635918735307,0.8060734251147279,0.12961234329797497,1081272.9509682753,2174.633121274553,1083447.58408955,3355,0,349.30392156862746,71,133,39,39.17500000000001,0.5234885620915033,45.00868055555555,8480.860864786064,119.4487445744516,0
3557,33.161412455329156,1,1,204,0.004878048780487805,0.004878048780487805,0.9951219512195122,205,6550,4600,1950,0.7022900763358778,85,46,39,233.4572049514545,0.4792075163398693,0.8094234830049163,0.13045387755003274,1073616.3532270936,2578.6946029141923,1076195.0478300077,3356,0,348.59512195121954,66,139,40,39.597335084825154,0.520020325203252,45.53793532338309,8438.321480975947,127.85335577236283,8
3558,33.50635877476782,5,3,206,0.023923444976076555,0.014354066985645933,0.9856459330143541,209,6300,4900,1400,0.7777777777777778,77,49,28,211.65334281418896,0.4799305683351736,0.7952084904635344,0.119225454453595,1087427.954789183,-2068.447659854488,1085359.5071293286,3357,0,342.8899521531101,73,136,41,39.83570685304898,0.5273125996810207,45.22804054054054,8536.480679399256,116.93809149861994,7
3559,32.95704173529736,9,4,211,0.04186046511627907,0.018604651162790697,0.9813953488372094,215,6600,4600,2000,0.696969696969697,86,46,40,202.0147670425365,0.4810448815474897,0.7903294240083263,0.1125949986734933,1066168.4808522444,-6523.644542507705,1059644.8363097368,3358,0,334.07906976744187,68,147,43,40.49857063722873,0.5228197674418604,45.637077294686,8383.049459511269,123.28013911045983,8
3560,32.932371850881665,2,4,209,0.009389671361502348,0.018779342723004695,0.9812206572769953,213,7250,5500,1750,0.7586206896551724,90,55,35,220.2826000776339,0.48135168453066407,0.8012261364465292,0.12195471826657202,1063188.899261597,-3009.596979395679,1060179.3022822014,3359,0,334.7323943661972,80,133,38,40.30020075239974,0.5216647104851331,45.89763374485596,8368.193613703304,104.6024201712913,8
3561,33.36963707837743,3,5,207,0.014150943396226415,0.02358490566037736,0.9764150943396226,212,7700,5700,2000,0.7402597402597403,97,57,40,220.86135414057927,0.48163693403678204,0.8010931036658726,0.1233154411946536,1080091.8473110048,-2389.8904013381125,1077701.9569096665,3360,0,336.87264150943395,70,142,38,39.94985680236803,0.5244693396226415,45.569248826291094,8490.261828245657,121.28945468922367,0
3562,33.27295751059443,2,4,205,0.009569377990430622,0.019138755980861243,0.9808612440191388,209,6200,4200,2000,0.6774193548387096,82,42,40,248.00127597232245,0.4820267451846399,0.8213437452362111,0.1348073974978037,1068131.2998808934,4979.585055287057,1073110.8849361804,3361,0,341.8373205741627,63,146,39,40.330592668722176,0.5094198564593302,46.614583333333314,8430.882202554225,133.82352702467023,8
3563,33.457426643125984,4,2,207,0.019138755980861243,0.009569377990430622,0.9904306220095693,209,7450,5100,2350,0.6845637583892618,98,51,47,244.3572785721371,0.48257978315544103,0.8189074185345426,0.1343924481652465,1077952.6435125873,3431.1148796752477,1081383.7583922625,3362,0,342.42105263157896,67,142,35,39.95213777080443,0.5128588516746411,46.155024509803916,8492.999646189332,126.7611887490945,0
3564,33.77701164403919,6,3,210,0.028169014084507043,0.014084507042253521,0.9859154929577465,213,5700,3700,2000,0.6491228070175439,77,37,40,191.21019850200653,0.4832884887944016,0.7746934488091688,0.10479123502941622,1087064.0531999802,-6728.453320647388,1080335.5998793328,3363,0,334.7089201877934,76,137,46,41.442159006078725,0.5161874021909233,46.293290043290035,8569.454496378643,112.75598021550846,8
3565,33.23730134751719,8,6,212,0.03669724770642202,0.027522935779816515,0.9724770642201834,218,6200,4200,2000,0.6774193548387096,82,42,40,189.05578322301398,0.4847103609126397,0.775187306286391,0.10437853391263156,1072127.483568807,-9261.619775796025,1062865.8637930108,3364,0,327.93119266055044,84,134,40,41.202977741323345,0.5196865443425076,46.004901960784316,8442.111614321591,100.5013287419237,8
3566,32.73722908484091,4,5,211,0.018518518518518517,0.023148148148148147,0.9768518518518519,216,7100,5100,2000,0.7183098591549296,91,51,40,210.30563084849024,0.4843835235429228,0.796580189939001,0.11711044364788246,1058767.130830296,-5767.062125817725,1053000.0687044784,3365,0,331.74074074074076,70,146,40,40.32328622247862,0.5226176697530864,45.67194835680751,8325.995689344445,118.9427955620635,8
3567,33.17293142671858,3,8,206,0.014018691588785047,0.037383177570093455,0.9626168224299065,214,7150,4700,2450,0.6573426573426573,96,47,49,223.47037015303036,0.48434689131674785,0.7967266704963094,0.12603728876630765,1077006.7221750715,-1814.1818276474305,1075192.540347424,3366,0,332.06542056074767,82,132,39,39.486267073811376,0.5297897196261683,45.18072289156623,8453.102405723965,103.08661470395079,8
3568,32.82582545113971,1,4,203,0.004830917874396135,0.01932367149758454,0.9806763285024155,207,6600,4500,2100,0.6818181818181818,87,45,42,223.57494195457375,0.4833399777996654,0.7893464020884398,0.12689569857923352,1067762.6151261982,-255.00706037986674,1067507.6080658182,3367,0,338.44444444444446,84,123,35,39.2361945258572,0.5331119162640902,44.93872549019604,8372.596876403955,99.67377233814233,0
3569,32.370522135363515,1,4,200,0.004901960784313725,0.0196078431372549,0.9803921568627451,204,6850,4800,2050,0.7007299270072993,89,48,41,223.4116545446881,0.482513120190605,0.790040367127465,0.12738941207102078,1054406.04108396,-536.6803599037012,1053869.3607240564,3368,0,344.37254901960785,71,133,38,39.06043343536258,0.5347222222222222,44.762731481481474,8262.16365034841,116.36850211758323,0
3570,32.506834344254266,3,2,201,0.014778325123152709,0.009852216748768473,0.9901477832512315,203,5700,4100,1600,0.7192982456140351,73,41,32,241.92741984538023,0.4828134907086768,0.8079015738346238,0.13812406932757804,1059251.0825186244,4952.376272431377,1064203.4587910557,3369,0,346.9162561576355,66,137,37,38.53786033292733,0.5297105911330049,44.71393034825871,8298.541976564911,125.73548449340774,8
3571,32.688810796237114,4,5,200,0.01951219512195122,0.024390243902439025,0.975609756097561,205,6950,4900,2050,0.7050359712230215,90,49,41,247.05254222499838,0.48281623625059783,0.8202233165019628,0.14144804875187267,1066074.6064421057,4725.288344607727,1070799.8947867134,3370,0,344.34634146341466,61,144,36,38.29730226081622,0.5244918699186991,44.6068548387097,8348.498200833385,136.86062624317023,8
3572,32.460697762715114,0,4,196,0.0,0.02,0.98,200,6800,5100,1700,0.75,85,51,34,236.77187446339852,0.48274654522613064,0.8075358539765314,0.13326513041011964,1053230.1852151419,3075.0570389642744,1056305.242254106,3371,1,353.6,68,132,41,39.228127098889814,0.5255729166666667,45.259661835748794,8269.049125121606,121.6036636047295,8
3573,32.816157794517586,2,1,197,0.010101010101010102,0.005050505050505051,0.9949494949494949,198,5550,3400,2150,0.6126126126126126,77,34,43,234.41637429770893,0.48251604454015623,0.8048481477800837,0.132846136343935,1066959.8847789483,4872.573542196538,1071832.4583211448,3372,0,356.09090909090907,70,128,39,39.01937939896053,0.5276199494949495,44.997065727699535,8368.216529144825,119.54595041635464,0
3574,32.36163049530635,1,1,197,0.005050505050505051,0.005050505050505051,0.9949494949494949,198,6000,4600,1400,0.7666666666666667,74,46,28,237.34209527063055,0.4824615657420226,0.8069382888516627,0.1356622695353739,1054881.3571516017,4473.550313657688,1059354.9074652593,3373,0,357.02525252525254,59,139,38,38.610086466761885,0.5298295454545454,44.6701388888889,8262.89061969569,140.04899355416424,0
3575,32.165865267112935,2,1,198,0.010050251256281407,0.005025125628140704,0.9949748743718593,199,6450,4700,1750,0.7286821705426356,82,47,35,231.649792238598,0.4823623589327107,0.802343920901202,0.13336538874170323,1050743.7377188024,2430.9137077139444,1053174.6514265162,3374,0,356.1708542713568,65,134,41,38.47605999794176,0.5321922110552764,44.39709595959598,8221.688573246474,126.48751651148422,0
3576,32.45956101110206,1,2,197,0.005025125628140704,0.010050251256281407,0.9899497487437185,199,6050,4100,1950,0.6776859504132231,80,41,39,233.0346012967337,0.48233380708255075,0.8028166800363576,0.1349084837366979,1062074.8997489936,3650.0401620549574,1065724.9399110486,3375,0,357.0100502512563,68,131,43,38.22649257401397,0.5347047738693467,44.187801932367144,8303.551650560441,122.11105368471237,0
3577,32.20320867263536,1,2,196,0.005050505050505051,0.010101010101010102,0.98989898989899,198,6750,5000,1750,0.7407407407407407,85,50,35,236.17012095342488,0.4820449631680596,0.8049197046522509,0.1377492739925609,1056001.8763006562,3529.2181705936778,1059531.09447125,3376,0,359.65656565656565,72,126,37,37.85881112906519,0.5370896464646464,43.90696347031962,8247.017494974089,114.5419096524179,0
3578,32.16955976948266,1,4,193,0.005076142131979695,0.02030456852791878,0.9796954314720813,197,5850,3800,2050,0.6495726495726496,79,38,41,238.55849468957643,0.4817932249041749,0.8067548484326468,0.13992209205809342,1056621.381621223,5163.201251275775,1061784.5828724988,3377,0,362.11167512690355,59,138,39,37.58361274808641,0.5388113367174281,43.69791666666666,8245.125188834578,139.74788455651827,0
3579,31.821918111250927,2,0,195,0.010256410256410256,0.0,1.0,195,7300,5000,2300,0.684931506849315,96,50,46,237.59309609280072,0.48150277557494053,0.8044215150843392,0.14016891001332601,1046971.3936419009,3450.634987194698,1050422.0286290955,3378,0,366.4102564102564,61,134,40,37.38647279713562,0.541292735042735,43.48118279569892,8162.920795070205,133.8183736896755,0
3580,32.26940340868987,2,2,195,0.01015228426395939,0.01015228426395939,0.9898477157360406,197,6450,4900,1550,0.7596899224806202,80,49,31,210.46533545398052,0.4816173296729859,0.7761534135095909,0.11833819451562243,1046701.7343989972,-1791.1136698903233,1044910.6207291068,3379,0,363.6802030456853,75,122,40,39.93821638056287,0.524270304568528,45.29879385964912,8219.055969622863,109.58741292830484,8
3581,32.10721627716834,3,1,197,0.015151515151515152,0.005050505050505051,0.9949494949494949,198,5900,4000,1900,0.6779661016949152,78,40,38,231.97086432442748,0.48215498897605497,0.7973842560366307,0.1279057684954104,1035261.563720708,2530.103947629871,1037791.6676683379,3380,0,357.550505050505,74,124,37,40.16478432873915,0.5160458754208754,46.055555555555536,8153.449200163091,110.18174594814987,8
3582,32.58763451486834,3,0,200,0.015,0.0,1.0,200,7300,5500,1800,0.7534246575342466,91,55,36,232.63924084556754,0.4823607621440536,0.7984644930510771,0.1276857732262454,1049266.673626396,1520.1204793994993,1050786.7941057957,3381,0,354.81,69,131,37,40.33155212181628,0.5136458333333334,46.23511904761903,8269.597193185224,119.84923468384382,8
3583,32.21899706602664,12,1,211,0.05660377358490566,0.0047169811320754715,0.9952830188679245,212,6250,4400,1850,0.704,81,44,37,218.6322209295173,0.4838948254791499,0.7990490949820424,0.12284143295207516,1044838.7579341701,-2962.916367922929,1041875.8415662472,3382,0,335.6698113207547,73,139,42,39.758594959097934,0.519555817610063,45.32657657657657,8205.322282074225,112.40167509690718,0
3584,32.19433677223466,5,9,207,0.023148148148148147,0.041666666666666664,0.9583333333333334,216,6800,5200,1600,0.7647058823529411,84,52,32,222.2925197604455,0.4838613443870227,0.8024272230163589,0.12613748195444927,1047145.9990088947,-3445.4554646489287,1043700.5435442458,3383,0,329.99074074074076,79,137,36,39.27829963923488,0.5225212191358024,44.94791666666665,8211.232665293353,103.93965399105511,0
3585,32.068979827664954,4,1,210,0.018957345971563982,0.004739336492890996,0.995260663507109,211,6000,4100,1900,0.6833333333333333,79,41,38,214.3774774673487,0.4831612502821034,0.7961126179075304,0.11990824184827129,1038553.1972244596,-3671.5170726740284,1034881.6801517856,3384,0,333.90521327014216,71,140,41,40.04468430826368,0.5240916271721958,45.5005787037037,8161.536807703331,114.95122264370889,8
3586,31.706122322952158,3,5,208,0.014084507042253521,0.023474178403755867,0.9765258215962441,213,6750,4600,2150,0.6814814814814815,89,46,43,211.15625183045506,0.48364558419700593,0.7939245303645932,0.11907191615475757,1029332.040955342,-5880.020868575557,1023452.0200867665,3385,0,331.7230046948357,78,135,36,39.80670547649847,0.5266529733959311,45.18723628691983,8079.1246557364175,103.57852122738997,0
3587,31.302142303861608,3,4,207,0.014218009478672985,0.018957345971563982,0.981042654028436,211,6400,4700,1700,0.734375,81,47,34,228.11183029451632,0.4836831415030467,0.8078716105868855,0.12902904915426328,1017156.6683621092,-2194.9061367294335,1014961.7622253798,3386,0,335.4881516587678,74,137,39,39.25417688186692,0.5226105845181674,45.06944444444444,7979.872527602492,107.83611523787151,8
3588,31.23959681720353,4,4,207,0.018957345971563982,0.018957345971563982,0.981042654028436,211,7500,5300,2200,0.7066666666666667,97,53,44,218.6224247082473,0.4835072970736478,0.7994712512193543,0.12461634702589698,1017465.4431671662,-5211.847551588324,1012253.5956155779,3387,0,335.7630331753555,64,147,45,39.19586420528277,0.5268562401263823,44.77564102564104,7973.10607228823,124.5797823795036,0
3589,31.510602022974485,1,4,204,0.004807692307692308,0.019230769230769232,0.9807692307692307,208,6550,4200,2350,0.6412213740458015,89,42,47,217.47318087611464,0.48317936718072585,0.7934936862835955,0.12448464836356926,1027581.2418285044,-3455.7277461853755,1024125.514082319,3388,0,341.16346153846155,64,144,43,39.06145414993305,0.528896233974359,44.61538461538462,8047.322978175034,125.73942153398491,8
3590,31.304195806617816,4,1,207,0.019230769230769232,0.004807692307692308,0.9951923076923077,208,6400,4500,1900,0.703125,83,45,38,205.35615568886715,0.48338355862133037,0.7800817960320212,0.11880552462628241,1024069.9396855641,-5940.186805928245,1018129.7528796359,3389,0,341.22115384615387,71,137,49,38.96021870286576,0.5322015224358974,44.21296296296298,8007.207492202059,112.77757031270507,0
3591,31.367055131836683,0,6,201,0.0,0.028985507246376812,0.9710144927536232,207,6150,4000,2150,0.6504065040650406,83,40,43,220.63288977139217,0.4831601863577381,0.7970844551480474,0.12684797505347836,1024231.759093519,-2354.1574391123004,1021877.6016544066,3390,1,343.82608695652175,72,135,35,38.81090978465205,0.5338164251207729,44.449200913241995,8015.876003939227,111.33161116582261,8
3592,31.305488402924457,3,1,203,0.014705882352941176,0.004901960784313725,0.9950980392156863,204,5950,4300,1650,0.7226890756302521,76,43,33,213.60853631061894,0.4833029476158279,0.787377089827519,0.12361476319891744,1024197.5898289774,-2994.530388753602,1021203.0594402237,3391,0,349.2352941176471,75,129,42,38.73824545892942,0.5361519607843137,44.20230263157895,8007.871848461897,106.77162464615863,0
3593,31.214881659432105,0,1,202,0.0,0.0049261083743842365,0.9950738916256158,203,6700,4800,1900,0.7164179104477612,86,48,38,206.18897842803935,0.4831853875042677,0.7706154680210568,0.11671165359732327,1014538.0114172067,-5462.688769894447,1009075.3226473123,3392,1,351.9064039408867,78,125,39,39.78524513860153,0.5324302134646962,45.042194092826996,7958.477739540852,102.03176589154938,8
3594,30.97506994915053,2,8,196,0.00980392156862745,0.0392156862745098,0.9607843137254902,204,6100,3800,2300,0.6229508196721312,84,38,46,264.17604758717465,0.48338645803148844,0.8250928718695707,0.1501988568419212,1008081.6391518976,6362.204615269736,1014443.8437671674,3393,0,351.1470588235294,76,128,39,38.13298690280503,0.5330882352941176,44.872835497835496,7902.581766382976,103.98133903135495,8
3595,30.666102381856025,5,3,198,0.024875621890547265,0.014925373134328358,0.9850746268656716,201,6050,4600,1450,0.7603305785123967,75,46,29,222.42735872708084,0.4832441956882256,0.7939193900284487,0.1264514883804779,998000.5648408884,-1853.4740708610407,996147.0907700274,3394,0,355.70646766169153,73,128,44,39.201473184727455,0.5304726368159204,44.876126126126145,7823.654836271983,107.17335392153402,8
3596,30.65595661214737,1,2,197,0.005025125628140704,0.010050251256281407,0.9899497487437185,199,6000,3800,2200,0.6333333333333333,82,38,44,220.63877717985096,0.4827885217332453,0.7908587980355364,0.12663133036168583,1000496.9742720547,-1650.3142048947957,998846.6600671599,3395,0,359.8643216080402,63,136,40,38.87798358497378,0.5336578726968174,44.514973958333314,7832.1378733866395,124.31964878391491,0
3597,30.731231347511223,3,0,200,0.015,0.0,1.0,200,6350,4500,1850,0.7086614173228346,82,45,37,217.69800768579785,0.4828208752093803,0.7887810337810339,0.1264501193579207,1006509.3491156221,-2526.9839960801055,1003982.365119542,3396,0,357.5,69,131,40,38.49079161579161,0.5371354166666666,44.06249999999999,7865.274523003641,113.98948584063247,0
3598,30.575651564593116,1,3,198,0.004975124378109453,0.014925373134328358,0.9850746268656716,201,8000,6000,2000,0.75,100,60,40,220.97426832172272,0.48251762023217243,0.7922310777424248,0.12948330981065082,1003986.3126531931,-3828.9718312873492,1000157.3408219058,3397,0,356.7164179104478,64,137,39,38.07115460780022,0.5398009950248757,43.73397435897435,7835.500707843068,122.42969856004794,0
3599,30.54809213189637,3,4,197,0.014925373134328358,0.01990049751243781,0.9800995024875622,201,5850,3700,2150,0.6324786324786325,80,37,43,215.66831008400646,0.4823082504145937,0.7862096393474114,0.127037907479441,1004611.0555304678,-2717.4462724071764,1001893.6092580606,3398,0,357.13432835820896,68,133,45,38.0075886900557,0.5424958540630183,43.53864734299514,7834.405029236894,115.21183866524844,0
3600,31.103738444489828,2,3,196,0.010050251256281407,0.01507537688442211,0.9849246231155779,199,6050,4500,1550,0.743801652892562,76,45,31,205.50685104785714,0.4822322893930934,0.773373393375423,0.11826902993584673,1015932.5547456711,-4093.7799594421886,1011838.7747862289,3399,0,359.7437185929648,73,126,40,39.159082355748886,0.5348618090452262,44.41159909909912,7949.75477106708,108.90075028859013,8
3601,30.80323372704507,4,6,194,0.02,0.03,0.97,200,6900,4900,2000,0.7101449275362319,89,49,40,191.4279399500916,0.48240630234505866,0.7626778428241963,0.10932920947301632,1003839.4221970317,-8467.41747362616,995372.0047234055,3400,0,358.845,68,132,44,39.81395245698065,0.5272395833333333,44.701086956521756,7864.032088738854,115.64753071674785,8
3602,30.77412062710058,1,2,193,0.005128205128205128,0.010256410256410256,0.9897435897435898,195,5600,3900,1700,0.6964285714285714,73,39,34,215.47525514614932,0.4819400387699357,0.7814175642956034,0.1217186465582559,999597.3140650388,-1522.3027416862133,998075.0113233526,2734,0,350.0358974358974,75,120,37,39.62859396285941,0.5280448717948718,45.12061403508771,7843.688969045519,104.5825195872736,8
3603,30.9105118285383,3,2,194,0.015306122448979591,0.01020408163265306,0.9897959183673469,196,6600,4800,1800,0.7272727272727273,84,48,36,209.598175165701,0.48148002790859934,0.7725476559289362,0.11707962343310244,1000633.3203114665,-3853.816410544254,996779.5039009223,2735,0,348.984693877551,73,123,40,40.21861400014754,0.5265731292517006,45.55180180180179,7865.124040155629,107.74142520761136,8
3604,30.78798438682349,0,3,191,0.0,0.015463917525773196,0.9845360824742269,194,6800,5200,1600,0.7647058823529411,84,52,32,203.86286820406713,0.4811831187792675,0.7661528686066776,0.11322230064872034,994921.8689930625,-5034.474829624645,989887.3941634379,2736,1,353.55670103092785,70,124,37,40.591936942136066,0.5272766323024055,45.774647887323944,7827.086171579772,111.81551673685388,7
3605,30.788100137189616,2,2,191,0.010362694300518135,0.010362694300518135,0.9896373056994818,193,5450,3800,1650,0.6972477064220184,71,38,33,202.60330731208848,0.4814425014392631,0.76368099227702,0.11361031588675134,997838.4086345814,-3616.927649520462,994221.4809850609,2737,0,355.1658031088083,74,119,44,40.244553852308485,0.5297387737478412,45.402777777777786,7838.564772428112,105.92655097875827,0
3606,30.731728132690705,2,2,191,0.010362694300518135,0.010362694300518135,0.9896373056994818,193,6900,5500,1400,0.7971014492753623,83,55,28,198.18642983762305,0.48125022488485897,0.7575986916966153,0.11215289873470025,998757.1968324097,-5911.975377030828,992845.2214553789,2738,0,355.6735751295337,83,110,39,39.999361593462694,0.5331930051813472,45.05208333333331,7834.990062995818,94.39747063850383,0
3607,31.186150773400517,2,1,192,0.010362694300518135,0.0051813471502590676,0.9948186528497409,193,7000,4900,2100,0.7,91,49,42,210.67538651967183,0.48152908210995965,0.7698681724390615,0.1181269284885585,1010713.7308539782,-3013.498818320166,1007700.232035658,2739,0,356.5958549222798,77,116,41,40.042313610295125,0.5313579447322971,45.405982905982874,7939.807403099651,103.11438185843703,8
3608,31.187130131169237,4,2,194,0.02040816326530612,0.01020408163265306,0.9897959183673469,196,6000,4000,2000,0.6666666666666666,80,40,40,228.4340973736032,0.4819231859410431,0.7913475359521167,0.12985837759787505,1014938.2748591324,1169.3017414730648,1016107.5766006054,2740,0,352.0816326530612,83,113,38,39.05062663037312,0.5351296768707483,44.87847222222219,7956.508286068189,95.86154561527938,7
3609,31.182357082852047,2,0,196,0.01020408163265306,0.0,1.0,196,5600,3600,2000,0.6428571428571429,76,36,40,223.48476316325605,0.481879033664748,0.7871422779824957,0.12778976619821894,1016555.1615423602,636.9179039359724,1017192.0794462962,2741,0,352.9642857142857,68,128,37,38.949243230459984,0.5373086734693877,44.65579710144928,7962.234113818841,117.09167814439472,0
3610,30.755674050952045,3,1,198,0.01507537688442211,0.005025125628140704,0.9949748743718593,199,6200,4600,1600,0.7419354838709677,78,46,32,219.1877479536418,0.48187697747999253,0.7874225302384663,0.1236962278351843,998707.77359183,-2219.098448522478,996488.6751433075,2742,0,348.6281407035176,73,126,37,39.57182574753273,0.5306742043551089,45.15765765765764,7837.848015462174,107.3677810337284,8
3611,30.559819452122046,2,6,194,0.01,0.03,0.97,200,6100,4500,1600,0.7377049180327869,77,45,32,211.1743205123387,0.48191478224455614,0.7809977724150745,0.11987313641727737,994092.7622082455,-4114.627282888221,989978.1349253573,2743,0,347.86,87,113,41,39.54736711837135,0.5327083333333333,44.9337121212121,7794.779705898698,89.59516903331837,8
3612,31.123594045909694,2,7,189,0.01020408163265306,0.03571428571428571,0.9642857142857143,196,6300,5200,1100,0.8253968253968254,74,52,22,205.23753959868498,0.48153508198151057,0.7726632185063584,0.11787642884072812,1015974.6422462671,-3796.772826144173,1012177.8694201229,2744,0,341.61224489795916,71,125,37,39.243778664854744,0.5365114795918368,44.487847222222236,7952.456516852045,112.00642981481754,7
3613,30.775268263892542,2,3,188,0.010471204188481676,0.015706806282722512,0.9842931937172775,191,6000,3800,2200,0.6333333333333333,82,38,44,232.59556663480186,0.481334389639019,0.7835383009173664,0.13080558406978288,998293.3078701636,2239.719522358224,1000533.0273925218,2745,0,350.17277486910996,74,117,35,39.367263754839406,0.5308682373472949,45.29166666666666,7838.717287382276,105.92861199165237,8
3614,30.691987826534348,7,3,192,0.035897435897435895,0.015384615384615385,0.9846153846153847,195,6600,5100,1500,0.7727272727272727,81,51,30,229.45611458862604,0.48152260111023,0.7872962440673852,0.13099604651227803,1000095.7673745862,295.6177996607321,1000391.385174247,2746,0,343.6923076923077,68,127,35,38.8585403114528,0.5354166666666667,44.71618357487924,7835.167786031057,115.22305567692732,0
3615,30.679785966671297,2,2,192,0.010309278350515464,0.010309278350515464,0.9896907216494846,194,6650,4800,1850,0.7218045112781954,85,48,37,224.17857059964572,0.48155758684543204,0.787585344662725,0.1276413026423938,998900.6009256497,-663.5782226718575,998237.0227029779,2747,0,346.45360824742266,78,116,39,39.097405225718695,0.5316258591065293,44.81803797468356,7828.927977491994,100.37087150630762,8
3616,30.37450584183618,1,0,193,0.0051813471502590676,0.0,1.0,193,6000,4000,2000,0.6666666666666666,80,40,40,212.5981383009337,0.4813075705238918,0.7722596500325496,0.11962265819929876,985450.2539473606,-2699.0221245219045,982751.2318228387,2748,0,349.22279792746116,75,118,34,39.85589857411891,0.5324913644214162,45.271381578947356,7737.255908313094,103.16341211084125,8
3617,30.318244069098593,3,2,194,0.015306122448979591,0.01020408163265306,0.9897959183673469,196,6600,4600,2000,0.696969696969697,86,46,40,213.6538786782394,0.48161575527646955,0.778065616958646,0.12141298271994845,986556.5235010744,-3643.6744437353964,982912.849057339,2749,0,344.86224489795916,82,114,37,39.44158836358867,0.5352359693877551,44.892068273092356,7734.424538059291,94.3222504641377,0
3618,30.84109357696408,4,3,195,0.020202020202020204,0.015151515151515152,0.9848484848484849,198,6100,4000,2100,0.6557377049180327,82,40,42,210.43053451849448,0.48107235638961526,0.7810403138528133,0.12148566941273942,1008294.96317174,-3264.7903894929136,1005030.1727822471,2750,0,340.12626262626264,72,126,40,38.91136532738096,0.537773569023569,44.292237442922385,7886.3070333789665,109.53204213026342,8
3619,31.008175949319906,2,3,194,0.01015228426395939,0.015228426395939087,0.9847715736040609,197,6300,4300,2000,0.6825396825396826,83,43,40,206.05103096661193,0.4812774094409337,0.7755008364724001,0.11953035876980109,1015194.090577701,-3863.6422010501565,1011330.4483766508,2751,0,342.7208121827411,74,123,37,38.838494174265456,0.5396044839255499,44.111111111111136,7934.647690142692,107.22496878571205,0
3620,30.59076439310341,1,3,192,0.005128205128205128,0.015384615384615385,0.9846153846153847,195,7550,5400,2150,0.7152317880794702,97,54,43,213.60752509470007,0.4811712485681558,0.7781023085055689,0.12244982022961201,998016.0252257511,-3913.253369335138,994102.771856416,2752,0,346.94358974358977,71,124,42,39.103798519861066,0.5380876068376068,44.56018518518521,7814.099191618025,110.05773509321162,7
3621,30.66007172097879,3,4,191,0.015384615384615385,0.020512820512820513,0.9794871794871794,195,6700,5000,1700,0.746268656716418,84,50,34,210.5478096765612,0.4807956648162834,0.7761094159841542,0.1220973375727277,1003696.7289733536,-3434.7704270261693,1000261.9585463274,2753,0,345.97435897435895,77,118,39,38.73651704940847,0.5416666666666667,44.12393162393163,7845.178608092351,101.88543646873184,0
3622,30.881947064685615,1,6,186,0.005208333333333333,0.03125,0.96875,192,5700,3900,1800,0.6842105263157895,75,39,36,217.19962434598457,0.480523287521815,0.780295205102127,0.1265549811189272,1012372.0348541952,-122.63486625767746,1012249.3999879375,2754,0,352.2864583333333,79,113,41,38.38381430629717,0.5436197916666667,43.94531250000001,7907.467305039633,100.09452284860295,0
3623,30.821239044896394,2,0,188,0.010638297872340425,0.0,1.0,188,6100,4000,2100,0.6557377049180327,82,40,42,214.16137004028815,0.480098821443471,0.7737627303850858,0.12559647844291227,1012297.8736455477,-340.9800982398251,1011956.8935473078,2755,0,358.24468085106383,65,123,43,38.21375238623067,0.5459330673758865,43.702651515151516,7899.4018442246315,121.52925914191741,0
3624,30.605576193089906,1,0,189,0.005291005291005291,0.0,1.0,189,6500,4600,1900,0.7076923076923077,84,46,38,198.6738162641329,0.4799969041990319,0.7537532539747656,0.11245635490124983,994730.8038289142,-4774.6070095642335,989956.19681935,2756,0,357.34391534391534,82,107,37,39.977336122733625,0.5353835978835979,45.04267068273092,7803.115968406388,95.15995083422425,8
3625,31.106692933659446,3,6,186,0.015625,0.03125,0.96875,192,6300,4500,1800,0.7142857142857143,81,45,36,206.7829160414283,0.4803403595840605,0.7637085789263052,0.11562048735511385,1007284.1884746619,-3042.167644957257,1004242.0208297046,2757,0,352.7447916666667,74,118,42,40.251550874129066,0.5297309027777778,45.51388888888888,7916.221314214447,106.97596370560063,8
3626,30.692912685428347,6,6,186,0.03125,0.03125,0.96875,192,6000,4400,1600,0.7333333333333333,76,44,32,198.32932642134574,0.47982736601948806,0.7529974008337059,0.11211430417322348,997176.5794655933,-4846.128134289838,992330.4513313035,2758,0,352.6458333333333,82,110,40,40.03731557612462,0.5341254340277778,45.092871485943746,7823.842238375114,95.41271022408675,0
3627,30.7722463738718,2,2,186,0.010638297872340425,0.010638297872340425,0.9893617021276596,188,6650,4800,1850,0.7218045112781954,85,48,37,213.34300651999385,0.479513335798536,0.7646536645270241,0.12147866111792442,1001927.8671616481,-1499.1393007141123,1000428.727860934,2759,0,354.29787234042556,85,103,45,39.37171697993795,0.5371786347517731,44.815891472868195,7852.588258293684,92.38339127404333,0
3628,31.108438556677534,1,1,186,0.0053475935828877,0.0053475935828877,0.9946524064171123,187,7000,5400,1600,0.7714285714285715,86,54,32,218.87128077016826,0.4796973530370115,0.7674989032346473,0.12485628728083989,1013431.3021692061,-37.798584329014375,1013393.5035848771,2760,0,356.4652406417112,67,120,39,39.15892746404214,0.5374888591800356,44.74571078431375,7940.562372394621,118.51585630439733,8
3629,31.133479563025794,3,3,186,0.015873015873015872,0.015873015873015872,0.9841269841269842,189,5150,3300,1850,0.6407766990291263,70,33,37,240.90764237618447,0.47990778265600964,0.7901028040223803,0.1359536146377318,1010975.9911958049,5760.368507581446,1016736.3597033863,2761,0,353.24867724867727,73,116,33,39.01831087052586,0.5308641975308642,45.15765765765765,7934.1288571089235,108.68669667272498,8
3630,31.420576834305393,2,2,186,0.010638297872340425,0.010638297872340425,0.9893617021276596,188,6900,5000,1900,0.7246376811594203,88,50,38,235.67357819522874,0.4801758590283309,0.7843214174573883,0.13400082469877922,1022597.1044866878,3699.823733291303,1026296.9282199792,2762,0,356.07978723404256,78,110,35,38.85805898668319,0.533632535460993,44.87078059071728,8016.307241125681,102.77316975802155,0
3631,31.687469608984248,4,2,188,0.021052631578947368,0.010526315789473684,0.9894736842105263,190,6800,5000,1800,0.7352941176470589,86,50,36,235.01537921325004,0.48064315882298336,0.7902612125521553,0.13459347921950104,1033503.0184256801,3777.8207586700664,1037280.8391843502,2763,0,353.0736842105263,63,127,41,38.59397569886995,0.5349232456140351,44.59635416666668,8093.0952653675495,128.46182960900873,8
3632,31.56876058959073,4,1,191,0.020833333333333332,0.005208333333333333,0.9947916666666666,192,5200,3500,1700,0.6730769230769231,69,35,34,179.9487609234641,0.48078461314717863,0.7378238902463861,0.10409050234336102,1032678.0517139562,-6434.172832243184,1026243.878881713,2764,0,341.0677083333333,79,113,49,39.61599809950453,0.5411241319444444,44.218750000000014,8074.697044556286,102.21135499438336,8
3633,32.04148950879642,6,2,195,0.030456852791878174,0.01015228426395939,0.9898477157360406,197,5700,4500,1200,0.7894736842105263,69,45,24,196.6940910348406,0.48124503608550023,0.7619311133223001,0.11314060547458944,1046406.8139422819,-3935.592575791654,1042471.2213664902,2765,0,333.20304568527916,74,123,44,39.40365559842762,0.5390757191201354,44.43055555555557,8188.8256729356335,110.65980639102207,8
3634,31.64563074531029,6,5,196,0.029850746268656716,0.024875621890547265,0.9751243781094527,201,6700,4800,1900,0.7164179104477612,86,48,38,192.47818146866445,0.4821040630182421,0.7616266705687236,0.11205921523860703,1037159.2490513369,-6973.894769838195,1030185.3542814987,2766,0,326.9452736318408,82,119,36,39.047998366013076,0.5426513266998342,43.97590361445786,8102.044016118681,98.80541483071562,0
3635,31.521751652153355,0,5,191,0.0,0.025510204081632654,0.9744897959183674,196,5450,3700,1750,0.6788990825688074,72,37,35,194.69449909322273,0.4812162044304902,0.7582511832413805,0.11350133027137554,1033504.3913872335,-4406.476041643094,1029097.9153455904,2767,1,336.2142857142857,82,114,37,38.9400771090636,0.5434736394557823,43.925702811245,8071.910400483706,98.43793171321593,0
3636,31.66460537061754,2,3,190,0.010362694300518135,0.015544041450777202,0.9844559585492227,193,5500,3800,1700,0.6909090909090909,72,38,34,195.92386664436003,0.4808757915947035,0.7583946224894016,0.11455824324691292,1039091.6414226425,-3383.429562927926,1035708.2118597146,2768,0,342.24870466321244,80,113,41,38.79501112728612,0.5445811744386874,43.81430041152266,8112.019079064775,101.40023848830968,0
3637,31.36574927133062,1,3,188,0.005235602094240838,0.015706806282722512,0.9842931937172775,191,6600,4300,2300,0.6515151515151515,89,43,46,226.83952565782656,0.4800783043997428,0.7810338381743049,0.13231641224223745,1028561.2829328391,1863.6707060985068,1030424.9536389377,2769,0,346.717277486911,80,111,37,38.095058752636355,0.5417757417102966,43.904320987654344,8032.632857372459,100.40791071715573,8
3638,31.79070051127798,5,6,187,0.025906735751295335,0.031088082901554404,0.9689119170984456,193,6600,4900,1700,0.7424242424242424,83,49,34,214.47889041878386,0.4804530080598734,0.7700363796714786,0.1266949074003867,1046332.8287153475,-316.7391776765098,1046016.089537671,2770,0,341.9326424870466,78,115,40,37.93073543015728,0.5457685664939551,43.433544303797504,8156.427354278133,104.56958146510426,0
3639,31.727675121110845,2,1,188,0.010582010582010581,0.005291005291005291,0.9947089947089947,189,5550,4000,1550,0.7207207207207207,71,40,31,215.31614732326153,0.4798995740928365,0.7693160817326381,0.1279153951486637,1045976.523045441,1693.1270265450576,1047669.650071986,2771,0,348.6031746031746,78,111,43,37.69374122761978,0.5480599647266313,43.22257383966245,8146.950755650226,104.44808661090033,0
3640,32.002694990391824,1,1,188,0.005291005291005291,0.005291005291005291,0.9947089947089947,189,5700,3600,2100,0.631578947368421,78,36,42,222.93092613266012,0.47971194979173704,0.778127478826028,0.1317061757247242,1053353.2277158017,3465.0021199021717,1056818.2298357037,2772,0,349.3809523809524,67,122,43,37.70853235019008,0.5462962962962963,43.42830882352942,8210.985575889608,122.55202352074042,8
3641,31.57746615628704,2,2,188,0.010526315789473684,0.010526315789473684,0.9894736842105263,190,6050,4200,1850,0.6942148760330579,79,42,37,223.8377036847013,0.47978859184999534,0.7812402823697617,0.12900235564607487,1031841.3380192138,2142.999133833874,1033984.3371530477,2773,0,348.5263157894737,71,119,39,38.63539898132427,0.5393640350877194,44.35763888888887,8072.538006099383,113.69771839576596,7
3642,31.972426781579284,2,6,184,0.010526315789473684,0.031578947368421054,0.968421052631579,190,6000,4500,1500,0.75,75,45,30,216.95895619182488,0.4796679197994988,0.7753209861234804,0.12614960977081283,1047475.0463229507,1451.8185374420027,1048926.8648603926,2774,0,347.4684210526316,75,115,38,38.47049689440996,0.5419956140350877,44.024122807017534,8184.169991403136,109.12226655204181,0
3643,32.160186703846875,3,3,184,0.016042780748663103,0.016042780748663103,0.983957219251337,187,5350,3800,1550,0.7102803738317757,69,38,31,210.59765434092373,0.47940026450462886,0.7678613496728952,0.1193715895355646,1045694.5788293987,1294.1650916983804,1046988.7439210971,2775,0,353.1711229946524,78,109,36,39.61898914167528,0.5353163992869876,44.98945147679325,8201.186851956732,105.14342117893247,8
3644,32.57147268666983,5,1,188,0.026455026455026454,0.005291005291005291,0.9947089947089947,189,5350,3600,1750,0.6728971962616822,71,36,35,202.59854516354147,0.4799171638710646,0.7573231740907302,0.11462082075690735,1058467.3686733292,-261.21020074046237,1058206.1584725888,2776,0,350.27513227513225,80,109,38,39.896716101694935,0.5348875661375662,45.06172839506172,8303.714950367037,103.79643687958796,7
3645,33.042474524718166,1,2,187,0.005291005291005291,0.010582010582010581,0.9894179894179894,189,6150,4400,1750,0.7154471544715447,79,44,35,198.75052061640963,0.4795770948253218,0.7555123636756294,0.11324157570004753,1076049.551511616,-1176.9182856023785,1074872.6332260135,2777,0,351.1111111111111,82,107,41,39.71938775510207,0.5373677248677249,44.79166666666667,8432.71485266246,102.83798600807879,0
3646,32.88620114906622,4,3,188,0.020942408376963352,0.015706806282722512,0.9842931937172775,191,5750,3700,2050,0.6434782608695652,78,37,41,196.48463973343715,0.4802000091852668,0.7546140285091016,0.11299212569876395,1073914.4666796236,-1748.4605819851677,1072166.0060976385,2778,0,348.37696335078533,76,115,46,39.41857233603306,0.5400850785340314,44.4399350649351,8404.399701123051,110.58420659372436,0
3647,33.19470243424406,4,3,189,0.020833333333333332,0.015625,0.984375,192,6100,4400,1700,0.7213114754098361,78,44,34,203.96592689578702,0.48021878635834786,0.7614045648441259,0.11692749860217776,1082981.76464615,-321.7241125423634,1082660.0405336076,2779,0,346.0520833333333,75,117,41,39.3485293591601,0.5392795138888888,44.55866228070177,8479.299194997382,113.05732259996509,8
3648,33.269061434292404,2,7,184,0.010471204188481676,0.03664921465968586,0.9633507853403142,191,6650,4900,1750,0.7368421052631579,84,49,35,217.05446070837772,0.47983259851198673,0.7752485362622714,0.12458096172629209,1085796.581671056,2285.3982947224213,1088081.9799657785,2780,0,348.3612565445026,70,121,42,38.96744956165539,0.5387216404886561,44.51291079812208,8499.81566632585,121.4259380903693,8
3649,33.22581127334947,2,5,181,0.010752688172043012,0.026881720430107527,0.9731182795698925,186,5800,4600,1200,0.7931034482758621,70,46,24,221.29790617557842,0.47935677613096966,0.7726553507624416,0.1280984037458701,1087107.8927661383,5114.940091218354,1092222.8328573566,2781,0,356.66129032258067,72,114,43,38.531381900671235,0.5423387096774194,44.192351598173516,8499.416648078426,118.04745344553369,0
3650,32.85671061591917,2,0,183,0.01092896174863388,0.0,1.0,183,6200,4300,1900,0.6935483870967742,81,43,38,219.77375271164965,0.47920544846774354,0.7568465138041385,0.12411573674488764,1067163.1369601835,4106.889473054805,1071270.0264332383,2782,0,360.3606557377049,79,104,31,39.5288392765914,0.5350637522768671,45.130208333333314,8374.182989531224,106.00231632318005,8
3651,33.27302998574475,1,2,182,0.005434782608695652,0.010869565217391304,0.9891304347826086,184,5350,3800,1550,0.7102803738317757,69,38,31,222.20479070948133,0.4793627989625406,0.7654456870007149,0.125306888517852,1080213.4271848039,5855.719701834428,1086069.1468866384,2783,0,359.3967391304348,73,111,42,39.523717452951814,0.5337975543478262,45.18581081081083,8478.44015768517,116.14301585870096,8
3652,33.57444362255924,4,4,182,0.021505376344086023,0.021505376344086023,0.978494623655914,186,6200,4400,1800,0.7096774193548387,80,44,36,223.47591434648882,0.48022256127094837,0.7726942536891104,0.12666288466744405,1091657.700983876,5391.840576151395,1097049.5415600273,2784,0,356.0806451612903,77,109,36,39.29317229641266,0.5393145161290323,44.99198717948717,8561.75214974314,111.19158636030053,7
3653,33.242987817267895,1,2,181,0.00546448087431694,0.01092896174863388,0.9890710382513661,183,5650,3700,1950,0.6548672566371682,76,37,39,219.0078058687617,0.4795069456954703,0.7709156767111818,0.12399339275231433,1080522.353988919,5078.565987852556,1085600.9199767716,2785,0,362.879781420765,72,111,35,39.45029755242147,0.5352345173041895,45.03424657534247,8475.823434916436,117.71976992939494,8
3654,33.50532032677879,3,4,180,0.016304347826086956,0.021739130434782608,0.9782608695652174,184,5800,3900,1900,0.6724137931034483,77,39,38,218.79949028615445,0.4797049477310525,0.7734184821125945,0.12601064522194413,1094610.6032462749,5300.048410420859,1099910.6516566956,2786,0,361.7554347826087,68,116,39,38.79119418851877,0.5390625,44.384057971014485,8564.494018312456,125.94844144577142,8
3655,33.87213106457864,5,7,178,0.02702702702702703,0.03783783783783784,0.9621621621621621,185,5450,3300,2150,0.6055045871559633,76,33,43,211.34527517565476,0.4797321778300039,0.7647794737009688,0.12279594488581784,1109475.1612731367,4446.466651965115,1113921.627925102,2787,0,359.9351351351351,75,110,35,38.64218521295208,0.543581081081081,44.05153508771931,8669.519949286501,115.59359932382002,0
3656,34.010938043235264,1,3,176,0.00558659217877095,0.01675977653631285,0.9832402234636871,179,5300,3100,2200,0.5849056603773585,75,31,44,222.05031479845272,0.47817672044023185,0.7687952919670584,0.12913411511094558,1114321.5885794181,8387.091906154681,1122708.680485573,2788,0,372.4245810055866,77,102,35,38.33298553144131,0.5448091247672253,44.01709401709404,8706.218755511984,113.06777604561017,0
3657,34.280471150157254,2,2,176,0.011235955056179775,0.011235955056179775,0.9887640449438202,178,4950,2900,2050,0.5858585858585859,70,29,41,231.21638564130186,0.4778382160011849,0.7726221900582426,0.13403554409990012,1122098.0042861274,11339.488977271176,1133437.4932633985,2789,0,375.0561797752809,77,101,38,38.22132113715052,0.5438319288389513,44.137286324786324,8771.094374544102,113.9103165525208,8
3658,34.46340681583136,2,1,177,0.011235955056179775,0.0056179775280898875,0.9943820224719101,178,6150,4500,1650,0.7317073170731707,78,45,33,229.95198339100563,0.4780193984214647,0.7727081923035832,0.12853745252713436,1115880.416298288,9569.78299099431,1125450.1992892823,2790,0,373.7865168539326,70,108,41,39.67353704237533,0.5292017790262172,45.525234741784026,8770.067359457054,125.2866765636722,8
3659,34.64424744146142,5,1,181,0.027472527472527472,0.005494505494505495,0.9945054945054945,182,5700,3800,1900,0.6666666666666666,76,38,38,223.58459561348997,0.47881693582660434,0.770486706201752,0.12617994643999084,1124985.1892090708,8205.871720094696,1133191.0609291655,2791,0,366.52197802197804,76,106,44,39.45902785150578,0.5321085164835164,45.15692640692638,8828.846500300935,116.16903289869651,0
3660,34.12470417746189,3,8,176,0.016304347826086956,0.043478260869565216,0.9565217391304348,184,5500,4100,1400,0.7454545454545455,69,41,28,225.00873926899246,0.4790045636334838,0.7758738385343635,0.12798662233649005,1110733.1441528427,7684.932886022656,1118418.0770388653,2792,0,363.44565217391306,80,104,36,39.11500336021503,0.5354393115942029,44.85596707818927,8706.714646101314,108.83393307626643,0
3661,33.82724467621769,2,2,176,0.011235955056179775,0.011235955056179775,0.9887640449438202,178,5700,4100,1600,0.7192982456140351,73,41,32,228.60756087120194,0.4784220994942762,0.7718511791473044,0.12969297233814986,1100186.656097717,9002.197590708449,1109188.8536884254,2793,0,375.0449438202247,75,103,37,39.12564488392089,0.5347612359550562,44.956140350877185,8627.43104351778,115.0324139135704,8
3662,33.26236518831095,1,0,177,0.005649717514124294,0.0,1.0,177,5100,3500,1600,0.6862745098039216,67,35,32,230.918716294332,0.4779642291559665,0.7673050319182622,0.12767883348549514,1073419.6016777894,9074.535292921806,1082494.1369707112,2794,0,377.91525423728814,81,96,36,40.081118639265334,0.5296610169491525,45.94766260162603,8450.381623488733,104.32569905541645,7
3663,33.56561972419719,2,2,177,0.0111731843575419,0.0111731843575419,0.9888268156424581,179,6200,4300,1900,0.6935483870967742,81,43,38,228.9632708786112,0.478299646391731,0.7634887863330915,0.12889191122886762,1089136.392493827,7874.446171663123,1097010.8386654903,2795,0,374.6815642458101,78,101,40,39.42039768806072,0.5320647113594041,45.253164556962,8550.735404423585,109.62481287722545,8
3664,33.942551420701854,2,4,175,0.0111731843575419,0.0223463687150838,0.9776536312849162,179,5950,4500,1450,0.7563025210084033,74,45,29,230.03457070567293,0.47839641788546444,0.7657724272219915,0.13064582781005543,1104299.821268628,9055.427063175433,1113355.2483318034,2796,0,373.5810055865922,84,95,39,39.04636079750176,0.5357891061452513,44.914215686274474,8658.26235075859,103.07455179474512,0
3665,33.55717807020397,0,1,174,0.0,0.005714285714285714,0.9942857142857143,175,6250,5200,1050,0.832,73,52,21,237.16070624467812,0.477603995621237,0.7673590001735835,0.13490687119115857,1092280.2634184153,10559.191737886365,1102839.4551563016,2797,1,381.7142857142857,83,92,39,38.802602268124716,0.5371428571428571,44.853670634920604,8561.990808462795,103.15651576461198,0
3666,33.86054183871443,4,4,174,0.02247191011235955,0.02247191011235955,0.9775280898876404,178,6400,5200,1200,0.8125,76,52,24,233.51773474068943,0.4779241784633615,0.7697258839084857,0.13442677809266154,1106068.608979169,9657.327207320497,1115725.9361864896,2798,0,376.0449438202247,71,107,39,38.43235269145867,0.5403206928838951,44.401041666666686,8654.719222577707,121.89745383912263,0
3667,33.56650525597099,2,4,172,0.011363636363636364,0.022727272727272728,0.9772727272727273,176,5700,3800,1900,0.6666666666666666,76,38,38,213.1145052723975,0.4777245670995671,0.7466854633157021,0.12380049281760848,1099403.3899631342,5959.761909358176,1105363.1518724924,2799,0,380.14772727272725,80,96,37,38.60416038589091,0.5478219696969697,44.05864197530865,8591.056939356178,107.38821174195223,8
3668,33.08699598449894,1,0,173,0.005780346820809248,0.0,1.0,173,5100,3600,1500,0.7058823529411765,66,36,30,224.3758193104193,0.477091454944661,0.754016225936839,0.1282425152474409,1078504.9033753062,8698.084265027763,1087202.9876403338,2800,0,387.5895953757225,69,104,35,38.94369001826165,0.5399205202312138,44.67261904761905,8448.016028304064,122.43501490295745,8
3669,33.28282217113649,0,3,170,0.0,0.017341040462427744,0.9826589595375722,173,4550,3000,1550,0.6593406593406593,61,30,31,228.37018641793037,0.4769234216068468,0.759872084396449,0.12864214142477814,1080173.213880409,10185.871643504805,1090359.0855239138,2801,1,388.5895953757225,73,100,44,39.409808552958744,0.5361271676300579,45.22804054054054,8479.529820881182,116.15794275179701,8
3670,33.058295138208514,7,0,177,0.03954802259887006,0.0,1.0,177,5950,3800,2150,0.6386554621848739,81,38,43,220.15636307672992,0.4773396036637562,0.7586694805025616,0.12588656947531496,1077711.3630392342,6103.002826636731,1083814.3658658708,2802,0,379.91525423728814,68,109,40,39.03423199716211,0.5403130885122411,44.65579710144928,8441.244021250901,124.13594148898383,0
3671,32.57621388325104,3,1,179,0.016666666666666666,0.005555555555555556,0.9944444444444445,180,4900,3700,1200,0.7551020408163265,61,37,24,210.610740661514,0.47786700806952204,0.7523439893221304,0.119095917714829,1058467.0353042118,3684.9052542431887,1062151.940558455,2803,0,374.56666666666666,82,98,34,39.7114390508074,0.5342592592592592,45.08032128514055,8304.317976864866,101.27217044957153,8
3672,32.250218308786785,2,3,178,0.011049723756906077,0.016574585635359115,0.9834254143646409,181,5500,3400,2100,0.6181818181818182,76,34,42,209.18164655086227,0.478097503580929,0.7593861347144868,0.11737853147967199,1045439.5021289971,2037.3512849312829,1047476.8534139284,2804,0,373.4806629834254,72,109,39,40.050460472240864,0.5268186003683242,45.376712328767105,8211.656613898242,114.05078630414225,8
3673,32.19317516619082,3,2,179,0.016574585635359115,0.011049723756906077,0.988950276243094,181,6150,4700,1450,0.7642276422764228,76,47,29,201.511668728447,0.478194700225087,0.7508406028241448,0.11400442501313678,1046169.8123156897,-186.91506938779094,1045982.897246302,2805,0,373.1933701657459,76,105,40,39.924935880428116,0.5306744935543278,45.06222943722944,8207.256304205443,107.99021452901898,0
3674,32.2908580299696,1,0,180,0.005555555555555556,0.0,1.0,180,6250,4700,1550,0.752,78,47,31,202.58485888705096,0.4782342747775709,0.7498805770516854,0.11492984921250765,1050217.7005121293,301.64093178663643,1050519.341443916,2806,0,375.9166666666667,75,105,41,39.78933791917454,0.5328703703703703,44.9561403508772,8235.585063345332,109.80780084460443,8
3675,31.98814116968178,5,4,181,0.02702702702702703,0.021621621621621623,0.9783783783783784,185,6300,4100,2200,0.6507936507936508,85,41,44,194.61152943002887,0.4790601743047395,0.7477842600309557,0.1121239014736469,1045164.8394588928,-2619.7744172824646,1042545.0650416104,2807,0,366.72972972972974,73,112,41,39.394502569750394,0.5367680180180181,44.3693693693694,8177.148699907461,112.0157356151707,0
3676,31.715586519949987,4,3,182,0.021621621621621623,0.016216216216216217,0.9837837837837837,185,5250,3800,1450,0.7238095238095238,67,38,29,189.52276069872568,0.4793710830395613,0.7405650472729282,0.11007291397852467,1038716.8426854875,-2877.9032779961517,1035838.9394074914,2808,0,367.43783783783783,78,107,42,39.215932509015985,0.5390202702702702,44.06645569620256,8117.082467724614,104.06515984262326,0
3677,31.354973380349783,2,1,183,0.010869565217391304,0.005434782608695652,0.9945652173913043,184,5550,4300,1250,0.7747747747747747,68,43,25,192.71751297514268,0.4786221984636097,0.7449737828199845,0.11264757584512339,1028835.1551197456,-2695.08952878517,1026140.0655909604,2809,0,370.19565217391306,81,103,45,38.8893021256901,0.5409873188405797,43.826219512195145,8032.322067938748,99.16446997455245,0
3678,31.790368953065414,0,0,183,0.0,0.0,1.0,183,5350,3800,1550,0.7102803738317757,69,38,31,217.15127121138252,0.47819336856222106,0.7670101383856034,0.12333145692656068,1034286.355027183,2969.319358147848,1037255.6743853308,2810,1,373.20765027322403,76,107,38,39.37418239994344,0.5297700364298725,44.9134199134199,8109.296495928018,106.70126968326339,8
3679,32.127600825071866,6,1,188,0.031746031746031744,0.005291005291005291,0.9947089947089947,189,5350,3700,1650,0.6915887850467289,70,37,33,220.59659829096182,0.4789966321437953,0.7775061644173862,0.1281574436729457,1052300.3475371832,3276.7754094198153,1055577.122946603,2811,0,362.32804232804233,74,115,37,38.40950817596411,0.5382495590828924,44.05555555555555,8222.880944505881,111.120012763593,8
3680,31.735555265817908,2,2,188,0.010526315789473684,0.010526315789473684,0.9894736842105263,190,6300,4700,1600,0.746031746031746,79,47,32,215.76328853269763,0.4789334447229184,0.7741824945376328,0.12615851103199,1041419.9017056816,640.0365470836723,1042059.9382527652,2812,0,361.4,80,110,36,38.28675350969666,0.5427631578947368,43.81430041152266,8130.19542760241,101.62744284503012,8
3681,31.620776785967482,0,4,184,0.0,0.02127659574468085,0.9787234042553191,188,5800,4600,1200,0.7931034482758621,70,46,24,204.2132954569314,0.47828251223119805,0.760670680580436,0.11729353720016152,1032218.3197807664,-1241.4590573105543,1030976.8607234558,2813,1,366.2074468085106,74,114,41,39.26817778260947,0.5429964539007093,44.486111111111114,8079.5476462700635,109.18307630094681,8
3682,32.01672872093995,0,6,178,0.0,0.03260869565217391,0.967391304347826,184,6100,4300,1800,0.7049180327868853,79,43,36,206.04483969852348,0.4773996198622001,0.7586823102135654,0.11899929700530809,1046848.6567875731,239.55273528208363,1047088.2095228552,2814,2,375.01630434782606,74,110,40,39.00875334926499,0.5449501811594203,44.277777777777786,8187.38901680483,110.6403921189842,0
3683,32.02879189674829,4,5,177,0.02197802197802198,0.027472527472527472,0.9725274725274725,182,6250,4300,1950,0.688,82,43,39,203.7733727956663,0.4764851860846336,0.7536744557235739,0.1187395851839192,1049987.6790296384,141.90614995266242,1050129.585179591,2815,0,379.92857142857144,80,102,38,38.725139370197375,0.5483058608058609,43.942901234567906,8201.19953004316,102.51499412553952,0
3684,32.08870151572164,0,1,176,0.0,0.005649717514124294,0.9943502824858758,177,5500,3100,2400,0.5636363636363636,79,31,48,233.54984385480958,0.4756409433316213,0.780533979355257,0.13342193335404845,1045815.0143897661,7949.986662349139,1053765.0010521153,2816,1,390.2542372881356,61,116,37,38.72811924190578,0.5414312617702448,44.69086021505377,8192.5387807948,134.303914439259,8
3685,32.16721474287776,1,0,177,0.005649717514124294,0.0,1.0,177,5250,3700,1550,0.7047619047619048,68,37,31,232.59692188069874,0.47563826827598016,0.7781533714747708,0.1336700352458443,1050228.1538130848,8205.967169874228,1058434.120982959,2817,0,391.2429378531073,66,111,39,38.52151273626997,0.5431967984934087,44.465174129353215,8219.843618064931,124.54308512219593,0
3686,31.95695825804683,0,3,174,0.0,0.01694915254237288,0.9830508474576272,177,6600,4900,1700,0.7424242424242424,83,49,34,217.46376106499736,0.4754911402157165,0.7629922580385822,0.12375874911986444,1040334.9511785483,3247.030250131577,1043581.9814286799,2818,1,392.2429378531073,69,108,42,39.287423941991804,0.5370174199623352,44.83630952380953,8154.255405516818,118.17761457270751,8
3687,31.845455487200063,1,0,175,0.005714285714285714,0.0,1.0,175,6000,4500,1500,0.75,75,45,30,216.5824928772173,0.4751929392446634,0.7596128809053422,0.12398379772843512,1038523.4325198507,3985.1987853106443,1042508.6313051613,2819,0,391.49142857142857,63,112,43,39.08138688844985,0.5396428571428571,44.61263020833332,8132.927116693598,129.0940812173587,0
3688,32.04706285118049,1,0,176,0.005681818181818182,0.0,1.0,176,5050,3900,1150,0.7722772277227723,62,39,23,217.88501250333775,0.47503246753246753,0.7639757414318684,0.12572713831792964,1047569.0867822856,5399.92071433369,1052969.0074966194,2820,0,390.2613636363636,64,112,39,38.73981510498275,0.545217803030303,44.31089743589744,8194.084740233735,128.0325740661521,8
3689,32.46306200991314,2,2,176,0.011235955056179775,0.011235955056179775,0.9887640449438202,178,5800,3800,2000,0.6551724137931034,78,38,40,213.9726471700324,0.47537704458410035,0.7620506165162229,0.12473876365082623,1064364.2167364685,4148.965801631983,1068513.1825381005,2821,0,386.86516853932585,70,108,39,38.44677437836598,0.5476942883895131,43.92605633802816,8312.944312221576,118.75634731745109,0
3690,32.32790491202821,0,0,176,0.0,0.0,1.0,176,6550,5000,1550,0.7633587786259542,81,50,31,210.6601108902601,0.47442031926406925,0.7541662307772774,0.1193374422187982,1050964.25462562,2529.2492842266624,1053493.5039098468,2822,1,392.25,70,106,40,39.640151515151494,0.5380563446969697,45.01173708920189,8243.236317063553,117.7605188151936,7
3691,32.343302928957755,2,0,178,0.011235955056179775,0.0,1.0,178,6000,4100,1900,0.6833333333333333,79,41,38,209.39462996410285,0.47483415857297023,0.7560112941228012,0.11950123146960707,1053793.9647816452,2531.759462771403,1056325.7242444167,2823,0,388.8314606741573,66,112,45,39.38424995432122,0.5404962546816479,44.72947761194029,8256.291834430285,125.09533082470129,0
3692,32.05628464175431,3,3,178,0.016574585635359115,0.016574585635359115,0.9834254143646409,181,5950,4200,1750,0.7058823529411765,77,42,35,199.07601331453702,0.4758453550235318,0.7511627520592288,0.11100103503720686,1037153.7892151672,-855.5116897956259,1036298.2775253715,2824,0,383.37016574585635,63,118,43,40.557683899588376,0.5268186003683242,45.62174479166668,8154.421755631182,129.4352659623997,8
3693,32.179477634905815,2,1,179,0.011111111111111112,0.005555555555555556,0.9944444444444445,180,6250,4300,1950,0.688,82,43,39,194.5075740026477,0.47564336333540247,0.7438845502251967,0.10919224770211293,1043284.5173312699,-1664.6519078741483,1041619.8654233958,2825,0,386.18333333333334,65,115,47,40.40690467336064,0.5296875,45.3598484848485,8194.187060630875,126.06441631739807,0
3694,31.993098063006208,0,0,179,0.0,0.0,1.0,179,5750,4100,1650,0.7130434782608696,74,41,33,206.80124684569552,0.47560181407319063,0.7482680883821582,0.11497232753997509,1034189.5850361455,1224.3391320613428,1035413.9241682069,2826,1,389.1899441340782,73,106,32,40.476561202458065,0.5324720670391061,45.73479729729729,8134.731564077703,111.43467895996854,8
3695,31.75313930963746,4,6,177,0.02185792349726776,0.03278688524590164,0.9672131147540983,183,6900,4900,2000,0.7101449275362319,89,49,40,203.1027170229053,0.47656578394283317,0.7489036970415508,0.11419544240912008,1029947.8993451272,-1662.9566501945014,1028284.9426949327,2827,0,381.6612021857924,81,102,36,40.126766417290085,0.5358606557377049,45.299796747967456,8087.531036054704,99.84606217351487,0
3696,31.70889503207616,3,5,175,0.016666666666666666,0.027777777777777776,0.9722222222222222,180,5800,4100,1700,0.7068965517241379,75,41,34,214.02637057905292,0.4757739757914339,0.7626093775796585,0.12104180453756534,1030322.9825229025,2303.257694712389,1032626.2402176149,2828,0,386.3388888888889,76,104,36,39.61970653789002,0.5373263888888888,45.07575757575758,8083.36604416185,106.3600795284454,8
3697,31.610945079921706,4,0,179,0.0223463687150838,0.0,1.0,179,5850,3800,2050,0.6495726495726496,79,38,41,215.436184831635,0.47529188374866616,0.7645439761467123,0.12314438713215721,1030419.7558347052,2747.940194434909,1033167.6960291401,2829,0,380.4413407821229,67,112,41,39.16836653067758,0.541550279329609,44.66911764705884,8071.2504992668055,120.46642536219113,0
3698,31.78400350031571,3,1,181,0.016483516483516484,0.005494505494505495,0.9945054945054945,182,6450,4900,1550,0.7596899224806202,80,49,31,196.0711400958076,0.47571995223928926,0.7458253554867911,0.11317547695711333,1039066.8825223189,-2103.7943416103053,1036963.0881807086,2830,0,375.15384615384613,73,109,42,39.28542756216167,0.5420100732600732,44.2989864864865,8127.201908547816,111.3315329938057,8
3699,31.69670623491632,0,2,179,0.0,0.011049723756906077,0.988950276243094,181,5850,4000,1850,0.6837606837606838,77,40,37,226.79851471570544,0.47524171270718235,0.7668993711228356,0.1286644187608704,1030888.2896592313,4710.786586505324,1035599.0762457367,2831,1,378.1933701657459,81,100,41,39.172467251083354,0.5344728360957642,44.95680894308942,8084.029104146504,99.80282844625314,8
3700,32.01631433606743,4,0,183,0.02185792349726776,0.0,1.0,183,5750,3500,2250,0.6086956521739131,80,35,45,220.73788196356253,0.4753748073420205,0.7629168589121871,0.12649922728721674,1044430.9146991436,3759.0935935913894,1048190.008292735,2832,0,375.0218579234973,70,113,46,38.93332376029105,0.5375113843351549,44.57159624413148,8177.876065007885,116.82680092868407,0
3701,31.755261105498,1,1,183,0.005434782608695652,0.005434782608695652,0.9945652173913043,184,5150,3100,2050,0.6019417475728155,72,31,41,221.06056717021613,0.47536466995327475,0.7650501672240788,0.1274838007665841,1037848.3778051356,3935.470206858784,1041783.8480119944,2833,0,373.9782608695652,74,110,47,38.68155149934815,0.5396852355072463,44.33333333333336,8118.7617559723785,109.71299670232943,0
3702,32.10294270977746,4,4,183,0.0213903743315508,0.0213903743315508,0.9786096256684492,187,7000,5000,2000,0.7142857142857143,90,50,40,218.6995442860399,0.4760460391390183,0.7727737028565407,0.12688496430371277,1051078.1576282398,1574.06281646147,1052652.2204447014,2834,0,368.6631016042781,78,109,36,38.509622816509534,0.5443961675579323,44.10601265822786,8214.950015409462,105.319871992429,8
3703,32.42254295326909,2,2,183,0.010810810810810811,0.010810810810810811,0.9891891891891892,185,6750,5200,1550,0.7703703703703704,83,52,31,219.68568867971024,0.475522669408539,0.7773069466549367,0.12512414270926928,1055746.1584490957,2636.464377970006,1058382.6228270656,2835,0,373.55135135135134,74,111,43,39.19929882805415,0.536204954954955,44.805555555555586,8274.052836435714,111.81152481669884,8
3704,32.098530801205726,2,1,184,0.010810810810810811,0.005405405405405406,0.9945945945945946,185,6700,5000,1700,0.746268656716418,84,50,34,223.5477111212523,0.475299892283588,0.775021929461611,0.1271963108923365,1044882.8003385824,3016.23168113099,1047899.0320197133,2836,0,374.5189189189189,79,106,42,39.13979043342179,0.5336148648648649,44.84375000000001,8190.140749745165,103.67266771829323,8
3705,32.38759712157821,2,1,185,0.010752688172043012,0.005376344086021506,0.9946236559139785,186,6550,4900,1650,0.7480916030534351,82,49,33,220.17397946964408,0.4756992879976751,0.772137747253689,0.12634805881874525,1056970.3239472632,2793.4724809577147,1059763.7964282208,2837,0,373.02150537634407,68,118,44,38.8949211132778,0.5362343189964158,44.5199275362319,8274.385659548156,121.68214205217876,0
3706,32.39751893824083,5,5,185,0.02631578947368421,0.02631578947368421,0.9736842105263158,190,6100,4500,1600,0.7377049180327869,77,45,32,206.7642539183406,0.47605297967140076,0.7608328178100565,0.11997454627272405,1060759.7321651406,-234.56107845099132,1060525.1710866897,2838,0,366.10526315789474,79,111,35,38.81049754914434,0.5439144736842105,44.101562500000014,8290.474475172523,104.94271487560155,8
3707,32.87702103087773,1,2,184,0.005376344086021506,0.010752688172043012,0.989247311827957,186,5550,3700,1850,0.6666666666666666,74,37,37,205.981894309798,0.475096871064613,0.7564835365297491,0.120115389279469,1078028.5500164276,1660.8725704859808,1079689.4225869137,2839,0,374.747311827957,81,105,37,38.64025786662699,0.5460349462365591,43.915142276422785,8419.307253067433,103.94206485268435,0
3708,32.72451734321019,2,2,184,0.010752688172043012,0.010752688172043012,0.989247311827957,186,6550,4900,1650,0.7480916030534351,82,49,33,201.5652901656917,0.4747402644580064,0.7528687288376812,0.1182885805188984,1075019.0630602138,-412.6941241237828,1074606.36893609,2840,0,375.48924731182797,71,115,41,38.5110933942917,0.5484431003584229,43.67766203703702,8388.024794121124,118.1411942833961,0
3709,32.83878318652287,0,2,182,0.0,0.010869565217391304,0.9891304347826086,184,4800,3200,1600,0.6666666666666666,64,32,32,216.08117193716228,0.47446939098756635,0.762983042556659,0.12420110848084585,1072211.6127745737,4736.948370593304,1076948.561145167,2841,1,375.875,74,110,42,38.93655905212236,0.5449501811594203,44.45833333333336,8391.677386789426,113.40104576742468,8
3710,32.76778259809364,2,3,181,0.010869565217391304,0.016304347826086956,0.9836956521739131,184,5700,4000,1700,0.7017543859649122,74,40,34,212.51484288030062,0.4745281688049418,0.7590144403692882,0.12288575386216546,1071791.358512122,3054.3144309337017,1074845.6729430556,2842,0,376.5217391304348,79,105,44,38.79631632982068,0.5470448369565217,44.23177083333335,8380.957728832762,106.0880725168704,0
3711,32.99613133049448,3,5,179,0.016304347826086956,0.02717391304347826,0.9728260869565217,184,6250,4300,1950,0.688,82,43,39,200.8920450205008,0.4741037310921042,0.7534255281435565,0.11537367539347453,1077081.0485881483,225.4029007398085,1077306.4514888881,2843,0,376.6141304347826,75,109,41,39.35714157994494,0.5424026268115942,44.49013157894738,8430.837174658438,112.41116232877917,8
3712,32.81986621880643,0,2,177,0.0,0.0111731843575419,0.9888268156424581,179,6200,4500,1700,0.7258064516129032,79,45,34,232.88968219038105,0.47325314376582345,0.7758721725202169,0.1332128982128983,1070046.9456447295,7840.578619997942,1077887.5242647275,2844,1,387.9664804469274,69,110,33,38.695852758352764,0.5414338919925512,44.64285714285715,8380.787266588093,121.46068502301584,8
3713,33.27633511071627,0,2,175,0.0,0.011299435028248588,0.9887005649717514,177,5250,3600,1650,0.6857142857142857,69,36,33,228.28354243390592,0.47292709938366717,0.7758406983317698,0.13303886788072813,1090926.5042371454,9158.113384458797,1100084.6176216041,2845,2,393.2598870056497,71,106,37,38.092606456108626,0.5486111111111112,43.93807870370372,8520.802302149443,120.01130003027384,8
3714,33.11613128836753,3,2,176,0.016853932584269662,0.011235955056179775,0.9887640449438202,178,6100,4300,1800,0.7049180327868853,79,43,36,223.99243019678102,0.4730997005861317,0.7711696003061186,0.1315446453701098,1088111.8862383794,7045.765144907668,1095157.651383287,2846,0,390.2303370786517,62,116,41,37.908765479876145,0.5512055243445693,43.65079365079366,8489.293973129154,136.9240963407928,0
3715,32.73178020264771,2,1,177,0.011235955056179775,0.0056179775280898875,0.9943820224719101,178,5750,4600,1150,0.8,69,46,23,221.95355163357792,0.4730752343468969,0.7689518280202066,0.13164141683094976,1078566.4797450777,6528.332170469146,1085094.811915547,2847,0,388.4550561797753,66,112,42,37.58567001776485,0.5540730337078652,43.28358208955224,8402.785365455837,127.31492977963389,0
3716,32.90728747380591,1,3,175,0.0056179775280898875,0.016853932584269662,0.9831460674157303,178,5650,4300,1350,0.7610619469026548,70,43,27,221.19142102000473,0.4727300619987727,0.7629907347631462,0.12531521174650112,1069830.0734015894,6077.446837127027,1075907.5202387164,2848,0,388.6011235955056,76,102,36,39.36791518559782,0.5409644194756554,45.008116883116905,8391.091201214442,110.4090947528216,8
3717,32.425933566593,2,3,174,0.011299435028248588,0.01694915254237288,0.9830508474576272,177,5300,3700,1600,0.6981132075471698,69,37,32,221.6775431033858,0.4728776108543058,0.7632798541334562,0.1263554411784305,1056098.2675834135,6122.653846726816,1062220.9214301403,2849,0,391.0169491525424,67,110,40,39.11861282836168,0.543255649717514,44.776348039215705,8275.865183103684,123.52037586721917,0
3718,32.54630567874476,5,2,177,0.027932960893854747,0.0111731843575419,0.9888268156424581,179,5450,4000,1450,0.7339449541284404,69,40,29,210.03753204923134,0.4737513861862616,0.7556279092767615,0.1207083166114259,1062612.4914383322,3387.7010452785344,1066000.1924836107,2850,0,385.39106145251395,69,110,44,39.09707663638479,0.5461475791433892,44.46428571428572,8316.74346897926,120.5325140431777,8
3719,32.53100703113728,6,3,180,0.03278688524590164,0.01639344262295082,0.9836065573770492,183,5150,3600,1550,0.6990291262135923,67,36,31,202.96067072059816,0.4740011809683941,0.7518128697349773,0.11810400678266487,1066023.1620219336,1522.1551935331386,1067545.3172154666,2851,0,377.2568306010929,80,103,42,38.79843354933778,0.549408014571949,43.99434156378602,8328.121874599443,104.10152343249304,0
3720,32.19412997241205,1,2,179,0.0055248618784530384,0.011049723756906077,0.988950276243094,181,5550,3900,1650,0.7027027027027027,72,39,33,205.02610260140136,0.4735689073050951,0.7527815721056044,0.11967467348796954,1055938.0234363284,1548.9715067556144,1057486.994943084,2852,0,382.1160220994475,80,101,45,38.627443596438376,0.5512776243093922,43.878600823045275,8245.60561381893,103.07007017273664,0
3721,32.58789914151242,4,3,180,0.02185792349726776,0.01639344262295082,0.9836065573770492,183,6050,4200,1850,0.6942148760330579,79,42,37,227.034928960347,0.47384480273824536,0.7813616756713699,0.12617853890595823,1053307.7789716767,5177.531354443307,1058485.3103261201,2853,0,378.89617486338796,60,123,42,39.97554122730429,0.5269239526411658,45.74795081967215,8285.540135211417,138.09233558685693,8
3722,33.034274323772976,4,2,182,0.021739130434782608,0.010869565217391304,0.9891304347826086,184,6450,4500,1950,0.6976744186046512,84,45,39,222.37317054092026,0.47492971410469625,0.7780004621564944,0.12532828920347722,1072272.6150178523,4438.932217144691,1076711.547234997,2854,0,375.79347826086956,64,120,44,39.54245025892617,0.5301177536231885,45.208333333333336,8416.857812077991,131.5134033137186,0
3723,32.95034921613753,6,6,182,0.031914893617021274,0.031914893617021274,0.9680851063829787,188,6000,4200,1800,0.7,78,42,36,212.65640470550042,0.4758368652103007,0.7724232878255799,0.1210752294127301,1072812.6987185127,2028.0982863770032,1074840.7970048897,2855,0,368.6436170212766,73,115,42,39.39324985289791,0.533632535460993,44.819819819819834,8408.276049973869,115.18186369827218,0
3724,32.49509787498225,2,1,183,0.010869565217391304,0.005434782608695652,0.9945652173913043,184,6650,4600,2050,0.6917293233082706,87,46,41,217.48520788766072,0.4748418567355666,0.7736837874100437,0.12412802039701876,1058763.8559311037,2603.0954622235254,1061366.9513933272,2856,0,376.2391304347826,63,121,44,39.17474283771148,0.5354393115942029,44.72656250000001,8295.135336445679,131.66881486421713,0
3725,32.08099301910522,4,1,186,0.0213903743315508,0.0053475935828877,0.9946524064171123,187,5250,3500,1750,0.6666666666666666,70,35,35,209.92739762872012,0.4756255630306863,0.7693946795785636,0.12101825005270145,1048378.5941591515,1366.6780002973273,1049745.2721594488,2857,0,371.14973262032083,67,120,44,38.98057852477679,0.5382130124777184,44.34742647058823,8201.588426713333,122.41176756288557,0
3726,31.8147420851141,2,1,187,0.010638297872340425,0.005319148936170213,0.9946808510638298,188,6500,4600,1900,0.7076923076923077,84,46,38,208.35413641125973,0.47567034550764214,0.7689054202061794,0.12130030207341382,1042697.2880867744,-649.9414004636228,1042047.3466863108,2858,0,370.1276595744681,68,120,41,38.64209269414468,0.5408909574468085,43.976449275362306,8145.323234019451,119.7841652061684,0
3727,31.781045932802535,0,7,180,0.0,0.0374331550802139,0.9625668449197861,187,6650,4800,1850,0.7218045112781954,85,48,37,209.59700209451614,0.4754937898913231,0.7697298311363072,0.12261745107241827,1043072.758240332,-325.0153812738822,1042747.7428590581,2859,1,372.1336898395722,69,118,41,38.42465537937309,0.5426693404634582,43.79464285714284,8142.474223587187,118.00687280561141,0
3728,32.12142151666219,1,1,180,0.0055248618784530384,0.0055248618784530384,0.994475138121547,181,5900,4100,1800,0.6949152542372882,77,41,36,218.52354322317598,0.4742339369756497,0.7675123965909882,0.12445525401594634,1045923.4961152833,3611.781662296785,1049535.27777758,2860,0,384.43093922651934,64,117,42,39.231139579670064,0.5317104051565378,44.807692307692314,8197.139683194384,128.08030754991225,8
3729,32.328866544342674,3,3,180,0.01639344262295082,0.01639344262295082,0.9836065573770492,183,5350,3700,1650,0.6915887850467289,70,37,33,249.49154191556366,0.474818100842691,0.7932425842269675,0.1368271417786325,1040681.2428472496,9978.233584113104,1050659.4764313628,2861,0,378.76502732240436,64,119,41,39.9355775911072,0.5163365209471766,46.26602564102564,8202.931794816948,128.17080929401482,8
3730,32.323161548539396,10,5,185,0.05263157894736842,0.02631578947368421,0.9736842105263158,190,6650,5000,1650,0.7518796992481203,83,50,33,228.85774443539384,0.4767572867353569,0.7869411256997945,0.1266327221074145,1043346.0805047557,3105.5661299651424,1046451.6466347208,2862,0,363.2736842105263,72,118,35,40.104108165786805,0.5224232456140351,45.918949771689476,8212.702832952182,114.06531712433586,8
3731,31.961185662622604,0,1,184,0.0,0.005405405405405406,0.9945945945945946,185,5750,3600,2150,0.6260869565217392,79,36,43,235.29069267345457,0.4761224539757149,0.7893465564667512,0.1302261640377147,1031744.3011068148,5801.966253862191,1037546.2673606769,2863,1,374.05405405405406,68,117,38,39.930287366565665,0.5227477477477478,45.90881642512076,8121.055493472213,119.42728666870902,0
3732,32.29789917164417,2,1,185,0.010752688172043012,0.005376344086021506,0.9946236559139785,186,6850,4900,1950,0.7153284671532847,88,49,39,235.64053217549144,0.4764893926184249,0.7910098286572311,0.13130810799678047,1044775.9279935574,5188.311135308886,1049964.2391288662,2864,0,372.994623655914,60,126,36,39.65186863600762,0.525649641577061,45.64549180327868,8215.116259590832,136.91860432651387,0
3733,32.306806939389865,6,4,187,0.031413612565445025,0.020942408376963352,0.9790575916230366,191,7550,5500,2050,0.7284768211920529,96,55,41,229.92969628149928,0.4774180214935244,0.7890191381346467,0.13024282134821427,1050252.4713997748,2546.846353568739,1052799.3177533436,2865,0,364.1047120418848,69,122,36,39.15201585448883,0.5298865619546248,45.01488095238094,8237.75501348875,119.38775381867754,0
3734,32.32530459005823,2,3,186,0.010582010582010581,0.015873015873015872,0.9841269841269842,189,6200,4900,1300,0.7903225806451613,75,49,26,233.39447016518628,0.47747687530488947,0.7921917852186007,0.1329300955519445,1052575.0990655376,5133.04151109392,1057708.1405766315,2866,0,359.7195767195767,71,118,40,38.85005055086267,0.5327932098765432,44.80613425925926,8249.219439583872,116.1861892899137,0
3735,32.76296580439883,1,1,186,0.0053475935828877,0.0053475935828877,0.9946524064171123,187,7400,5600,1800,0.7567567567567568,92,56,36,230.17788891624747,0.47719246545147875,0.7860189277450282,0.13180249817560905,1068531.3519370197,4390.458165937329,1072921.810102957,2867,0,364.4117647058824,65,122,41,38.72358175750832,0.5345922459893049,44.60227272727272,8367.58700515753,128.73210777165428,0
3736,32.89433804208098,3,3,186,0.015873015873015872,0.015873015873015872,0.9841269841269842,189,5300,3700,1600,0.6981132075471698,69,37,32,219.15278902451377,0.47727986978873504,0.7779036544476148,0.12589220858503627,1073837.338715814,3966.889547646491,1077804.2282634606,2868,0,361.1798941798942,66,123,39,38.88094513740996,0.5352733686067019,44.48072139303483,8405.13752676619,127.35056858736651,7
3737,32.38918992021451,0,2,184,0.0,0.010752688172043012,0.989247311827957,186,6150,4700,1450,0.7642276422764228,76,47,29,221.0503813406057,0.47715053763440857,0.7764785581137843,0.12751053332372314,1058646.9067564062,3452.8604887113875,1062099.7672451176,2869,1,366.18817204301075,68,118,41,38.67193650606206,0.5369623655913979,44.323671497584556,8281.14916196792,121.78160532305765,0
3738,32.693017061414594,3,2,185,0.016042780748663103,0.0106951871657754,0.9893048128342246,187,6500,4800,1700,0.7384615384615385,82,48,34,214.06543450539652,0.47673724915186017,0.7701262201424528,0.12438262710473964,1070869.2189955409,1947.2169325472446,1072816.4359280881,2870,0,365.1818181818182,72,115,40,38.57064540707291,0.539605614973262,44.04965753424659,8367.788913107823,116.21929045983087,0
3739,32.63133889132215,1,0,186,0.005376344086021506,0.0,1.0,186,5100,3800,1300,0.7450980392156863,64,38,26,199.47345799336014,0.4766401482127289,0.7540699414409888,0.11574407646718401,1068415.4662748491,324.1055262866348,1068739.5718011358,2871,0,368.13978494623655,79,107,36,38.997067877677694,0.545866935483871,44.101562500000014,8350.308635822359,105.70010931420708,8
3740,32.50731598182052,0,0,186,0.0,0.0,1.0,186,5450,3800,1650,0.6972477064220184,71,38,33,200.41260624666685,0.47663651554780584,0.7548631003748287,0.11665223990591984,1065329.7633244027,51.10287599780986,1065380.8662004005,2872,1,369.13978494623655,79,107,37,38.85349913538805,0.5469870071684588,43.98437500000001,8322.380818158288,105.34659263491504,0
3741,32.4264035734576,2,4,184,0.010638297872340425,0.02127659574468085,0.9787234042553191,188,5950,4400,1550,0.7394957983193278,75,44,31,195.36507670667507,0.47664575985132934,0.753959659916724,0.11237614180930115,1058977.2876068444,-2172.56419521224,1056804.7234116322,2873,0,366.20212765957444,74,114,42,39.4376211437784,0.5429964539007093,44.43055555555557,8287.197946599947,111.98916144053982,7
3742,32.74824871494835,2,0,186,0.010752688172043012,0.0,1.0,186,6750,5100,1650,0.7555555555555555,84,51,33,209.50111223363982,0.4759396493267461,0.7649525462050113,0.1206844435261394,1069953.0846260341,881.2722533937249,1070834.3568794278,2874,0,370.2043010752688,69,117,36,39.0196278185276,0.5417786738351255,44.375000000000014,8371.271077758702,121.32276924287973,7
3743,33.00046882525494,1,2,185,0.0053475935828877,0.0106951871657754,0.9893048128342246,187,5450,4000,1450,0.7339449541284404,69,40,29,194.9882616925482,0.4758879113717824,0.7435622847160275,0.11174050568580389,1076529.3309190185,-867.8834206114998,1075661.447498407,2875,0,369.2192513368984,75,112,42,39.59182943407025,0.5408868092691622,44.572368421052644,8429.231593029792,112.38975457373056,8
3744,32.80840179330533,3,3,185,0.015957446808510637,0.015957446808510637,0.9840425531914894,188,6550,5000,1550,0.7633587786259542,81,50,31,206.540146272636,0.4762184975537604,0.757854987212556,0.11991437927028484,1074396.9102239222,231.21899850383124,1074628.129222426,2876,0,367.1436170212766,78,110,37,38.79385851924368,0.5442708333333333,44.079641350211,8396.33795366915,107.64535838037372,0
3745,32.78471212557606,7,1,191,0.036458333333333336,0.005208333333333333,0.9947916666666666,192,4600,3000,1600,0.6521739130434783,62,30,32,199.39171643664372,0.47691358529668415,0.7545801926298168,0.11721626171162322,1077540.465129153,-29.471425591776097,1077510.9937035614,2877,0,359.96875,75,117,42,38.50079297195199,0.5477430555555556,43.612938596491226,8405.576000836418,112.07434667781891,0
3746,32.28292004608259,2,2,191,0.010362694300518135,0.010362694300518135,0.9896373056994818,193,5750,4200,1550,0.7304347826086957,73,42,31,196.7026480013489,0.47678738485895217,0.7539364780297424,0.1165084915084916,1063363.516406801,-2516.716106951121,1060846.8002998498,2878,0,359.0621761658031,79,114,44,38.28463203463205,0.549924438687392,43.33333333333334,8285.949478494555,104.88543643663994,0
3747,32.36789528299471,0,2,189,0.0,0.010471204188481676,0.9895287958115183,191,6650,4900,1750,0.7368421052631579,84,49,35,218.8481271354015,0.47632841921557817,0.7818549727593866,0.12946950094168044,1065791.6564146578,1799.3015845768077,1067590.9579992346,2879,1,363.6282722513089,69,122,39,37.76185126123512,0.5508835078534031,43.377976190476176,8306.314793976804,120.38137382575079,8
3748,32.80242988395567,0,2,187,0.0,0.010582010582010581,0.9894179894179894,189,5800,3800,2000,0.6551724137931034,78,38,40,207.39485987104973,0.47595125520657433,0.7677671367871086,0.12166788373361523,1077470.7958188509,1092.380942799512,1078563.1767616505,2880,2,368.33862433862436,69,120,41,38.374748413066996,0.5480599647266313,43.69047619047617,8407.575183351924,121.84891570075253,8
3749,33.04874570462803,2,2,187,0.010582010582010581,0.010582010582010581,0.9894179894179894,189,6500,5100,1400,0.7846153846153846,79,51,28,209.58772029976768,0.4757331419565462,0.7703114278243526,0.12422647448014851,1088806.8463075222,1340.108952874446,1090146.9552603967,2881,0,368.8095238095238,72,117,42,37.92769192284173,0.5505401234567902,43.30764840182647,8483.360252290971,117.82444794848571,0
3750,32.60596611983918,2,4,185,0.010582010582010581,0.021164021164021163,0.9788359788359788,189,6550,4400,2150,0.6717557251908397,87,44,43,206.7697397699638,0.47595477316221996,0.7671183269793354,0.12342502945288153,1076405.7974882857,163.62932670659393,1076569.4268149922,2882,0,369.36507936507934,76,113,39,37.73351672457965,0.5527998236331569,43.04653679653679,8378.215915587456,110.23968309983495,0
3751,32.82503783697491,2,1,186,0.0106951871657754,0.0053475935828877,0.9946524064171123,187,6000,4300,1700,0.7166666666666667,77,43,34,229.94877259511435,0.47552853008260976,0.7879751248109517,0.13417167004346908,1076512.743106394,6108.556792062934,1082621.299898457,2883,0,374.048128342246,72,115,38,38.00353799866281,0.5412767379679144,43.89269406392694,8406.7320076773,116.76016677329582,8
3752,33.029546167303,2,1,187,0.010638297872340425,0.005319148936170213,0.9946808510638298,188,5500,3600,1900,0.6545454545454545,74,36,38,225.43850844041293,0.475513899950696,0.7853286052009449,0.13238838582910176,1085253.7944749484,5831.599341146193,1091085.3938160946,2884,0,373.0159574468085,63,125,43,37.873280423280406,0.5434397163120568,43.65234375000001,8467.046746989312,134.39756741252876,0
3753,32.65924048320546,2,1,188,0.010582010582010581,0.005291005291005291,0.9947089947089947,189,6100,4400,1700,0.7213114754098361,78,44,34,229.70812606393415,0.47566512814739764,0.7905583462269425,0.1335534084512936,1069954.8323119069,5255.463900683862,1075210.2962125908,2885,0,371.9312169312169,63,126,40,38.14677783429774,0.5354387125220459,44.026692708333336,8359.893800119993,132.69672698603165,8
3754,33.12004446683347,2,1,189,0.010526315789473684,0.005263157894736842,0.9947368421052631,190,6550,4600,1950,0.7022900763358778,85,46,39,217.3517540045708,0.4757785667873387,0.77576891353981,0.12253518218721202,1075154.3346049758,2187.3360904017804,1077341.6706953775,2886,0,370.83684210526314,71,119,40,39.658566129154345,0.525109649122807,45.19675925925926,8439.09466362661,118.8604882200931,7
3755,33.45862678322658,6,3,192,0.03076923076923077,0.015384615384615385,0.9846153846153847,195,6950,5200,1750,0.7482014388489209,87,52,35,207.3699039365645,0.477021103180897,0.7690203117953438,0.11828923241601184,1089977.684107948,-744.2864707069853,1089233.397637241,2887,0,355.2,70,125,43,39.454487105797604,0.5295940170940171,44.74765258215964,8540.393027796039,122.00561468280056,0
3756,33.790682695830185,3,0,195,0.015384615384615385,0.0,1.0,195,6750,5200,1550,0.7703703703703704,83,52,31,216.33894413589007,0.4770078861573707,0.7768523845094886,0.12480235676197382,1104479.9814034922,2038.4065992120914,1106518.3880027044,2888,0,356.07179487179485,72,123,37,38.78943892547531,0.532051282051282,44.32077625570779,8639.57552145962,119.99410446471694,0
3757,34.055183384636585,1,3,193,0.00510204081632653,0.015306122448979591,0.9846938775510204,196,4500,2800,1700,0.6222222222222222,62,28,34,217.42682702379017,0.47713893249607536,0.7878370602553766,0.12403682798785753,1109440.622198628,4544.430851189487,1113985.0530498174,2889,0,355.25,65,131,42,39.19437488406606,0.5266794217687074,44.74431818181819,8692.779054288638,133.73506237367135,8
3758,34.3302114652575,0,2,191,0.0,0.010362694300518135,0.9896373056994818,193,5850,4000,1850,0.6837606837606838,77,40,37,215.1052053037189,0.47651864745250433,0.7824405100789766,0.12316253773176031,1119620.7165854543,3717.24882068241,1123337.9654061368,2890,1,361.6269430051814,66,127,39,39.111422251983534,0.527903713298791,44.605099502487576,8767.76094122803,132.84486274587925,0
3759,34.44431175533913,3,0,194,0.015463917525773196,0.0,1.0,194,6050,4700,1350,0.7768595041322314,74,47,27,210.02044305455667,0.4767835363139434,0.777567502755423,0.12099286626445978,1125392.4526108417,2421.084301516977,1127813.5369123586,2891,0,359.9381443298969,71,123,43,39.003398136095235,0.5304445876288659,44.3721064814815,8804.926857712535,124.01305433397937,0
3760,34.28463117383629,6,4,196,0.03,0.02,0.98,200,6100,4200,1900,0.6885245901639344,80,42,38,207.03065261003897,0.47773188860971527,0.779555074805816,0.12104446842482185,1125047.5241289933,483.86462754710647,1125531.3887565404,2892,0,350.11,77,123,41,38.5129954473579,0.53453125,43.81677350427353,8783.14743332941,114.06684978349882,0
3761,34.00521483309657,1,4,193,0.005076142131979695,0.02030456852791878,0.9796954314720813,197,5850,4100,1750,0.7008547008547008,76,41,35,222.5715546600905,0.4774217428087986,0.7926050722523694,0.12909150170285233,1113258.957922611,4305.955400821515,1117564.9133234324,2893,0,356.3756345177665,67,130,43,38.42243374840361,0.5364847715736041,44.11764705882353,8701.334383762936,129.87066244422294,8
3762,33.75043471267657,1,1,193,0.005154639175257732,0.005154639175257732,0.9948453608247423,194,5850,3900,1950,0.6666666666666666,78,39,39,216.22657697538412,0.47724814379573743,0.7840310404393012,0.12624463510516618,1107065.9771947404,3225.4173469453026,1110291.3945416857,2894,0,362.4896907216495,69,125,41,38.33081570996978,0.5382302405498282,43.869047619047606,8644.530986228974,125.28305777143441,0
3763,33.32936748613509,1,3,191,0.005154639175257732,0.015463917525773196,0.9845360824742269,194,6500,4800,1700,0.7384615384615385,82,48,34,230.93885619947082,0.47722978206292394,0.7944198949475341,0.13516234921359477,1094030.4018167036,5230.825928599781,1099261.2277453034,2895,0,363.2938144329897,73,121,38,37.86099512874043,0.5376396048109966,43.77815315315318,8539.712091534846,116.98235741828556,8
3764,32.7831296592367,3,1,193,0.015463917525773196,0.005154639175257732,0.9948453608247423,194,5850,4500,1350,0.7692307692307693,72,45,27,230.4937695815567,0.47735275003115935,0.7942929395813889,0.13628666199296285,1079298.5695581918,5104.319160289646,1084402.8887184814,2896,0,363.87628865979383,67,127,41,37.4831477722723,0.5404853951890034,43.39767156862743,8412.227403827681,125.55563289295046,0
3765,33.07999326857569,2,0,195,0.010256410256410256,0.0,1.0,195,6800,4900,1900,0.7205882352941176,87,49,38,229.17351705004035,0.4773449202572914,0.793335982758794,0.13646551374190374,1091290.8009584078,4218.990195998387,1095509.7911544063,2897,0,362.8871794871795,72,123,43,37.24978241949518,0.5431089743589743,43.13641552511413,8497.04564537139,118.01452285238042,0
3766,33.51467715086099,1,1,195,0.00510204081632653,0.00510204081632653,0.9948979591836735,196,6950,4900,2050,0.7050359712230215,90,49,41,226.43914967526334,0.4773700505843363,0.7921499906953686,0.13545178226029286,1107074.6366840554,3987.007871557344,1111061.6445556127,2898,0,362.03061224489795,75,121,34,37.14855623100305,0.5449617346938775,42.96874999999997,8614.319361432164,114.8575914857622,0
3767,33.012336239728796,0,2,193,0.0,0.010256410256410256,0.9897435897435898,195,7100,4900,2200,0.6901408450704225,93,49,44,238.20431987282592,0.4771730989514495,0.7958967460817041,0.13356509978538483,1069904.8296058578,4871.190452982789,1074776.0200588407,2899,1,364.8820512820513,72,123,33,39.34069424205061,0.525,45.4052511415525,8404.767454184343,116.73288130811586,8
3768,32.83155428522345,3,1,195,0.015306122448979591,0.00510204081632653,0.9948979591836735,196,6450,5100,1350,0.7906976744186046,78,51,27,202.78813917985983,0.4774861547182976,0.7689257180126243,0.11656041776851825,1071975.5835685958,-2173.2132323757173,1069802.3703362201,2900,0,362.5765306122449,74,122,41,39.276251426707994,0.5344919217687074,44.458333333333364,8389.830101303212,113.37608245004341,8
3769,33.20039898894832,1,1,195,0.00510204081632653,0.00510204081632653,0.9948979591836735,196,7100,4700,2400,0.6619718309859155,95,47,48,202.9292920026625,0.47736841531484386,0.7677497965478324,0.11674221247149433,1084295.7358406612,-2292.926800869463,1082002.8090397918,2901,0,363.4183673469388,73,123,47,39.239324006756306,0.5373618197278911,44.4256756756757,8485.169538898499,116.23519916299314,8
3770,33.46173701885543,1,4,192,0.00510204081632653,0.02040816326530612,0.9795918367346939,196,5400,3400,2000,0.6296296296296297,74,34,40,224.2143722046344,0.47725994243851383,0.7845655714827275,0.12757563408019687,1089258.3743783426,4245.476515975715,1093503.8508943184,2902,0,364.40816326530614,79,117,35,39.12278015921614,0.5345450680272108,44.84374999999997,8537.971336217259,108.07558653439568,8
3771,33.6382763287044,1,2,191,0.0051813471502590676,0.010362694300518135,0.9896373056994818,193,6150,4400,1750,0.7154471544715447,79,44,35,219.97103225316943,0.47655125575705237,0.7820154500979184,0.12723397073694998,1100357.6839813862,3659.363118618716,1104017.047100005,2903,0,370.7461139896373,72,121,39,38.59449093444912,0.5383743523316062,44.22089041095892,8603.96836746617,119.49956065925237,7
3772,33.385105609260215,5,3,193,0.025510204081632654,0.015306122448979591,0.9846938775510204,196,5400,3800,1600,0.7037037037037037,70,38,32,221.67628307017637,0.4765033577533577,0.7909663474377815,0.12951485792168907,1095301.2364983675,3960.461389825281,1099261.6978881927,2904,0,365.2755102040816,77,119,37,38.165100446622546,0.5419855442176871,43.84348290598291,8551.812375684038,111.06249838550698,8
3773,33.499779022189635,2,0,195,0.010256410256410256,0.0,1.0,195,5700,4100,1600,0.7192982456140351,73,41,32,217.4845675338921,0.47633271653890213,0.7869479021926042,0.12787708915746973,1101104.2630069202,3194.6368899572076,1104298.8998968774,2905,0,368.0615384615385,64,131,40,38.02959039106613,0.5441239316239317,43.60576923076925,8589.150073333562,134.2054698958369,0
3774,32.97790325981656,1,4,192,0.00510204081632653,0.02040816326530612,0.9795918367346939,196,5850,4000,1850,0.6837606837606838,77,40,37,215.64818053142025,0.47634310134310137,0.7858868852006295,0.1274912043301761,1085667.7701915973,1774.4558606845922,1087442.226052282,2906,0,367.17857142857144,65,131,41,37.86930536761392,0.5461309523809523,43.4027777777778,8462.03837118214,130.18520571049444,0
3775,32.90304186471585,2,3,191,0.010309278350515464,0.015463917525773196,0.9845360824742269,194,7050,5500,1550,0.7801418439716312,86,55,31,213.92889434080027,0.4759361145237968,0.7822666145176085,0.1271739001677016,1084928.3735428678,569.5054781977751,1085497.8790210655,2907,0,365.9587628865979,67,127,44,37.704803944961455,0.5495060137457044,43.19852941176472,8449.549537685327,126.11267966694518,0
3776,32.63679077350221,0,2,189,0.0,0.010471204188481676,0.9895287958115183,191,6500,4500,2000,0.6923076923076923,85,45,40,228.2258593950495,0.4754707449251401,0.7836115502313237,0.1341849108169589,1072720.4151988577,4264.507729874637,1076984.9229287324,2908,1,372.5026178010471,65,126,39,37.75642505386274,0.5441208551483421,43.60795454545454,8367.813543490258,128.7355929767732,8
3777,32.45122575938461,0,3,186,0.0,0.015873015873015872,0.9841269841269842,189,6250,4400,1850,0.704,81,44,37,242.1092304939284,0.47489352320912603,0.7874710749622107,0.13576336201236355,1051740.0984697884,6877.197184025261,1058617.2956538138,2909,2,377.4179894179894,74,115,36,39.2387440219664,0.5279431216931216,45.40277777777774,8261.99193604547,111.64853967629013,8
3778,32.74864195452727,4,2,188,0.021052631578947368,0.010526315789473684,0.9894736842105263,190,6100,4700,1400,0.7704918032786885,75,47,28,241.65718251828847,0.4757483987747146,0.790109902076354,0.1366469233584683,1064057.635793678,7327.434060593741,1071385.0698542718,2910,0,373.88947368421054,78,112,36,38.92146847359438,0.530921052631579,45.08175105485229,8348.226462379613,107.02854438948222,0
3779,33.21109946153642,1,3,186,0.005291005291005291,0.015873015873015872,0.9841269841269842,189,5350,3800,1550,0.7102803738317757,69,38,31,243.85152806850303,0.4760134057563135,0.7907784193138387,0.138471086723124,1080451.2179132323,9543.936098322909,1089995.1540115552,2911,0,376.5978835978836,80,109,38,38.70010923451809,0.5326278659611994,44.92026748971191,8471.478367021218,105.89347958776523,0
3780,32.95609261269525,2,1,187,0.010638297872340425,0.005319148936170213,0.9946808510638298,188,5750,3700,2050,0.6434782608695652,78,37,41,228.0739119957318,0.47577760552963927,0.7840179608727738,0.12917323819351903,1071314.1588609705,5517.762237567514,1076831.921098538,2912,0,378.3244680851064,81,107,35,39.20490401222265,0.5344082446808511,45.02032520325202,8403.133776956516,103.74239230810514,8
3781,33.28259799469587,2,1,188,0.010582010582010581,0.005291005291005291,0.9947089947089947,189,6300,4700,1600,0.746031746031746,79,47,32,231.106138754679,0.4757413505197193,0.7837999943263112,0.1271570741769417,1072456.2310296823,5470.243707332923,1077926.4747370153,2913,0,377.30687830687833,74,115,31,40.272002772002764,0.5196759259259259,46.13888888888887,8449.15730759789,114.17780145402554,8
3782,33.18896119172806,3,1,190,0.015706806282722512,0.005235602094240838,0.9947643979057592,191,6150,4100,2050,0.6666666666666666,82,41,41,248.84104143823723,0.47648456875172224,0.8084496213025272,0.135185430975694,1065242.7463636622,8665.222877932216,1073907.9692415944,2914,0,374.3350785340314,56,135,38,40.33272624543185,0.512598167539267,46.637426900584785,8408.840606032833,150.157867964872,8
3783,32.77980727206817,8,8,190,0.04040404040404041,0.04040404040404041,0.9595959595959596,198,5650,4300,1350,0.7610619469026548,70,43,27,236.7019531590509,0.4784472260677844,0.804619782969787,0.13088943112336807,1057878.8905853163,4830.399921454824,1062709.290506771,2915,0,361.7979797979798,65,133,36,39.930253566917244,0.5173085016835017,45.943813131313135,8327.912841832098,128.12173602818612,0
3784,32.97964931046477,1,0,191,0.005235602094240838,0.0,1.0,191,6350,4300,2050,0.6771653543307087,84,43,41,244.0514458621005,0.4775431707541104,0.8043726801807225,0.13552562637026402,1065705.805891332,7467.408558282868,1073173.2144496148,2916,0,375.84293193717275,57,134,39,39.575164841634276,0.518760907504363,45.7794540229885,8384.104453836717,147.08955182169677,0
3785,33.17826923925521,5,2,194,0.025510204081632654,0.01020408163265306,0.9897959183673469,196,5700,3700,2000,0.6491228070175439,77,37,40,235.13903935374182,0.478417168149311,0.8000491962076965,0.12779018746733156,1065025.2677610463,5185.803669758896,1070211.0714308051,2917,0,367.2295918367347,65,131,38,40.664579959304014,0.5135522959183674,46.62247474747475,8406.627752004471,129.33273464622263,8
3786,33.199744614133614,6,4,196,0.03,0.02,0.98,200,5050,2500,2550,0.49504950495049505,76,25,51,223.94061905235347,0.47939332077051927,0.7919466348798834,0.12473423857941612,1073806.8760615005,3043.7953135772614,1076850.6713750777,2918,0,357.905,66,134,39,39.96665953501643,0.5215104166666666,45.66231343283582,8443.946239779414,127.93857939059718,8
3787,33.38036518830348,7,7,196,0.034482758620689655,0.034482758620689655,0.9655172413793104,203,5650,3600,2050,0.6371681415929203,77,36,41,188.02213286466028,0.4795964818156693,0.7557541031368358,0.10761889394704903,1088532.666459056,-5316.353271902428,1083216.3131871535,2919,0,353.35960591133005,77,126,43,39.816309766598714,0.5355603448275862,44.618055555555564,8524.742568054608,110.71094244226764,8
3788,33.22767791292245,2,4,194,0.010101010101010102,0.020202020202020204,0.9797979797979798,198,5300,3600,1700,0.6792452830188679,70,36,34,210.0306544465721,0.4789167051222889,0.765838601641577,0.1184926473961898,1078881.1126076484,419.62123020562103,1079300.733837854,2920,0,357.80808080808083,79,119,44,39.81704435133612,0.5306186868686869,45.1692708333333,8467.433391065086,107.1827011527226,8
3789,33.303349551620194,2,1,195,0.01020408163265306,0.00510204081632653,0.9948979591836735,196,7000,5000,2000,0.7142857142857143,90,50,40,217.95978285870066,0.4785272762951334,0.7791825737223288,0.11946403288331359,1071855.6468344443,524.2848079816431,1072379.931642426,2921,0,362.3826530612245,79,117,41,40.75918441536224,0.5214179421768708,46.289062500000014,8449.4240366318,106.95473464090887,8
3790,33.37843509628353,3,0,198,0.015151515151515152,0.0,1.0,198,5800,3800,2000,0.6551724137931034,78,38,40,232.43767114656802,0.47883391871336034,0.7927429856287063,0.1288149711324444,1077924.6447414993,4710.058819041473,1082634.703560541,2922,0,359.6969696969697,83,115,43,39.95092059464557,0.5242529461279462,45.85813492063494,8482.857748800088,102.20310540722998,0
3791,33.62107772184824,6,0,204,0.029411764705882353,0.0,1.0,204,5800,3800,2000,0.6551724137931034,78,38,40,218.8634183480403,0.4794282655590972,0.78534671427107,0.1226471563456083,1089436.9039353603,1087.5769739594743,1090524.4809093198,2923,0,350.0882352941176,71,133,47,39.85659619610521,0.5274714052287581,45.428240740740726,8558.976903843157,120.54897047666418,0
3792,33.42141522189635,3,6,201,0.014492753623188406,0.028985507246376812,0.9710144927536232,207,5850,4300,1550,0.7350427350427351,74,43,31,217.40971779336763,0.479815479261448,0.7901749769956297,0.12174944196428578,1082743.3691721787,-170.213933127372,1082573.1552390512,2924,0,346.0,76,131,42,39.9204799107143,0.5257648953301127,45.45454545454545,8507.269329209974,111.93775433171018,8
3793,33.33578443452319,1,4,198,0.0049504950495049506,0.019801980198019802,0.9801980198019802,202,6700,4500,2200,0.6716417910447762,89,45,44,218.73245691590796,0.4789814335911203,0.787620240201784,0.12326771674309417,1082036.470698053,235.29914168052437,1082271.7698397336,2925,0,355.06435643564356,76,126,43,39.6379774167286,0.5281043729372937,45.21103896103896,8493.589881490929,111.75776159856485,0
3794,33.75432543022702,5,7,196,0.024630541871921183,0.034482758620689655,0.9655172413793104,203,8250,6300,1950,0.7636363636363637,102,63,39,214.11959908956715,0.4796726901754215,0.782329522131489,0.12260309058476015,1100852.2160000233,-1707.1929706423398,1099145.023029381,2926,0,353.92118226600985,71,132,40,39.135050227534514,0.5334051724137931,44.60358796296299,8620.733605610561,121.41878317761355,8
3795,34.12888800748022,3,2,197,0.01507537688442211,0.010050251256281407,0.9899497487437185,199,6250,4500,1750,0.72,80,45,35,223.51408640447232,0.4790217924640035,0.7948008919201079,0.12656605793378514,1109373.73822016,3542.1315158787925,1112915.8697360386,2927,0,361.4572864321608,74,125,42,39.32878944692595,0.5286850921273032,45.027777777777786,8701.918417240604,117.59349212487302,8
3796,34.02904338014036,4,1,200,0.01990049751243781,0.004975124378109453,0.9950248756218906,201,5700,3600,2100,0.631578947368421,78,36,42,236.46892527746576,0.47909100331674953,0.8034886132895374,0.13507835258202233,1109026.0618254081,6550.040188910993,1115576.102014319,2928,0,357.55721393034827,63,138,39,38.65681711929959,0.5285033167495854,44.69401041666667,8687.818594740926,137.90188245620516,8
3797,34.275420851995364,3,3,200,0.014778325123152709,0.014778325123152709,0.9852216748768473,203,6450,5000,1450,0.7751937984496124,79,50,29,227.31927971846062,0.47936176006763237,0.7964070275933204,0.13064011617554933,1119066.8061113367,3827.0920644135867,1122893.8981757502,2929,0,354.9802955665025,69,134,42,38.65546626290859,0.5307881773399015,44.46428571428572,8758.594149858121,126.93614709939307,0
3798,34.07180086576339,4,3,201,0.0196078431372549,0.014705882352941176,0.9852941176470589,204,6150,4600,1550,0.7479674796747967,77,46,31,195.28257290494994,0.47967125068418176,0.7725044563279848,0.11170163170163198,1110864.5661734694,-3563.501873740475,1107301.064299729,2930,0,352.80882352941177,69,135,44,39.65617715617718,0.5321180555555556,44.64285714285717,8700.477721078922,126.09388001563654,8
3799,34.160883242592476,3,6,198,0.014705882352941176,0.029411764705882353,0.9705882352941176,204,6200,3900,2300,0.6290322580645161,85,39,46,216.72971616289027,0.47993184342702594,0.7939438046317759,0.1225744126532651,1110006.0693428367,1114.2600695513092,1111120.3294123881,2931,0,352.54411764705884,80,124,38,39.5495972691654,0.5287479575163399,45.07458847736623,8708.477218594458,108.85596523243073,8
3800,34.315198268009375,1,4,195,0.005025125628140704,0.020100502512562814,0.9798994974874372,199,6000,4600,1400,0.7666666666666667,74,46,28,216.04538023206078,0.4790651489772093,0.7894732627279835,0.12268640370644113,1116384.4097443481,2437.938857672176,1118822.3486020204,2932,0,362.16582914572865,81,118,41,39.40778552456837,0.5302030988274706,44.91869918699185,8753.165411860067,108.06377051679095,0
3801,34.11755373745462,2,1,196,0.01015228426395939,0.005076142131979695,0.9949238578680203,197,6350,4300,2050,0.6771653543307087,84,43,41,210.62731014047841,0.4792573120618806,0.7810063328914425,0.12040140321744065,1112143.4358775003,1099.5560778534164,1113242.9919553536,2933,0,365.2994923857868,66,131,44,39.28928433700706,0.5330478003384095,44.66728855721392,8711.327503579227,131.9898106602913,0
3802,33.864835704611075,4,5,195,0.02,0.025,0.975,200,6900,5400,1500,0.782608695652174,84,54,30,207.09568699882595,0.47977858040201005,0.7796693078023538,0.1199412688182496,1108189.725196206,-999.7375070901262,1107189.9876891158,2934,0,360.66,73,127,45,38.874215912842494,0.5363020833333334,44.172297297297305,8663.56312071514,118.6789468591115,0
3803,33.95933518547348,3,2,196,0.015151515151515152,0.010101010101010102,0.98989898989899,198,6300,4700,1600,0.746031746031746,79,47,32,237.49570357005723,0.4796265318156181,0.8014942909367806,0.1368451764754253,1109603.9935350213,6805.236225748901,1116409.2297607702,2935,0,364.37373737373736,65,133,40,38.29432147928628,0.5358270202020202,44.36553030303029,8681.176641400129,133.55656371384813,8
3804,33.535853414020025,1,3,194,0.005076142131979695,0.015228426395939087,0.9847715736040609,197,6800,5300,1500,0.7794117647058824,83,53,30,233.83537447961936,0.47954327670154356,0.7964908317556842,0.13526366506685486,1097032.1140811988,5104.983042468975,1102137.0971236678,2780,0,352.0253807106599,68,129,42,38.23690708060362,0.538335448392555,44.217995169082116,8577.867819953799,126.14511499932057,0
3805,33.334432506220445,1,1,194,0.005128205128205128,0.005128205128205128,0.9948717948717949,195,6300,4200,2100,0.6666666666666666,84,42,42,254.8111899940737,0.47933408229799984,0.8050363262042095,0.1447377797382982,1084560.6404529575,9971.637482910655,1094532.2779358681,2781,0,355.8205128205128,79,116,37,38.40884632399231,0.530715811965812,44.90885416666667,8503.3185837157,107.63694409766708,8
3806,33.6549679226968,2,4,192,0.01020408163265306,0.02040816326530612,0.9795918367346939,196,5150,3500,1650,0.6796116504854369,68,35,33,253.23802300219188,0.4792582417582418,0.8065096417074147,0.14465166527242507,1096821.818799744,11201.397795703364,1108023.2165954472,2782,0,354.9744897959184,64,132,40,38.230232460820645,0.532312925170068,44.69551282051284,8592.264326546234,134.2541301022849,0
3807,33.73126307686511,3,1,194,0.015384615384615385,0.005128205128205128,0.9948717948717949,195,5350,3600,1750,0.6728971962616822,71,36,35,242.68575035978716,0.4794343113930743,0.7975406582320792,0.14002103971396504,1102583.5060024105,9166.261097704195,1111749.7671001148,2783,0,346.62051282051283,69,126,41,38.11037713886628,0.5352029914529914,44.315476190476204,8624.56193730206,124.99365126524725,0
3808,33.33578548866819,2,1,195,0.01020408163265306,0.00510204081632653,0.9948979591836735,196,6050,4000,2050,0.6611570247933884,81,40,41,236.26164232494756,0.4795624018838305,0.7931838949962602,0.1371061656641632,1091517.4857792314,6326.742763320077,1097844.2285425514,2784,0,345.4030612244898,71,125,39,38.051221166892816,0.5368835034013606,44.09722222222224,8530.720105954373,120.15098740780807,0
3809,32.97140679565681,2,3,194,0.01015228426395939,0.015228426395939087,0.9847715736040609,197,6450,4600,1850,0.7131782945736435,83,46,37,234.97303145839174,0.4794062294968749,0.794087495317044,0.13726498405933776,1081685.8949565971,4983.402764747207,1086669.2977213443,2785,0,344.6395939086294,73,124,44,37.82966743602425,0.5392343485617597,43.84853603603605,8445.67411965892,115.69416602272491,0
3810,33.292300500690416,1,1,194,0.005128205128205128,0.005128205128205128,0.9948717948717949,195,6600,4900,1700,0.7424242424242424,83,49,34,245.68506020798065,0.4788924134284959,0.8021724372029881,0.14191925242602138,1088615.0576452527,7891.291196177498,1096506.3488414302,2786,0,349.0974358974359,67,128,41,37.9879497623897,0.5332264957264957,44.27083333333332,8513.81226345778,127.07182482772805,8
3811,33.40755030700673,3,1,196,0.015228426395939087,0.005076142131979695,0.9949238578680203,197,6650,5300,1350,0.7969924812030075,80,53,27,241.03288049769114,0.47882027176352776,0.8018274224786195,0.1407999101143524,1095982.8110926975,6783.57878672588,1102766.3898794234,2787,0,346.53299492385787,72,125,45,37.675825859283606,0.5364847715736041,43.849885844748854,8557.347824787059,118.85205312204249,0
3812,33.164415313735354,3,2,197,0.01507537688442211,0.010050251256281407,0.9899497487437185,199,5450,3700,1750,0.6788990825688074,72,37,35,224.29695818910022,0.4787013772566537,0.7916101253606731,0.12954063971699223,1084374.4820695017,3394.3795732139843,1087768.8616427155,2788,0,343.96984924623115,74,125,41,38.54200611919762,0.5355422948073703,44.27777777777778,8480.877982729102,114.60645922606895,8
3813,32.733756356069364,3,3,197,0.015,0.015,0.985,200,7000,5200,1800,0.7428571428571429,88,52,36,208.71490824758425,0.4788887144053601,0.7808248509305549,0.1162460121313199,1058714.093002954,-2806.117043692736,1055907.9759592612,2789,0,343.085,67,133,41,40.35647423156461,0.5215104166666666,45.664828431372555,8325.345538906564,124.25888864039648,8
3814,32.47864626519479,2,1,198,0.010050251256281407,0.005025125628140704,0.9949748743718593,199,6100,3700,2400,0.6065573770491803,85,37,48,198.22773861280885,0.4786759978342893,0.7619380233565514,0.1099666990940499,1049189.3487766064,-4304.31360307379,1044885.0351735326,2790,0,345.61306532663315,72,127,46,40.780492711315674,0.52428810720268,45.819063926940615,8255.452710072932,114.65906541767961,8
3815,31.994427072462397,3,5,196,0.014925373134328358,0.024875621890547265,0.9751243781094527,201,7000,5200,1800,0.7428571428571429,88,52,36,225.31059974376097,0.47885572139303484,0.7939674489002333,0.12754573152883938,1039900.1401148202,-339.89515142204436,1039560.2449633982,2791,0,343.1094527363184,79,122,37,39.29452232606438,0.5305244610281924,45.03906249999998,8157.329121170337,103.2573306477258,7
3816,32.29272865464666,3,0,199,0.01507537688442211,0.0,1.0,199,6050,4400,1650,0.7272727272727273,77,44,33,221.48061453546714,0.47881875708508875,0.7903171601704466,0.12634707190560424,1052018.0199355383,750.3195115414796,1052768.3394470797,2792,0,347.24120603015075,66,133,43,39.091622000243596,0.5329773869346734,44.74502487562188,8242.879649440105,124.89211590060765,0
3817,32.08136012527569,3,3,199,0.01485148514851485,0.01485148514851485,0.9851485148514851,202,6000,4100,1900,0.6833333333333333,79,41,38,215.80769052359705,0.47914973400325106,0.7871746727460738,0.12413685617386362,1047713.6481766338,-1179.067451389481,1046534.5807252442,2793,0,343.0693069306931,71,131,39,38.914579205585454,0.5354269801980198,44.42997685185186,8199.033949840807,115.47935140620855,0
3818,31.89452322444938,6,7,198,0.02926829268292683,0.03414634146341464,0.9658536585365853,205,7450,5500,1950,0.738255033557047,94,55,39,210.03354479963085,0.4796508847441416,0.7822675527152272,0.122402582534901,1045623.9618504995,-4526.778553020965,1041097.1832974786,2794,0,338.809756097561,82,123,35,38.560097371301666,0.5390752032520325,43.93825301204821,8166.967336200344,99.59716263658956,0
3819,31.840148960157904,1,3,196,0.005025125628140704,0.01507537688442211,0.9849246231155779,199,5450,3200,2250,0.5871559633027523,77,32,45,195.51300970667853,0.4786474459841294,0.7597525976868691,0.11347189802768905,1042580.1879200315,-4482.401919839487,1038097.786000192,2795,0,349.5175879396985,81,118,43,39.08967278894682,0.5455402010050252,44.09298780487809,8148.117388241736,100.59404183014489,8
3820,32.13335576109013,3,5,194,0.01507537688442211,0.02512562814070352,0.9748743718592965,199,5750,3800,1950,0.6608695652173913,77,38,39,194.73290343705582,0.4786474459841294,0.7611519467012593,0.11375928305314086,1054196.2231381088,-4492.6617351870955,1049703.5614029218,2796,0,350.4673366834171,84,115,46,38.85991771122383,0.5473722780569514,43.848039215686306,8231.022084783244,97.98835815218148,0
3821,32.55410918099516,2,1,195,0.01020408163265306,0.00510204081632653,0.9948979591836735,196,6200,4300,1900,0.6935483870967742,81,43,38,190.10910192329078,0.4783130559916274,0.751522378629792,0.11193948347894347,1070462.135453482,-4699.080957210104,1065763.0544962718,2797,0,353.13775510204084,73,123,46,38.67763567168005,0.5509141156462585,43.552927927927925,8348.405983380762,114.36172579973648,0
3822,32.89200531928963,2,1,196,0.01015228426395939,0.005076142131979695,0.9949238578680203,197,5750,4300,1450,0.7478260869565218,72,43,29,203.19832133675112,0.4782235229117027,0.7704830017656019,0.11881167476810771,1079369.453586096,-1284.7877858276406,1078084.6658002683,2798,0,352.1928934010152,80,117,44,38.60865000083665,0.5475888324873097,43.814300411522645,8426.461393590163,105.33076741987705,8
3823,32.82044920136487,2,1,197,0.010101010101010102,0.005050505050505051,0.9949494949494949,198,6550,4800,1750,0.732824427480916,83,48,35,196.7959356242602,0.47786291425250815,0.7642048225893718,0.11614019206011983,1079931.0622708097,-3644.7912381432398,1076286.2710326663,2799,0,351.35858585858585,73,125,46,38.42003219198125,0.5503472222222222,43.46846846846845,8419.48009917892,115.33534382436876,0
3824,33.265149957786356,2,0,199,0.010050251256281407,0.0,1.0,199,7400,5100,2300,0.6891891891891891,97,51,46,192.35543789743264,0.4776872578380116,0.7587354287560129,0.11429574659739866,1096720.7119666473,-5007.96143969446,1091712.7505269528,2800,0,350.49748743718595,77,122,45,38.276428472366696,0.5527638190954773,43.21581196581195,8541.964521745636,110.93460417851476,0
3825,33.07401975329979,0,2,197,0.0,0.010050251256281407,0.9899497487437185,199,6800,5200,1600,0.7647058823529411,84,52,32,229.982958357427,0.4775413261594166,0.7963158390263041,0.13441964244789678,1085216.8458903192,3316.276135434292,1088533.1220257536,2801,1,351.49748743718595,78,121,39,37.93762010157163,0.5422424623115578,43.82911392405063,8472.600946296252,108.62308905508016,8
3826,32.691394408262504,3,3,197,0.015,0.015,0.985,200,6700,5000,1700,0.746268656716418,84,50,34,226.6445553091689,0.4778156407035176,0.7926798116539147,0.1336117624810119,1075349.307468666,2044.413118651485,1077393.7205873174,2802,0,350.545,68,132,41,37.69521287031585,0.5450520833333333,43.508454106280176,8385.066289196518,123.30979837053704,0
3827,32.52779152652375,1,2,196,0.005050505050505051,0.010101010101010102,0.98989898989899,198,6600,4700,1900,0.7121212121212122,85,47,38,238.3947042656019,0.47773366063340683,0.7969890439769951,0.13904210048788365,1066635.006946516,4656.027408070631,1071291.0343545866,2803,0,354.80808080808083,78,120,37,37.80313561940068,0.5416140572390573,43.90822784810127,8330.099776214991,106.79615097711527,8
3828,32.027167092140246,1,1,196,0.005076142131979695,0.005076142131979695,0.9949238578680203,197,6950,5200,1750,0.7482014388489209,87,52,35,214.16989685661525,0.4772803791567388,0.7749972830048641,0.1237584044901683,1047356.2172363417,-1487.5653964715966,1045868.65183987,2804,0,357.01015228426394,77,120,38,38.780243690165356,0.5387055837563453,44.25747863247863,8190.708464402847,106.37283720003698,8
3829,32.49123907520578,1,0,197,0.005076142131979695,0.0,1.0,197,7300,5400,1900,0.7397260273972602,92,54,38,199.82444483868863,0.477184338202286,0.7664953959370193,0.11606824136374988,1064153.1256506,-4171.238488702289,1059981.8871618977,2805,0,358.0,79,118,41,38.94824311490981,0.5407148900169205,44.06250000000003,8315.726500810551,105.26236076975381,8
3830,32.532020781455515,3,3,197,0.015,0.015,0.985,200,6150,3900,2250,0.6341463414634146,84,39,45,202.75254003471886,0.4778648450586265,0.775515666784399,0.11451560532767385,1056652.0912168503,-3302.2209145574875,1053349.8703022928,2806,0,353.615,80,120,39,39.95839430176425,0.5284895833333334,45.126028806584344,8291.56532751625,103.64456659395312,8
3831,32.69734253908292,2,2,197,0.010050251256281407,0.010050251256281407,0.9899497487437185,199,7550,5900,1650,0.7814569536423841,92,59,33,223.75493212836415,0.47813562763311507,0.7963678433111019,0.1248427051220876,1058103.8991185548,1.193226406094709,1058105.092344961,2807,0,356.21608040201005,65,134,38,39.90418915565482,0.5223513400335008,45.59659090909092,8318.31541015592,127.97408323316799,8
3832,32.72328008576753,4,1,200,0.01990049751243781,0.004975124378109453,0.9950248756218906,201,6100,4300,1800,0.7049180327868853,79,43,36,196.79752356805895,0.4785893449419569,0.7685056820711116,0.10867853830923059,1055623.5507554724,-4751.179878240761,1050872.3708772317,2808,0,352.8756218905473,76,125,39,40.996928703309166,0.5211442786069651,45.99567099567096,8311.854801006019,109.36651053955288,8
3833,33.13466003747451,0,2,198,0.0,0.01,0.99,200,5850,3700,2150,0.6324786324786325,80,37,43,219.07974775272405,0.4786552554438861,0.7906671251719379,0.11625618731111768,1055689.9073438987,406.05572119990484,1056095.9630650985,2809,1,355.54,71,129,38,42.03920220082531,0.5088020833333333,47.569444444444464,8364.200641404204,117.80564283667893,8
3834,32.713759592024694,6,5,199,0.029411764705882353,0.024509803921568627,0.9754901960784313,204,6050,4000,2050,0.6611570247933884,81,40,41,211.32993248692878,0.4801481655880743,0.7883684584041011,0.1137112262550022,1046851.2832756717,-2603.7977962993104,1044247.4854793723,2810,0,348.9019607843137,80,124,40,41.67016148163211,0.5129187091503268,47.01646090534981,8276.042678682008,103.4505334835251,0
3835,33.149471943718865,3,3,199,0.01485148514851485,0.01485148514851485,0.9851485148514851,202,7050,5100,1950,0.723404255319149,90,51,39,211.05707056298724,0.48005588805149174,0.7879159551049821,0.11442715771604095,1063305.629547642,-2566.3657429084465,1060739.2638047335,2811,0,353.2524752475247,65,137,39,41.37145854104352,0.5151093234323432,46.71717171717171,8396.192009987362,129.17218476903633,0
3836,33.2984194648416,3,0,202,0.01485148514851485,0.0,1.0,202,6350,4500,1850,0.7086614173228346,82,45,37,207.91632362609153,0.48107749207756595,0.7845946863815674,0.11420331399172216,1072404.2478760662,-2155.930268121137,1070248.317607945,2812,0,354.019801980198,69,133,45,40.92855223297177,0.5178424092409242,46.205357142857125,8450.960475786766,122.47768805488066,0
3837,33.46985274870835,5,0,207,0.024154589371980676,0.0,1.0,207,5800,4200,1600,0.7241379310344828,74,42,32,201.59777779635664,0.48159580538748964,0.7820760259964388,0.11193158934732565,1081490.6925932798,-3594.775933150449,1077895.9166601293,2813,0,346.44444444444446,65,142,47,40.66108679456139,0.5205817230273753,45.78598484848485,8508.505653779128,130.90008698121736,0
3838,33.79060862365227,2,2,207,0.009569377990430622,0.009569377990430622,0.9904306220095693,209,7000,5400,1600,0.7714285714285715,86,54,32,200.7671848856013,0.48146220555760033,0.7838534697154644,0.11233766910011149,1094432.5277773892,-4854.772470180082,1089577.755307209,2814,0,344.11961722488036,68,141,49,40.37630741246022,0.5230263157894737,45.48611111111112,8600.179208728188,126.47322365776748,0
3839,34.022230625679,0,3,204,0.0,0.014492753623188406,0.9855072463768116,207,6650,4300,2350,0.6466165413533834,90,43,47,203.49583122145899,0.4813808373590982,0.7836566366964548,0.11424608477236295,1103051.4898562434,-3156.724038326757,1099894.7658179167,2815,1,346.07246376811594,69,138,46,40.17526686925355,0.5247081320450886,45.357142857142875,8663.518012896162,125.55823207095887,0
3840,33.4256059751505,2,1,205,0.009708737864077669,0.0048543689320388345,0.9951456310679612,206,5600,3500,2100,0.625,77,35,42,201.41258821173912,0.4813067329702423,0.7797744278664573,0.11383205828146695,1085886.3147071078,-3057.765370226415,1082828.5493368814,2816,0,348.3883495145631,73,133,42,39.967371695751446,0.527002427184466,45.10135135135138,8520.141793328137,116.71427114148133,0
3841,32.996128379017854,3,1,207,0.014423076923076924,0.004807692307692308,0.9951923076923077,208,7600,5400,2200,0.7105263157894737,98,54,44,201.08288213244344,0.48110164669267935,0.7819270015698572,0.11457047935453274,1074540.2593047777,-5985.66953832998,1068554.5897664477,2817,0,346.02403846153845,76,132,48,39.65986394557825,0.5295973557692308,44.7916666666667,8420.886930061932,110.80114381660437,0
3842,32.60197930413223,2,2,207,0.009569377990430622,0.009569377990430622,0.9904306220095693,209,6400,4300,2100,0.671875,85,43,42,195.3404343407734,0.48133281192491717,0.7752761714660321,0.10979479585360674,1057375.4737933178,-6890.3631375865925,1050485.1106557313,2818,0,344.1244019138756,79,130,39,40.33742331288343,0.5287579744816586,45.312499999999986,8303.316604021145,105.10527346862209,8
3843,33.03219870684417,2,2,207,0.009569377990430622,0.009569377990430622,0.9904306220095693,209,7300,5200,2100,0.7123287671232876,94,52,42,208.4186434526788,0.4815312154950313,0.7878525278249386,0.11747232630969212,1072229.2610827407,-4405.486386973317,1067823.7746957673,2819,0,342.2200956937799,72,137,45,39.895086618876974,0.5271132376395534,45.20547945205481,8416.423232154848,116.89476711326178,8
3844,32.86218089264767,3,4,206,0.014285714285714285,0.01904761904761905,0.9809523809523809,210,7150,5400,1750,0.7552447552447552,89,54,35,209.24741994362375,0.48123053846738056,0.778632283988576,0.11730197187724191,1064965.538016399,-4581.741768239621,1060383.7962481594,2820,0,341.4952380952381,76,134,36,40.08681385833463,0.5302579365079365,45.413961038961,8366.252465080206,110.08226927737114,8
3845,32.913890659093205,0,4,202,0.0,0.019417475728155338,0.9805825242718447,206,6150,4200,1950,0.6829268292682927,81,42,39,206.067777096602,0.4805978175073013,0.7790582635705039,0.11544289027785233,1066427.0343965294,-3398.7503172373954,1063028.284079292,2821,1,348.9854368932039,81,125,40,40.19386155330439,0.5346379449838188,45.43953252032518,8378.57539275361,103.4392023796742,8
3846,32.85193580866623,5,1,206,0.024154589371980676,0.004830917874396135,0.9951690821256038,207,7050,4700,2350,0.6666666666666666,94,47,47,204.28104665477179,0.48079944655503964,0.780663144203702,0.11580084369910908,1068213.6381064903,-4806.839991341149,1063406.7981151491,2822,0,346.42512077294685,90,117,37,39.77681644073374,0.5378925120772946,44.98626373626372,8377.694894064367,93.08549882293741,0
3847,33.25851876513124,3,1,208,0.014354066985645933,0.004784688995215311,0.9952153110047847,209,7800,5600,2200,0.717948717948718,100,56,44,204.36440498265046,0.4807423935713409,0.7848348649200425,0.11675036111132578,1083944.9338769172,-5296.047710856831,1078648.8861660603,2823,0,344.0956937799043,71,138,41,39.47277393702423,0.5402711323763956,44.69039351851854,8491.21933808268,119.59463856454478,0
3848,33.24578451941904,3,1,210,0.014218009478672985,0.004739336492890996,0.995260663507109,211,6100,4300,1800,0.7049180327868853,79,43,36,202.15319272348714,0.4807031896486873,0.7849091581194922,0.1165433507043466,1086461.5543054484,-4373.665605165959,1082087.8887002824,2824,0,341.8056872037915,76,135,40,39.17709545983701,0.5426046603475514,44.345238095238116,8499.443125649144,111.83477796906769,0
3849,33.48001950613898,2,1,211,0.009433962264150943,0.0047169811320754715,0.9952830188679245,212,8250,6300,1950,0.7636363636363637,102,63,39,201.219606442824,0.4803589525768279,0.7848228603114158,0.1167444629085333,1096167.6002794863,-6535.917375277004,1089631.6829042092,2825,0,340.9669811320755,81,131,39,38.956595843261844,0.5448113207547169,44.105691056910594,8567.346454924658,105.76970932005752,0
3850,33.19312454556678,2,2,211,0.009389671361502348,0.009389671361502348,0.9906103286384976,213,6700,4600,2100,0.6865671641791045,88,46,42,201.265611221737,0.4800534074467771,0.785472146674276,0.1175450510747104,1088881.3284705693,-5469.126775486488,1083412.201695083,2826,0,337.84507042253523,86,127,42,38.70249614359842,0.5474374021909233,43.85775862068967,8502.161319484125,98.862340924234,0
3851,32.670628541471075,1,2,210,0.0047169811320754715,0.009433962264150943,0.9905660377358491,212,6400,4200,2200,0.65625,86,42,44,202.39003541027307,0.4797716586187368,0.7876646493414023,0.11877916047502345,1073266.093063224,-5356.327484057881,1067909.7655791661,2827,0,340.3443396226415,69,143,45,38.48784470246732,0.5493808962264151,43.67559523809522,8374.27941408983,121.36636832014246,0
3852,33.041695925192236,1,3,208,0.004739336492890996,0.014218009478672985,0.985781990521327,211,6750,4600,2150,0.6814814814814815,89,46,43,198.05533032844326,0.4795465658617317,0.7817049449360998,0.11691530861286886,1087296.9211743395,-5881.009822343547,1081415.911351996,2828,0,337.30331753554503,74,137,45,38.3773888798657,0.5518364928909952,43.45833333333332,8476.571742142,114.5482667857027,0
3853,32.50316210322859,0,2,206,0.0,0.009615384615384616,0.9903846153846154,208,7300,5300,2000,0.726027397260274,93,53,40,208.16371153657425,0.47916811826458566,0.7777695796481048,0.12098885428294197,1064742.0023648187,-4571.870591770991,1060170.1317730476,2829,1,341.59615384615387,82,126,38,38.71046825202257,0.5415164262820513,44.0386546184739,8319.553101096226,101.45796464751496,8
3854,32.522695960417515,3,1,208,0.014354066985645933,0.004784688995215311,0.9952153110047847,209,6600,4200,2400,0.6363636363636364,90,42,48,203.2043846351395,0.47923759354680406,0.7745069467138279,0.11919226846121915,1068237.188547319,-4985.903891373896,1063251.2846559451,2830,0,338.2392344497608,76,133,43,38.48767549878603,0.5437101275917066,43.69588744588747,8335.700726002093,109.68027271055385,0
3855,32.3533587851357,4,1,211,0.018867924528301886,0.0047169811320754715,0.9952830188679245,212,7550,5400,2150,0.7152317880794702,97,54,43,201.4234873859317,0.47945123178038096,0.7829590463816365,0.11888350151754007,1064593.8282345207,-7063.159693492755,1057530.668541028,2831,0,333.9433962264151,72,140,43,38.297386620684534,0.5446639150943396,43.46461187214611,8299.781453184472,115.2747424053399,8
3856,31.941289012300423,0,4,207,0.0,0.018957345971563982,0.981042654028436,211,7150,4800,2350,0.6713286713286714,95,48,47,195.82430874981662,0.47911682840592795,0.7752370459393583,0.11612864657478472,1052478.140057283,-8129.839149797928,1044348.3009074851,2832,1,336.49763033175356,78,133,41,38.261466947454956,0.5465541074249605,43.288502109704645,8199.696146894483,105.1243095755703,0
3857,31.75626710155076,4,1,210,0.018957345971563982,0.004739336492890996,0.995260663507109,211,6050,4100,1950,0.6776859504132231,80,41,39,191.3695786181601,0.4793566162641992,0.7726446841993233,0.11455096723002717,1049192.3499994702,-8093.300418240786,1041099.0495812293,2833,0,337.0805687203791,83,128,36,38.024677585347426,0.5492693522906793,42.94394841269841,8163.140634276355,98.35109197923319,0
3858,31.34543550952794,1,0,211,0.004739336492890996,0.0,1.0,211,6600,5100,1500,0.7727272727272727,81,51,30,191.53749483665956,0.4794591138193034,0.7738649674097531,0.11508858535905697,1036745.91179911,-9084.857054370004,1027661.05474474,2834,0,338.07582938388623,86,125,40,37.87785329671186,0.5507997630331753,42.804118773946364,8061.916908287479,93.7432198638079,0
3859,31.850902997707447,1,3,209,0.0047169811320754715,0.014150943396226415,0.9858490566037735,212,6700,4800,1900,0.7164179104477612,86,48,38,223.08502950740822,0.47943493099645296,0.7975659513837927,0.13138565754007644,1047406.9392387193,-2367.8384107335532,1045039.1008279858,2835,0,337.47641509433964,70,142,40,37.823464912280684,0.5451061320754718,43.54460093896711,8168.336038731247,116.69051483901781,8
3860,32.15565692923231,2,2,209,0.009478672985781991,0.009478672985781991,0.990521327014218,211,6950,5500,1450,0.7913669064748201,84,55,29,224.03819804288872,0.4792503573309261,0.801210752369669,0.129341640107235,1051272.2850865575,-2044.9703193553278,1049227.3147672021,2836,0,339.97156398104266,72,139,37,38.56340680803575,0.538556477093207,44.292237442922385,8222.451086927003,114.20070954065282,8
3861,31.855818874380546,5,4,210,0.02336448598130841,0.018691588785046728,0.9813084112149533,214,7250,5200,2050,0.7172413793103448,93,52,41,219.85975899967033,0.4794271861699794,0.8022045761634862,0.12854815701488467,1045353.1340080282,-4083.782377488742,1041269.3516305394,2837,0,335.9626168224299,78,136,39,38.18347144303192,0.541861370716511,43.815928270042214,8160.953387530893,104.62760753244736,0
3862,31.586657669848545,4,3,211,0.018691588785046728,0.014018691588785047,0.985981308411215,214,7350,5300,2050,0.7210884353741497,94,53,41,209.19783942535602,0.4793654841823527,0.7908113047241951,0.12369405718557963,1039906.1183400663,-6640.777367610297,1033265.340972456,2838,0,336.0934579439252,70,144,43,38.02982656756238,0.5455120716510904,43.39788732394363,8105.203090458423,115.78861557797747,0
3863,31.16654847622758,0,2,209,0.0,0.009478672985781991,0.990521327014218,211,6700,4800,1900,0.7164179104477612,86,48,38,206.47507768907215,0.4783758369066426,0.7858853505226104,0.12249750095595288,1027077.6103560558,-6486.814121805814,1020590.79623425,2839,1,340.97630331753555,71,140,46,37.97178782755703,0.5473439968404423,43.27256944444441,8001.30790958699,112.69447759981676,0
3864,30.965537943956996,5,3,211,0.02336448598130841,0.014018691588785047,0.985981308411215,214,8300,6100,2200,0.7349397590361446,105,61,44,199.69744491855644,0.47842167229754434,0.7816304091730173,0.12004940130618158,1024321.509018652,-10189.122374771468,1014132.3866438805,2840,0,336.86915887850466,79,135,45,37.64996962640478,0.5512071651090342,42.7864583333333,7964.7556841786445,100.81969220479297,0
3865,31.219997615196192,0,2,209,0.0,0.009478672985781991,0.990521327014218,211,6700,5100,1600,0.7611940298507462,83,51,32,204.06825222508155,0.47793105393816293,0.7830074639752866,0.12293867877950039,1033366.3381648792,-6724.547492492038,1026641.7906723872,2841,1,340.0568720379147,67,144,46,37.45782726045882,0.5528238546603476,42.708333333333336,8032.64521974319,119.89022716034611,0
3866,31.573754370657277,0,2,207,0.0,0.009569377990430622,0.9904306220095693,209,6800,4700,2100,0.6911764705882353,89,47,42,209.1430046346824,0.4773839099496994,0.7877896816570811,0.12328679027656243,1038567.5311479041,-5158.173203940716,1033409.3579439634,2842,2,340.01913875598086,73,136,38,38.146403874650126,0.546152312599681,43.51069819819819,8098.330213791462,110.93603032591044,8
3867,31.77248494161275,0,1,206,0.0,0.004830917874396135,0.9951690821256038,207,6800,5000,1800,0.7352941176470589,86,50,36,204.9764177033527,0.4769202507699764,0.7814022856944671,0.12148787310133013,1046746.3925541982,-5288.334842066743,1041458.0577121314,2843,3,343.71014492753625,77,130,36,38.04774075230219,0.5480575684380032,43.30929487179487,8155.701563337844,105.91820212127071,0
3868,32.197124792074355,0,2,204,0.0,0.009708737864077669,0.9902912621359223,206,5250,3600,1650,0.6857142857142857,69,36,33,186.88098791198962,0.4768208816796906,0.7572352699582734,0.10801901083002766,1052999.1687135552,-7092.895016061614,1045906.2736974936,2844,4,346.252427184466,87,119,43,39.467624733870224,0.5414138349514563,44.24715909090908,8234.50613467751,94.6494958008909,8
3869,32.25924694805697,3,4,203,0.014492753623188406,0.01932367149758454,0.9806763285024155,207,6450,4600,1850,0.7131782945736435,83,46,37,180.0500270416446,0.4768547832340572,0.7497135153353571,0.10462366436203656,1056677.7849871956,-9799.027247750248,1046878.7577394454,2845,0,345.43961352657004,90,117,33,39.43919573643412,0.542975040257649,44.047619047619044,8256.831064085993,91.74256737873326,0
3870,32.618885977244766,2,2,203,0.00975609756097561,0.00975609756097561,0.9902439024390244,205,6250,4300,1950,0.688,82,43,39,182.6026633139312,0.4766409612625538,0.7508128239415595,0.10467638387892128,1064182.983856424,-8385.470578890003,1055797.513277534,2846,0,349.2390243902439,80,125,42,39.895786135024906,0.536839430894309,44.56018518518519,8332.16219349298,104.15202741866226,7
3871,32.551721771953,3,0,206,0.014563106796116505,0.0,1.0,206,6150,4100,2050,0.6666666666666666,82,41,41,177.5912250539733,0.4768588681032441,0.7458073045153757,0.10264943843007365,1064596.1770629664,-9537.412145522156,1055058.7649174442,2847,0,348.34466019417476,87,119,46,39.70521305810112,0.539846278317152,44.24715909090909,8325.195319659299,95.69190022596895,0
3872,32.068606853081896,0,2,204,0.0,0.009708737864077669,0.9902912621359223,206,5950,3800,2150,0.6386554621848739,81,38,43,180.55582849438426,0.4766230562791065,0.7513810474247304,0.1048009872585541,1050090.1427190504,-9230.02085751484,1040860.1218615356,2848,1,349.34466019417476,88,118,35,39.468804786950216,0.5417677993527508,44.08941947565545,8206.695796379207,93.25790677703644,0
3873,32.23625025750014,0,4,200,0.0,0.0196078431372549,0.9803921568627451,204,6050,4300,1750,0.7107438016528925,78,43,35,212.4339823455128,0.47646716732670075,0.779122696667464,0.12216409012143466,1052690.0126321588,-2124.573688239909,1050565.4389439188,2849,2,353.51960784313724,76,128,45,39.01097083267164,0.5364583333333333,44.439935064935106,8238.298209069842,108.39866064565582,8
3874,31.916623972791783,2,2,200,0.009900990099009901,0.009900990099009901,0.9900990099009901,202,5900,4200,1700,0.711864406779661,76,42,34,209.0756900885323,0.4765980329376221,0.7726086047138665,0.1209806165475483,1044163.6675719703,-2638.1521274030038,1041525.5154445673,2850,0,357.0940594059406,79,123,43,38.85769279714942,0.5385726072607261,44.20572916666671,8164.089556582065,103.34290577951981,0
3875,32.360990895415654,1,2,199,0.004975124378109453,0.009950248756218905,0.9900497512437811,201,7350,5400,1950,0.7346938775510204,93,54,39,205.48773907896597,0.4764407131011608,0.7686657130261882,0.11961549443228345,1060558.3702778064,-3963.651666067619,1056594.7186117389,2851,0,355.0696517412935,80,121,37,38.7206148282098,0.5414075456053068,43.98148148148152,8285.012946835668,103.56266183544585,0
3876,32.03413091683195,3,2,200,0.01485148514851485,0.009900990099009901,0.9900990099009901,202,5750,4300,1450,0.7478260869565218,72,43,29,203.12884363530344,0.47668834047583863,0.7682776086622471,0.11885423983987489,1051432.7772807386,-3434.7351581411003,1047998.0421225975,2852,0,354.2722772277228,81,121,43,38.5837072570116,0.5429042904290429,43.788109756097604,8207.525234522262,101.32747203113904,0
3877,31.655073515063037,2,6,196,0.009900990099009901,0.0297029702970297,0.9702970297029703,202,5800,4000,1800,0.6896551724137931,76,40,36,246.93761055175258,0.4765405645042116,0.8079339239934284,0.14522985683117437,1040543.3219897792,5189.856321547639,1045733.1783113269,2853,0,354.9306930693069,67,135,36,37.26525470984189,0.5439356435643564,43.596813725490186,8116.461711015985,121.14121956740276,8
3878,31.20001142268355,2,4,194,0.010101010101010102,0.020202020202020204,0.9797979797979798,198,5600,3600,2000,0.6428571428571429,76,36,40,243.8583149220632,0.47543006204173716,0.7994246823626858,0.14414977456980194,1027097.9623950607,4893.27567390864,1031991.2380689693,2854,0,362.449494949495,69,129,38,37.1505224342245,0.5459806397306397,43.40773809523808,8005.681502400751,116.02436960001089,0
3879,30.87081844934841,0,1,193,0.0,0.005154639175257732,0.9948453608247423,194,6400,4700,1700,0.734375,81,47,34,208.2788726677531,0.4749162037284333,0.772159761988398,0.12324810692504458,1016571.481116074,-2853.927585391484,1013717.5535306826,2855,1,370.2216494845361,70,124,42,38.02345357877889,0.5488079896907216,43.36854460093895,7922.423068016419,113.17747240023456,8
3880,30.503366577507435,3,2,194,0.015306122448979591,0.01020408163265306,0.9897959183673469,196,5650,3800,1850,0.672566371681416,75,38,37,202.7746657103379,0.4752518315018315,0.7667556431952296,0.12084596373319054,1006529.1060620123,-4030.279398110296,1002498.8266639019,2856,0,365.9183673469388,75,121,36,37.896648081950595,0.5512329931972789,43.10581140350875,7836.137606390056,104.48183475186741,0
3881,30.104661427309146,1,2,193,0.005128205128205128,0.010256410256410256,0.9897435897435898,195,6300,4100,2200,0.6507936507936508,85,41,44,199.21777651924177,0.47496805885981147,0.7613598847757794,0.11929501249073025,994735.4663622947,-5666.202433294632,989069.2639290001,2857,0,368.7076923076923,79,116,39,37.80838989346433,0.5526709401709402,42.929687499999986,7739.0147208250255,97.96221165601298,0
3882,30.67031932342816,0,4,189,0.0,0.02072538860103627,0.9792746113989638,193,6250,4500,1750,0.72,80,45,35,202.15442736139588,0.47421245322394934,0.7623768437999578,0.12187938430627625,1015394.4358809734,-3796.7038537070575,1011597.7320272663,2858,1,373.1295336787565,73,120,37,37.47834609773884,0.5550518134715026,42.68018018018016,7892.081042120825,108.11069920713459,0
3883,30.516358007694627,4,1,192,0.02072538860103627,0.0051813471502590676,0.9948186528497409,193,6350,4300,2050,0.6771653543307087,84,43,41,203.43130567204133,0.47407302461139894,0.7660303782791233,0.12403768715489777,1013522.8397674065,-3713.5450755365114,1009809.29469187,2859,0,373.8756476683938,75,118,43,37.02669644756432,0.5582361830742659,42.269736842105246,7864.988979943626,104.86651973258168,0
3884,30.221250413392248,0,2,190,0.0,0.010416666666666666,0.9895833333333334,192,6450,4700,1750,0.7286821705426356,82,47,35,202.19209544403685,0.4740611592859221,0.7635621655446232,0.12378977054611083,1004882.5620341761,-4214.137821427657,1000668.4242127484,2860,1,375.4427083333333,77,115,35,36.906611427584984,0.5598415798611112,42.12072649572648,7793.434100996283,101.21342988306861,0
3885,30.75682078347302,1,1,190,0.005235602094240838,0.005235602094240838,0.9947643979057592,191,4850,3400,1450,0.7010309278350515,63,34,29,197.69474532163605,0.4741342886010838,0.7519733688833952,0.11839179026301626,1016306.0965487405,-2866.325014794381,1013439.7715339462,2861,0,372.869109947644,80,111,41,37.844755711188924,0.5509380453752182,42.92695473251027,7906.749581553781,98.83436976942227,8
3886,30.540932471220536,1,1,190,0.005235602094240838,0.005235602094240838,0.9947643979057592,191,6350,4200,2150,0.6614173228346457,85,42,43,197.69728395423056,0.4735831725911637,0.7524130690246884,0.11886188177929918,1010311.9146226323,-4602.815706501544,1005709.0989161307,2862,0,373.83769633507853,84,107,43,37.69673003319196,0.5526287085514834,42.78186274509803,7855.681760275076,93.52002095565567,0
3887,30.215504246542867,2,1,191,0.010416666666666666,0.005208333333333333,0.9947916666666666,192,6350,4900,1450,0.7716535433070866,78,49,29,197.5082348036466,0.4736322444008145,0.7543782175877296,0.1197377948319175,1001906.805226935,-5173.0310923735,996733.7741345614,2863,0,372.1510416666667,76,116,42,37.39209042515937,0.5554470486111112,42.47835497835497,7781.146358728202,102.38350472010792,0
3888,30.40727206772311,2,1,192,0.010362694300518135,0.0051813471502590676,0.9948186528497409,193,6100,4300,1800,0.7049180327868853,79,43,36,194.32981083269647,0.4733590151842257,0.7496393686385276,0.11871550815890217,1010444.8285737179,-5428.089521278727,1005016.7390524391,2864,0,371.0777202072539,81,112,44,37.190384678558516,0.5578583765112263,42.20020325203251,7838.988558719136,96.77763652739674,0
3889,30.89958796551823,0,3,189,0.0,0.015625,0.984375,192,6400,4500,1900,0.703125,83,45,38,196.30379578576014,0.4730419893470041,0.7531183923916798,0.11867132276146139,1023768.3918724745,-4606.0757339898055,1019162.3161384846,2865,1,373.0104166666667,73,119,42,37.52842410820071,0.55615234375,42.58164414414416,7954.1211307071235,108.96056343434415,8
3890,31.100465053826603,4,3,190,0.02072538860103627,0.015544041450777202,0.9844559585492227,193,5900,4400,1500,0.7457627118644068,74,44,30,190.51538959676714,0.4726517523028209,0.7464653780430652,0.11614427799065687,1032876.8060591437,-5144.214577635367,1027732.5914815083,2866,0,371.52331606217615,76,117,46,37.36538326946968,0.5586679620034543,42.27543290043292,8015.353892592715,105.46518279727256,0
3891,31.156314331132116,0,3,187,0.0,0.015789473684210527,0.9842105263157894,190,5350,3200,2150,0.5981308411214953,75,32,43,218.13877294103307,0.47207602339181287,0.776290844929491,0.12669689913306206,1020409.8092001621,1168.1887351838282,1021577.9979353459,2867,1,376.38421052631577,75,115,35,38.48231180492338,0.543530701754386,44.06524122807021,7973.983792560792,106.31978390081055,8
3892,31.138467573698364,0,2,185,0.0,0.0106951871657754,0.9893048128342246,187,5950,4600,1350,0.773109243697479,73,46,27,196.34067382954683,0.47192153987694785,0.7480305514455952,0.11238020669387663,1015424.4552520214,-3476.1756465635917,1011948.2796054578,2868,2,381.3475935828877,77,110,39,39.60386924994333,0.539605614973262,44.61805555555555,7952.202395991357,103.27535579209554,8
3893,31.530468674921806,1,1,185,0.005376344086021506,0.005376344086021506,0.9946236559139785,186,5450,3600,1850,0.6605504587155964,73,36,37,198.22823459744546,0.4724989102005231,0.7500818296102227,0.1140077045391009,1029676.8776763268,-1827.794066482289,1027849.0836098444,2869,0,383.6236559139785,78,108,40,39.369647095242996,0.5411626344086021,44.435654008438824,8058.06360571382,103.3085077655618,0
3894,31.830193672418126,2,1,186,0.0106951871657754,0.0053475935828877,0.9946524064171123,187,5550,4000,1550,0.7207207207207207,71,40,31,195.858078168443,0.47307994556571403,0.7490768278807958,0.1133975945702167,1041512.7694512286,-2152.2621174778583,1039360.5073337507,2870,0,382.36898395721926,83,104,40,39.17366530935416,0.5432263814616756,44.184027777777786,8142.671940331288,98.1044812088107,0
3895,31.80924206744294,1,3,184,0.0053475935828877,0.016042780748663103,0.983957219251337,187,5300,3700,1600,0.6981132075471698,69,37,32,200.4807161327352,0.47320093726640217,0.755972339649351,0.11674273767531065,1042585.652263708,-896.3363608912355,1041689.3159028167,2871,0,383.3422459893048,85,102,35,38.83507585075847,0.5452317290552584,43.96802325581397,8144.1831252617785,95.81391912072681,0
3896,31.56625272307524,2,2,184,0.010752688172043012,0.010752688172043012,0.989247311827957,186,7150,5800,1350,0.8111888111888111,85,58,27,213.41934769109224,0.47263150247021213,0.7659960676486408,0.1199347403803723,1023728.0679078132,-653.3247068105643,1023074.7432010027,2872,0,385.4462365591398,74,112,40,39.88406864081731,0.5321460573476702,45.319444444444436,8039.31078031985,108.63933486918717,8
3897,31.492590975049136,6,6,184,0.031578947368421054,0.031578947368421054,0.968421052631579,190,6850,5200,1650,0.7591240875912408,85,52,33,208.90813325087322,0.4735281490763947,0.7675911448895707,0.11891153878098369,1025274.0093717527,-2012.3841263019967,1023261.6252454508,2873,0,377.0263157894737,82,108,41,39.49859417010951,0.5356907894736842,44.82931726907629,8035.98594006898,97.9998285374266,0
3898,31.512416053644934,4,1,187,0.02127659574468085,0.005319148936170213,0.9946808510638298,188,5050,3500,1550,0.693069306930693,66,35,31,209.15277403981636,0.473648405203474,0.7676273465610701,0.12033843031889326,1029208.081154218,402.34504752015073,1029610.4262017381,2874,0,379.3510638297872,72,116,40,39.07514934956172,0.5392287234042553,44.42066210045662,8053.922430605504,111.86003375840977,0
3899,31.843037328648563,4,0,191,0.020942408376963352,0.0,1.0,191,6200,4700,1500,0.7580645161290323,77,47,30,198.60165778114393,0.474656700652154,0.752308049176527,0.11298122812015055,1036508.1810675567,-3229.5513872536003,1033278.6296803032,2875,0,373.6910994764398,87,104,42,39.78354790071904,0.5367582897033158,44.85085227272723,8124.7238354523015,93.38763029255519,8
3900,32.252872651394576,2,2,191,0.010362694300518135,0.010362694300518135,0.9896373056994818,193,5300,3600,1700,0.6792452830188679,70,36,34,229.9312026532687,0.4749995502302821,0.7855083325848817,0.1303982718775996,1048872.2834865681,4333.693114349329,1053205.9766009175,2876,0,370.80829015544043,81,112,38,39.105565517699404,0.5360535405872193,44.96951219512195,8225.465845393768,101.54896105424405,8
3901,32.05787022978196,7,1,197,0.03535353535353535,0.005050505050505051,0.9949494949494949,198,6150,4600,1550,0.7479674796747967,77,46,31,201.88696169493002,0.47566560272778546,0.7729881122392424,0.11371741951470818,1040400.0103771166,-3741.3605915179187,1036658.6497855987,2877,0,362.3939393939394,75,123,44,40.0867943476078,0.5305660774410774,45.23026315789475,8167.375162159934,108.89833549546579,8
3902,32.368460149583605,5,2,200,0.024752475247524754,0.009900990099009901,0.9900990099009901,202,5950,4600,1350,0.773109243697479,73,46,27,206.72263445966558,0.47640099830878607,0.7837398591344285,0.1180209901771266,1054732.6454319449,-2742.57777713924,1051990.0676548057,2878,0,356.1831683168317,67,135,42,39.43775627562754,0.5340346534653465,44.71507352941176,8263.17996925261,123.33104431720312,0
3903,32.831571094232665,2,0,202,0.009900990099009901,0.0,1.0,202,6250,4800,1450,0.768,77,48,29,213.64112612560194,0.47617215079716924,0.7909989457576834,0.12308898226215773,1072726.0796319288,-814.3184646265308,1071911.7611673023,2879,0,357.15841584158414,68,134,42,38.907631055729425,0.5359942244224423,44.368961352657,8392.768619242777,123.42306793004084,0
3904,32.743049382267316,4,5,201,0.019417475728155338,0.024271844660194174,0.9757281553398058,206,7300,5500,1800,0.7534246575342466,91,55,36,208.82172690030683,0.4768657747257084,0.7897014051640829,0.1216139170149664,1073228.7461339463,-3677.3039746514555,1069551.4421592948,2880,0,351.20388349514565,77,129,40,38.61708046456638,0.5389360841423948,43.963675213675224,8383.410026132893,108.87545488484277,0
3905,33.11326088107931,2,2,201,0.009852216748768473,0.009852216748768473,0.9901477832512315,203,6450,4900,1550,0.7596899224806202,80,49,31,209.5818370432504,0.4767737241704466,0.7881744088572236,0.12258835526358186,1086744.4965345385,-1497.618403929513,1085246.878130609,2881,0,357.04926108374383,81,122,42,38.431343382255726,0.5411535303776683,43.800813008130106,8483.590516382275,104.7356853874355,0
3906,33.06175245911075,1,1,201,0.0049504950495049506,0.0049504950495049506,0.995049504950495,202,6250,4100,2150,0.656,84,41,43,210.0393586355525,0.47678275290215594,0.7839546622707769,0.12018228390566847,1078039.4879454775,-1363.8554736264023,1076675.632471851,2882,0,357.7227722772277,70,132,36,39.266512505266384,0.5324876237623762,44.630281690140855,8442.970412313427,120.61386303304896,8
3907,32.70586441252871,1,5,197,0.0049504950495049506,0.024752475247524754,0.9752475247524752,202,7900,6300,1600,0.7974683544303798,95,63,32,203.81300727074617,0.47668731425381344,0.7759345812240201,0.11681588218366945,1066968.3670173897,-4807.593691085538,1062160.7733263043,2883,0,358.6930693069307,73,129,37,39.36037326867261,0.5377475247524752,44.566441441441455,8354.175332625964,114.44075798117758,8
3908,32.33915761974422,1,0,198,0.005050505050505051,0.0,1.0,198,6100,4400,1700,0.7213114754098361,78,44,34,205.3565024531774,0.4760838076193406,0.7722817167133977,0.1177300646760713,1055083.8488466532,-2366.334201202689,1052717.5146454505,2884,0,365.1060606060606,70,128,40,39.31123523443035,0.5384048821548821,44.556924882629126,8260.813869092859,118.01162670132656,8
3909,32.30572231596306,3,1,200,0.014925373134328358,0.004975124378109453,0.9950248756218906,201,6550,4300,2250,0.6564885496183206,88,43,45,190.08540176836627,0.47663660862354895,0.7601970564929916,0.1086607595183356,1053087.5779569661,-6714.684929354495,1046372.8930276117,2885,0,360.64179104477614,74,127,39,39.8131527415144,0.5385572139303483,44.6666666666667,8248.727764675976,111.46929411724291,8
3910,32.415518673366584,0,2,198,0.0,0.01,0.99,200,6200,4400,1800,0.7096774193548387,80,44,36,190.85869173010985,0.4763981365159129,0.7613956232568118,0.10969079681307596,1058355.3688889206,-5800.735781664342,1052554.6331072564,2886,1,362.67,75,125,45,39.58556818994496,0.53984375,44.46271929824563,8283.373494329076,110.44497992438768,0
3911,32.54034766632306,4,2,200,0.019801980198019802,0.009900990099009901,0.9900990099009901,202,6650,4700,1950,0.706766917293233,86,47,39,216.31212355958502,0.47720042526640727,0.7902542943101771,0.12408250016526484,1061829.8424490464,-1112.6663841812428,1060717.1760648652,2887,0,357.9504950495049,68,134,41,39.00900701256747,0.5378506600660067,44.53502415458939,8312.919130578519,122.24881074380176,8
3912,32.91151340934461,1,3,198,0.004975124378109453,0.014925373134328358,0.9850746268656716,201,6450,4900,1550,0.7596899224806202,80,49,31,222.76122550801847,0.4767786069651741,0.7847823390038509,0.12696963924271615,1071904.5743652731,1105.755322651963,1073010.329687925,2888,0,360.70646766169153,72,129,39,39.09202728390921,0.532960199004975,44.777397260273986,8399.762112436358,116.66336267272719,8
3913,32.52833129074842,0,1,197,0.0,0.005050505050505051,0.9949494949494949,198,6800,5200,1600,0.7647058823529411,84,52,32,220.53660154276955,0.47625098275478983,0.7770138312811414,0.1261079461860594,1060444.2655438092,373.35488971031464,1060817.6204335194,2889,1,361.7676767676768,75,123,35,39.02330470567183,0.5348800505050505,44.65460526315791,8305.95959356697,110.74612791422626,0
3914,32.24663033017509,0,2,195,0.0,0.01015228426395939,0.9898477157360406,197,7050,5400,1650,0.7659574468085106,87,54,33,256.4496012562911,0.4759131444455955,0.8131801142199604,0.14508088497202654,1047897.2544888243,7296.566614244259,1055193.8211030685,2890,2,364.2741116751269,68,129,33,38.52556700420441,0.528923434856176,45.06340579710145,8220.846110894738,120.89479574845203,8
3915,31.748208365793957,4,2,197,0.020100502512562814,0.010050251256281407,0.9899497487437185,199,6050,4500,1550,0.743801652892562,76,45,31,246.80073877474132,0.476580080537367,0.808744538649731,0.14104726158991748,1034838.9283184473,5229.8024043710875,1040068.7307228184,2891,0,361.51256281407035,62,137,37,38.37450891508013,0.5318257956448911,44.675925925925945,8106.081904507149,130.74325652430886,0
3916,32.23671471761347,0,2,195,0.0,0.01015228426395939,0.9898477157360406,197,6300,4800,1500,0.7619047619047619,78,48,30,245.81650112246805,0.47613544148623915,0.805414127189717,0.14136443358817236,1052712.03829713,6054.797988740737,1058766.8362858708,2892,1,366.11167512690355,64,133,35,38.15699400096154,0.5334708121827412,44.43910256410259,8238.44374361835,128.72568349403673,0
3917,32.38158266180991,3,4,194,0.015151515151515152,0.020202020202020204,0.9797979797979798,198,5650,3900,1750,0.6902654867256637,74,39,35,206.02288746182134,0.4765789237553197,0.7695628854920895,0.11525042714448443,1048718.724658742,-2037.9880421052922,1046680.7366166367,2893,0,364.8030303030303,73,125,44,40.2521202064897,0.5268834175084175,45.495495495495504,8241.258650415602,112.89395411528223,8
3918,31.963006009449128,2,2,194,0.01020408163265306,0.01020408163265306,0.9897959183673469,196,5850,4000,1850,0.6837606837606838,77,40,37,200.37547921108813,0.47696341357055644,0.7607528492055171,0.11289909605402053,1037412.8860942192,-3475.579161822644,1033937.3069323965,2894,0,368.60714285714283,77,119,45,40.11383093965126,0.5298681972789115,45.21901709401709,8143.5660877172795,105.76059854178285,0
3919,32.38076464049167,3,2,195,0.015228426395939087,0.01015228426395939,0.9898477157360406,197,5950,4300,1650,0.7226890756302521,76,43,33,200.9091051945155,0.4773073569529334,0.7615097003947684,0.11435845259840076,1054189.425563078,-2990.7491609204644,1051198.6764021574,2895,0,367.28934010152284,82,115,41,39.70270591514205,0.532307529610829,44.8293172690763,8262.621820663588,100.76368073979985,0
3920,32.71125252881305,3,2,196,0.015151515151515152,0.010101010101010102,0.98989898989899,198,5950,4600,1350,0.773109243697479,73,46,27,215.20746086674006,0.4773891623510913,0.7832598929340218,0.1227662417125126,1065646.775728147,317.0273570566101,1065963.8030852035,2896,0,366.2878787878788,67,131,38,39.25244803856848,0.5368265993265993,44.74571078431373,8349.687513597004,124.62220169547767,8
3921,32.56467259727034,1,1,196,0.005076142131979695,0.005076142131979695,0.9949238578680203,197,5700,3700,2000,0.6491228070175439,77,37,40,212.56864382711348,0.47702786698435723,0.7794720925552754,0.12225768821270426,1063456.4407788373,111.49867711343995,1063567.9394559506,2897,0,368.47715736040607,72,125,38,39.00241950493207,0.5387055837563453,44.434931506849324,8322.39278277844,115.58878864970055,0
3922,32.41325043597299,0,1,195,0.0,0.00510204081632653,0.9948979591836735,196,5600,3600,2000,0.6428571428571429,76,36,40,217.31349227184526,0.47649954212454215,0.782104798979872,0.12543691093479784,1059637.9113344601,1254.7230111473737,1060892.6343456076,2898,1,371.3469387755102,73,123,39,38.7422584640793,0.5399128401360545,44.298986486486505,8288.10098774567,113.53562996911877,0
3923,32.55544182868053,1,4,192,0.00510204081632653,0.02040816326530612,0.9795918367346939,196,6550,5000,1550,0.7633587786259542,81,50,31,208.5851924696913,0.47645538984824704,0.7714533222329711,0.11928547892182306,1061358.8804541351,-1473.2507282113293,1059885.6297259238,2899,0,372.234693877551,73,123,38,39.324696802646095,0.5397534013605443,44.65090090090093,8313.002741726767,113.87674988666804,8
3924,32.73135901714027,5,4,193,0.025380710659898477,0.02030456852791878,0.9796954314720813,197,5800,3900,1900,0.6724137931034483,77,39,38,207.2556997107758,0.47713146172174453,0.7754043590230115,0.1184374253734741,1066858.770043247,-977.4878244215674,1065881.2822188253,2900,0,370.23857868020303,73,124,38,39.38738192376964,0.5410850253807107,44.67905405405407,8357.00154635266,114.47947323770767,8
3925,32.25653610730522,2,4,191,0.010256410256410256,0.020512820512820513,0.9794871794871794,195,5050,3400,1650,0.6732673267326733,67,34,33,233.304288752362,0.4769418010397392,0.7895345596432553,0.1341499660326088,1053315.283997812,5098.594633020546,1058413.8786308325,2901,0,373.4871794871795,74,121,41,38.48222373188408,0.5423076923076924,44.444444444444464,8243.337005200268,111.39644601621984,8
3926,31.78408141853514,2,0,193,0.010362694300518135,0.0,1.0,193,6300,4600,1700,0.7301587301587301,80,46,34,226.70861637219406,0.4763196243523316,0.7806402868608158,0.1271274287769553,1030118.0352558725,1807.3268945801465,1031925.3621504527,2902,0,378.1295336787565,74,119,36,39.630839379557344,0.5333009499136443,45.40277777777776,8092.13884004395,109.35322756816149,7
3927,31.68119882723416,3,2,194,0.015306122448979591,0.01020408163265306,0.9897959183673469,196,5700,4100,1600,0.7192982456140351,73,41,32,241.80500431568046,0.4768107884179313,0.7942493736354099,0.1349830983018269,1025381.3295897174,4688.4673653318305,1030069.7969550493,2903,0,373.3265306122449,68,128,38,39.424607883858464,0.5285926870748299,45.57669082125603,8060.435444374637,118.53581535845055,8
3928,31.65394167238011,4,2,196,0.020202020202020204,0.010101010101010102,0.98989898989899,198,6400,4600,1800,0.71875,82,46,36,207.61290556744416,0.4774612666427387,0.7771006651619734,0.1172354078052421,1028064.8646073503,-3312.093269413486,1024752.7713379369,2904,0,370.4191919191919,75,123,37,39.84297974365871,0.532354797979798,45.134320175438596,8067.503363458164,107.56671151277553,8
3929,31.856778272643805,2,0,198,0.010101010101010102,0.0,1.0,198,5450,4100,1350,0.7522935779816514,68,41,27,230.6076141878628,0.4775258934522894,0.8006668507960846,0.13151253466989749,1037718.9011449207,2811.1759981361492,1040530.0771430569,2905,0,371.4040404040404,59,139,41,38.87084523647572,0.5343013468013468,44.75694444444444,8131.2214264654385,137.81731231297354,8
3930,31.636278733288012,3,2,199,0.014925373134328358,0.009950248756218905,0.9900497512437811,201,5500,3900,1600,0.7090909090909091,71,39,32,234.5706558048417,0.4778389303482587,0.7996392964013843,0.13209383972035382,1026639.453217369,2463.8979632643595,1029103.3511806334,2906,0,366.8457711442786,78,123,42,39.26405638079467,0.5301616915422885,45.23997890295358,8059.659037524482,103.32896201954465,8
3931,31.18948860305524,4,1,202,0.019704433497536946,0.0049261083743842365,0.9950738916256158,203,5400,3700,1700,0.6851851851851852,71,37,34,225.46739177081835,0.4784696142027996,0.7992672342825338,0.12513680613634187,1007689.3791401848,-559.7807940211715,1007129.5983461636,2907,0,362.320197044335,63,140,39,40.069417765825776,0.5259133825944171,45.80078125000002,7928.343636108716,125.84672438267803,8
3932,31.463174779340136,5,3,204,0.024154589371980676,0.014492753623188406,0.9855072463768116,207,6800,5100,1700,0.75,85,51,34,189.46441000362321,0.47888623110235606,0.7686512457017483,0.1058228046117797,1018494.0423477616,-9606.325434875334,1008887.7169128862,2908,0,356.2608695652174,74,133,43,40.734738901018936,0.5284319645732689,45.55555555555555,8005.630027187645,108.1841895565898,6
3933,31.685019313880886,5,6,203,0.023923444976076555,0.028708133971291867,0.9712918660287081,209,6450,4200,2250,0.6511627906976745,87,42,45,202.6606305469618,0.47961523125996813,0.7831582978466094,0.11290337344552442,1024875.7157172224,-6709.6082440955615,1018166.1074731268,2909,0,353.7751196172249,69,140,43,40.5001852718621,0.5296551036682615,45.654761904761926,8058.9337814413,116.79614176001884,8
3934,31.21357328993691,5,5,203,0.02403846153846154,0.02403846153846154,0.9759615384615384,208,7350,5000,2350,0.6802721088435374,97,50,47,197.73136038903658,0.4798663368636195,0.7727147625205351,0.11130606757449221,1012805.5988199653,-8897.314227139686,1003908.2845928256,2910,0,354.1442307692308,80,128,45,40.217514766015455,0.5306490384615384,45.25462962962959,7951.513288327577,99.39391610409471,8
3935,31.56207108656391,3,4,202,0.014563106796116505,0.019417475728155338,0.9805825242718447,206,6250,4700,1550,0.752,78,47,31,192.85507500414255,0.47967085010655935,0.7639712781535744,0.10765927776190495,1021530.1775017257,-8048.5441997824455,1013481.6333019433,2911,0,356.5728155339806,80,126,41,40.66943826661271,0.5279126213592233,45.57613168724276,8030.14421780572,100.3768027225715,8
3936,31.36933551141854,7,4,205,0.03349282296650718,0.019138755980861243,0.9808612440191388,209,5750,4100,1650,0.7130434782608696,74,41,33,187.7334169183082,0.4806724251625567,0.7636566889014096,0.10644668318008128,1020080.6954359656,-9249.353102680818,1010831.3423332848,2912,0,351.7751196172249,89,120,40,40.189215152340324,0.5323464912280702,44.97685185185182,7999.906697437362,89.88659210603777,0
3937,31.863116451761968,0,3,202,0.0,0.014634146341463415,0.9853658536585366,205,6900,5000,1900,0.7246376811594203,88,50,38,184.59284137278047,0.48003845847282006,0.7543726756257265,0.10736112482453877,1043981.2182645347,-9357.708116146585,1034623.5101483881,2913,1,359.14146341463413,86,119,35,39.288080760835655,0.5435975609756097,44.013409961685824,8156.530528480256,94.84337823814252,8
3938,31.785703556487864,0,2,200,0.0,0.009900990099009901,0.9900990099009901,202,5900,4200,1700,0.711864406779661,76,42,34,187.38983050847463,0.479469402164097,0.7540157744588012,0.10924901185770747,1042175.6139697243,-7241.377667629586,1034934.2363020947,2914,2,365.41584158415844,89,113,36,39.12499999999998,0.5451732673267327,43.92361111111111,8139.568185038117,91.45582230379907,0
3939,31.30465756826425,2,3,199,0.009900990099009901,0.01485148514851485,0.9851485148514851,202,7100,5300,1800,0.7464788732394366,89,53,36,184.65882148723915,0.47915332578033926,0.752392229963736,0.10838669956859703,1028430.2310596358,-9518.257110135644,1018911.9739495001,2915,0,366.38613861386136,78,124,39,38.937542866940994,0.5472359735973598,43.67088607594937,8024.295136169011,102.87557866883347,0
3940,31.07841801101452,1,1,199,0.005,0.005,0.995,200,6700,5100,1600,0.7611940298507462,83,51,32,195.5183386709274,0.4786814279731993,0.7628184070471662,0.11109274529904827,1011253.4753940033,-7156.280103152966,1004097.1952908504,2916,0,370.85,88,112,39,39.90927234354924,0.53640625,44.89700374531832,7928.197553465189,90.09315401664988,8
3941,31.2008952322873,3,2,200,0.01485148514851485,0.009900990099009901,0.9900990099009901,202,6050,3900,2150,0.6446280991735537,82,39,43,210.9346453909829,0.47902094313909,0.7811703009556696,0.12316103916551052,1023452.0405882888,-3273.7013487659606,1020178.3392395228,2917,0,368.14356435643566,79,123,38,38.46445910223173,0.5430074257425743,43.86718750000002,7991.57304836364,101.15915251093215,8
3942,30.99844357273489,3,6,197,0.014778325123152709,0.029556650246305417,0.9704433497536946,203,6650,4700,1950,0.706766917293233,86,47,39,202.07121642230643,0.47923779446910203,0.7780074177783789,0.11535252713593044,1010056.712832964,-6429.322276465257,1003627.3905564988,2918,0,367.0935960591133,71,132,38,39.560841125909135,0.5351498357963875,44.71932870370372,7913.303484388153,111.45497865335427,8
3943,31.323454823148445,3,5,195,0.015,0.025,0.975,200,6800,5200,1600,0.7647058823529411,84,52,32,190.38440363167427,0.47882956448911224,0.7625844071114019,0.10919053121289046,1022068.0437704487,-7882.837003154167,1014185.2067672944,2919,0,370.175,74,126,46,39.67813842222587,0.5340625,44.54166666666668,8001.837563363487,108.13294004545253,8
3944,31.09436505628139,2,5,192,0.01015228426395939,0.025380710659898477,0.9746192893401016,197,6350,4100,2250,0.6456692913385826,86,41,45,199.41358102835602,0.4781587762008357,0.7694213932691605,0.11322734737286587,1011562.0241416937,-5406.1588667225915,1006155.8652749711,2920,0,370.2741116751269,78,119,39,39.836951839407284,0.5315672588832487,44.92352320675105,7931.441086679353,101.68514213691479,8
3945,31.016832758109455,2,4,190,0.010309278350515464,0.020618556701030927,0.979381443298969,194,6900,5600,1300,0.8115942028985508,82,56,26,207.18733539520534,0.4773321626337625,0.7705435492002806,0.11451996498710129,1000853.2641976345,-4227.17581385955,996626.088383775,2921,0,376.57216494845363,81,113,39,40.69698636530318,0.5227126288659794,45.960365853658544,7879.504846248404,97.27783760800499,8
3946,31.244097768294147,0,3,187,0.0,0.015789473684210527,0.9842105263157894,190,5100,3300,1800,0.6470588235294118,69,33,36,208.00029806534613,0.4766946300937529,0.7668745456927162,0.11516168893966548,1008702.8801997429,-1137.900051815901,1007564.980147927,2427,1,369.89473684210526,83,107,39,40.609952743480896,0.5250548245614035,45.89533730158731,7939.270924728638,95.65386656299565,0
3947,30.841176888051535,1,1,187,0.005319148936170213,0.005319148936170213,0.9946808510638298,188,5750,3900,1850,0.6782608695652174,76,39,37,226.24387036413256,0.4768555391208708,0.780728070553594,0.12246041597276877,988760.4074790021,1390.1962901730722,990150.6037691752,2428,0,373.75531914893617,66,122,37,41.052807965453,0.5154033687943262,46.78171641791043,7809.549875243988,118.32651326127255,8
3948,30.687583029963236,3,1,189,0.015789473684210527,0.005263157894736842,0.9947368421052631,190,6700,5100,1600,0.7611940298507462,83,51,32,212.44890088462375,0.47712510442773604,0.7649597334073861,0.11566805141904032,985628.0049293278,-2820.882734331807,982807.122194996,2429,0,359.4947368421053,73,117,39,41.1667476626863,0.5199013157894736,46.55123873873875,7777.729905046315,106.54424527460706,8
3949,30.323129050649314,6,4,191,0.03076923076923077,0.020512820512820513,0.9794871794871794,195,7400,5800,1600,0.7837837837837838,90,58,32,199.97543270805434,0.47798704731694425,0.7547227525610205,0.11003053544156917,977099.2721375831,-7320.830051112005,969778.4420864711,2430,0,349.91282051282053,81,114,37,41.0615992794235,0.5237713675213675,46.138211382113845,7697.8837772888855,95.03560218875167,0
3950,30.220951371060888,5,2,194,0.025510204081632654,0.01020408163265306,0.9897959183673469,196,5250,3400,1850,0.6476190476190476,71,34,37,198.3560021945454,0.47848966509680796,0.756587389687247,0.10975768551925591,975496.0702834461,-5750.899868417175,969745.1704150289,2431,0,349.1020408163265,85,111,43,40.878253563426625,0.5255102040816326,45.91812015503877,7678.5961350623365,90.33642511838043,0
3951,30.22203710148927,6,1,199,0.03,0.005,0.995,200,6050,4200,1850,0.6942148760330579,79,42,37,190.83202442109874,0.47928706030150753,0.7545116637440912,0.10697848875724257,979406.3305439412,-8669.581442292341,970736.7491016489,2432,0,343.065,76,124,49,40.55564411853273,0.5288541666666666,45.41396103896102,7694.108715001661,101.23827256581133,0
3952,30.685172356438294,4,6,197,0.019704433497536946,0.029556650246305417,0.9704433497536946,203,6850,4700,2150,0.6861313868613139,90,47,43,203.39874430216403,0.47949487066933294,0.7788394149174871,0.11355461324755076,993173.7902906158,-7047.939636213734,986125.850654402,2433,0,338.2167487684729,71,132,45,40.39790174002049,0.5320710180623973,45.57291666666666,7807.1389042292,109.95970287646762,8
3953,30.818735631966668,5,2,200,0.024752475247524754,0.009900990099009901,0.9900990099009901,202,5650,3900,1750,0.6902654867256637,74,39,35,190.40565328125243,0.4797557181091243,0.7618041924674406,0.10409602481783413,991108.8982254142,-8307.452552105577,982801.4456733087,2434,0,340.68811881188117,74,128,43,41.55998995983939,0.5222772277227723,46.38888888888888,7815.973786662631,105.62126738733285,8
3954,31.012651323735692,4,1,203,0.0196078431372549,0.004901960784313725,0.9950980392156863,204,6250,4600,1650,0.736,79,46,33,206.74856970344956,0.4796652137866641,0.7748074546586765,0.11187988050648943,994179.6974716387,-5940.953903905655,988238.743567733,2435,0,338.11764705882354,74,130,37,41.556620591300565,0.5181270424836601,46.79166666666671,7852.661753930996,106.11705072879725,7
3955,31.229656659229274,10,9,204,0.046948356807511735,0.04225352112676056,0.9577464788732395,213,6400,4100,2300,0.640625,87,41,46,212.84443283591264,0.4810702527534178,0.78944929227472,0.11722572827477025,1006612.3815687182,-6149.631711879574,1000462.7498568386,2436,0,324.69953051643193,81,132,36,40.69598363936561,0.5218114241001566,46.10010162601628,7929.206652032772,97.89144014855273,8
3956,30.944475574096156,3,7,200,0.014492753623188406,0.033816425120772944,0.966183574879227,207,5950,4100,1850,0.6890756302521008,78,41,37,223.95788921932942,0.4802336897894095,0.8005984290517443,0.12130751022454783,992287.5477840652,-2903.875059931311,989383.6727241339,2437,0,334.951690821256,68,139,37,41.0825881768505,0.5130837359098228,46.75422705314009,7836.557635197196,115.24349463525289,8
3957,31.10280459901818,6,4,202,0.02912621359223301,0.019417475728155338,0.9805825242718447,206,7000,4800,2200,0.6857142857142857,92,48,44,221.12350448790215,0.4809692951298445,0.7980635480070539,0.12146377729464464,1001708.0382095905,-3899.761623478931,997808.2765861115,2438,0,336.86407766990294,75,131,35,40.59135974149878,0.51709142394822,46.20339912280701,7893.786084978314,105.25048113304419,0
3958,31.013876341497944,6,2,206,0.028846153846153848,0.009615384615384616,0.9903846153846154,208,6100,4100,2000,0.6721311475409836,81,41,40,225.09983688455532,0.48086503623188404,0.8055204170030115,0.12545863947331828,1003299.1546681133,-2531.504787558827,1000767.6498805545,2439,0,334.0432692307692,63,145,40,39.9123368313284,0.5205328525641026,45.63802083333335,7888.75096785371,125.21826933101127,0
3959,30.69453036056706,6,7,205,0.02830188679245283,0.0330188679245283,0.9669811320754716,212,6700,5000,1700,0.746268656716418,84,50,34,217.527099674623,0.4820016058600853,0.8025572278768569,0.12068004703348945,991572.9861582568,-5961.200841057708,985611.7853171991,2440,0,326.74056603773585,62,150,43,40.2876254905787,0.522061713836478,45.81679894179896,7802.033982027109,125.8392577746308,8
3960,30.346819495514584,2,0,207,0.00966183574879227,0.0,1.0,207,6750,4400,2350,0.6518518518518519,91,44,47,208.71404936404235,0.4814599846786423,0.7885511753101284,0.11679972819749329,982932.2523759812,-7119.645871217908,975812.6065047632,2441,0,334.64251207729467,67,140,45,40.16883589126294,0.5252616747181964,45.4810049019608,7723.842002419989,115.28122391671624,0
3961,30.48503022130619,3,2,208,0.014285714285714285,0.009523809523809525,0.9904761904761905,210,6250,4000,2250,0.64,85,40,45,215.88115339679874,0.4822207032733348,0.7961096630948923,0.11888957299508009,982589.1725236621,-5825.5032240767,976763.6692995854,2442,0,330.84761904761905,84,126,37,40.621782186182706,0.5211309523809524,46.102941176470615,7740.059511336117,92.14356561114425,8
3962,30.6838640193693,2,3,207,0.009523809523809525,0.014285714285714285,0.9857142857142858,210,6800,5300,1500,0.7794117647058824,83,53,30,219.77676161672844,0.4821931723247513,0.7926094357358799,0.12345701604104607,994988.5491153741,-5064.927765938896,989923.6213494352,2443,0,331.8142857142857,68,142,40,39.73820321299427,0.527281746031746,45.335144927536255,7814.101783555918,114.91326152288114,8
3963,30.48111437412313,4,3,208,0.018957345971563982,0.014218009478672985,0.985781990521327,211,6950,5200,1750,0.7482014388489209,87,52,35,212.13498570675085,0.48254908598510493,0.785125712002082,0.12030465343022012,991251.618646077,-7094.1704093440385,984157.448236733,2444,0,326.2369668246445,75,136,39,39.559764694290685,0.5304107424960506,44.969846491228076,7773.603277951071,103.64804370601428,0
3964,30.55846019181287,3,4,207,0.014218009478672985,0.018957345971563982,0.981042654028436,211,6450,4400,2050,0.6821705426356589,85,44,41,206.00291465869373,0.4827747686752426,0.7793651953096465,0.11773119941375182,996058.8588686768,-7611.794380287637,988447.0644883892,2445,0,327.13270142180096,71,140,40,39.41617558174677,0.5326816745655608,44.67592592592596,7802.310553604142,109.89169793808651,0
3965,30.69125486315728,4,4,207,0.018957345971563982,0.018957345971563982,0.981042654028436,211,6100,3800,2300,0.6229508196721312,84,38,46,209.4127446897121,0.48296753930640185,0.7888577231840592,0.11931656383483623,999480.5626958658,-6439.206420368109,993041.3562754976,2446,0,327.25592417061614,79,132,43,39.44727891156458,0.5318424170616114,44.79166666666667,7832.6640015349485,99.14764558904999,8
3966,31.07897236093161,2,3,206,0.009569377990430622,0.014354066985645933,0.9856459330143541,209,6400,4600,1800,0.71875,82,46,36,208.349744046966,0.48271780303030304,0.7836425248406176,0.11944607815613288,1013969.5709560032,-5947.939883980615,1008021.6310720225,2447,0,331.1913875598086,70,139,43,39.234774950701706,0.5344397926634769,44.55692488262914,7938.9082713642165,113.41297530520309,0
3967,31.392960305573972,2,1,207,0.009615384615384616,0.004807692307692308,0.9951923076923077,208,6550,4400,2150,0.6717557251908397,87,44,43,208.21613060484611,0.48285420924687233,0.7852539858023975,0.11803676014562896,1020787.1627853992,-5641.1293587449845,1015146.0334266543,2448,0,333.6394230769231,80,128,40,39.67473524962182,0.5297976762820513,44.98456790123457,8005.68933718534,100.07111671481675,8
3968,30.947892809743895,3,1,209,0.014285714285714285,0.004761904761904762,0.9952380952380953,210,6400,4500,1900,0.703125,83,45,38,193.21806314600644,0.4827186337054758,0.773114126839384,0.1110066055849318,1010329.5068527875,-9357.217909328536,1000972.2889434589,2449,0,331.29047619047617,75,135,41,39.53924842210661,0.5351686507936508,44.47642543859653,7907.916195889007,105.43888261185343,8
3969,30.78783320354973,1,1,209,0.004761904761904762,0.004761904761904762,0.9952380952380953,210,6200,4300,1900,0.6935483870967742,81,43,38,194.21577946534848,0.4822377914483178,0.7735037349367999,0.11051889121991998,1002249.4260905383,-9269.469298625976,992979.9567919123,2450,0,332.26190476190476,86,124,39,39.883941000735135,0.5320436507936508,44.83955938697315,7855.837085738046,91.34694285741914,8
3970,31.343093188895104,3,5,207,0.014150943396226415,0.02358490566037736,0.9764150943396226,212,6550,5000,1550,0.7633587786259542,81,50,31,181.3436880517351,0.4819657441354437,0.7468767672613255,0.10238943617690208,1017932.5517262407,-12030.871376410101,1005901.6803498305,2451,0,330.0660377358491,95,117,37,40.51714350590372,0.5323309748427674,45.13888888888887,7988.135555780852,84.08563742927213,8
3971,31.265151326039486,2,2,207,0.009569377990430622,0.009569377990430622,0.9904306220095693,209,6800,4400,2400,0.6470588235294118,92,44,48,189.1678676523905,0.4813347288676236,0.7575276877923978,0.10750889626675017,1017398.8396478745,-10108.16619035934,1007290.6734575151,2452,0,333.35406698564594,96,113,42,40.06242282651397,0.5347388357256778,44.88831615120273,7976.105400573334,83.08443125597223,0
3972,31.744033323856154,3,4,206,0.014285714285714285,0.01904761904761905,0.9809523809523809,210,5750,3600,2150,0.6260869565217392,79,36,43,186.33036412039564,0.48139714817346396,0.7563688640680588,0.10673385472947804,1035412.2439915534,-9164.251912467531,1026247.9920790859,2453,0,332.54761904761904,81,129,44,39.82932126396766,0.5374503968253967,44.588414634146346,8107.7938771526,100.09622070558765,0
3973,31.70207550598051,1,4,203,0.004830917874396135,0.01932367149758454,0.9806763285024155,207,7250,5300,1950,0.7310344827586207,92,53,39,180.19402559753598,0.48107988211935027,0.7436436214209694,0.10370994511810727,1035500.777236803,-11331.789288064681,1024168.9879487383,2454,0,336.4009661835749,86,121,44,39.80291922362238,0.5394524959742351,44.40852490421456,8102.780242171527,94.21837490897124,0
3974,31.39646215615087,0,1,202,0.0,0.0049261083743842365,0.9950738916256158,203,6500,4700,1800,0.7230769230769231,83,47,36,178.64750709505643,0.48030674372856,0.7356274795653264,0.10314827244756941,1026485.7462367308,-10424.17607324,1016061.5701634908,2455,1,343.4729064039409,90,113,47,39.71977259501315,0.5414614121510672,44.28800366300366,8028.452015868284,89.2050223985365,0
3975,30.993248604923377,0,5,197,0.0,0.024752475247524754,0.9752475247524752,202,5850,4200,1650,0.717948717948718,75,42,33,202.5259628528234,0.4800292062788369,0.7693607091067978,0.1169116840432592,1013242.4769237586,-5208.418351527246,1008034.0585722313,2456,2,346.14356435643566,83,119,39,39.11695764629812,0.5424401815181519,44.295634920634924,7925.108956268856,95.48324043697417,8
3976,30.57269608133142,0,6,191,0.0,0.030456852791878174,0.9695431472081218,197,5600,3700,1900,0.6607142857142857,75,37,38,202.38061217124573,0.47950119133947994,0.7645241008615316,0.11731855245624037,1000729.477313546,-4494.35115269467,996235.1261608513,2457,3,347.53807106598987,85,112,33,38.959437922110745,0.544257614213198,44.13759689922481,7822.403488639117,92.02827633693079,0
3977,30.707243176513042,1,2,190,0.005208333333333333,0.010416666666666666,0.9895833333333334,192,6000,4400,1600,0.7333333333333333,76,44,32,187.7863877232356,0.4786786694662595,0.7488845759915879,0.1075036144911228,1001416.7007230475,-6789.51503309957,994627.1856899479,2458,0,356.6510416666667,74,118,43,39.81525542020156,0.5388997395833333,44.61111111111112,7842.2887156906045,105.97687453635952,8
3978,30.394737646323314,2,2,190,0.010416666666666666,0.010416666666666666,0.9895833333333334,192,5750,4100,1650,0.7130434782608696,74,41,33,185.09983036577393,0.4787229812027341,0.7444175093067704,0.10664969356553253,993118.9574556899,-7384.769888383352,985734.1875673066,2459,0,354.3645833333333,80,112,40,39.635526712948995,0.5413953993055556,44.3672839506173,7769.889338138088,97.1236167267261,0
3979,30.810753293018347,0,1,189,0.0,0.005263157894736842,0.9947368421052631,190,5300,3900,1400,0.7358490566037735,67,39,28,181.62979763950995,0.47845191682910976,0.7364236974082761,0.10520110712286762,1008272.5733239187,-6673.5313083415385,1001599.0420155772,2460,1,358.62631578947367,81,109,36,39.522557806577666,0.543421052631579,44.16920731707319,7882.339438111017,97.31283256927182,0
3980,31.054782112236925,1,2,188,0.005263157894736842,0.010526315789473684,0.9894736842105263,190,5950,4100,1850,0.6890756302521008,78,41,37,177.35897301741417,0.4781809848695813,0.7337387709225835,0.1016745364541852,1013166.5677447708,-8011.163609841693,1005155.4041349291,2461,0,359.5263157894737,75,115,45,40.028180948292835,0.540186403508772,44.55866228070177,7932.675085331167,105.76900113774889,8
3981,31.51665422389817,2,1,189,0.010526315789473684,0.005263157894736842,0.9947368421052631,190,5500,3800,1700,0.6909090909090909,72,38,34,174.4227044022542,0.4779692286271234,0.7290706399399716,0.10075476219000885,1030553.7268000839,-7549.606387941186,1023004.1204121427,2462,0,359.96315789473687,77,113,48,39.810336048879876,0.5426535087719297,44.270833333333364,8059.727720799028,104.67178858180556,0
3982,31.144523213885854,4,3,190,0.02072538860103627,0.015544041450777202,0.9844559585492227,193,6350,4800,1550,0.7559055118110236,79,48,31,189.08298813093268,0.4784110535405872,0.7458817172605439,0.10732370792617671,1013086.5864032683,-6638.512201500953,1006448.0742017673,2463,0,355.25906735751295,85,108,41,40.11420837686385,0.5334628670120898,44.93701550387595,7943.815041642494,93.45664754873522,8
3983,31.22423182891868,2,3,189,0.010416666666666666,0.015625,0.984375,192,5550,4100,1450,0.7387387387387387,70,41,29,216.82166125426988,0.4782542993746364,0.7745678291654119,0.12037990861541038,1008918.2759789472,-198.93266649002362,1008719.3433124572,2464,0,357.4791666666667,67,125,40,40.275497137692085,0.5270182291666667,45.7873774509804,7937.593860308005,118.47155015385081,8
3984,31.328439267075144,3,2,190,0.015625,0.010416666666666666,0.9895833333333334,192,6150,4300,1850,0.6991869918699187,80,43,37,241.12683187489432,0.47849630962769046,0.7963637008912254,0.13336293029631183,1011101.8715692253,4210.758198852432,1015312.6297680777,2465,0,358.390625,70,122,39,39.809868914939074,0.5197482638888888,45.936032863849746,7959.427564377015,113.70610806252878,8
3985,31.3569082438177,7,3,194,0.03553299492385787,0.015228426395939087,0.9847715736040609,197,5500,3600,1900,0.6545454545454545,74,36,38,196.04823475352325,0.4793091094305743,0.7631253724822047,0.10994758538645828,1016309.8995863984,-5050.8476447114535,1011259.0519416869,2466,0,350.2233502538071,78,119,39,40.406783537901106,0.5249576988155669,45.39820675105483,7983.525069618566,102.35288550793032,8
3986,31.219934175308723,2,1,195,0.01020408163265306,0.00510204081632653,0.9948979591836735,196,6400,4600,1800,0.71875,82,46,36,196.90658688898915,0.4792767748124891,0.7634074166003766,0.11115193995967583,1013865.3217344788,-5672.647986431651,1008192.6737480472,2467,0,352.4183673469388,81,115,36,40.12914132854815,0.5290178571428572,45.147357723577215,7956.482716273369,98.22818168238727,0
3987,31.48410853011706,3,5,193,0.015151515151515152,0.025252525252525252,0.9747474747474747,198,6250,4300,1950,0.688,82,43,39,195.80538475493844,0.4792435779110906,0.7656224752868801,0.1114572288741493,1025008.4061594858,-5709.566930979309,1019298.8392285065,2468,0,349.7070707070707,85,113,43,39.831598787993855,0.531986531986532,44.828003875968975,8033.862819815555,94.51603317430065,0
3988,31.48571217529581,4,6,191,0.02030456852791878,0.030456852791878174,0.9695431472081218,197,6400,5200,1200,0.8125,76,52,24,193.5132131291182,0.4791094737387341,0.761683432899908,0.11118511289155808,1027911.7424888898,-6017.099179564633,1021894.6433093252,2469,0,351.60913705583755,71,126,42,39.52860189484015,0.5346869712351946,44.47337962962964,8045.437622107584,113.31602284658568,0
3989,31.912523367422153,2,1,192,0.010362694300518135,0.0051813471502590676,0.9948186528497409,193,7450,5900,1550,0.7919463087248322,90,59,31,240.95373843518797,0.4794354040731146,0.8018955415875066,0.1346187001714959,1033126.6535214621,3737.14588860628,1036863.7994100684,2470,0,357.2176165803109,64,129,37,39.413680354368715,0.519376079447323,45.544871794871796,8120.305224806554,126.87976913760241,8
3990,31.53189134787613,6,2,196,0.030303030303030304,0.010101010101010102,0.98989898989899,198,6350,4500,1850,0.7086614173228346,82,45,37,241.1473040652134,0.48037160949597496,0.807223696822237,0.13214872262773736,1014784.0684298512,2992.4884620377525,1017776.556891889,2471,0,347.95454545454544,71,127,37,40.17829987834555,0.5165193602693603,46.29629629629631,7999.7576197389735,112.67264253153483,8
3991,31.468284288073065,5,2,199,0.024875621890547265,0.009950248756218905,0.9900497512437811,201,6000,4400,1600,0.7333333333333333,76,44,32,212.16835094077877,0.481353648424544,0.7782989467866848,0.11580429237128198,1011485.8683105779,-3278.942264128281,1008206.9260464497,2472,0,343.58706467661693,78,123,40,41.07359543744689,0.5151326699834162,46.45305907172998,7978.687217502131,102.29086176284783,8
3992,31.48283367120936,1,2,198,0.005,0.01,0.99,200,6550,4600,1950,0.7022900763358778,85,46,39,217.71368451397524,0.4810411432160804,0.7828354436714868,0.11967364870079125,1014163.7613300234,-2390.5341640575443,1011773.2271659658,2473,0,346.145,81,119,35,40.650232304022175,0.5175520833333334,46.1763211382114,7991.088663420193,98.65541559778016,0
3993,31.462200864943163,3,2,199,0.014925373134328358,0.009950248756218905,0.9900497512437811,201,5900,4300,1600,0.7288135593220338,75,43,32,205.9258263907553,0.4812696932006633,0.775589266780849,0.11419523099850962,1016240.0123129635,-4245.987130620346,1011994.0251823431,2474,0,345.2786069651741,69,132,39,40.599385245901615,0.5249792703150913,45.83333333333333,7996.642719839712,115.89337275130018,8
3994,31.3217997853559,3,3,199,0.01485148514851485,0.01485148514851485,0.9851485148514851,202,6400,4400,2000,0.6875,84,44,40,209.63402245461927,0.4811919158333744,0.7804889839264875,0.11755280714639416,1015135.5463352524,-4238.6104170147255,1010896.9359182377,2475,0,344.1237623762376,74,128,39,40.06555379775608,0.5280012376237624,45.40277777777778,7974.443220352208,107.76274622097579,0
3995,30.93910655831604,4,3,200,0.019704433497536946,0.014778325123152709,0.9852216748768473,203,6600,4300,2300,0.6515151515151515,89,43,46,206.82874267113476,0.4815433513794729,0.7770096720690278,0.1170533777749138,1005522.1937266629,-5605.82178871882,999916.3719379441,2476,0,342.7832512315271,80,123,38,39.77574611181167,0.5316091954022988,45.048868312757186,7887.960230434835,98.59950288043544,0
3996,31.24341729850707,4,3,201,0.0196078431372549,0.014705882352941176,0.9852941176470589,204,5500,3900,1600,0.7090909090909091,71,39,32,217.60475107682979,0.48153614894233554,0.7874587110830007,0.12107751534274817,1010207.4809665309,-2334.8105136656127,1007872.6704528652,2477,0,341.45098039215685,71,133,34,40.169504181600956,0.5246119281045751,45.70312499999998,7945.10338333124,111.90286455396114,8
3997,30.888812963217475,3,2,202,0.014705882352941176,0.00980392156862745,0.9901960784313726,204,7150,5100,2050,0.7132867132867133,92,51,41,214.19663019946643,0.48116487974500144,0.7843089750167331,0.1200509417418484,1000950.164061726,-5069.96957207547,995880.1944896504,2478,0,342.30882352941177,75,129,38,39.96917734467532,0.5269607843137255,45.422149122806985,7863.607620323411,104.84810160431215,0
3998,30.777827668483383,4,6,200,0.019417475728155338,0.02912621359223301,0.970873786407767,206,6200,4600,1600,0.7419354838709677,78,46,32,213.39067668606907,0.48164022416923197,0.7898019642117542,0.1185218095810574,994613.9101934826,-4951.7329324871625,989662.1772609955,2479,0,339.90776699029124,67,139,37,40.34707158351411,0.5232605177993528,45.772058823529406,7824.583762042726,116.78483226929443,8
3999,30.814718844584252,0,5,195,0.0,0.025,0.975,200,5450,3700,1750,0.6788990825688074,72,37,35,216.7850968990735,0.4810395728643216,0.783229494217343,0.11917781345201589,992679.0458763604,-2410.3953700027996,990268.6505063575,2480,1,350.84,76,124,40,40.66891399740625,0.5192708333333333,46.171536796536785,7821.6527283675905,102.91648326799461,8
4000,30.78934537187673,4,2,197,0.020100502512562814,0.010050251256281407,0.9899497487437185,199,5850,4100,1750,0.7008547008547008,76,41,35,214.71484475320227,0.48173633318105685,0.7775805297388072,0.11950805631453948,995623.5299908995,-2894.9696650739224,992728.5603258256,2481,0,352.80904522613065,72,127,44,40.230239778550825,0.5225607202680067,45.690639269406375,7830.018738835398,108.75026026160275,0
4001,31.1811170544585,3,2,198,0.015,0.01,0.99,200,6350,4400,1950,0.6929133858267716,83,44,39,214.90374102179584,0.4820979899497488,0.7809806681183282,0.12089699849714375,1011561.4455924565,-2872.332213752994,1008689.1133787035,2482,0,348.79,76,124,43,39.80462318763612,0.5257291666666667,45.27867965367966,7942.495305984851,104.5065171840112,0
4002,30.80099529451158,3,5,196,0.014925373134328358,0.024875621890547265,0.9751243781094527,201,6050,4200,1850,0.6942148760330579,79,42,37,215.7448965445807,0.48199212271973463,0.7841746081946648,0.12229707087773169,1001519.6310535333,-3035.450162197688,998484.1808913356,2483,0,348.0049751243781,79,122,40,39.4852033869458,0.5280887230514096,44.98697916666668,7854.654854726716,99.42601081932551,0
4003,30.534606127253706,2,3,195,0.010101010101010102,0.015151515151515152,0.9848484848484849,198,5450,3900,1550,0.7155963302752294,70,39,31,217.79462963571535,0.4814953682339469,0.7847025921157857,0.12400857491711668,994178.7762408528,-1744.6403273867809,992434.135913466,2484,0,353.92929292929296,80,118,43,39.25964655882009,0.5307239057239057,44.81738683127573,7791.90058363037,97.39875729537962,0
4004,30.986223805204556,3,1,197,0.015151515151515152,0.005050505050505051,0.9949494949494949,198,6100,4300,1800,0.7049180327868853,79,43,36,215.7090151633406,0.4815375625972073,0.7803143828139318,0.1240494139941412,1011874.5332811782,-2045.908191410108,1009828.6250897681,2485,0,354.7828282828283,67,131,44,38.92666436891847,0.5331965488215489,44.439338235294144,7918.859861247416,118.19193822757337,0
4005,31.257255676410367,1,4,194,0.005050505050505051,0.020202020202020204,0.9797979797979798,198,5750,3800,1950,0.6608695652173913,77,38,39,216.47520795947887,0.48163957681724184,0.7814743476020292,0.12568736985280937,1023612.1335461963,-1032.6701041479046,1022579.4634420484,2486,0,353.989898989899,72,126,41,38.53812378031781,0.5357744107744108,44.07819634703199,7999.413249948976,111.10296180484688,0
4006,31.325542316996476,0,1,193,0.0,0.005154639175257732,0.9948453608247423,194,5950,4100,1850,0.6890756302521008,78,41,37,218.22872672830795,0.48112080017093106,0.7770576898988377,0.12704282332768713,1026649.3134429625,58.87449383007515,1026708.1879367925,2487,1,360.20103092783506,72,122,43,38.39118177089144,0.5374785223367697,43.97831050228312,8020.018268429698,111.38914261707913,0
4007,30.952285652088072,1,1,193,0.005154639175257732,0.005154639175257732,0.9948453608247423,194,5600,4000,1600,0.7142857142857143,72,40,32,245.82450012160905,0.4807018188130976,0.8015230114315335,0.13865868361249797,1004940.1089018502,5007.779984590425,1009947.8888864407,2488,0,361.1855670103093,72,122,32,38.912765520588316,0.528833762886598,45.1769406392694,7887.35612407231,109.54661283433764,8
4008,30.55264205104021,0,1,192,0.0,0.0051813471502590676,0.9948186528497409,193,7900,6400,1500,0.810126582278481,94,64,30,232.0469032218275,0.48061717400690845,0.7936316743450562,0.13010596440289557,990172.8671104921,-546.6905065463625,989626.1766039457,2489,1,363.94300518134713,65,128,37,39.499449817122304,0.5256368739205527,45.407196969696976,7778.482779755846,119.66896584239764,8
4009,30.700090057948756,3,0,195,0.015384615384615385,0.0,1.0,195,5750,3700,2050,0.6434782608695652,78,37,41,189.7627020064303,0.48100273151819545,0.7557576478209704,0.10425001617401505,988775.516870911,-7223.457248154472,981552.0596227566,2490,0,360.8871794871795,76,119,41,41.382388998454196,0.5166666666666666,46.198593073593045,7791.7260494747325,102.52271117729912,8
4010,30.607542037051747,4,0,199,0.020100502512562814,0.0,1.0,199,5650,4100,1550,0.7256637168141593,72,41,31,206.65943346431308,0.48207684043111176,0.7809987124054969,0.11204292527821925,981770.4429762375,-4871.575292504746,976898.8676837328,2491,0,354.61306532663315,65,134,43,41.48284313725489,0.5100502512562815,46.71717171717171,7752.364813930011,119.26715098353863,8
4011,30.369635639203988,4,3,200,0.019704433497536946,0.014778325123152709,0.9852216748768473,203,6150,4300,1850,0.6991869918699187,80,43,37,186.49555776318198,0.48285108683282124,0.7615422417592814,0.10092904304178102,973593.0967898133,-10435.842475960228,963157.254313853,2492,0,348.60591133004925,71,132,40,42.06590675351389,0.5126231527093597,46.78819444444443,7689.950274267157,108.30915879249517,8
4012,30.898849943153667,8,3,205,0.038461538461538464,0.014423076923076924,0.9855769230769231,208,6050,4100,1950,0.6776859504132231,80,41,39,204.26657721606622,0.48376242567818656,0.787038208502024,0.11088757048872183,991509.7626203103,-7143.538902646854,984366.2237176634,2493,0,340.1923076923077,64,144,43,41.49191337719293,0.5089142628205128,46.66666666666667,7827.708652265608,122.30794769165013,8
4013,31.109533247629916,8,5,208,0.03755868544600939,0.023474178403755867,0.9765258215962441,213,6400,4500,1900,0.703125,83,45,38,207.11213332612004,0.48421952047716066,0.7881522779835577,0.11444353228201551,1003750.8305443104,-7422.204831620863,996328.6257126895,2494,0,332.84507042253523,74,139,40,40.71099872425734,0.5134976525821596,45.9722222222222,7902.6855985992715,106.79304862971989,0
4014,31.19924490497841,5,5,208,0.023474178403755867,0.023474178403755867,0.9765258215962441,213,7250,5000,2250,0.6896551724137931,95,50,45,207.11578524009835,0.48441144772197126,0.7951605103119492,0.11417387759215376,1005911.6756648346,-8181.962682499372,997729.7129823352,2495,0,333.7887323943662,71,142,45,40.80541628684286,0.5160406885758999,46.06481481481478,7922.586032583564,111.58571876878258,8
4015,31.0439925536667,4,2,210,0.018867924528301886,0.009433962264150943,0.9905660377358491,212,6550,4900,1650,0.7480916030534351,82,49,33,199.18751762059114,0.48475038376702734,0.7861761099967326,0.11086385048084976,1003852.8399168961,-8959.008952114382,994893.8309647817,2496,0,336.1556603773585,65,147,48,40.62577577111651,0.518622248427673,45.6912878787879,7894.757765423514,121.45781177574636,0
4016,30.896268804091896,3,2,211,0.014084507042253521,0.009389671361502348,0.9906103286384976,213,7200,5000,2200,0.6944444444444444,94,50,44,202.80641364789028,0.48469657040777153,0.7827467036738427,0.11277956659543566,998810.2614911532,-9286.974590453829,989523.2869006994,2497,0,335.5399061032864,76,137,40,40.568250336951166,0.5210289514866979,45.72510822510821,7856.145406408389,103.37033429484723,8
4017,31.148067397341553,5,3,213,0.023148148148148147,0.013888888888888888,0.9861111111111112,216,6600,4600,2000,0.696969696969697,86,46,40,204.3139540321578,0.4843247559575079,0.7873951627031062,0.11493226194669225,1010469.8684605838,-8509.381148892857,1001960.487311691,2498,0,331.68518518518516,82,134,42,40.07686243594797,0.5244020061728395,45.281124497991954,7934.000701511561,96.75610611599464,0
4018,31.650773352815442,4,5,212,0.018433179723502304,0.02304147465437788,0.9769585253456221,217,7450,5500,1950,0.738255033557047,94,55,39,223.71135895705902,0.4847999160835182,0.8081136895821635,0.12563619767633769,1026265.994817529,-4932.527929590693,1021333.4668879383,2499,0,330.0921658986175,80,137,39,39.64772076894588,0.5275057603686636,45.344650205761305,8060.038759419356,100.75048449274195,8
4019,31.58936143713723,6,9,209,0.027522935779816515,0.04128440366972477,0.9587155963302753,218,7000,4800,2200,0.6857142857142857,92,48,44,221.12700250956885,0.4845549014219479,0.8079779602887227,0.1254387824355876,1027377.0610729475,-5163.838007569846,1022213.2230653776,2500,0,329.5045871559633,86,132,37,39.31965244198234,0.5302465596330275,44.95929118773945,8056.573131854144,93.68108292853655,0
4020,31.276165968389616,3,3,209,0.014150943396226415,0.014150943396226415,0.9858490566037735,212,6700,5400,1300,0.8059701492537313,80,54,26,229.1961086168618,0.48409509225312225,0.8113694427083986,0.13054745748422694,1018433.004159096,-2415.8237119511527,1016017.1804471449,2501,0,339.60377358490564,86,126,41,38.95463857871194,0.531937893081761,44.80363984674328,7981.563714682153,92.80888040328085,0
4021,31.163982303172386,1,5,205,0.004761904761904762,0.023809523809523808,0.9761904761904762,210,7450,5600,1850,0.7516778523489933,93,56,37,223.56021980162265,0.48374819624819626,0.8036138989870878,0.12795122545161913,1016235.8671724973,-4012.01723292458,1012223.8499395727,2502,0,343.3047619047619,66,144,41,38.911380331994,0.5344246031746032,44.62064676616917,7958.637644774751,120.5854188602235,0
4022,31.04059932507156,7,0,212,0.0330188679245283,0.0,1.0,212,6450,4700,1750,0.7286821705426356,82,47,35,199.19156515270504,0.48367453202778027,0.7837127436809201,0.11416104226531577,1012626.2276205563,-8508.679361116097,1004117.5482594401,2503,0,340.2358490566038,69,143,46,39.48047140499078,0.5341489779874213,44.56845238095241,7928.7483246258535,114.90939600907033,8
4023,30.96357025581851,1,2,211,0.004694835680751174,0.009389671361502348,0.9906103286384976,213,5150,3600,1550,0.6990291262135923,67,36,31,199.35415719678153,0.48357176602592494,0.7839307814875738,0.1148135788308399,1011577.0954372489,-7417.580139907434,1004159.5152973415,2504,0,339.63380281690144,73,140,46,39.287623676046756,0.5358470266040689,44.38344594594597,7914.801130002992,108.42193328771222,0
4024,31.124854224096577,4,4,211,0.018604651162790697,0.018604651162790697,0.9813953488372094,215,6800,4500,2300,0.6617647058823529,91,45,46,191.04568690162856,0.48347189016880393,0.7771736895236658,0.11105646472225582,1019636.9203234151,-10840.55283331013,1008796.367490105,2505,0,336.69767441860466,80,135,39,39.14278118301178,0.5387596899224807,44.03292181069961,7966.937994809964,99.58672493512455,0
4025,31.192060071313584,1,4,208,0.0047169811320754715,0.018867924528301886,0.9811320754716981,212,8350,5500,2850,0.6586826347305389,112,55,57,195.3828357248026,0.48326049211600947,0.7807122280244132,0.11210885506068471,1017919.7919137421,-10973.188903098207,1006946.6030106439,2506,0,342.4198113207547,73,139,44,39.53265331423218,0.5334119496855345,44.52421171171173,7968.81613505452,109.16186486376054,8
4026,31.138036307047244,2,3,207,0.009523809523809525,0.014285714285714285,0.9857142857142858,210,6550,4200,2350,0.6412213740458015,89,42,47,214.60445151263434,0.48276942355889724,0.792870026134648,0.124421851855473,1019276.1693170473,-4801.75934876309,1014474.4099682843,2507,0,345.54761904761904,78,132,33,38.641351026367786,0.541765873015873,44.13238396624474,7967.215117856725,102.1437835622657,8
4027,31.03677433808013,2,0,209,0.009569377990430622,0.0,1.0,209,6200,4200,2000,0.6774193548387096,82,42,40,213.04374020567434,0.4829497530977794,0.7923351540327248,0.12409040602501165,1017344.1073781302,-4652.24125759191,1012691.8661205383,2508,0,348.14832535885165,79,130,37,38.50352590181718,0.5434110845295056,43.95833333333334,7946.707429479293,100.59123328454801,0
4028,31.401977098368615,4,4,209,0.018779342723004695,0.018779342723004695,0.9812206572769953,213,6450,4500,1950,0.6976744186046512,84,45,39,217.2458085451587,0.4828188206808988,0.7919205153401019,0.12623742928975482,1028597.2161083436,-4358.313223848442,1024238.9028844951,2509,0,342.59154929577466,83,130,34,38.48716085271318,0.5428892801251957,44.04761904761906,8037.410804939615,96.83627475830862,8
4029,31.278282044333764,2,3,208,0.009478672985781991,0.014218009478672985,0.985781990521327,211,6050,3900,2150,0.6446280991735537,82,39,43,215.1176308075312,0.48234785225306553,0.7880444381665432,0.12570880169890533,1026242.0822113481,-4097.4469279413215,1022144.6352834068,2510,0,346.74881516587675,84,127,38,38.32524039611542,0.5451224328593998,43.835784313725505,8012.376587900877,95.38543557024853,0
4030,31.171875900386954,2,5,205,0.009523809523809525,0.023809523809523808,0.9761904761904762,210,6850,4900,1950,0.7153284671532847,88,49,39,223.5590541295351,0.4819401724006987,0.7979470302460425,0.12886452794946376,1018641.2761284049,-3304.703962286284,1015336.5721661187,2511,0,348.83809523809526,77,133,37,38.635695815702874,0.5441964285714286,44.35096153846154,7969.060100976332,103.49428702566665,8
4031,31.04752226450191,5,7,203,0.023809523809523808,0.03333333333333333,0.9666666666666667,210,6250,4600,1650,0.736,79,46,33,201.24988580786118,0.48194349510138984,0.7831195135546851,0.11773065719162441,1018988.9713703885,-7235.7171744478255,1011753.2541959407,2512,0,347.26190476190476,90,120,38,38.639680695797225,0.5473214285714285,43.79578754578755,7954.505990431342,88.38339989368158,8
4032,30.8942315468278,1,5,199,0.004901960784313725,0.024509803921568627,0.9754901960784313,204,6050,4400,1650,0.7272727272727273,77,44,33,199.81250711809906,0.4816261993303068,0.7761011836286007,0.11523022027036327,1009707.5879139963,-6499.559080546739,1003208.0288334496,2513,0,358.1862745098039,74,130,42,39.224793568013936,0.5423304738562091,44.333333333333364,7898.625198805709,106.73817836223931,8
4033,31.184047721077448,1,3,197,0.005,0.015,0.985,200,6250,4400,1850,0.704,81,44,37,198.83041215863028,0.4810510887772194,0.7714395283314188,0.11554832260255705,1021489.2178583132,-5629.375559526657,1015859.8422987866,2514,0,365.795,77,123,37,38.95461581272394,0.544375,44.04380341880344,7981.750248693572,103.65909413887756,0
4034,31.017289019179458,1,6,192,0.005050505050505051,0.030303030303030304,0.9696969696969697,198,6100,4200,1900,0.6885245901639344,80,42,38,198.68125860804594,0.48050834059717307,0.7697883269555621,0.11629040530278295,1018156.1841214279,-5242.28957583758,1012913.8945455904,2515,0,370.3030303030303,80,118,41,38.68502392424549,0.5462962962962963,43.775720164609076,7947.382541385489,99.34228176731861,0
4035,31.477347169043238,1,0,193,0.0051813471502590676,0.0,1.0,193,5700,3900,1800,0.6842105263157895,75,39,36,221.13778129239392,0.47982782815198616,0.7786068534476924,0.12778480723444025,1029375.940892846,1226.7823369629568,1030602.723229809,2516,0,379.8756476683938,77,116,40,38.602045256745015,0.5408031088082901,44.25747863247864,8050.096130971938,104.54670299963556,8
4036,31.949771075164772,2,2,193,0.010256410256410256,0.010256410256410256,0.9897435897435898,195,7250,5600,1650,0.7724137931034483,89,56,33,222.14111357723738,0.4800433958939114,0.7818116909400366,0.12924228279373948,1046921.8866177547,262.8787443302999,1047184.765362085,2517,0,376.96923076923076,82,113,31,38.31421381181163,0.5428418803418804,44.00100401606427,8179.109317158809,99.74523557510743,0
4037,32.1220492573334,1,2,192,0.005154639175257732,0.010309278350515464,0.9896907216494846,194,6900,5000,1900,0.7246376811594203,88,50,38,225.39493687619617,0.47979263483076046,0.7871930265694391,0.1320170344560588,1054632.125030819,1841.7482497864726,1056473.8732806055,2518,0,379.7938144329897,82,112,35,37.974254742547465,0.5453715635738832,43.75000000000003,8231.275122191759,100.38140392916779,0
4038,31.622347436251697,3,1,194,0.015384615384615385,0.005128205128205128,0.9948717948717949,195,4900,3400,1500,0.6938775510204082,64,34,30,223.5869674365564,0.480121596616442,0.7880891573102904,0.12947496820479626,1034765.8694737911,2372.0325524991677,1037137.9020262903,2519,0,377.64102564102564,77,118,33,38.457489385397096,0.5381410256410256,44.17735042735042,8089.712706848765,105.0612039850489,7
4039,32.09971540952991,5,0,199,0.02512562814070352,0.0,1.0,199,5950,3800,2150,0.6386554621848739,81,38,43,219.1156057902039,0.48058368441534266,0.7897618172161629,0.12833914053426254,1053898.8594417945,435.13740563877946,1054333.9968474333,2520,0,370.13065326633165,85,114,38,38.13516260162606,0.5417190117252931,43.75000000000001,8225.552073692053,96.77120086696533,0
4040,32.52220548807641,0,2,197,0.0,0.010050251256281407,0.9899497487437185,199,6200,4300,1900,0.6935483870967742,81,43,38,230.15636234051794,0.4803669018493139,0.7963342801784403,0.13124598578580107,1059372.6942287723,2764.273133313457,1062136.9673620858,2521,1,371.13065326633165,64,135,38,38.88509554006824,0.5328203517587939,44.75961538461538,8300.980237317184,129.702816208081,8
4041,32.65854090891067,3,3,197,0.015,0.015,0.985,200,6000,4400,1600,0.7333333333333333,76,44,32,218.67370547339215,0.4804731993299833,0.7830584093270234,0.12135620182677667,1055125.7906954552,145.6532783832381,1055271.4439738384,2522,0,370.165,70,130,42,40.24539228134977,0.5280208333333334,45.80399061032861,8301.670771534365,118.59529673620523,8
4042,32.29705156009464,1,3,195,0.005050505050505051,0.015151515151515152,0.9848484848484849,198,7250,5900,1350,0.8137931034482758,86,59,27,216.05241242676803,0.48032674460339436,0.776338243194203,0.12041338652415665,1044802.7523535367,-1703.5689687788736,1043099.1833847578,2523,0,372.8131313131313,74,124,41,40.14335572057803,0.5296717171717171,45.63888888888885,8215.113920438422,111.01505297889759,0
4043,32.41799273022832,1,1,195,0.00510204081632653,0.00510204081632653,0.9948979591836735,196,6300,4500,1800,0.7142857142857143,81,45,36,211.80973755871958,0.480454168847026,0.7698010260298076,0.11855746808022273,1050085.5287928395,-1016.331946436454,1049069.196846403,2524,0,375.76020408163265,77,119,39,40.08162154362766,0.5310374149659864,45.472756410256366,8251.262332337248,107.1592510693149,0
4044,32.349950257153054,2,4,193,0.01015228426395939,0.02030456852791878,0.9796954314720813,197,5350,3600,1750,0.6728971962616822,71,36,35,232.33280183628358,0.4803364239096654,0.7870545009549317,0.1293344489701008,1046138.5375368954,3860.459506971867,1049998.9970438671,2525,0,374.6954314720812,69,128,40,39.775941096157574,0.5258565989847716,45.68452380952382,8227.093004386117,119.23323194762489,8
4045,32.047665161456045,4,0,197,0.02030456852791878,0.0,1.0,197,5700,3700,2000,0.6491228070175439,77,37,40,217.68341843590431,0.4814522255602749,0.7831405508862452,0.120715350223547,1035150.712376545,-32.97086670237877,1035117.7415098426,2526,0,373.9593908629442,65,132,40,40.30054644808744,0.5235300338409475,45.833333333333336,8145.448228536748,125.31458813133457,8
4046,32.53377869213927,3,1,199,0.015,0.005,0.995,200,5250,3400,1850,0.6476190476190476,71,34,37,210.6270988759079,0.4817572236180905,0.7782662556053825,0.11801468102846065,1054158.7700041367,-843.1193038867054,1053315.65070025,2527,0,369.335,72,128,40,40.07193572496266,0.5261979166666666,45.43378995433789,8282.000740122186,115.0277880572526,0
4047,32.0426748778682,7,6,200,0.03398058252427184,0.02912621359223301,0.970873786407767,206,6950,4700,2250,0.6762589928057554,92,47,45,205.71099738813393,0.4827590970084458,0.7792609099435652,0.11702139238404018,1042995.2388292501,-5238.881829872322,1037756.3569993777,2528,0,359.31067961165047,85,121,36,39.60355843025556,0.5306432038834952,44.85222868217052,8175.61708214981,96.18373037823305,0
4048,31.862064522681912,4,3,201,0.0196078431372549,0.014705882352941176,0.9852941176470589,204,6150,4300,1850,0.6991869918699187,80,43,37,239.97392782446087,0.48172077739141633,0.8139504733451137,0.13532584927439467,1034402.7790106117,2695.9395663427813,1037098.7185769544,2529,0,360.01960784313724,65,139,35,39.07137142562198,0.5241523692810457,45.18623737373737,8118.892546065327,124.9060391702358,8
4049,32.04278459345588,2,1,202,0.009852216748768473,0.0049261083743842365,0.9950738916256158,203,6700,4800,1900,0.7164179104477612,86,48,38,237.94126904700352,0.4816093986245915,0.8113174540976262,0.13508923662023464,1042383.2131557366,2305.1969143140086,1044688.4100700506,2530,0,362.7586206896552,68,135,39,38.85830965909092,0.5263752052545156,44.92753623188407,8173.232012243843,120.19458841535064,0
4050,31.724596882803482,1,1,202,0.0049261083743842365,0.0049261083743842365,0.9950738916256158,203,5700,3600,2100,0.631578947368421,78,36,42,230.93640910388953,0.48167442975824676,0.8035876214703799,0.12876579157633614,1026422.314252406,1107.6566955110547,1027529.9709479171,2531,0,363.57142857142856,63,140,39,39.74722471047412,0.5230911330049262,45.62174479166668,8070.04760223531,128.09599368627477,8
4051,32.03487884151169,4,2,204,0.019417475728155338,0.009708737864077669,0.9902912621359223,206,6500,4300,2200,0.6615384615384615,87,43,44,246.36354811768214,0.4818937958797063,0.8154727923632137,0.1373676736900199,1036461.2227783201,3369.2528660116673,1039830.4756443318,2532,0,359.11650485436894,63,143,38,39.354791839955645,0.5221480582524272,45.62174479166667,8148.976585514107,129.3488346907001,8
4052,31.873263181734767,3,1,206,0.014492753623188406,0.004830917874396135,0.9951690821256038,207,7000,5300,1700,0.7571428571428571,87,53,34,241.02920454401968,0.4819622281631568,0.8129905629526615,0.13590778943678763,1034736.1830263697,1480.3278215524351,1036216.5108479221,2533,0,357.0048309178744,67,140,33,39.04828463789028,0.5252616747181964,45.18995098039217,8121.627753752725,121.21832468287649,0
4053,31.88274847061192,4,2,208,0.01904761904761905,0.009523809523809525,0.9904761904761905,210,5850,3900,1950,0.6666666666666666,78,39,39,231.15721460363685,0.4823939583808005,0.8081398995829336,0.13151406594869702,1037830.3304816781,130.39368506346455,1037960.7241667416,2534,0,352.87619047619046,74,136,39,38.94918168127303,0.5280257936507937,44.847222222222236,8134.9718354668585,109.93205183063323,0
4054,31.801653354766906,2,7,203,0.009523809523809525,0.03333333333333333,0.9666666666666667,210,6050,4000,2050,0.6611570247933884,81,40,41,226.28788489707597,0.48280834662413613,0.8023609727545418,0.12980486739757102,1037725.3776627249,-1085.0638369362568,1036640.3138257887,2535,0,350.4809523809524,68,142,40,38.754161249655276,0.5308531746031746,44.5350241545894,8124.208606119714,119.47365597234874,0
4055,31.55848104446608,0,3,200,0.0,0.014778325123152709,0.9852216748768473,203,6050,4300,1750,0.7107438016528925,78,43,35,223.74650011960273,0.4820605521143247,0.7994900458532743,0.1285470488621854,1030266.2103420836,-546.3082488942218,1029719.9020931894,2536,1,361.5073891625616,65,138,42,38.7587502573605,0.5344827586206897,44.47601010101012,8063.948991633652,124.0607537174408,8
4056,31.649764263039305,2,0,202,0.009900990099009901,0.0,1.0,202,6550,4800,1750,0.732824427480916,83,48,35,221.86902938810044,0.4812103878298277,0.7962606940305672,0.12857129053288624,1035879.2897256975,-984.0934850650283,1034895.1962406324,2537,0,364.1782178217822,64,138,40,38.47413613112013,0.5360457920792079,44.150641025641015,8097.571898388164,126.52456091231507,8
4057,31.774315194672816,1,2,201,0.0049261083743842365,0.009852216748768473,0.9901477832512315,203,6800,5100,1700,0.75,85,51,34,219.14738945553518,0.4811033751158367,0.7943681102921727,0.1274553785724252,1041064.4158081666,-1770.6902041181684,1039293.7256040485,2538,0,363.37931034482756,66,137,42,38.40444376961232,0.5379207717569787,44.01430348258703,8133.770206472064,123.238942522304,0
4058,31.878608876705698,1,3,199,0.0049504950495049506,0.01485148514851485,0.9851485148514851,202,6350,4600,1750,0.7244094488188977,81,46,35,194.95097754304172,0.480711130814574,0.7685009161211511,0.11275807796585025,1042785.5041597224,-6091.5893192694875,1036693.9148404528,2539,0,366.0990099009901,74,128,50,39.23580944106574,0.5406353135313531,44.222222222222236,8153.839737130757,110.18702347473996,8
4059,31.94133241885241,2,0,201,0.009950248756218905,0.0,1.0,201,6550,5300,1250,0.8091603053435115,78,53,25,205.66635742635634,0.48082607794361526,0.7778909936716119,0.11608484788434564,1037260.6753330193,-4084.075040531432,1033176.6002924879,2540,0,368.2437810945274,83,118,35,39.90990908796,0.5338412106135987,45.15128968253966,8140.207372765771,98.07478762368399,8
4060,31.462742403447045,2,4,199,0.009852216748768473,0.019704433497536946,0.9802955665024631,203,5650,3900,1750,0.6902654867256637,74,39,35,204.8554909518031,0.48081073501438815,0.7815706230727042,0.1163980782269412,1023758.9181545838,-4305.472841031569,1019453.4453135522,2541,0,365.60591133004925,88,115,41,39.67107879121549,0.5356629720853858,44.89700374531833,8026.2398575085,91.20727110805113,0
4061,31.786406337450693,2,3,198,0.009950248756218905,0.014925373134328358,0.9850746268656716,201,5700,4300,1400,0.7543859649122807,71,43,28,233.93593498564266,0.480384535655058,0.7959842851534054,0.13133991680007298,1030572.7672580247,2317.6007758493133,1032890.368033874,2542,0,369.681592039801,71,130,37,39.39886228055223,0.531198175787728,45.35590277777777,8094.22074573884,114.00310909491324,7
4062,31.755115661329317,4,2,200,0.019801980198019802,0.009900990099009901,0.9900990099009901,202,7300,5000,2300,0.684931506849315,96,50,46,214.1931573974035,0.48081734479418087,0.7880943723511438,0.11962839086653856,1027927.9540108655,-3664.9731906721045,1024262.9808201934,2543,0,368.08910891089107,67,135,40,40.10761589403973,0.5283106435643564,45.55759803921567,8079.847903411113,120.59474482703155,7
4063,31.581132348163464,5,4,201,0.024390243902439025,0.01951219512195122,0.9804878048780488,205,6200,4500,1700,0.7258064516129032,79,45,34,223.48363388333976,0.4811922126574207,0.7978114423887532,0.12389490321747747,1019988.6390307917,-1609.8464859350515,1018378.7925448567,2544,0,362.9609756097561,89,116,41,40.16495704115249,0.5257621951219512,45.844907407407426,8026.505616126455,90.1854563609714,8
4064,31.80330546171056,5,0,206,0.024271844660194174,0.0,1.0,206,7100,4500,2600,0.6338028169014085,97,45,52,221.0928606736806,0.48102948141131896,0.7951314894889971,0.12433861257168263,1031645.5743413572,-2682.1057535053396,1028963.4685878519,2545,0,359.2378640776699,72,134,41,39.6596638655462,0.5294296116504854,45.291095890410965,8100.585081214825,112.50812612798367,0
4065,32.26303635395851,5,2,209,0.023696682464454975,0.009478672985781991,0.990521327014218,211,6800,5100,1700,0.75,85,51,34,230.73234338463004,0.4821202888738434,0.8063034596333714,0.12703308948987005,1039808.8131182975,-1016.4951754447402,1038792.3179428527,2546,0,351.70142180094786,77,134,37,40.25580584924514,0.519599131121643,46.11378205128206,8191.140279448542,106.37844518764341,8
4066,31.852799560586465,3,3,209,0.014150943396226415,0.014150943396226415,0.9858490566037735,212,6650,4000,2650,0.6015037593984962,93,40,53,231.01160038338858,0.48242356329547825,0.8098865736391336,0.1284243185593148,1029635.086890724,-1478.4701532968193,1028156.6167374272,2547,0,350.9292452830189,64,148,37,39.863413378713425,0.5224547955974843,45.73717948717949,8098.982657504246,126.54660402350385,0
4067,31.587253930819717,4,0,213,0.018779342723004695,0.0,1.0,213,6650,4300,2350,0.6466165413533834,90,43,47,230.07700854478705,0.4826112070747335,0.8077820171131287,0.12957637604350658,1025079.6579823497,-2080.54775426178,1022999.110228088,2548,0,343.6244131455399,74,139,42,39.37457976703191,0.5259194053208138,45.23611111111109,8047.291650736431,108.74718446941122,0
4068,31.592437788491498,0,3,210,0.0,0.014084507042253521,0.9859154929577465,213,6350,3900,2450,0.6141732283464567,88,39,49,223.7887834593763,0.4825050934538046,0.8073027939757069,0.12793126992246603,1029846.4310750684,-2856.384007946046,1026990.0470671224,2549,1,344.6244131455399,65,148,39,38.95130217991513,0.5333039906103286,44.66540404040404,8066.6423381031445,124.10218981697146,8
4069,31.975950838245577,3,3,210,0.014084507042253521,0.014084507042253521,0.9859154929577465,213,6950,4600,2350,0.6618705035971223,93,46,47,205.00043058587565,0.4819523798978356,0.7920992250625287,0.11791850338264123,1044266.4605288586,-6734.985189039187,1037531.4753398194,2550,0,345.5868544600939,74,139,38,39.191370939985156,0.5381455399061033,44.43055555555555,8172.075991313278,110.43345934207132,8
4070,32.050548436475474,4,6,208,0.018691588785046728,0.028037383177570093,0.9719626168224299,214,6400,3900,2500,0.609375,89,39,50,196.49501352249447,0.4819546824038729,0.7841020048440881,0.1140289960362825,1049434.8201010309,-7958.2581666542355,1041476.5619343766,2551,0,344.77570093457945,80,134,35,39.0688602442334,0.5409852024922118,44.09722222222223,8201.824374195303,102.52280467744129,0
4071,31.9425557940242,4,3,209,0.018867924528301886,0.014150943396226415,0.9858490566037735,212,6700,4300,2400,0.6417910447761194,91,43,48,204.50970681624352,0.4816960825956064,0.7887250053155572,0.11946316874984406,1047917.3357792306,-6238.146578425829,1041679.1892008048,2552,0,347.00471698113205,82,130,41,38.61189367956886,0.5403400157232705,43.85040160642572,8182.072838303685,99.78137607687421,8
4072,32.425490039174704,1,4,206,0.004761904761904762,0.01904761904761905,0.9809523809523809,210,7350,5100,2250,0.6938775510204082,96,51,45,204.81634976243475,0.4810843396369712,0.7866343376527021,0.12051571071483093,1066017.9570534118,-5682.418651022643,1060335.538402389,2553,0,351.26190476190476,72,138,39,38.326841031348536,0.5422619047619048,43.578767123287655,8314.584132476693,115.48033517328741,0
4073,32.628960016914775,2,4,204,0.009615384615384616,0.019230769230769232,0.9807692307692307,208,6000,4400,1600,0.7333333333333333,76,44,32,215.10971778789587,0.48061003886411496,0.796919467372164,0.12524739537909269,1069417.8025827184,-1591.567657815889,1067826.2349249024,2554,0,350.5192307692308,74,134,39,38.464815919858225,0.5388120993589743,43.97222222222223,8353.920124330663,112.89081249095491,8
4074,32.38943650135264,1,1,204,0.004878048780487805,0.004878048780487805,0.9951219512195122,205,5900,4000,1900,0.6779661016949152,78,40,38,216.47167691189134,0.4799587517934003,0.7954392226849094,0.12679055361982186,1063410.9913822988,-860.3278897874679,1062550.6634925113,2555,0,355.47317073170734,64,141,41,38.20291327913276,0.5411077235772358,43.74999999999999,8299.7931034716,129.68426724174375,0
4075,32.28360202935431,1,2,203,0.004878048780487805,0.00975609756097561,0.9902439024390244,205,5950,4000,1950,0.6722689075630253,79,40,39,214.40238202792656,0.4799139167862267,0.7935448377040164,0.12610285607719535,1061222.7951536907,-1444.2609713429938,1059778.5341823478,2556,0,356.45365853658535,66,139,42,38.0971329533511,0.5425813008130081,43.59452736318407,8277.692236755443,125.41957934477945,0
4076,32.00213941135655,4,2,205,0.01932367149758454,0.00966183574879227,0.9903381642512077,207,6900,4500,2400,0.6521739130434783,93,45,48,216.0428138457866,0.4800871206791426,0.7909054803286757,0.12391735100105424,1044240.7881373925,-3179.8563596509207,1041060.9317777415,2557,0,353.8550724637681,73,134,40,39.01922158548234,0.5363325281803543,44.53828828828831,8175.32131246202,111.99070291043863,8
4077,31.77200164584945,2,3,204,0.00966183574879227,0.014492753623188406,0.9855072463768116,207,5300,3200,2100,0.6037735849056604,74,32,42,179.656016557011,0.4800597611118928,0.7552184510942463,0.10038609206678197,1028620.6317470545,-9740.422950393873,1018880.2087966606,2558,0,354.7294685990338,77,130,44,40.967994471851924,0.5277274557165861,45.53952991452989,8084.718474359131,104.99634382284586,8
4078,31.870563157218,6,4,206,0.02857142857142857,0.01904761904761905,0.9809523809523809,210,7400,5600,1800,0.7567567567567568,92,56,36,172.19813993124802,0.4802451203766993,0.7486643765152126,0.09740815078151194,1035646.8429245932,-13732.708004543316,1021914.1349200499,2559,0,350.3904761904762,86,124,37,40.67715182541171,0.5321428571428571,45.0670498084291,8124.856689936316,94.47507778995715,0
4079,31.5193915604237,2,4,204,0.009615384615384616,0.019230769230769232,0.9807692307692307,208,6700,4700,2000,0.7014925373134329,87,47,40,177.90907695280083,0.48008068948965693,0.7541040199763538,0.10105625051306422,1025508.1049523314,-11810.559928063154,1013697.5450242682,2560,0,354.71634615384613,88,120,39,40.370402232927994,0.5342047275641026,44.90870786516852,8040.32232045214,91.36729909604705,0
4080,31.126054567147268,3,2,205,0.014492753623188406,0.00966183574879227,0.9903381642512077,207,6000,4300,1700,0.7166666666666667,77,43,34,199.91049870567156,0.4802190328783828,0.772938851529827,0.11252815847827465,1009953.4243800518,-7019.941452536686,1002933.482927515,2561,0,354.04347826086956,73,134,44,40.16359755760624,0.5296900161030595,45.25619369369369,7929.169615732871,108.6187618593544,8
4081,31.603731631029184,2,5,202,0.00966183574879227,0.024154589371980676,0.9758454106280193,207,6050,4200,1850,0.6942148760330579,79,42,37,200.2525962769322,0.480284500414302,0.7735958115392512,0.11350777291898784,1027601.3364497456,-6294.032887658695,1021307.3035620869,2562,0,354.84541062801935,78,129,37,39.882799034815605,0.5320048309178744,44.98945147679325,8059.2849386089665,103.32416587960213,0
4082,31.90148484894653,3,4,201,0.014634146341463415,0.01951219512195122,0.9804878048780488,205,6550,4900,1650,0.7480916030534351,82,49,33,194.01132052582878,0.47976048142834365,0.7644388890436946,0.11078353782495448,1039571.0560078186,-7212.289328698245,1032358.7666791203,2563,0,359.0487804878049,74,131,36,39.75538599640932,0.5344512195121951,44.70833333333336,8144.183236229035,110.05653021931128,0
4083,32.206066104962154,0,3,198,0.0,0.014925373134328358,0.9850746268656716,201,5800,3800,2000,0.6551724137931034,78,38,40,196.53706452081357,0.479443407960199,0.7569324073320085,0.11011225055904045,1043517.950614347,-4982.009042296444,1038535.9415720506,2564,1,363.3482587064677,83,118,36,40.43339179007532,0.5322864842454395,45.43650793650792,8198.488653306795,98.77697172658789,8
4084,32.53969141722121,6,1,203,0.029411764705882353,0.004901960784313725,0.9950980392156863,204,5600,3700,1900,0.6607142857142857,75,37,38,202.98138663934142,0.4804152983032293,0.7796950259104036,0.11642437235006971,1061777.951266861,-3295.7678297545003,1058482.1834371067,2565,0,358.0980392156863,69,135,41,39.35330139220596,0.5368668300653594,44.53869047619049,8312.632180944029,120.47293015860912,8
4085,32.34592137925152,2,4,201,0.00975609756097561,0.01951219512195122,0.9804878048780488,205,7650,5600,2050,0.7320261437908496,97,56,41,202.21553614181215,0.48075183325362664,0.7806581719019601,0.11691971838083384,1057964.792115617,-5862.616468635795,1052102.1756469812,2566,0,356.8780487804878,72,133,44,39.063197388975674,0.5396849593495935,44.23515981735161,8272.949412124799,114.90207516839999,0
4086,32.33115502976904,3,6,198,0.014705882352941176,0.029411764705882353,0.9705882352941176,204,6450,4300,2150,0.6666666666666666,86,43,43,197.23522319760954,0.48072468930100776,0.7719243340983364,0.11486615124983567,1059727.9614541081,-5446.863798770083,1054281.097655338,2567,0,359.04901960784315,77,127,40,38.913737047082584,0.5426368464052287,43.96367521367523,8277.95010991901,107.50584558336375,0
4087,31.979610977494225,0,4,194,0.0,0.020202020202020204,0.9797979797979798,198,6700,4900,1800,0.7313432835820896,85,49,36,202.22074478788133,0.4802701293818045,0.7725696994458495,0.11803772839667208,1048903.4394809348,-3877.9930515191018,1045025.4464294156,2568,1,370.57575757575756,72,126,40,38.699115085334384,0.5435606060606061,43.87842465753423,8190.668342394998,113.75928253326386,0
4088,31.82922609321158,3,2,195,0.015228426395939087,0.01015228426395939,0.9898477157360406,197,6100,4300,1800,0.7049180327868853,79,43,36,195.03275678928333,0.480418436410097,0.7633204795828727,0.1146383257616109,1046095.3914318271,-4695.426388897725,1041399.9650429294,2569,0,371.8730964467005,70,127,42,38.61766809728182,0.5465313028764806,43.61795774647884,8160.441989126562,116.57774270180802,0
4089,31.89386000835465,3,3,195,0.015151515151515152,0.015151515151515152,0.9848484848484849,198,7050,5000,2050,0.7092198581560284,91,50,41,201.14763114925606,0.4802535721000188,0.7677740296340567,0.11668754951410604,1044195.3581653459,-4642.515449598006,1039552.8427157479,2570,0,370.87373737373736,77,121,39,38.96342179426964,0.5376157407407407,44.11057692307695,8161.30143723408,105.99092775628675,8
4090,31.414069349499588,1,2,194,0.00510204081632653,0.01020408163265306,0.9897959183673469,196,5350,3600,1750,0.6728971962616822,71,36,35,204.4430509307229,0.4799652232687947,0.7684757254038488,0.11887447318092641,1029187.7486564481,-2467.9433368302757,1026719.8053196179,2571,0,375.2551020408163,79,117,40,38.79017455957409,0.5389562074829932,44.023437500000036,8041.2654862216,101.78817071166583,0
4091,31.651602523813647,2,3,193,0.01020408163265306,0.015306122448979591,0.9846938775510204,196,6350,4900,1450,0.7716535433070866,78,49,29,197.61483777507271,0.47988891069248213,0.7609384990236558,0.11384542605481124,1034145.2743510539,-4677.509874651241,1029467.7644764027,2572,0,374.36224489795916,76,120,39,39.32071161445104,0.5382121598639455,44.372294372294405,8091.026532602657,106.46087542898233,8
4092,31.53475261581318,1,1,193,0.005154639175257732,0.005154639175257732,0.9948453608247423,194,5950,4000,1950,0.6722689075630253,79,40,39,218.9401948667778,0.47954892455887327,0.7821915999633011,0.12719514221327227,1032882.3281202874,477.891638621556,1033360.219758909,2573,0,374.7886597938144,74,120,36,38.45190290138199,0.5423646907216495,44.05555555555557,8071.14473894733,109.06952349928824,8
4093,31.735996144445362,2,1,194,0.010256410256410256,0.005128205128205128,0.9948717948717949,195,7350,5600,1750,0.7619047619047619,91,56,35,205.86441901269694,0.4794706582077716,0.7717583163611683,0.11891697615909913,1037725.9231905158,-3623.8311455938824,1034102.0920449219,2574,0,373.8410256410256,75,120,41,39.006279701289905,0.5410790598290598,44.270833333333336,8115.819847355562,108.21093129807416,8
4094,32.01718734831749,1,2,193,0.005128205128205128,0.010256410256410256,0.9897435897435898,195,5250,3400,1850,0.6476190476190476,71,34,37,209.43321025326162,0.47930764825094724,0.7752654631001274,0.12149408845482157,1048233.0580828283,-343.0371104237838,1047890.0209724045,2575,0,374.5692307692308,77,118,38,38.75140258859142,0.5432158119658119,44.110576923076934,8192.859599106747,106.40077401437334,0
4095,31.892934076111874,3,4,192,0.015306122448979591,0.02040816326530612,0.9795918367346939,196,6150,4300,1850,0.6991869918699187,80,43,37,203.00400840151008,0.47959510727367866,0.7702598571698205,0.11881953829045018,1046896.9918586941,-2845.1428538401487,1044051.849004854,2576,0,368.9234693877551,79,117,42,38.574592607649834,0.545812074829932,43.776041666666686,8171.733811845484,103.43966850437322,0
4096,31.866130764714732,1,1,192,0.0051813471502590676,0.0051813471502590676,0.9948186528497409,193,6000,4400,1600,0.7333333333333333,76,44,32,207.92819315496354,0.47939604922279794,0.7726402063986422,0.12046843833571809,1042899.0499261916,-1230.376981163593,1041668.6729450279,2577,0,375.1865284974093,73,120,34,38.838548830811575,0.5432318652849741,44.158220720720735,8152.687593590829,111.68065196699766,8
4097,31.714082961653435,2,3,191,0.010309278350515464,0.015463917525773196,0.9845360824742269,194,5850,3900,1950,0.6666666666666666,78,39,39,214.942324254861,0.4794192795968876,0.7784076271402147,0.11990417127646814,1026228.9030707654,-533.9948712909363,1025694.9081994744,2578,0,374.180412371134,67,127,39,40.13549758134121,0.5273840206185567,45.603553921568604,8067.949996081118,120.4171641206137,8
4098,31.91257259862365,5,2,194,0.025510204081632654,0.01020408163265306,0.9897959183673469,196,6250,4700,1550,0.752,78,47,31,216.12471080975848,0.47962072649572646,0.7835456400430707,0.12258955748342748,1037859.4511845971,-588.5852503110054,1037270.8659342862,2579,0,369.0,72,124,37,39.45091758518434,0.5318346088435374,44.96289954337898,8138.88998366436,113.040138662005,0
4099,31.86957987051738,5,2,197,0.02512562814070352,0.010050251256281407,0.9899497487437185,199,4950,3200,1750,0.6464646464646465,67,32,35,209.22645569871463,0.480435637784884,0.7802231587089561,0.1197794907294468,1039327.4403784594,-1259.0406678395884,1038068.3997106198,2580,0,364.37688442211055,68,131,43,39.267083407223495,0.5344430485762144,44.61050724637681,8139.155837402513,119.69346819709577,0
4100,32.27701165369097,4,4,197,0.01990049751243781,0.01990049751243781,0.9800995024875622,201,6600,4300,2300,0.6515151515151515,89,43,46,195.08538109121162,0.4804757462686567,0.7617016956036138,0.1111532985287138,1051121.7580907138,-5788.302249921727,1045333.455840792,2581,0,361.681592039801,80,121,42,39.81292517006801,0.5368988391376451,44.79166666666667,8237.362349119063,102.96702936398829,8
4101,32.40733418533599,5,1,201,0.024752475247524754,0.0049504950495049506,0.995049504950495,202,5550,3900,1650,0.7027027027027027,72,39,33,209.0477469630661,0.4799009285256884,0.7765381261123327,0.11839747113551473,1053475.4945528763,-1904.6642765841125,1051570.8302762923,2582,0,360.7029702970297,81,121,39,39.690032549488485,0.5318172442244224,45.020325203252014,8263.21153160646,102.01495718032666,8
4102,32.38959099941073,4,3,202,0.01951219512195122,0.014634146341463415,0.9853658536585366,205,6250,4300,1950,0.688,82,43,39,216.15880345208188,0.48068507890961265,0.7882141390821078,0.11983161148905673,1046092.9504292487,-2025.55990711104,1044067.3905221377,2583,0,356.2731707317073,83,122,34,40.351965926648745,0.525609756097561,45.845734126984134,8231.952722382495,99.18015328171681,8
4103,32.26834290976956,4,4,202,0.019417475728155338,0.019417475728155338,0.9805825242718447,206,5750,4100,1650,0.7130434782608696,74,41,33,212.7675428834148,0.4808494158970716,0.7882039152853828,0.11900953772270068,1045014.3186757462,-2480.9742274753744,1042533.3444482709,2584,0,355.49029126213594,74,132,36,40.085066033617125,0.5278620550161812,45.499999999999986,8212.293270536316,110.9769360883286,0
4104,32.15722084386579,3,3,202,0.014634146341463415,0.014634146341463415,0.9853658536585366,205,6000,4200,1800,0.7,78,42,36,209.98525641089032,0.4811324326478559,0.7827805863416082,0.11816109646165304,1043310.4687091114,-3184.036742390314,1040126.4319667211,2585,0,357.0975609756098,82,123,40,39.91958992297709,0.5299288617886179,45.26857429718874,8191.454712198059,99.89578917314705,0
4105,31.7108572617505,0,4,198,0.0,0.019801980198019802,0.9801980198019802,202,5850,4000,1850,0.6837606837606838,77,40,37,217.10017656357252,0.48083735612367207,0.7756740567776117,0.12247371327897229,1029612.3634345896,-1544.1948212627794,1028068.1686133269,2586,1,362.480198019802,84,118,30,39.63923888301112,0.5321782178217822,45.171568627450974,8080.828013490671,96.20033349393655,7
4106,31.81097387271724,3,3,198,0.014925373134328358,0.014925373134328358,0.9850746268656716,201,6250,4400,1850,0.704,81,44,37,221.2237188748935,0.480240464344942,0.7885958834732798,0.12474280126184834,1032720.5531052757,-757.543736702848,1031963.0093685728,2587,0,365.0149253731343,75,126,39,39.552124235741296,0.5348258706467661,45.189144736842096,8105.78145926103,108.0770861234804,8
4107,31.82892547811153,3,2,199,0.014925373134328358,0.009950248756218905,0.9900497512437811,201,6850,5400,1450,0.7883211678832117,83,54,29,228.82417953805054,0.4804570895522388,0.792763856167982,0.13068267723551327,1037254.9373583469,419.80200256348144,1037674.7393609104,2588,0,364.3333333333333,69,132,42,38.86055413072202,0.5380907960199005,44.70238095238098,8125.848891406029,117.76592596240621,0
4108,31.601522323318974,5,1,203,0.024509803921568627,0.004901960784313725,0.9950980392156863,204,6000,4400,1600,0.7333333333333333,76,44,32,219.41739470828335,0.4807025540101098,0.7893929810438334,0.12681581626360205,1033497.1736094048,-1446.5485456495553,1032050.6250637553,2589,0,359.8137254901961,74,130,41,38.63840013033562,0.5410028594771241,44.25000000000003,8082.089334188895,109.21742343498507,0
4109,31.6121939503765,1,1,203,0.004901960784313725,0.004901960784313725,0.9950980392156863,204,5250,3700,1550,0.7047619047619048,68,37,31,225.2906976744161,0.48080920586625453,0.7958276333789296,0.13091216216216223,1035483.0395097587,606.9392802363473,1036089.9787899951,2590,0,360.5735294117647,76,128,36,38.281249999999986,0.5424325980392157,44.04761904761909,8091.216308727418,106.46337248325551,0
4110,31.569819315811433,3,3,203,0.014563106796116505,0.014563106796116505,0.9854368932038835,206,5700,4000,1700,0.7017543859649122,74,40,34,222.93631678094684,0.4809895216670614,0.797546751969687,0.13053261090822968,1036398.5305419154,-689.825776759586,1035708.7047651559,2591,0,357.7864077669903,81,125,41,38.05024333614267,0.5450546116504854,43.762703252032544,8089.3651603053495,99.86870568278209,0
4111,31.65571984140565,1,4,200,0.004901960784313725,0.0196078431372549,0.9803921568627451,204,6050,4700,1350,0.7768595041322314,74,47,27,211.22134564767882,0.48058080991017094,0.7856536159431089,0.12396568364161498,1039933.9753557586,-2918.7492681235617,1037015.226087635,2592,0,362.1029411764706,68,136,37,38.26037556196867,0.5462111928104575,43.67451690821254,8114.16768096654,119.32599530833147,7
4112,31.794957442231656,1,5,196,0.004975124378109453,0.024875621890547265,0.9751243781094527,201,6650,5000,1650,0.7518796992481203,83,50,33,212.48111041839672,0.48027466832504145,0.7843119614296659,0.12253054571504382,1039131.8428306619,-2690.8224328452443,1036441.0203978167,2593,0,362.1442786069652,72,129,38,38.90264832282188,0.5380907960199005,44.335045662100455,8128.856342643611,112.90078253671682,8
4113,31.62054340566542,2,5,193,0.010101010101010102,0.025252525252525252,0.9747474747474747,198,6650,4500,2150,0.6766917293233082,88,45,43,209.39217493632594,0.47964255499153974,0.7771095012692992,0.12184924718619429,1036194.531003703,-2855.794699201526,1033338.7363045015,2594,0,368.43939393939394,76,122,36,38.632930846191826,0.541087962962963,43.9935064935065,8095.064440054294,106.51400579018808,0
4114,31.652343459845714,1,4,190,0.005154639175257732,0.020618556701030927,0.979381443298969,194,6000,4200,1800,0.7,78,42,36,219.46400822258545,0.4789235128109253,0.7808999198474347,0.12640530430361974,1034103.2322841894,589.6880546037464,1034692.9203387932,2595,0,375.52061855670104,75,119,38,38.77055406613046,0.5406464776632303,44.38048245614034,8090.956764338279,107.87942352451039,8
4115,31.89453614205206,1,1,190,0.005235602094240838,0.005235602094240838,0.9947643979057592,191,6050,4700,1350,0.7768595041322314,74,47,27,216.00972896938114,0.47842495636998256,0.775872191281102,0.12509530224056778,1043692.668142088,839.5540745405642,1044532.2222166286,2596,0,379.9214659685864,75,116,40,38.648819090990266,0.5429755671902269,44.17489035087719,8159.423205748379,108.79230940997839,0
4116,31.630693538132146,2,1,191,0.010416666666666666,0.005208333333333333,0.9947916666666666,192,6450,4900,1550,0.7596899224806202,80,49,31,203.98857862507467,0.4781651078025015,0.7667495095224435,0.11712697318680082,1032444.0192136526,-2728.6424021296484,1029715.376811523,2597,0,378.5833333333333,70,122,38,39.286295339266914,0.5397677951388888,44.49823943661971,8081.697886833484,115.45282695476405,8
4117,32.00184532327183,1,1,191,0.005208333333333333,0.005208333333333333,0.9947916666666666,192,6650,4500,2150,0.6766917293233082,88,45,43,199.87598592104763,0.47792934664048864,0.7614778377234737,0.11556132690591257,1046695.6440521037,-3208.1352371637404,1043487.50881494,2598,0,378.7760416666667,76,116,40,39.12492506787971,0.5423177083333333,44.237012987013,8184.887549807629,107.69588881325826,0
4118,32.40703992409415,2,1,192,0.010362694300518135,0.0051813471502590676,0.9948186528497409,193,7250,5200,2050,0.7172413793103448,93,52,41,199.6130604996684,0.4778319750287852,0.7640825632108266,0.11622717230100676,1062151.5491551785,-3446.1357117339326,1058705.4134434445,2599,0,377.1658031088083,79,114,38,38.8606880096289,0.5448510362694301,43.971354166666686,8297.130547232642,105.02696895231193,0
4119,32.35409579336978,3,1,194,0.015384615384615385,0.005128205128205128,0.9948717948717949,195,6700,4700,2000,0.7014925373134329,87,47,40,218.17891034543027,0.47770177989250157,0.7821867674093066,0.1297410704153204,1066924.0207216484,856.0640524829378,1067780.0847741312,2600,0,374.22564102564104,73,122,43,37.583817510779824,0.5504807692307692,43.18693693693694,8308.954443331057,113.82129374426106,8
4120,32.59996392653896,1,2,193,0.005128205128205128,0.010256410256410256,0.9897435897435898,195,6300,4300,2000,0.6825396825396826,83,43,40,216.46665955555548,0.47774253238170766,0.7798875897435891,0.12934193329084334,1076514.830765597,1305.9138755685294,1077820.7446411655,2601,0,375.14358974358976,75,120,39,37.44688888888888,0.5521367521367522,43.00986842105263,8377.869018950181,111.70492025266908,0
4121,32.49256576687665,0,3,190,0.0,0.015544041450777202,0.9844559585492227,193,6200,4600,1600,0.7419354838709677,78,46,32,212.6901670006919,0.4774260578583765,0.7735561057959495,0.12839359295905609,1076109.8274966523,975.5957842696162,1077085.4232809218,2602,1,379.94300518134713,69,124,42,37.160005300183094,0.5582361830742659,42.63392857142856,8362.484002055511,121.1954203196451,8
4122,32.58602062397488,0,2,188,0.0,0.010526315789473684,0.9894736842105263,190,5900,4200,1700,0.711864406779661,76,42,34,217.73051664033576,0.4766986911723754,0.7798174122065138,0.13098071690213678,1078138.863276754,3048.746342254234,1081187.6096190084,2603,3,386.7736842105263,78,112,40,37.160199566012245,0.5597587719298245,42.761075949367076,8382.392884402996,107.46657544106405,8
4123,32.47919960376562,0,3,185,0.0,0.015957446808510637,0.9840425531914894,188,6100,4500,1600,0.7377049180327869,77,45,32,215.14971247273408,0.4762202753441802,0.7719252724442136,0.12601626016260167,1066358.096365823,2185.3275652158877,1068543.423931039,2604,4,391.3829787234043,87,101,39,38.2367886178862,0.5509751773049645,43.75000000000001,8322.79489846496,95.66430917775816,8
4124,32.46369378629765,2,3,184,0.0106951871657754,0.016042780748663103,0.983957219251337,187,5600,3900,1700,0.6964285714285714,73,39,34,209.3997517074545,0.47542071569585803,0.7649195904264889,0.12386239625008744,1068902.4035106318,1765.579578925519,1070667.9830895574,2605,0,392.67914438502675,70,117,38,38.00966687629828,0.5538101604278075,43.38321596244131,8330.728697419778,119.01040996313968,0
4125,32.18650241220173,1,0,185,0.005405405405405406,0.0,1.0,185,6250,4800,1450,0.768,77,48,29,198.22377847147663,0.4747870152761457,0.7519191836900956,0.11526860387013624,1054522.0140015697,-1443.732380651249,1053078.2816209185,2606,0,385.71351351351353,80,105,40,38.94593067068577,0.5480855855855855,44.020061728395085,8239.098900654315,102.98873625817893,8
4126,31.695351918965645,0,0,185,0.0,0.0,1.0,185,6650,4900,1750,0.7368421052631579,84,49,35,202.25787783757823,0.47453241284763026,0.7522820816876281,0.11464952819183179,1030594.1796201572,-1960.8416636536099,1028633.3379565036,2607,1,386.71351351351353,84,101,36,39.82992134813462,0.5373873873873873,44.9877450980392,8082.703162766575,96.22265669960208,8
4127,31.874067647046147,5,2,188,0.02631578947368421,0.010526315789473684,0.9894736842105263,190,5500,4100,1400,0.7454545454545455,69,41,28,196.71425268397803,0.4757182307620904,0.7531966919156257,0.11274403855011864,1039823.8308493682,-2590.366438295236,1037233.464411073,2608,0,377.5105263157895,78,112,41,39.54278942115768,0.5404605263157894,44.567510548523195,8141.672448029742,104.3804160003813,0
4128,32.049758397787016,4,2,190,0.020833333333333332,0.010416666666666666,0.9895833333333334,192,5150,3700,1450,0.7184466019417476,66,37,29,194.91929382776416,0.47648126181646305,0.7537476564520307,0.11266859629775229,1048188.827137845,-2687.554803227888,1045501.2723346171,2609,0,372.171875,83,109,43,39.26089345746058,0.5431315104166667,44.24603174603174,8196.852891814955,98.7572637568067,0
4129,32.130185486017815,3,3,190,0.015544041450777202,0.015544041450777202,0.9844559585492227,193,4600,3100,1500,0.6739130434782609,61,31,30,184.22140912527232,0.47681549546632124,0.7406256093874133,0.10321717502504243,1041074.3474555737,-4842.363341512379,1036231.9841140613,2610,0,370.9481865284974,80,113,45,40.745032415593165,0.5330310880829016,45.43467078189299,8179.231246086932,102.24039057608664,8
4130,32.16138057525435,2,2,190,0.010416666666666666,0.010416666666666666,0.9895833333333334,192,6500,4300,2200,0.6615384615384615,87,43,44,232.40999838827167,0.47648751090750435,0.7918824544883865,0.1326986119829811,1048013.9409646941,3813.783666098155,1051827.7246307924,2611,0,373.3697916666667,64,128,33,38.77837936806861,0.5366753472222222,44.71153846153847,8210.429368009656,128.28795887515088,8
4131,31.674796551770857,1,5,186,0.005235602094240838,0.02617801047120419,0.9738219895287958,191,4950,3300,1650,0.6666666666666666,66,33,33,214.7345446380618,0.4763927160834022,0.7788851430080637,0.12265346024241805,1032275.8751113568,1183.0579965787,1033458.9331079356,2612,0,375.81675392670155,65,126,40,39.21473170128586,0.5367582897033158,44.69696969696969,8086.671543899056,124.41033144460086,8
4132,31.76323899701447,3,4,185,0.015873015873015872,0.021164021164021163,0.9788359788359788,189,6950,5700,1250,0.8201438848920863,82,57,25,212.98614405000333,0.4760696930466434,0.7750409659495263,0.12283702386448836,1038133.2862100503,-528.3988720325656,1037604.8873380178,2613,0,380.62433862433863,69,120,39,38.88494800457865,0.5395723104056438,44.33035714285714,8120.89597035276,117.69414449786609,0
4133,31.49320103517284,3,3,185,0.015957446808510637,0.015957446808510637,0.9840425531914894,188,5750,4100,1650,0.7130434782608696,74,41,33,212.55970963277142,0.476649315432169,0.7735183370268965,0.12029788824861362,1023533.1152110323,162.38035375667368,1023695.495564789,2614,0,382.6329787234043,72,116,39,39.62927464039847,0.5355718085106382,45.048515981735164,8029.238340402882,111.51719917226225,8
4134,31.260316680911206,4,1,188,0.021164021164021163,0.005291005291005291,0.9947089947089947,189,7450,6100,1350,0.8187919463087249,88,61,27,212.5267996194066,0.4771825396825397,0.7735973114452093,0.12195968226379214,1020181.4887620384,-1886.81863248832,1018294.67012955,2615,0,381.48148148148147,68,121,41,39.09029131950597,0.538966049382716,44.5199275362319,7986.387970879564,117.44688192469947,0
4135,31.576531570852147,1,0,189,0.005291005291005291,0.0,1.0,189,6400,5200,1200,0.8125,76,52,24,209.99329026225848,0.47710866261398177,0.7716223820482611,0.12144564848679987,1032872.1627326229,-820.7552254963957,1032051.4075071266,2616,0,382.46560846560845,69,120,39,38.855112093708776,0.5408950617283951,44.22619047619047,8076.449771425677,117.04999668732864,0
4136,31.78396629274001,1,0,190,0.005263157894736842,0.0,1.0,190,5850,4000,1850,0.6837606837606838,77,40,37,209.4248262199403,0.47719356261022927,0.7722525376987617,0.12182494754817541,1041441.2774358353,-229.26829094551067,1041212.0091448898,2617,0,381.44736842105266,72,118,35,38.645717205499814,0.5428179824561403,44.00684931506849,8136.477672542179,113.0066343408636,0
4137,31.63790986834268,1,3,188,0.005235602094240838,0.015706806282722512,0.9842931937172775,191,5150,3300,1850,0.6407766990291263,70,33,37,212.72804541341281,0.47716198218058237,0.7774835053559348,0.12450529764551546,1038511.6572879915,834.1109987837581,1039345.7682867752,2618,0,380.4450261780105,74,117,37,38.32721252529633,0.5445026178010471,43.777777777777786,8106.335572933151,109.54507530990745,0
4138,32.12878397029029,0,0,188,0.0,0.0,1.0,188,5800,3700,2100,0.6379310344827587,79,37,42,230.67840082581458,0.47612901543596164,0.7842654345328914,0.1311970189848014,1045732.7833888674,4845.5932326544835,1050578.3766215218,2619,1,387.26063829787233,75,113,38,38.974673202614376,0.5374556737588653,44.86019736842106,8197.331600972524,109.29775467963366,8
4139,31.91784906794371,3,3,188,0.015706806282722512,0.015706806282722512,0.9842931937172775,191,5350,4000,1350,0.7476635514018691,67,40,27,225.03441085436782,0.47648456875172224,0.7822573905681083,0.1290227353615929,1041365.7535501876,3318.625766816434,1044684.379317004,2620,0,382.16230366492147,69,122,40,38.80514777272907,0.5400850785340314,44.553571428571445,8153.3005520881525,118.1637761172196,0
4140,31.749645952565565,1,3,186,0.005291005291005291,0.015873015873015872,0.9841269841269842,189,5900,3800,2100,0.6440677966101694,80,38,42,226.0230077427807,0.47670175241097223,0.7840025475816108,0.12947717997527178,1035610.9223010974,3114.379101953926,1038725.3014030514,2621,0,381.94179894179894,65,124,42,38.81355692187272,0.5396274250440918,44.5864898989899,8109.288517209112,124.75828488014018,8
4141,31.964934183800676,3,1,188,0.015873015873015872,0.005291005291005291,0.9947089947089947,189,5450,3600,1850,0.6605504587155964,73,36,37,220.15663547390304,0.4765528256219746,0.7748347529046753,0.12660641905975387,1043833.170789364,2711.3597754088,1046544.5305647728,2622,0,380.6084656084656,70,119,41,38.813221195246584,0.5411706349206349,44.43955399061036,8168.9728366729505,116.69961195247072,8
4142,31.6726868457407,1,1,188,0.005291005291005291,0.005291005291005291,0.9947089947089947,189,5900,4000,1900,0.6779661016949152,78,40,38,206.28570150094546,0.4762549720439791,0.7657994536364807,0.11685279832940071,1029646.0600277549,-1219.7480418977011,1028426.3119858572,2623,0,380.92063492063494,74,115,41,39.75389000853349,0.5347222222222222,45.01388888888891,8076.095247235509,109.13642225993931,8
4143,32.178380424225224,5,2,191,0.025906735751295335,0.010362694300518135,0.9896373056994818,193,5900,3900,2000,0.6610169491525424,79,39,40,210.26586739177841,0.47652089630109384,0.7733628621348534,0.11612848822922064,1038079.1699390153,-845.4765822871941,1037233.6933567281,2624,0,373.99481865284974,78,115,36,40.650630710132894,0.5242335924006909,45.9915611814346,8173.58017526733,104.78948942650423,8
4144,32.43833329577512,4,1,194,0.020512820512820513,0.005128205128205128,0.9948717948717949,195,6250,4700,1550,0.752,78,47,31,202.7327050984866,0.47702881311128736,0.7685096700796352,0.11292905436094428,1049201.2966237022,-2708.516588527359,1046492.7800351748,2625,0,370.83076923076925,71,124,40,40.50341296928326,0.5267628205128205,45.65972222222223,8250.374701095598,116.20246057881124,0
4145,32.09678251374177,6,3,197,0.03,0.015,0.985,200,6100,4400,1700,0.7213114754098361,78,44,34,182.7441204906295,0.4785029313232831,0.7501126279863486,0.10179472871436143,1038154.0112991144,-8156.691654265096,1029997.3196448494,2626,0,361.08,77,123,41,41.01180318543796,0.5280208333333334,45.6597222222222,8163.50458031795,106.01954000412923,8
4146,31.79512109624927,3,2,198,0.015,0.01,0.99,200,6200,4400,1800,0.7096774193548387,80,44,36,177.54140133239264,0.4785903475711893,0.7425427113913101,0.09967935093990177,1030859.4497113432,-9595.95374430202,1021263.4959670411,2627,0,361.09,84,116,42,40.834396105041954,0.5309895833333333,45.35539215686273,8096.456142879407,96.38638265332627,0
4147,32.186874736577,1,4,195,0.005025125628140704,0.020100502512562814,0.9798994974874372,199,6950,4700,2250,0.6762589928057554,92,47,45,176.38707421443374,0.4785660203373771,0.7376364692942077,0.09955034095243827,1045208.1127123694,-9877.759810695117,1035330.3529016743,2628,0,362.95477386934675,88,111,37,40.65934907075715,0.533500837520938,45.15449438202246,8202.68036650545,93.2122768921074,0
4148,32.16162004126535,2,3,194,0.01015228426395939,0.015228426395939087,0.9847715736040609,197,6300,4400,1900,0.6984126984126984,82,44,38,173.75871878154425,0.4780627352463828,0.730256272938266,0.09844578882211683,1045598.9575708074,-9363.612954635824,1036235.3446161716,2629,0,366.79695431472084,91,106,39,40.576064191939416,0.5357445008460238,45.00679347826086,8200.994621256046,90.1208200138027,0
4149,32.63243930417342,1,5,190,0.005128205128205128,0.02564102564102564,0.9743589743589743,195,6650,4300,2350,0.6466165413533834,90,43,47,211.777334438605,0.47782293594149267,0.7780336807792576,0.11630013897635075,1050889.1669594487,-1139.0986861845568,1049750.0682732642,2630,0,369.4102564102564,73,122,36,40.83877595355629,0.520619658119658,46.213400900900886,8281.67579131391,113.4476135796426,8
4150,32.63859275596573,2,1,191,0.010416666666666666,0.005208333333333333,0.9947916666666666,192,6950,5500,1450,0.7913669064748201,84,55,29,225.74499158844898,0.4778276568862711,0.7806211049078167,0.1242985362606684,1051942.077251212,2144.131076121931,1054086.208327334,2631,0,375.640625,78,114,38,40.37879771487922,0.5224066840277778,46.11023206751054,8286.604740455145,106.2385223135275,8
4151,32.86200400150303,5,5,191,0.025510204081632654,0.025510204081632654,0.9744897959183674,196,4950,3100,1850,0.6262626262626263,68,31,37,218.9112744596212,0.47861612593755454,0.7796987138916427,0.1218629863359909,1062697.42405747,2377.2894930753337,1065074.7135505453,2632,0,367.4030612244898,69,127,42,40.117271308757545,0.5254039115646258,45.6845238095238,8357.316196215563,121.12052458283424,0
4152,32.399756400171846,5,1,195,0.025510204081632654,0.00510204081632653,0.9948979591836735,196,5400,3400,2000,0.6296296296296297,74,34,40,202.11424420026827,0.479210273853131,0.7661112944022872,0.11077907308698287,1042773.8447076146,-2448.11050102236,1040325.7342065923,2633,0,365.4030612244898,79,117,46,41.16120306218458,0.5212585034013606,46.289062500000014,8220.172571059256,104.05281735518047,8
4153,32.57321426797717,6,5,196,0.029850746268656716,0.024875621890547265,0.9751243781094527,201,5950,4200,1750,0.7058823529411765,77,42,35,199.97672525874964,0.47982690713101156,0.771092728849418,0.1108627671430632,1052029.2345262852,-4073.7277605924764,1047955.5067656927,2634,0,357.2786069651741,88,113,44,40.76252974134624,0.5246165008291874,45.845037453183544,8278.644052307236,94.07550059440041,0
4154,32.188532290662906,4,3,197,0.02,0.015,0.985,200,7000,4800,2200,0.6857142857142857,92,48,44,205.80376380773467,0.47989426298157456,0.7743839508979311,0.11532875885225789,1043017.5751973359,-4068.6114613542723,1038948.9637359816,2635,0,359.815,71,129,44,40.189058119269504,0.5276041666666667,45.42824074074074,8194.29129320753,115.41255342545817,0
4155,31.849824299654145,8,1,204,0.03902439024390244,0.004878048780487805,0.9951219512195122,205,5900,3700,2200,0.6271186440677966,81,37,44,219.56754468408357,0.4814791567033317,0.7888151941318622,0.12299003542083979,1031910.911450202,-1585.170968032945,1030325.7404821691,2636,0,348.81951219512194,74,131,43,39.85523061254179,0.5285569105691057,45.444444444444436,8107.549718945279,109.56148268844971,8
4156,31.806382548618124,5,1,208,0.023923444976076555,0.004784688995215311,0.9952153110047847,209,6100,4200,1900,0.6885245901639344,80,42,38,214.29384550009388,0.48181779842964056,0.7928258148142782,0.11875981800105273,1027156.7109222756,-3877.32769704742,1023279.3832252282,2637,0,343.0622009569378,83,126,41,40.4120311635926,0.518092105263158,45.858134920634924,8083.333382333591,97.38955882329627,8
4157,32.01121283947771,2,4,206,0.009523809523809525,0.01904761904761905,0.9809523809523809,210,6400,4300,2100,0.671875,85,43,42,220.56000994075356,0.4820127971443761,0.7955958357031585,0.1226347620238431,1034809.0407351573,-2752.5015377345926,1032056.5391974227,2638,0,342.4,70,140,35,40.122468409208935,0.5199404761904762,45.73063380281689,8139.4707998971,116.27815428424428,8
4158,32.26011827317534,3,3,206,0.014354066985645933,0.014354066985645933,0.9856459330143541,209,6150,4600,1550,0.7479674796747967,77,46,31,221.59313740139635,0.48217818365844684,0.7985518622525944,0.12466020866838537,1046565.8372149438,-1567.638526884717,1044998.1986880591,2639,0,344.5693779904306,76,133,39,39.63422999982295,0.5245215311004785,45.278679653679625,8217.339921071607,108.12289369831062,8
4159,32.20803228172548,4,5,205,0.01904761904761905,0.023809523809523808,0.9761904761904762,210,5850,4000,1850,0.6837606837606838,77,40,37,231.88553238528118,0.48272338042074886,0.8077057424825871,0.13086208473513528,1045869.1998935515,654.3872445369589,1046523.5871380885,2640,0,343.0904761904762,73,137,35,39.248232434821034,0.5227678571428571,45.157657657657666,8207.970388912716,112.43795053305091,8
4160,32.677343276698345,2,4,203,0.00966183574879227,0.01932367149758454,0.9806763285024155,207,6650,4800,1850,0.7218045112781954,85,48,37,228.81815363630648,0.4826237434141613,0.8068713149986686,0.1276797254473245,1057486.990623038,344.4441377558787,1057831.4347607938,2641,0,348.69565217391306,64,143,40,39.7716535433071,0.5213365539452496,45.59294871794874,8313.34654675623,129.89603979306608,8
4161,32.885551685813965,1,3,201,0.004901960784313725,0.014705882352941176,0.9852941176470589,204,6550,5000,1550,0.7633587786259542,81,50,31,226.72580075452814,0.48198137013426057,0.8018525233577507,0.12746054596899936,1066635.7596192549,1016.769342618356,1067652.5289618731,2642,0,354.4656862745098,68,136,41,39.53035781321005,0.5236417483660131,45.304951690821284,8375.787175292448,123.17334081312423,0
4162,33.33615983499416,4,4,201,0.01951219512195122,0.01951219512195122,0.9804878048780488,205,6150,3900,2250,0.6341463414634146,84,39,45,213.89285869537642,0.4826368962219034,0.7920763889414733,0.11866153941746604,1076903.2688447207,-1081.6162576813635,1075821.6525870394,2643,0,353.4439024390244,65,140,41,40.380769429783705,0.521189024390244,45.817550505050505,8473.466763613971,130.36102713252262,8
4163,33.223103983631226,3,6,198,0.014705882352941176,0.029411764705882353,0.9705882352941176,204,6600,4500,2100,0.6818181818181818,87,45,42,214.31990628324547,0.4827017732380308,0.7928427183536435,0.11735822033212841,1068961.5339213135,-1580.0528459183097,1067381.4810753951,2644,0,355.9950980392157,73,131,39,40.88927501248544,0.5129187091503268,46.326013513513495,8427.837230982754,115.44982508195552,8
4164,33.03344084686988,6,2,202,0.029411764705882353,0.00980392156862745,0.9901960784313726,204,6450,4600,1850,0.7131782945736435,83,46,37,201.52160000000072,0.48337237193728066,0.7802058823529414,0.11146106194690247,1066138.52789415,-4280.011607425326,1061858.5162867247,2645,0,351.79901960784315,81,123,40,40.81499999999997,0.5166462418300654,45.93495934959348,8392.642491582748,103.61287026645368,0
4165,32.549757956152874,1,4,199,0.0049261083743842365,0.019704433497536946,0.9802955665024631,203,5850,3500,2350,0.5982905982905983,82,35,47,210.82304905311292,0.4828917312913557,0.7853902094811813,0.11648636889359816,1050198.4946127147,-2168.790250951683,1048029.7043617631,2646,0,354.46305418719214,80,123,37,40.619357397188615,0.5216543513957307,45.974794238683124,8268.458962292785,103.35573702865982,8
4166,32.40324827565539,3,1,201,0.01485148514851485,0.0049504950495049506,0.995049504950495,202,6400,4700,1700,0.734375,81,47,34,223.66233480449014,0.4826609526624304,0.797015346773924,0.12209957010830808,1041595.7916707367,-206.8506624785864,1041388.9410082581,2647,0,356.91584158415844,67,135,41,40.7750322216852,0.5155734323432344,46.44607843137253,8215.97067185424,122.62642793812299,8
4167,32.66602125738629,3,6,198,0.014705882352941176,0.029411764705882353,0.9705882352941176,204,5900,4100,1800,0.6949152542372882,77,41,36,219.2739617358455,0.48332508290672593,0.7936959242531438,0.12032241250581083,1051715.8871297666,-577.2181617057222,1051138.668968061,2648,0,353.7352941176471,70,134,46,40.67992599444955,0.5173611111111112,46.244131455399035,8289.194596064395,118.41706565806278,0
4168,32.6586768298423,4,4,198,0.019801980198019802,0.019801980198019802,0.9801980198019802,202,5900,4300,1600,0.7288135593220338,75,43,32,260.6265966612894,0.4834480649557493,0.825726965489757,0.1441479008107171,1054034.2908282753,8641.873996573864,1062676.1648248492,2649,0,357.3811881188119,70,132,37,39.314450154953704,0.5183580858085808,45.93603286384977,8297.392996807212,118.53418566867445,8
4169,32.14248126652299,6,2,202,0.029411764705882353,0.00980392156862745,0.9901960784313726,204,5300,3500,1800,0.660377358490566,71,35,36,246.22699067816802,0.4834830483917705,0.8210838412428725,0.13637517957330422,1037820.5759412072,5007.887455577194,1042828.4633967844,2650,0,354.8333333333333,64,140,38,39.624324693615826,0.511233660130719,45.88141025641024,8168.002010308549,127.62503141107108,8
4170,32.606597572696266,4,2,204,0.019417475728155338,0.009708737864077669,0.9902912621359223,206,5550,3800,1750,0.6846846846846847,73,38,35,247.6450040882478,0.484131048227958,0.8215407979553,0.1394980996283135,1058222.9945526724,5662.727562454991,1063885.7221151274,2651,0,352.1504854368932,61,145,40,38.91920557460652,0.5149170711974109,45.228494623655926,8307.2319487965,136.18413030813934,0
4171,32.882836077630685,3,6,201,0.014492753623188406,0.028985507246376812,0.9710144927536232,207,7150,5200,1950,0.7272727272727273,91,52,39,237.99758634065762,0.48426629457655207,0.8137639203557847,0.1328435281098136,1064238.6069764777,2107.243950189303,1066345.850926667,2652,0,351.24154589371983,65,142,37,39.52569272125723,0.5176630434782609,45.5808080808081,8366.024582882088,128.70807050587828,8
4172,32.41862644227383,2,2,201,0.009852216748768473,0.009852216748768473,0.9901477832512315,203,6400,4600,1800,0.71875,82,46,36,233.65186920494227,0.48402774390739567,0.8073872064822705,0.13145741877609218,1051740.4565014686,2148.224716005639,1053888.6812174742,2653,0,356.2512315270936,68,135,38,39.32305557201841,0.5200636288998358,45.27475845410629,8257.842451094326,121.43885957491656,0
4173,32.663138828521284,1,2,200,0.0049504950495049506,0.009900990099009901,0.9900990099009901,202,6400,4300,2100,0.671875,85,43,42,252.98243219082258,0.48403506395415663,0.8188134065685415,0.13808550555951762,1049902.3458396373,6321.369802672252,1056223.7156423095,2654,0,358.94059405940595,63,139,39,40.03749946505754,0.5075288778877888,46.451822916666664,8281.679307791414,131.45522710780023,8
4174,32.23323731593969,4,3,201,0.0196078431372549,0.014705882352941176,0.9852941176470589,204,5500,3900,1600,0.7090909090909091,71,39,32,251.7718451859117,0.4845691868701503,0.8197963263915651,0.1389454493001786,1039604.4711917614,6048.627195094795,1045653.0983868563,2655,0,356.36764705882354,71,133,33,39.626946264122296,0.5103656045751634,46.02141203703704,8186.552098977448,115.30355068982321,0
4175,32.40112077139057,2,4,199,0.009852216748768473,0.019704433497536946,0.9802955665024631,203,6850,4700,2150,0.6861313868613139,90,47,43,288.92205265827255,0.4844169145978637,0.8394955110049931,0.16097746712961689,1048072.9786244147,13112.279263966999,1061185.2578883816,2656,0,358.64039408866995,56,147,34,38.301869281984956,0.5132389162561577,45.65058479532163,8241.206120179331,147.16439500320234,7
4176,32.80279849544888,7,6,200,0.03398058252427184,0.02912621359223301,0.970873786407767,206,6650,4400,2250,0.6616541353383458,89,44,45,269.5432025896705,0.4848996566421975,0.8358770710439054,0.1530616894619971,1067171.3408774324,9679.756186403167,1076851.0970638355,2657,0,351.31067961165047,64,142,34,38.04436032753242,0.5174453883495146,44.91987179487179,8367.342045706073,130.7397194641574,8
4177,33.23761401524219,4,2,202,0.0196078431372549,0.00980392156862745,0.9901960784313726,204,5550,3900,1650,0.7027027027027027,72,39,33,258.03208640603657,0.4847321831031263,0.8276506223554101,0.1477973950660147,1084110.2509430794,9597.045989002774,1093707.2969320822,2658,0,349.48039215686276,56,148,36,38.0002623545125,0.5206801470588236,44.59064327485379,8489.197614711691,151.59281454842306,0
4178,33.53369433842834,5,2,205,0.024154589371980676,0.00966183574879227,0.9903381642512077,207,5950,3800,2150,0.6386554621848739,81,38,43,249.5109522155583,0.485169160295796,0.8242509456205034,0.14511377018036312,1098707.1910555938,7477.895489272327,1106185.0865448662,2659,0,345.24154589371983,62,145,37,37.62743293286828,0.5245068438003221,44.01455026455026,8584.137826513668,138.45383591151077,0
4179,32.965506618356045,0,3,202,0.0,0.014634146341463415,0.9853658536585366,205,6150,4100,2050,0.6666666666666666,82,41,41,248.80033227180192,0.4851018252829587,0.818176243811114,0.142460098371251,1075123.947767642,6348.239087592267,1081472.1868552344,2660,1,346.8536585365854,60,145,40,38.24955981991621,0.5231199186991871,44.60382513661203,8419.26429276185,140.32107154603085,8
4180,32.503095757990984,1,1,202,0.0049261083743842365,0.0049261083743842365,0.9950738916256158,203,5500,3400,2100,0.6181818181818182,76,34,42,245.99001711130302,0.4850570648197825,0.81428251056085,0.13871843612511364,1055213.8752521763,5814.415845873733,1061028.29109805,2661,0,339.2068965517241,65,138,40,38.91807319087437,0.5224753694581281,45.18623737373739,8282.236127095435,127.41901733992977,8
4181,32.29870548317653,2,2,202,0.00980392156862745,0.00980392156862745,0.9901960784313726,204,5950,4000,1950,0.6722689075630253,79,40,39,242.0046637967798,0.4849364314691394,0.812856856091489,0.13746276019061207,1050860.9777652277,4112.651524246236,1054973.6292894739,2662,0,338.5049019607843,70,134,44,38.7357172983647,0.524969362745098,44.90903755868547,8239.107867312121,117.70154096160172,0
4182,31.842540929420522,2,3,201,0.00980392156862745,0.014705882352941176,0.9852941176470589,204,5950,3900,2050,0.6554621848739496,80,39,41,243.02954732323164,0.4845696899449435,0.8096119311462491,0.13543098840460616,1030058.5238896159,3316.9313554660475,1033375.4552450819,2663,0,339.4264705882353,65,139,39,39.462335567138275,0.5185866013071896,45.643939393939405,8099.343270494672,124.60528108453342,8
4183,31.92164579876645,2,2,201,0.009852216748768473,0.009852216748768473,0.9901477832512315,203,7100,4900,2200,0.6901408450704225,93,49,44,236.78292908386956,0.48445044627615474,0.803808587312558,0.13298543700073057,1035068.3600944197,1317.3036210388764,1036385.6637154586,2664,0,340.70443349753697,69,134,38,39.31240139075556,0.5209872742200328,45.342261904761905,8129.094115391224,117.8129581940757,0
4184,31.792052375319532,5,2,204,0.024271844660194174,0.009708737864077669,0.9902912621359223,206,5300,3600,1700,0.6792452830188679,70,36,34,241.41395739425283,0.4851167219196464,0.8144937586685161,0.1345846672658979,1028550.8341875073,3161.3054524731906,1031712.1396399805,2665,0,336.5242718446602,60,146,39,39.48753020945222,0.5174453883495146,45.62841530054645,8086.99474355806,134.78324572596767,8
4185,31.936844932783877,6,4,206,0.02857142857142857,0.01904761904761905,0.9809523809523809,210,6550,4300,2250,0.6564885496183206,88,43,45,198.1444995369213,0.4854252107541581,0.7777594287381049,0.10978085017721795,1031286.1832944944,-7681.263066354114,1023604.9202281403,2666,0,331.0761904761905,88,122,41,40.83296872841156,0.5206845238095238,45.868445692883896,8116.160042433712,92.22909139129219,8
4186,31.937718923959263,8,2,212,0.037383177570093455,0.009345794392523364,0.9906542056074766,214,6650,4700,1950,0.706766917293233,86,47,39,187.53990621234752,0.4859196064235882,0.7704026855645332,0.10565450446614619,1036555.0452840427,-10570.91280469927,1025984.1324793434,2667,0,323.28504672897196,81,133,44,40.44550259274031,0.5256522585669782,45.223577235772325,8136.977778695636,100.45651578636587,0
4187,31.45365928861885,2,6,208,0.009345794392523364,0.028037383177570093,0.9719626168224299,214,6600,4500,2100,0.6818181818181818,87,45,42,196.62207794451706,0.4859826795664956,0.7841900660614864,0.11049467402877028,1020075.0157058558,-9286.146150525772,1010788.86955533,2668,0,323.56542056074767,72,142,44,40.312056439563705,0.5273072429906542,45.31963470319635,8010.629437546658,111.25874218814802,8
4188,31.888394816426292,7,5,210,0.03255813953488372,0.023255813953488372,0.9767441860465116,215,6550,4400,2150,0.6717557251908397,87,44,43,185.33336951075532,0.48665326378323553,0.7706993340485073,0.1051729570185331,1037217.2925442676,-11103.804851589604,1026113.487692678,2669,0,320.5906976744186,94,121,41,40.218158434002575,0.5332848837209303,44.945175438596486,8133.288945448365,86.52435048349324,8
4189,31.513926913674208,0,5,205,0.0,0.023809523809523808,0.9761904761904762,210,7400,5300,2100,0.7162162162162162,95,53,42,186.90979927356994,0.4858471937419306,0.7690556292494126,0.10643116616106417,1026087.2924610369,-11042.84602578968,1015044.4464352473,2670,1,328.9238095238095,90,120,45,40.04489451098249,0.5347222222222222,44.81456043956042,8041.895291741459,89.35439213046065,0
4190,31.613677570591875,1,0,206,0.0048543689320388345,0.0,1.0,206,6650,4800,1850,0.7218045112781954,85,48,37,191.32487297230844,0.48529678743389376,0.7680208055692621,0.10981032880891245,1031762.2060154931,-8369.645399291,1023392.5606162022,2671,0,333.54368932038835,74,132,46,39.62580411343664,0.5368122977346279,44.51388888888892,8076.855540431151,109.14669649231286,0
4191,31.405291477167182,2,4,204,0.009615384615384616,0.019230769230769232,0.9807692307692307,208,7150,5100,2050,0.7132867132867133,92,51,41,209.55917715298943,0.48538821534745447,0.7861117665565514,0.11778670991702507,1018563.4634483093,-6060.135744334593,1012503.3277039748,2672,0,331.3269230769231,75,133,43,39.975289706884816,0.526943108974359,45.3125,7998.535173091018,106.64713564121357,8
4192,31.69454289806728,2,5,201,0.009708737864077669,0.024271844660194174,0.9757281553398058,206,6450,4700,1750,0.7286821705426356,82,47,35,207.32925500858013,0.48539348014839373,0.7804497101438357,0.11731668556016671,1030021.2894564194,-4939.290682804676,1025081.9987736148,2673,0,335.3543689320388,78,128,40,39.76963192828203,0.529126213592233,45.05537974683544,8080.353203245395,103.59427183647942,0
4193,31.74226392780561,1,0,202,0.0049504950495049506,0.0,1.0,202,6450,4500,1950,0.6976744186046512,84,45,39,224.8882962314291,0.48509412508415023,0.7938532654527286,0.12419789182118948,1023993.6333522242,-793.163288717722,1023200.4700635065,2674,0,338.23762376237624,77,125,37,40.28128286014722,0.5202145214521452,45.99358974358973,8062.7385137134115,104.71088978848586,8
4194,32.15191740054526,6,5,203,0.028846153846153848,0.02403846153846154,0.9759615384615384,208,6750,4700,2050,0.6962962962962963,88,47,41,203.51077864523066,0.48566353508608945,0.7823011375920323,0.11473645713939769,1043738.511535718,-5867.5925630706515,1037870.9189726473,2675,0,329.4519230769231,79,129,35,40.00976246444205,0.5297976762820513,45.19531249999998,8192.459265771693,103.70201602242649,8
4195,32.32757379947326,1,2,202,0.004901960784313725,0.00980392156862745,0.9901960784313726,204,6150,4700,1450,0.7642276422764228,76,47,29,205.97290051845698,0.4849510206381403,0.7780181765643326,0.11560122209181059,1048010.7793279708,-3777.6360014420716,1044233.1433265287,2676,0,333.8970588235294,82,122,37,40.124266844102706,0.5309436274509804,45.36897590361444,8231.603223111313,100.38540515989406,8
4196,32.136952410445815,5,2,205,0.024154589371980676,0.00966183574879227,0.9903381642512077,207,6200,4200,2000,0.6774193548387096,82,42,40,202.58871720398304,0.48527371292778637,0.7792521744391447,0.1150090198284738,1045421.834600937,-5241.866318232604,1040179.9682827044,2677,0,330.0048309178744,89,118,38,39.76313640076228,0.5338667471819646,44.930555555555536,8197.154597469911,92.10286064572934,0
4197,31.963669818319413,1,1,205,0.0048543689320388345,0.0048543689320388345,0.9951456310679612,206,6700,4600,2100,0.6865671641791045,88,46,42,201.35109266968442,0.4847077512037256,0.7798219069615084,0.11490021847687286,1041396.3539824592,-5962.741244681011,1035433.6127377781,2678,0,332.50485436893206,70,136,41,39.59315190528191,0.5359021035598706,44.732981220657294,8159.27070376969,116.56101005385271,0
4198,31.85626987845331,1,2,204,0.0048543689320388345,0.009708737864077669,0.9902912621359223,206,7100,4900,2200,0.6901408450704225,93,49,44,202.70678947588962,0.4844309929749783,0.7810768339626135,0.11562926961644354,1037777.894813104,-6227.074950677639,1031550.8198624263,2679,0,333.4854368932039,70,136,43,39.57351419703413,0.5320084951456311,44.747652582159624,8131.38766645145,116.16268094930643,8
4199,31.790972847584523,0,5,199,0.0,0.024509803921568627,0.9754901960784313,204,6150,4200,1950,0.6829268292682927,81,42,39,204.32047668178413,0.48439009224379403,0.7809268189380656,0.11695516401183224,1036722.4843606692,-4585.273561740886,1032137.2107989283,2680,1,337.65686274509807,70,134,41,39.39758430516461,0.533343545751634,44.6156103286385,8118.918197739209,115.9845456819887,0
4200,32.03526909867719,5,4,200,0.024509803921568627,0.0196078431372549,0.9803921568627451,204,6450,4100,2350,0.6356589147286822,88,41,47,214.632188993309,0.4844001537396568,0.7852253352467147,0.12361262035932498,1046589.4016308038,-2323.645150156419,1044265.7564806474,2681,0,336.4019607843137,73,131,40,38.897091891991124,0.5357945261437909,44.383445945945965,8188.745095198228,112.17459034518122,8
4201,32.39413422133968,2,5,197,0.009900990099009901,0.024752475247524754,0.9752475247524752,202,6250,4300,1950,0.688,82,43,39,213.10112738450422,0.48459230251383345,0.7804495358338353,0.123606495690829,1060535.3680287406,-1449.7434883867008,1059085.624540354,2682,0,339.1485148514852,76,126,34,38.662327077275556,0.5392945544554455,44.11525974025977,8289.164621166748,109.06795554166774,0
4202,32.165378377442956,1,3,195,0.005050505050505051,0.015151515151515152,0.9848484848484849,198,5550,3700,1850,0.6666666666666666,74,37,37,204.26267448772003,0.48417657967150357,0.7721366088007111,0.11675209914196816,1048477.9925752115,-2317.0162190138963,1046160.9763561975,2683,0,345.57070707070704,68,130,40,39.45547310747152,0.5364057239057238,44.67089371980679,8212.75731427683,120.77584285701221,8
4203,32.640878678430234,5,2,198,0.025,0.01,0.99,200,6150,4300,1850,0.6991869918699187,80,43,37,195.9153480044702,0.4845121440536013,0.7664543184409089,0.11352490171721819,1068300.072438233,-4290.723907012332,1064009.3485312208,2684,0,338.375,74,126,46,39.14033802001338,0.5401041666666666,44.1527777777778,8351.07814076899,112.85240730768905,0
4204,32.81021301072381,1,6,193,0.005025125628140704,0.03015075376884422,0.9698492462311558,199,7000,5000,2000,0.7142857142857143,90,50,40,195.96294828485983,0.48435252863644823,0.7648518837280298,0.11414927736546475,1075496.671079083,-4648.500292957816,1070848.1707861254,2685,0,340.91959798994975,80,119,39,38.93824292650256,0.5425041876046901,43.95576131687245,8400.86601136208,105.01082514202601,0
4205,32.44517070292878,1,0,194,0.005154639175257732,0.0,1.0,194,6500,5100,1400,0.7846153846153846,79,51,28,210.6466154811716,0.48451605149297583,0.7757089012690301,0.12131721822145917,1059980.8507052504,-643.7242648170036,1059337.1264404333,2686,0,344.67525773195877,73,121,43,38.998969748701306,0.5416666666666667,44.38344594594596,8293.522730778235,113.60990042161966,8
4206,32.19743099049285,2,2,194,0.01020408163265306,0.01020408163265306,0.9897959183673469,196,6150,4400,1750,0.7154471544715447,79,44,35,211.09619076606123,0.484614294435723,0.7785568463520169,0.12000226395772716,1047816.9978111314,-1111.9646284283745,1046705.0331827031,2687,0,342.1479591836735,83,113,37,39.49295395259158,0.5412414965986394,44.8784722222222,8214.25778481404,98.96696126281977,8
4207,31.978154102936784,2,2,194,0.01020408163265306,0.01020408163265306,0.9897959183673469,196,6950,5000,1950,0.7194244604316546,89,50,39,213.55431892814863,0.48399725274725275,0.7719039623684936,0.1218094746511951,1041729.341913108,-1656.8399760555722,1040072.5019370525,2688,0,343.03061224489795,74,122,38,39.29902600935902,0.5392219387755102,44.74999999999999,8162.423834774598,110.30302479425131,8
4208,32.2237026876729,2,1,195,0.01020408163265306,0.00510204081632653,0.9948979591836735,196,6650,4900,1750,0.7368421052631579,84,49,35,218.50045086782274,0.48345761381475666,0.7817834387919596,0.12404799849451456,1048258.8600726889,-40.99328958544629,1048217.8667831034,2689,0,343.8265306122449,75,121,42,39.35540927816587,0.5345450680272108,44.928728070175445,8219.34083083325,109.59121107777665,7
4209,32.29442028196972,5,4,196,0.025,0.02,0.98,200,6100,4000,2100,0.6557377049180327,82,40,42,218.486146145983,0.4838227596314908,0.7854243078029488,0.12579916613498535,1054973.8244855436,-0.5669606529154407,1054973.2575248908,2690,0,337.29,67,133,45,38.808731871029615,0.5378645833333333,44.39338235294118,8254.667537146865,123.20399309174425,0
4210,31.970124551614045,0,4,192,0.0,0.02040816326530612,0.9795918367346939,196,5900,3900,2000,0.6610169491525424,79,39,40,218.16207989779315,0.48326029129600556,0.7819199501737351,0.12609421010538266,1045561.5490903106,520.3764421403021,1046081.9255324509,2691,1,344.83673469387753,70,126,45,38.669305491815834,0.5396471088435374,44.24882629107982,8176.396877695683,116.8056696813669,0
4211,32.394852773250676,2,3,191,0.010309278350515464,0.015463917525773196,0.9845360824742269,194,5300,3600,1700,0.6792452830188679,70,36,34,217.37808867742626,0.4830582411908196,0.777665414287922,0.12630744336271524,1061102.7615958282,2032.0980412082804,1063134.8596370365,2692,0,347.7371134020619,72,122,40,38.48585791009275,0.5416666666666667,44.0496575342466,8291.473661441227,115.15935640890592,0
4212,32.1055519908208,2,4,189,0.010362694300518135,0.02072538860103627,0.9792746113989638,193,6550,4400,2150,0.6717557251908397,87,44,43,223.30525764874326,0.4829098751439263,0.7881012187750713,0.13074694401590922,1053982.010047635,1921.9448621655033,1055903.9549098006,2693,0,349.7046632124352,78,115,45,38.04128286934595,0.5430699481865284,43.76318565400844,8226.624364947527,105.46954314035291,8
4213,31.66964479381008,1,1,189,0.005263157894736842,0.005263157894736842,0.9947368421052631,190,5400,3700,1700,0.6851851851851852,71,37,34,234.6835663564717,0.4819885361552028,0.7913728979278731,0.1381933726476853,1041395.5031192042,5479.682131921416,1046875.1852511256,2694,0,354.9,67,123,36,37.532417916094225,0.5469298245614035,43.55085784313726,8121.653239785155,121.21870507142023,8
4214,31.9944974541974,1,4,186,0.005263157894736842,0.021052631578947368,0.9789473684210527,190,5300,3200,2100,0.6037735849056604,74,32,42,218.75473332058385,0.4820117423187598,0.7768086163433272,0.12522577495823467,1043380.0931645057,2348.8668064417025,1045728.9599709474,2695,0,355.7105263157895,69,121,40,39.02638581361923,0.5391447368421053,44.613095238095255,8170.975674240156,118.41993730782835,8
4215,31.708719048918265,2,2,186,0.010638297872340425,0.010638297872340425,0.9893617021276596,188,6200,4500,1700,0.7258064516129032,79,45,34,209.54715847084378,0.4814582385178443,0.7636172916845037,0.1202031755942723,1034695.9982418796,-436.4787374518055,1034259.5195044278,2696,0,360.1010638297872,76,112,40,39.18142784014686,0.5405031028368794,44.53463203463206,8100.479579542443,106.58525762555847,8
4216,32.111821837286556,1,3,184,0.0053475935828877,0.016042780748663103,0.983957219251337,187,6300,4300,2000,0.6825396825396826,83,43,40,214.14937325993967,0.48113847200659343,0.7705176144691204,0.12435163702456055,1051633.901549079,1341.3481831284616,1052975.2497322075,2697,0,362.2513368983957,73,114,39,38.5931168985938,0.5409982174688057,44.07376126126129,8218.257781865308,112.5788737241823,8
4217,31.992160238869733,0,3,181,0.0,0.016304347826086956,0.9836956521739131,184,7250,5700,1550,0.7862068965517242,88,57,31,226.65849480151246,0.4805228874633722,0.7771739130434787,0.13032863451086962,1044682.2695285233,3307.2221514325815,1047989.4916799559,2698,2,368.58152173913044,65,119,41,38.6520606884058,0.5404211956521738,44.44444444444444,8175.7742832667045,125.78114281948775,8
4218,31.79075768768608,4,2,183,0.021621621621621623,0.010810810810810811,0.9891891891891892,185,6600,4900,1700,0.7424242424242424,83,49,34,203.20753322781735,0.4808215824520172,0.7558774932137364,0.11349884172968369,1029098.2246295991,-1775.8976647784398,1027322.3269648207,2699,0,362.2,74,111,41,40.385052765647764,0.5331081081081082,45.555555555555564,8088.98167831126,109.31056322042244,8
4219,32.11432463155423,3,2,184,0.016129032258064516,0.010752688172043012,0.989247311827957,186,6100,4900,1200,0.8032786885245902,73,49,24,212.3872956934179,0.4809624140269302,0.7715499538197359,0.11763494489025646,1036917.3955653937,745.616300319647,1037663.0118657134,2700,0,361.1290322580645,87,99,39,40.48351034097262,0.5310259856630825,45.88068181818185,8160.8702792402155,93.80310665793351,7
4220,32.047909618965875,3,2,185,0.016042780748663103,0.0106951871657754,0.9893048128342246,187,5250,3000,2250,0.5714285714285714,75,30,45,215.59052861156368,0.4807898721560961,0.77275438365771,0.12128920662606452,1039696.603363103,2179.7480629397696,1041876.3514260427,2701,0,360.0267379679144,72,115,40,39.78523612122571,0.5358177361853833,45.276826484018265,8163.345242696349,113.37979503744928,8
4221,31.63007006802861,2,5,182,0.0106951871657754,0.026737967914438502,0.9732620320855615,187,5100,3500,1600,0.6862745098039216,67,35,32,207.54105682662404,0.4808629463515612,0.7642143110452582,0.11411011897001673,1018984.2332614417,-203.78706785093345,1018780.4461935908,2702,0,360.8663101604278,74,113,40,40.89858284088422,0.5265151515151515,46.16666666666664,8028.766118934536,108.4968394450613,8
4222,31.599570387475445,5,4,183,0.026737967914438502,0.0213903743315508,0.9786096256684492,187,6750,4900,1850,0.725925925925926,86,49,37,207.13110327668983,0.48103305349510284,0.7651983950652417,0.11579434446337594,1023188.5002467432,-1763.1674167741244,1021425.3328299691,2703,0,359.1764705882353,69,118,43,40.249778278073435,0.5316399286987522,45.52083333333333,8041.432339229418,116.54249766999156,0
4223,31.456190886131136,2,0,185,0.010810810810810811,0.0,1.0,185,6100,4000,2100,0.6557377049180327,82,40,42,253.55841900771395,0.4809721406188798,0.8027248923800647,0.1391144839420701,1012717.3204895143,8256.600537009945,1020973.9210265242,2704,0,363.68108108108106,64,121,35,39.81595511767922,0.5220720720720721,46.25,7982.0084373557775,124.71888183368402,8
4224,31.16573724974755,1,3,183,0.005376344086021506,0.016129032258064516,0.9838709677419355,186,5700,4300,1400,0.7543859649122807,71,43,28,253.45828595651832,0.4810544415383125,0.8037198229720874,0.13995522353851086,1005349.1324600094,8062.813580237345,1013411.9460402468,2705,0,362.7204301075269,68,118,36,39.5615403665181,0.5239695340501792,45.999396135265705,7916.11608132553,116.41347178419898,0
4225,31.688062739436223,3,2,184,0.016129032258064516,0.010752688172043012,0.989247311827957,186,5750,4500,1250,0.782608695652174,70,45,25,246.09312028921593,0.48115433982369465,0.7981584808757385,0.13710150412690136,1024977.9056070448,7498.002203668742,1032475.9078107135,2706,0,362.80645161290323,63,123,38,39.395024103581406,0.5272737455197133,45.65429687500001,8059.722598131034,127.93210473223863,0
4226,31.65116482799496,4,7,181,0.02127659574468085,0.03723404255319149,0.9627659574468085,188,6400,4500,1900,0.703125,83,45,38,237.35259837187496,0.48118801437402814,0.7940036940488455,0.13383468207856905,1027525.9641826082,4777.191498661838,1032303.1556812701,2707,0,359.70212765957444,67,121,34,39.141968257785265,0.530751329787234,45.189950980392176,8065.034861349124,120.37365464700186,0
4227,31.911864125783186,5,1,185,0.026881720430107527,0.005376344086021506,0.9946236559139785,186,6700,4600,2100,0.6865671641791045,88,46,42,251.7067473110638,0.48139833381768865,0.807240854188541,0.14017618256615016,1032098.758294683,8057.244270828793,1040156.0025655117,2708,0,363.0376344086022,56,130,38,39.26717324135947,0.523521505376344,45.66885964912283,8116.18079383273,144.93179988987018,8
4228,31.98305389937882,2,3,184,0.0106951871657754,0.016042780748663103,0.983957219251337,187,6100,4700,1400,0.7704918032786885,75,47,28,246.57448784819593,0.4814295708508232,0.8041113256223182,0.13870922842646582,1037567.1278994133,7667.516633984516,1045234.6445333979,2709,0,361.58288770053474,63,124,38,38.99920127795525,0.526626559714795,45.27994791666668,8146.725155033861,129.31309769895017,0
4229,31.624947908535084,1,0,185,0.005405405405405406,0.0,1.0,185,5900,4500,1400,0.7627118644067796,73,45,28,235.49571226194107,0.4812732569526048,0.7855641084465346,0.13157817949489145,1023837.6314744273,5321.874452930039,1029159.5059273574,2710,0,365.1621621621622,67,118,34,39.54990919671705,0.5257319819819819,45.542279411764724,8047.212158527556,120.10764415712771,8
4230,31.534483721143687,4,6,183,0.021164021164021163,0.031746031746031744,0.9682539682539683,189,6000,4200,1800,0.7,78,42,36,233.15519074941315,0.4817593999774851,0.787293646052607,0.13141474387694138,1023613.2471539526,3932.148378761044,1027545.3955327136,2711,0,358.41269841269843,72,117,29,39.264812948028656,0.5283840388007055,45.20547945205478,8034.813660455757,111.59463417299662,0
4231,31.335580233687836,1,0,184,0.005434782608695652,0.0,1.0,184,6450,4900,1550,0.7596899224806202,80,49,31,238.45125798390234,0.48113417676407694,0.7895189904338453,0.13488762815198527,1018266.3417116813,5311.37802876331,1023577.7197404447,2712,0,368.2717391304348,71,113,33,38.98763076253712,0.5309103260869565,45.066550925925924,7988.487547711414,112.51390912269596,0
4232,31.266771027945282,1,1,184,0.005405405405405406,0.005405405405405406,0.9945945945945946,185,6000,4400,1600,0.7333333333333333,76,44,32,241.30678798252347,0.48122674304739527,0.7974765100671142,0.13476278639203876,1012100.0313177288,5845.321534858434,1017945.3528525872,2713,0,367.2756756756757,60,125,41,39.42030201342281,0.5248873873873874,45.56010928961748,7955.51380321694,132.59189672028234,8
4233,31.616324328221506,2,3,183,0.010752688172043012,0.016129032258064516,0.9838709677419355,186,5450,3700,1750,0.6788990825688074,72,37,35,251.17702820009842,0.4815121573186089,0.8003434609212525,0.13946441533797815,1021610.665198275,8671.026172405507,1030281.6913706805,2714,0,366.2741935483871,63,123,34,39.39919595791452,0.5254256272401434,45.78450520833332,8037.3595325926135,127.57713543797799,8
4234,31.768573308898453,5,3,185,0.026595744680851064,0.015957446808510637,0.9840425531914894,188,5550,3800,1750,0.6846846846846847,73,38,35,237.7521793118714,0.4820940948913415,0.7890128565976542,0.13321290448881176,1029364.6022798492,5796.735499706116,1035161.3377795554,2715,0,363.1329787234043,72,116,41,39.38142283258595,0.5293661347517731,45.43378995433788,8087.205305804017,112.32229591394469,0
4235,31.47363581056994,6,7,184,0.031413612565445025,0.03664921465968586,0.9633507853403142,191,5800,4000,1800,0.6896551724137931,76,40,36,230.48154708668267,0.4828763663084413,0.7890989236565125,0.13079085903777224,1023720.121249472,3189.7194658685185,1026909.8407153406,2716,0,357.74869109947645,80,111,35,39.06746331871123,0.5331042757417104,44.94598765432096,8027.477096592441,100.3434637074055,0
4236,31.481893424886916,3,1,186,0.016042780748663103,0.0053475935828877,0.9946524064171123,187,5850,4200,1650,0.717948717948718,75,42,33,233.9351815714942,0.48203572729189426,0.7904103934668605,0.13380273655396244,1026405.476678817,4772.470310567249,1031177.9469893842,2717,0,365.90909090909093,63,124,37,38.67153472709114,0.5349264705882353,44.645182291666686,8039.0531566252175,127.60401835913044,0
4237,31.93245058896998,1,4,183,0.0053475935828877,0.0213903743315508,0.9786096256684492,187,5550,3800,1750,0.6846846846846847,73,38,35,231.20964346571566,0.48207645717133385,0.7880993752885297,0.13305646646353275,1042990.099381879,5279.87380327132,1048269.9731851503,2718,0,366.7486631016043,65,122,38,38.50345807089044,0.5372660427807487,44.4128787878788,8161.523119283173,125.56189414281805,0
4238,31.580712639317937,1,0,184,0.005434782608695652,0.0,1.0,184,6400,4500,1900,0.703125,83,45,38,235.46421345299865,0.48175350934505423,0.7871816065872315,0.13281490599632523,1025343.4966219797,5086.339990248472,1030429.8366122282,2719,0,372.7771739130435,72,112,33,39.17676951506328,0.5302875905797102,45.17694063926941,8047.4938115431005,111.77074738254306,8
4239,31.433380553899955,1,1,184,0.005405405405405406,0.005405405405405406,0.9945945945945946,185,6500,4500,2000,0.6923076923076923,85,45,40,223.9862974696402,0.4818718174696435,0.7771600732540394,0.12389606751546207,1014522.0231753227,1947.8063344896836,1016469.8295098124,2720,0,371.7567567567568,73,112,39,40.24109138087054,0.5255067567567567,45.93186936936936,7986.220236730558,109.4002772154871,8
4240,31.174932635645973,2,0,186,0.010752688172043012,0.0,1.0,186,5300,3600,1700,0.6792452830188679,70,36,34,212.45778775825747,0.48184636249152374,0.7657026655241113,0.11521897025081627,1000057.6924446323,-5.991006517096139,1000051.7014381152,2721,0,370.63440860215053,73,113,37,41.32465451446776,0.5216173835125448,46.70608108108108,7896.42085931607,108.17014875775439,7
4241,31.260585008548517,6,3,189,0.03125,0.015625,0.984375,192,6250,4500,1750,0.72,80,45,35,202.9552044835355,0.482706492691972,0.7640880455343861,0.1115123584545398,1006868.7792876079,-3780.148202319016,1003088.6310852888,2722,0,360.0208333333333,80,112,37,41.042278915011465,0.5252278645833333,46.19341563786009,7934.1423061820415,99.17677882727551,0
4242,31.458775891195774,3,4,188,0.015625,0.020833333333333332,0.9791666666666666,192,7000,5400,1600,0.7714285714285715,86,54,32,208.6413715580796,0.48264911467422916,0.7672487983891931,0.11449396052566953,1012863.6984907179,-3134.945749101568,1009728.7527416163,2723,0,360.875,78,114,39,40.94764873993245,0.5288628472222222,46.24208860759493,7982.913265111566,102.34504186040469,8
4243,31.39398518213921,5,3,190,0.025906735751295335,0.015544041450777202,0.9844559585492227,193,7100,5200,1900,0.7323943661971831,90,52,38,197.74755690203745,0.48252419761082327,0.7607935373662222,0.10949116619180628,1013558.9900769127,-5614.237187238912,1007944.7528896738,2724,0,351.8341968911917,86,107,46,40.86829932934396,0.5306023316062176,45.89319923371647,7977.425137937496,92.76075741787787,8
4244,31.810436566425786,4,4,190,0.020618556701030927,0.020618556701030927,0.979381443298969,194,6200,4600,1600,0.7419354838709677,78,46,32,232.38075531174883,0.48195041664441,0.7958487564624186,0.13273273650857528,1036696.3585894208,3181.656567589853,1039878.0151570106,2725,0,350.64948453608247,65,129,37,38.76421859545008,0.539465206185567,44.6969696969697,8121.300850670833,124.9430900103205,8
4245,32.12214695132486,1,2,189,0.005235602094240838,0.010471204188481676,0.9895287958115183,191,5500,3400,2100,0.6181818181818182,76,34,42,231.92226425997634,0.4806558280518049,0.7928769421677648,0.13318870294802304,1048538.2499822713,4935.873019816484,1053474.123002088,2726,0,357.0471204188482,65,126,41,38.56598873720845,0.5411212914485166,44.49179292929295,8207.472174794826,126.26880268915117,0
4246,32.34987402321838,3,3,189,0.015625,0.015625,0.984375,192,5850,4400,1450,0.7521367521367521,73,44,29,216.84775180074143,0.48078347694880746,0.7847374201935091,0.1237164060498935,1053910.736253499,1457.6347510471142,1055368.371004546,2727,0,356.0989583333333,61,131,42,39.20603512582547,0.5373263888888888,44.74126344086021,8257.587971014054,135.37029460678778,8
4247,32.32391749173733,4,2,191,0.02072538860103627,0.010362694300518135,0.9896373056994818,193,5800,4300,1500,0.7413793103448276,73,43,30,205.81871310461509,0.4805834412780656,0.7735648563359483,0.1185729250478651,1056114.9980122026,-926.3540437292295,1055188.6439684734,2728,0,355.1088082901554,66,127,44,39.110585695170926,0.539777633851468,44.37189054726367,8262.90191851902,125.19548361392454,0
4248,32.71958646211811,4,2,193,0.020512820512820513,0.010256410256410256,0.9897435897435898,195,6350,5000,1350,0.7874015748031497,77,50,27,211.08247139288144,0.4809939201691779,0.7788409916311374,0.11946249252288872,1063392.525660264,-457.29552458243415,1062935.2301356816,2729,0,351.9641025641026,68,127,45,39.66672588030948,0.5306089743589744,45.04830917874398,8341.91389148933,122.6752042866078,8
4249,32.80499626322822,1,3,191,0.005154639175257732,0.015463917525773196,0.9845360824742269,194,6700,5800,900,0.8656716417910447,76,58,18,212.63800310344547,0.48115084664280755,0.7762296693727349,0.12005868790609936,1065410.913796767,-190.63016112760852,1065220.2836356394,2730,0,354.7061855670103,74,120,39,39.71957311534966,0.5308204467353952,45.13888888888889,8360.717797642203,112.98267294111085,8
4250,32.41132695588202,3,3,191,0.015463917525773196,0.015463917525773196,0.9845360824742269,194,6100,4700,1400,0.7704918032786885,75,47,28,210.16971271288384,0.48127381461104285,0.7746344630365734,0.11984865787247048,1055760.9561064634,-522.2046323249715,1055238.7514741386,2731,0,355.62371134020617,64,130,45,39.39523555388124,0.5335588487972509,44.75961538461539,8272.679558114312,129.26061809553613,0
4251,32.16409027792732,2,1,192,0.010362694300518135,0.0051813471502590676,0.9948186528497409,193,6700,5000,1700,0.746268656716418,84,50,34,200.79602564637898,0.4811591465169833,0.7626530283456561,0.11548797536674209,1050378.074555618,-3117.6514406271253,1047260.4231149908,2732,0,357.7253886010363,69,124,44,39.30287061837664,0.5360535405872193,44.43452380952382,8220.031048111976,119.13088475524603,0
4252,31.693567098408646,2,1,193,0.010309278350515464,0.005154639175257732,0.9948453608247423,194,7100,5300,1800,0.7464788732394366,89,53,36,200.34669652580004,0.48109576144436733,0.7627476529789463,0.11338540068244002,1030043.5408137483,-4626.835864045135,1025416.7049497031,2733,0,356.7113402061856,76,118,42,39.94083625172451,0.5314110824742269,45.048701298701324,8080.316092216097,106.31994858179075,8
4253,31.866475684796328,3,4,192,0.015306122448979591,0.02040816326530612,0.9795918367346939,196,6700,5100,1600,0.7611940298507462,83,51,32,222.69834710743734,0.480991082330368,0.7875324675324669,0.12498376623376627,1033051.3647388245,111.76628088390044,1033163.1310197085,2734,0,353.6275510204082,71,125,41,39.699810606060616,0.5260948129251701,45.37037037037038,8114.148901221313,114.28378734114526,8
4254,32.135212760943304,2,2,192,0.010309278350515464,0.010309278350515464,0.9896907216494846,194,6850,4800,2050,0.7007299270072993,89,48,41,230.42247664951796,0.48080030447091504,0.7913305885430237,0.1276496807262473,1037655.4659851134,2169.828476239669,1039825.2944613531,2735,0,357.0412371134021,78,116,39,40.01723049516591,0.5257731958762887,45.87289029535864,8166.428738682198,104.69780434207946,8
4255,31.80480878891245,5,2,195,0.025380710659898477,0.01015228426395939,0.9898477157360406,197,5800,4100,1700,0.7068965517241379,75,41,34,216.30143926118524,0.480935330985186,0.7789446890680092,0.12113718435059889,1030392.2606394459,-624.9342040204397,1029767.3264354254,2736,0,352.5482233502538,70,127,40,39.94596541786745,0.5292935702199661,45.45187793427229,8095.8543498771905,115.65506214110272,0
4256,31.710071315010776,5,5,195,0.025,0.025,0.975,200,6500,4600,1900,0.7076923076923077,84,46,38,211.10584152761072,0.4813541666666667,0.7723114317879454,0.11793683119303972,1026556.3668918615,-3157.5908583538103,1023398.7760335078,2737,0,345.175,79,121,38,40.17522089175449,0.5297395833333334,45.546874999999964,8068.726740077265,102.13578151996538,8
4257,31.947007013968836,5,6,194,0.025,0.03,0.97,200,6900,4900,2000,0.7101449275362319,89,49,40,207.8967370332489,0.48058678810720273,0.7754799884687482,0.11799713083918628,1039176.2974998085,-3691.7277094998767,1035484.5697903086,2738,0,345.87,84,116,37,39.636084818783125,0.5332812499999999,44.93872549019604,8148.444325756437,97.00528959233854,7
4258,32.37073290240449,4,2,196,0.020202020202020204,0.010101010101010102,0.98989898989899,198,6550,4400,2150,0.6717557251908397,87,44,43,193.4139536303144,0.48081651968073286,0.7588189340553089,0.108692868389382,1049819.7262190504,-5540.043230575863,1044279.6829884745,2739,0,349.12626262626264,76,122,41,40.393383264279876,0.52940867003367,45.319264069264065,8244.202078201657,108.47634313423232,8
4259,32.26921445374992,5,5,196,0.024875621890547265,0.024875621890547265,0.9751243781094527,201,6050,4000,2050,0.6611570247933884,81,40,41,187.47283862052967,0.4810862354892205,0.7536408619892123,0.10618582833156617,1049008.2602202767,-6917.888744024537,1042090.3714762521,2740,0,344.0995024875622,82,119,40,40.23734229134876,0.5328047263681592,45.01757028112448,8228.08270653656,100.34247203093365,0
4260,32.3104750267769,4,3,197,0.02,0.015,0.985,200,5950,4200,1750,0.7058823529411765,77,42,35,203.48040008926685,0.4805229271356784,0.7752027995150446,0.11662524763170692,1054069.5192165624,-3053.502501582527,1051016.01671498,2741,0,346.78,73,127,40,39.36886917226937,0.5343229166666666,44.56644144144145,8253.179614807075,113.05725499735719,8
4261,32.142464934133066,2,4,195,0.010050251256281407,0.020100502512562814,0.9798994974874372,199,6600,5100,1500,0.7727272727272727,81,51,30,201.10614892861858,0.4804208331218382,0.7722135296995896,0.11631428442316966,1051406.1550471913,-4111.151439722422,1047295.0036074689,2742,0,348.5075376884422,76,123,41,39.07966185363448,0.5373743718592965,44.22348484848487,8221.28766923239,108.17483775305776,0
4262,32.08127413405955,3,4,194,0.015151515151515152,0.020202020202020204,0.9797979797979798,198,6250,4800,1450,0.768,77,48,29,199.22134169389983,0.48060661607615923,0.7689886505562193,0.11591863862218996,1051260.5784497452,-3963.2914182669615,1047297.2870314782,2743,0,348.6515151515151,79,119,36,38.897277605411716,0.5398779461279462,43.997395833333364,8212.889723304048,103.960629408912,0
4263,32.0774680307452,2,3,193,0.01020408163265306,0.015306122448979591,0.9846938775510204,196,7600,5800,1800,0.7631578947368421,94,58,36,203.10488400866737,0.4795122536193965,0.7718691412909413,0.11892100479938635,1053064.0165532765,-4023.511012848763,1049040.5055404278,2744,0,352.65816326530614,81,115,40,38.558398608563465,0.5421981292517006,43.762703252032544,8219.443694717558,101.47461351503158,0
4264,32.406928428445354,0,2,191,0.0,0.010362694300518135,0.9896373056994818,193,6150,3900,2250,0.6341463414634146,84,39,45,211.71096855406637,0.47898563435521013,0.7696687707998227,0.12090135116844887,1056070.6309008158,-33.65277409667942,1056036.9781267191,2745,1,356.8031088082902,71,122,38,39.299982998979964,0.5339486183074266,44.70486111111113,8273.331294102278,116.52579287467996,7
4265,31.978446458759734,2,5,188,0.010362694300518135,0.025906735751295335,0.9740932642487047,193,6650,4900,1750,0.7368421052631579,84,49,35,224.66547642251072,0.479357818796776,0.7912803269091384,0.12638787710729835,1037426.2106099776,1364.7707719781683,1038790.9813819558,2746,0,357.4611398963731,61,132,45,39.556194072510635,0.5290911053540588,45.278897849462375,8145.58512703725,133.5341824104467,8
4266,32.226895397534584,3,1,190,0.015706806282722512,0.005235602094240838,0.9947643979057592,191,5500,3900,1600,0.7090909090909091,71,39,32,254.9798115187774,0.4795214475980527,0.8112128747130458,0.14055922273170784,1039044.7092402823,9287.084824333966,1048331.7940646163,2747,0,361.0680628272251,62,129,34,39.58998024916441,0.5205606457242583,46.06481481481482,8183.542650716535,131.9926233986538,8
4267,31.84474655692645,1,3,188,0.005235602094240838,0.015706806282722512,0.9842931937172775,191,5400,3500,1900,0.6481481481481481,73,35,38,218.3912491917451,0.4795524478736107,0.7794747677890086,0.11996006047326642,1025595.6987455157,1196.2251629426355,1026791.9239084583,2748,0,362.0418848167539,72,119,34,40.66166273098693,0.5212150959860384,46.20433789954337,8082.058536836358,112.25081301161609,8
4268,31.59154699308205,2,2,188,0.010526315789473684,0.010526315789473684,0.9894736842105263,190,5050,3300,1750,0.6534653465346535,68,33,35,232.50570314662056,0.4792194606887589,0.7865916164339173,0.12428536352690733,1008852.7008305462,3862.801315594898,1012715.5021461411,2749,0,364.67894736842106,74,116,33,41.40184197992233,0.5112390350877193,47.27777777777779,7983.885959529493,107.89035080445261,8
4269,31.962626606717272,5,1,192,0.025906735751295335,0.0051813471502590676,0.9948186528497409,193,6000,4500,1500,0.75,75,45,30,237.85114828610577,0.4796895239637306,0.7998397642077686,0.1275642357030811,1021766.6288986208,4005.6731927921264,1025772.302091413,2750,0,359.83937823834196,72,121,36,41.13196012039129,0.5123596718480139,47.14611872146119,8081.874193365164,112.24825268562728,8
4270,32.179307524433895,4,3,193,0.02040816326530612,0.015306122448979591,0.9846938775510204,196,5900,4400,1500,0.7457627118644068,74,44,30,234.96551921379043,0.48039311878597596,0.8005483612103292,0.12751057674488975,1032492.0793794723,3420.0075031048486,1035912.0868825772,2751,0,355.2908163265306,63,133,40,40.72753362460383,0.5154124149659864,46.67968750000001,8151.672238123205,129.39162282735245,0
4271,32.20070355340941,4,1,196,0.02030456852791878,0.005076142131979695,0.9949238578680203,197,6350,4100,2250,0.6456692913385826,86,41,45,195.5916732184594,0.4810173434856176,0.7640376213396904,0.10711608884286801,1036104.8476508064,-5219.303843644273,1030885.5438071622,2752,0,353.4213197969543,78,119,44,41.359456485957324,0.5217851099830795,46.32120253164558,8168.635755063898,104.72609942389613,8
4272,32.40448953006182,4,7,193,0.02,0.035,0.965,200,6550,5100,1450,0.7786259541984732,80,51,29,194.42115517145479,0.48128245393634844,0.7580867418242783,0.10761847645462769,1046091.3919053425,-5873.540634169482,1040217.851271173,2753,0,349.015,87,113,40,40.964199198732864,0.5255208333333333,45.90435606060607,8233.839633668436,94.64183486975215,8
4273,32.27201553357774,7,3,197,0.035,0.015,0.985,200,6400,4500,1900,0.703125,83,45,38,187.49116194711902,0.4809710008375209,0.7559421595936442,0.10430798189273136,1043422.8682474756,-7273.486806017252,1036149.3814414584,2754,0,348.035,74,126,44,40.94058932765311,0.52796875,45.70833333333332,8206.504616726008,110.89871103683795,8
4274,32.01532855346636,4,2,199,0.01990049751243781,0.009950248756218905,0.9900497512437811,201,6850,5000,1850,0.7299270072992701,87,50,37,206.16077601674016,0.4808032752902156,0.7682463367291772,0.11316722425983282,1030879.6901815421,-4544.608618455361,1026335.0815630867,2755,0,345.7512437810945,83,118,34,40.9984199895752,0.5217143449419569,46.23015873015873,8124.524845214968,97.88584150861408,8
4275,31.68749735181654,2,1,200,0.009950248756218905,0.004975124378109453,0.9950248756218906,201,6550,4600,1950,0.7022900763358778,85,46,39,191.0807776182296,0.48101264510779435,0.7585491207074462,0.1050109274911795,1020687.674114526,-7743.241104970996,1012944.433009555,2756,0,345.25373134328356,79,122,35,41.33497708579146,0.5194859038142621,46.18489583333332,8042.765441132262,101.80715748268686,8
4276,31.41115948662671,0,2,198,0.0,0.01,0.99,200,6150,4600,1550,0.7479674796747967,77,46,31,192.90615243861436,0.4808977177554439,0.7595305378304484,0.106340728253849,1012744.1279428658,-7077.085374748569,1005667.0425681173,2757,1,347.765,80,120,37,41.16624886052874,0.5209895833333333,46.06481481481481,7976.398601117922,99.70498251397403,0
4277,31.61607023510522,5,5,198,0.024630541871921183,0.024630541871921183,0.9753694581280788,203,5750,3400,2350,0.591304347826087,81,34,47,199.22061527707993,0.4811795834755889,0.7721514626796178,0.10742698285370711,1012408.4881619818,-6011.4716153264135,1006397.0165466554,2758,0,343.55172413793105,92,111,40,41.88934746687912,0.5167795566502463,46.93100358422938,8001.047165008563,86.96790396748438,8
4278,31.71641066864921,3,3,198,0.014925373134328358,0.014925373134328358,0.9850746268656716,201,6600,4600,2000,0.696969696969697,86,46,40,195.9462182866759,0.4812137230514096,0.7641481138277337,0.10640596062528312,1017849.0006939361,-6911.26750542978,1010937.7331885063,2759,0,347.4925373134328,79,122,41,41.689419831765775,0.5189676616915423,46.65364583333337,8035.237010155143,101.7118608880398,0
4279,31.380929545581868,5,4,199,0.024630541871921183,0.019704433497536946,0.9802955665024631,203,6200,4700,1500,0.7580645161290323,77,47,30,191.52307238347103,0.48217232437529467,0.7654893592331005,0.10528999141901714,1010919.209003147,-8077.129432049894,1002842.079571097,2760,0,344.18226600985224,76,127,38,41.310136083426634,0.5194478653530378,46.171536796536785,7965.373120451166,104.80754105856798,7
4280,31.874232322228988,0,2,197,0.0,0.010050251256281407,0.9899497487437185,199,7100,4900,2200,0.6901408450704225,93,49,44,194.79843190095679,0.48129853814527185,0.7649273342576595,0.10746973540645427,1027926.5409107844,-6852.304344241069,1021074.2365665433,2761,1,351.8241206030151,77,122,43,41.08642924751536,0.520676298157454,46.03365384615383,8094.982319335282,105.12964051084782,0
4281,32.301964888871936,4,0,201,0.01990049751243781,0.0,1.0,201,5950,4200,1750,0.7058823529411765,77,42,35,191.28155041240916,0.4819060945273632,0.7621563380202652,0.10661273049615243,1044976.5822648521,-6173.05183994373,1038803.5304249084,2762,0,348.13432835820896,68,133,45,40.77158387243552,0.5245128524046434,45.637077294685994,8216.422198257915,120.82973820967521,0
4282,31.97423641303756,4,4,201,0.01951219512195122,0.01951219512195122,0.9804878048780488,205,5700,4100,1600,0.7192982456140351,73,41,32,206.40331001332768,0.48267475689462774,0.7818357855339761,0.11362088477244095,1030452.2648717457,-4162.248343948327,1026290.0165277974,2763,0,342.3219512195122,79,126,39,40.87962013197932,0.5201727642276424,46.119791666666664,8117.625801841222,102.75475698533192,8
4283,31.696548428848214,2,3,200,0.009852216748768473,0.014778325123152709,0.9852216748768473,203,7150,6000,1150,0.8391608391608392,83,60,23,204.91260482051428,0.48199958542652294,0.7731240370598103,0.11417840515553809,1025304.5099713892,-5730.43642550837,1019574.0735458808,2764,0,344.8768472906404,72,131,39,40.435834502103745,0.5236042692939245,45.647831050228305,8062.085841099013,111.97341445970852,7
4284,31.753395159955474,6,4,202,0.02912621359223301,0.019417475728155338,0.9805825242718447,206,6800,4900,1900,0.7205882352941176,87,49,38,198.0465596579871,0.48228648669981844,0.7695413347429305,0.11156430395660703,1030546.7055672052,-7180.754079108536,1023365.9514880966,2765,0,340.0873786407767,78,128,47,40.18109753993722,0.5269012944983819,45.22679324894514,8089.91431013527,103.71685012993936,0
4285,31.980109687721047,6,6,202,0.028846153846153848,0.028846153846153848,0.9711538461538461,208,6500,5000,1500,0.7692307692307693,80,50,30,194.6846829959681,0.4823703432738759,0.7695578867089357,0.11078075324460832,1041048.1521068404,-7564.774104708332,1033483.378002132,2766,0,337.6682692307692,83,125,41,39.87372019180919,0.5299979967948718,44.841269841269835,8160.004178255794,98.31330335247944,0
4286,31.97086698250891,2,3,201,0.00980392156862745,0.014705882352941176,0.9852941176470589,204,6950,4700,2250,0.6762589928057554,92,47,45,209.11392651956686,0.48190138124215204,0.783925181654995,0.11663303666727584,1034484.7243672411,-4484.967472610743,1029999.7568946304,2767,0,345.25,69,135,41,40.29047236033928,0.5206290849673203,45.61011904761906,8133.065045624874,117.87050790760686,8
4287,32.040676020808135,2,2,201,0.009852216748768473,0.009852216748768473,0.9901477832512315,203,6350,4400,1950,0.6929133858267716,83,44,39,195.4709361352759,0.48193658651579446,0.7658920653533872,0.10961749159910272,1038453.3620199108,-6352.509838628799,1032100.852181282,2768,0,347.7142857142857,76,127,38,40.42375132837406,0.5261699507389163,45.4004329004329,8157.5422444752185,107.33608216414761,8
4288,31.561786506100567,2,3,200,0.009852216748768473,0.014778325123152709,0.9852216748768473,203,5700,3600,2100,0.631578947368421,78,36,42,188.83354002144924,0.48203311710481395,0.7573091565884518,0.1064184971118346,1024456.1178098855,-7609.6649354658075,1016846.4528744197,2769,0,347.35960591133005,81,122,33,40.39960072127765,0.5286843185550082,45.21087398373982,8041.599999401125,99.2790123382855,0
4289,31.64726631857792,2,3,199,0.009900990099009901,0.01485148514851485,0.9851485148514851,202,6000,4300,1700,0.7166666666666667,77,43,34,192.39333419245145,0.4818348439321544,0.7610763816502806,0.10881365247067305,1028338.4454909351,-6830.907558743559,1021507.5379321915,2770,0,349.980198019802,84,118,38,40.16891404672628,0.5304249174917492,45.07352941176469,8067.725906360956,96.04435602810662,0
4290,31.370101642849953,2,1,200,0.009950248756218905,0.004975124378109453,0.9950248756218906,201,5800,4100,1700,0.7068965517241379,75,41,34,201.4069646815033,0.4817578772802653,0.7708125273837745,0.11479933019657465,1021705.1080835786,-4844.295076259466,1016860.8130073192,2771,0,352.636815920398,70,131,44,39.6366262359163,0.5325456053067994,44.77699530516435,8006.371598870629,114.37673712672327,0
4291,31.479830903343448,2,1,201,0.009900990099009901,0.0049504950495049506,0.995049504950495,202,6000,4500,1500,0.75,75,45,30,222.62853738852652,0.48156494753953005,0.7968573027603476,0.12680261073035745,1025055.1217284363,-758.6955013959769,1024296.4262270404,2772,0,351.480198019802,78,124,38,39.12348007302542,0.53125,44.80485232067511,8033.500096298916,102.99359097819124,8
4292,31.278730893697535,2,2,201,0.009852216748768473,0.009852216748768473,0.9901477832512315,203,7300,5200,2100,0.7123287671232876,94,52,42,218.3950286307885,0.4816480108601993,0.795038951286394,0.125663138805094,1021592.8564043175,-3277.8397753139534,1018315.0166290036,2773,0,350.5665024630542,66,137,39,38.836760143561015,0.5342261904761905,44.41853233830846,7994.263948406315,121.12521133948962,0
4293,31.065011080543982,2,2,201,0.009852216748768473,0.009852216748768473,0.9901477832512315,203,5900,4000,1900,0.6779661016949152,78,40,38,214.08600685649142,0.4815362385992294,0.7906098897134517,0.12399878346686352,1016590.2780649074,-2972.449351990727,1013617.8287129167,2774,0,351.41379310344826,71,132,38,38.69258845595582,0.5363300492610837,44.16956018518519,7947.375447587672,111.93486545898129,0
4294,30.792752444393155,2,2,201,0.009852216748768473,0.009852216748768473,0.9901477832512315,203,6900,4600,2300,0.6666666666666666,92,46,46,243.14909109837237,0.48136349965045766,0.807235068361182,0.14023925384759953,1006427.4225220855,1442.3826085447035,1007869.8051306301,2775,0,352.14778325123154,71,132,35,38.112079372264986,0.5347906403940887,44.32870370370372,7872.822933988972,110.88483005618271,8
4295,30.403541110308087,2,1,202,0.009852216748768473,0.0049261083743842365,0.9950738916256158,203,6650,4900,1750,0.7368421052631579,84,49,35,242.9191833153923,0.48164293030288247,0.8080314219120672,0.14143942593922854,996479.4497913516,1162.7948267776974,997642.2446181292,2776,0,352.53694581280786,74,129,34,37.75281635383891,0.5373050082101807,43.97222222222225,7784.151067047555,105.19123063577777,0
4296,30.50059976314335,5,4,203,0.024154589371980676,0.01932367149758454,0.9806763285024155,207,7700,5800,1900,0.7532467532467533,96,58,38,218.05343374238146,0.4825983381017151,0.797622496956456,0.12563269370351487,996568.5005498073,-5638.96329912396,990929.5372506834,2777,0,346.68599033816423,63,144,42,38.79435672142283,0.5306964573268922,44.3684895833333,7796.914386066492,123.76054581057923,8
4297,30.2389381336587,2,4,201,0.00975609756097561,0.01951219512195122,0.9804878048780488,205,6500,4400,2100,0.676923076923077,86,44,42,214.42535352828384,0.4822702454965726,0.7912646517379172,0.12451874804994822,990314.6290193124,-5030.287113660899,985284.3419056515,2778,0,349.2878048780488,67,138,41,38.58393936673247,0.5339939024390243,44.07169117647056,7739.000297166542,115.50746712188868,0
4298,29.830434038396536,3,1,203,0.014705882352941176,0.004901960784313725,0.9950980392156863,204,5900,4300,1600,0.7288135593220338,75,43,32,218.2747067245988,0.4823994252873563,0.7931878178557783,0.1251196539921858,973197.4683442749,-4215.121602406311,968982.3467418686,2779,0,351.12254901960785,67,137,41,38.98631934032986,0.5323733660130718,44.56188725490196,7619.829773135144,113.72880258410663,8
4299,30.028377350353686,0,3,200,0.0,0.014778325123152709,0.9852216748768473,203,6500,4200,2300,0.6461538461538462,88,42,46,243.31148641549817,0.48228511274772795,0.8125978481233274,0.13849072040895885,977597.8907364166,472.159182346596,978070.0499187631,2780,1,353.8472906403941,80,123,40,38.621673722406996,0.5272475369458128,44.83024691358024,7662.333634075572,95.77917042594466,8
4300,30.08524332727297,4,2,202,0.0196078431372549,0.00980392156862745,0.9901960784313726,204,6600,4800,1800,0.7272727272727273,84,48,36,212.85817321052264,0.48223793827875977,0.7927319035022624,0.1223400173658838,982286.0728525704,-5582.476192492906,976703.5966600776,2781,0,352.95588235294116,62,142,44,39.021621913081,0.5301776960784313,44.46097883597882,7687.953631332703,123.9992521182694,8
4301,30.187832413387028,1,2,201,0.0049261083743842365,0.009852216748768473,0.9901477832512315,203,5700,3800,1900,0.6666666666666666,76,38,38,206.77676347456216,0.48193353818140433,0.7812664232809423,0.11629125177809393,979251.894900468,-5802.692509229739,973449.2023912382,2782,0,355.320197044335,68,135,46,40.02304113323851,0.5215004105090312,45.28985507246377,7689.1471690619965,113.07569366267641,8
4302,30.66543463628915,5,3,203,0.024271844660194174,0.014563106796116505,0.9854368932038835,206,7600,5300,2300,0.6973684210526315,99,53,46,239.1830153184626,0.4818035164574947,0.8112764602896709,0.13263785394932948,990504.1864725011,-1417.6443987891298,989086.542073712,2783,0,350.91747572815535,66,140,35,39.75409836065575,0.5157261326860841,45.83333333333334,7794.131303390173,118.09289853621475,8
4303,30.466608962181308,6,5,204,0.028708133971291867,0.023923444976076555,0.9760765550239234,209,8000,6000,2000,0.75,100,60,40,235.69345286422885,0.4822213148693412,0.809835280302958,0.13327131325564506,989903.0730869918,-3137.265340643121,986765.8077463487,2784,0,345.89473684210526,67,142,32,39.07448721030387,0.5203349282296651,45.0827205882353,7766.465069541353,115.91738909763214,0
4304,30.889364219428714,3,6,201,0.014492753623188406,0.028985507246376812,0.9710144927536232,207,7900,5900,2000,0.7468354430379747,99,59,40,231.13921526272424,0.482412683895377,0.8054536023665471,0.13192094076348512,1006445.418138026,-2774.199169362413,1003671.2189686636,2785,0,348.07246376811594,63,144,34,38.82619229788322,0.5231481481481481,44.72656250000001,7885.2341864830805,125.16244740449334,0
4305,31.047122081333857,3,3,201,0.014705882352941176,0.014705882352941176,0.9852941176470589,204,6800,5300,1500,0.7794117647058824,83,53,30,227.18725840831368,0.4821654955085482,0.800129204512797,0.13093726218043847,1014521.8285936194,-1502.7134332852893,1013019.1151603342,2786,0,351.44117647058823,66,138,37,38.54844513369417,0.5260927287581699,44.3563432835821,7936.99981939325,120.25757302110985,0
4306,30.797943382481883,2,4,199,0.009852216748768473,0.019704433497536946,0.9802955665024631,203,6700,4600,2100,0.6865671641791045,88,46,42,231.0559570575354,0.4821164382448097,0.8055126186383135,0.1342857038773689,1008863.3543648319,-679.2224233916263,1008184.1319414403,2787,0,353.70935960591135,67,136,38,38.126969996209645,0.5283764367816092,44.041053921568626,7883.0091295632565,117.6568526800486,0
4307,30.770246716615745,1,1,199,0.005,0.005,0.995,200,6800,5000,1800,0.7352941176470589,86,50,36,243.75023347356355,0.4818205611390285,0.813001974333663,0.13918770378169118,1002712.7714426755,2082.294429215244,1004795.0658718908,2788,0,358.785,61,139,33,38.48490457387299,0.5271874999999999,44.707661290322584,7855.408246958611,128.77718437637068,8
4308,30.696752477233773,2,1,200,0.009950248756218905,0.004975124378109453,0.9950248756218906,201,6500,4500,2000,0.6923076923076923,85,45,40,203.29307520841823,0.4817868988391376,0.7747428779004044,0.11496041063549375,997405.9963282393,-6146.853555023022,991259.1427732164,2789,0,357.97512437810946,75,126,40,39.89713828700463,0.5302135157545605,45.0794956140351,7825.231624507591,104.33642166010121,8
4309,30.543450993674305,1,3,198,0.004975124378109453,0.014925373134328358,0.9850746268656716,201,6050,4500,1550,0.743801652892562,76,45,31,199.0741651511366,0.4820750414593698,0.7714541489210223,0.11364165784832797,995231.1843288955,-6625.036569469583,988606.1477594259,2790,0,358.93532338308455,71,130,42,39.637350051950506,0.5348776948590381,44.71932870370372,7797.15267337073,109.81905173761591,7
4310,30.655195721162254,1,3,196,0.005025125628140704,0.01507537688442211,0.9849246231155779,199,5800,4200,1600,0.7241379310344828,74,42,32,203.1848198455989,0.4815639646041656,0.7725796539709278,0.11639501575163105,999913.8516971067,-4966.536836360462,994947.3148607463,2791,0,363.0251256281407,70,129,45,39.396648285369636,0.5366938860971524,44.58626760563384,7829.757956421943,111.85368509174205,8
4311,31.086644274207206,2,3,195,0.010101010101010102,0.015151515151515152,0.9848484848484849,198,6000,3800,2200,0.6333333333333333,82,38,44,197.0421870843256,0.48142700268334787,0.761212905348094,0.11429745316703636,1017745.123729972,-5492.254985167734,1012252.8687448043,2792,0,365.5050505050505,85,113,33,39.0713260121809,0.5428240740740741,44.11337209302326,7954.656576270614,93.5841950149484,8
4312,30.686335459143297,2,1,196,0.01015228426395939,0.005076142131979695,0.9949238578680203,197,6800,5000,1800,0.7352941176470589,86,50,36,217.9766254010207,0.4812353240788701,0.7835385153758736,0.12733385673878683,1006714.7791749459,-2311.9419388221113,1004402.8372361237,2793,0,366.98984771573606,83,114,41,38.26571778982701,0.5436230964467005,43.84920634920636,7860.329182094079,94.70276123004915,8
4313,30.762343023494626,1,2,195,0.005076142131979695,0.01015228426395939,0.9898477157360406,197,7350,5800,1550,0.7891156462585034,89,58,31,209.89458983602594,0.4808371318070375,0.7720197357506235,0.12298458345557912,1010101.1740656659,-4347.045675319814,1005754.1283903461,2794,0,367.8527918781726,73,124,37,38.357079099148585,0.5461082910321489,43.735923423423415,7883.283428247723,107.99018394859895,7
4314,31.295616724458675,2,1,196,0.01015228426395939,0.005076142131979695,0.9949238578680203,197,6600,4900,1700,0.7424242424242424,83,49,34,204.2375925131452,0.48022635450119133,0.7648591739617583,0.12059014939426152,1029901.7434143558,-3931.0694799921575,1025970.6739343636,2795,0,368.8071065989848,79,118,38,38.21081603478319,0.5484348561759729,43.45052083333334,8028.874170859517,101.63131861847491,0
4315,30.97430439525589,2,3,195,0.010101010101010102,0.015151515151515152,0.9848484848484849,198,6850,5100,1750,0.7445255474452555,86,51,35,203.74204885245243,0.48007571484728845,0.7697213421074014,0.11775270499231753,1012976.2627059062,-5172.828159479585,1007803.4345464266,2796,0,367.8989898989899,78,120,45,39.04037344469654,0.5445075757575757,44.251054852320685,7921.6456757698425,101.5595599457672,8
4316,31.42436306836388,4,2,197,0.020100502512562814,0.010050251256281407,0.9899497487437185,199,7600,6100,1500,0.8026315789473685,91,61,30,221.7032575972251,0.4803743041808368,0.7865927098004446,0.12369158580231236,1016893.5927863434,-2310.275569904512,1014583.3172164389,2797,0,366.7185929648241,70,129,39,39.95842945021146,0.533396147403685,45.59859154929576,7994.402224258035,114.20574606082907,8
4317,31.370854486644408,1,1,197,0.005050505050505051,0.005050505050505051,0.9949494949494949,198,6400,4900,1500,0.765625,79,49,30,215.73254857679305,0.48053344357278366,0.7781267005680799,0.12092059904496846,1016593.1450292894,-2137.5539914271367,1014455.5910378622,2798,0,369.06060606060606,77,121,40,39.92720409519312,0.5351957070707071,45.41933760683758,7986.412915049382,103.71964824739457,0
4318,31.581333854368673,4,3,198,0.01990049751243781,0.014925373134328358,0.9850746268656716,201,7000,5300,1700,0.7571428571428571,87,53,34,214.4153027117411,0.4805669568822554,0.7791230554434823,0.121355948017731,1026417.4828477594,-3184.076941315074,1023233.4059064443,2799,0,364.46268656716416,85,116,35,39.57942380477294,0.5379871475953566,45.04602713178293,8051.786534648772,94.72690040763261,0
4319,31.433223770673422,3,2,199,0.014925373134328358,0.009950248756218905,0.9900497512437811,201,6250,4300,1950,0.688,82,43,39,190.77812991542078,0.48081467661691546,0.7581009188653618,0.10873988628640005,1023757.7326743513,-7387.882854786994,1016369.8498195643,2800,0,365.2835820895522,72,129,45,39.908308173990825,0.5372616086235489,44.77739726027399,8022.469183251543,111.42318310071587,8
4320,30.96497692618459,0,0,199,0.0,0.0,1.0,199,6900,5200,1700,0.7536231884057971,86,52,34,187.94990330019164,0.48032460281204,0.7520624068523429,0.10748459160988343,1009507.2097811374,-8752.643508157504,1000754.56627298,2801,1,369.9145728643216,73,126,44,39.85161705255423,0.5386306532663316,44.65090090090093,7906.87896172569,108.3134104345985,0
4321,30.689114934430773,7,1,205,0.03398058252427184,0.0048543689320388345,0.9951456310679612,206,6550,4600,1950,0.7022900763358778,85,46,39,203.79275367367507,0.4815943444628621,0.7787398785630368,0.11550400664014612,997835.4305080142,-7079.673980723174,990755.756527291,2802,0,358.31067961165047,87,119,39,39.79603776942235,0.534031148867314,44.992897727272705,7825.942270743817,89.95335943383698,8
4322,31.018695854318054,0,2,203,0.0,0.00975609756097561,0.9902439024390244,205,6350,4400,1950,0.6929133858267716,83,44,39,205.90152395141635,0.4815598597162442,0.7810148302488065,0.11706972361809041,1009509.6766328419,-5778.083827519527,1003731.5928053224,2803,1,358.94146341463414,90,115,39,39.61866624790617,0.5357723577235772,44.871794871794854,7913.744198729816,87.93049109699795,0
4323,30.762140130771254,3,2,204,0.014563106796116505,0.009708737864077669,0.9902912621359223,206,6500,4800,1700,0.7384615384615385,82,48,34,202.8934371962631,0.48183311626805586,0.7800109339229837,0.11629828431797404,1003582.1987321996,-6975.951638047838,996606.2470941518,2804,0,358.02912621359224,72,134,42,39.38071429901496,0.5380764563106797,44.563356164383585,7857.77783220519,109.13580322507208,0
4324,30.659898019496868,3,4,203,0.014492753623188406,0.01932367149758454,0.9806763285024155,207,6600,4600,2000,0.696969696969697,86,46,40,213.2823367053341,0.4817863452308366,0.7857524073725266,0.12060664875163478,996202.0594453301,-5505.539386166974,990696.5200591631,2805,0,357.1690821256039,82,125,37,39.643334810292764,0.5319041867954911,45.08032128514054,7815.811352560447,95.31477259220057,8
4325,30.84919870404757,3,3,203,0.014563106796116505,0.014563106796116505,0.9854368932038835,206,6950,4800,2150,0.6906474820143885,91,48,43,216.2719588564271,0.4821019812139869,0.7842981332616255,0.11964722885121792,995713.9583902671,-5080.998351649574,990632.9600386175,2806,0,359.65533980582524,89,117,36,40.43101615646262,0.5217435275080906,45.92592592592595,7837.98159665808,88.06720895121438,8
4326,31.223750883675535,3,2,204,0.014563106796116505,0.009708737864077669,0.9902912621359223,206,6450,4700,1750,0.7286821705426356,82,47,35,211.72387826628585,0.4822134738337675,0.7787522296887632,0.11817217909019269,1010527.169830585,-4859.453702003277,1005667.7161285818,2807,0,354.9466019417476,78,128,37,40.196186404077054,0.5249797734627832,45.582805907172975,7943.859088878109,101.84434729330908,0
4327,30.99840201656984,5,5,204,0.023923444976076555,0.023923444976076555,0.9760765550239234,209,7650,5600,2050,0.7320261437908496,97,56,41,221.44411745022322,0.48270055054594524,0.7992691218375063,0.12392367839122427,1004036.9838001132,-4982.383247000119,999054.600553113,2808,0,350.66028708133973,67,142,40,39.844831477580506,0.5194377990430622,45.48100490196077,7889.6821309023635,117.75644971496065,8
4328,31.24674330541976,3,3,204,0.014492753623188406,0.014492753623188406,0.9855072463768116,207,5900,3800,2100,0.6440677966101694,80,38,42,215.29844273675104,0.48270386786110725,0.7920202745408471,0.12163522317111825,1014990.2294343825,-3594.8368419520975,1011395.3925924305,2809,0,354.4154589371981,73,134,36,39.6278027834539,0.5218900966183575,45.11542792792792,7964.312796047775,109.10017528832569,0
4329,31.322675245462847,7,5,206,0.03317535545023697,0.023696682464454975,0.976303317535545,211,5850,4300,1550,0.7350427350427351,74,43,31,203.92130815446546,0.48345933950199355,0.7848050468706436,0.11677178066950472,1021568.3860611118,-6386.087669034305,1015182.2983920776,2810,0,348.5118483412322,70,141,43,39.39280790441174,0.5256220379146919,44.60093896713616,7999.78184672856,114.28259781040799,0
4330,31.523975941037634,0,3,203,0.0,0.014563106796116505,0.9854368932038835,206,6550,4100,2450,0.6259541984732825,90,41,49,207.4618615309969,0.4829327492304049,0.7835718931866753,0.11919550129917403,1029150.8029997642,-5048.091722709512,1024102.7112770547,2811,1,356.8398058252427,68,138,40,39.17346094765448,0.527002427184466,44.474637681159436,8055.175374064089,118.45846138329543,0
4331,31.42890008080702,7,4,206,0.03333333333333333,0.01904761904761905,0.9809523809523809,210,7000,5200,1800,0.7428571428571429,88,52,36,259.3172836166349,0.483725886686413,0.8247040434371269,0.14606048102506908,1019975.1672321407,3899.4379446124594,1023874.6051767531,2812,0,350.06190476190477,70,140,36,38.62522794893947,0.5188988095238095,45.2318075117371,8007.084065481452,114.3869152211636,8
4332,31.896676984020985,3,2,207,0.014354066985645933,0.009569377990430622,0.9904306220095693,209,7950,5700,2250,0.7169811320754716,102,57,45,257.01490881179404,0.48407595693779903,0.8225855827026349,0.14617575702815636,1038178.1281918379,3615.4513895250793,1041793.579581363,2813,0,348.4066985645933,75,134,35,38.30272405765959,0.5228767942583732,44.86019736842106,8138.111870306366,108.50815827075154,0
4333,31.871033085651366,4,3,208,0.018957345971563982,0.014218009478672985,0.985781990521327,211,6500,4600,1900,0.7076923076923077,84,46,38,245.28529515641267,0.48412416309335743,0.8171555338243208,0.13993485936478806,1038297.997388529,2235.8461499515597,1040533.8435384806,2814,0,345.61137440758296,63,148,40,38.48175572275712,0.5230055292259084,44.74283854166667,8135.309438188003,129.13189584425402,8
4334,31.806297136327963,3,4,207,0.014218009478672985,0.018957345971563982,0.981042654028436,211,6200,4000,2200,0.6451612903225806,84,40,44,243.8680607060142,0.4846357105243361,0.8185715666053917,0.13704212237411603,1031504.3162196253,1910.191441273018,1033414.5076608983,2815,0,346.0473933649289,64,147,40,39.10969355650642,0.5216232227488151,45.320512820512846,8100.411443758448,126.56892880872574,8
4335,32.16989341808716,3,4,206,0.014285714285714285,0.01904761904761905,0.9809523809523809,210,7350,5600,1750,0.7619047619047619,91,56,35,243.7522741000511,0.48487459178248654,0.8165167718292163,0.1382876605693747,1046289.9115814422,1657.1090631840452,1047947.0206446262,2816,0,346.8,69,141,40,38.73858597351075,0.525248015873016,44.955357142857174,8204.758977568461,118.90955039954291,0
4336,31.829627730060125,2,4,204,0.009615384615384616,0.019230769230769232,0.9807692307692307,208,6100,3900,2200,0.639344262295082,83,39,44,240.73302790503823,0.4847180609748545,0.8124999999999998,0.13716184148077842,1036552.411293876,2206.480110608967,1038758.891404485,2817,0,350.97596153846155,74,134,42,38.64795918367352,0.5272936698717949,44.79166666666669,8123.1862436091515,109.77278707579934,0
4337,32.03223085466717,1,0,205,0.004878048780487805,0.0,1.0,205,6800,4900,1900,0.7205882352941176,87,49,38,232.98159821832311,0.4844263111748765,0.8043501967406159,0.13394522422650612,1045946.3367790589,937.2498386770503,1046883.5866177359,2818,0,352.1951219512195,63,142,40,38.496022015582874,0.5306910569105692,44.44986979166666,8185.840765773566,129.93398040910424,0
4338,32.2427068058693,4,3,206,0.019138755980861243,0.014354066985645933,0.9856459330143541,209,6500,4600,1900,0.7076923076923077,84,46,38,227.2254682933871,0.48430023923444976,0.804039350744874,0.13228687664907468,1056723.4163682633,-277.1053718267267,1056446.3109964365,2819,0,346.4354066985646,68,141,37,38.15894215460817,0.5339912280701755,43.97644927536231,8254.892281412083,121.39547472664829,0
4339,32.14552803973816,3,4,205,0.014354066985645933,0.019138755980861243,0.9808612440191388,209,6550,4400,2150,0.6717557251908397,87,44,43,223.7908061077392,0.48425135719543616,0.8016963557411201,0.1289063826564002,1050237.5015627053,-1343.300584140709,1048894.2009785646,2820,0,347.3875598086124,72,137,35,38.65726526738865,0.5346391547049442,44.37785388127855,8217.108865637421,114.12651202274196,8
4340,31.8357934052088,0,2,203,0.0,0.00975609756097561,0.9902439024390244,205,7150,4800,2350,0.6713286713286714,95,48,47,224.39276221311778,0.48358142037302726,0.797668897042952,0.12993053402085614,1041724.2761128357,-1398.9224437158887,1040325.3536691199,2821,1,353.5219512195122,74,131,37,38.44015237888413,0.536941056910569,44.18055555555557,8144.2149823686605,110.05695922119811,0
4341,32.01359036307748,2,3,202,0.00975609756097561,0.014634146341463415,0.9853658536585366,205,5800,3700,2100,0.6379310344827587,79,37,42,222.31255639908983,0.4837806870715766,0.7957451030978968,0.12948916199738547,1049362.8351041118,-142.69310756119648,1049220.1419965506,2822,0,354.23414634146343,79,126,38,38.26620558719827,0.5390752032520325,43.95833333333336,8196.813032546359,103.7571269942577,0
4342,32.07862803325518,1,6,197,0.0049261083743842365,0.029556650246305417,0.9704433497536946,203,6600,4600,2000,0.696969696969697,86,46,40,221.23929721653823,0.48330122421109106,0.7940941060511664,0.12945412403825865,1052900.7311501405,-611.3964403125037,1052289.334709828,2823,0,358.5221674876847,83,120,39,38.11876845264026,0.5410509031198687,43.787202380952394,8218.955032181148,99.02355460459214,0
4343,31.72863330615721,1,5,193,0.005050505050505051,0.025252525252525252,0.9747474747474747,198,6450,4700,1750,0.7286821705426356,82,47,35,202.12293227248392,0.4829577500897298,0.7705364813892812,0.11555232428382829,1034303.6315295632,-4238.703427033195,1030064.9281025301,2824,0,366.40909090909093,72,126,37,39.502300584926026,0.5324074074074074,44.66324200913242,8101.486363875242,112.5206439427117,8
4344,31.948298478835348,5,6,192,0.025252525252525252,0.030303030303030304,0.9696969696969697,198,5850,4200,1650,0.717948717948718,75,42,33,206.97588809660738,0.48319168845818594,0.7737424272150579,0.12001775900209423,1045847.43723355,-2156.9595730049678,1043690.477660545,2825,0,365.0858585858586,82,116,38,38.83054165849189,0.5365109427609427,44.126506024096386,8174.722758364652,99.69174095566649,0
4345,31.967217019112322,4,3,193,0.02040816326530612,0.015306122448979591,0.9846938775510204,196,5600,3900,1700,0.6964285714285714,73,39,34,231.758276954127,0.48315944967730684,0.7981658938572602,0.13522033680428353,1048363.8754795252,3793.401080417194,1052157.2765599424,2826,0,363.8979591836735,71,125,37,37.95922306330737,0.5355548469387755,43.89467592592593,8186.974474426029,115.30949963980322,7
4346,32.00438521472521,1,2,192,0.005154639175257732,0.010309278350515464,0.9896907216494846,194,7550,6000,1550,0.7947019867549668,91,60,31,240.16369533012005,0.4828384568132044,0.8015299463012726,0.13586968273489358,1040030.2383988668,3605.5010617876806,1043635.7394606546,2827,0,368.2783505154639,72,122,37,38.94011903429233,0.5295854810996563,45.062785388127864,8159.108822007454,113.32095586121464,7
4347,31.995177878301043,4,2,194,0.02040816326530612,0.01020408163265306,0.9897959183673469,196,6100,4400,1700,0.7213114754098361,78,44,34,232.7789760951431,0.48288417931275074,0.7967494979919674,0.13324589666135817,1043383.5758751079,3275.5520933394782,1046659.1279684474,2828,0,365.2091836734694,64,132,39,38.67056768741632,0.5329506802721089,44.61538461538463,8171.076196612292,127.67306557206706,0
4348,31.537903376199235,0,1,193,0.0,0.005154639175257732,0.9948453608247423,194,6150,4400,1750,0.7154471544715447,79,44,35,233.05291052323705,0.4825786104730873,0.7943907082773498,0.13389377648584871,1029594.4265425671,3039.9955528497835,1032634.4220954169,2829,1,369.88659793814435,65,129,41,38.520949145563115,0.5344716494845361,44.47601010101011,8058.690903735275,123.97986005746577,0
4349,31.31100616142097,1,3,191,0.005154639175257732,0.015463917525773196,0.9845360824742269,194,5950,4300,1650,0.7226890756302521,76,43,33,230.87093096566497,0.48241168562932896,0.7925186705897744,0.133253719905909,1023583.9997941537,2513.1581908071576,1026097.1579849609,2830,0,370.58247422680415,67,127,43,38.398134835050726,0.5362972508591065,44.301470588235304,8006.178229878068,119.49519746086669,0
4350,31.03893565733522,2,4,189,0.010362694300518135,0.02072538860103627,0.9792746113989638,193,7300,5900,1400,0.8082191780821918,87,59,28,225.01660905903887,0.482577045552677,0.7868592722359966,0.1309719755863986,1017205.0885212739,-122.39205266869794,1017082.6964686052,2831,0,369.3523316062176,70,123,42,38.22397325692457,0.5390220207253886,43.98474178403756,7946.441127061322,113.52058752944745,0
4351,31.207584542945273,1,1,189,0.005263157894736842,0.005263157894736842,0.9947368421052631,190,5850,3800,2050,0.6495726495726496,79,38,41,255.15196376482783,0.4823836210897614,0.8062349809911145,0.142610279219349,1010432.4336745212,7712.7639407456845,1018145.1976152669,2832,0,367.64736842105265,64,126,38,39.03596469131141,0.5275767543859649,45.52884615384616,7941.430047394688,124.084844490542,8
4352,31.028213043276622,3,1,191,0.015625,0.005208333333333333,0.9947916666666666,192,6950,4900,2050,0.7050359712230215,90,49,41,253.17583470067976,0.4827479639325189,0.8071071752951855,0.14294697128484596,1007706.1599599501,5675.369636175641,1013381.5295961258,2833,0,364.4583333333333,68,124,35,38.68642143505903,0.5305989583333333,45.13888888888891,7907.884852001789,116.29242429414396,0
4353,31.246116409349774,4,2,193,0.020512820512820513,0.010256410256410256,0.9897435897435898,195,6050,4500,1550,0.743801652892562,76,45,31,251.41953169345788,0.4828421006256058,0.809416575753209,0.14344347937991653,1017958.5466735427,6136.932217603095,1024095.4788911458,2834,0,359.8205128205128,60,135,37,38.322713183480516,0.5331196581196581,44.74043715846995,7975.870015146195,132.93116691910325,0
4354,31.558390312824137,7,1,199,0.035,0.005,0.995,200,6650,4900,1750,0.7368421052631579,84,49,35,222.12047999337221,0.4832103224455611,0.7857800735918479,0.12776809765818747,1030634.4904367437,-864.9944572930126,1029769.4959794506,2835,0,345.535,71,129,40,38.75324323049345,0.5381770833333333,44.42997685185187,8065.378542766797,113.5968808840394,8
4355,31.8462444956447,2,3,198,0.009950248756218905,0.014925373134328358,0.9850746268656716,201,6150,4600,1550,0.7479674796747967,77,46,31,218.28818352240856,0.4830317164179105,0.7836115627302176,0.12654109858111515,1042418.7939554435,-840.4589995689093,1041578.3349558746,2836,0,344.7860696517413,77,124,33,38.55210562485864,0.5404228855721394,44.13728632478635,8148.266537020055,105.8216433379228,0
4356,31.945747822341417,1,4,195,0.005025125628140704,0.020100502512562814,0.9798994974874372,199,6400,4600,1800,0.71875,82,46,36,231.06999737415177,0.48291541884506706,0.7915602463301337,0.1330686021384134,1043639.205762446,2030.74170701819,1045669.9474694643,2837,0,348.81909547738695,71,128,35,38.48011470832393,0.5376360971524288,44.38657407407408,8165.762044634398,115.0107330230197,8
4357,31.492357556505212,2,7,190,0.01015228426395939,0.03553299492385787,0.9644670050761421,197,6050,4000,2050,0.6611570247933884,81,40,41,225.87509813081917,0.4827676629027245,0.785286784180345,0.13082768700618522,1030576.5373110301,1106.315299289974,1031682.8526103201,2838,0,352.3147208121827,76,121,34,38.39079548058454,0.5397102368866329,44.169372294372316,8056.709601610846,106.0093368633006,0
4358,31.672332827797188,1,2,189,0.005235602094240838,0.010471204188481676,0.9895287958115183,191,6100,3800,2300,0.6229508196721312,84,38,46,230.63934464621153,0.4820841370441811,0.78196614110703,0.13425092921927742,1037976.8091061057,3579.658202039943,1041556.4673081456,2839,0,363.19895287958116,75,116,36,38.0782451772936,0.5415575916230366,43.98300438596494,8108.655494660472,108.11540659547296,0
4359,31.904345328239785,1,3,187,0.005263157894736842,0.015789473684210527,0.9842105263157894,190,6150,4400,1750,0.7154471544715447,79,44,35,254.79138442599555,0.4819038336582196,0.8073905329136848,0.149061798044266,1047129.653968103,9209.922841608986,1056339.576809712,2840,0,363.9526315789474,71,119,37,37.26547941724544,0.5398026315789474,43.79340277777776,8174.103753150972,115.1282218753658,8
4360,31.781747683393956,2,2,187,0.010582010582010581,0.010582010582010581,0.9894179894179894,189,5800,3900,1900,0.6724137931034483,77,39,38,246.0756708623847,0.48115782956208486,0.7996938787316805,0.14506228774042182,1045417.9611894236,7850.385226254585,1053268.3464156783,2841,0,366.5978835978836,64,125,39,37.19801103821723,0.5427138447971782,43.50961538461537,8151.712687062796,127.37051073535619,0
4361,32.00623084965221,0,0,187,0.0,0.0,1.0,187,6750,4900,1850,0.725925925925926,86,49,37,246.88616673872824,0.4805227320644778,0.7979751217215414,0.14633223818654,1054457.1397063883,7916.176242478542,1062373.315948867,2842,1,370.7486631016043,65,122,40,36.97071241187078,0.5450089126559714,43.30808080808079,8215.740822896798,126.39601265995074,0
4362,32.261850467513426,2,2,187,0.010582010582010581,0.010582010582010581,0.9894179894179894,189,6200,4300,1900,0.6935483870967742,81,43,38,233.70513897368764,0.48046948290742614,0.7875739730487736,0.13563906278451146,1056391.2261450014,5376.811663360471,1061768.037808362,2843,0,367.81481481481484,75,114,36,38.111967311159916,0.5442019400352733,44.09265350877194,8256.044546038167,110.08059394717556,8
4363,32.63488907776631,0,2,185,0.0,0.0106951871657754,0.9893048128342246,187,6300,4700,1600,0.746031746031746,79,47,32,269.78676545639547,0.4801166312077128,0.8091918118273513,0.14980662354902516,1054543.2250466156,13200.361143856537,1067743.5861904721,2844,1,372.5187165775401,60,127,36,38.92364143212199,0.526180926916221,45.782103825136616,8296.37284324979,138.27288072082985,8
4364,32.690523837331234,6,2,189,0.031413612565445025,0.010471204188481676,0.9895287958115183,191,6000,4200,1800,0.7,78,42,36,207.47083520259497,0.4806569762101589,0.764770871280134,0.11677931384238138,1060703.737539295,-186.98193404163612,1060516.7556052534,2845,0,365.4450261780105,75,116,45,39.972515154775984,0.5335405759162304,45.25767543859649,8327.660033451735,111.0354671126898,8
4365,32.17630964991256,8,7,190,0.04060913705583756,0.03553299492385787,0.9644670050761421,197,6700,4700,2000,0.7014925373134329,87,47,40,197.0756370620823,0.4815202096066853,0.7593454692449386,0.11265667014146002,1048869.0413857934,-4758.693094839422,1044110.3482909539,2846,0,355.10659898477155,74,123,41,39.63466873368148,0.5373307952622673,44.6666666666667,8215.684397277755,111.02276212537507,0
4366,32.41649689120391,4,2,192,0.020618556701030927,0.010309278350515464,0.9896907216494846,194,5750,4200,1550,0.7304347826086957,73,42,31,196.71097384527982,0.4817473247511707,0.7573974828642467,0.1132436666615711,1058912.294472407,-2890.0662675180697,1056022.228204889,2847,0,360.46907216494844,76,118,46,39.371405384425366,0.5399484536082475,44.399350649350694,8285.677655065138,109.0220744087518,0
4367,32.34463527134353,2,3,191,0.010309278350515464,0.015463917525773196,0.9845360824742269,194,5900,4200,1700,0.711864406779661,76,42,34,229.9681444253118,0.4818335692537792,0.7969257169828534,0.13057564203064959,1052234.28821127,3696.073352127143,1055930.361563397,2848,0,360.9896907216495,70,124,42,39.05776678553625,0.5322701890034365,44.92370892018781,8250.349601343629,117.86213716205184,8
4368,32.81937328797334,4,3,192,0.020512820512820513,0.015384615384615385,0.9846153846153847,195,6750,5000,1750,0.7407407407407407,85,50,35,218.19422745960856,0.4816955238346991,0.7866210634445696,0.12518822905601243,1071001.078088043,987.2505683657596,1071988.3286564087,2849,0,358.1333333333333,62,133,44,38.952845554764515,0.535309829059829,44.527116402116405,8384.459931753912,135.23322470570827,0
4369,33.0812556193228,2,3,191,0.010309278350515464,0.015463917525773196,0.9845360824742269,194,6050,4600,1450,0.7603305785123967,75,46,29,214.28486822874217,0.4813995646600075,0.7797827884008113,0.12403268681288628,1082362.2265475418,1536.769418301612,1083898.9959658433,2850,0,360.5927835051546,67,127,48,38.712709842904786,0.5380691580756014,44.19424019607843,8462.375728968624,126.30411535774066,0
4370,33.470261551117524,2,3,190,0.010362694300518135,0.015544041450777202,0.9844559585492227,193,6500,4400,2100,0.676923076923077,86,44,42,207.2448290092878,0.48152908210995965,0.7708811240774436,0.12085653210507714,1097493.1885706747,389.9576408373432,1097883.1462115122,2851,0,362.6062176165803,69,124,40,38.60643413330234,0.5406951640759932,43.91369047619047,8571.275759422319,124.22138781771476,0
4371,33.646398645202225,4,4,190,0.020618556701030927,0.020618556701030927,0.979381443298969,194,5700,4400,1300,0.7719298245614035,70,44,26,204.30173841328318,0.4814190392251126,0.7692186882070025,0.12018857134172971,1106091.3837625906,695.2785093299685,1106786.6622719206,2852,0,361.680412371134,69,125,42,38.347733252084424,0.5430627147766323,43.586309523809504,8627.39724784935,125.03474272245435,0
4372,33.321464585024856,3,2,191,0.015544041450777202,0.010362694300518135,0.9896373056994818,193,4900,3200,1700,0.6530612244897959,66,32,34,203.52935418395765,0.4811523999712148,0.7677119700581956,0.12048524510118262,1097396.358873322,1170.4744410623848,1098566.8333143843,2853,0,364.46632124352334,70,123,46,38.13037119609749,0.5446891191709844,43.353873239436595,8551.824823735851,122.1689260533693,0
4373,32.76745156245014,0,2,189,0.0,0.010471204188481676,0.9895287958115183,191,6600,4700,1900,0.7121212121212122,85,47,38,205.1701686295374,0.48109098006797096,0.7670294218362737,0.12200923495286109,1080564.9081249598,-460.06311696848525,1080104.8450079914,2854,1,368.8952879581152,71,120,45,37.916701875950636,0.5470658813263525,43.18576388888887,8415.14804231843,118.52321186363984,0
4374,32.75398094386106,2,3,188,0.010471204188481676,0.015706806282722512,0.9842931937172775,191,6600,5000,1600,0.7575757575757576,82,50,32,202.1268721370164,0.481161017727565,0.7639123732692297,0.12080606078886773,1081683.843680537,-1072.5256071416138,1080611.3180733954,2855,0,368.71204188481676,74,117,38,37.80533938607871,0.5494109947643979,42.99999999999999,8417.773102572273,113.753690575301,0
4375,33.01366761273624,1,1,188,0.005291005291005291,0.005291005291005291,0.9947089947089947,189,6150,4600,1550,0.7479674796747967,77,46,31,213.58187377815335,0.4810909884048182,0.7744850828497527,0.12501083022625006,1083685.4718827389,2341.114734175848,1086026.5866169147,2856,0,372.87301587301585,79,110,41,38.30356235389778,0.5451940035273368,43.776041666666686,8458.8925948363,107.07458980805443,8
4376,33.37252454236535,0,1,187,0.0,0.005319148936170213,0.9946808510638298,188,6150,4600,1550,0.7479674796747967,77,46,31,230.60912656511016,0.4808520119846778,0.7900208017726729,0.13313079024402957,1091045.0291048167,6570.9882410132805,1097616.01734583,2857,1,375.3670212765957,68,120,41,38.39665249734323,0.538563829787234,44.293478260869556,8533.572172381988,125.49370841738218,8
4377,33.39454130432896,1,0,188,0.005319148936170213,0.0,1.0,188,5700,3900,1800,0.6842105263157895,75,39,36,204.33115122299643,0.4809989759927182,0.7596178390953687,0.11411787731212505,1080989.6980364658,875.9738919978145,1081865.6719284635,2858,0,376.3351063829787,71,117,44,40.35941557210819,0.5254875886524824,45.558449074074055,8496.958881933304,119.67547721032822,8
4378,32.845830448392256,5,1,192,0.025906735751295335,0.0051813471502590676,0.9948186528497409,193,6650,5000,1650,0.7518796992481203,83,50,33,243.17651987075752,0.48172135866436383,0.8032985548898965,0.13682019579541552,1065609.4375217643,6576.23891159575,1072185.67643336,2859,0,367.559585492228,66,127,42,39.07928466796877,0.5292530224525043,45.27363184079603,8366.699099291978,126.76816817109058,8
4379,32.85020801160797,5,5,192,0.025380710659898477,0.025380710659898477,0.9746192893401016,197,5750,3700,2050,0.6434782608695652,78,37,41,232.60368605708112,0.4827406851065299,0.798577660886149,0.13238326584479523,1069434.258324829,4600.870096415386,1074035.1284212442,2860,0,359.7005076142132,73,124,39,38.89863877089424,0.532307529610829,44.83389639639641,8382.259580889928,114.82547371082093,0
4380,32.429417277978175,1,1,192,0.0051813471502590676,0.0051813471502590676,0.9948186528497409,193,6850,4500,2350,0.656934306569343,92,45,47,238.46071997879147,0.4820620592256764,0.8015226231138741,0.1362457713004071,1056961.8499584927,4958.776746243509,1061920.6267047361,2861,0,367.45595854922277,58,135,37,38.5974921052025,0.5335708117443869,44.68573446327684,8279.692854110923,142.753325070878,0
4381,32.20664912068454,4,1,195,0.02040816326530612,0.00510204081632653,0.9948979591836735,196,6850,5400,1450,0.7883211678832117,83,54,29,244.1007616906744,0.48256148613291466,0.8068662090625243,0.13769468195064005,1045684.9682869745,5000.499449467869,1050685.4677364423,2862,0,362.7704081632653,67,129,33,38.95432571886583,0.5256164965986394,45.17463235294118,8207.071202858275,122.49360004266082,8
4382,32.25852812922684,0,4,191,0.0,0.020512820512820513,0.9794871794871794,195,5850,3300,2550,0.5641025641025641,84,33,51,225.8788824405519,0.4823684906159133,0.7904874067646026,0.1267514438404676,1045717.7567360228,2391.111647955047,1048108.8683839778,2863,1,365.4923076923077,65,130,45,39.6242045290192,0.5242521367521368,45.375631313131336,8213.807359672028,126.36626707187735,8
4383,32.02599753882305,4,3,192,0.020512820512820513,0.015384615384615385,0.9846153846153847,195,7750,6100,1650,0.7870967741935484,94,61,33,222.90696707386968,0.48241364877962817,0.7864486428151845,0.12640373933463947,1041467.1760817599,-319.94209452506675,1041147.2339872348,2864,0,366.18461538461537,68,127,43,39.28809270111885,0.5279380341880342,44.97282608695655,8167.499644072193,120.11028888341461,0
4384,32.449172992588984,5,2,195,0.025380710659898477,0.01015228426395939,0.9898477157360406,197,6950,4900,2050,0.7050359712230215,90,49,41,200.13335071161913,0.4823522048413274,0.7719098092499062,0.11459012032554089,1058273.8866999063,-3990.8202168278826,1054283.0664830785,2865,0,363.4010152284264,66,131,45,39.49379578336476,0.5307212351945855,44.60509950248756,8287.353307668835,125.56595920710356,8
4385,32.752410001935985,1,3,193,0.00510204081632653,0.015306122448979591,0.9846938775510204,196,6000,3900,2100,0.65,81,39,42,201.02157355960236,0.4823232818768533,0.7721268215548198,0.11581824787630976,1070139.6006615781,-2175.770709312986,1067963.8299522651,2866,0,365.8826530612245,68,128,46,39.23022598870055,0.5330038265306123,44.368961352657,8372.532586998515,123.1254792205664,0
4386,32.64891474223593,1,2,192,0.005154639175257732,0.010309278350515464,0.9896907216494846,194,5650,4200,1450,0.7433628318584071,71,42,29,210.4123281965847,0.4819776810355572,0.7730906795707975,0.11988609397247277,1063233.022679424,293.4671434939937,1063526.4898229179,2867,0,368.0154639175258,77,117,40,39.421768707483025,0.5292096219931272,44.79166666666667,8332.275116508139,108.21136514945636,8
4387,32.20857063521774,2,1,193,0.010309278350515464,0.005154639175257732,0.9948453608247423,194,7350,5600,1750,0.7619047619047619,91,56,35,211.3912602586452,0.48181409468867403,0.7753789866794951,0.12131811065672443,1051153.668846543,-1709.060243406273,1049444.6086031366,2868,0,368.9845360824742,71,123,37,39.116090473224254,0.5315721649484536,44.516782407407405,8228.749259943716,115.89787690061571,0
4388,32.23460083463976,2,1,194,0.010256410256410256,0.005128205128205128,0.9948717948717949,195,6050,3700,2350,0.6115702479338843,84,37,47,216.8144415631677,0.48206560049343555,0.7817824002562936,0.12555068825402102,1054794.366739573,688.930317723356,1055483.2970572964,2869,0,368.06666666666666,72,123,46,38.63149356686002,0.5373931623931624,44.17808219178084,8246.31740530001,114.53218618472235,8
4389,31.956371479275926,0,1,193,0.0,0.005154639175257732,0.9948453608247423,194,6250,4400,1850,0.704,81,44,37,207.26801567262197,0.48200105051368336,0.764656352702707,0.11639384586087317,1036153.983710907,-2097.683972991802,1034056.2997379153,2870,1,365.840206185567,74,120,42,40.06908462867013,0.5292096219931272,45.34722222222221,8137.778764896133,109.9699833094072,8
4390,31.697398692959535,2,2,193,0.010256410256410256,0.010256410256410256,0.9897435897435898,195,6100,4400,1700,0.7213114754098361,78,44,34,204.53454813850718,0.4822352189620231,0.7633233794991938,0.11564933157214394,1029884.109556864,-2970.623803351953,1026913.485753512,2871,0,364.94871794871796,81,114,37,39.86992533346623,0.5315705128205128,45.08384146341461,8080.179110411754,99.75529765940436,0
4391,31.79474359771149,0,2,191,0.0,0.010362694300518135,0.9896373056994818,193,6650,4500,2150,0.6766917293233082,88,45,43,210.4561145796224,0.48198897164651694,0.7690188782941683,0.1195564836485575,1034500.066796529,-1706.6270819287347,1032793.4397146002,2872,1,369.3316062176166,82,111,39,39.53598018957655,0.5338946459412781,44.90461847389557,8110.692248582842,98.91088108027856,0
4392,32.25853717669524,1,1,191,0.005208333333333333,0.005208333333333333,0.9947916666666666,192,6850,5000,1850,0.7299270072992701,87,50,37,208.86650302974243,0.4818787721785922,0.7666700784347513,0.11937286542616207,1051486.6201772648,-1325.9333322019875,1050160.6868450628,2873,0,371.15625,70,122,39,39.34139707713231,0.5363498263888888,44.674295774647916,8236.433721919482,117.66333888456403,0
4393,32.531909141931564,5,2,194,0.025510204081632654,0.01020408163265306,0.9897959183673469,196,5700,3900,1800,0.6842105263157895,75,39,36,200.47093208630005,0.4821968210361067,0.7623926993477803,0.11602434613586607,1064354.6606990283,-2225.565819853534,1062129.0948791748,2874,0,364.44897959183675,78,118,46,39.07023195876291,0.539593962585034,44.19831223628693,8321.717264681887,106.68868288053702,0
4394,32.081021416047754,4,5,193,0.020202020202020204,0.025252525252525252,0.9747474747474747,198,6250,4500,1750,0.72,80,45,35,229.48190025037525,0.4824588952127023,0.7974187803267576,0.1344722716539388,1053425.484201398,2498.416377341584,1055923.9005787396,2875,0,361.54545454545456,60,138,45,37.85205792852225,0.5428240740740741,43.73292349726775,8221.309569512076,137.0218261585346,8
4395,32.34453842172853,4,1,196,0.02030456852791878,0.005076142131979695,0.9949238578680203,197,6600,4800,1800,0.7272727272727273,84,48,36,216.96355702068607,0.4823327808280673,0.7843562046402341,0.1284326319881092,1065209.7296705614,222.3383844734135,1065432.0680550348,2876,0,363.2791878172589,65,132,43,37.787177397864035,0.5455266497461929,43.35542929292927,8301.050177962827,127.70846427635118,0
4396,31.857250351527405,0,4,192,0.0,0.02040816326530612,0.9795918367346939,196,5850,3600,2250,0.6153846153846154,81,36,45,218.6801838312448,0.4822224402581545,0.7836341433124991,0.12989075979373876,1050194.3414562102,881.3383296351367,1051075.6797858453,2877,1,366.0459183673469,67,129,44,37.61409736308318,0.5471938775510203,43.22916666666665,8180.012720470277,122.0897420965713,0
4397,31.52619319981218,1,5,188,0.0051813471502590676,0.025906735751295335,0.9740932642487047,193,5950,4400,1550,0.7394957983193278,75,44,31,229.98154088600677,0.481791072970639,0.7842657252624543,0.13447203627796195,1034549.5690338751,3035.460801873188,1037585.0298357484,2878,0,368.5699481865285,80,113,38,37.922502217090894,0.5440954231433506,43.81430041152265,8076.559860255423,100.95699825319278,8
4398,31.917265714448586,0,2,186,0.0,0.010638297872340425,0.9893617021276596,188,5650,3800,1850,0.672566371681416,75,38,37,222.71607021595622,0.4810534948989267,0.7740095247095291,0.1320869259358821,1051711.38233239,3596.605214891937,1055307.987547282,2879,1,378.61170212765956,73,115,38,37.568027910292244,0.5500886524822695,43.285472972972954,8193.62577188057,112.24144892987083,8
4399,32.26514671601795,2,0,188,0.010638297872340425,0.0,1.0,188,6650,4800,1850,0.7218045112781954,85,48,37,204.62643260799774,0.48050178727196874,0.7573450992729884,0.12149816044518477,1063527.35336326,-724.8383400507,1062802.5150232092,2880,0,379.47872340425533,75,113,39,37.98894330859978,0.5528036347517731,43.242872807017505,8284.306379264766,110.45741839019688,8
4400,32.31747591770588,1,1,188,0.005291005291005291,0.005291005291005291,0.9947089947089947,189,6300,4600,1700,0.7301587301587301,80,46,34,206.46853161581575,0.4806207550001876,0.7623821667830948,0.12333573039540913,1067106.692343032,-35.2096309051949,1067071.4827121268,2881,0,378.46560846560845,76,113,34,37.7136414683793,0.5545634920634921,43.019480519480496,8304.961749631177,109.27581249514706,0
4401,31.926501769313482,0,1,187,0.0,0.005319148936170213,0.9946808510638298,188,6850,5400,1450,0.7883211678832117,83,54,29,217.46514650283598,0.48033586016611673,0.7777520814061045,0.12504245923913024,1042538.2367880724,893.1460795850949,1043431.3828676575,2882,1,381.46276595744683,68,120,36,38.88700181159417,0.54083554964539,44.44444444444443,8158.994896602305,119.98521906768096,8
4402,31.57215627113942,3,1,189,0.015789473684210527,0.005263157894736842,0.9947368421052631,190,6650,4400,2250,0.6616541353383458,89,44,45,219.24128690578274,0.48042386057736935,0.7809564869449566,0.12756974320330888,1034583.0039424782,714.6618390399608,1035297.6657815182,2883,0,378.2684210526316,75,115,37,38.384061462683384,0.5443530701754387,43.996710526315795,8082.575861188908,107.76767814918544,0
4403,31.624743628916487,1,3,187,0.005263157894736842,0.015789473684210527,0.9842105263157894,190,6950,5300,1650,0.762589928057554,86,53,33,217.31566250762125,0.48034844054580894,0.780097878256055,0.12759860689131697,1039049.5429634405,210.34796146818735,1039259.8909249087,2884,0,379.0,67,123,37,38.08737699693239,0.546984649122807,43.658088235294116,8106.747240905152,120.9962274761963,0
4404,31.660918272541608,2,1,188,0.010582010582010581,0.005291005291005291,0.9947089947089947,189,7300,5600,1700,0.7671232876712328,90,56,34,221.42827325804336,0.4804249221359151,0.7818390962772428,0.13149770128730107,1043664.1292198236,1119.3491989008671,1044783.4784187245,2885,0,381.16402116402116,72,117,39,37.55082712756104,0.5497685185185186,43.23630136986301,8129.374477684254,112.90797885672575,0
4405,31.732264717968423,2,2,188,0.010526315789473684,0.010526315789473684,0.9894736842105263,190,6600,5000,1600,0.7575757575757576,82,50,32,241.88574417269845,0.48036410470620994,0.8007803803305993,0.14162258607834136,1041720.2478235844,5795.455472915166,1047515.7032964996,2886,0,379.3263157894737,73,117,36,37.56609487447125,0.5453947368421053,43.76407657657658,8130.946152325159,111.38282400445424,8
4406,31.391364192733853,3,2,189,0.015706806282722512,0.010471204188481676,0.9895287958115183,191,5700,3900,1800,0.6842105263157895,75,39,36,233.8630228313218,0.48055708643336087,0.794860194609476,0.13805801370289383,1033000.248813798,4416.112154620084,1037416.3609684181,2887,0,375.6178010471204,63,128,40,37.457439834200365,0.5481566317626527,43.457031249999964,8053.233763116322,127.82910735105273,0
4407,31.293942756176868,1,2,188,0.005263157894736842,0.010526315789473684,0.9894736842105263,190,6900,5100,1800,0.7391304347826086,87,51,36,240.9428191793392,0.4802266081871345,0.7899080738432143,0.13813155827235737,1020983.1052808692,4299.7095441700385,1025282.8148250392,2888,0,375.33684210526314,70,120,38,38.40220741676718,0.5365679824561403,44.556924882629126,7993.820970184831,114.19744243121187,8
4408,31.386699006186507,2,2,188,0.010526315789473684,0.010526315789473684,0.9894736842105263,190,5400,3700,1700,0.6851851851851852,71,37,34,222.15031152632685,0.48047143321266134,0.7701027579967981,0.1276098878109469,1024610.2759147931,2123.4983975098303,1026733.7743123029,2889,0,376.3157894736842,73,117,36,38.80564125165272,0.5386513157894737,44.48198198198202,8019.867122188951,109.86119345464316,8
4409,30.960327841626984,0,1,187,0.0,0.005319148936170213,0.9946808510638298,188,5200,3600,1600,0.6923076923076923,68,36,32,235.46776920389675,0.4801912665453028,0.7780490234605053,0.1329639646784139,1005536.1270880444,4554.269739869395,1010090.3968279138,2890,1,381.27659574468083,78,110,36,39.13323244865228,0.5310837765957447,45.134493670886066,7890.7196314716,101.16307219835385,8
4410,30.838471485319335,1,3,185,0.005319148936170213,0.015957446808510637,0.9840425531914894,188,5450,3700,1750,0.6788990825688074,72,37,35,222.67014794055967,0.4807423815754542,0.7677150430604276,0.12286226974768388,994563.0438227442,1241.9000208448406,995804.943843589,2891,0,379.0904255319149,79,109,39,40.37346193283779,0.524324024822695,46.02864583333334,7832.088363556704,99.14035903236335,8
4411,31.392663173093727,3,0,188,0.015957446808510637,0.0,1.0,188,5750,4000,1750,0.6956521739130435,75,40,35,220.70628595179267,0.48091601243979215,0.7677650675978362,0.12290213514212425,1015282.0151870797,1465.824553118383,1016747.8397401981,2892,0,372.20212765957444,70,118,41,40.058768387655036,0.5281471631205674,45.67194835680751,7984.034860703934,114.05764086719905,0
4412,30.985067399519973,3,0,191,0.015706806282722512,0.0,1.0,191,6050,4800,1250,0.7933884297520661,73,48,25,242.80639254332957,0.4814618352163131,0.7856572710559904,0.13636842125349496,1004699.5415842717,4539.494256402717,1009239.0358406744,2893,0,367.34031413612564,69,122,44,39.159009232747024,0.5268869982547992,45.3422619047619,7890.587178690243,114.356335923047,8
4413,31.450255774809154,2,3,190,0.010362694300518135,0.015544041450777202,0.9844559585492227,193,6450,4400,2050,0.6821705426356589,85,44,41,223.089611447346,0.4816381512665515,0.7729447929547162,0.12113247088541026,1009272.9257120062,-18.33903171640395,1009254.5866802897,2894,0,364.52331606217615,71,122,40,41.00618896693505,0.5178648531951641,46.657986111111114,7967.671135310818,112.22072021564531,8
4414,31.861455992752017,5,2,193,0.02564102564102564,0.010256410256410256,0.9897435897435898,195,6300,4700,1600,0.746031746031746,79,47,32,200.11043930150856,0.482033659353247,0.7540529662722366,0.109755937635437,1025665.5640454734,-4250.722680486053,1021414.8413649873,2895,0,361.3128205128205,84,111,38,41.18469773806648,0.5202991452991452,46.262254901960794,8084.453999141331,96.24349998977775,8
4415,32.15541664621193,4,6,191,0.02030456852791878,0.030456852791878174,0.9695431472081218,197,6650,4300,2350,0.6466165413533834,90,43,47,195.58759116498678,0.4820813477675334,0.7596253383055409,0.10904678027965686,1040334.4945367875,-5354.696441541215,1034979.7980952463,2896,0,357.9593908629442,74,123,46,40.64974064974064,0.5278659052453469,45.62499999999999,8179.534109380147,110.53424472135335,8
4416,32.01947566555,5,1,195,0.025510204081632654,0.00510204081632653,0.9948979591836735,196,6250,4500,1750,0.72,80,45,35,193.1604407417371,0.4812674428745857,0.758322181331551,0.10711624441132624,1034240.1818707517,-5495.142127406533,1028745.0397433451,2897,0,359.9795918367347,71,125,45,40.923838797814255,0.5249787414965986,45.83333333333331,8138.283398327226,114.62370983559472,8
4417,31.591469450788296,2,1,196,0.01015228426395939,0.005076142131979695,0.9949238578680203,197,6500,4800,1700,0.7384615384615385,82,48,34,188.11057551965217,0.4814435926654926,0.7524783831170492,0.1049450072804399,1022287.1984518047,-7439.393350572014,1014847.8051012327,2898,0,359.1015228426396,75,122,47,40.81480209399636,0.5273371404399323,45.60032894736839,8036.859436349729,107.15812581799638,0
4418,31.55660829798946,2,2,196,0.010101010101010102,0.010101010101010102,0.98989898989899,198,6350,4600,1750,0.7244094488188977,81,46,35,203.91278130801203,0.48144943512963817,0.7637896144120226,0.11347402199609156,1020374.7369519807,-4336.509882338464,1016038.2270696423,2899,0,357.85353535353534,76,122,39,40.512510196120125,0.5274621212121212,45.69805194805191,8024.906964090904,105.59088110645926,8
4419,31.298288560039527,4,3,197,0.02,0.015,0.985,200,5750,3300,2450,0.5739130434782609,82,33,49,199.88609284379842,0.4817106365159129,0.7626236453201996,0.11258844852189388,1015743.4246198612,-5143.403104191933,1010600.0215156693,2900,0,354.98,82,118,35,40.13844417077173,0.5304166666666666,45.23092369477907,7973.836066375421,97.24190324848074,0
4420,31.012487167051376,3,5,195,0.015,0.025,0.975,200,6750,4800,1950,0.7111111111111111,87,48,39,209.37282605016034,0.48199382328308205,0.7752132831850316,0.11918397789936153,1009663.8176641855,-4470.76662701157,1005193.051037174,2901,0,346.48,88,112,42,39.48414518545697,0.5336979166666667,44.826779026217196,7913.556240824511,89.92677546391491,0
4421,31.1512633293345,0,1,194,0.0,0.005128205128205128,0.9948717948717949,195,6500,4600,1900,0.7076923076923077,84,46,38,210.4248643615959,0.4813981408053573,0.7715382466094951,0.1203436544503283,1015595.7796843702,-2758.6791627412676,1012837.1005216289,2902,1,351.5487179487179,72,123,42,39.27575207227345,0.5358440170940171,44.64897260273974,7954.507095868194,110.47926522039158,0
4422,31.498991339968597,3,1,196,0.015228426395939087,0.005076142131979695,0.9949238578680203,197,6950,5100,1850,0.7338129496402878,88,51,37,210.0460085550841,0.4815245260540764,0.7753338644317265,0.12139607812677063,1030135.4993933027,-3074.8300163075983,1027060.6693769951,2903,0,348.93401015228426,78,119,44,38.87915034027636,0.5385998307952622,44.251054852320685,8055.833808412877,103.27992062067791,0
4423,31.934303589547312,2,0,198,0.010101010101010102,0.0,1.0,198,6500,4700,1800,0.7230769230769231,83,47,36,210.90521150173097,0.481389615272864,0.7775616771905041,0.12197791570395322,1044587.2372832097,-2038.2215577549741,1042549.0157254547,2904,0,348.12626262626264,78,120,37,38.8302488229027,0.5419823232323233,44.22468354430381,8168.006606408767,104.718033415497,8
4424,31.579053520104598,1,3,196,0.005025125628140704,0.01507537688442211,0.9849246231155779,199,4200,2900,1300,0.6904761904761905,55,29,26,211.14014250432544,0.4813672740808419,0.7804963021588724,0.1227795657770555,1034620.2483206062,-310.0266663452853,1034310.2216542609,2905,0,347.3718592964824,80,119,34,38.61529766390353,0.543603433835846,44.02006172839507,8083.604170752106,101.04505213440133,0
4425,32.08309080175046,1,1,196,0.005076142131979695,0.005076142131979695,0.9949238578680203,197,5650,4000,1650,0.7079646017699115,73,40,33,206.33086687194503,0.4808781380572533,0.7674895563158124,0.11929060580373084,1049345.9428039454,-1747.5083945400347,1047598.4344094053,2906,0,351.66497461928935,78,119,43,38.96070698217939,0.5398159898477157,44.23786919831228,8205.639666159843,105.20050854051081,8
4426,31.923076413413686,1,3,194,0.005076142131979695,0.015228426395939087,0.9847715736040609,197,6350,4200,2150,0.6614173228346457,85,42,43,212.25244761224715,0.4805759867398736,0.7727920595803575,0.1232703967150182,1045503.1456391283,-1367.8796703578464,1044135.2659687705,2907,0,352.5888324873096,81,116,34,38.635353071590494,0.5417195431472082,44.06758130081304,8170.150158804009,100.86605134325937,0
4427,31.759059920025315,1,1,194,0.005128205128205128,0.005128205128205128,0.9948717948717949,195,6750,5000,1750,0.7407407407407407,85,50,35,210.91079388664022,0.48006212001057363,0.7694026812238912,0.12295496681323007,1041285.0229861615,-1826.3498279435198,1039458.673158218,2908,0,356.26153846153846,82,113,35,38.524819479840595,0.5436965811965813,43.92570281124502,8132.678948396134,99.1790115658065,0
4428,31.812619546404044,1,3,192,0.005128205128205128,0.015384615384615385,0.9846153846153847,195,5600,3800,1800,0.6785714285714286,74,38,36,217.3300871502481,0.4799982377301965,0.7822473143574054,0.12467883947040562,1038113.890221388,522.6764467395205,1038636.5666681274,2909,0,357.0923076923077,67,128,41,38.9791454298335,0.5364850427350427,44.53125000000001,8127.130149745422,121.30044999620033,7
4429,32.295841163926156,3,2,193,0.015384615384615385,0.010256410256410256,0.9897435897435898,195,6900,5000,1900,0.7246376811594203,88,50,38,209.5192834404704,0.48026147678209535,0.7748915891486174,0.12132628273645826,1056798.2989327996,-1616.0755332984627,1055182.223399501,2910,0,357.20512820512823,72,123,44,38.81811970102634,0.5396367521367522,44.17808219178082,8261.984023785208,114.74977810812788,0
4430,32.31218795790697,1,4,190,0.005154639175257732,0.020618556701030927,0.979381443298969,194,6150,4400,1750,0.7154471544715447,79,44,35,206.53675636954213,0.4804069182557911,0.7657998372881107,0.1176409520379581,1052168.564592729,-1487.7035030044385,1050680.8610897246,2911,0,359.96907216494844,86,108,37,39.532897000406614,0.5361361683848798,44.80363984674327,8245.95275544569,95.8831715749499,8
4431,32.73262866042447,3,2,191,0.015544041450777202,0.010362694300518135,0.9896373056994818,193,6350,4600,1750,0.7244094488188977,81,46,35,199.55957469645645,0.48044626151410474,0.7569118929506569,0.11439234636971764,1067881.2424729036,-2328.8146851566435,1065552.427787747,2912,0,362.16062176165804,76,117,37,39.464172227518276,0.5388061312607945,44.56168831168832,8361.16740213929,110.01536055446434,0
4432,32.58173553318437,2,1,192,0.010362694300518135,0.0051813471502590676,0.9948186528497409,193,6100,4800,1300,0.7868852459016393,74,48,26,193.86854180936703,0.480365302964882,0.7476162920006255,0.11187459889733246,1065062.9939259586,-3403.5580864908698,1061659.4358394677,2913,0,361.6580310880829,81,112,43,39.35189785373612,0.5410729706390328,44.30894308943091,8330.858394460598,102.85010363531603,0
4433,32.486133925236096,1,4,189,0.0051813471502590676,0.02072538860103627,0.9792746113989638,193,6950,4800,2150,0.6906474820143885,91,48,43,226.29397920564412,0.48032369926597585,0.7843090031899789,0.12746522683256042,1054298.798724586,2166.2940870231278,1056465.0928116092,2914,0,362.5025906735751,75,118,39,39.46497740477724,0.5331390328151986,45.23026315789472,8276.48379114975,110.35311721533002,8
4434,32.83285238939916,7,5,191,0.03571428571428571,0.025510204081632654,0.9744897959183674,196,6800,5100,1700,0.75,85,51,34,219.04343449646504,0.48070163963021106,0.7828238946343617,0.12505511599464153,1069864.9579780216,869.378968584384,1070734.336946606,2915,0,356.5816326530612,67,129,41,39.123224822482236,0.5370960884353742,44.71507352941176,8381.732308047434,125.1004822096632,0
4435,33.01077692714113,1,3,189,0.005208333333333333,0.015625,0.984375,192,5450,3600,1850,0.6605504587155964,73,36,37,205.28565812462486,0.48031593131908085,0.7631574693983099,0.11723582989913398,1075759.0309924262,317.58013215801384,1076076.6111245842,2916,0,364.890625,70,122,44,39.46277033886942,0.5371636284722222,44.7036384976526,8427.53123986481,120.39330342664013,8
4436,32.55436658522236,3,3,189,0.015625,0.015625,0.984375,192,7650,5500,2150,0.7189542483660131,98,55,43,204.15860039730134,0.48019208569662597,0.7682136051099355,0.11672721029285951,1061251.3108698432,-2717.28354060218,1058534.0273292412,2917,0,365.7604166666667,70,122,37,39.446631042672145,0.53759765625,44.65962441314555,8312.444190862849,118.74920272661213,8
4437,32.345014203410365,1,0,190,0.005263157894736842,0.0,1.0,190,7100,4800,2300,0.676056338028169,94,48,46,201.08014271650225,0.47992318759862623,0.7615647775450622,0.11564899263084298,1056280.0069949843,-2620.613088971725,1053659.3939060126,2918,0,364.15263157894736,75,115,39,39.296408523722654,0.5401315789473684,44.435307017543884,8266.243624407816,110.21658165877088,0
4438,32.57290503788709,3,4,189,0.015544041450777202,0.02072538860103627,0.9792746113989638,193,6100,4200,1900,0.6885245901639344,80,42,38,199.0359098025516,0.4804327684225676,0.7646634528689762,0.11268092369347187,1058727.508530063,-2555.0414213460313,1056172.467108717,2919,0,359.47668393782385,80,113,39,39.961309223578475,0.534704231433506,45.03600823045267,8304.917891990084,103.81147364987605,8
4439,32.71854109652364,2,3,188,0.010471204188481676,0.015706806282722512,0.9842931937172775,191,5800,4500,1300,0.7758620689655172,71,45,26,205.31577515534622,0.47995200698080276,0.7707165014224608,0.1170307155458971,1065632.241325326,-241.77806835241427,1065390.4632569735,2920,0,363.9005235602094,65,126,41,39.535730113577806,0.5368128272251309,44.775883838383834,8350.560733457753,128.47016513011928,0
4440,32.49573523090103,3,2,189,0.015706806282722512,0.010471204188481676,0.9895287958115183,191,6650,5300,1350,0.7969924812030075,80,53,27,197.40055367541473,0.4802333057775328,0.7610251194744684,0.11381551923342467,1061983.597375544,-2922.7699767718414,1059060.8273987721,2921,0,363.3089005235602,73,118,41,39.294497669125995,0.5397578534031413,44.34121621621621,8307.820147292,113.80575544235616,0
4441,31.983910955901823,2,2,189,0.010471204188481676,0.010471204188481676,0.9895287958115183,191,5600,3800,1800,0.6785714285714286,74,38,36,191.51986243883653,0.4801368604757968,0.7534322591198124,0.11112901849750387,1047217.3774742214,-3687.414384515554,1043529.9630897058,2922,0,356.85340314136124,79,112,40,39.20059914516866,0.5421029668411868,44.1015625,8184.632838754409,103.60294732600518,0
4442,32.26316404177737,0,0,189,0.0,0.0,1.0,189,6600,4700,1900,0.7121212121212122,85,47,38,217.30750462714084,0.4800027674584412,0.7689754370435944,0.12138598435229242,1044421.3003639494,992.1173123045,1045413.4176762538,2923,1,361.5132275132275,73,116,38,40.02245150106957,0.5303681657848325,45.55180180180179,8209.303958603115,112.45621861100159,8
4443,31.838568163563536,3,1,191,0.015625,0.005208333333333333,0.9947916666666666,192,5800,4200,1600,0.7241379310344828,74,42,32,209.430013185495,0.4807823407504363,0.7626303215058714,0.11767427830781625,1032510.2843895068,-952.2715052294297,1031558.0128842774,2924,0,356.8489583333333,79,113,43,39.99187288034493,0.5326605902777778,45.32552083333332,8108.470764467929,102.6388704363029,0
4444,31.511170153534945,2,4,189,0.010362694300518135,0.02072538860103627,0.9792746113989638,193,6300,4600,1700,0.7301587301587301,80,46,34,203.4422409691049,0.480572197035118,0.7578554159381419,0.11506986729898497,1023935.3790379906,-3237.6583761923903,1020697.7206617981,2925,0,355.73056994818654,81,112,32,39.88480831838416,0.5354598445595855,45.071138211382106,8033.10674086811,99.17415729466802,0
4445,31.594216161526866,0,1,188,0.0,0.005291005291005291,0.9947089947089947,189,5450,3900,1550,0.7155963302752294,70,39,31,229.07770343425827,0.47954191526886564,0.7748062021507902,0.12695290573774237,1020305.00032615,3495.8252554411483,1023800.8255815911,2926,1,364.2433862433862,83,106,42,40.0363114407469,0.5286044973544973,45.85813492063494,8029.4130210111,96.73991591579639,7
4446,31.549674523625885,3,1,190,0.015706806282722512,0.005235602094240838,0.9947643979057592,191,4550,3200,1350,0.7032967032967034,59,32,27,222.33878336342354,0.48039978873886285,0.7771448163661272,0.1201081309557062,1010848.4061780653,2200.160958897277,1013048.5671369627,2927,0,361.39267015706804,69,122,36,41.23183773244763,0.5176156195462478,46.86011904761904,7986.4808529970005,115.7460993187971,8
4447,31.4654547081274,6,2,194,0.030612244897959183,0.01020408163265306,0.9897959183673469,196,5300,3500,1800,0.660377358490566,71,35,36,215.93694813634818,0.4810815672422815,0.7772135027991178,0.11835531461144153,1012703.6998739033,-763.9707365681361,1011939.7291373352,2928,0,352.5051020408163,79,117,40,40.810505944743795,0.5209927721088435,46.2890625,7983.1300128627945,101.05227864383284,0
4448,31.809857774836992,6,3,197,0.03,0.015,0.985,200,6650,5200,1450,0.7819548872180451,81,52,29,240.46849882973382,0.4821482412060301,0.7997303586093614,0.13169886450150237,1023542.9985996727,2575.969672189689,1026118.9682718624,2929,0,345.325,74,126,41,40.21922620677069,0.5196875000000001,46.31944444444446,8069.542392463886,109.04787016843089,8
4449,31.84769021656725,6,5,198,0.029556650246305417,0.024630541871921183,0.9753694581280788,203,6500,4900,1600,0.7538461538461538,81,49,32,212.06951898949362,0.4830624380172008,0.7856647962174792,0.11658542000585619,1025955.6446709014,-3585.215986017218,1022370.4286848841,2930,0,330.20197044334975,76,127,36,40.78860878679673,0.5213464696223317,46.1715367965368,8083.850264251242,106.36645084541108,8
4450,32.01376457494802,3,1,200,0.014925373134328358,0.004975124378109453,0.9950248756218906,201,6600,4500,2100,0.6818181818181818,87,45,42,206.71557281624243,0.4831478026533997,0.7796210584707131,0.11447960042797324,1033631.9617582913,-4066.435388791872,1029565.5263694995,2931,0,333.1044776119403,79,122,42,40.632472501195586,0.5246683250414594,45.88541666666666,8135.16444589432,102.97676513790279,0
4451,32.39901643541598,3,0,203,0.014778325123152709,0.0,1.0,203,5300,3700,1600,0.6981132075471698,69,37,32,202.60871139849007,0.4835318815132745,0.772588224846559,0.11139397565446454,1043744.125812097,-3605.6695278933007,1040138.4562842037,2932,0,330.79802955665025,83,120,38,41.025300454345604,0.5248357963875205,46.16815476190478,8223.90212570106,99.08315814097664,8
4452,31.943535173272437,7,9,201,0.03333333333333333,0.04285714285714286,0.9571428571428572,210,6850,4600,2250,0.6715328467153284,91,46,45,194.26334873010754,0.48435862383230804,0.7703026758297999,0.10845445240532219,1033902.6789485798,-8680.120665284088,1025222.5582832957,2933,0,320.73809523809524,79,131,41,40.63033094506991,0.5286706349206349,45.57291666666664,8127.300485491394,102.8772213353341,0
4453,32.06000768766319,3,2,202,0.014705882352941176,0.00980392156862745,0.9901960784313726,204,7500,5500,2000,0.7333333333333333,95,55,40,196.10775984032503,0.4834337470620432,0.765964971847326,0.1104899817636943,1040548.4045193832,-7488.076676856283,1033060.327842527,2934,0,328.5343137254902,84,120,44,40.2241662658329,0.5319648692810457,45.22058823529409,8168.229899834696,97.24083214088924,0
4454,31.982561164718575,1,2,201,0.0049261083743842365,0.009852216748768473,0.9901477832512315,203,6100,4200,1900,0.6885245901639344,80,42,38,199.67085334341513,0.4831193402591491,0.7713024649258995,0.11322568858458301,1040050.3545855229,-5166.451635957808,1034883.9029495651,2935,0,330.384236453202,85,118,40,39.88121388427136,0.53438013136289,44.973352713178265,8156.405345483805,95.95770994686829,0
4455,31.787536692958472,6,3,204,0.028985507246376812,0.014492753623188406,0.9855072463768116,207,6650,4400,2250,0.6616541353383458,89,44,45,191.25856098906598,0.48343769053984337,0.7677560213803591,0.10975138025762789,1037377.7783361995,-8368.523782676535,1029009.2545535229,2936,0,324.70531400966183,76,131,43,39.63485129291324,0.5380938003220612,44.52110389610392,8121.044784179176,106.85585242341021,0
4456,31.733364079483465,1,6,199,0.004878048780487805,0.02926829268292683,0.9707317073170731,205,5600,3600,2000,0.6428571428571429,76,36,40,193.48495784498456,0.48280627291567035,0.768586050209582,0.11151267427760346,1036944.4517677918,-6473.369292423435,1030471.0824753683,2937,0,328.8243902439024,78,127,45,39.410223677876324,0.5395325203252033,44.3565400843882,8112.426988040987,104.00547420565368,0
4457,31.46884364967341,2,1,200,0.009950248756218905,0.004975124378109453,0.9950248756218906,201,6950,5000,1950,0.7194244604316546,89,50,39,230.36248789885877,0.48247408789386403,0.8039751705866955,0.13017334428154523,1022269.7391988421,-51.47991488755633,1022218.2592839545,2938,0,335.17910447761193,65,136,37,39.23555211558307,0.5282441956882256,45.107323232323225,8021.177792648747,123.40273527151918,7
4458,31.622567325686596,1,4,197,0.004975124378109453,0.01990049751243781,0.9800995024875622,201,6450,4500,1950,0.6976744186046512,84,45,39,235.35460170448778,0.4824761608623549,0.8089725606392533,0.13188213480127217,1024663.3635673802,1581.8475627162925,1026245.2111300966,2939,0,329.27363184079604,61,140,39,39.438687961985224,0.5225953565505804,45.43010752688172,8050.15356382398,131.9697305544915,7
4459,31.798070395574758,5,7,195,0.024752475247524754,0.034653465346534656,0.9653465346534653,202,5900,4100,1800,0.6949152542372882,77,41,36,225.35003267180682,0.4833936751884144,0.8025573598729341,0.12767627493991962,1033781.1367334912,292.52258767805097,1034073.6593211693,2940,0,324.1188118811881,62,140,42,39.26033696450956,0.522483498349835,45.00661375661377,8108.2976461732005,130.77899429311614,6
4460,31.638650162447554,2,5,192,0.01015228426395939,0.025380710659898477,0.9746192893401016,197,6050,4200,1850,0.6942148760330579,79,42,37,240.94998581221734,0.4825928467833834,0.8101277721852167,0.13280266659882664,1020025.6421409843,3705.03280039364,1023730.674941378,2941,0,333.1725888324873,69,128,37,39.953020003125516,0.5181895093062605,46.07142857142857,8033.957237678638,116.4341628649078,8
4461,31.21448494057078,1,1,192,0.0051813471502590676,0.0051813471502590676,0.9948186528497409,193,6450,4700,1750,0.7286821705426356,82,47,35,241.32243129147483,0.48224871365860683,0.8075212031363899,0.1336164198519111,1007759.6718029998,3589.0028313996063,1011348.6746343994,2942,0,338.3316062176166,68,125,38,39.761565272496824,0.5199158031088082,45.89371980676328,7931.796656396234,116.6440684764152,0
4462,31.192773206178668,3,4,191,0.015384615384615385,0.020512820512820513,0.9794871794871794,195,5250,3900,1350,0.7428571428571429,66,39,27,217.74855435858936,0.4826416424354569,0.7829325544424914,0.12164905149864207,1009812.7691974854,-272.9458668806292,1009539.8233306048,2943,0,335.8051282051282,68,127,39,40.00580935429644,0.5248397435897436,45.54649758454107,7937.110392363267,116.72221165240099,8
4463,31.338636867965274,2,1,192,0.010362694300518135,0.0051813471502590676,0.9948186528497409,193,7600,5600,2000,0.7368421052631579,96,56,40,218.66173820345955,0.482520824337939,0.7744534551826736,0.12292516723406025,1016457.0920004343,-1747.9450907902246,1014709.146909644,2944,0,338.580310880829,74,119,43,39.73636256225684,0.5309801381692574,45.30555555555556,7981.776706732606,107.86184738827846,8
4464,31.594790804715636,3,5,190,0.015384615384615385,0.02564102564102564,0.9743589743589743,195,5750,3900,1850,0.6782608695652174,76,39,37,214.15232082958437,0.4822627544277029,0.783653046286195,0.12271742165710675,1030660.6048616586,-606.3278962503787,1030054.2769654082,2945,0,335.9641025641026,66,129,40,39.10399801164609,0.5370192307692307,44.57400497512439,8070.130878897302,122.27471028632276,8
4465,31.392582057674904,3,0,193,0.015544041450777202,0.0,1.0,193,6050,3900,2150,0.6446280991735537,82,39,43,214.00770544533316,0.48225995790155446,0.7772421732585018,0.1213231982789717,1020782.991363759,-958.9148521239204,1019824.0765116351,2946,0,337.14507772020727,75,118,37,39.526004156365296,0.5325993091537133,44.98355263157893,8005.624750069855,106.74166333426473,8
4466,30.95416845194781,3,3,193,0.015306122448979591,0.015306122448979591,0.9846938775510204,196,5900,4300,1600,0.7288135593220338,75,43,32,208.63395438253656,0.4823674341531485,0.776030020792668,0.1191601605119721,1008768.7255306048,-3007.3183470238064,1005761.407183581,2947,0,332.96938775510205,67,129,36,39.373324932997264,0.5347576530612245,44.69975490196077,7902.606792588249,117.94935511325745,0
4467,31.209097036004326,5,4,194,0.025252525252525252,0.020202020202020204,0.9797979797979798,198,6200,4600,1600,0.7419354838709677,78,46,32,223.34418341199785,0.4825309995043498,0.7932228543832087,0.12702572484614552,1015798.6664136772,-425.4552677680931,1015373.211145909,2948,0,329.64646464646466,75,123,40,39.16179828095621,0.5318287037037037,44.860197368421055,7962.6828580759475,106.16910477434597,8
4468,31.01044023974987,0,3,191,0.0,0.015463917525773196,0.9845360824742269,194,6100,4500,1600,0.7377049180327869,77,45,32,210.76540209286804,0.48190534693659526,0.7758069750172953,0.11870679775918158,1006377.2500299473,-2478.0988480647857,1003899.1511818825,2949,1,337.2371134020619,72,122,33,39.86443280684068,0.5287800687285223,45.234018264840174,7900.405251719358,109.72785071832442,8
4469,31.442008803292012,0,2,189,0.0,0.010471204188481676,0.9895287958115183,191,6400,4200,2200,0.65625,86,42,44,233.41333565341006,0.48121498117020295,0.7950667399489202,0.12972344735138555,1016270.2515798393,2842.2058693160725,1019112.4574491554,2950,2,343.4764397905759,60,131,37,39.8133689300826,0.5221967713787086,45.74795081967213,7994.195168582898,133.2365861430483,8
4470,31.111207688061345,1,0,190,0.005263157894736842,0.0,1.0,190,5900,4200,1700,0.711864406779661,76,42,34,226.77014962201963,0.4814049011417432,0.7870398369815461,0.12642180911304346,1006525.8870081316,1750.0051990539296,1008275.8922071855,2951,0,343.70526315789476,65,125,40,39.85976246613305,0.5240131578947369,45.62815656565656,7913.815251080873,121.75100386278267,8
4471,31.39423440842087,3,3,190,0.015544041450777202,0.015544041450777202,0.9844559585492227,193,6850,4800,2050,0.7007299270072993,89,48,41,225.71727816008183,0.4816741328439839,0.7864369122223815,0.1265259238126699,1017372.1339918491,477.69379211094383,1017849.82778396,2952,0,339.34715025906735,64,129,37,39.67028096017458,0.5261226252158895,45.41666666666667,7992.448843143824,124.88201317412225,8
4472,31.177421979210713,4,5,189,0.020618556701030927,0.02577319587628866,0.9742268041237113,194,5700,3800,1900,0.6666666666666666,76,38,38,222.1740122120996,0.48180463561419434,0.7862365233007014,0.12600492183631057,1013912.5582827005,553.0042211802538,1014465.5625038807,2953,0,338.3556701030928,70,124,38,39.301568582331385,0.5290485395189004,44.967723004694825,7951.248918201561,113.58927026002229,0
4473,31.46350584252779,1,1,189,0.005263157894736842,0.005263157894736842,0.9947368421052631,190,5950,4200,1750,0.7058823529411765,77,42,35,225.7142765667823,0.48162652000371303,0.785702009440959,0.12855650070446908,1024514.8387079816,2299.525130181114,1026814.3638381627,2954,0,343.60526315789474,72,118,42,39.0458417207187,0.53125,44.80593607305936,8029.299921343698,111.51805446310692,0
4474,31.102845038003675,7,4,192,0.03571428571428571,0.02040816326530612,0.9795918367346939,196,6150,4600,1550,0.7479674796747967,77,46,31,210.1712457931576,0.48194771498342925,0.7778492049335879,0.12178560927196513,1017961.9223636766,-2560.7349213655534,1015401.1874423111,2955,0,333.86224489795916,74,122,39,38.77560483506143,0.5358205782312926,44.15277777777779,7957.576506181502,107.53481765110138,0
4475,31.364312212862995,3,1,194,0.015384615384615385,0.005128205128205128,0.9948717948717949,195,6000,4100,1900,0.6833333333333333,79,41,38,237.0678883798416,0.48150057273768615,0.8034746206174783,0.13507356430944478,1021399.1105561543,3428.1860665192257,1024827.2966226735,2956,0,334.8615384615385,72,123,41,38.74149659863948,0.5295940170940171,44.79166666666667,8004.433845991087,111.17269230543177,8
4476,31.401964251119225,2,1,195,0.01020408163265306,0.00510204081632653,0.9948979591836735,196,7100,5100,2000,0.7183098591549296,91,51,40,225.42749734835218,0.4814604046746904,0.7924832710213612,0.12794130147519084,1021433.0553017951,-248.1805268870221,1021184.8747749081,2957,0,334.13775510204084,69,127,41,39.19073317775188,0.5290178571428572,44.9404761904762,8009.37004857417,116.07782679093,8
4477,31.18810024758919,2,1,196,0.01015228426395939,0.005076142131979695,0.9949238578680203,197,6150,4100,2050,0.6666666666666666,82,41,41,228.62302362043852,0.4808759798335578,0.7890166575660165,0.1284341515862344,1011358.1513827249,693.9517064585962,1012052.1030891835,2958,0,330.3147208121827,76,121,37,39.51051350154937,0.5297694585448393,45.332792207792174,7942.58640639692,104.50771587364369,8
4478,31.014036894329863,3,1,198,0.01507537688442211,0.005025125628140704,0.9949748743718593,199,6600,4600,2000,0.696969696969697,86,46,40,226.95777650456859,0.48130594047679476,0.7905065869890004,0.12874790113382611,1008669.3567308793,-614.9291136138318,1008054.4276172655,2959,0,327.5929648241206,80,119,32,39.17049045313967,0.5322445561139029,44.95884773662548,7909.855705868612,98.87319632335765,0
4479,30.92149598626984,4,5,197,0.019801980198019802,0.024752475247524754,0.9752475247524752,202,5950,4100,1850,0.6890756302521008,78,41,37,219.83760748342021,0.48160240464344944,0.7864168834301601,0.1244671542961836,1005074.7263612805,-2159.3553629368434,1002915.3709983437,2960,0,323.7079207920792,81,121,35,39.42789555411619,0.5302702145214522,45.03302845528454,7883.960187251258,97.33284181791676,8
4480,30.670883718389888,2,2,197,0.010050251256281407,0.010050251256281407,0.9899497487437185,199,6000,4200,1800,0.7,78,42,36,229.17506402356435,0.4810109046918092,0.7970393139603968,0.12934891571111604,995992.578327928,-148.66741894045026,995843.9109089875,2961,0,329.0251256281407,74,125,35,39.31231493087728,0.5308835845896147,45.15277777777778,7816.389518732444,105.62688538827628,8
4481,30.60995284856124,2,2,197,0.010050251256281407,0.010050251256281407,0.9899497487437185,199,5650,3400,2250,0.6017699115044248,79,34,45,225.56298541096024,0.48117375598531376,0.7898097605504169,0.12477241282499744,987955.8583547918,-880.7454270494281,987075.1129277423,2962,0,329.95979899497485,74,125,40,40.19968931649627,0.5226654103852597,45.93055555555553,7777.0537147045325,105.09532046898016,8
4482,30.22949420628717,4,1,200,0.01990049751243781,0.004975124378109453,0.9950248756218906,201,6550,4800,1750,0.732824427480916,83,48,35,228.1747845314815,0.481044776119403,0.7941500012324603,0.12817663138826713,980259.5670785336,-2015.8968993864337,978243.6701791472,2963,0,327.5771144278607,70,131,39,39.5236826439298,0.5260157545605306,45.33450704225352,7698.40904390746,109.97727205582085,0
4483,30.056186876909802,4,4,200,0.0196078431372549,0.0196078431372549,0.9803921568627451,204,6600,4800,1800,0.7272727272727273,84,48,36,226.08527878083848,0.4812755561994913,0.7955525174894085,0.12854562993539134,978184.6289550528,-3169.371092713036,975015.2578623397,2964,0,323.6666666666667,77,127,39,39.10372173366837,0.5291053921568627,44.87179487179488,7668.1810109039325,99.58676637537575,0
4484,30.141576548525297,1,2,199,0.004975124378109453,0.009950248756218905,0.9900497512437811,201,6300,4000,2300,0.6349206349206349,86,40,46,215.42322857954852,0.48098984245439474,0.791782950419939,0.1191785871805712,972876.411139438,-4583.96450069182,968292.4466387462,2965,0,328.64179104477614,78,123,40,40.45228086563907,0.5224917081260365,45.925632911392384,7658.201984619333,98.18207672588889,8
4485,30.590133363819312,5,3,201,0.024509803921568627,0.014705882352941176,0.9852941176470589,204,6050,4200,1850,0.6942148760330579,79,42,37,206.32155567063882,0.48131077143501083,0.7862967498811291,0.11564444970287867,991290.3053665722,-5945.088415109096,985345.2169514631,2966,0,324.70098039215685,67,137,42,40.16719066530274,0.5257352941176471,45.419730392156865,7787.644399101008,116.2334984940449,0
4486,31.04576413001664,1,0,202,0.0049504950495049506,0.0,1.0,202,6400,3800,2600,0.59375,90,38,52,203.8842552807854,0.4814299993432179,0.7803975260558924,0.11470336719247744,1007185.0519600904,-5730.1651502354,1001454.886809855,2967,0,327.94059405940595,72,130,45,40.08342203051184,0.527588696369637,45.27682648401827,7908.075563426491,109.83438282536792,0
4487,30.920324985898716,1,4,199,0.0049261083743842365,0.019704433497536946,0.9802955665024631,203,6750,4400,2350,0.6518518518518519,91,44,47,206.49176677076204,0.48157688305776386,0.7829715834534396,0.1141113124314696,997674.3511713794,-6147.692112950003,991526.6590584294,2968,0,327.320197044335,76,127,45,40.72307576241696,0.5212951559934318,45.96861471861469,7854.73298951841,103.35174986208435,7
4488,31.149178552101144,4,2,201,0.019704433497536946,0.009852216748768473,0.9901477832512315,203,5850,4000,1850,0.6837606837606838,77,40,37,199.4187806717629,0.4821347282511503,0.7756826531386316,0.11129907663413148,1008099.6702725858,-6243.198591726881,1001856.471680859,2969,0,327.9162561576355,66,137,49,40.51105577283465,0.5238608374384237,45.584577114427866,7924.831433871024,120.07320354350037,0
4489,31.601431033038285,4,3,202,0.01951219512195122,0.014634146341463415,0.9853658536585366,205,6250,4400,1850,0.704,81,44,37,199.065069977878,0.4827723975769169,0.7744701884123462,0.11249286127854573,1026590.7908195939,-6378.326477370629,1020212.4643422234,2970,0,325.45365853658535,72,133,41,40.03153632275276,0.5272865853658537,45.10559360730593,8055.028004325941,111.8753889489714,0
4490,31.45039901009794,3,4,201,0.014634146341463415,0.01951219512195122,0.9804878048780488,205,6050,4400,1650,0.7272727272727273,77,44,33,195.34080783196896,0.48335923800414476,0.7702505846976282,0.11109896540764147,1023652.6015404925,-7057.774775156729,1016594.8267653357,2971,0,325.65365853658534,75,130,45,39.8762758528069,0.5295223577235773,44.860197368421055,8024.2485961207985,106.98998128161065,0
4491,31.043945310534305,2,4,199,0.009852216748768473,0.019704433497536946,0.9802955665024631,203,7200,5300,1900,0.7361111111111112,91,53,38,199.45819741188137,0.4833184981059682,0.772605777744676,0.11401129061938431,1011937.3041884989,-7432.161882544606,1004505.1423059542,2972,0,329.7832512315271,67,136,45,39.57633389328853,0.5310960591133005,44.66911764705883,7926.477947855197,118.30564101276414,0
4492,31.45132141982754,2,1,200,0.009950248756218905,0.004975124378109453,0.9950248756218906,201,6700,4500,2200,0.6716417910447762,89,45,44,196.84779381267236,0.48292599502487565,0.7651605364293208,0.11333384877079929,1027414.6558964753,-6451.138331194404,1020963.5175652809,2973,0,329.25373134328356,70,131,42,39.364022500287,0.5343594527363185,44.395539906103295,8039.098030754651,114.8442575822093,0
4493,31.522980717224073,2,3,199,0.009900990099009901,0.01485148514851485,0.9851485148514851,202,7150,5600,1550,0.7832167832167832,87,56,31,196.65560830153066,0.4830247483703594,0.763339643455405,0.11393738224036784,1031668.6039974896,-6973.316623056371,1024695.2873744331,2974,0,328.4009900990099,73,129,37,39.12694864740948,0.5367677392739274,44.15822072072074,8064.895474881064,110.47802020385019,0
4494,31.2846446516949,1,3,197,0.005,0.015,0.985,200,6000,4500,1500,0.75,75,45,30,213.00752999371787,0.4826261515912898,0.7739160305343493,0.12346896650078447,1024009.298072321,-2375.6617454024436,1021633.6363269185,2975,0,332.1,79,121,33,38.69062765055131,0.5380729166666667,44.14062500000003,8004.469627679823,101.3224003503775,8
4495,31.271279034507153,1,1,197,0.005050505050505051,0.005050505050505051,0.9949494949494949,198,5200,3100,2100,0.5961538461538461,73,31,42,212.8880592235824,0.4824626339537507,0.7740775465884528,0.12452222675235693,1026292.4727466186,-1102.9174562395237,1025189.555290379,2976,0,336.2171717171717,81,117,39,38.34663823879416,0.541087962962963,43.80081300813013,8011.676264836755,98.90958351650315,0
4496,31.719197074889724,3,3,197,0.015,0.015,0.985,200,7150,5200,1950,0.7272727272727273,91,52,39,228.77663686030365,0.4825450167504188,0.7969794030371788,0.13225644324648642,1037418.0438465266,317.4022178807418,1037735.4460644074,2977,0,333.56,69,131,39,38.3899046760148,0.5352083333333333,44.24107142857143,8112.467859019794,117.5719979568086,8
4497,32.030534826806075,1,4,194,0.005050505050505051,0.020202020202020204,0.9797979797979798,198,6350,4400,1950,0.6929133858267716,83,44,39,218.1499712977704,0.4826105812780939,0.7912329007275405,0.1238712445716907,1042030.9696169725,-486.19477733381336,1041544.7748396387,2978,0,333.4191919191919,71,127,40,39.357346435256076,0.529040404040404,44.92187500000001,8170.288766368912,115.07448966716777,7
4498,31.841377440009637,4,3,195,0.020202020202020204,0.015151515151515152,0.9848484848484849,198,6600,5300,1300,0.803030303030303,79,53,26,233.35757163222124,0.4824695773299834,0.7994020353389133,0.13180700030281672,1034232.7853895478,2069.2102601867255,1036301.9956497345,2979,0,333.74242424242425,71,127,37,39.176706684830926,0.5292508417508417,45.124421296296305,8115.589501745535,114.30407748937374,8
4499,31.49896027744327,2,0,197,0.01015228426395939,0.0,1.0,197,5700,4000,1700,0.7017543859649122,74,40,34,231.27930007622945,0.4823263061569805,0.7973166558016167,0.13173039820383584,1025679.3426885486,2343.680095930516,1028023.0227844791,2980,0,335.65482233502536,79,118,39,38.90254817422658,0.5322546531302876,44.80468749999998,8038.387011427167,101.75173432186287,0
4500,31.31754356544823,1,2,196,0.005050505050505051,0.010101010101010102,0.98989898989899,198,6000,4100,1900,0.6833333333333333,79,41,38,229.96940403255238,0.4822740945837392,0.7957187033482618,0.1316638016494062,1021345.7976437935,1375.656879058918,1022721.4545228524,2981,0,334.95454545454544,67,131,40,38.73460492642354,0.5343013468013468,44.607843137254896,7998.2549988227975,119.37694028093728,0
4501,31.389733599721968,1,1,196,0.005076142131979695,0.005076142131979695,0.9949238578680203,197,7550,5900,1650,0.7814569536423841,92,59,33,225.4236300370538,0.4819809903656895,0.790395667868375,0.12981697182186047,1025474.7149853247,-716.7534473588858,1024757.9615379658,2982,0,337.0812182741117,71,126,38,38.624443438231054,0.5368549069373942,44.38657407407408,8023.637344327104,113.00897668066344,0
4502,31.187986300823095,3,3,196,0.01507537688442211,0.01507537688442211,0.9849246231155779,199,7300,5000,2300,0.684931506849315,96,50,46,213.00410477394382,0.4821921053076832,0.7852112579196695,0.12266201354074971,1018876.9241735005,-3695.0065783189016,1015181.9175951816,2983,0,334.6030150753769,66,133,44,38.942785313139915,0.5336578726968174,44.387437810945265,7972.041087870513,120.78850133137142,8
4503,30.88089273642898,2,2,196,0.010101010101010102,0.010101010101010102,0.98989898989899,198,6600,5100,1500,0.7727272727272727,81,51,30,210.11550934545656,0.4819151754430942,0.7806792692766289,0.12156430461592191,1010235.2733845388,-3746.7801948123647,1006488.4931897265,2984,0,336.4141414141414,69,129,39,38.83679242538833,0.5368265993265993,44.21130952380951,7898.983113786841,114.47801614183828,0
4504,30.969880711395135,5,2,199,0.024875621890547265,0.009950248756218905,0.9900497512437811,201,5000,3000,2000,0.6,70,30,40,199.88968840737132,0.4819993781094527,0.7725286476819111,0.11683083232185405,1016176.3376181906,-4575.365701310968,1011600.9719168796,2985,0,332.34328358208955,78,123,46,38.708522064374485,0.5397491708126037,43.82911392405065,7933.581783504589,101.71258696800756,0
4505,30.827443579295966,0,1,198,0.0,0.005025125628140704,0.9949748743718593,199,6500,4400,2100,0.676923076923077,86,44,42,224.74971749231744,0.4818241036834002,0.7825284434277153,0.12665877256882968,1000618.9689851748,-1322.2338806257458,999296.7351045491,2986,1,336.40201005025125,76,123,35,39.4846642596722,0.5278999162479062,45.211038961038945,7854.4923210559755,103.34858317178914,8
4506,30.438899195328634,5,2,201,0.024630541871921183,0.009852216748768473,0.9901477832512315,203,6700,5500,1200,0.8208955223880597,79,55,24,222.64090046689293,0.4825625111772261,0.7885972064229811,0.1270023068077362,991609.2648605099,-3145.444072028329,988463.8207884816,2987,0,330.53694581280786,69,134,38,39.064048562933614,0.5314552545155993,44.747023809523824,7769.619611569553,112.60318277637033,0
4507,30.873150234015124,2,1,202,0.009852216748768473,0.0049261083743842365,0.9950738916256158,203,6400,4300,2100,0.671875,85,43,42,210.20168699271963,0.4823592888845534,0.7778236128633731,0.11787830003584543,1000613.3027854299,-4933.879145429203,995679.4236400006,2988,0,331.2512315270936,76,127,40,40.048707049238395,0.5269396551724138,45.40043290043289,7860.290684580124,103.42487742868585,8
4508,30.89614768965314,4,2,204,0.019417475728155338,0.009708737864077669,0.9902912621359223,206,6500,4800,1700,0.7384615384615385,82,48,34,210.27736421415577,0.482837536506433,0.7774017162600901,0.11669652826311547,998186.7331860668,-5720.784950418979,992465.9482356479,2989,0,327.3883495145631,70,136,39,40.45882392550697,0.524221278317152,45.80399061032864,7853.677448223747,112.1953921174821,8
4509,30.731397337471012,4,8,200,0.019230769230769232,0.038461538461538464,0.9615384615384616,208,6450,4300,2150,0.6666666666666666,86,43,43,221.17785805118922,0.48309759383128953,0.7959307682905037,0.12334397114633844,994335.6656141526,-4064.9934591115125,990270.672155041,2990,0,323.32211538461536,66,142,41,39.98925355498516,0.524238782051282,45.61567164179106,7817.585871201845,118.44827077578553,8
4510,31.27122985912315,4,3,201,0.0196078431372549,0.014705882352941176,0.9852941176470589,204,6700,5100,1600,0.7611940298507462,83,51,32,211.24855745246384,0.4831550436266461,0.7874414022118412,0.11899055108867883,1014870.5337172411,-4622.0127502440355,1010248.5209669971,2991,0,330.5,75,129,34,39.848289218850866,0.5293096405228759,45.23026315789474,7966.9630019378,106.22617335917067,8
4511,31.19602611080074,7,8,200,0.03365384615384615,0.038461538461538464,0.9615384615384616,208,7250,5500,1750,0.7586206896551724,90,55,35,205.92707133217164,0.48293888579214667,0.7888973093069054,0.11770343215414072,1016880.5244310091,-6969.354341839804,1009911.1700891693,2992,0,324.9375,68,140,39,39.41297621159263,0.5327524038461539,44.67089371980677,7965.25346636434,117.13608038771088,0
4512,30.78868679042715,9,6,203,0.0430622009569378,0.028708133971291867,0.9712918660287081,209,6650,4600,2050,0.6917293233082706,87,46,41,198.64738976593324,0.48319032940743467,0.7834344089235601,0.1154796718511427,1008635.175555578,-8377.4510299559,1000257.7245256221,2993,0,321.3205741626794,73,136,40,38.94678471916706,0.5372807017543859,44.03153153153155,7880.933003901041,107.95798635480878,0
4513,30.98095166621653,2,3,202,0.00975609756097561,0.014634146341463415,0.9853658536585366,205,7250,5600,1650,0.7724137931034483,89,56,33,200.25348877375896,0.4824944205324406,0.7815133167755894,0.1169151190621594,1016213.6060690467,-7549.936009062096,1008663.6700599845,2994,0,328.37560975609756,77,128,42,38.74110355075869,0.5390243902439025,43.87019230769232,7935.145192392744,103.05383366743824,0
4514,30.866131811668588,0,3,199,0.0,0.01485148514851485,0.9851485148514851,202,5950,3800,2150,0.6386554621848739,81,38,43,203.52738472038322,0.4821329614304714,0.7794900897987249,0.11568295650910639,1004448.6041772374,-5463.440501153458,998985.1636760839,2995,1,332.35643564356434,78,124,39,39.691656329680896,0.5326423267326732,44.88396624472574,7874.445125160397,100.95442468154354,7
4515,31.077643202358765,1,4,196,0.005,0.02,0.98,200,6500,4500,2000,0.6923076923076923,85,45,40,205.38452073103184,0.4818734296482412,0.7803733694624735,0.11431943035709397,1004958.2540955998,-5219.426125576149,999738.8279700236,2996,0,336.425,64,136,44,40.46595038544751,0.5228645833333334,45.68910256410257,7903.383332984488,123.49036457788263,8
4516,31.13043030882762,3,2,197,0.01507537688442211,0.010050251256281407,0.9899497487437185,199,6950,5000,1950,0.7194244604316546,89,50,39,197.98276479024952,0.48236553136050625,0.7695470877852506,0.11119631862916309,1009419.5287966528,-6780.466171113583,1002639.0626255393,2997,0,336.92964824120605,71,128,42,40.29963451122978,0.5268006700167505,45.34143518518518,7927.630704513651,111.65677048610776,0
4517,31.56167666815226,5,5,197,0.024752475247524754,0.024752475247524754,0.9752475247524752,202,5550,3700,1850,0.6666666666666666,74,37,37,189.43179951490367,0.48265684777432966,0.7627669774781376,0.10729223815301278,1025998.5438498016,-7078.6499077721755,1018919.8939420294,2998,0,332.45544554455444,77,125,40,40.1885398662686,0.5298061056105611,45.018696581196586,8047.637454928314,104.51477214192616,0
4518,31.1150215386278,2,1,198,0.010050251256281407,0.005025125628140704,0.9949748743718593,199,7250,5500,1750,0.7586206896551724,90,55,35,214.27207521671068,0.4821995076392061,0.7843812744496648,0.12227622016857832,1013753.5210825145,-3606.185855880329,1010147.3352266342,2999,0,337.0502512562814,69,130,39,39.2624655085306,0.5364845058626466,44.73214285714287,7942.664873119386,115.11108511767226,7
4519,31.337478242695212,3,3,198,0.014925373134328358,0.014925373134328358,0.9850746268656716,201,7100,4800,2300,0.676056338028169,94,48,46,219.80164343104494,0.4823383084577115,0.7889473204243536,0.1269677728525219,1024694.904544711,-2254.075193130723,1022440.8293515802,3000,0,334.1940298507463,75,126,37,38.6498642226748,0.5398009950248757,44.27083333333335,8013.907196439288,106.85209595252384,8
4520,31.06727793675626,3,5,196,0.014925373134328358,0.024875621890547265,0.9751243781094527,201,5600,3600,2000,0.6428571428571429,76,36,40,198.9760786470208,0.48257359038142617,0.7591185388074349,0.11507186387134806,1016208.7161928442,-5359.754913004653,1010848.9612798395,3001,0,332.40796019900495,82,119,42,39.13763493621201,0.5403192371475953,44.226907630522106,7946.173749386245,96.90455791934444,8
4521,31.314142101857698,3,3,196,0.01507537688442211,0.01507537688442211,0.9849246231155779,199,6750,4900,1850,0.725925925925926,86,49,37,193.5171751145123,0.48236870378830177,0.7518259303022896,0.11290122628540265,1026927.194054681,-6804.39007165262,1020122.8039830284,3002,0,336.24120603015075,84,115,34,38.94102705203053,0.5430276381909548,43.89705882352945,8019.643892703798,95.47195110361665,0
4522,31.527641267694555,0,2,194,0.0,0.01020408163265306,0.9897959183673469,196,5900,3800,2100,0.6440677966101694,80,38,42,200.25833458452882,0.48150564713064714,0.7574286061642266,0.11710434157582018,1034627.2831734399,-3661.452671193724,1030965.8305022462,3003,1,342.26020408163265,85,111,36,38.6801549966117,0.5443771258503401,43.81056201550391,8077.048697347569,95.02410232173611,0
4523,31.179166109975945,1,0,195,0.005128205128205128,0.0,1.0,195,6650,4500,2150,0.6766917293233082,88,45,43,211.92047486114564,0.481304520222046,0.7669747767507442,0.12241523900802699,1019518.3030814811,-2438.6394162684555,1017079.6636652127,3004,0,344.6923076923077,77,118,44,38.851408689748844,0.5403311965811965,44.27083333333335,7973.4221666657595,103.55093722942544,8
4524,30.756277648574525,2,3,194,0.01015228426395939,0.015228426395939087,0.9847715736040609,197,5650,3700,1950,0.6548672566371682,76,37,39,208.3206460677829,0.4815482665147277,0.7648181561315319,0.12091949137082772,1007124.6842539962,-3089.027021078895,1004035.6572329174,3005,0,342.1827411167513,79,118,39,38.757377633051824,0.5420368020304569,44.088541666666686,7870.883865951655,99.63144134116018,0
4525,30.633475680486747,0,1,193,0.0,0.005154639175257732,0.9948453608247423,194,6450,4700,1750,0.7286821705426356,82,47,35,211.2471350438507,0.481213165251144,0.7641840593456559,0.12313679604780953,1004346.43522315,-2816.9385935208247,1001529.4966296292,3006,1,348.1340206185567,80,114,44,38.52063663452527,0.5442439862542956,43.93004115226339,7844.312856865423,98.05391071081779,0
4526,31.191361590297948,0,1,192,0.0,0.0051813471502590676,0.9948186528497409,193,5900,3700,2200,0.6271186440677966,81,37,44,210.83301085623478,0.4809455059009787,0.7641568152026779,0.12323950222215038,1023473.9804481133,-1343.5798338214627,1022130.4006142918,3007,2,350.9015544041451,82,111,45,38.42429289960155,0.5454447322970639,43.8253012048193,7990.4376604062,97.44436171227073,0
4527,31.63027008825829,2,0,194,0.010309278350515464,0.0,1.0,194,5800,3900,1900,0.6724137931034483,77,39,38,206.8695405704873,0.4809883731282161,0.7611648961222475,0.1220158667436698,1040597.8324510421,-1546.4008964419245,1039051.4315546002,3008,0,349.2113402061856,71,123,47,38.18316412859558,0.5475730240549828,43.48958333333331,8113.493759618277,114.27455999462362,0
4528,31.585401097930742,0,2,192,0.0,0.010309278350515464,0.9896907216494846,194,5400,4100,1300,0.7592592592592593,67,41,26,203.34631872467997,0.48073130886882826,0.7572863753638037,0.12040843816618632,1040300.2819002003,-1891.7534614697151,1038408.5284387306,3009,1,350.2113402061856,76,118,48,38.12515373532925,0.5488616838487972,43.34415584415583,8106.577781790301,106.66549712881975,0
4529,31.802720725560125,2,4,190,0.010309278350515464,0.020618556701030927,0.979381443298969,194,6750,4900,1850,0.725925925925926,86,49,37,235.43020509290432,0.4804697932802735,0.7913974327667292,0.1372165240967654,1042644.0814915138,3543.9819888901957,1046188.063480404,3010,0,350.60309278350513,78,116,37,37.906046172330946,0.5415592783505154,43.93459915611816,8143.576430516623,104.4048260322644,8
4530,32.228218269349966,4,0,194,0.020618556701030927,0.0,1.0,194,6100,4300,1800,0.7049180327868853,79,43,36,227.48457617588267,0.48043084415006326,0.7843611445872245,0.1341875642731521,1060298.3128518406,3340.3024638211546,1063638.6153156618,3011,0,350.46907216494844,74,120,38,37.65081578139949,0.5443513745704467,43.48611111111113,8266.985600230932,111.71602162474233,0
4531,32.18201571237519,1,3,192,0.005128205128205128,0.015384615384615385,0.9846153846153847,195,5300,3900,1400,0.7358490566037735,67,39,28,230.2429348221351,0.48022072429288926,0.7938425391424127,0.13346629018555356,1053398.0587222115,4207.492115228195,1057605.5508374397,3012,0,349.6666666666667,66,129,40,38.247655506268856,0.5346153846153846,44.13868159203979,8234.132969193977,124.75959044233299,8
4532,31.919083148495226,4,1,195,0.02040816326530612,0.00510204081632653,0.9948979591836735,196,6800,4800,2000,0.7058823529411765,88,48,40,228.80298370178394,0.4800884135705565,0.7948772700015714,0.13381419902863398,1047513.9810463237,1934.8648665466912,1049448.8459128703,3013,0,348.8112244897959,74,122,44,37.943750225884585,0.5375744047619048,43.805555555555564,8177.491774404782,110.50664560006462,0
4533,31.983656885370493,1,1,195,0.00510204081632653,0.00510204081632653,0.9948979591836735,196,6150,4100,2050,0.6666666666666666,82,41,41,225.4826467126991,0.4797106663178092,0.7923224616129658,0.13265496529668158,1051443.987202338,2066.4746209070545,1053510.461823245,3014,0,348.8826530612245,62,134,44,37.8029350442782,0.5397534013605443,43.58465608465607,8201.1003799326,132.27581257955808,0
4534,32.29980524140319,2,3,194,0.01015228426395939,0.015228426395939087,0.9847715736040609,197,6550,4900,1650,0.7480916030534351,82,49,33,223.0569429337377,0.47972564660381917,0.7910401570025793,0.13251748314215586,1064846.0463375882,1554.2607582275687,1066400.307095816,3015,0,348.03553299492387,68,129,45,37.49399827542282,0.5421425549915397,43.2216183574879,8293.891717255787,121.96899584199686,0
4535,32.52363096399837,2,5,191,0.01020408163265306,0.025510204081632654,0.9744897959183674,196,5850,4400,1450,0.7521367521367521,73,44,29,219.39610670972598,0.47986383656026516,0.7864521372351398,0.13101680221687131,1073816.6874077795,2068.2401074401314,1075884.9275152197,3016,0,349.80102040816325,70,126,37,37.393305737938896,0.5446960034013606,43.03110328638496,8357.561565939395,119.39373665627707,0
4536,32.19885297381643,3,4,190,0.015463917525773196,0.020618556701030927,0.979381443298969,194,5900,4400,1500,0.7457627118644068,74,44,30,222.39512846642273,0.4788394939729003,0.789461883534543,0.133928031729186,1065649.3477972944,2699.044720707582,1068348.392518002,3017,0,352.87628865979383,73,121,40,37.000681639948205,0.5472508591065293,42.7224099099099,8284.043296768594,113.48004516121361,0
4537,32.075710976995104,1,2,189,0.005235602094240838,0.010471204188481676,0.9895287958115183,191,6800,4800,2000,0.7058823529411765,88,48,40,225.19902619567742,0.4783055479011666,0.7877479743400113,0.13656408871564257,1063674.7993819576,2907.705801939787,1066582.5051838974,3018,0,358.6387434554974,64,127,40,36.668352001659414,0.5495200698080279,42.46794871794871,8260.523644235738,129.0706819411834,0
4538,32.265049280229036,2,2,189,0.010471204188481676,0.010471204188481676,0.9895287958115183,191,6550,4900,1650,0.7480916030534351,82,49,33,221.7281853819484,0.4782159915495545,0.784713255546603,0.13581149483254995,1072975.9096099401,2831.800279271374,1075807.7098892115,3019,0,358.413612565445,68,123,41,36.38619777946885,0.5528468586387434,42.10446859903381,8321.012029803012,122.36782396769136,0
4539,31.83586862658286,0,0,189,0.0,0.0,1.0,189,6300,4500,1800,0.7142857142857143,81,45,36,224.51543266106927,0.47796704379151184,0.7842909987898583,0.13797890181986036,1059695.3021348796,3483.589849542779,1063178.8919844225,3020,1,353.8201058201058,68,121,36,36.19083143174768,0.5543430335097002,41.98369565217389,8214.173168733769,120.79666424608483,0
4540,31.618496793468406,0,1,188,0.0,0.005291005291005291,0.9947089947089947,189,5700,4300,1400,0.7543859649122807,71,43,28,223.3141813840206,0.4776680175616346,0.7830741212278125,0.13762170328401735,1053275.9084458586,3542.289453219384,1056818.197899078,3021,2,354.8201058201058,71,118,36,36.11957709769632,0.5558862433862434,41.88368055555554,8161.250018696008,114.9471833619156,0
4541,31.40034428214931,1,2,187,0.005291005291005291,0.010582010582010581,0.9894179894179894,189,5100,3300,1800,0.6470588235294118,69,33,36,240.5069102939731,0.4776773987766896,0.7992164185935813,0.14034255519917216,1029811.5052495654,6635.356662551878,1036446.8619121172,3022,0,355.66137566137564,66,123,37,37.73030109876769,0.5381944444444444,43.88992537313434,8041.944517410557,121.84764420319026,8
4542,31.336272496887464,0,2,185,0.0,0.0106951871657754,0.9893048128342246,187,5300,3600,1700,0.6792452830188679,70,36,34,241.1846972111373,0.47737455197132617,0.7975820454009548,0.14069660259593333,1027621.588614764,6869.32033953611,1034490.9089543001,3023,1,360.3101604278075,68,119,37,37.724249390866945,0.5390485739750446,43.90096618357489,8025.189109861115,118.01748690972228,0
4543,31.73413292640329,2,1,186,0.0106951871657754,0.0053475935828877,0.9946524064171123,187,6000,3900,2100,0.65,81,39,42,227.99524777104392,0.4771984551396316,0.7853952185985542,0.13172875321977973,1037730.0261850543,3919.502887902642,1041649.529072957,3024,0,360.2620320855615,64,123,45,38.432134352675774,0.5366532976827094,44.26282051282051,8115.597648069606,126.8062132510876,8
4544,32.23073820775132,1,2,185,0.0053475935828877,0.0106951871657754,0.9893048128342246,187,6500,5100,1400,0.7846153846153846,79,51,28,226.66861932782928,0.47740330247445995,0.7835259417908635,0.13150295401891912,1055249.3078344816,3938.3807306978206,1059187.6885651795,3025,0,361.09090909090907,66,121,38,38.30730907102496,0.5389928698752229,44.10758706467661,8247.601370668188,124.96365713133618,0
4545,32.190566898251085,4,1,188,0.021164021164021163,0.005291005291005291,0.9947089947089947,189,5750,4100,1650,0.7130434782608696,74,41,33,221.5907930450028,0.4773302938196555,0.7809085417983774,0.13026484599755966,1058008.8884647284,3339.0057287122563,1061347.8941934407,3026,0,358.06349206349205,60,129,43,37.93209670973757,0.5422729276895943,43.61338797814208,8253.230386105568,137.55383976842614,0
4546,32.306433528382634,2,2,188,0.010526315789473684,0.010526315789473684,0.9894736842105263,190,5650,3500,2150,0.6194690265486725,78,35,43,214.98050684711149,0.47783985426529285,0.7756844465423647,0.12045390207765277,1046792.3370896007,1357.9894382389334,1048150.3265278396,3027,0,357.05263157894734,72,118,35,39.96111266816145,0.5319627192982457,45.4337899543379,8224.126343412468,114.22397699183983,8
4547,32.35405673768708,6,1,193,0.030927835051546393,0.005154639175257732,0.9948453608247423,194,7050,5200,1850,0.7375886524822695,89,52,37,209.08152380886673,0.47872876715987395,0.7741901022402189,0.11856722043619157,1052144.7011749595,-1853.1965221831001,1050291.5046527765,3028,0,348.1082474226804,80,114,37,39.63953742457096,0.5359213917525774,44.97170781893003,8251.199834941743,103.13999793677178,0
4548,32.56634182878744,3,3,193,0.015306122448979591,0.015306122448979591,0.9846938775510204,196,5600,4100,1500,0.7321428571428571,71,41,30,209.23178378675473,0.4788635967207396,0.766207129333796,0.11676970446932376,1053947.231667326,-696.1481402270692,1053251.083527099,3029,0,345.5408163265306,75,121,39,40.26348633408754,0.5316751700680272,45.58662280701751,8285.313007482824,110.47084009977098,8
4549,32.910933573312334,0,5,188,0.0,0.025906735751295335,0.9740932642487047,193,5800,4600,1200,0.7931034482758621,70,46,24,205.74241967768407,0.4781951640759931,0.7577667880024128,0.11524114785413755,1066276.6467634193,-524.332529817757,1065752.3142336016,2868,1,336.00518134715026,77,116,40,40.208792385848895,0.5335168393782384,45.44604700854698,8377.608237725704,108.8001069834507,0
4550,32.83395413236294,6,1,193,0.030927835051546393,0.005154639175257732,0.9948453608247423,194,6650,5300,1350,0.7969924812030075,80,53,27,201.76629217536504,0.4794359720812635,0.7668595319039879,0.1123487377304641,1061876.6348170212,-2599.8177290629806,1059276.8170879583,2869,0,333.05670103092785,71,123,39,40.542752242258764,0.5294243986254296,45.674189814814824,8350.521986296435,117.61298572248499,8
4551,32.59185100062773,5,2,196,0.025252525252525252,0.010101010101010102,0.98989898989899,198,6800,4400,2400,0.6470588235294118,92,44,48,199.93185125587704,0.4799384496402263,0.7698721054389299,0.11281993837145493,1058306.0410633709,-4082.182802984454,1054223.8582603864,2870,0,327.2878787878788,78,120,39,40.06581897518155,0.5331965488215489,45.16086497890295,8305.679117736436,106.48306561200559,0
4552,32.29652675141446,1,4,193,0.005076142131979695,0.02030456852791878,0.9796954314720813,197,6000,4400,1600,0.7333333333333333,76,44,32,209.20938398488812,0.47994794364446286,0.7805519598328134,0.1192995119112699,1052017.4709195055,-1381.6145935179911,1050635.8563259875,2871,0,329.5989847715736,65,132,41,39.42024280649685,0.5372779187817258,44.76010101010102,8243.36222575561,126.82095731931709,8
4553,32.742217684734754,2,1,194,0.010256410256410256,0.005128205128205128,0.9948717948717949,195,6150,4900,1250,0.7967479674796748,74,49,25,207.37586416528785,0.4794871794871795,0.7693505620767989,0.11785619133969993,1065461.9487230899,-959.781529663615,1064502.1671934263,2872,0,333.2358974358974,85,110,36,39.5981704808027,0.5352564102564102,44.88856589147286,8352.914109446236,98.269577758191,7
4554,32.545768233130055,1,4,191,0.005128205128205128,0.020512820512820513,0.9794871794871794,195,5900,4200,1700,0.711864406779661,76,42,34,206.24034764341818,0.4795852057449996,0.7701039439901356,0.11776999196665801,1060575.6221407806,-1153.3029975098502,1059422.3191432706,2873,0,334.20512820512823,73,122,39,39.442039773562726,0.537232905982906,44.70720720720723,8308.70006582279,113.81780912086013,0
4555,32.01908000919911,3,2,192,0.015463917525773196,0.010309278350515464,0.9896907216494846,194,6450,4700,1750,0.7286821705426356,82,47,35,204.47000242797822,0.4789852750031159,0.7679705127093877,0.11780267272128493,1046172.8030316898,-2467.808884804824,1043704.994146885,2874,0,336.7319587628866,78,116,40,39.14285345850314,0.5401632302405499,44.369725738396646,8185.046204355843,104.93648979943389,0
4556,31.82213262189462,0,2,190,0.0,0.010416666666666666,0.9895833333333334,192,6550,4800,1750,0.732824427480916,83,48,35,233.363577449635,0.47860992946480513,0.7938231899345687,0.12967022025259514,1028494.7702777953,3052.6437960532717,1031547.4140738485,2875,1,340.9583333333333,66,126,34,39.82245867221098,0.5315755208333333,45.755597014925364,8090.599110165449,122.58483500250681,8
4557,31.63353815710833,2,1,191,0.010416666666666666,0.005208333333333333,0.9947916666666666,192,6800,4900,1900,0.7205882352941176,87,49,38,215.62904068675104,0.4786053846713205,0.7751945826096112,0.11823192334798208,1018233.9849082311,-1287.8365279181662,1016946.148380313,2876,0,341.6458333333333,77,115,41,40.80296989315226,0.5260416666666667,46.27403846153846,8026.249885775918,104.23701150358336,8
4558,31.950414247928922,4,1,194,0.020512820512820513,0.005128205128205128,0.9948717948717949,195,5500,3300,2200,0.6,77,33,44,243.21418973394228,0.4793946603224954,0.795670449768811,0.1348733233979137,1032009.4741019423,5699.869608291276,1037709.3437102336,2877,0,336.48205128205126,65,130,38,39.65163934426232,0.5306623931623932,45.83333333333334,8120.730288015284,124.93431212331205,7
4559,31.58368488038832,3,2,195,0.015228426395939087,0.01015228426395939,0.9898477157360406,197,6650,4400,2250,0.6616541353383458,89,44,45,236.7891353863439,0.4796198936427363,0.7913215090803509,0.13268102650030092,1023391.8803185319,2415.615700406054,1025807.4960189379,2878,0,334.0304568527919,69,128,36,39.40364324545509,0.5336294416243654,45.43154761904762,8040.209780488144,116.52477942736441,0
4560,31.70814571485034,5,3,197,0.025,0.015,0.985,200,5750,4200,1550,0.7304347826086957,73,42,31,230.9463100636047,0.4798513400335009,0.7893952246308515,0.13103424330346766,1031299.8538700481,1884.979164084497,1033184.8330341326,2879,0,329.665,77,123,38,39.061681851502755,0.5367708333333333,44.95192307692307,8087.101587369274,105.02729334245811,0
4561,31.74788550194791,6,2,201,0.029556650246305417,0.009852216748768473,0.9901477832512315,203,4900,3100,1800,0.6326530612244898,67,31,36,205.1644811348741,0.4798098652229755,0.7707320561279163,0.11671873513853626,1033421.5913886153,-3095.7190818359086,1030325.8723067794,2880,0,325.6847290640394,89,114,40,39.61475580252515,0.5346366995073892,44.849537037037024,8100.487683917111,91.01671554963046,8
4562,31.79607617209559,4,2,203,0.01951219512195122,0.00975609756097561,0.9902439024390244,205,6000,4200,1800,0.7,78,42,36,224.76612522191382,0.4801311174876455,0.7956743343562145,0.12869920235298293,1036986.5333706795,-384.11099739330393,1036602.4223732862,2881,0,323.2780487804878,71,134,36,38.863141770048564,0.5314024390243902,44.60358796296298,8120.603771209581,114.37470100295185,8
4563,31.64848779073652,4,1,206,0.01932367149758454,0.004830917874396135,0.9951690821256038,207,6500,4500,2000,0.6923076923076923,85,45,40,239.54832986940647,0.48098900927098476,0.8097454241496727,0.13885323545527564,1035918.615296994,1730.5148350046638,1037649.1301319987,2882,0,317.0144927536232,71,136,32,38.01155640373197,0.536634460547504,44.14062500000001,8097.562305832991,114.05017332159143,8
4564,31.312541552137358,0,2,204,0.0,0.009708737864077669,0.9902912621359223,206,7250,5400,1850,0.7448275862068966,91,54,37,241.87798048493087,0.4807329899755308,0.810603305516771,0.14070333884240166,1025994.4581324757,1183.093504362966,1027177.5516368387,2883,1,319.5388349514563,72,134,33,37.8149386845039,0.538379854368932,44.0068493150685,8015.796167884493,111.33050233172906,0
4565,31.509532137158452,4,6,202,0.019230769230769232,0.028846153846153848,0.9711538461538461,208,5950,4100,1850,0.6890756302521008,78,41,37,238.8869777058159,0.4811079369503282,0.8103017383953846,0.14084237868683658,1036501.889651142,1971.3607610253557,1038473.2504121673,2884,0,315.84134615384613,67,141,39,37.3775680840898,0.5424679487179487,43.50490196078429,8082.040534690223,120.62747066701824,0
4566,31.138416813990823,3,3,202,0.014634146341463415,0.014634146341463415,0.9853658536585366,205,6950,5200,1750,0.7482014388489209,87,52,35,236.97975663385137,0.48061135023114937,0.8060018227881991,0.1407881772099676,1026556.1935332619,704.6073828967756,1027260.8009161587,2885,0,320.0780487804878,70,135,41,37.13670818573116,0.5454776422764227,43.221830985915474,7995.6656554939,114.22379507848429,0
4567,31.087836698843727,1,1,202,0.0049261083743842365,0.0049261083743842365,0.9950738916256158,203,7400,5400,2000,0.7297297297297297,94,54,40,246.67390587521174,0.48030369539416995,0.8064097227683653,0.14553517577678615,1022837.7702782277,2461.477574244499,1025299.2478524722,2886,0,320.5221674876847,72,131,37,37.15117464908864,0.5425389983579638,43.47888127853881,7974.686648617477,110.75953678635385,8
4568,30.864394463275175,0,3,199,0.0,0.01485148514851485,0.9851485148514851,202,6200,4000,2200,0.6451612903225806,84,40,44,246.95992280099077,0.4800800042690836,0.8059124586342261,0.14600270635994594,1016088.8050177428,3586.6425692266057,1019675.4475869694,2887,1,323.0990099009901,74,128,35,37.06585475868294,0.5438325082508251,43.402777777777786,7919.717884847359,107.02321466009944,0
4569,30.62620358283273,2,1,200,0.009950248756218905,0.004975124378109453,0.9950248756218906,201,5850,3900,1950,0.6666666666666666,78,39,39,227.92480361082497,0.4802497927031509,0.7994288034368966,0.13265285254805892,1003652.7781738791,-298.5275282520961,1003354.250645627,2888,0,325.2139303482587,69,132,40,38.15294892660622,0.5382462686567164,43.98809523809523,7840.672714866854,113.63293789662107,8
4570,30.209258815833305,3,2,201,0.014778325123152709,0.009852216748768473,0.9901477832512315,203,6550,4400,2150,0.6717557251908397,87,44,43,235.2442828660498,0.4800130875156481,0.8046106937082413,0.13442411741165983,984635.9951531141,-824.0022872212849,983811.9928658928,2889,0,322.97536945812806,65,138,38,38.6749577589582,0.5321223316912972,44.68118686868687,7712.992106435224,118.66141702208037,8
4571,30.05469175782019,3,4,200,0.014705882352941176,0.0196078431372549,0.9803921568627451,204,5550,4100,1450,0.7387387387387387,70,41,29,224.83834397112622,0.4803348063363276,0.7960153479327998,0.12975453415840962,982475.2872533094,-2170.3766842817895,980304.9105690276,2890,0,322.30882352941177,72,132,41,38.55753669289582,0.5344158496732025,44.30650684931508,7684.789121124161,106.73318223783558,0
4572,30.53054072626217,2,4,198,0.009900990099009901,0.019801980198019802,0.9801980198019802,202,6650,4700,1950,0.706766917293233,86,47,39,218.73850337652246,0.48004921760832797,0.7879086844410634,0.12720811992479383,1000291.1592449832,-3289.561777196923,997001.5974677863,2891,0,322.13861386138615,77,125,37,38.4177622426266,0.5373349834983498,44.01709401709404,7815.296536338101,101.49735761478053,0
4573,30.941274819789566,0,2,196,0.0,0.010101010101010102,0.98989898989899,198,6750,5100,1650,0.7555555555555555,84,51,33,191.80515141045078,0.4794299808576458,0.7557288798794821,0.11010092294341017,1009857.946538974,-7610.808732208972,1002247.1378067649,2892,1,329.0050505050505,80,118,37,39.608290968272335,0.5351957070707071,44.50874485596708,7905.2251394645,98.81531424330625,8
4574,31.42662443154335,5,2,199,0.024875621890547265,0.009950248756218905,0.9900497512437811,201,5000,3500,1500,0.7,65,35,30,209.89389212962047,0.4803928275290215,0.7856513491712334,0.1174293502483777,1017826.5731883674,-2472.8838081077392,1015353.6893802597,2893,0,322.0547263681592,69,132,40,40.14908446861176,0.5252902155887231,45.49107142857144,7998.3565126888025,115.91821032882322,8
4575,31.10595315490052,6,1,204,0.02926829268292683,0.004878048780487805,0.9951219512195122,205,6850,4600,2250,0.6715328467153284,91,46,45,203.1515615969086,0.4807508369201339,0.7833490549743716,0.11503566834657813,1011111.9801146134,-6768.204458074527,1004343.7756565389,2894,0,316.65365853658534,74,131,41,39.847977266949954,0.5289634146341464,45.02777777777779,7931.154000245361,107.17775676007246,0
4576,31.542777625348435,0,4,200,0.0,0.0196078431372549,0.9803921568627451,204,6400,4900,1500,0.765625,79,49,30,206.14535386788657,0.48048472262468206,0.7860300356884362,0.1170806262811109,1026231.074754765,-4889.446388891337,1021341.6283658737,2895,1,319.20588235294116,76,128,41,39.654928581530186,0.5304330065359477,44.91341991341992,8046.139270881654,105.87025356423229,0
4577,31.485268990129672,1,3,198,0.004975124378109453,0.014925373134328358,0.9850746268656716,201,6800,5400,1400,0.7941176470588235,82,54,28,211.28660570219589,0.48060219734660037,0.7863628123221518,0.1180591137016396,1019334.6293302117,-3925.64921882264,1015408.9801113891,2896,0,324.5223880597015,70,131,40,40.163505150676485,0.5219216417910448,45.53990610328639,8011.744503591701,114.45349290845287,7
4578,31.94137626325945,2,1,199,0.01,0.005,0.995,200,6000,4700,1300,0.7833333333333333,73,47,26,204.19513521594067,0.4804072445561139,0.7780047972088961,0.11504163269045528,1036684.7731135973,-3662.8025155524488,1033021.9705980448,2897,0,319.875,74,126,41,40.01978394388718,0.5244791666666666,45.22222222222223,8137.952863517118,109.97233599347457,0
4579,32.004344919952004,5,5,199,0.024509803921568627,0.024509803921568627,0.9754901960784313,204,6750,4800,1950,0.7111111111111111,87,48,39,202.3078163016118,0.4808509610740848,0.780772995625707,0.11554702078418967,1042993.0394176141,-5348.871155528337,1037644.1682620858,2898,0,314.38235294117646,67,137,40,39.53483139325568,0.5277777777777778,44.69975490196077,8170.717102265912,121.9510015263569,0
4580,31.966315515921643,4,1,202,0.019704433497536946,0.0049261083743842365,0.9950738916256158,203,6450,4600,1850,0.7131782945736435,83,46,37,211.41453546954023,0.48039717764879936,0.784385805345619,0.12295933427703089,1047358.5718981716,-2764.634810421283,1044593.9370877503,2899,0,316.1773399014778,74,129,41,38.601970412167915,0.5393575533661741,44.0138888888889,8182.932795471582,110.58017291177813,8
4581,31.965208900951534,2,3,201,0.00980392156862745,0.014705882352941176,0.9852941176470589,204,6250,4300,1950,0.688,82,43,39,211.76983547248304,0.48025884204256414,0.7754817340599125,0.12292054412523244,1046708.9792318693,-2717.722336099073,1043991.2568957703,2900,0,315.6127450980392,82,122,36,38.669429323394304,0.5422283496732025,44.08885542168676,8180.253196527424,99.75918532350516,8
4582,32.45247668592541,0,4,197,0.0,0.01990049751243781,0.9800995024875622,201,6800,4900,1900,0.7205882352941176,87,49,38,210.27852769358478,0.4798548922056385,0.7709832990894658,0.1224397714764322,1063647.1181406984,-2267.5700023697464,1061379.5481383286,2901,1,321.18905472636817,84,117,37,38.58683946008045,0.5434286898839138,43.97058823529413,8308.788516205343,98.91414900244456,0
4583,32.90951644626094,1,1,197,0.005050505050505051,0.005050505050505051,0.9949494949494949,198,7000,4900,2100,0.7,91,49,42,212.46857194558808,0.4793781725888325,0.7704875423452024,0.12436430297419863,1080279.589535875,-694.9076618691724,1079584.6818740058,2902,0,325.6666666666667,84,114,41,38.330523404119646,0.5462962962962963,43.77450980392158,8432.256983559155,100.38401170903755,0
4584,33.33095447969444,1,2,196,0.005050505050505051,0.010101010101010102,0.98989898989899,198,5700,3700,2000,0.6491228070175439,77,37,40,229.5652449483244,0.4792745560512058,0.7899486328396643,0.13244569071088794,1089485.6613037323,4721.608540975398,1094207.2698447078,2903,0,326.6212121212121,78,120,35,38.447389682498724,0.5418771043771045,44.316983122362856,8522.158996779439,109.25844867665947,8
4585,32.87337931251709,3,3,196,0.01507537688442211,0.01507537688442211,0.9849246231155779,199,5950,4000,1950,0.6722689075630253,79,40,39,231.91630830725086,0.47949659915740317,0.7936127864253815,0.13357612693015758,1073992.0459821864,4065.254091108435,1078057.300073295,2904,0,324.07035175879395,70,129,43,38.45264401461671,0.5376884422110553,44.38086854460097,8403.06466786958,120.04378096956542,8
4586,32.74776586876673,3,4,195,0.01507537688442211,0.020100502512562814,0.9798994974874372,199,5700,4000,1700,0.7017543859649122,74,40,34,256.69865743974043,0.479386621660491,0.8059746684760876,0.14802219737077868,1070256.6548137348,9446.689281326864,1079703.3440950618,2905,0,324.50251256281405,70,129,40,37.77401583840239,0.5405674204355109,44.33685446009391,8372.39683141331,119.60566902019015,8
4587,33.1332141230224,2,1,196,0.01015228426395939,0.005076142131979695,0.9949238578680203,197,5700,4200,1500,0.7368421052631579,72,42,30,249.26310035518716,0.4796252892019752,0.7964386807597432,0.14433124946376014,1084178.2096735747,8949.12437615456,1093127.3340497292,2906,0,328.16751269035535,74,123,39,37.80392077021918,0.5425126903553299,44.18055555555557,8476.120429610444,114.5421679677087,0
4588,33.08794005554542,5,8,193,0.024875621890547265,0.03980099502487562,0.9601990049751243,201,7300,5700,1600,0.7808219178082192,89,57,32,241.47721793976248,0.47958126036484244,0.7941886087436771,0.14129254449164783,1086021.1815148892,4949.874707174146,1090971.0562220635,2907,0,322.5771144278607,81,120,35,37.601176310179,0.5457607794361525,43.78810975609758,8477.523665908284,104.66078599886771,0
4589,32.58157326366234,0,5,188,0.0,0.025906735751295335,0.9740932642487047,193,5100,3400,1700,0.6666666666666666,68,34,34,292.42742616407406,0.47898450993091535,0.8309140359311282,0.1668556490465602,1061495.9239535995,18382.104185081476,1079878.028138681,2908,1,336.03108808290153,56,137,38,37.27224727949598,0.5368631260794473,44.736842105263165,8316.875280461192,148.51563000823558,8
4590,32.98201302123482,3,1,190,0.015706806282722512,0.005235602094240838,0.9947643979057592,191,6200,4500,1700,0.7258064516129032,79,45,34,241.11194178801293,0.4789577018462386,0.7989013296256449,0.13839303316110466,1076437.4584364144,7508.385163391641,1083945.843599806,2909,0,327.35602094240835,66,125,36,38.3516907036654,0.5358311518324608,44.51181592039802,8426.514614085094,127.67446384977416,8
4591,33.00130780700562,2,3,189,0.010416666666666666,0.015625,0.984375,192,5900,4300,1600,0.7288135593220338,75,43,32,234.70443259770758,0.4793933382417103,0.7927145502853239,0.1333062553389487,1073696.8843912142,6100.2836065936435,1079797.167997808,2910,0,326.5,77,115,39,38.924827234176234,0.5339084201388888,44.911858974359,8418.242259904102,109.32782155719613,8
4592,32.87133768725183,1,1,189,0.005263157894736842,0.005263157894736842,0.9947368421052631,190,7850,6300,1550,0.802547770700637,94,63,31,223.75218159640798,0.4795663928339367,0.7803838376754686,0.12212800893680317,1056587.2198102537,1432.7390958855613,1058019.9589061392,2911,0,329.3421052631579,73,117,38,40.77952661188841,0.5206688596491228,46.45270270270271,8334.438829149503,114.17039491985621,8
4593,32.88683728536997,5,3,191,0.02577319587628866,0.015463917525773196,0.9845360824742269,194,5700,3500,2200,0.6140350877192983,79,35,44,210.58719764395386,0.4801865774620302,0.7795795127179073,0.11744017530486607,1064082.7129662537,316.4393169879413,1064399.1522832417,2912,0,323.41237113402065,61,133,42,40.25789522928912,0.5265786082474226,45.61491935483872,8365.92075500316,137.1462418852977,8
4594,32.78813793043147,1,2,190,0.005208333333333333,0.010416666666666666,0.9895833333333334,192,5350,3500,1850,0.6542056074766355,72,35,37,212.0101865038156,0.48024662321844097,0.7781704592684964,0.11457693367659015,1050667.1368337937,800.427126712435,1051467.563960506,2913,0,326.7447916666667,65,127,42,41.476257273482986,0.5171983506944444,46.84343434343434,8300.532392741792,127.70049834987373,8
4595,32.56434517050853,2,1,191,0.010416666666666666,0.005208333333333333,0.9947916666666666,192,5950,4200,1750,0.7058823529411765,77,42,35,205.99628024952338,0.48046761380162883,0.7710951916920874,0.10976960123350585,1038888.2642321923,-1548.5763946568795,1037339.6878375354,2914,0,327.6302083333333,72,120,43,42.1995631378752,0.5067274305555556,47.40296803652968,8225.656937904421,114.24523524867251,8
4596,32.92846659483545,9,3,197,0.045,0.015,0.985,200,5500,3500,2000,0.6363636363636364,75,35,40,224.47008864585925,0.4818085217755444,0.7892882301144719,0.12236313472262962,1058003.833010778,1998.0428367171426,1060001.8758474952,2915,0,314.995,69,131,42,40.8127262498777,0.51265625,46.502976190476154,8347.268280402028,120.97490261452214,0
4597,32.45355306086565,6,2,201,0.029556650246305417,0.009852216748768473,0.9901477832512315,203,6100,4300,1800,0.7049180327868853,79,43,36,227.81911882670866,0.4820615682257881,0.7983785724257604,0.12563514978304807,1046476.3789729595,981.4653061166582,1047457.8442790761,2916,0,309.4679802955665,76,127,38,40.26431209602953,0.5182163382594417,46.049783549783534,8241.586824385378,108.44193189980761,8
4598,32.709973896640655,1,1,201,0.0049504950495049506,0.0049504950495049506,0.995049504950495,202,5800,3900,1900,0.6724137931034483,77,39,38,230.90880138046418,0.48168758107153997,0.786400347966435,0.1260607379785213,1051468.9759637634,2358.6881857072885,1053827.6641494706,2917,0,311.990099009901,74,128,37,40.589623502775304,0.5158312706270627,46.44444444444444,8293.79560357044,112.0783189671681,8
4599,32.98421830603286,7,6,202,0.03365384615384615,0.028846153846153848,0.9711538461538461,208,7200,5300,1900,0.7361111111111112,91,53,38,227.25103714079452,0.4825706637866964,0.7992387258953992,0.1254668021909754,1063965.145540862,-442.5634388365179,1063522.5821020256,2918,0,303.94711538461536,78,130,32,40.2326783643946,0.5154747596153846,46.00474683544304,8377.834879075843,107.40813947533131,8
4600,32.836176912250686,4,5,201,0.019417475728155338,0.024271844660194174,0.9757281553398058,206,5400,3600,1800,0.6666666666666666,72,36,36,216.68734319990935,0.482128621043492,0.7901278659476814,0.1189339369001931,1057278.8564724,-780.2107139113987,1056498.6457584887,2919,0,307.79611650485435,77,129,44,40.73518576991894,0.5120347896440129,46.233974358974365,8332.706112267479,108.21696249698024,8
4601,32.44232887929793,5,3,203,0.024271844660194174,0.014563106796116505,0.9854368932038835,206,5700,4100,1600,0.7192982456140351,73,41,32,216.40528378574518,0.4827812968663667,0.7927172768744888,0.12038631738751254,1048909.2407437,-1502.0996182736862,1047407.1411254263,2920,0,308.57766990291265,67,139,40,40.207831325301214,0.5159283980582524,45.7107843137255,8249.73436575286,123.13036366795313,0
4602,32.448893948279576,3,6,200,0.014563106796116505,0.02912621359223301,0.970873786407767,206,5850,3700,2150,0.6324786324786325,80,37,43,207.36500564051644,0.4834981056121241,0.7831400316897323,0.11634051557151508,1051828.8908404114,-3427.4992236040953,1048401.3916168073,2921,0,308.8009708737864,73,133,42,40.10301489016658,0.518406148867314,45.38288288288287,8262.04383074998,113.17868261301344,0
4603,32.07413174612431,1,0,201,0.004975124378109453,0.0,1.0,201,6450,4800,1650,0.7441860465116279,81,48,33,207.9200508927991,0.48295294361525704,0.7788084541860643,0.11722499243021742,1041220.472369798,-3351.8772788496544,1037868.5950909484,2922,0,313.09452736318406,74,127,34,39.89652603655658,0.5202632669983416,45.19444444444443,8172.666958533245,110.44144538558439,0
4604,32.01869605655902,3,4,200,0.014705882352941176,0.0196078431372549,0.9803921568627451,204,5800,3700,2100,0.6379310344827587,79,37,42,201.25773638365743,0.4835409019929811,0.7753197019088869,0.11423502501776575,1041524.677104966,-4677.020219627113,1036847.656885339,2923,0,309.47549019607845,78,126,38,39.80336279983458,0.5225183823529411,44.93670886075948,8166.793994172935,104.70248710478121,0
4605,32.11505438183193,3,7,196,0.014778325123152709,0.034482758620689655,0.9655172413793104,203,6850,5000,1850,0.7299270072992701,87,50,37,184.61415326153562,0.48310308247573525,0.7580148340450046,0.1039303174908213,1042081.0931626628,-8973.416271183942,1033107.6768914788,2924,0,311.5911330049261,76,127,46,40.54860779211582,0.5259646962233169,45.25162337662337,8181.2579689431295,107.64813117030434,8
4606,31.882122331755454,5,2,199,0.024875621890547265,0.009950248756218905,0.9900497512437811,201,5800,4000,1800,0.6896551724137931,76,40,36,210.33173713941818,0.48292081260364844,0.7860386465059674,0.11753156509938072,1032198.7327008031,-2579.1694955867056,1029619.5632052164,2925,0,314.1442786069652,66,135,41,40.18579051343146,0.523476368159204,45.53793532338309,8112.79067481098,122.92107083046939,8
4607,31.781708491246984,4,2,201,0.019704433497536946,0.009852216748768473,0.9901477832512315,203,6700,4700,2000,0.7014925373134329,87,47,40,205.51582173468282,0.48269765400185344,0.7831679970188303,0.11701523089235995,1034778.0048021862,-4767.3496060207,1030010.6551961654,2926,0,311.79802955665025,78,125,44,39.57364491293342,0.5301724137931034,44.81803797468354,8110.118729313057,103.9758811450392,7
4608,32.010968684706626,0,1,200,0.0,0.004975124378109453,0.9950248756218906,201,5200,3600,1600,0.6923076923076923,68,36,32,218.51309326563947,0.482799543946932,0.79246458761841,0.12441553086113351,1042242.4683829958,148.72513983683848,1042391.1935228326,2927,1,315.9004975124378,78,123,42,39.24197798790885,0.5308354063018241,44.81803797468355,8168.621795294414,104.72592045249249,8
4609,32.3017286234923,2,5,197,0.009900990099009901,0.024752475247524754,0.9752475247524752,202,6800,5100,1700,0.75,85,51,34,218.02825079655102,0.48275126020064696,0.7926849972604428,0.12518048864150338,1054327.4029514699,-1225.3681135241118,1053102.0348379458,2928,0,315.3217821782178,67,135,43,38.93000429682036,0.5333127062706271,44.50061274509804,8253.071870576408,123.18017717278221,0
4610,31.951216714875343,1,0,198,0.005050505050505051,0.0,1.0,198,5750,4300,1450,0.7478260869565218,72,43,29,230.5681978483767,0.48200810986343984,0.7971816255195008,0.13018235170823722,1037682.636021856,2501.3230652224106,1040183.9590870783,2929,0,320.6111111111111,71,127,35,39.26260217983651,0.5265151515151515,45.138888888888886,8143.122593305028,114.69186751133843,8
4611,31.936675751709547,4,4,198,0.019801980198019802,0.019801980198019802,0.9801980198019802,202,5600,3700,1900,0.6607142857142857,75,37,38,244.5143461227416,0.48255679112687383,0.8120219919941216,0.1375729068294987,1036113.948696338,4668.944934827412,1040782.8936311654,2930,0,315.24257425742576,66,136,44,39.045206705729186,0.5239789603960396,45.27363184079602,8135.113425311091,123.25929432289533,8
4612,32.183270786410105,2,4,196,0.01,0.02,0.98,200,5650,4000,1650,0.7079646017699115,73,40,33,243.23424656920218,0.4826847780569514,0.8089395354266375,0.13772556446519182,1046114.357659442,5240.16752210378,1051354.5251815459,2931,0,318.44,69,131,37,38.82801252869539,0.5261979166666666,45.0297619047619,8205.77621509449,118.92429297238392,0
4613,32.32025490782617,2,3,195,0.010101010101010102,0.015151515151515152,0.9848484848484849,198,6400,4500,1900,0.703125,83,45,38,228.45301974810516,0.48268108325214926,0.7998707790179214,0.12630019278301946,1042977.7406393425,1654.2828758225733,1044632.0235151651,2932,0,322.22727272727275,69,129,42,40.14858637925645,0.5183080808080809,45.95238095238094,8210.883806345339,118.99831603399042,8
4614,31.929837175400568,5,2,198,0.025,0.01,0.99,200,6100,4900,1200,0.8032786885245902,73,49,24,224.87338040503045,0.483053810720268,0.797211102719033,0.12615777782044935,1034989.6126550486,448.32257636678696,1035437.9352314154,2933,0,319.76,64,136,44,39.658993160456525,0.5220833333333333,45.38461538461539,8129.827773121227,127.02855895501918,0
4615,32.34308828633284,5,6,197,0.024630541871921183,0.029556650246305417,0.9704433497536946,203,6750,4700,2050,0.6962962962962963,88,47,41,228.13083609672364,0.4836019932042465,0.8012544883947108,0.1299292854200113,1053147.1467516413,701.0678242663707,1053848.2145759077,2934,0,315.1970443349754,67,136,41,38.985245713028,0.5264265188834154,44.80698529411766,8253.730204687814,123.190003055042,8
4616,32.51622881433949,3,4,196,0.015,0.02,0.98,200,6400,4900,1500,0.765625,79,49,30,253.38519776935325,0.4829679648241206,0.8198999814206986,0.14300631906262645,1055901.7963332133,7109.977097781286,1063011.7734309947,2935,0,318.085,65,135,36,38.697268326417706,0.5253125000000001,45.154671717171716,8286.609006709903,127.48629241092158,8
4617,32.34331568768122,4,3,197,0.02,0.015,0.985,200,4850,3100,1750,0.6391752577319587,66,31,35,251.12905344764516,0.4829731993299833,0.8196520618556702,0.14329128343777342,1053733.577927255,8074.623202174226,1061808.2011294293,2936,0,317.105,56,144,40,38.326442583046955,0.5286458333333333,44.736842105263136,8256.056899223853,147.42958748614024,0
4618,32.595940300640414,1,5,193,0.005050505050505051,0.025252525252525252,0.9747474747474747,198,5500,3300,2200,0.6,77,33,44,244.5103470429412,0.48247545249448803,0.7981550337938201,0.14001434609616875,1063095.085720464,6887.549669831373,1069982.6353902952,2937,0,321.2171717171717,70,128,41,38.356167662377445,0.5304608585858586,44.60093896713616,8324.972546266868,118.92817923238384,8
4619,32.71622238019065,1,2,192,0.005154639175257732,0.010309278350515464,0.9896907216494846,194,6650,5400,1250,0.8120300751879699,79,54,25,270.49031618328,0.4817706942292969,0.8115229386838945,0.1569281874860896,1071148.0034961018,12497.032428950068,1083645.035925052,2938,0,320.96907216494844,69,125,32,37.18548887338143,0.5373711340206185,44.10714285714287,8371.847619788095,121.33112492446516,8
4620,32.44671847499925,0,2,190,0.0,0.010416666666666666,0.9895833333333334,192,5650,4000,1650,0.7079646017699115,73,40,33,269.1862840057951,0.48155779613874344,0.807045870626524,0.15679144220053284,1063560.197484737,13209.163475477568,1076769.3609602146,2939,1,325.234375,74,118,33,37.06604285326824,0.5388997395833333,43.95833333333336,8307.711876202991,112.26637670544582,0
4621,32.27591498261762,0,0,190,0.0,0.0,1.0,190,7200,5400,1800,0.75,90,54,36,255.10759762305446,0.4812993130975587,0.7964883700990892,0.1475366550452584,1055749.0786303964,8665.922228430947,1064415.0008588273,2940,2,327.6421052631579,69,121,39,37.701206267938886,0.5385964912280702,44.226190476190496,8255.333730970751,119.64251784015582,8
4622,31.82656685004391,4,4,190,0.020618556701030927,0.020618556701030927,0.979381443298969,194,6050,4000,2050,0.6611570247933884,81,40,41,247.3871713175282,0.48134392304542134,0.7927774049899328,0.14416700673331972,1043386.7950001317,6774.1015610295035,1050160.8965611611,2941,0,321.8659793814433,76,118,34,37.6047830374754,0.5410760309278351,43.93939393939398,8149.529996450735,107.23065784803599,0
4623,32.237685260079765,2,4,188,0.010416666666666666,0.020833333333333332,0.9791666666666666,192,6700,4900,1800,0.7313432835820896,85,49,36,252.08232569182948,0.48100844422629435,0.8066428281235072,0.14586974272940767,1054674.8628642038,8072.978455903997,1062747.8413201077,2942,0,325.328125,70,122,36,37.75666762259823,0.5404730902777778,44.204812206572775,8246.244755127516,117.80349650182166,8
4624,32.6512338898213,0,1,187,0.0,0.005319148936170213,0.9946808510638298,188,5300,3800,1500,0.7169811320754716,68,38,30,232.26257800823512,0.4801829701900102,0.7885532288846717,0.13267031660986744,1064109.935369681,6530.583374627862,1070640.518744309,2943,1,332.6914893617021,64,124,40,38.765744983575026,0.5379543439716312,44.69551282051283,8336.006524018341,130.25010193778658,8
4625,32.187481728458906,7,2,192,0.03608247422680412,0.010309278350515464,0.9896907216494846,194,5400,3600,1800,0.6666666666666666,72,36,36,208.8668535943682,0.48115696722041207,0.7735945390199883,0.1212085599205122,1053918.4427424183,-174.27418386258523,1053744.1685585557,2944,0,323.2886597938144,74,120,37,38.75226142017189,0.5431164089347079,44.09722222222225,8236.865983984166,111.3089997835698,8
4626,32.61727206539438,2,1,193,0.010309278350515464,0.005154639175257732,0.9948453608247423,194,7000,5000,2000,0.7142857142857143,90,50,40,210.5312831396026,0.4803790974484981,0.7763704929412263,0.12296394186019097,1070009.813077656,-745.8922161585551,1069263.9208614975,2945,0,323.72680412371136,78,116,40,38.46284189574112,0.5456937285223368,43.85548523206754,8354.73532624415,107.11199136210449,0
4627,32.15974619403713,1,7,187,0.005154639175257732,0.03608247422680412,0.9639175257731959,194,5700,3700,2000,0.6491228070175439,77,37,40,222.19231808797574,0.47990057956305754,0.7891715493584515,0.12762286038937434,1049818.9747360754,2152.3423138700764,1051971.3170499455,2946,0,324.6185567010309,67,127,42,38.807953637090314,0.5379617697594501,44.48529411764705,8217.288090020504,122.64609089582841,8
4628,32.17204681049421,1,1,187,0.005319148936170213,0.005319148936170213,0.9946808510638298,188,6400,4900,1500,0.765625,79,49,30,215.59052861156349,0.47919274092615766,0.771439885959067,0.12128920662606453,1043723.8556212885,1003.3955515786747,1044727.2511728673,2947,0,333.56382978723406,72,116,43,39.785236121225715,0.5318040780141844,45.27682648401827,8194.965862073823,113.81897030658087,8
4629,31.915403626130008,2,2,187,0.010582010582010581,0.010582010582010581,0.9894179894179894,189,6150,4400,1750,0.7154471544715447,79,44,35,188.30567902750224,0.479374226049758,0.7437833932302567,0.10337407391955002,1027686.6476270006,-5246.1535982198475,1022440.4940287807,2948,0,332.7566137566138,81,108,40,41.4484469640086,0.5245811287477954,46.22713414634148,8099.2634430792905,99.9909067046826,8
4630,32.19258503028317,4,3,188,0.020942408376963352,0.015706806282722512,0.9842931937172775,191,7150,5500,1650,0.7692307692307693,88,55,33,183.42300502800046,0.47971548635987876,0.7398338069565404,0.10156665723663273,1039363.4189206975,-7221.3676770776265,1032142.0512436199,2949,0,329.4816753926702,90,101,47,41.22961619892789,0.5278141361256545,45.89056776556778,8180.439504203985,90.89377226893316,0
4631,32.354999286830726,2,3,187,0.010526315789473684,0.015789473684210527,0.9842105263157894,190,5750,4100,1650,0.7130434782608696,74,41,33,195.82732431063636,0.4794886521860206,0.7511581042648199,0.10863678228483145,1045200.089361035,-2814.2526262383453,1042385.8367347966,2950,0,329.81052631578945,69,121,45,40.84088314501492,0.5259320175438597,45.81845238095236,8224.043791939763,119.18904046289511,8
4632,32.26015658668419,1,4,184,0.005319148936170213,0.02127659574468085,0.9787234042553191,188,5850,4100,1750,0.7008547008547008,76,41,35,199.20222241522353,0.4794208906967042,0.7550119936813766,0.11008432067302518,1040909.2334241923,-1979.7134738748314,1038929.5199503175,2951,0,333.4095744680851,84,104,42,40.907766092591665,0.5268727836879432,45.96813725490196,8195.107670163934,97.56080559718968,8
4633,32.185071870280595,3,2,185,0.016042780748663103,0.0106951871657754,0.9893048128342246,187,7400,6100,1300,0.8243243243243243,87,61,26,196.59741075356743,0.4796134974028712,0.7497537675849095,0.10876358047115905,1038834.088953966,-3953.5815818220526,1034880.507372144,2952,0,334.44919786096256,78,109,45,40.93059664054525,0.5250111408199644,45.92563291139239,8177.401765142849,104.83848416849807,8
4634,31.709101287538118,5,0,190,0.02631578947368421,0.0,1.0,190,6500,4800,1700,0.7384615384615385,82,48,34,198.81095356572368,0.479948714378539,0.761094887174512,0.10976440659571685,1022832.7087745437,-3829.930766063932,1019002.7780084797,2953,0,329.7157894736842,84,106,41,40.95520119656476,0.5262061403508772,46.00490196078433,8053.956290263705,95.88043202694887,8
4635,31.811742673610404,0,2,188,0.0,0.010526315789473684,0.9894736842105263,190,7100,5000,2100,0.704225352112676,92,50,42,201.81978436206705,0.4801099972152603,0.7655021552903585,0.11196306937683914,1027656.0451073421,-3619.735715612123,1024036.30939173,2954,1,330.7157894736842,66,124,43,40.687886109242164,0.5285087719298245,45.81778606965176,8085.979181760872,122.51483608728594,0
4636,31.599978607135323,4,3,189,0.020833333333333332,0.015625,0.984375,192,5900,4100,1800,0.6949152542372882,77,41,36,183.17829315153014,0.4807527995927865,0.7410382353188867,0.1025642986237112,1023687.825692022,-6796.52227394739,1016891.3034180746,2955,0,326.9270833333333,80,112,40,40.79777783391434,0.5300564236111112,45.46039094650202,8043.446200759017,100.54307750948772,8
4637,31.301325859908697,4,6,187,0.02072538860103627,0.031088082901554404,0.9689119170984456,193,6400,4500,1900,0.703125,83,45,38,183.43761909885052,0.48067789291882557,0.7431164648426298,0.10341179774830593,1016103.2049519476,-7721.689464980864,1008381.5154869667,2956,0,325.9326424870466,81,112,38,40.52414664140655,0.5379965457685665,45.1981707317073,7975.635087627611,98.46463071145199,8
4638,31.554998775353745,3,3,187,0.015789473684210527,0.015789473684210527,0.9842105263157894,190,6750,4800,1950,0.7111111111111111,87,48,39,188.0755136792839,0.48002761533463284,0.7461075009682849,0.10599831946072003,1024256.2231610393,-6222.496937957126,1018033.7262230822,2957,0,332.0,84,106,38,40.416325974379944,0.537390350877193,45.20833333333331,8039.950729636939,95.71369916234451,8
4639,31.237402256350162,3,1,189,0.015789473684210527,0.005263157894736842,0.9947368421052631,190,5550,3800,1750,0.6846846846846847,73,38,35,190.03932003875548,0.47990056158915806,0.7499888837836641,0.10797274007321866,1016407.3304996962,-4918.528405886467,1011488.8020938097,2958,0,332.8,86,104,42,40.05151131136766,0.540186403508772,44.8994252873563,7968.679268124906,92.65906125726634,0
4640,31.446477537999247,1,0,190,0.005263157894736842,0.0,1.0,190,6850,5200,1650,0.7591240875912408,85,52,33,194.3150091156889,0.47992318759862623,0.7531000970670427,0.10883470793139036,1018813.8359086063,-5255.8360376457695,1013557.9998709605,2959,0,333.7842105263158,72,118,44,40.50173309415705,0.5337719298245613,45.4480593607306,8004.761883566919,111.17724838287387,8
4641,31.956254903948132,2,3,189,0.010416666666666666,0.015625,0.984375,192,7200,5600,1600,0.7777777777777778,88,56,32,190.3176153050884,0.4802579852021524,0.7514324714169409,0.10725439756601,1037258.7254069869,-6118.278585229156,1031140.4468217577,2960,0,331.296875,76,116,48,40.361956213939344,0.5358615451388888,45.21103896103898,8142.100985673195,107.13290770622625,0
4642,31.64715465175459,2,1,190,0.010471204188481676,0.005235602094240838,0.9947643979057592,191,5750,4000,1750,0.6956521739130435,75,40,35,186.66358147700373,0.4804514558647928,0.7465436474377845,0.1060326117462159,1029675.4757616795,-5509.417587057278,1024166.0581746222,2961,0,333.6806282722513,80,111,44,40.14575771324864,0.5386671029668412,44.90740740740742,8072.954728294838,100.91193410368547,0
4643,32.163055469252484,6,0,196,0.030612244897959183,0.0,1.0,196,6250,4300,1950,0.688,82,43,39,178.85134907237511,0.48075996424210715,0.7413957222658349,0.10314652566734403,1051189.5568222597,-7848.665926308781,1043340.8908959508,2962,0,325.7908163265306,76,120,48,39.759048097782994,0.542251275510204,44.33170995671001,8223.073394391391,108.19833413672883,0
4644,31.7312180891411,2,2,196,0.010101010101010102,0.010101010101010102,0.98989898989899,198,6250,4300,1950,0.688,82,43,39,178.12802497001604,0.4807732571057444,0.7441892802624299,0.10354731918817828,1039501.1413571237,-8817.142947195309,1030683.9984099284,2963,0,323.489898989899,80,118,41,39.473430801179,0.5445075757575757,44.03292181069961,8122.147181664986,101.52683977081233,0
4645,31.848425868584965,4,8,192,0.02,0.04,0.96,200,6550,4700,1850,0.7175572519083969,84,47,37,199.14792171595576,0.4808704983249581,0.7725386619837993,0.11403043341069673,1038693.8487636751,-5179.255743913218,1033514.5930197618,2964,0,321.18,71,129,42,39.51742149587418,0.5372395833333333,44.603587962962976,8133.973695864185,114.56300980090401,8
4646,31.83611926261868,4,2,194,0.02040816326530612,0.01020408163265306,0.9897959183673469,196,5350,3200,2150,0.5981308411214953,75,32,43,223.24572362618272,0.4805888060352346,0.7911217350376267,0.1272533600403896,1036898.1559357683,1746.6158297069646,1038644.7717654753,2965,0,326.3673469387755,62,134,44,39.077346246868785,0.5345982142857143,44.775132275132265,8125.369327674949,131.05434399475723,8
4647,31.876290130178575,0,7,187,0.0,0.03608247422680412,0.9639175257731959,194,5950,4100,1850,0.6890756302521008,78,41,37,227.63988043349914,0.4801598694870288,0.791973983316675,0.1300905939657669,1038999.059418785,2553.524331322072,1041552.5837501071,2966,1,330.319587628866,63,131,43,38.865581373111524,0.5363509450171822,44.677734375,8138.726615757016,129.18613675804787,0
4648,31.390847625487122,2,4,185,0.010582010582010581,0.021164021164021163,0.9788359788359788,189,6900,5400,1500,0.782608695652174,84,54,30,217.94641684750587,0.4796427633307066,0.777560031928763,0.12362227550335657,1020890.4857407301,-200.11532781959977,1020690.3704129105,2967,0,338.7936507936508,78,111,41,39.40464188467239,0.5372023809523809,44.96308016877637,8005.825089295519,102.6387831960964,8
4649,31.77848663930477,2,0,187,0.0106951871657754,0.0,1.0,187,6700,4900,1800,0.7313432835820896,85,49,36,213.78335820198,0.478996559523125,0.7704050422825899,0.12234748934381082,1036254.0171955515,206.77274927146755,1036460.789944823,2968,0,343.01604278074865,67,120,42,39.163629956211395,0.54049688057041,44.623161764705884,8115.489441848192,121.12670808728645,0
4650,31.86599995645016,0,4,183,0.0,0.0213903743315508,0.9786096256684492,187,5250,3300,1950,0.6285714285714286,72,33,39,209.93324669187152,0.47870306480363406,0.7657085561497332,0.12071161684782615,1040562.5911705014,1039.7366301059897,1041602.3278006074,2969,1,344.01604278074865,71,116,42,39.07948369565218,0.5420008912655971,44.44444444444444,8143.533322203924,114.69765242540738,0
4651,31.617545903878504,2,1,184,0.010810810810810811,0.005405405405405406,0.9945945945945946,185,5650,4300,1350,0.7610619469026548,70,43,27,207.40643046518693,0.47853872894633764,0.7598848242916028,0.12003151765647728,1034421.9150432931,259.1513988185643,1034681.0664421117,2970,0,348.3783783783784,73,112,43,38.89500330178294,0.5435247747747748,44.20045045045046,8087.75400007435,110.79115068595,0
4652,31.636608569920725,1,2,183,0.005405405405405406,0.010810810810810811,0.9891891891891892,185,5400,4000,1400,0.7407407407407407,68,40,28,207.86116352962023,0.4786354289071681,0.7612067006765808,0.12081566227561988,1036362.0366778915,683.8837563588531,1037045.9204342504,2971,0,348.7567567567568,75,110,41,38.717369477911674,0.5457207207207206,44.03782894736843,8097.77501429922,107.9703335239896,0
4653,31.97319059437503,2,3,182,0.010810810810810811,0.016216216216216217,0.9837837837837837,185,6000,4300,1700,0.7166666666666667,77,43,34,206.09750509171658,0.4788973756365061,0.7606176016469373,0.12054408560903275,1049312.7101135373,252.14632308571527,1049564.856436623,2972,0,342.72972972972974,78,107,45,38.52258106021618,0.5479166666666666,43.80274261603377,8191.443740093739,105.01850948838127,0
4654,31.91480428125753,3,2,183,0.016216216216216217,0.010810810810810811,0.9891891891891892,185,6900,5600,1300,0.8115942028985508,82,56,26,201.6489813750841,0.47914096161378766,0.7555275614597641,0.11897289901129926,1050051.3582519577,-1551.6426433939769,1048499.7156085637,2973,0,343.34594594594597,68,117,47,38.3055261299435,0.5510135135135135,43.478260869565204,8186.841098235602,120.3947220328765,0
4655,32.10207040285225,1,2,182,0.005434782608695652,0.010869565217391304,0.9891304347826086,184,6200,5100,1100,0.8225806451612904,73,51,22,203.6214919625268,0.4790045636334838,0.7574190845753606,0.12094625968376538,1058264.9887888995,97.09918178027556,1058362.0879706799,2974,0,344.1902173913044,69,115,46,38.00076064908722,0.5529891304347826,43.22916666666665,8242.875369065667,119.46196187051692,0
4656,32.27172529847294,1,1,182,0.00546448087431694,0.00546448087431694,0.994535519125683,183,6750,5200,1550,0.7703703703703704,83,52,31,192.64603008669673,0.47876508737164475,0.7435019793153479,0.11429300581372155,1063498.1453562207,-2374.260858512225,1061123.8844977084,2975,0,346.8633879781421,71,112,45,38.32681741335586,0.548155737704918,43.27256944444442,8285.037115471621,116.69066359819185,8
4657,32.60848524368819,2,4,180,0.010869565217391304,0.021739130434782608,0.9782608695652174,184,6300,4100,2200,0.6507936507936508,85,41,44,200.09332728664083,0.47915367367545736,0.7520473622728354,0.11409329282452928,1062157.220935916,-593.8855122799064,1061563.3354236363,2976,0,345.8478260869565,71,113,44,39.65560405093904,0.5336843297101449,44.7627314814815,8322.900704125443,117.22395357923159,8
4658,32.92592703088409,1,2,179,0.0055248618784530384,0.011049723756906077,0.988950276243094,181,5650,4200,1450,0.7433628318584071,71,42,29,229.32322194544767,0.4789057704112953,0.7798046106390109,0.1289692405634895,1068066.5806057828,7136.493903355066,1075203.0745091378,2977,0,351.1988950276243,70,111,38,39.44941247623983,0.5306744935543278,45.29049295774648,8386.546642945701,119.80780918493859,8
4659,32.7316642334571,3,4,178,0.016483516483516484,0.02197802197802198,0.978021978021978,182,6900,5500,1400,0.7971014492753623,83,55,28,228.3387522955353,0.47853044745309936,0.7805312936069044,0.12983034140953023,1065267.046072163,5348.349632333704,1070615.3957044967,2978,0,350.1263736263736,78,104,40,39.04519182731234,0.5341117216117216,44.8707805907173,8350.803945848656,107.06158904934175,0
4660,32.64570312957629,1,2,177,0.00558659217877095,0.0111731843575419,0.9888268156424581,179,6750,5200,1550,0.7703703703703704,83,52,31,225.81680154426877,0.478349339861486,0.7747702639821268,0.1291370177076281,1064294.536040774,5517.1176059539175,1069811.653646728,2979,0,351.94972067039106,66,113,37,38.88554858743304,0.5367202048417132,44.651741293532346,8336.023448385606,126.30338558160008,0
4661,32.7801160025136,3,3,177,0.016666666666666666,0.016666666666666666,0.9833333333333333,180,6100,4300,1800,0.7049180327868853,79,43,36,217.8187063037264,0.47820582453962346,0.7681938438691402,0.12056878157135355,1058214.7764518594,3999.7947196460864,1062214.5711715054,2980,0,350.85,72,108,43,40.37000898523049,0.5247685185185185,45.90468036529679,8329.274053321313,115.6843618516849,8
4662,32.920467302780274,3,0,180,0.016666666666666666,0.0,1.0,180,6100,4500,1600,0.7377049180327869,77,45,32,219.10294923131772,0.47830863335402446,0.7605115149713195,0.11648692066720247,1049489.5764136787,3889.2522759530666,1053378.8286896318,2981,0,351.52222222222224,73,107,37,41.96189653250084,0.5129050925925926,47.4943693693694,8312.603356943666,113.871278862242,8
4663,32.7650759043565,5,1,184,0.02702702702702703,0.005405405405405406,0.9945945945945946,185,5500,3700,1800,0.6727272727272727,73,37,36,225.11449027049267,0.4796599588719154,0.7697120357481981,0.1213715033804482,1049152.1464448285,4735.870132624401,1053888.016577453,2982,0,342.9945945945946,83,102,36,41.240189232452906,0.5166103603603603,46.93700396825398,8291.628273564069,99.89913582607312,0
4664,32.795304768899854,7,2,189,0.03664921465968586,0.010471204188481676,0.9895287958115183,191,5800,4000,1800,0.6896551724137931,76,40,36,212.16162210447777,0.48049164140718287,0.7641705162950343,0.11605437340559267,1054854.477479549,759.9274052468782,1055614.4048847957,2983,0,333.18324607329845,79,112,41,40.98607260810789,0.5206151832460733,46.36718750000003,8317.965385330805,105.29070108013677,0
4665,32.73107294462843,7,7,189,0.03571428571428571,0.03571428571428571,0.9642857142857143,196,6000,3700,2300,0.6166666666666667,83,37,46,201.92713819459138,0.48180762689691264,0.7587118218585829,0.11164485348542322,1056262.3759808776,-2542.392247112214,1053719.9837337653,2984,0,325.06632653061223,89,107,36,40.81909643128324,0.5243941326530612,45.94907407407409,8315.35938813192,93.4310043610328,0
4666,32.93194906777474,3,3,189,0.015625,0.015625,0.984375,192,6700,4700,2000,0.7014925373134329,87,47,40,213.65224402042296,0.4813305564645143,0.7709614071038247,0.11847988077496285,1063713.3895936713,352.9505362520631,1064066.3401299233,2985,0,332.578125,86,106,43,40.40300546448093,0.5282660590277778,45.833333333333364,8370.203721392825,97.32795024875378,8
4667,33.01353718522269,0,5,184,0.0,0.026455026455026454,0.9735449735449735,189,8000,6300,1700,0.7875,97,63,34,218.66127121163476,0.48034049120042027,0.7686757769754644,0.12215437933101018,1068744.733390697,938.6164007895841,1069683.3497914865,2986,1,337.1798941798942,72,117,39,39.98406422910123,0.5308090828924162,45.54794520547943,8400.362372815169,116.6716996224329,0
4668,33.17463139892426,3,5,182,0.016042780748663103,0.026737967914438502,0.9732620320855615,187,5500,4100,1400,0.7454545454545455,69,41,28,209.30406411075364,0.4807790907174209,0.7542202364854869,0.11778459698676408,1076338.1822337254,2156.391179819466,1078494.5734135448,2987,0,339.0053475935829,78,109,42,39.934671394309554,0.5331439393939394,45.26635021097043,8450.694936653628,108.34224277761062,0
4669,33.470296021514955,3,3,182,0.016216216216216217,0.016216216216216217,0.9837837837837837,185,5300,3700,1600,0.6981132075471698,69,37,32,207.6296186703534,0.48094276341558945,0.7510850581867874,0.11767995039784881,1088267.2693656345,2891.3036299623063,1091158.5729955968,2988,0,339.72972972972974,82,103,35,39.6977582558197,0.5360923423423423,44.99246987951805,8535.177520847852,104.08753074204698,0
4670,33.769892919962544,1,1,182,0.00546448087431694,0.00546448087431694,0.994535519125683,183,6100,4800,1300,0.7868852459016393,74,48,26,214.27735732795338,0.4805628115054345,0.7587676666609544,0.1219662589018585,1099409.982973411,4415.733154302382,1103825.7161277134,2989,0,344.0382513661202,81,102,38,39.36205630507295,0.5376821493624773,44.82977642276422,8617.071126566128,106.38359415513739,0
4671,33.249693274611545,2,0,184,0.010869565217391304,0.0,1.0,184,5950,4300,1650,0.7226890756302521,76,43,33,235.3330630275802,0.4808520432406747,0.7784767179313326,0.13046019927937944,1073869.285763245,7793.389661980926,1081662.675425226,2990,0,342.92391304347825,81,103,38,39.86495351626931,0.5237771739130435,45.84603658536586,8450.541328063442,104.32767071683261,8
4672,33.545874589628305,3,0,187,0.016042780748663103,0.0,1.0,187,6600,4800,1800,0.7272727272727273,84,48,36,218.3109738947276,0.4811157111916125,0.77476920551992,0.12229167735363752,1086876.5201858939,3455.4143250192983,1090331.9345109132,2991,0,338.4064171122995,71,116,39,39.885443307757896,0.530581550802139,45.44270833333336,8539.34698212549,120.2724927059928,7
4673,33.08490220625916,6,2,191,0.031088082901554404,0.010362694300518135,0.9896373056994818,193,7000,5000,2000,0.7142857142857143,90,50,40,215.2015974326227,0.4817449715745538,0.7796240589292815,0.12280944350280923,1077941.1724914855,794.9324517126834,1078736.1049431982,2992,0,328.85492227979273,68,125,44,39.2378565655371,0.5349740932642487,44.731280193236735,8445.54063112378,124.19912692829088,0
4674,33.46507806475154,4,4,191,0.020512820512820513,0.020512820512820513,0.9794871794871794,195,7150,5000,2150,0.6993006993006993,93,50,43,209.75921992567694,0.4816525685082386,0.77316998731919,0.11996296710035122,1091030.9379769096,-379.2403070366645,1090651.697669873,2993,0,324.06666666666666,72,123,37,39.29274937133275,0.5354166666666667,44.648972602739725,8545.342065763825,118.68530646894202,8
4675,33.666208959850564,3,6,188,0.015463917525773196,0.030927835051546393,0.9690721649484536,194,5600,4300,1300,0.7678571428571429,69,43,26,214.07746772178137,0.48173619642825344,0.7800336629497147,0.12197437114380641,1096361.8667616332,2541.274428611382,1098903.1411902446,2994,0,326.52061855670104,79,115,44,39.328231292517,0.5352233676975945,44.791666666666686,8591.89707829525,108.75819086449683,8
4676,33.85991600923333,0,5,183,0.0,0.026595744680851064,0.973404255319149,188,5750,4400,1350,0.7652173913043478,71,44,27,212.66822256033495,0.4805711210983426,0.7720091272920324,0.12175839994937902,1104259.1144586625,3618.164623594845,1107877.2790822573,2995,1,337.281914893617,67,121,43,39.17646353166988,0.5374556737588653,44.60784313725492,8647.556980789526,129.06801463864966,0
4677,34.20653681256669,2,4,181,0.010810810810810811,0.021621621621621623,0.9783783783783784,185,5650,4000,1650,0.7079646017699115,73,40,33,212.0550459418081,0.48037113200156684,0.7688682887948484,0.1224215765392441,1118316.898870819,4778.948273510481,1123095.8471443295,2996,0,339.5945945945946,70,115,45,38.87044102740646,0.5401463963963964,44.29284037558686,8746.856368929373,124.95509098470534,0
4678,34.38917472804353,4,2,183,0.021621621621621623,0.010810810810810811,0.9891891891891892,185,5950,4200,1750,0.7058823529411765,77,42,35,223.45630898797663,0.4803172737955346,0.7781575993965406,0.12674027718275507,1118382.551560436,7031.927401649772,1125414.4789620857,2997,0,339.4108108108108,77,108,36,39.26636600862266,0.5368806306306306,44.96527777777776,8770.433624217985,113.90173537945435,8
4679,34.1069652010471,2,3,182,0.010810810810810811,0.016216216216216217,0.9837837837837837,185,5200,3600,1600,0.6923076923076923,68,36,32,239.13667045345204,0.48034420289855073,0.7881922134809742,0.13341266071018867,1103689.400471817,10586.521688719335,1114275.9221605363,2998,0,340.25945945945944,66,119,37,39.51649045611032,0.5271959459459459,45.60012437810945,8676.807704986528,131.46678340888678,8
4680,33.72785639904996,3,4,181,0.016216216216216217,0.021621621621621623,0.9783783783783784,185,6400,4700,1700,0.734375,81,47,34,209.72192207812924,0.4800026929103016,0.761994802373352,0.11801511709840358,1094274.4080692611,2498.666428238779,1096773.0744975,2999,0,341.1189189189189,69,116,45,39.925565681349106,0.5302364864864865,45.26785714285717,8591.569134508045,124.51549470301515,8
4681,34.01704309800193,2,3,180,0.01092896174863388,0.01639344262295082,0.9836065573770492,183,5250,3600,1650,0.6857142857142857,69,36,33,231.59867345750408,0.48020001401148943,0.7818226330206168,0.12692710886178551,1094792.5507639726,8860.5004936183,1103653.0512575908,3000,0,344.25136612021856,67,116,39,40.417069194541696,0.5223702185792349,46.29289215686272,8630.365621769366,128.81142719058755,8
4682,33.72331270088674,6,3,183,0.03225806451612903,0.016129032258064516,0.9838709677419355,186,5800,4200,1600,0.7241379310344828,74,42,32,214.4499155991497,0.4812851157609222,0.7712614542784433,0.12002458626989057,1092338.0540073134,3850.360697521582,1096188.414704835,3001,0,339.19354838709677,69,117,43,40.01792952915497,0.5326500896057348,45.476190476190474,8583.38601839236,124.39689881728059,8
4683,33.44260580560729,2,1,184,0.010810810810810811,0.005405405405405406,0.9945945945945946,185,5550,3500,2050,0.6306306306306306,76,35,41,200.24426221657285,0.4801116333725029,0.7476277234554085,0.11281176750043691,1085396.9207313175,918.901120796168,1086315.8218521136,3002,0,342.0162162162162,81,104,45,40.12182555511234,0.5391891891891891,45.22357723577233,8520.387475066744,105.18996882798449,8
4684,33.28526097006266,2,2,184,0.010752688172043012,0.010752688172043012,0.989247311827957,186,4700,2700,2000,0.574468085106383,67,27,40,206.4106764988286,0.4803139833381769,0.760983775559009,0.11586234480315868,1079100.9877817056,2647.5929797151866,1081748.5807614208,3003,0,341.11290322580646,70,116,44,40.107887762157205,0.5356742831541219,45.363849765258216,8475.63071297546,121.08043875679229,8
4685,33.070540560109556,5,4,185,0.026455026455026454,0.021164021164021163,0.9788359788359788,189,6300,4600,1700,0.7301587301587301,80,46,34,211.6542988814481,0.4807614732260122,0.7673810621528474,0.118185092748908,1070439.1993719575,1212.6116476577304,1071651.8110196153,3004,0,336.41269841269843,73,116,41,40.18067081604425,0.5362654320987654,45.56587837837836,8414.273938963635,115.26402656114568,8
4686,33.2858600625585,2,4,183,0.0106951871657754,0.0213903743315508,0.9786096256684492,187,6350,4600,1750,0.7244094488188977,81,46,35,225.54196960430735,0.4801346002721714,0.7786720455665264,0.12337139070433623,1070627.3056475203,4544.278245578801,1075171.583893099,3005,0,340.5080213903743,75,112,40,40.647403854814016,0.5279634581105169,46.367872807017534,8442.363493114626,112.56484657486168,8
4687,33.42314387138179,7,2,188,0.03684210526315789,0.010526315789473684,0.9894736842105263,190,5400,4100,1300,0.7592592592592593,67,41,26,221.53625820390243,0.48105854915065444,0.7846780842647954,0.12290509902335331,1079721.8829799918,4439.50917125193,1084161.3921512438,3006,0,335.66315789473686,61,129,43,40.1854468239804,0.527905701754386,45.81653225806452,8495.610612065453,139.2723051158271,8
4688,33.17458683012886,5,6,187,0.025906735751295335,0.031088082901554404,0.9689119170984456,193,6050,4700,1350,0.7768595041322314,74,47,27,245.32446960223666,0.4814481235607369,0.7930301575952283,0.13466298709414137,1068201.8091076082,7761.208449494439,1075963.0175571025,3007,0,330.72020725388603,75,118,41,40.00523224412633,0.5225064766839378,46.23081140350875,8418.6879819056,112.24917309207466,8
4689,32.883315371417815,4,4,187,0.020942408376963352,0.020942408376963352,0.9790575916230366,191,6600,4600,2000,0.696969696969697,86,46,40,239.18301531846237,0.481415908882153,0.787271478843018,0.13263785394932945,1062142.504314635,6009.289375975618,1068151.7936906107,3008,0,334.5602094240838,65,126,45,39.754098360655725,0.5267233856893543,45.83333333333334,8357.842656902047,128.58219472156995,0
4690,32.407612019158684,2,4,185,0.010582010582010581,0.021164021164021163,0.9788359788359788,189,5000,3100,1900,0.62,69,31,38,262.0052237492351,0.4812598502758077,0.8113982184620794,0.14428303382497146,1044540.0199071624,11934.98832616122,1056475.0082333237,3009,0,337.78306878306876,68,121,33,39.45289273397551,0.5222663139329806,46.10507246376811,8228.128305226595,121.00188684156758,8
4691,32.27332629753423,4,1,188,0.021164021164021163,0.005291005291005291,0.9947089947089947,189,6100,4600,1500,0.7540983606557377,76,46,30,220.47322796298184,0.48112616796127433,0.7754137686241445,0.121137517457612,1039488.053210228,1935.8573040430947,1041423.9105142711,3010,0,336.9259259259259,80,109,38,40.59765994460207,0.5246913580246914,46.19341563786009,8191.182713582016,102.3897839197752,6
4692,31.843863125373264,5,3,190,0.025906735751295335,0.015544041450777202,0.9844559585492227,193,5650,3600,2050,0.6371681415929203,77,36,41,242.07630389195992,0.4816302802964882,0.8009451350078987,0.13325347331324724,1026239.5685660077,5435.656333227736,1031675.2248992354,3011,0,330.89637305699483,75,118,36,39.97535721355432,0.5204555267702936,46.12116228070175,8084.482958762179,107.79310611682905,8
4693,32.10017492061513,2,4,188,0.010416666666666666,0.020833333333333332,0.9791666666666666,192,6350,4400,1950,0.6929133858267716,83,44,39,241.87046492878216,0.48162028704915644,0.80114412568306,0.1341281669150522,1036846.795829941,5406.523313461357,1042253.3191434024,3012,0,333.5520833333333,81,111,40,39.68579234972677,0.5232747395833333,45.83333333333334,8158.794458989701,100.72585751839136,0
4694,32.26396170275844,2,2,188,0.010526315789473684,0.010526315789473684,0.9894736842105263,190,5300,3400,1900,0.6415094339622641,72,34,38,236.49657043688444,0.4818295739348371,0.7946957007258513,0.1319518248138504,1044079.4580750605,6084.242219670514,1050163.700294731,3013,0,336.27894736842103,65,125,40,39.58003753334577,0.5252192982456141,45.59659090909091,8208.061847960274,126.27787458400422,0
4695,31.890536427214617,2,3,187,0.010526315789473684,0.015789473684210527,0.9842105263157894,190,5950,4200,1750,0.7058823529411765,77,42,35,236.3477396861871,0.4823604149262044,0.7942384473365891,0.13291976380602186,1034480.0972057763,4949.4065449864875,1039429.5037507628,3014,0,333.67894736842106,70,120,43,39.2704913311445,0.528234649122807,45.29049295774648,8122.822812688867,116.04032589555524,0
4696,31.470564085013855,4,3,188,0.020942408376963352,0.015706806282722512,0.9842931937172775,191,5550,3400,2150,0.6126126126126126,77,34,43,226.26310793329878,0.48289014420868925,0.7866683394481646,0.12692989431930324,1020084.1619800965,2411.4825686303057,1022495.6445487267,3015,0,329.86387434554973,69,122,40,39.625949736995885,0.5284140488656195,45.386904761904766,8012.817730574224,116.12779319672788,7
4697,31.11448481335017,4,8,184,0.020833333333333332,0.041666666666666664,0.9583333333333334,192,6200,4300,1900,0.6935483870967742,81,43,38,223.31056371753758,0.48290589550610824,0.7854475229826361,0.12637054443899937,1011196.4904443396,562.1716620641164,1011758.6621064037,3016,0,329.0625,75,117,37,39.35882703438884,0.5311414930555556,45.05208333333333,7932.573081320253,105.76764108427004,0
4698,30.679188794413054,3,4,183,0.016042780748663103,0.0213903743315508,0.9786096256684492,187,5850,4400,1450,0.7521367521367521,73,44,29,221.27949952010928,0.4818775995246583,0.7781287416417819,0.12567081982205525,998122.0363056097,922.7889307395008,999044.8252363493,3017,0,338.39572192513367,75,112,41,39.27051430157796,0.5335895721925134,44.91502192982456,7825.800200833623,104.34400267778165,0
4699,30.686484440718715,1,3,181,0.005434782608695652,0.016304347826086956,0.9836956521739131,184,6650,4700,1950,0.706766917293233,86,47,39,219.15784305077273,0.48202450601884855,0.7715309159893275,0.12531561045844383,1000389.549286398,398.64316642832546,1000788.1924528263,3018,0,343.95652173913044,68,116,40,39.05972862717276,0.5369678442028986,44.655797101449274,7835.615909274093,115.229645724619,8
4700,30.566161330297135,0,3,178,0.0,0.016574585635359115,0.9834254143646409,181,5100,3900,1200,0.7647058823529411,63,39,24,208.81850021031377,0.48150194393288315,0.7560203979271922,0.11939149729501679,996437.1045315291,314.90034443642253,996752.0048759655,3019,1,350.64088397790056,70,111,40,39.32764498582702,0.5357965009208103,44.65962441314555,7804.7751143264795,111.49678734752113,8
4701,30.28184058833765,2,1,179,0.011111111111111112,0.005555555555555556,0.9944444444444445,180,5600,4200,1400,0.75,70,42,28,204.8424424503295,0.4814368663356094,0.7483195951362505,0.11788666331444175,989087.1390336336,-1078.5949288283136,988008.5441048053,3020,0,353.4111111111111,73,107,43,39.176063868847685,0.5379050925925926,44.41159909909911,7739.687212309229,106.02311249738669,0
4702,30.030443113721127,2,3,178,0.011049723756906077,0.016574585635359115,0.9834254143646409,181,5650,4500,1150,0.7964601769911505,68,45,23,207.61177492545002,0.4813510333537958,0.7559870550161827,0.11809352872777237,977474.0714576755,-1262.9746162133943,976211.0968414622,3021,0,352.0718232044199,81,100,41,39.55807609327025,0.5325161141804788,44.85518292682925,7662.111914876596,94.59397425773575,8
4703,30.293002910169974,2,3,177,0.011111111111111112,0.016666666666666666,0.9833333333333333,180,5600,4300,1300,0.7678571428571429,69,43,26,205.65141774909742,0.48141294227188086,0.7534392294287731,0.11771700850899536,987872.7960400446,-968.5117877198386,986904.2842523248,3022,0,353.9555555555556,70,110,42,39.36359414794816,0.5353009259259259,44.61561032863851,7736.360059526564,110.51942942180806,0
4704,29.953807179408333,1,2,176,0.0056179775280898875,0.011235955056179775,0.9887640449438202,178,4850,3100,1750,0.6391752577319587,66,31,35,220.9655204913712,0.48107569457669436,0.7650727357822116,0.12258450269811419,967636.7414927583,2312.8712461042937,969949.6127388625,3023,0,357.9943820224719,66,112,40,40.201235549574896,0.5255735018726592,45.81778606965174,7613.725024504766,115.35947006825404,8
4705,30.16510145128941,4,2,178,0.022222222222222223,0.011111111111111112,0.9888888888888889,180,5900,3800,2100,0.6440677966101694,80,38,42,213.9166300529277,0.4814905338299193,0.761874783047745,0.12028113293138926,978451.7052768851,-38.58170752564092,978413.1235693594,3024,0,354.5777777777778,71,109,40,39.84953374988166,0.5291666666666667,45.29803240740741,7683.110692273593,108.21282665174074,0
4706,29.788701839901513,4,1,181,0.02197802197802198,0.005494505494505495,0.9945054945054945,182,6400,5200,1200,0.8125,76,52,24,213.05933365472896,0.481948702770526,0.7632053250593978,0.12126835955547999,969787.6382379299,-1475.538402086614,968312.0998358433,3025,0,351.3131868131868,78,104,40,39.39461468237566,0.5332532051282051,44.83122362869199,7601.146598177408,97.45059741253087,0
4707,29.402659327879277,3,1,183,0.016304347826086956,0.005434782608695652,0.9945652173913043,184,6050,4700,1350,0.7768595041322314,74,47,27,206.8655562680991,0.48225404886354634,0.7596337207996271,0.11896306122925142,960160.6228682135,-3125.167728728431,957035.4551394851,3026,0,346.8804347826087,70,114,45,39.15288860822474,0.5358922101449275,44.439553990610335,7514.15673169498,107.34509616707115,0
4708,29.992498617457024,1,0,184,0.005434782608695652,0.0,1.0,184,5250,3900,1350,0.7428571428571429,66,39,27,211.33268834359342,0.48209194583036347,0.7643243154762627,0.12242273891154407,981536.8295023595,-563.8366226037724,980972.9928797557,3027,0,347.58152173913044,72,112,39,38.75715786342424,0.5381567028985508,44.16381278538813,7673.166491329729,106.57175682402402,0
4709,29.938784491445453,1,4,181,0.005405405405405406,0.021621621621621623,0.9783783783783784,185,5650,3600,2050,0.6371681415929203,77,36,41,212.77694407484316,0.4820297199373286,0.7681855214972988,0.12400562692070044,981517.2644383173,-881.1511832229562,980636.1132550943,3028,0,346.6972972972973,77,108,40,38.48853482145965,0.5400337837837839,43.93696581196581,7666.215996781183,99.56124671144394,0
4710,29.81711897693608,3,2,182,0.016304347826086956,0.010869565217391304,0.9891304347826086,184,5900,4100,1800,0.6949152542372882,77,41,36,210.15580424760404,0.4818815831155461,0.7647142673583787,0.12340385294973177,979680.2608741076,-1522.9013740999471,978157.3595000077,3029,0,341.25,65,119,44,38.26807043467552,0.542572463768116,43.655303030303024,7643.460328652069,117.59169736387798,0
4711,29.951759884901268,4,2,184,0.021505376344086023,0.010752688172043012,0.989247311827957,186,5450,3300,2150,0.6055045871559633,76,33,43,204.67780511321257,0.4817688656398334,0.7571859295264494,0.12147867322873046,987156.1265546301,-2240.2101425479323,984915.9164120822,3030,0,336.51612903225805,71,115,44,38.00316503249555,0.545586917562724,43.25810185185182,7689.871685727041,108.30805191164846,0
4712,29.918431356352166,1,1,184,0.005405405405405406,0.005405405405405406,0.9945945945945946,185,5400,4200,1200,0.7777777777777778,66,42,24,204.18679115976676,0.4816992264003133,0.7546645161580992,0.12139906443681187,986554.0204273863,-2111.740052633291,984442.2803747529,3031,0,339.1189189189189,72,113,37,37.94984349243391,0.5469594594594595,43.1934931506849,7683.247847035753,106.71177565327434,0
4713,30.032657611286155,1,4,181,0.005405405405405406,0.021621621621621623,0.9783783783783784,185,5150,3200,1950,0.6213592233009708,71,32,39,201.4410266753973,0.48150460242851545,0.7518040470223217,0.12038326756179064,991783.0799231351,-2192.8396281994683,989590.2402949356,3032,0,339.72972972972974,73,112,40,37.82698645268485,0.5488175675675675,43.00394144144142,7718.274634139181,105.72978950875591,0
4714,30.308544413503046,1,3,179,0.005494505494505495,0.016483516483516484,0.9835164835164835,182,6300,4500,1800,0.7142857142857143,81,45,36,216.85511792352364,0.48105571914273576,0.7700453736922068,0.12566194952676574,991973.0290394087,322.88563785915903,992295.9146772678,3033,0,346.1373626373626,69,113,39,38.60358624634056,0.5396634615384616,44.151785714285715,7754.386965794017,112.38241979411619,8
4715,30.103504554674316,2,0,181,0.011049723756906077,0.0,1.0,181,4850,3100,1750,0.6391752577319587,66,31,35,229.05758824594045,0.4814968283200327,0.7766970279399334,0.13073641792713772,980848.2724196379,3884.1479431278885,984732.4203627658,3034,0,345.1325966850829,62,119,43,38.87827363602996,0.535451197053407,44.7255291005291,7684.6561974143015,123.94606770023067,8
4716,30.523900506837712,1,3,179,0.005494505494505495,0.016483516483516484,0.9835164835164835,182,5800,4200,1600,0.7241379310344828,74,42,32,226.48237626195314,0.48162237164308985,0.7758881361557795,0.1284412549559934,992643.0317941718,2763.230524122526,995406.2623182943,3035,0,344.2307692307692,75,107,38,39.19386297271638,0.5337110805860805,44.969846491228054,7784.515031945264,103.79353375927019,8
4717,31.010608948273358,2,4,177,0.011049723756906077,0.022099447513812154,0.9779005524861879,181,6750,5100,1650,0.7555555555555555,84,51,33,247.7358547304399,0.4813791692244731,0.7960975925293907,0.14023542567222974,1007912.7965008132,6989.227626975458,1014902.0241277887,3036,0,346.48618784530385,66,115,35,38.724160009756666,0.5297536832412524,45.04042288557215,7906.451743512691,119.79472338655592,8
4718,31.498430893996034,4,0,181,0.022099447513812154,0.0,1.0,181,6650,5100,1550,0.7669172932330827,82,51,31,245.2213749456595,0.48117710251688156,0.7965043114847961,0.1408355993267974,1028199.2595165805,7577.287227353081,1035776.5467439336,3037,0,347.11049723756906,61,120,37,38.223577503068576,0.5336671270718232,44.48924731182797,8048.187786221314,131.9375046921527,0
4719,31.693067042691776,2,2,181,0.01092896174863388,0.01092896174863388,0.9890710382513661,183,6050,4200,1850,0.6942148760330579,79,42,37,233.5559453459785,0.4812446205888829,0.7879271632733265,0.13159838135148777,1028661.3682153263,5399.995658883555,1034061.3638742099,3038,0,344.30601092896177,65,118,36,39.26721334324475,0.5221425318761385,45.217803030303024,8074.8292498448955,124.22814230530608,7
4720,32.18211262498777,2,2,181,0.01092896174863388,0.01092896174863388,0.9890710382513661,183,5300,3300,2000,0.6226415094339622,73,33,40,231.79098504789584,0.48137472727636665,0.7868169727143584,0.13143243593587756,1046522.0845902074,6614.876972308212,1053136.9615625157,3039,0,342.9016393442623,67,116,38,39.06425196219765,0.5245901639344263,44.975490196078425,8207.227496642088,122.4959327857028,0
4721,31.819673674597368,2,0,183,0.01092896174863388,0.0,1.0,183,5550,4100,1450,0.7387387387387387,70,41,29,247.3110152630163,0.4816899857883465,0.800109856812989,0.13739083867646465,1028348.2168846641,8714.368312331706,1037062.5851969959,3040,0,334.39344262295083,59,124,38,39.47634981334788,0.5167918943533698,45.763888888888886,8089.710091854227,137.11373037041062,8
4722,31.711043274047274,4,1,186,0.0213903743315508,0.0053475935828877,0.9946524064171123,187,6850,4500,2350,0.656934306569343,92,45,47,240.4230383846863,0.48241786939604775,0.7974556905047978,0.13521629378154182,1028668.2267289044,5213.108111990098,1033881.3348408946,3041,0,328.2192513368984,66,121,41,39.16534415756169,0.5204434046345812,45.28917910447761,8077.145863786014,122.38099793615173,0
4723,31.36822799385088,6,5,187,0.03125,0.026041666666666668,0.9739583333333334,192,6650,4700,1950,0.706766917293233,86,47,39,238.26369172490578,0.48360806609947643,0.7967168097481359,0.13370115264688368,1016857.0890497064,3406.024798724813,1020263.1138484312,3042,0,320.46875,65,127,38,39.30885710448563,0.5234375,45.375631313131315,7987.115249760044,122.87869615015452,8
4724,31.58209491644631,1,2,186,0.005319148936170213,0.010638297872340425,0.9893617021276596,188,6250,4300,1950,0.688,82,43,39,236.3438337965487,0.4828852116281716,0.7920109657416101,0.13338846152788802,1025567.6002481463,4627.315692034682,1030194.915940181,3043,0,327.57978723404256,65,123,35,39.13155952602135,0.52521054964539,45.15467171717172,8048.549346841215,123.82383610524947,0
4725,31.584667011272394,1,1,186,0.0053475935828877,0.0053475935828877,0.9946524064171123,187,5200,3300,1900,0.6346153846153846,71,33,38,223.01990113416895,0.482978504207157,0.7735337533406024,0.1232776371001834,1019192.4869260697,2860.041534187802,1022052.5284602576,3044,0,330.1550802139037,74,113,39,40.29269859493739,0.5254567736185383,45.95833333333332,8023.821448655296,108.43001957642292,8
4726,32.07638509630202,5,0,191,0.02617801047120419,0.0,1.0,191,6100,4500,1600,0.7377049180327869,77,45,32,230.78019617120722,0.48345503811885737,0.7876195101381074,0.1294139094163611,1039599.6620262779,3683.802788388962,1043283.4648146668,3045,0,316.8848167539267,69,122,42,39.52616313051608,0.5289594240837696,45.40178571428571,8166.590366259381,118.35638211970118,8
4727,32.1037529854222,6,3,194,0.030456852791878174,0.015228426395939087,0.9847715736040609,197,5950,3800,2150,0.6386554621848739,81,38,43,220.0519696043325,0.4840356193238717,0.7881007163527678,0.12392400393507119,1041825.0224776014,501.12963585473244,1042326.1521134562,3046,0,308.20304568527916,62,135,45,39.63200934579438,0.5257508460236886,45.23809523809523,8178.813260571825,131.91634291244878,8
4728,32.48093724687371,3,1,196,0.015228426395939087,0.005076142131979695,0.9949238578680203,197,6500,4400,2100,0.676923076923077,86,44,42,207.36633857490548,0.48374965468420866,0.7731373164562982,0.1176906967938365,1056529.5440063875,-2082.2673726364346,1054447.276633751,3047,0,308.5939086294416,83,114,38,39.651400233372264,0.5328891708967851,44.940476190476176,8284.57238707459,99.81412514547698,8
4729,32.21757115009721,3,3,196,0.01507537688442211,0.01507537688442211,0.9849246231155779,199,6050,4200,1850,0.6942148760330579,79,42,37,180.97902185241605,0.48376245706647714,0.7494925449126537,0.10075204771891887,1041873.6810060305,-8138.544063550737,1033735.1369424798,3048,0,306.4321608040201,75,124,45,41.07995374112997,0.525963149078727,45.68256578947367,8193.490031387764,109.24653375183685,8
4730,32.63571627474076,3,3,196,0.01507537688442211,0.01507537688442211,0.9849246231155779,199,6600,5000,1600,0.7575757575757576,82,50,32,176.40193094616538,0.4838523425206842,0.7432200634982633,0.09898248951656419,1057928.5895386771,-9075.87080044486,1048852.7187382323,3049,0,306.5175879396985,79,120,47,40.8860159379528,0.5284757118927973,45.377604166666664,8309.784267611394,105.18714262799233,0
4731,32.86572224089645,1,2,195,0.005076142131979695,0.01015228426395939,0.9898477157360406,197,6350,4200,2150,0.6614173228346457,85,42,43,199.11232162032704,0.48326729168824895,0.7603723061407841,0.1116934862086815,1065291.512792496,-3327.466737091429,1061964.0460554045,3050,0,310.5736040609137,81,116,38,40.31909519533006,0.5282360406091371,45.3887195121951,8367.98362391112,103.30843980137185,8
4732,32.65206508978006,3,4,194,0.015151515151515152,0.020202020202020204,0.9797979797979798,198,6800,5300,1500,0.7794117647058824,83,53,30,207.6099063815236,0.48364140559572033,0.772499734288993,0.11479506514288963,1053735.8536474116,-2646.7996146810956,1051089.0540327304,3051,0,309.7676767676768,82,116,33,40.671878344777575,0.5218855218855218,45.94628514056225,8295.378433890803,101.16315163281466,8
4733,32.985837308665275,5,5,194,0.02512562814070352,0.02512562814070352,0.9748743718592965,199,5400,3500,1900,0.6481481481481481,73,35,38,236.80215255045448,0.48433983892526605,0.7985877731412876,0.13065395829710283,1063802.406420406,5182.139945740699,1068984.5463661468,3052,0,308.83417085427135,73,126,38,40.01635073716878,0.5175879396984925,46.030405405405375,8377.399728644898,114.75890039239586,8
4734,32.89995525854756,3,2,195,0.015228426395939087,0.01015228426395939,0.9898477157360406,197,5950,4000,1950,0.6722689075630253,79,40,39,233.9288751636952,0.48424712524603747,0.7941378298510431,0.13011183259104775,1063648.031212188,4413.597502309265,1068061.6287144974,3053,0,311.8730964467005,62,135,40,39.769192838719476,0.5209919627749577,45.717592592592595,8365.879826739469,134.93354559257207,0
4735,32.63762705196766,3,0,198,0.015151515151515152,0.0,1.0,198,6200,4500,1700,0.7258064516129032,79,45,34,228.41925885935458,0.4843506981831855,0.7888592998294119,0.12806058448817068,1057716.1104711865,2520.5460074857947,1060236.6564786723,3054,0,311.1818181818182,68,130,41,39.59531645319415,0.5238846801346801,45.41062801932369,8309.192974100024,122.19401432500035,0
4736,32.5763836587116,4,0,202,0.019801980198019802,0.0,1.0,202,5600,3700,1900,0.6607142857142857,75,37,38,216.0605560603857,0.48448762786726435,0.7802112811994839,0.12234152188988842,1058898.7149519713,-242.75096716972166,1058655.9639848017,3055,0,306.0,78,124,38,39.52009101722086,0.5270214521452146,45.02900843881857,8306.032842939185,106.48760055050236,0
4737,32.62476186358297,2,4,200,0.00980392156862745,0.0196078431372549,0.9803921568627451,204,5900,4600,1300,0.7796610169491526,72,46,26,213.05222200590333,0.48439109839338035,0.7809581210192875,0.12148375962755523,1062690.7933830079,-1418.2730329065816,1061272.5203501014,3056,0,303.9901960784314,70,134,41,39.32442854131939,0.5293607026143791,44.76232394366198,8327.068399952384,118.95811999931978,0
4738,33.01159064216128,3,4,199,0.014778325123152709,0.019704433497536946,0.9802955665024631,203,7500,5100,2400,0.68,99,51,48,219.909867058932,0.4842533206522623,0.7896134710889398,0.12683574316793292,1078947.7213296057,-645.7500077735531,1078301.9713218322,3057,0,304.7931034482759,71,132,40,38.706239625773364,0.5324302134646962,44.328703703703724,8440.116172284104,118.8748756659733,0
4739,33.03278956852542,1,6,194,0.005,0.03,0.97,200,5150,3400,1750,0.6601941747572816,69,34,35,222.7638965495918,0.48423942629815747,0.7898297673395298,0.12935389342600273,1081794.784145868,3046.964276671811,1084841.7484225398,3058,0,309.14,73,127,40,38.37264864418899,0.53390625,44.073761261261275,8453.95758932099,115.80763820987657,0
4740,32.65377983675487,1,1,194,0.005128205128205128,0.005128205128205128,0.9948717948717949,195,6350,4200,2150,0.6614173228346457,85,42,43,225.9302677431691,0.4837397568067671,0.7893407965318062,0.13203992195496722,1071401.9111155588,3062.424127776457,1074464.3352433352,3059,0,315.1897435897436,75,120,41,38.04463171036205,0.5366452991452991,43.83223684210528,8364.845739431907,111.53127652575876,0
4741,32.44400340781024,4,1,197,0.020202020202020204,0.005050505050505051,0.9949494949494949,198,5500,3200,2300,0.5818181818181818,78,32,46,211.8403397736601,0.4841124869678169,0.7819457120643616,0.1216915758189481,1059136.1416715619,-226.4479763465556,1058909.6936952153,3060,0,311.3838383838384,66,132,43,39.06779231315286,0.5321969696969697,44.48072139303483,8290.068345885593,125.60709614978171,8
4742,32.20440902838342,2,3,196,0.010050251256281407,0.01507537688442211,0.9849246231155779,199,7000,4800,2200,0.6857142857142857,92,48,44,218.95334745392586,0.48424360861546795,0.7848060395435115,0.1233053061977373,1045091.4936676931,-1034.743813167006,1044056.7498545261,3061,0,310.78391959798995,76,123,42,39.659998052959494,0.5269053601340034,45.23809523809524,8204.45658580245,107.95337612897961,8
4743,32.25434665851422,0,0,196,0.0,0.0,1.0,196,6050,4100,1950,0.6776859504132231,80,41,39,220.3252870826419,0.48364348944706087,0.7846923412049123,0.12450286733138541,1047790.3277613828,920.9409532884201,1048711.2687146713,3062,1,314.40816326530614,75,121,36,39.49096852538938,0.5286458333333333,45.10690789473684,8221.410153623756,109.61880204831674,0
4744,32.4136986733561,1,2,195,0.005076142131979695,0.01015228426395939,0.9898477157360406,197,6500,4700,1800,0.7230769230769231,83,47,36,232.7421143444825,0.48379713560551124,0.7972845022101265,0.13163521832537714,1053245.445746747,3126.9143933589376,1056372.360140106,3063,0,313.8071065989848,73,124,35,39.13997791275539,0.5288705583756346,45.0731981981982,8263.120537365976,113.193432018712,8
4745,32.608722789235514,1,1,195,0.00510204081632653,0.00510204081632653,0.9948979591836735,196,6850,5200,1650,0.7591240875912408,85,52,33,227.7090572681297,0.48342872405372406,0.7923955489623884,0.129557180366039,1061473.867841423,2291.442752185157,1063765.310593608,3064,0,316.2040816326531,76,120,37,39.0356865136172,0.5307716836734694,44.84577922077922,8320.253253893005,109.47701649859216,0
4746,32.28520051025614,5,4,196,0.025,0.02,0.98,200,6850,5100,1750,0.7445255474452555,86,51,35,225.47748749508074,0.4837055067001675,0.7961402119624803,0.12862715044107845,1051772.771426498,580.2163833969257,1052352.9878098948,3065,0,309.27,66,134,38,38.98959982945547,0.5333854166666667,44.745024875621894,8240.958053130997,124.8630008050151,8
4747,32.418268858398186,3,3,196,0.01507537688442211,0.01507537688442211,0.9849246231155779,199,7100,5600,1500,0.7887323943661971,86,56,30,215.69877577261713,0.484055377899599,0.7854816736653343,0.12415155757195143,1058911.826781672,-1218.8030624093285,1057693.0237192626,3066,0,311.49748743718595,72,127,38,38.893269874944195,0.5366415410385259,44.40639269406394,8285.902280131708,115.08197611294038,0
4748,32.33593694265557,2,1,197,0.010101010101010102,0.005050505050505051,0.9949494949494949,198,6000,4800,1200,0.8,72,48,24,217.44012402086722,0.4838641277410313,0.786075403064213,0.1264755277588833,1059497.7543260956,475.46462009939796,1059973.218946195,3067,0,313.92424242424244,75,123,37,38.44417599186165,0.5389835858585859,44.01041666666667,8277.663024643352,110.36884032857803,0
4749,31.951150041191763,2,3,196,0.010050251256281407,0.01507537688442211,0.9849246231155779,199,5850,4400,1450,0.7521367521367521,73,44,29,219.92951300234762,0.4839475153545505,0.7891938200292656,0.12849836538636453,1048265.591572916,458.9082103500323,1048724.499783266,3068,0,313.33668341708545,78,121,40,38.20863574749918,0.5406721105527639,43.842299578059084,8184.533120388114,104.92991179984762,0
4750,32.379540982133314,1,4,193,0.005076142131979695,0.02030456852791878,0.9796954314720813,197,6500,4400,2100,0.676923076923077,86,44,42,206.76869625939563,0.4831518267205359,0.777546853989745,0.11921075470146182,1058170.1028783908,-2140.70948143253,1056029.3933969582,3069,0,317.44162436548226,71,126,41,39.056988380208644,0.540556260575296,44.343171296296326,8278.050762373876,116.59226425878698,7
4751,32.688631733255626,4,6,191,0.02030456852791878,0.030456852791878174,0.9695431472081218,197,7600,5500,2100,0.7236842105263158,97,55,42,201.12015659030612,0.48297053593010814,0.7707484157511157,0.11695130925020915,1070969.0163245662,-3921.3087466869865,1067047.7075778793,3070,0,314.7766497461929,76,121,37,38.87230032061447,0.5440461082910322,44.020562770562805,8367.617554879182,110.1002309852524,0
4752,32.204446864311244,3,4,190,0.015463917525773196,0.020618556701030927,0.979381443298969,194,5950,4100,1850,0.6890756302521008,78,41,37,211.68338224567006,0.4826954578637181,0.7783967663850377,0.1203259294266366,1048018.9042835543,-380.3627367710701,1047638.5415467832,3071,0,319.12886597938143,80,114,42,39.48125651107305,0.5389819587628866,44.881687242798364,8215.944147302065,102.69930184127581,8
4753,32.261841742492585,2,3,189,0.010416666666666666,0.015625,0.984375,192,6150,4400,1750,0.7154471544715447,79,44,35,204.79547584622162,0.4822713287158231,0.7692072104682541,0.11742948989474518,1052617.4471798833,-1435.7418041519945,1051181.7053757312,3072,0,322.78125,68,124,45,39.31862281583044,0.5423719618055556,44.550120772946876,8241.283576762067,121.19534671708922,0
4754,32.22292932140381,2,2,189,0.010471204188481676,0.010471204188481676,0.9895287958115183,191,5700,4000,1700,0.7017543859649122,74,40,34,217.43338584152895,0.4822988426563792,0.7723224032604763,0.12494676331691344,1052024.6909761128,1849.0581095651291,1053873.749085678,3073,0,324.8062827225131,73,118,41,38.91178455351735,0.5436845549738221,44.467905405405425,8233.99262347194,112.79441949961563,7
4755,32.07067749954221,4,2,191,0.02072538860103627,0.010362694300518135,0.9896373056994818,193,6450,4600,1850,0.7131782945736435,83,46,37,227.19384880243499,0.48300320236039146,0.7902598208578706,0.12897442154662392,1043258.9700752648,2354.4041418126694,1045613.3742170775,3074,0,322.05699481865287,81,112,39,39.136400800172645,0.5383203799654577,44.93140243902439,8180.222732638563,100.99040410664892,8
4756,32.51114052092202,4,0,195,0.020512820512820513,0.0,1.0,195,6600,4700,1900,0.7121212121212122,85,47,38,227.72806703871566,0.48353158868622786,0.7944514098876512,0.13122672592341472,1062308.1178075902,2783.4748535718313,1065091.592661162,3075,0,319.57948717948716,67,128,41,38.5411673058485,0.541880341880342,44.36274509803922,8311.058716500418,124.04565248508086,0
4757,32.69953111554235,3,5,193,0.015151515151515152,0.025252525252525252,0.9747474747474747,198,6600,5100,1500,0.7727272727272727,81,51,30,227.79002289860813,0.4836932138645336,0.7937691480512103,0.1305323434322019,1066698.5809954226,2396.658838171932,1069095.2398335945,3076,0,315.72222222222223,66,132,41,38.755655649562755,0.5370896464646464,44.574004975124375,8352.310272034278,126.55015563688299,8
4758,32.559206195242375,0,5,188,0.0,0.025906735751295335,0.9740932642487047,193,5450,4100,1350,0.7522935779816514,68,41,27,204.16488719090106,0.4829627230857801,0.7622608665809423,0.11821795212729443,1065395.6404616612,-546.7238502931314,1064848.916611368,3077,1,323.80829015544043,74,119,44,38.95762075393163,0.5420444732297064,44.180555555555586,8329.27804041909,112.55781135701474,8
4759,32.38749691535026,1,0,189,0.005291005291005291,0.0,1.0,189,6250,4600,1650,0.736,79,46,33,204.31923304141282,0.4822014897369507,0.7582424708068354,0.11908401877743906,1061815.819612396,-660.1212211108405,1061155.698391285,3078,0,331.15343915343914,78,111,39,38.702690525231745,0.544918430335097,43.934599156118175,8293.31737995923,106.3245817943491,0
4760,32.28595229908119,3,1,191,0.015625,0.005208333333333333,0.9947916666666666,192,6400,4400,2000,0.6875,84,44,40,198.6721894261996,0.48241619400814423,0.7554049179795528,0.1165876686920223,1060603.7506292306,-2657.506149770634,1057946.24447946,3079,0,326.9635416666667,72,120,43,38.58626064688528,0.5473090277777778,43.67865296803651,8275.578783510156,114.93859421541885,0
4761,32.14314551687197,4,2,193,0.020512820512820513,0.010256410256410256,0.9897435897435898,195,6400,4600,1800,0.71875,82,46,36,190.06075219418167,0.4823717948717949,0.7492336341498353,0.1126237574057584,1058893.4327280384,-5149.183536446245,1053744.2491915922,3080,0,322.7897435897436,76,119,44,38.43856505393346,0.5497863247863248,43.31709956709955,8250.59582030743,108.5604713198346,0
4762,32.01430100542212,1,5,189,0.005154639175257732,0.02577319587628866,0.9742268041237113,194,6650,4600,2050,0.6917293233082706,87,46,41,193.94911058748224,0.48198213236472415,0.7587140730227713,0.1126041964520625,1048392.0033624605,-4783.060680164352,1043608.9426822962,3081,0,325.1443298969072,78,116,40,39.11608875607536,0.5449957044673539,44.07964135021098,8193.111395229946,105.0398896824352,8
4763,32.1985653154809,2,5,186,0.010471204188481676,0.02617801047120419,0.9738219895287958,191,4950,3000,1950,0.6060606060606061,69,30,39,191.9839413125856,0.48162028106916505,0.752916106222292,0.11222154095282104,1056523.092547654,-2582.9065209877613,1053940.186026666,3082,0,330.8324607329843,82,109,43,38.90715837089298,0.5471749563699826,43.82530120481929,8248.457771330304,100.59094843085737,0
4764,32.54269252640478,2,3,185,0.010638297872340425,0.015957446808510637,0.9840425531914894,188,6350,4400,1950,0.6929133858267716,83,44,39,190.10061291873802,0.48111275457958813,0.7443387257091003,0.11186398616771866,1069890.9427510533,-3272.615205364016,1066618.3275456892,3083,0,335.4255319148936,71,117,42,38.70176032498307,0.5503102836879432,43.57638888888886,8344.714732899209,117.53119342111562,0
4765,32.616639195142604,1,1,185,0.005376344086021506,0.005376344086021506,0.9946236559139785,186,6400,4800,1600,0.75,80,48,32,210.65077661291608,0.4809030804998547,0.7669889680902975,0.12022108895332773,1062707.5210710897,1172.0329252024235,1063879.5539962922,3084,0,339.06451612903226,65,121,44,39.3512221260459,0.5406586021505376,44.72853535353536,8326.097259189346,128.0938039875284,8
4766,32.41653053878284,3,5,183,0.015957446808510637,0.026595744680851064,0.973404255319149,188,6400,4700,1700,0.734375,81,47,34,205.92523141984407,0.48123779250578375,0.7628427822162742,0.11618087848267587,1052555.6357199682,-650.4474264208511,1051905.1882935474,3085,0,336.43617021276594,71,117,39,39.92018659399724,0.5319703014184397,45.16782407407408,8260.775013167276,116.34894384742643,8
4767,32.64571553768604,3,3,183,0.016129032258064516,0.016129032258064516,0.9838709677419355,186,5200,3500,1700,0.6730769230769231,69,35,34,210.19163463294575,0.48054223578417127,0.7685312746397712,0.11879861613899856,1060563.4772809017,2184.3141843350077,1062747.7914652368,3086,0,340.8225806451613,70,116,37,39.74197555734624,0.5333781362007168,45.09976525821598,8321.400553869722,118.87715076956745,8
4768,32.8831762430218,3,2,184,0.016129032258064516,0.010752688172043012,0.989247311827957,186,6400,4500,1900,0.703125,83,45,38,204.69030397032463,0.4807178145887823,0.7623962565148741,0.1165833739972337,1070745.3467240862,234.2380991529726,1070979.5848232391,3087,0,340.94086021505376,74,112,42,39.58197271506842,0.5356182795698925,44.80555555555557,8391.60389290674,113.40005260684784,0
4769,32.392284574120296,7,4,187,0.03664921465968586,0.020942408376963352,0.9790575916230366,191,5450,3600,1850,0.6605504587155964,73,36,37,196.4909767617982,0.48126664829613297,0.7575740931189232,0.11343808967691474,1059008.407085356,-2032.8807385683572,1056975.5263467878,3088,0,332.3979057591623,72,119,47,39.26781063988097,0.5394306282722513,44.292237442922385,8282.958612560464,115.04109184111755,0
4770,32.60689517822259,1,2,186,0.005319148936170213,0.010638297872340425,0.9893617021276596,188,6300,4700,1600,0.746031746031746,79,47,32,194.82711229303862,0.480933197747184,0.7523941145756505,0.11283581704313886,1067024.9967324035,-2322.9202284271905,1064702.0765039762,3089,0,332.15425531914894,73,115,50,39.18808004108435,0.5412788120567376,44.17229729729731,8341.747085712552,114.27050802345961,0
4771,32.10043241962975,2,5,183,0.010638297872340425,0.026595744680851064,0.973404255319149,188,5950,4300,1650,0.7226890756302521,76,43,33,194.20859820917727,0.4812532000227557,0.7515669340475635,0.11325198030400344,1052569.917450104,-2666.3743629731543,1049903.5430871306,3090,0,332.9255319148936,75,113,41,38.94107257546561,0.5437167553191489,43.91447368421053,8220.45613114532,109.60608174860427,0
4772,31.625225062701144,1,0,184,0.005434782608695652,0.0,1.0,184,6200,4700,1500,0.7580645161290323,77,47,30,193.49710450575625,0.4806342559594519,0.7463766112630938,0.10848073875049981,1024903.0290789406,-3336.846294809062,1021566.1827841316,3091,0,340.67391304347825,73,111,43,40.484813299421276,0.5318161231884058,45.41103603603605,8051.4332838403125,110.29360662794949,8
4773,31.48635306597572,1,4,181,0.005405405405405406,0.021621621621621623,0.9783783783783784,185,6650,4700,1950,0.706766917293233,86,47,39,204.47340008550321,0.48088890520955735,0.7588004193063242,0.1124793378949003,1014509.3996016425,-2161.9627289502887,1012347.4368726922,3092,0,339.82702702702704,72,113,44,40.95664699269253,0.5241554054054054,46.14726027397258,7992.896989778876,111.01245819137327,7
4774,31.291182131878934,3,1,183,0.016304347826086956,0.005434782608695652,0.9945652173913043,184,6350,4100,2250,0.6456692913385826,86,41,45,226.69408694220843,0.4811985230062565,0.7798826246793427,0.1257617848422626,1010837.8832567893,2680.1941982986473,1013518.0774550879,3093,0,335.45652173913044,67,117,39,40.05585939854155,0.5302309782608696,45.81801470588236,7953.654796480831,118.71126561911687,8
4775,31.6469798571591,6,2,187,0.031746031746031744,0.010582010582010581,0.9894179894179894,189,5600,3700,1900,0.6607142857142857,75,37,38,217.49732710363145,0.48153073286052006,0.7768020024606517,0.122050152977988,1025898.4153353136,1226.032643056285,1027124.4479783699,3094,0,327.43386243386243,74,115,43,39.83697430862378,0.5340057319223985,45.37499999999999,8058.112246129121,108.89340873147461,0
4776,31.962222721053518,5,4,188,0.026041666666666668,0.020833333333333332,0.9791666666666666,192,5450,3700,1750,0.6788990825688074,72,37,35,206.84048079592927,0.48164528341332175,0.7684438816023027,0.1159359414979629,1035755.3325104191,-1002.7738073196751,1034752.5587030994,3095,0,322.0416666666667,72,120,40,40.15376567083308,0.5318467881944444,45.41952054794519,8136.9579846791285,113.01330534276568,8
4777,32.172585486739074,5,3,190,0.025906735751295335,0.015544041450777202,0.9844559585492227,193,5950,4500,1450,0.7563025210084033,74,45,29,199.72364592467133,0.4817921973949338,0.7602054789979256,0.11316188058832752,1045970.0012573464,-2769.0115642104506,1043200.989693136,3096,0,320.56476683937825,82,111,36,39.912167372116656,0.5351360103626943,45.005020080321245,8203.847790155069,100.04692427018377,0
4778,31.68998061006799,1,5,186,0.005235602094240838,0.02617801047120419,0.9738219895287958,191,5300,3500,1800,0.660377358490566,71,35,36,182.43605268622065,0.48192569119132905,0.7407638887728389,0.10152258491401926,1024687.2960384641,-6112.018894605215,1018575.2771438588,3097,0,324.8324607329843,76,115,43,41.058667588750566,0.5305410122164049,45.69805194805194,8058.823802868737,106.03715530090444,8
4779,32.16158788697095,7,4,189,0.03626943005181347,0.02072538860103627,0.9792746113989638,193,5550,3800,1750,0.6846846846846847,73,38,35,178.20664160821573,0.48205868595279217,0.7384293580584651,0.10060723578365377,1044480.5901833595,-6923.324359691365,1037557.2658236681,3098,0,321.0880829015544,82,111,41,40.60135257136289,0.5348661485319517,45.14307228915661,8196.603479175661,99.95857901433733,0
4780,32.515047245904775,7,5,191,0.03571428571428571,0.025510204081632654,0.9744897959183674,196,6550,4800,1750,0.732824427480916,83,48,35,198.28037855547262,0.48221099337170764,0.7606983557940268,0.11231518302638005,1057022.0941907996,-3832.6518044703407,1053189.4423863292,3099,0,317.11224489795916,83,113,39,39.95902635930358,0.5331101190476191,45.01488095238093,8290.853192835919,99.88979750404721,8
4781,32.905609189827324,6,1,196,0.030456852791878174,0.005076142131979695,0.9949238578680203,197,6150,4000,2150,0.6504065040650406,83,40,43,223.9708911626436,0.48221299941296314,0.7930159385214468,0.12636205243237664,1068435.8820606796,2309.7073310550422,1070745.5893917347,3100,0,316.4060913705584,71,126,37,39.46032512016958,0.5337880710659899,45.16782407407407,8385.407990011829,118.10433788749054,8
4782,32.65981413628512,5,2,199,0.024875621890547265,0.009950248756218905,0.9900497512437811,201,6500,5200,1300,0.8,78,52,26,214.03747173682885,0.48243470149253737,0.7882223738165031,0.12210561783038004,1063988.7301214598,-1153.3084496646534,1062835.4216717952,3101,0,311.07960199004975,64,137,42,39.28014607399967,0.537002487562189,44.743589743589745,8336.626916069701,130.25979556358908,0
4783,32.45451115528997,3,4,198,0.01485148514851485,0.019801980198019802,0.9801980198019802,202,6500,4200,2300,0.6461538461538462,88,42,46,184.7281022660155,0.4826019448959821,0.7500933589667103,0.10365873689305682,1052067.715182213,-8030.705503809586,1044037.0096784035,3102,0,309.83168316831683,81,121,45,40.672395729395326,0.5324360561056105,45.37601626016258,8263.696920688864,102.02094963813413,8
4784,32.90096991518129,5,3,200,0.024630541871921183,0.014778325123152709,0.9852216748768473,203,5500,3300,2200,0.6,77,33,44,208.99049799829808,0.4824639483652799,0.7847708184549973,0.11365503404995533,1056342.6151888215,-1946.8861589730523,1054395.7290298485,3103,0,309.1527093596059,70,133,41,41.300346418094804,0.5166256157635468,46.59624413145538,8337.229348224879,119.10327640321255,8
4785,33.14377808217601,6,4,202,0.02912621359223301,0.019417475728155338,0.9805825242718447,206,6400,4800,1600,0.75,80,48,32,203.30470202192043,0.4834793590654353,0.7806272113077384,0.11218397765383899,1068931.1485555398,-4136.254272193469,1064794.8942833464,3104,0,305.2621359223301,80,126,37,40.86282849764548,0.5204288025889967,46.02623456790123,8417.650120176086,105.22062650220107,0
4786,32.987068193657194,4,3,203,0.019417475728155338,0.014563106796116505,0.9854368932038835,206,7200,4800,2400,0.6666666666666666,96,48,48,207.99744552720549,0.483424106085721,0.7870941677261409,0.11579395133348647,1066759.8650628296,-4023.3346151969827,1062736.5304476325,3105,0,306.2281553398058,68,138,41,40.392625351220886,0.5230582524271845,45.68236714975845,8389.193097680378,123.3704867305938,0
4787,32.92314942325515,4,3,204,0.01932367149758454,0.014492753623188406,0.9855072463768116,207,7250,5400,1850,0.7448275862068966,91,54,37,194.55764503704498,0.4835060894579679,0.7749270594879032,0.10949315027997704,1068199.588367348,-7084.720731541418,1061114.8676358066,3106,0,303.951690821256,74,133,43,40.30780310052164,0.5267210144927537,45.2638888888889,8386.715049610062,113.33398715689273,8
4788,32.60985190125321,7,2,209,0.03317535545023697,0.009478672985781991,0.990521327014218,211,6850,5100,1750,0.7445255474452555,86,51,35,184.27873509137112,0.48368408184758893,0.7632232438773607,0.10132495372562533,1050564.2488948482,-10330.669816288002,1040233.5790785601,3107,0,298.4265402843602,87,124,38,41.48712926692781,0.5203890205371249,46.16477272727275,8277.529168684647,95.14401343315686,8
4789,32.19828641693628,3,3,209,0.014150943396226415,0.014150943396226415,0.9858490566037735,212,6600,5000,1600,0.7575757575757576,82,50,32,190.45610397144202,0.483872935855018,0.7723412408796229,0.10629122675640079,1042035.8237339463,-9307.58336259233,1032728.2403713539,3108,0,297.95754716981133,75,137,41,40.74116474517831,0.5233392295597484,45.58662280701753,8191.674787159651,109.22233049546202,8
4790,32.53803604189265,1,2,208,0.004761904761904762,0.009523809523809525,0.9904761904761905,210,5650,3500,2150,0.6194690265486725,78,35,43,214.61367731163753,0.4834121288068656,0.7994137624807975,0.11960492578266604,1052580.8645473125,-2470.349998327507,1050110.514548985,3109,0,301.5190476190476,64,146,39,40.18213415658603,0.5184523809523809,45.641025641025664,8276.341475271207,129.3178355511126,8
4791,32.63627631033114,4,4,208,0.018867924528301886,0.018867924528301886,0.9811320754716981,212,6700,4600,2100,0.6865671641791045,88,46,42,206.14935815300925,0.483529687919163,0.7892055569607033,0.11608894633850995,1059090.7087638674,-5433.826032502811,1053656.8827313646,3110,0,299.54245283018867,78,134,40,39.98811741973327,0.5252555031446541,45.239978902953574,8314.418441348967,106.59510822242267,8
4792,32.812458294398844,3,6,205,0.014218009478672985,0.02843601895734597,0.9715639810426541,211,7100,4900,2200,0.6901408450704225,93,49,44,226.53370681220716,0.483559016023471,0.8097625385035416,0.12912939672064302,1068701.9278559787,-880.5981610865292,1067821.3296948923,3111,0,299.26066350710903,60,151,40,38.99287434765156,0.5311512638230648,44.77459016393444,8374.573115916783,139.57621859861305,6
4793,33.09529991726191,3,0,208,0.014423076923076924,0.0,1.0,208,8100,6300,1800,0.7777777777777778,99,63,36,221.58988634559725,0.482893402390685,0.8014113535201566,0.12764825847232264,1081291.9659100543,-1779.3272335168476,1079512.6386765374,3112,0,304.39903846153845,64,144,39,38.7106085302907,0.5335536858974359,44.37499999999999,8459.986041350057,132.18728189609465,0
4794,33.399152407456675,3,3,208,0.014218009478672985,0.014218009478672985,0.985781990521327,211,6950,4900,2050,0.7050359712230215,90,49,41,211.14502819873317,0.48305875272699916,0.794364711877598,0.11961667483212766,1085802.323181819,-3297.6475707050517,1082504.675611114,3113,0,301.0568720379147,80,131,41,39.62630707417121,0.5305094786729858,45.01028806584361,8516.440251222335,106.45550314027919,7
4795,33.707515922170145,1,4,205,0.004784688995215311,0.019138755980861243,0.9808612440191388,209,6950,5200,1750,0.7482014388489209,87,52,35,224.68819615959367,0.48216955741626794,0.8000628749068692,0.1269818533904938,1095032.06168229,458.15573526294065,1095490.2174175528,3114,0,304.85167464114835,76,133,38,39.37557495665713,0.5271630781499203,45.10281385281385,8591.950960572643,113.05198632332426,8
4796,33.83904766414024,1,2,204,0.0048543689320388345,0.009708737864077669,0.9902912621359223,206,6200,4100,2100,0.6612903225806451,83,41,42,213.02559393238,0.4814719985792091,0.7886343468786272,0.12260545135432081,1105300.246735741,-308.5516931025022,1104991.6950426383,3115,0,309.49029126213594,67,139,45,38.963952152632075,0.534132281553398,44.408700980392155,8648.96615006403,129.08904701588105,8
4797,33.882395622201045,1,2,203,0.004878048780487805,0.00975609756097561,0.9902439024390244,205,6700,4400,2300,0.6567164179104478,90,44,46,209.91352638964946,0.4815738083851427,0.7868702017599687,0.1215719281681128,1108760.817593025,-1151.221371275692,1107609.5962217494,3116,0,311.64878048780486,68,137,46,38.802544356583674,0.5364329268292682,44.17270531400964,8668.041609508082,127.47120013982473,0
4798,33.99772084666135,4,4,203,0.01932367149758454,0.01932367149758454,0.9806763285024155,207,6600,4600,2000,0.696969696969697,86,46,40,217.93347289937276,0.48154988039960606,0.7944354696370659,0.12399972461263618,1106700.191635637,237.40324431107638,1106937.594879948,3117,0,309.54589371980677,78,129,36,39.28371488122923,0.5288848631239935,44.84440928270042,8674.708545671718,111.21421212399638,8
4799,33.92239297072653,4,1,206,0.01932367149758454,0.004830917874396135,0.9951690821256038,207,5800,4100,1700,0.7068965517241379,75,41,34,218.59060474216466,0.4817570314087832,0.7875086736187182,0.12398053990974335,1103202.1764307977,1029.9261797753425,1104232.102610573,3118,0,309.30917874396135,83,124,34,39.39045836169726,0.5284822866344605,44.96527777777773,8651.38806840217,104.23359118556832,8
4800,34.25979414105776,0,3,203,0.0,0.014563106796116505,0.9854368932038835,206,6700,4900,1800,0.7313432835820896,85,49,36,218.35069137910958,0.4814779185413213,0.7880894321218839,0.12424734031572131,1115258.6945567157,803.5014046034876,1116062.1959613191,3119,1,311.7378640776699,83,123,36,39.26986132711245,0.5298847087378641,44.841269841269785,8741.685568531642,105.32151287387521,0
4801,34.006998175164284,4,3,204,0.01932367149758454,0.014492753623188406,0.9855072463768116,207,6600,5300,1300,0.803030303030303,79,53,26,238.614182960611,0.4822788174413333,0.8113938646804995,0.1355693777670456,1106520.815531547,4806.312065393851,1111327.1275969408,3120,0,309.92270531400965,76,131,37,38.81284138516202,0.5277274557165861,44.89989177489178,8675.188914895472,114.14722256441411,8
4802,34.279068085459514,1,4,201,0.004878048780487805,0.01951219512195122,0.9804878048780488,205,6950,5200,1750,0.7482014388489209,87,52,35,234.40226233353678,0.48172026940857643,0.8051634207216853,0.1342114312775539,1117952.7633426965,4460.131381911571,1122412.894724608,3121,0,313.780487804878,66,139,35,38.61858525598104,0.5303861788617886,44.605099502487576,8754.699182833414,132.6469573156578,0
4803,34.33128655016634,2,5,198,0.009852216748768473,0.024630541871921183,0.9753694581280788,203,6550,4900,1650,0.7480916030534351,82,49,33,222.81760338037202,0.48167442975824676,0.7979651518013662,0.12611608849408443,1115805.163259302,2574.2064633768155,1118379.3697226788,3122,0,317.46305418719214,69,134,40,39.36378869238707,0.5246305418719213,45.04464285714288,8752.945423571482,126.85428150103597,8
4804,34.50830324874125,3,1,200,0.014925373134328358,0.004975124378109453,0.9950248756218906,201,6950,5200,1750,0.7482014388489209,87,52,35,249.97045827547197,0.4815744195688225,0.8152216445860605,0.13801098502802017,1113128.8232287592,8499.864412425482,1121628.6876411848,3123,0,321.1741293532338,72,129,37,39.65543071161048,0.5182939469320067,46.00456621004564,8764.951453019263,121.73543684748977,8
4805,34.24645028037393,2,4,198,0.009900990099009901,0.019801980198019802,0.9801980198019802,202,5950,4100,1850,0.6890756302521008,78,41,37,248.72250545132914,0.4817101579560941,0.816970609447651,0.13859789445183496,1107807.8695463815,8757.34977445508,1116565.2193208367,3124,0,320.21287128712873,60,142,39,39.319122748125764,0.520575495049505,45.64549180327869,8710.739018547982,145.17898364246636,0
4806,34.37805880493468,5,2,201,0.024630541871921183,0.009852216748768473,0.9901477832512315,203,6350,4700,1650,0.7401574803149606,80,47,33,237.08263012618534,0.48201482709847343,0.8091361764692824,0.13373582747199333,1116186.2631688039,5975.6749965555155,1122161.9381653594,3125,0,319.3645320197044,67,136,42,39.133165514477504,0.5238095238095238,45.17463235294117,8760.401473959664,130.7522608053681,0
4807,33.846282584840125,1,1,201,0.0049504950495049506,0.0049504950495049506,0.995049504950495,202,6700,4600,2100,0.6865671641791045,88,46,42,236.05091267865288,0.4819985263451718,0.807883933451111,0.1338663316176954,1100684.146638545,4863.499476990606,1105547.6461155356,3126,0,321.23267326732673,69,133,38,38.95023728945422,0.5258353960396039,44.970238095238095,8631.809388973068,125.09868679671114,0
4808,33.4857019588932,1,5,197,0.0049504950495049506,0.024752475247524754,0.9752475247524752,202,6800,5000,1800,0.7352941176470589,86,50,36,238.34165942872437,0.4820390621151667,0.807344380132978,0.13062258648108924,1077692.0544235138,4171.782520890081,1081863.8369444038,3127,0,322.2227722772277,67,135,38,40.24599484764318,0.5145420792079207,46.29289215686273,8495.56059808803,126.79941191176164,7
4809,33.1880127121365,5,3,199,0.024752475247524754,0.01485148514851485,0.9851485148514851,202,7200,5600,1600,0.7777777777777778,88,56,32,246.45275034330783,0.48257269756826426,0.8120758880375611,0.13700838601776213,1072795.5728850241,5278.683898727955,1078074.256783752,3128,0,322.029702970297,64,138,37,39.470802344636326,0.5206270627062706,45.737179487179496,8438.47771940319,131.85121436567485,8
4810,32.834457845427266,1,2,198,0.005,0.01,0.99,200,6650,4500,2150,0.6766917293233082,88,45,43,245.67524046757268,0.48242357621440535,0.8097162090030239,0.1375732391073979,1063716.4200647555,5615.757457743074,1069332.1775224986,3129,0,325.74,68,132,37,39.20240001581558,0.5226041666666666,45.45591787439614,8357.816934356137,122.90907256406084,0
4811,33.24977068966511,6,4,200,0.029411764705882353,0.0196078431372549,0.9803921568627451,204,6400,4800,1600,0.75,80,48,32,233.59500470133207,0.48348606684052936,0.8041341400364894,0.1321784804654029,1080562.1824410127,3282.7856174782046,1083844.968058491,3130,0,319.75,74,130,36,39.100180685697694,0.5260416666666667,45.05555555555557,8476.844316381883,114.5519502213768,0
4812,33.25147364501841,1,2,199,0.004975124378109453,0.009950248756218905,0.9900497512437811,201,6600,4600,2000,0.696969696969697,86,46,40,235.62072346470796,0.48289593698175787,0.8051628376841278,0.13381560220938976,1081809.1966881566,4179.333114887851,1085988.5298030444,3131,0,325.2487562189055,75,126,39,38.90469122203718,0.5287624378109452,44.91502192982458,8481.951425540585,113.09268567387447,0
4813,32.693582043167694,1,0,200,0.005,0.0,1.0,200,6900,5100,1800,0.7391304347826086,87,51,36,227.72389698696108,0.4828763609715243,0.7984561874542355,0.12833353589485236,1061188.0473828455,1431.5755172009349,1062619.6229000464,3132,0,325.85,66,134,40,39.409298470425504,0.5283854166666666,45.21144278606964,8329.95059893393,126.21137271112016,8
4814,32.2095576727745,2,2,200,0.009900990099009901,0.009900990099009901,0.9900990099009901,202,6750,4900,1850,0.725925925925926,86,49,37,224.78050996216427,0.4832063896688176,0.7997400161538586,0.12608342095652464,1044000.8556969487,-215.79105110061073,1043785.0646458481,3133,0,323.61386138613864,65,137,37,39.668309364410284,0.5272792904290429,45.39141414141416,8200.82993019572,126.16661431070338,8
4815,32.10632342678814,3,3,200,0.014778325123152709,0.014778325123152709,0.9852216748768473,203,6150,4200,1950,0.6829268292682927,81,42,39,216.87164373768806,0.4834932692776667,0.7931896424134117,0.1225741033929281,1043040.2108022921,-1508.8309997602187,1041531.3798025319,3134,0,322.8029556650246,70,133,38,39.571701968458605,0.5296079638752053,45.09976525821598,8183.90937818398,116.912991116914,0
4816,32.3405231760825,5,4,201,0.024390243902439025,0.01951219512195122,0.9804878048780488,205,6900,5300,1600,0.7681159420289855,85,53,32,216.15212505767178,0.48422305914235614,0.795318867853982,0.12190481519823176,1049968.4680972337,-2509.4168754469174,1047459.0512217868,3135,0,319.0048780487805,71,134,38,39.67435275080904,0.5247967479674797,45.18229166666667,8240.938002030409,116.06954932437195,8
4817,32.44798605611413,4,2,203,0.01951219512195122,0.00975609756097561,0.9902439024390244,205,5700,3800,1900,0.6666666666666666,76,38,38,215.14089110758312,0.4838305037462139,0.7938738617584451,0.12244983367746705,1056353.5973964361,-1247.0291462855262,1055106.5682501507,3136,0,319.45853658536583,76,129,43,39.34254939384304,0.5276422764227642,44.832251082251105,8279.679558853204,108.94315209017374,0
4818,32.86063465988402,1,0,204,0.004901960784313725,0.0,1.0,204,6450,5100,1350,0.7906976744186046,78,51,27,242.89188873352393,0.48358165105122514,0.8131904500635256,0.1394883571020583,1072644.129665199,4857.311718661458,1077501.4413838605,3137,0,319.27941176470586,65,139,37,38.28570582906088,0.534109477124183,44.491792929292934,8396.161845152512,129.17172069465403,8
4819,33.21964857750537,2,3,203,0.009708737864077669,0.014563106796116505,0.9854368932038835,206,7050,5200,1850,0.7375886524822695,89,52,37,229.87442465725772,0.483716650880101,0.8040334164133935,0.13154540529200942,1083221.567538771,1550.9869228613652,1084772.5544616324,3138,0,317.16990291262135,62,144,40,38.755935038307975,0.5279631877022654,44.62632275132274,8483.423814146308,136.8294163571985,8
4820,32.84938386689827,3,2,204,0.014563106796116505,0.009708737864077669,0.9902912621359223,206,6700,4700,2000,0.7014925373134329,87,47,40,224.5540897489678,0.4834561725471624,0.7965028306185251,0.12487012850060694,1061941.9837570328,-207.31689424517754,1061734.6668627877,3139,0,317.9611650485437,67,139,39,40.016278591079775,0.5233110841423948,45.72610294117647,8352.74085181747,124.66777390772344,8
4821,33.17921393251014,2,2,204,0.009708737864077669,0.009708737864077669,0.9902912621359223,206,6950,4600,2350,0.6618705035971223,93,46,47,222.7653728157925,0.48368853106006787,0.7952506050964065,0.12527920304857923,1076277.7238614154,-198.51831813576246,1076079.2055432796,3140,0,318.7718446601942,72,134,43,39.6170634920635,0.5265978964401294,45.291095890410965,8451.041219967283,117.3755724995456,0
4822,33.33967911597631,6,7,203,0.02857142857142857,0.03333333333333333,0.9666666666666667,210,7150,5300,1850,0.7412587412587412,90,53,37,214.2144559539319,0.4841179653679654,0.791890473274429,0.12188578626228903,1085285.1020764576,-2653.2484607569895,1082631.8536157005,3141,0,313.64285714285717,79,131,39,39.37793427230044,0.5301091269841269,44.843749999999986,8506.827499435798,107.68136075235188,0
4823,32.809848046868765,1,0,204,0.004901960784313725,0.0,1.0,204,5750,4200,1550,0.7304347826086957,73,42,31,220.62134067285865,0.4833960164525581,0.7951512263828049,0.12575574343435744,1068608.1122811022,601.5508770700108,1069209.6631581723,3142,0,323.4901960784314,64,140,40,39.14484700071164,0.5310968137254901,44.77564102564103,8373.87243580821,130.8417568095033,0
4824,32.71760247354684,0,1,203,0.0,0.004901960784313725,0.9950980392156863,204,6450,4700,1750,0.7286821705426356,82,47,35,219.17397143690982,0.4833436966740719,0.7942279260282616,0.12539727220117391,1066788.1259171467,-487.56195220018344,1066300.5639649464,3143,1,324.4901960784314,65,139,36,39.03687680263703,0.5325265522875817,44.63383838383838,8354.96856095308,128.53797786081662,0
4825,32.686027376950925,1,3,201,0.004901960784313725,0.014705882352941176,0.9852941176470589,204,6150,3900,2250,0.6341463414634146,84,39,45,216.63296173773094,0.48357863260246625,0.792211598500961,0.12474369372339908,1067795.852515254,-686.0443876711174,1067109.8081275828,3144,0,323.53921568627453,69,135,37,38.852523238439026,0.5346200980392157,44.38988095238094,8354.879349016133,121.08520795675555,0
4826,32.798522005495265,4,4,201,0.01951219512195122,0.01951219512195122,0.9804878048780488,205,6050,3900,2150,0.6446280991735537,82,39,43,211.96706963741045,0.48361928104575164,0.7889915247188997,0.12313051949352724,1074240.889716858,-1509.261304406566,1072731.6284124514,3145,0,322.74146341463415,73,132,38,38.63459282073848,0.536839430894309,44.05968468468469,8394.464063962776,114.99265841044898,0
4827,32.57442115042017,6,3,204,0.028985507246376812,0.014492753623188406,0.9855072463768116,207,5850,4000,1850,0.6837606837606838,77,40,37,209.86370903526233,0.48338883416975437,0.7892773633371128,0.12491179823588974,1074475.3529899635,-2151.3234309109257,1072324.0295590525,3146,0,320.14009661835746,74,133,46,37.76248670668178,0.5496678743961353,43.152777777777764,8366.649587982196,113.06283227002967,8
4828,32.184444747782194,1,5,200,0.004878048780487805,0.024390243902439025,0.975609756097561,205,7650,5700,1950,0.7450980392156863,96,57,39,207.90616849206825,0.4830523672883788,0.7854775176705096,0.12451436873163432,1063497.4321344395,-4428.464736755288,1059068.9673976842,3147,0,323.21463414634144,76,129,40,37.580031223140196,0.5514735772357724,42.924783549783534,8273.8230998661,108.86609341929079,0
4829,32.17287732081569,1,1,200,0.004975124378109453,0.004975124378109453,0.9950248756218906,201,7100,5200,1900,0.7323943661971831,90,52,38,213.90298385327517,0.48250310945273633,0.7890455688949412,0.128673370388169,1064458.2942957883,-1761.8389325526487,1062696.4553632357,3148,0,329.8358208955224,76,125,42,37.26005784906654,0.5531198175787728,42.762445887445885,8276.072270769884,108.89568777328795,0
4830,32.20937392003663,1,1,200,0.004975124378109453,0.004975124378109453,0.9950248756218906,201,5650,4100,1550,0.7256637168141593,72,41,31,215.10820293690935,0.48256944444444444,0.7891140452748686,0.1263597847604807,1058397.6137671056,-315.9982619689936,1058081.6155051365,3149,0,330.318407960199,66,135,42,38.126680413204724,0.5460717247097844,43.64116915422885,8257.15744041485,125.10844606689167,8
4831,32.35380075582331,2,2,200,0.009900990099009901,0.009900990099009901,0.9900990099009901,202,6050,4400,1650,0.7272727272727273,77,44,33,222.04227805171195,0.48253062246523165,0.7988678833793963,0.13017036546505809,1062519.599790762,734.8544824267901,1063254.4542731887,3150,0,329.65346534653463,61,141,39,38.025818364581966,0.5426980198019802,43.71639784946236,8291.748600963176,135.93030493382255,8
4832,32.73760327974724,1,1,200,0.004975124378109453,0.004975124378109453,0.9950248756218906,201,6350,4500,1850,0.7086614173228346,82,45,37,231.0670887851933,0.48257980928689886,0.8020307240473317,0.1303425236331532,1062923.9794272133,2571.3499052437105,1065495.329332457,3151,0,332.228855721393,67,134,35,39.286456767858944,0.5287624378109452,45.174632352941174,8342.371791645144,124.51301181559917,8
4833,32.654037448268966,2,3,199,0.009900990099009901,0.01485148514851485,0.9851485148514851,202,6950,4900,2050,0.7050359712230215,90,49,41,226.18357942430669,0.4824398018160025,0.8028660434203871,0.13051569655388162,1067410.1507613738,936.129722609443,1068346.2804839832,3152,0,329.04455445544556,64,138,41,38.52762979212366,0.5369740099009901,44.31089743589745,8349.281530242524,130.45752391003944,8
4834,32.18803232716553,3,1,201,0.01485148514851485,0.0049504950495049506,0.995049504950495,202,5900,4300,1600,0.7288135593220338,75,43,32,225.678803950706,0.4827348406482439,0.8022775114187628,0.13135740923748593,1054863.1768223168,1312.0520153806392,1056175.2288376975,3153,0,329.8217821782178,70,132,37,38.20702005730657,0.539397689768977,43.98474178403757,8240.62740770305,117.72324868147214,0
4835,32.07306933729245,0,3,198,0.0,0.014925373134328358,0.9850746268656716,201,6750,4800,1950,0.7111111111111111,87,48,39,231.35903079165564,0.48230203150912104,0.8072483353805391,0.13524472837807544,1052421.20170579,1747.4298422483935,1054168.6315480382,3154,1,332.46268656716416,70,131,40,37.89647881946435,0.5406301824212272,43.82335680751175,8216.371239707536,117.37673199582194,0
4836,32.32311655933887,1,4,195,0.005025125628140704,0.020100502512562814,0.9798994974874372,199,6600,4300,2300,0.6515151515151515,89,43,46,233.13916617888427,0.4819076442820161,0.8059795321040628,0.13731785338095998,1062959.8574756135,3163.514970698026,1066123.3724463114,3155,0,332.78391959798995,59,140,40,37.5626184673707,0.5430276381909548,43.541666666666664,8289.532600947108,140.50055255842557,0
4837,32.42341164930149,2,3,194,0.01015228426395939,0.015228426395939087,0.9847715736040609,197,6000,3600,2400,0.6,84,36,48,212.47208417280615,0.48169286750233087,0.7815235783123666,0.12541493817987756,1066924.4959501545,-61.66573809005149,1066862.8302120646,3156,0,336.9543147208122,64,133,45,38.010812302182224,0.5429357021996616,43.46153846153846,8317.852142340034,129.96643972406304,8
4838,32.06616273635128,6,3,197,0.03,0.015,0.985,200,5600,3700,1900,0.6607142857142857,75,37,38,223.75618305817335,0.48164939279731994,0.7969231438010784,0.13279894827322583,1056836.2348615355,1694.7284060378533,1058530.9632675734,3157,0,332.41,69,131,39,37.51418835371628,0.5453645833333334,43.258928571428584,8232.700977533783,119.31450692077946,8
4839,32.55488675668661,1,2,196,0.005050505050505051,0.010101010101010102,0.98989898989899,198,6900,5400,1500,0.782608695652174,84,54,30,223.633209523748,0.4809617964757558,0.793864529503187,0.13324937141958632,1074160.0770920159,1543.5731164728863,1075703.6502084888,3158,0,336.33838383838383,71,127,40,37.3685890215514,0.5475063131313131,43.11342592592593,8362.913328294677,117.78751166612221,0
4840,32.164248402658274,0,3,193,0.0,0.015306122448979591,0.9846938775510204,196,5700,3400,2300,0.5964912280701754,80,34,46,221.88616372925983,0.48034460579103433,0.7901776752209901,0.13251574568491847,1061978.6167870963,2227.672248278984,1064206.2890353752,3159,1,338.7755102040816,74,122,33,37.325919720390566,0.5494791666666667,43.027777777777786,8265.31838813868,111.69349173160377,0
4841,32.62783271850512,1,3,191,0.005154639175257732,0.015463917525773196,0.9845360824742269,194,6150,4300,1850,0.6991869918699187,80,43,37,224.19939605229857,0.4803284635792247,0.7906530909122471,0.1344701142557915,1078602.6038342516,3414.4104720150535,1082017.0143062668,3160,0,342.319587628866,76,118,35,37.105846968660664,0.5516537800687284,42.87067099567099,8389.572733774701,110.38911491808817,0
4842,33.053187774338255,2,3,190,0.010362694300518135,0.015544041450777202,0.9844559585492227,193,6050,4100,1950,0.6776859504132231,80,41,39,210.58166485883993,0.4801404181059297,0.7777432797728072,0.12269316091551251,1083534.7590920664,984.5107004058782,1084519.2697924722,3161,0,344.2746113989637,73,120,41,38.55506688656773,0.542206390328152,43.947072072072075,8463.365506970906,115.93651379412199,8
4843,32.90058475261517,1,1,190,0.005235602094240838,0.005235602094240838,0.9947643979057592,191,7900,6500,1400,0.8227848101265823,93,65,28,210.46892471155502,0.4793469275282447,0.7764018485836242,0.12343342548265118,1080598.3904777828,-613.5237422208384,1079984.866735562,3162,0,347.67539267015707,64,127,44,38.307645011359135,0.5448298429319371,43.70192307692307,8432.356601739968,131.755571902187,0
4844,33.20400570302425,0,4,186,0.0,0.021052631578947368,0.9789473684210527,190,6150,4000,2150,0.6504065040650406,83,40,43,217.6251424030443,0.47929256010396365,0.7795091429563292,0.12369214803110204,1080517.895442702,2879.5721729509464,1083397.467615653,3163,1,348.7473684210526,77,113,40,39.33320900731122,0.5359100877192983,44.88514957264956,8470.83494851589,110.01084348721936,8
4845,32.80314102864299,3,2,187,0.015873015873015872,0.010582010582010581,0.9894179894179894,189,5850,3800,2050,0.6495726495726496,79,38,41,222.00643903591686,0.479172529926076,0.7842333793420744,0.12765370244565213,1071164.296552601,3911.0742200111613,1075075.3707726123,3164,0,350.8994708994709,65,124,43,38.770946557971,0.5392967372134039,44.44444444444444,8383.024929542096,128.96961430064763,0
4846,32.28497480841361,2,3,186,0.010582010582010581,0.015873015873015872,0.9841269841269842,189,5700,4100,1600,0.7192982456140351,73,41,32,212.52802291247912,0.4793120755000188,0.7753173270800586,0.12041457734451493,1049618.253867003,1114.658461440511,1050732.9123284435,3165,0,351.70899470899474,72,117,41,39.58636448423802,0.5320767195767195,45.00570776255708,8232.484301175105,114.34005973854313,8
4847,31.87596837386565,0,1,185,0.0,0.005376344086021506,0.9946236559139785,186,5050,3300,1750,0.6534653465346535,68,33,35,210.58461959292907,0.4788306451612903,0.7697807781649237,0.11967878380825887,1037270.770957805,1436.6541434027567,1038707.4251012077,3166,1,357.71505376344084,74,112,43,39.516641260162594,0.5336581541218638,44.88888888888889,8131.913709599517,109.89072580539887,0
4848,32.086903991908564,0,1,184,0.0,0.005405405405405406,0.9945945945945946,185,5350,3600,1750,0.6728971962616822,71,36,35,211.32610701770645,0.47859136310223266,0.7695407239300369,0.12036400008399818,1044820.0022445377,1809.5487217139912,1046629.5509662516,3167,2,360.5027027027027,76,109,43,39.412262333898795,0.5351351351351351,44.80519480519481,8188.411213519533,107.74225280946753,0
4849,31.993561114098227,4,1,187,0.02127659574468085,0.005319148936170213,0.9946808510638298,188,6550,4700,1850,0.7175572519083969,84,47,37,199.10043090209936,0.47920814844312964,0.7583445293988313,0.11454192557181596,1044887.9602692258,-2542.471373196073,1042345.4888960297,3168,0,355.5744680851064,70,118,43,39.336371029468026,0.5386746453900709,44.424882629108,8176.7581368485,116.81083052640714,0
4850,32.35105250600484,1,0,188,0.005319148936170213,0.0,1.0,188,7500,5700,1800,0.76,93,57,36,196.25535958101773,0.47904933249895704,0.754987443865295,0.11364554543179917,1058604.9480333633,-3548.6210538933865,1055056.32697947,3169,0,354.31382978723406,72,116,44,39.15743994496503,0.5410017730496454,44.17808219178084,8276.108295200593,114.94594854445268,0
4851,32.644675247489566,3,2,189,0.015706806282722512,0.010471204188481676,0.9895287958115183,191,5500,4000,1500,0.7272727272727273,70,40,30,191.20295364310712,0.4794594470469367,0.75244752606009,0.1116356289304894,1070798.5222728858,-2752.0319569496164,1068046.4903159363,3170,0,349.73298429319374,78,113,41,38.97136422136425,0.543357329842932,43.868670886075975,8361.324059631987,107.19646230297418,0
4852,32.32820232069451,1,3,187,0.005263157894736842,0.015789473684210527,0.9842105263157894,190,4800,3100,1700,0.6458333333333334,65,31,34,208.1927516672697,0.47913881927039825,0.7698232323232326,0.11995868072256964,1056302.0461207088,1182.8859147275357,1057484.9320354364,3171,0,352.42105263157896,70,120,41,39.044086700336706,0.5412280701754386,44.36619718309859,8264.181297473315,118.05973282104735,8
4853,32.324954274280536,4,0,191,0.020942408376963352,0.0,1.0,191,5700,3800,1900,0.6666666666666666,76,38,38,199.83950006229367,0.47954326260677876,0.7597129431557352,0.1127931730165255,1049710.5273535831,-1945.2746007068977,1047765.2527528763,3172,0,350.36649214659684,77,114,36,40.0593787664414,0.5331042757417104,45.15224358974357,8237.942072864465,106.9862606865515,8
4854,32.19910346860218,4,6,189,0.020512820512820513,0.03076923076923077,0.9692307692307692,195,6250,4400,1850,0.704,81,44,37,218.71679356041227,0.47958630716362677,0.7829816994987768,0.1250080860729363,1049563.127200957,661.4163641263785,1050224.5435650833,3173,0,344.1589743589744,69,126,36,39.08818044061079,0.5384081196581196,44.672619047619044,8221.312757652908,119.14946025583924,8
4855,32.19811110498408,0,4,185,0.0,0.021164021164021163,0.9788359788359788,189,7000,5100,1900,0.7285714285714285,89,51,38,205.94527922086772,0.47921122743817784,0.765140545868596,0.11992075485803698,1055320.7857187584,-1332.33322351272,1053988.4524952457,3174,1,351.2010582010582,75,114,41,38.69646680942185,0.5450837742504409,43.96929824561405,8243.704981374798,109.91606641833064,8
4856,31.697528323502937,3,2,186,0.015957446808510637,0.010638297872340425,0.9893617021276596,188,5900,4400,1500,0.7457627118644068,74,44,30,221.3671020101346,0.478875701634619,0.7759248636786262,0.12478872355918538,1028950.8591433257,2055.1739598791532,1031006.0331032049,3175,0,353.218085106383,73,115,33,39.559451135296385,0.5313054078014184,45.199887387387385,8076.533786370019,110.63744912835642,8
4857,31.414989909486458,1,1,186,0.0053475935828877,0.0053475935828877,0.9946524064171123,187,5350,3900,1450,0.7289719626168224,68,39,29,218.26900271026315,0.478686293676806,0.7717402443798189,0.12384139672491391,1021765.0314319343,1853.9268829737325,1023618.9583149081,3176,0,355.3048128342246,77,110,37,39.38501413760602,0.5333667557932265,44.95192307692307,8012.332762972378,104.05626964899193,0
4858,31.552016600436392,2,3,185,0.010638297872340425,0.015957446808510637,0.9840425531914894,188,5150,3200,1950,0.6213592233009708,71,32,39,176.72820522640822,0.4792063706527098,0.7294634413207863,0.09996002318161085,1025262.6582817195,-6511.434103243233,1018751.2241784763,3177,0,354.3404255319149,81,107,41,40.56582619095075,0.5321919326241135,45.071138211382106,8043.519679084808,99.30271208746676,8
4859,31.779066701364698,3,1,187,0.015957446808510637,0.005319148936170213,0.9946808510638298,188,7150,5000,2150,0.6993006993006993,93,50,43,211.5050319999263,0.4793331863693253,0.7721148406408178,0.11724983583091543,1026369.7199387131,-1333.5279081217595,1025036.1920305914,3178,0,354.4840425531915,79,109,40,40.470876667178956,0.5236591312056738,45.84635416666664,8076.765663332461,102.23754004218306,8
4860,32.24972511371557,3,0,190,0.015789473684210527,0.0,1.0,190,5000,3500,1500,0.7,65,35,30,227.27939896721676,0.4793627587487237,0.7897072969630343,0.12512034263472438,1039349.982572015,4244.567871110941,1043594.550443126,3179,0,351.53684210526313,65,125,39,40.347196319781176,0.5200657894736842,46.11742424242424,8187.643279343886,125.96374275913671,8
4861,32.23378829900582,5,4,191,0.02564102564102564,0.020512820512820513,0.9794871794871794,195,5900,4100,1800,0.6949152542372882,77,41,36,214.6775425258829,0.48033417041149,0.7829422530288705,0.11952122021824224,1042422.0673845842,-143.07845982531126,1042278.9889247589,3180,0,343.4974358974359,60,135,44,40.219957922066286,0.5231303418803419,45.67964480874318,8197.708489362956,136.62847482271593,0
4862,32.24942527685213,3,1,193,0.015463917525773196,0.005154639175257732,0.9948453608247423,194,5900,3700,2200,0.6271186440677966,81,37,44,212.4706125045822,0.4803245686662037,0.7799598604326226,0.11944801713955898,1046006.9524567795,-250.85242549122404,1045756.1000312883,3181,0,344.97938144329896,64,130,43,39.89295601837285,0.5260416666666667,45.30448717948719,8213.783909054684,128.34037357897944,0
4863,32.03041963855234,1,3,191,0.005154639175257732,0.015463917525773196,0.9845360824742269,194,5450,3900,1550,0.7155963302752294,70,39,31,203.62369642202734,0.48031510959172413,0.7682337124268541,0.11392196516258671,1037383.5902632293,-2002.8237486096618,1035380.7665146197,3182,0,345.95360824742266,72,122,41,40.30845854825444,0.5251288659793815,45.49086757990866,8152.034313259375,113.2226987952691,8
4864,32.061595907229965,6,4,193,0.030456852791878174,0.02030456852791878,0.9796954314720813,197,5350,3900,1450,0.7289719626168224,68,39,29,198.1014664082948,0.48051771470009325,0.7677387111993017,0.11260232176784804,1043360.947742269,-3411.733251821576,1039949.2144904474,3183,0,341.5989847715736,79,118,41,39.82890360502899,0.528817681895093,44.8828125,8179.464174614021,103.53752119764584,0
4865,32.540957596214405,3,1,195,0.015306122448979591,0.00510204081632653,0.9948979591836735,196,6450,4600,1850,0.7131782945736435,83,46,37,197.19589064144856,0.4802541208791209,0.766930512373897,0.11301727755794577,1061571.8720095616,-3782.477843832779,1057789.394165729,3184,0,342.60714285714283,69,127,44,39.5314472278862,0.5310905612244898,44.568452380952394,8311.98715980688,120.46358202618667,0
4866,32.229083658872405,1,0,196,0.00510204081632653,0.0,1.0,196,6250,4400,1850,0.704,81,44,37,193.81966313587552,0.48031517094017095,0.763024337118696,0.11174509844287338,1053253.1264048277,-4621.766768681569,1048631.359636146,3185,0,341.0255102040816,71,125,46,39.388039254522454,0.5334289965986394,44.34317129629631,8239.585320253715,116.05049746836218,0
4867,31.752677536834558,5,3,198,0.024875621890547265,0.014925373134328358,0.9850746268656716,201,5300,3800,1500,0.7169811320754716,68,38,30,233.9981070849104,0.4806768242122719,0.8025801226425995,0.13597187303582645,1040084.6932682678,3175.5698865529357,1043260.2631548208,3186,0,333.51741293532336,69,132,34,38.05838178294572,0.5357587064676617,44.04761904761905,8127.173417165999,117.78512198791303,8
4868,31.395993125522324,2,2,198,0.01,0.01,0.99,200,5950,3500,2450,0.5882352941176471,84,35,49,224.78762552065902,0.4806407035175879,0.7864778067885116,0.12989387533858257,1026715.4913115951,208.58747544209655,1026924.0787870372,3187,0,336.035,77,123,39,38.50870322019148,0.5373958333333333,44.25747863247864,8029.290442758459,104.27649925660336,7
4869,31.115282686026024,4,3,199,0.019801980198019802,0.01485148514851485,0.9851485148514851,202,7150,4800,2350,0.6713286713286714,95,48,47,220.36163388107175,0.48059054972661447,0.7904011009824574,0.12747640457187198,1017865.6884276574,-2690.2907653195634,1015175.3976623378,3188,0,332.86633663366337,75,127,43,38.579510949165886,0.5365614686468647,44.21600877192985,7958.791193621465,106.11721591495287,8
4870,30.729796737778234,1,3,197,0.005,0.015,0.985,200,5850,3900,1950,0.6666666666666666,78,39,39,213.9364601431672,0.4807207914572864,0.7763765528340787,0.12347456130701326,1004571.870607964,-2867.0900085462936,1001704.7805994177,3189,0,335.4,80,120,41,38.832692082013125,0.53796875,44.30298353909466,7857.517342299983,98.21896677874979,8
4871,30.586679897128455,5,0,202,0.024752475247524754,0.0,1.0,202,6650,5100,1550,0.7669172932330827,82,51,31,200.8049203254516,0.4813607293565177,0.7622882407399754,0.11343941938496657,993529.5090662438,-7148.877218194127,986380.6318480497,3190,0,333.03465346534654,82,120,37,39.999815352799224,0.525680693069307,45.11797188755016,7795.995005406302,95.07310982202807,8
4872,30.899648325969054,1,4,199,0.0049261083743842365,0.019704433497536946,0.9802955665024631,203,6650,5000,1650,0.7518796992481203,83,50,33,198.57529919928132,0.48160838251312815,0.7603648008542125,0.11281504989443764,1005397.4559050929,-7320.579875890415,998076.8760292025,3191,0,332.38916256157637,84,119,39,39.83634383807322,0.5277093596059113,44.90196078431369,7882.439700408875,93.83856786201042,0
4873,31.08674239826911,2,5,196,0.009950248756218905,0.024875621890547265,0.9751243781094527,201,6000,4000,2000,0.6666666666666666,80,40,40,192.42994767470225,0.48161587893864016,0.7510060420508171,0.11006993006993025,1013540.8088364291,-7192.879037885839,1006347.9297985433,3192,0,335.9154228855721,76,125,37,39.72902097902097,0.5302135157545605,44.64285714285716,7938.221719558047,104.45028578365852,0
4874,31.340670730943135,3,1,198,0.01507537688442211,0.005025125628140704,0.9949748743718593,199,6200,4100,2100,0.6612903225806451,83,41,42,189.0622982668632,0.4811039625738118,0.7422512769964564,0.10922944291987174,1024849.5885832342,-7247.916280920937,1017601.6723023133,3193,0,339.57286432160805,82,117,40,39.42956519605437,0.5331344221105527,44.26455823293173,8014.920274653983,97.74293017870711,0
4875,31.409715992145294,0,4,194,0.0,0.020202020202020204,0.9797979797979798,198,6800,4600,2200,0.6764705882352942,90,46,44,204.21613042136448,0.4810130706387052,0.7616769562376249,0.11728272037323169,1025296.2536068598,-4523.59331057669,1020772.6602962831,3194,1,342.26262626262627,75,123,44,39.2722079176054,0.533827861952862,44.49013157894739,8025.4924002957305,107.00656533727641,8
4876,31.790640629111177,3,4,193,0.015228426395939087,0.02030456852791878,0.9796954314720813,197,5850,4100,1750,0.7008547008547008,76,41,35,188.2651630655106,0.4808878500638834,0.7529761921015345,0.10612035722825484,1031949.423890996,-6393.974687160366,1025555.4492038357,3195,0,343.53299492385787,75,122,39,40.40590819436974,0.5284475465313029,45.202850877192986,8100.164601085215,108.00219468113619,8
4877,32.1868182164174,5,4,194,0.025252525252525252,0.020202020202020204,0.9797979797979798,198,6100,4000,2100,0.6557377049180327,82,40,42,234.84299852248324,0.4814109795074262,0.7974429877235647,0.13371334364241313,1047967.9386678664,3521.5866144375314,1051489.525282304,3196,0,339.85353535353534,78,120,39,38.825268261595966,0.5333543771043772,44.81803797468355,8213.495423817598,105.3012233822769,8
4878,32.01015583145056,4,1,197,0.020202020202020204,0.005050505050505051,0.9949494949494949,198,6650,4900,1750,0.7368421052631579,84,49,35,202.66686164661232,0.48130736296979953,0.7693971603992789,0.11523364989715874,1041785.2237413552,-4022.931638905044,1037762.2921024502,3197,0,339.7020202020202,78,120,41,39.70015676951438,0.5348274410774411,44.87078059071731,8166.726070447505,104.70161628778853,8
4879,31.943788907273543,1,4,194,0.005050505050505051,0.020202020202020204,0.9797979797979798,198,5950,3700,2250,0.6218487394957983,82,37,45,197.42207697222008,0.4811246987642927,0.7634345240514215,0.11294966398640874,1041550.1539813778,-4425.001066051947,1037125.152915326,3198,0,340.66161616161617,72,126,41,39.59322846818657,0.5367213804713804,44.63470319634705,8157.335135339178,113.29632132415526,0
4880,31.989465704829982,3,5,192,0.015228426395939087,0.025380710659898477,0.9746192893401016,197,6150,4400,1750,0.7154471544715447,79,44,35,211.96392908045425,0.4807637522013882,0.785903883123898,0.12166666538451638,1044053.6710430331,-1289.656342969217,1042764.014700064,3199,0,336.6497461928934,62,135,41,39.095127923030475,0.5362732656514382,44.51058201058202,8172.969974719473,131.8220963664431,8
4881,31.792409939066253,3,3,192,0.015384615384615385,0.015384615384615385,0.9846153846153847,195,5250,3300,1950,0.6285714285714286,72,33,39,184.6031980477173,0.4802262313860252,0.7433659131040309,0.10656545195251797,1039368.947884924,-5875.833653790316,1033493.1142311337,3200,0,340.5487179487179,83,112,44,39.57525056579374,0.5402243589743589,44.29563492063493,8129.45799781186,97.9452770820706,8
4882,31.526920887323556,1,6,187,0.0051813471502590676,0.031088082901554404,0.9689119170984456,193,6700,4400,2300,0.6567164179104478,90,44,46,184.03905623443663,0.4802168789579735,0.7401099144975933,0.10685796150528812,1032452.4969748176,-7297.683369973172,1025154.8136048444,3201,0,343.7616580310881,85,108,35,39.36705278684902,0.5429080310880829,44.07703488372095,8068.463074470249,94.92309499376763,0
4883,31.881162337673878,0,5,182,0.0,0.026737967914438502,0.9732620320855615,187,5800,4500,1300,0.7758620689655172,71,45,26,185.3193295103462,0.4791151553485519,0.7345582601749585,0.10789912230881638,1044900.5526024651,-4471.94603734397,1040428.6065651212,3202,2,353.2085561497326,83,104,37,39.22854305918825,0.5445075757575757,43.973214285714306,8162.431518150034,98.3425484114462,0
4884,31.957962367436437,2,2,182,0.010869565217391304,0.010869565217391304,0.9891304347826086,184,6300,4500,1800,0.7142857142857143,81,45,36,193.16796427248516,0.47804122614239325,0.7428210775935271,0.11513220576134595,1054557.0470905518,-2358.672400862938,1052198.374689689,3203,0,359.04891304347825,81,103,37,38.13969036905172,0.5558763586956521,43.10213414634146,8209.932329225956,101.35718924970315,7
4885,31.76777994131868,2,2,182,0.010869565217391304,0.010869565217391304,0.9891304347826086,184,6500,4800,1700,0.7384615384615385,82,48,34,193.50667765133093,0.4776075077215491,0.7446973255438456,0.11602566380632401,1050079.113315467,-2660.535902253823,1047418.5774132132,3204,0,359.94565217391306,83,101,40,37.906538374971845,0.5584239130434783,42.881944444444436,8168.069807828617,98.41047961239298,0
4886,31.617481700680933,1,3,180,0.00546448087431694,0.01639344262295082,0.9836065573770492,183,5900,4100,1800,0.6949152542372882,77,41,36,227.7182685815485,0.4771837907083809,0.778927098244186,0.13389432484513727,1039235.0308669974,4830.5603756648325,1044065.5912426623,3205,0,362.8087431693989,64,119,38,37.7672042002625,0.5480988160291439,43.60576923076922,8106.539899506299,126.66468592978592,8
4887,31.575170695058606,1,1,180,0.0055248618784530384,0.0055248618784530384,0.994475138121547,181,5350,3700,1650,0.6915887850467289,70,37,33,224.57924056129963,0.4768927767546552,0.7730313906759168,0.13267998942367543,1039281.4723042175,5130.208755901993,1044411.6810601195,3206,0,366.8453038674033,67,114,40,37.666241268135394,0.5502417127071824,43.4283088235294,8101.294944416898,120.91484991667012,0
4888,31.294414040320113,1,1,180,0.0055248618784530384,0.0055248618784530384,0.994475138121547,181,6600,5100,1500,0.7727272727272727,81,51,30,225.13097120487166,0.47666385307959896,0.7727028513237015,0.13374888859564335,1031699.0342826499,3653.4811158360967,1035352.5153984859,3207,0,367.8066298342541,70,111,41,37.44095912848055,0.5523710865561695,43.22183098591548,8035.72233764203,114.79603339488614,0
4889,31.807905389472314,0,1,179,0.0,0.005555555555555556,0.9944444444444445,180,5250,3900,1350,0.7428571428571429,66,39,27,224.60688796842166,0.4762440513138837,0.771223799000359,0.13392029769067787,1049717.651014055,5904.7629679575275,1055622.4139820123,3208,1,370.71666666666664,73,107,41,37.31798942523696,0.5541666666666667,43.088400900900886,8171.819837602154,111.94273750139936,0
4890,32.15081219057882,3,3,179,0.016483516483516484,0.016483516483516484,0.9835164835164835,182,5500,3400,2100,0.6181818181818182,76,34,42,221.28582540693046,0.4763618632748467,0.7700149650463766,0.13306856956487248,1063623.548174077,5172.962955989487,1068796.5111300664,3209,0,361.3791208791209,77,105,44,37.083084557741884,0.5568337912087913,42.77510683760682,8269.98923080576,107.40245754293196,0
4891,32.40987548210298,2,2,179,0.011049723756906077,0.011049723756906077,0.988950276243094,181,5450,3700,1750,0.6788990825688074,72,37,35,194.68897653788284,0.47628913443830573,0.7376654192824605,0.11477646288187664,1066097.63177939,-138.50863588233233,1065959.1231435076,3210,0,363.4806629834254,72,109,40,38.51379230412609,0.5534069981583793,43.50742009132417,8312.892576923463,115.45684134615921,8
4892,32.40683162622927,1,2,178,0.005555555555555556,0.011111111111111112,0.9888888888888889,180,5850,4200,1650,0.717948717948718,75,42,33,215.28161523570648,0.47577462238775087,0.7592197859965053,0.12508988207769156,1061496.6118633617,3854.141033835129,1065350.752897197,3211,0,366.4555555555556,79,101,35,38.53933501212463,0.5501157407407408,44.049479166666686,8294.545433291569,104.99424599103251,8
4893,32.01605665522647,2,2,178,0.011111111111111112,0.011111111111111112,0.9888888888888889,180,5850,4500,1350,0.7692307692307693,72,45,27,215.48868864567314,0.47538860438650943,0.7599689929727791,0.1258517476439227,1050268.2944256873,3414.187498383843,1053682.4819240712,3212,0,365.18888888888887,86,94,38,38.33818305053055,0.5526041666666667,43.85775862068966,8200.6645117967,95.3565640906593,0
4894,31.92279363882444,2,3,177,0.011111111111111112,0.016666666666666666,0.9833333333333333,180,5550,4200,1350,0.7567567567567568,69,42,27,223.1657923349405,0.4751176805296917,0.7658738514548236,0.1301136271381399,1046687.1597645176,5166.953867131594,1051854.1136316492,3213,0,366.03333333333336,84,96,35,38.20677402373662,0.5524305555555555,43.921568627450995,8174.738920059785,97.3183204769022,8
4895,31.591706887078253,0,4,173,0.0,0.022598870056497175,0.9774011299435028,177,5550,3200,2350,0.5765765765765766,79,32,47,210.93892811551606,0.474768875192604,0.7509073428824691,0.11782855576687476,1022684.9277706933,2194.812492768739,1024879.7402634621,3214,1,373.12994350282486,73,104,38,40.1844987829166,0.5354284369114878,45.5518018018018,8038.452895422665,110.11579308798171,8
4896,31.515103902907338,3,0,176,0.017045454545454544,0.0,1.0,176,5400,3600,1800,0.6666666666666666,72,36,36,223.838441274503,0.4753503787878788,0.7684174863444637,0.12293594041444275,1014937.974136609,4836.426824207694,1019774.4009608167,3215,0,375.4943181818182,71,105,37,40.528683540455276,0.5242660984848485,46.20949074074071,7998.234268877255,112.65118688559514,8
4897,31.44280167718248,7,4,179,0.03825136612021858,0.02185792349726776,0.9781420765027322,183,5350,3800,1550,0.7102803738317757,69,38,31,211.6125051578961,0.4770174042715027,0.7590993713557566,0.11942560412198196,1021031.6742233308,1262.6140855918684,1022294.2883089227,3216,0,362.09289617486337,79,104,36,39.763437563866745,0.5368283242258651,45.15624999999999,8013.001489919457,101.4303986065754,8
4898,31.138087474850273,2,1,180,0.011049723756906077,0.0055248618784530384,0.994475138121547,181,6550,5100,1450,0.7786259541984732,80,51,29,215.6676859167988,0.4767457028852056,0.7623693512986032,0.1223684808969575,1012766.3325306985,934.1942622676052,1013700.5267929661,3217,0,367.060773480663,84,97,41,39.450397206739694,0.5391919889502763,44.95098039215685,7941.738682923793,94.54450813004516,0
4899,31.616494944417983,2,1,181,0.01098901098901099,0.005494505494505495,0.9945054945054945,182,5750,4300,1450,0.7478260869565218,72,43,29,212.5183434133974,0.4773547699997976,0.7623001503703046,0.12138308581535324,1030364.4277691657,1644.2682603194044,1032008.6960294851,3218,0,365.55494505494505,66,116,41,39.27275541481438,0.5414949633699634,44.698383084577124,8071.742280508221,122.29912546224577,0
4900,31.23146874115508,0,2,179,0.0,0.011049723756906077,0.988950276243094,181,5650,3800,1850,0.672566371681416,75,38,37,213.88241924446024,0.47716134642930225,0.7609655921671501,0.12284981931809927,1019516.3946729333,1761.3265904074628,1021277.7212633407,3219,1,367.9447513812155,67,114,40,39.0202837729816,0.5435658379373849,44.485294117647065,7980.099549670154,119.10596342791276,0
4901,31.301296603715034,4,2,181,0.02185792349726776,0.01092896174863388,0.9890710382513661,183,4500,3000,1500,0.6666666666666666,60,30,30,209.75898408175777,0.47720005404431637,0.7598531715893297,0.12188036596937146,1025283.0133297481,1912.4646544663947,1027195.4779842144,3220,0,364.6666666666667,72,111,39,38.68086915314715,0.5465619307832423,44.049657534246585,8011.577585343006,111.27191090754175,0
4902,30.973519573677763,1,0,182,0.005494505494505495,0.0,1.0,182,5100,3600,1500,0.7058823529411765,66,36,30,207.80736728440831,0.47724599295731895,0.756256553613827,0.11772584224329218,1006945.2990881386,350.1303205832137,1007295.4294087219,3221,0,365.8076923076923,80,102,40,39.71141399367894,0.5387477106227105,45.0102880658436,7897.928833679005,98.72411042098756,8
4903,31.34356653558142,1,1,182,0.00546448087431694,0.00546448087431694,0.994535519125683,183,6250,4700,1550,0.752,78,47,31,207.88188277463647,0.4767947216717709,0.7579328051677072,0.11829561558905834,1020340.4495609376,-427.94125483110474,1019912.5083061064,3222,0,364.8032786885246,86,97,42,39.535236106549014,0.5404713114754098,44.83955938697315,7997.638247602599,92.9957935767744,0
4904,31.341038751268915,4,2,184,0.021505376344086023,0.010752688172043012,0.989247311827957,186,6350,4700,1650,0.7401574803149606,80,47,33,203.51647482298947,0.4776990700377797,0.7586866842496778,0.11474865069806844,1017439.1856082922,-2136.872719645415,1015302.3128886468,3223,0,357.66129032258067,77,109,39,40.0065513626834,0.5337141577060932,45.192307692307686,7985.9377587367835,103.713477386192,8
4905,31.52232876297307,6,3,187,0.031578947368421054,0.015789473684210527,0.9842105263157894,190,5200,3700,1500,0.7115384615384616,67,37,30,195.7563953841673,0.4786027568922306,0.7546109819519518,0.11180129693825343,1027273.8431337237,-2980.9150791399265,1024292.9280545838,3224,0,350.9684210526316,68,122,42,39.703447460232994,0.5371710526315789,44.70108695652178,8047.616269786277,118.34729808509232,0
4906,31.52454843704063,2,2,187,0.010582010582010581,0.010582010582010581,0.9894179894179894,189,5850,4000,1850,0.6837606837606838,77,40,37,193.13174473782487,0.47858972194078575,0.7492131093849337,0.11118852951646968,1029790.7741929207,-3872.942213040747,1025917.8319798799,3225,0,352.73015873015873,73,116,42,39.461027279068894,0.5396825396825398,44.39752252252256,8057.7526818664055,110.38017372419733,0
4907,31.21063551098056,4,3,188,0.020942408376963352,0.015706806282722512,0.9842931937172775,191,5450,3600,1850,0.6605504587155964,73,36,37,197.5363609065643,0.4789531092128226,0.7567166981667819,0.11029163655737102,1010208.8029751172,-3739.4058609038893,1006469.3971142133,3226,0,349.76439790575915,74,117,44,40.54351583965644,0.5284685863874345,45.569444444444436,7940.939332300719,107.30999097703675,8
4908,30.946214600586355,5,3,190,0.025906735751295335,0.015544041450777202,0.9844559585492227,193,5550,3800,1750,0.6846846846846847,73,38,35,192.6911600038324,0.47961643638457113,0.7523582994504057,0.1085260574736608,1004290.1323077431,-5446.433885043796,998843.6984226992,3227,0,346.7823834196891,79,114,38,40.325266618964875,0.531034110535406,45.23437499999999,7884.031704102491,99.79786967218342,0
4909,30.595322570713538,5,3,192,0.02564102564102564,0.015384615384615385,0.9846153846153847,195,5850,4500,1350,0.7692307692307693,72,45,27,190.12725035584998,0.4797812582606397,0.7518441915291258,0.1078716457398276,995098.10373712,-7010.946740428318,988087.1569966917,3140,0,327.65128205128207,83,112,43,40.103736163109204,0.5336004273504273,44.95287698412697,7803.248999403059,94.01504818557903,0
4910,30.267787671239795,2,3,191,0.010309278350515464,0.015463917525773196,0.9845360824742269,194,5700,4200,1500,0.7368421052631579,72,42,30,209.2796334927708,0.48008364047504587,0.7662775029596269,0.11582113895544176,977056.9697440035,-3604.375094082984,973452.5946499205,3141,0,330.1443298969072,92,102,41,40.594188523988024,0.5246993127147767,45.91173835125451,7690.689553338739,83.59445166672542,8
4911,30.17303373255411,2,2,191,0.010362694300518135,0.010362694300518135,0.9896373056994818,193,6150,4200,1950,0.6829268292682927,81,42,39,238.0182982225923,0.4803967868451353,0.7986872144015205,0.13091364539916717,972151.1929430792,1527.9545118749938,973679.1474549541,3142,0,330.11917098445593,74,119,35,40.11074939359124,0.5182426597582037,46.152777777777786,7659.340799026284,103.50460539224709,8
4912,29.806375663981484,6,1,196,0.030456852791878174,0.005076142131979695,0.9949238578680203,197,5900,4000,1900,0.6779661016949152,78,40,38,207.14707978178356,0.4814360388825581,0.7709929403809872,0.1130326454809274,957985.8066326634,-5611.207536729475,952374.5990959338,3143,0,324.1218274111675,75,122,36,41.21188777165099,0.5156514382402707,46.463815789473685,7556.994750991364,100.75993001321818,8
4913,29.419941099552826,7,7,196,0.034482758620689655,0.034482758620689655,0.9655172413793104,203,5550,3600,1950,0.6486486486486487,75,36,39,209.44913166121043,0.48241009445772165,0.7788351821406079,0.11589592283981076,949640.4192644309,-6369.727758935269,943270.6915054956,3144,0,315.4679802955665,85,118,37,40.59639724460123,0.5193965517241379,45.91812015503877,7475.073939502447,87.94204634708761,0
4914,29.08513794739677,3,3,196,0.01507537688442211,0.01507537688442211,0.9849246231155779,199,6200,4500,1700,0.7258064516129032,79,45,34,211.1649683273895,0.48207895538297546,0.7766969709868063,0.11739836327785892,940188.6208487735,-6293.019931339295,933895.6009174342,3145,0,322.3467336683417,73,126,39,40.365606949749974,0.5218278894472361,45.7347972972973,7395.338495830911,101.30600679220426,0
4915,29.494588306994036,2,4,194,0.010101010101010102,0.020202020202020204,0.9797979797979798,198,7400,4800,2600,0.6486486486486487,100,48,52,198.70018352424697,0.482387859132783,0.7664941563905294,0.11253696624431948,958789.9401304002,-8897.652586977569,949892.2875434227,3146,0,323.44444444444446,81,117,41,39.95387438554536,0.5300399831649831,45.02032520325203,7520.520534781297,92.84593252816416,8
4916,29.257988201747803,2,4,192,0.01020408163265306,0.02040816326530612,0.9795918367346939,196,6800,5100,1700,0.75,85,51,34,199.35619116441518,0.48233091313448456,0.7660701577311779,0.11363234693774713,952919.6927941691,-8005.911911797668,944913.7808823714,3147,0,327.3775510204082,67,129,43,39.68830652421823,0.5324723639455782,44.77634803921572,7467.330597875682,111.45269549068182,0
4917,29.818894841834474,3,1,194,0.015384615384615385,0.005128205128205128,0.9948717948717949,195,6650,4900,1750,0.7368421052631579,84,49,35,191.33234227342922,0.48233434663847036,0.7552034900407534,0.11011565030543194,973976.6510960904,-8379.353205230764,965597.2978908597,3148,0,329.05128205128204,70,125,46,39.5199519736716,0.5360042735042735,44.410211267605646,7621.405032857991,108.87721475511415,0
4918,29.861711834473542,2,3,193,0.01020408163265306,0.015306122448979591,0.9846938775510204,196,5500,3500,2000,0.6363636363636364,75,35,40,192.36530007379133,0.4824819030176173,0.7621066383643011,0.10968914982931094,972692.7849429615,-7277.532108967032,965415.2528339945,3149,0,327.8673469387755,69,127,41,39.852009483830834,0.5352891156462585,44.761904761904766,7621.846449179922,110.461542741738,7
4919,30.043146325109575,8,2,199,0.03980099502487562,0.009950248756218905,0.9900497512437811,201,5500,3700,1800,0.6727272727272727,73,37,36,197.4686622490529,0.4833602819237148,0.7653105926501258,0.11410863328910154,982477.2349933588,-6898.306943142492,975578.9280502164,3150,0,320.60696517412936,75,126,47,39.20700689568931,0.5398009950248757,44.257127192982466,7683.320549345138,102.4442739912685,8
4920,30.431372621324925,4,4,199,0.019704433497536946,0.019704433497536946,0.9802955665024631,203,6750,5500,1250,0.8148148148148148,80,55,25,194.2343533581153,0.48282873238062723,0.765347444659541,0.11337061514997468,998108.6651617266,-8576.601768235887,989532.0633934907,3151,0,318.3448275862069,79,124,39,38.905482121674304,0.5427442528735632,43.88020833333335,7794.076815904486,98.6592002013226,0
4921,30.504973441249973,2,2,199,0.009950248756218905,0.009950248756218905,0.9900497512437811,201,5900,3800,2100,0.6440677966101694,80,38,42,196.71347264467397,0.4820999170812604,0.7680092511860377,0.11501492807744178,1001024.9529415816,-6716.98106057784,994307.9718810038,3152,0,322.46268656716416,78,123,42,38.776442431416996,0.5435841625207296,43.815928270042214,7814.888304193685,100.19087569479083,0
4922,30.853261073078336,3,3,199,0.01485148514851485,0.01485148514851485,0.9851485148514851,202,6950,4600,2350,0.6618705035971223,93,46,47,203.60913220622217,0.48193233502454724,0.7809668405666019,0.1166471009742192,1006397.4878619445,-6367.656168381336,1000029.8316935631,3153,0,321.24257425742576,69,133,44,39.382816748232756,0.5379537953795379,44.58333333333334,7880.437099082111,114.20923332003059,8
4923,30.68157671134106,5,4,200,0.024509803921568627,0.0196078431372549,0.9803921568627451,204,6750,4700,2050,0.6962962962962963,88,47,41,219.46093799486758,0.48242005135387483,0.7959173136573081,0.12495734268671922,998964.0036913845,-3703.2845453559194,995260.7191460285,3154,0,318.97549019607845,80,124,42,39.21712526667678,0.5364072712418301,44.817386831275726,7829.404921336698,97.86756151670872,8
4924,31.02420099121332,3,2,201,0.014778325123152709,0.009852216748768473,0.9901477832512315,203,5700,3900,1800,0.6842105263157895,75,39,36,239.21308646894394,0.4818156692516542,0.8061096833144124,0.1349106657693729,1007232.709604878,1888.6490514121551,1009121.3586562901,3155,0,321.1182266009852,71,132,35,39.08671861693066,0.5300184729064039,45.18229166666667,7905.5157994537185,111.34529295005237,8
4925,31.508593919332313,3,2,202,0.014705882352941176,0.00980392156862745,0.9901960784313726,204,6450,4400,2050,0.6821705426356589,85,44,41,209.13913146936295,0.4821765631539972,0.7858431372549017,0.11612546574003146,1018135.8066057686,-4663.592337721799,1013472.2142680468,3156,0,320.4362745098039,62,142,43,40.46707317073173,0.5186376633986929,45.78373015873018,8009.997214116019,129.19350345348417,8
4926,31.26503423370722,8,3,207,0.0380952380952381,0.014285714285714285,0.9857142857142858,210,7200,5200,2000,0.7222222222222222,92,52,40,211.93885352641368,0.48332383990278727,0.7945435581063109,0.11713178290418401,1008823.931562558,-6438.202506924788,1002385.7290556333,3157,0,312.12857142857143,78,132,41,40.58120523201493,0.5167658730158731,45.96518987341769,7942.4070351608425,101.8257312200108,8
4927,31.38223679067071,4,2,209,0.018957345971563982,0.009478672985781991,0.990521327014218,211,6700,4600,2100,0.6865671641791045,88,46,42,218.1777046953479,0.4833775295268186,0.7958724007602755,0.1207464472327008,1013034.0908354601,-4695.709456676081,1008338.3813787841,3158,0,311.5260663507109,79,132,39,40.36781285231116,0.5190067140600316,45.91145833333334,7973.866780379557,100.93502253645009,7
4928,31.458320145260704,6,4,211,0.027906976744186046,0.018604651162790697,0.9813953488372094,215,8150,6300,1850,0.7730061349693251,100,63,37,220.7262443880048,0.4838395638629283,0.8084821065308303,0.12232269377358546,1015911.5321967003,-6302.332573551632,1009609.1996231487,3159,0,306.5860465116279,81,134,42,40.24917524742576,0.5197189922480621,45.85873983739838,7994.857124315131,98.70193980635965,7
4929,31.259150977151084,2,6,207,0.009389671361502348,0.028169014084507043,0.971830985915493,213,6550,4700,1850,0.7175572519083969,84,47,37,230.65752703872514,0.4837895296306139,0.81399177878526,0.1261386603614726,1005362.7344489549,-2771.1035790226288,1002591.6308699324,3160,0,309.61502347417843,66,147,40,40.5274934101637,0.5100743348982786,46.37748756218906,7928.02440749792,120.12158193178666,8
4930,31.596332636326487,7,4,210,0.03271028037383177,0.018691588785046728,0.9813084112149533,214,6600,4500,2100,0.6818181818181818,87,45,42,223.36623123809972,0.4842591373787899,0.8086781029857868,0.12402024942702111,1020958.6446248892,-3790.463060035736,1017168.1815648535,3161,0,308.2943925233645,64,150,38,40.10695749017631,0.5145054517133956,45.78525641025643,8032.253599520027,125.50396249250042,0
4931,31.191336672179894,3,5,208,0.014084507042253521,0.023474178403755867,0.9765258215962441,213,6400,4800,1600,0.75,80,48,32,220.37766561784565,0.48428595683113357,0.8060699018067583,0.12307197316266465,1009651.9791498338,-4499.050749704136,1005152.9284001297,3162,0,309.4319248826291,64,149,41,39.953627889399755,0.5162852112676056,45.56089743589746,7936.295710644282,124.0046204788169,0
4932,31.310333452804166,5,4,209,0.023474178403755867,0.018779342723004695,0.9812206572769953,213,6750,4500,2250,0.6666666666666666,90,45,45,211.99430872778254,0.4847427067646972,0.7942127767953195,0.11911298005657425,1015374.408385236,-6299.280838898378,1009075.1275463377,3163,0,309.3192488262911,75,138,40,39.92726665231511,0.5227895148669797,45.32620614035086,7973.921407436286,106.31895209915048,7
4933,31.560963399168138,6,6,209,0.027906976744186046,0.027906976744186046,0.9720930232558139,215,7500,5600,1900,0.7466666666666667,94,56,38,206.96219718914207,0.4849815257552706,0.7897617448981689,0.11769044347621273,1027203.9688267168,-7981.521930043485,1019222.4468966733,3164,0,307.27441860465115,83,132,39,39.5857635851074,0.5267926356589148,44.8660714285714,8052.272581528767,97.0153323075755,0
4934,31.72394632029516,3,2,210,0.014150943396226415,0.009433962264150943,0.9905660377358491,212,7350,5300,2050,0.7210884353741497,94,53,41,213.527860044165,0.4841859109064353,0.7979114455409231,0.12094570534208929,1031288.1605093268,-5708.249199511811,1025579.911309815,3165,0,312.54716981132077,73,139,36,39.57229214971845,0.5271717767295597,45.0168918918919,8089.070434203663,110.80918403018717,8
4935,31.354919524493273,1,5,206,0.004739336492890996,0.023696682464454975,0.976303317535545,211,6450,4200,2250,0.6511627906976745,87,42,45,207.71560162486537,0.4840526969081471,0.7928053682010219,0.11792211976043945,1019988.831523591,-6276.481241887096,1013712.3502817039,3166,0,314.6729857819905,82,129,37,39.63151118546216,0.5320892575039494,44.92971887550198,7997.7081377484465,97.533026070103,8
4936,31.151797084085967,3,6,203,0.014354066985645933,0.028708133971291867,0.9712918660287081,209,6550,4800,1750,0.732824427480916,83,48,35,221.70551028811514,0.48364752024291496,0.7922929096227309,0.12488506864707985,1011005.2288590391,-3520.913966371403,1007484.3148926677,3167,0,317.3636363636364,80,129,30,39.58049400164888,0.5264653110047847,45.228909465020536,7936.577315236876,99.20721644046094,8
4937,31.4902175771437,0,5,198,0.0,0.024630541871921183,0.9753694581280788,203,5800,3800,2000,0.6551724137931034,78,38,40,212.55971472551624,0.4827840234762393,0.780803100052351,0.11876506659000158,1019480.7323326882,-3059.8932734409564,1016420.8390592472,3168,1,327.39408866995075,74,129,42,40.132907592380285,0.5257594417077176,45.541666666666636,8012.948280983957,108.28308487816159,8
4938,31.811705773072507,4,4,198,0.019801980198019802,0.019801980198019802,0.9801980198019802,202,5900,3700,2200,0.6271186440677966,81,37,44,208.93671632472612,0.4832910529858956,0.7761130221518369,0.1177088422081094,1032465.2238526942,-3156.021281749164,1029309.202570945,3169,0,318.43564356435644,81,121,46,39.90036231884057,0.5288778877887789,45.223577235772346,8104.872598891512,100.06015554187051,0
4939,32.17253274379577,2,6,194,0.01,0.03,0.97,200,7700,6000,1700,0.7792207792207793,94,60,34,209.8279897685991,0.48321398659966497,0.7767546192941632,0.11891005837411305,1046029.3449480096,-3802.7530621190563,1042226.5918858906,3170,0,321.72,85,115,33,39.64691294985669,0.5317708333333333,44.99757751937983,8204.073787004956,96.51851514123477,0
4940,31.898850536047593,3,5,192,0.015228426395939087,0.025380710659898477,0.9746192893401016,197,5900,4600,1300,0.7796610169491526,72,46,26,208.7463556851306,0.4825917676715356,0.7748886356573068,0.1189368770764119,1038806.6967373377,-1930.5775589543464,1036876.1191783834,3171,0,326.48223350253807,74,123,38,39.464285714285666,0.5338409475465313,44.79166666666667,8140.852480553831,110.01152000748421,0
4941,32.06357582427013,5,1,196,0.025380710659898477,0.005076142131979695,0.9949238578680203,197,6350,4800,1550,0.7559055118110236,79,48,31,211.6495042560506,0.4824266635588246,0.774490610356007,0.1225622099011161,1049204.015708351,-1337.298042373809,1047866.7176659772,3172,0,326.8578680203046,77,120,42,38.762876731398315,0.5381768189509306,44.17735042735044,8202.588922138371,106.52712885893989,0
4942,31.69756665493184,2,2,196,0.010101010101010102,0.010101010101010102,0.98989898989899,198,5400,4000,1400,0.7407407407407407,68,40,28,221.652789337888,0.4822174793621494,0.790365427980106,0.1271587054622627,1034359.4680313796,853.7322534421542,1035213.2002848218,3173,0,326.1666666666667,67,131,39,38.86871389738365,0.5341961279461279,44.53125000000002,8097.737731377162,120.86175718473376,8
4943,31.94389428755786,3,4,195,0.01507537688442211,0.020100502512562814,0.9798994974874372,199,7050,5400,1650,0.7659574468085106,87,54,33,221.95425327409913,0.48253155508180634,0.791669333679756,0.12710330342900883,1041841.9255485078,-601.7506770462824,1041240.1748714616,3174,0,325.3718592964824,64,135,43,38.93063311790173,0.5340766331658291,44.59935897435897,8158.491077897583,127.47642309214973,8
4944,32.16072267082086,2,2,195,0.01015228426395939,0.01015228426395939,0.9898477157360406,197,6000,4300,1700,0.7166666666666667,77,43,34,218.52858508482785,0.482263717669809,0.7873187320945694,0.12610980731319177,1051312.292370399,548.3575467982137,1051860.6499171972,3175,0,328.43654822335026,70,127,42,38.71989996939789,0.5368020304568528,44.307511737089214,8223.25520403562,117.475074343366,8
4945,32.62152027086946,2,5,192,0.01015228426395939,0.025380710659898477,0.9746192893401016,197,6800,4800,2000,0.7058823529411765,88,48,40,226.01806975705347,0.48218925895231185,0.7901807491242818,0.12987280129581166,1065020.762272046,1942.7873879827248,1066963.5496600287,3176,0,327.5888324873096,67,130,40,38.69453519972827,0.5328362944162437,44.469975490196084,8335.777874362348,124.41459513973653,8
4946,32.874779267237884,6,1,197,0.030303030303030304,0.005050505050505051,0.9949494949494949,198,5800,4500,1300,0.7758620689655172,71,45,26,234.2943883444874,0.4822895836537968,0.8040410433816272,0.1326752093528458,1068619.8885327468,4674.3286313066565,1073294.2171640536,3177,0,315.25757575757575,70,128,38,39.05252028310027,0.5306712962962963,45.02640845070422,8382.200541157952,119.74572201654217,7
4947,32.48446074177721,0,5,192,0.0,0.025380710659898477,0.9746192893401016,197,6650,4400,2250,0.6616541353383458,89,44,45,236.2601548557403,0.48211911668220586,0.8055180937052298,0.13427062266058923,1057071.6234427458,3898.7810896384462,1060970.4045323841,3178,1,317.76142131979697,74,123,38,38.86162982723577,0.5328362944162437,44.88888888888889,8287.146873680063,111.9884712659468,0
4948,32.37750859329896,3,1,194,0.015384615384615385,0.005128205128205128,0.9948717948717949,195,6800,4800,2000,0.7058823529411765,88,48,40,233.58747499636988,0.48167569829940965,0.8015827582131283,0.134535240985789,1057783.704584879,3617.0049292575295,1061400.7095141367,3179,0,321.5487179487179,60,135,41,38.410910325784414,0.5358440170940171,44.381830601092894,8276.279476316457,137.93799127194094,0
4949,32.09823623231383,4,1,197,0.020202020202020204,0.005050505050505051,0.9949494949494949,198,6450,4500,1950,0.6976744186046512,84,45,39,205.62811296373056,0.48200757575757575,0.775206048212185,0.1155771807347859,1041037.6446000268,-3236.6787233381347,1037800.9658766886,3180,0,317.6111111111111,77,121,38,40.07540899795503,0.5274095117845118,45.312499999999986,8175.019540417388,106.16908494048556,8
4950,31.88559235753826,2,2,197,0.010050251256281407,0.010050251256281407,0.9899497487437185,199,6450,4800,1650,0.7441860465116279,81,48,33,213.57920334982904,0.482040886249429,0.7844843112833655,0.11949117156990911,1032691.3497836466,-2137.720841389877,1030553.6289422568,3181,0,317.0,69,130,43,40.055290007601,0.5234505862646566,45.49107142857142,8115.167947782384,117.61112967800555,8
4951,32.148211949238316,3,1,199,0.015,0.005,0.995,200,6900,5400,1500,0.782608695652174,84,54,30,224.4020424617042,0.48197393216080403,0.7980737704918037,0.12444113263785382,1038398.4085339884,-296.2552471981476,1038102.1532867902,3182,0,316.19,63,137,36,40.12978142076503,0.5205729166666666,45.83333333333332,8171.003870431384,129.6984741338315,8
4952,31.84015423964419,3,2,200,0.01485148514851485,0.009900990099009901,0.9900990099009901,202,5600,3500,2100,0.625,77,35,42,213.70863333895883,0.4822478982972924,0.7889083669213595,0.11951749664365209,1031099.1415910424,-1929.0423227208266,1029170.0992683215,3183,0,313.76237623762376,69,133,38,40.0671948699957,0.5232570132013201,45.50595238095239,8103.1297292618465,117.43666274292531,0
4953,31.859781447396163,5,4,201,0.024390243902439025,0.01951219512195122,0.9804878048780488,205,6450,4800,1650,0.7441860465116279,81,48,33,217.40513320225713,0.4826179658855412,0.7925989083825509,0.12365903004639305,1037005.099840172,-2359.9536275653654,1034645.1462126066,3184,0,309.20975609756096,79,126,44,39.309826061070034,0.5289126016260163,44.85677083333334,8128.807519032938,102.8962977092777,8
4954,31.99620546033641,2,1,202,0.009852216748768473,0.0049261083743842365,0.9950738916256158,203,7300,4900,2400,0.6712328767123288,97,49,48,208.05916821368268,0.4827291534572176,0.7783458175620035,0.11742910118820954,1039025.7657759438,-4664.232684014474,1034361.5330919293,3185,0,312.935960591133,71,132,39,39.85103841423031,0.5283764367816092,45.15335648148148,8154.125566895626,114.84683897036093,8
4955,31.63876117073045,2,1,203,0.00980392156862745,0.004901960784313725,0.9950980392156863,204,7200,5400,1800,0.75,90,54,36,202.43201711416674,0.4831565528510255,0.774400262898455,0.11517342391801146,1029894.0863262162,-6303.2925382063595,1023590.7937880099,3186,0,312.13235294117646,75,129,43,39.68136728262422,0.5310968137254901,44.84649122807018,8072.740925908975,107.63654567878633,0
4956,32.12218412617363,1,2,202,0.004901960784313725,0.00980392156862745,0.9901960784313726,204,6250,4800,1450,0.768,77,48,29,195.42960568745502,0.48317516661837145,0.7717220681928307,0.10759934157767187,1035277.2409965486,-6585.235402969464,1028692.0055935791,3187,0,312.8186274509804,81,123,39,41.15109743487106,0.5238970588235294,46.11280487804879,8155.41122898512,100.68408924672988,8
4957,31.77635580190528,4,1,205,0.019417475728155338,0.0048543689320388345,0.9951456310679612,206,6750,4500,2250,0.6666666666666666,90,45,45,189.0887186468622,0.4832701870708027,0.767761252902311,0.10501696527925754,1026861.3530202608,-9116.420505882992,1017744.9325143779,3188,0,310.7135922330097,70,136,41,40.967533279470594,0.5268001618122977,45.77464788732395,8078.3552425970665,115.40507489424381,0
4958,32.00906251154379,3,5,203,0.014423076923076924,0.02403846153846154,0.9759615384615384,208,6750,4400,2350,0.6518518518518519,91,44,47,186.0333730528934,0.4832466245509724,0.7650131226162158,0.1043939341346402,1037636.0289411085,-9743.013906975146,1027893.0150341333,3189,0,308.7019230769231,74,134,43,40.63812523864069,0.5294471153846154,45.375,8150.307542001834,110.1392911081329,0
4959,31.62903181512088,2,4,201,0.00975609756097561,0.01951219512195122,0.9804878048780488,205,6550,4600,1950,0.7022900763358778,85,46,39,225.1472689605814,0.4831021839630161,0.7950729929502816,0.1259172637789893,1024268.7987526351,-1427.7354558617862,1022841.0632967734,3190,0,313.9170731707317,72,133,41,39.775254649098194,0.5264735772357724,45.505136986301366,8049.426119045099,111.79758498673749,8
4960,31.949079327986116,7,1,207,0.03365384615384615,0.004807692307692308,0.9951923076923077,208,5900,3800,2100,0.6440677966101694,80,38,42,249.43853078160132,0.48316775439737397,0.8201808910087274,0.14026291270953553,1036336.7747877407,4200.464499599382,1040537.2392873401,3191,0,310.30288461538464,61,147,44,38.94239226033421,0.5208834134615384,45.295698924731184,8137.567920233025,133.40275279070534,8
4961,31.748211830388822,2,6,203,0.009569377990430622,0.028708133971291867,0.9712918660287081,209,6250,4900,1350,0.784,76,49,27,250.70394711760053,0.48327371641516376,0.8208953877138043,0.14182782328402543,1031694.8412095015,3679.993782417774,1035374.8349919192,3192,0,309.7751196172249,64,145,36,38.67275898918783,0.5228767942583732,45.06410256410257,8093.758874965161,126.46498242133065,0
4962,31.71174858170926,3,3,203,0.014563106796116505,0.014563106796116505,0.9854368932038835,206,5950,3900,2050,0.6554621848739496,80,39,41,263.39340988807646,0.48306002841581813,0.8319290916975686,0.1451972716820199,1022435.5830162818,6710.55892031232,1029146.1419365942,3193,0,314.9660194174757,62,144,38,39.3763293831662,0.5116302588996764,46.06481481481481,8052.728748642366,129.88272175229622,7
4963,31.569940578367937,6,2,207,0.028708133971291867,0.009569377990430622,0.9904306220095693,209,6250,4400,1850,0.704,81,44,37,229.931793179318,0.48371461323763953,0.8121085792789808,0.12873121458487308,1022688.0690684597,-1020.2996831989049,1021667.7693852608,3194,0,310.4354066985646,61,148,42,39.6111111111111,0.5171451355661882,45.46370967741935,8035.6955605220755,131.73271410691927,8
4964,31.673732976359368,5,3,209,0.02358490566037736,0.014150943396226415,0.9858490566037735,212,6300,4300,2000,0.6825396825396826,83,43,40,206.59768879333447,0.4835753301141614,0.7909836065573754,0.11456780923994044,1023072.572960361,-6427.11419170768,1016645.4587686533,3195,0,306.811320754717,68,144,42,40.582308743169385,0.5185731132075472,45.83333333333334,8050.407131491365,118.38834016899067,7
4965,31.455346626941637,5,4,210,0.02336448598130841,0.018691588785046728,0.9813084112149533,214,7450,5100,2350,0.6845637583892618,98,51,47,198.32692731646938,0.48355939113392715,0.7851293985375747,0.1112697723728385,1019623.1158557301,-9806.256082297441,1009816.8597734327,3196,0,304.9065420560748,73,141,42,40.33313983488132,0.5212714174454829,45.382882882882896,8009.069676071546,109.7132832338568,0
4966,31.932762753341063,5,4,211,0.023255813953488372,0.018604651162790697,0.9813953488372094,215,6850,4400,2450,0.6423357664233577,93,44,49,198.38134804686115,0.4836068246033471,0.7868107668877213,0.11271905846292632,1039051.5950305334,-8624.308777520175,1030427.2862530132,3197,0,302.7906976744186,78,137,42,39.836387209041916,0.5251453488372093,44.897151898734194,8146.138726119363,104.43767597588928,0
4967,31.869152869781,3,3,211,0.014018691588785047,0.014018691588785047,0.985981308411215,214,7200,4800,2400,0.6666666666666666,96,48,48,200.5146187605617,0.48357630204905444,0.7891405270939309,0.11490249988201123,1039610.6299996325,-8308.574173239373,1031302.0558263931,3198,0,304.9158878504673,66,148,44,39.45234037372941,0.5277453271028038,44.574004975124375,8140.210082363669,123.33651639944954,0
4968,31.563021702536425,3,1,213,0.014018691588785047,0.004672897196261682,0.9953271028037384,214,7250,4700,2550,0.6482758620689655,98,47,51,228.04517019515052,0.4839638819417021,0.8106776435950689,0.12940652799141672,1026623.314273067,-3226.7023140577367,1023396.6119590093,3199,0,305.76635514018693,73,141,36,39.13013733281822,0.5236565420560748,44.94650900900901,8050.258871456337,110.2775187870731,8
4969,31.103767401017862,6,5,214,0.0273972602739726,0.0228310502283105,0.9771689497716896,219,6300,4200,2100,0.6666666666666666,84,42,42,217.90839756063988,0.4844982754527809,0.8078980939133187,0.12541071007280846,1015944.5335047605,-5823.43093869716,1010121.1025660633,3200,0,299.69406392694066,70,149,39,38.84069513805179,0.5271594368340944,44.41021126760564,7949.8053388077005,113.56864769725287,0
4970,31.560603742913223,3,1,216,0.013824884792626729,0.004608294930875576,0.9953917050691244,217,6400,4500,1900,0.703125,83,45,38,214.33943174295302,0.4841109831029186,0.8038640730432467,0.12441541727608275,1033468.2981109113,-5497.39845170977,1027970.8996592015,3201,0,300.7465437788018,73,144,37,38.60263109644298,0.529857910906298,44.08783783783786,8076.7423429922055,110.64030606838638,0
4971,31.6983258157597,1,3,214,0.004608294930875576,0.013824884792626729,0.9861751152073732,217,7750,5800,1950,0.7483870967741936,97,58,39,191.79922937847934,0.48381674204926894,0.778686923807913,0.11207598256066859,1040006.9558172877,-11255.493465196972,1028751.4623520907,3202,0,301.40552995391704,82,135,39,38.92468113598879,0.5367223502304148,43.8378514056225,8119.9112478096595,99.0233079001178,8
4972,31.558669447450097,4,2,216,0.01834862385321101,0.009174311926605505,0.9908256880733946,218,7900,5700,2200,0.7215189873417721,101,57,44,191.03780927566692,0.4832984540368382,0.7762267525343292,0.11261731629676036,1038080.1018328735,-11837.490298637364,1026242.6115342362,3203,0,298.23394495412845,77,141,40,38.60967926689579,0.5394686544342507,43.50961538461538,8094.495264526248,105.1233151237175,0
4973,32.01322206168978,2,4,214,0.009174311926605505,0.01834862385321101,0.981651376146789,218,7350,4900,2450,0.6666666666666666,98,49,49,200.15336165677576,0.4831989247311828,0.7904609851145457,0.11611076484122017,1048103.2357944872,-8993.72279847766,1039109.5129960096,3204,0,299.0275229357798,77,141,38,38.98886409895104,0.5343081039755352,44.11057692307695,8191.844924199281,106.38759641817248,8
4974,31.55634214553255,1,1,214,0.004651162790697674,0.004651162790697674,0.9953488372093023,215,6650,4600,2050,0.6917293233082706,87,46,41,198.00188628637105,0.4829194740273854,0.7852553527397861,0.11536909907619318,1034480.0554029905,-8684.199540915255,1025795.8558620753,3205,0,300.6139534883721,79,136,40,38.875381388253274,0.5361434108527132,43.94531250000003,8080.149326717486,102.28037122427197,0
4975,31.73597656403756,2,1,215,0.009259259259259259,0.004629629629629629,0.9953703703703703,216,6850,4800,2050,0.7007299270072993,89,48,41,196.78074891283887,0.4830901880562733,0.7853182476243779,0.11557479078164755,1042791.9295727233,-9009.724627683354,1033782.2049450399,3206,0,300.2037037037037,70,146,41,38.60277284953929,0.5383873456790124,43.64730046948355,8135.603264428182,116.22290377754545,0
4976,31.255622848104455,2,0,217,0.009216589861751152,0.0,1.0,217,6300,4300,2000,0.6825396825396826,83,43,40,197.4143151902787,0.48275800762359905,0.7862607937253809,0.11687603268638366,1029388.1249800889,-9056.809648410386,1020331.3153316785,3207,0,299.7649769585253,72,145,42,38.28382723599834,0.540610599078341,43.35045662100455,8021.741331992062,111.4130740554453,0
4977,31.761906161918088,3,5,215,0.013636363636363636,0.022727272727272728,0.9772727272727273,220,6550,4200,2350,0.6412213740458015,89,42,47,209.41355115185402,0.48286892901618933,0.7958813872357895,0.1230374047218444,1043750.1209601617,-6834.916130911374,1036915.2048292503,3208,0,296.6636363636364,71,149,40,38.26561324303984,0.5391098484848484,43.63425925925923,8142.664600537965,114.68541690898543,8
4978,32.258080666474385,0,1,214,0.0,0.004651162790697674,0.9953488372093023,215,5950,3900,2050,0.6554621848739496,80,39,41,212.34838666341355,0.4819350865753822,0.7930928075815256,0.12527111201577742,1061310.2845265246,-3876.4946663010105,1057433.7898602237,3209,1,303.3860465116279,73,142,43,38.03543827397609,0.5414244186046512,43.48254504504502,8274.760754295594,113.35288704514512,0
4979,32.29574705651526,1,2,213,0.004651162790697674,0.009302325581395349,0.9906976744186047,215,7950,5600,2350,0.7044025157232704,103,56,47,210.6757338973223,0.4815076432659567,0.7917279560082175,0.12518267918066334,1064763.3244292163,-6086.041039784753,1058677.2833894317,3210,0,304.13953488372096,75,140,43,37.805633395605355,0.5437984496124031,43.21546052631577,8293.048534865826,110.57398046487768,0
4980,32.42454724447898,1,3,211,0.004672897196261682,0.014018691588785047,0.985981308411215,214,6900,4800,2100,0.6956521739130435,90,48,42,209.76638843283388,0.4811927771196232,0.7906951938311542,0.12555713056487794,1071257.2035688048,-4757.249064943243,1066499.9545038615,3211,0,306.45327102803736,78,136,35,37.55353936906902,0.5456094236760125,42.945675105485215,8334.870101939796,106.85730899922815,0
4981,32.242456365371375,2,1,212,0.009389671361502348,0.004694835680751174,0.9953051643192489,213,6750,4900,1850,0.725925925925926,86,49,37,208.9935324156683,0.4810056618537219,0.7906283406487609,0.1262007480475864,1067919.5802259252,-4712.342918545359,1063207.2373073797,3212,0,307.9342723004695,72,141,38,37.243698139010576,0.5484154929577465,42.62271689497717,8298.475819951525,115.25660861043785,0
4982,31.961804497537774,0,5,207,0.0,0.02358490566037736,0.9764150943396226,212,6300,4300,2000,0.6825396825396826,83,43,40,215.3645110461953,0.4806081217025843,0.7964011802814925,0.12725827384560057,1052060.6832098635,-3384.6930739164504,1048675.990135947,3213,1,310.2358490566038,72,140,39,37.8960198728287,0.5462362421383649,43.42180365296802,8200.702149974666,113.89864097187036,7
4983,32.32848591875819,3,3,207,0.014285714285714285,0.014285714285714285,0.9857142857142858,210,6850,4700,2150,0.6861313868613139,90,47,43,219.23343673469392,0.4805261259208628,0.8012092517006795,0.13014196549718934,1065546.2461095587,-2129.3268931298794,1063416.9192164289,3214,0,311.3333333333333,70,140,38,37.62238095238093,0.5457341269841269,43.251173708920184,8300.30081540886,118.57572593441229,8
4984,32.248151327808756,1,4,204,0.004807692307692308,0.019230769230769232,0.9807692307692307,208,6600,4500,2100,0.6818181818181818,87,45,42,218.40552824559512,0.4806913283475784,0.799111338996046,0.13028766463263425,1064398.816496424,-1705.8828438224245,1062692.9336526014,3215,0,314.91346153846155,71,137,34,37.45853041650245,0.5473257211538461,43.070023148148145,8285.51677416891,116.69741935449169,0
4985,31.820573757867972,0,5,199,0.0,0.024509803921568627,0.9754901960784313,204,7600,5400,2200,0.7105263157894737,98,54,44,221.84708691945085,0.48021608068514765,0.7995584262697202,0.13285046674650136,1051444.1256499607,-1748.0367331973398,1049696.0889167634,3216,2,320.671568627451,70,134,36,37.22534528021917,0.5490196078431373,42.92840375586856,8180.165689339267,116.85950984770382,0
4986,32.183819285180604,1,2,198,0.005,0.01,0.99,200,6700,4600,2100,0.6865671641791045,88,46,42,217.76394180492895,0.4799774916247906,0.791891663854202,0.13087922100770913,1064549.6710654083,-335.89347633108537,1064213.7775890771,3217,0,327.76,71,129,39,37.19414444819441,0.5506770833333333,42.7951388888889,8277.834769269999,116.58922210239436,0
4987,31.721706807049742,0,4,194,0.0,0.020202020202020204,0.9797979797979798,198,6400,4700,1700,0.734375,81,47,34,217.83671261617118,0.47965750995573325,0.7893714472661846,0.1312333366248643,1049972.6619961488,-255.4813947816151,1049717.180601367,3218,1,327.64646464646466,70,128,41,37.10357624831309,0.5521359427609427,42.70833333333334,8161.73081389719,116.59615448424557,0
4988,31.880243050464294,2,2,194,0.01020408163265306,0.01020408163265306,0.9897959183673469,196,6500,4200,2300,0.6461538461538462,88,42,46,239.71057823146185,0.4796964939822083,0.8089108412069737,0.1437717431625139,1053885.509077449,4825.500954142525,1058711.0100315916,3219,0,325.7704081632653,63,133,37,36.70744187027893,0.5481505102040816,42.87109374999998,8197.332026550002,130.11638137380956,7
4989,32.17321863940155,1,0,195,0.005128205128205128,0.0,1.0,195,6750,5000,1750,0.7407407407407407,85,50,35,219.96764113702218,0.47953013481364,0.7897442717764571,0.13074598369243262,1060822.052991338,919.3049325276388,1061741.3579238658,3220,0,318.8974358974359,60,135,48,37.55486101875252,0.5432692307692308,43.203551912568315,8261.968270138683,137.69947116897805,8
4990,32.49214107971592,0,3,192,0.0,0.015384615384615385,0.9846153846153847,195,7100,4800,2300,0.676056338028169,94,48,46,241.51082631541948,0.4791644638294123,0.8005560704355903,0.140539694870633,1064756.4924950013,5330.044065434901,1070086.5365604362,3221,1,319.8974358974359,76,119,37,37.81067251461989,0.5419337606837606,43.99350649350649,8318.199104336345,109.44998821495192,8
4991,32.73193817294061,2,0,194,0.010309278350515464,0.0,1.0,194,5300,4000,1300,0.7547169811320755,66,40,26,269.6161728457408,0.4791421843562487,0.8220455811735965,0.15696919466861928,1072763.8251123503,13746.895378829693,1086510.72049118,3222,0,322.159793814433,59,135,37,37.07286510250673,0.5382302405498282,43.97569444444443,8380.171740214468,142.0368091561774,8
4992,32.35366313662129,0,2,192,0.0,0.010309278350515464,0.9896907216494846,194,6200,4500,1700,0.7258064516129032,79,45,34,269.7277563158472,0.4790998967291633,0.8221286088064945,0.15739809577418368,1061085.3153484364,12240.832273725136,1073326.1476221615,3223,1,323.159793814433,59,135,37,36.98086135213304,0.5396262886597938,43.88888888888887,8286.132614434642,140.44292566838377,0
4993,31.965775154067657,5,0,197,0.025380710659898477,0.0,1.0,197,6100,4200,1900,0.6885245901639344,80,42,38,250.51958728588227,0.47946450153665526,0.8105695088288658,0.14822080148552086,1052580.8908863878,7238.426073972654,1059819.3169603604,3224,0,317.8680203045685,60,137,39,36.945340919173084,0.5430414551607445,43.3743169398907,8203.23888345846,136.720648057641,0
4994,32.33301670556011,2,1,198,0.010050251256281407,0.005025125628140704,0.9949748743718593,199,5750,4300,1450,0.7478260869565218,72,43,29,254.17072728657786,0.4795748523763599,0.81538160820309,0.15225566867555193,1068474.287901299,8764.977368576327,1077239.2652698753,3225,0,315.66331658291455,64,135,35,36.38236088600757,0.545644891122278,42.916666666666664,8312.27971138774,129.87937049043344,0
4995,32.03873167014246,0,2,196,0.0,0.010101010101010102,0.98989898989899,198,6800,4700,2100,0.6911764705882353,89,47,42,236.30114349923937,0.47930126134440854,0.8049601708138292,0.1384049554781262,1051896.6394044843,3312.875746857437,1055209.5151513417,3226,1,316.54040404040404,79,119,38,37.694783197831974,0.5446127946127945,43.75000000000001,8209.924990474025,103.92310114524082,8
4996,32.09056138816811,2,1,197,0.010101010101010102,0.005050505050505051,0.9949494949494949,198,6850,5300,1550,0.7737226277372263,84,53,31,243.98725182517188,0.4788227024902152,0.8034416181071697,0.13882133512125425,1044612.4422248624,4524.423800164949,1049136.8660250274,3227,0,317.35858585858585,77,121,35,38.61963083150144,0.5328282828282829,44.84508547008546,8188.064448214978,106.33849932746725,8
4997,32.184428009474,4,4,197,0.01990049751243781,0.01990049751243781,0.9800995024875622,201,5900,4000,1900,0.6779661016949152,78,40,38,197.72344235427073,0.4785478855721393,0.7672067774060125,0.11298570223184856,1049019.5476489689,-4616.8487883850785,1044402.6988605838,3228,0,313.48258706467664,74,127,37,39.632291610001985,0.536950663349917,44.680555555555564,8217.310279141137,111.04473350190725,8
4998,31.93957776066805,1,1,197,0.005050505050505051,0.005050505050505051,0.9949494949494949,198,5750,3700,2050,0.6434782608695652,78,37,41,218.71940409087904,0.478316904236955,0.7805377364674293,0.12339456493117815,1037057.3375892418,14.912577118251647,1037072.25016636,3229,0,318.19191919191917,79,119,34,39.59562831059561,0.5314078282828283,45.169270833333314,8139.185890026443,103.02766949400561,8
4999,31.900958476848892,1,5,193,0.005050505050505051,0.025252525252525252,0.9747474747474747,198,6450,4900,1550,0.7596899224806202,80,49,31,219.97067564538517,0.47800071356543433,0.7834287168506244,0.12479743356966784,1037547.4786712767,-403.996020502831,1037143.4826507738,3230,0,319.1818181818182,82,116,37,39.34457320473704,0.5337226430976432,44.95481927710842,8136.185719961354,99.22177707269944,0
5000,31.68020000069646,5,3,195,0.025252525252525252,0.015151515151515152,0.9848484848484849,198,6600,5100,1500,0.7727272727272727,81,51,30,215.18195187502783,0.4780055205182108,0.7852998654715957,0.12290444632138603,1032440.5410123909,-1767.4858380086303,1030673.0551743823,3231,0,319.1313131313131,66,132,40,39.204753060105965,0.5349326599326599,44.69838308457713,8088.006284381826,122.545549763361,8
