period,mktsize,entries,exits,surviv,entryrate,exitrate,survivrate,firms,totresinv,totinninv,totimiinv,costshareinn,firmsres,firmsinn,firmsimi,hindex,div,gini,pcm,cs,totprofits,ts,maxage,minage,avgage,actfirms,inactfirms,profitablefirms,wmc,avgproxopt,price,totoutput,avgoutput,magtechshock
1,512,40,5,35,1.0,0.125,0.875,40,0,0,0,0,0,0,0,364.56655244628683,0.5022702991452991,0.38470788491104857,0.15614971902990987,15143406.384688416,1096155.8915917873,16239562.276280204,0,0,0.0,38,2,35,47.917353027308025,0.4961622807017544,56.78418803418803,124526.49572649556,3277.013045434094,0
2,512,36,7,64,0.5070422535211268,0.09859154929577464,0.9014084507042254,71,1700,1200,500,0.7058823529411765,22,12,10,284.11151556876825,0.5008299798792757,0.5411059259949369,0.13384630322687244,15677828.798185866,874950.3401360492,16552779.138321916,1,0,0.49295774647887325,55,16,51,45.49884746442173,0.5196969696969698,52.529761904761884,126704.76190476128,2303.7229437229325,0
3,512,26,7,83,0.28888888888888886,0.07777777777777778,0.9222222222222223,90,2400,1500,900,0.625,33,15,18,247.70868834684444,0.500325114440283,0.5926402070105383,0.12271450426038912,15950575.861371262,769819.2449994227,16720395.106370684,2,0,1.1,61,29,53,44.20327959884235,0.5370560109289617,50.3864247311828,127802.15053763444,2095.1172219284335,0
4,512,20,4,99,0.1941747572815534,0.038834951456310676,0.9611650485436893,103,2950,1900,1050,0.6440677966101694,40,19,21,231.3118616131261,0.49963909512024873,0.6223502133381331,0.11956763083384254,16175919.51369652,724786.4112034473,16900705.924899966,3,0,1.766990291262136,56,47,56,42.81488549618323,0.55859375,48.62938596491228,128701.75438596489,2298.2456140350873,0
5,512,16,4,111,0.1391304347826087,0.034782608695652174,0.9652173913043478,115,3650,2400,1250,0.6575342465753424,49,24,25,211.07435210755858,0.49920861937452327,0.6276870597542055,0.11153908569093267,16290893.622504372,661067.9633246548,16951961.585829027,4,0,2.4434782608695653,63,52,63,42.41301858184402,0.562665343915344,47.73763020833334,129158.33333333359,2050.132275132279,0
6,512,10,11,110,0.08264462809917356,0.09090909090909091,0.9090909090909091,121,4300,2900,1400,0.6744186046511628,57,29,28,201.20830834118019,0.4983499770431588,0.6291475485724385,0.10808269306468814,16375511.111111283,630477.7777777876,17005988.88888907,5,0,3.231404958677686,74,47,62,41.99443986820431,0.5633445945945945,47.08333333333337,129493.33333333471,1749.9099099099285,0
7,512,10,11,109,0.08333333333333333,0.09166666666666666,0.9083333333333333,120,3400,2000,1400,0.5882352941176471,48,20,28,186.43545357244028,0.49743522408963586,0.59387716375081,0.10150499974514018,16444486.29372616,585767.0521873222,17030253.34591348,6,0,3.8833333333333333,73,47,73,41.826055262427126,0.5692066210045662,46.55123873873874,129765.76576576577,1777.6132296680241,0
8,512,13,4,118,0.10655737704918032,0.03278688524590164,0.9672131147540983,122,3050,1900,1150,0.6229508196721312,42,19,23,175.96602900462966,0.49576051122250825,0.5750300992076052,0.09716146120000636,16515971.433185216,553799.981650306,17069771.414835524,7,0,4.377049180327869,86,36,73,41.53143757267216,0.5695251937984496,46.00095785440616,130047.50957854524,1512.1803439365726,0
9,512,6,0,124,0.04838709677419355,0.0,1.0,124,3700,2600,1100,0.7027027027027027,48,26,22,199.3845477141846,0.4945731160940641,0.6315839904144904,0.11115528258098226,16564517.842579814,632041.7796292668,17196559.62220908,8,0,5.209677419354839,70,54,70,40.55614834467643,0.5800595238095239,45.627934272300486,130238.49765258278,1860.5499664654683,8
10,512,5,0,129,0.03875968992248062,0.0,1.0,129,5050,3400,1650,0.6732673267326733,67,34,33,211.7994684662266,0.49321200742894056,0.665444962361138,0.1177775335702148,16551734.969723254,670279.7337562517,17222014.703479506,9,0,5.9689922480620154,67,62,67,40.340595316986956,0.5806902985074627,45.726102941176485,130188.23529411822,1943.107989464451,8
11,512,10,2,137,0.07194244604316546,0.014388489208633094,0.9856115107913669,139,4750,3300,1450,0.6947368421052632,62,33,29,192.8088252368734,0.4925429221839919,0.6566011687661062,0.10885050869227883,16627705.251736034,608643.66319444,17236348.914930474,10,0,6.467625899280575,79,60,67,40.22936570786284,0.58082805907173,45.14322916666665,130486.66666666606,1651.7299578058994,0
12,512,5,0,142,0.035211267605633804,0.0,1.0,142,5150,3200,1950,0.6213592233009708,71,32,39,188.6052742439402,0.49176218659474574,0.659461593955863,0.10773964910117635,16686488.972080221,595881.9657495361,17282370.93782976,11,0,7.295774647887324,73,69,73,39.877908419253515,0.5880422374429224,44.69313063063064,130717.11711711738,1790.645439960512,0
13,512,4,3,143,0.0273972602739726,0.02054794520547945,0.9794520547945206,146,5550,3800,1750,0.6846846846846847,73,38,35,185.76008364067687,0.4912189025350338,0.6624190347564838,0.10710297165825587,16732476.41789026,586895.243780591,17319371.661670852,12,0,8.068493150684931,80,66,63,39.59245053655265,0.5885416666666667,44.34156378600824,130897.11934156404,1636.2139917695506,0
14,512,2,0,145,0.013793103448275862,0.0,1.0,145,4450,3200,1250,0.7191011235955056,57,32,25,182.44752026499015,0.4908963920817369,0.6545987159451441,0.10579465424239615,16760638.69937595,578137.3937517193,17338776.093127668,13,0,9.075862068965517,82,63,65,39.45815757635206,0.5899390243902439,44.12650602409641,131007.22891566371,1597.6491331178502,0
15,512,3,5,143,0.02027027027027027,0.033783783783783786,0.9662162162162162,148,5300,3600,1700,0.6792452830188679,70,36,34,183.09207482318598,0.4903082291475149,0.6638650845967888,0.10723964382500979,16810000.00000013,580655.555555561,17390655.55555569,14,0,9.871621621621621,85,63,73,39.05826558265579,0.5926470588235294,43.75000000000002,131200.00000000102,1543.529411764718,0
16,512,5,3,145,0.033783783783783786,0.02027027027027027,0.9797297297297297,148,5000,3500,1500,0.7,65,35,30,181.1268697347361,0.4893918152846724,0.6576847460415063,0.10747691556658778,16873512.25907031,576649.2913832207,17450161.550453532,15,0,10.452702702702704,83,65,65,38.61623315461531,0.5982680722891567,43.26636904761905,131447.61904761917,1583.706253585773,0
17,512,2,3,144,0.013605442176870748,0.02040816326530612,0.9795918367346939,147,4850,3100,1750,0.6391752577319587,66,31,35,220.40051827470617,0.48861942037088807,0.7081541747210456,0.12977274190406968,16835758.652477194,707871.9865107635,17543630.63898796,16,0,11.306122448979592,68,79,68,37.90165518730006,0.6021752450980392,43.55374396135263,131300.48309178656,1930.8894572321553,8
18,512,3,4,143,0.02040816326530612,0.027210884353741496,0.9727891156462585,147,5750,3900,1850,0.6782608695652174,76,39,37,210.49890350877362,0.4880564097785233,0.6932808211003725,0.12498372395833308,16876552.2279034,675349.1477964356,17551901.375699837,17,0,12.047619047619047,73,74,62,37.83854166666664,0.6027397260273972,43.24324324324321,131459.45945945804,1800.814513143261,0
19,512,5,2,146,0.033783783783783786,0.013513513513513514,0.9864864864864865,148,5000,3500,1500,0.7,65,35,30,202.58864703586784,0.48717307869093585,0.6827081494656653,0.12162008930580037,16930007.66312706,651365.4693559502,17581373.132483013,18,0,12.66891891891892,80,68,69,37.62710239869309,0.6037760416666667,42.83693415637857,131667.4897119328,1645.8436213991602,0
20,512,6,1,151,0.039473684210526314,0.006578947368421052,0.993421052631579,152,5250,3700,1550,0.7047619047619048,68,37,31,195.4911928980242,0.4866905207970256,0.6808898412620459,0.11867921427208578,16983909.02366852,628390.92702169,17612299.95069021,19,0,13.157894736842104,77,75,74,37.39257660600403,0.609172077922078,42.42788461538459,131876.92307692213,1712.6873126873004,0
21,512,2,3,150,0.013071895424836602,0.0196078431372549,0.9803921568627451,153,5300,3500,1800,0.660377358490566,71,35,36,193.88682771934282,0.4859534457057677,0.6827705102469948,0.11861105572776343,17020655.859607227,624116.1940643722,17644772.0536716,20,0,13.941176470588236,81,72,66,37.150006568791646,0.6103395061728395,42.14939024390241,132019.51219512077,1629.870520927417,0
22,512,2,2,150,0.013157894736842105,0.013157894736842105,0.9868421052631579,152,5100,3300,1800,0.6470588235294118,69,33,36,192.7033442772247,0.4854324604972697,0.6790534966048991,0.11834278890677087,17039088.96578227,621197.8854286752,17660286.851210944,21,0,14.80921052631579,84,68,69,37.03824656406357,0.6106150793650793,42.009803921568604,132090.9803921559,1572.5116713351895,0
23,512,3,0,153,0.0196078431372549,0.0,1.0,153,5450,4000,1450,0.7339449541284404,69,40,29,194.58747668163872,0.48487128769636506,0.6929503375239359,0.11745581423795265,16956344.529930517,623848.4591647355,17580192.989095252,22,0,15.666666666666666,72,81,72,37.62902435869,0.609375,42.63698630136985,131769.86301369822,1830.1369863013642,8
24,512,4,0,157,0.025477707006369428,0.0,1.0,157,4850,3100,1750,0.6391752577319587,66,31,35,186.6471945475619,0.48444560128477326,0.6875492849023499,0.11350449842093975,16992136.2762377,598056.9130659213,17590193.18930362,23,0,16.24203821656051,78,79,76,37.556830782878656,0.609375,42.365506329113906,131908.86075949302,1691.139240506321,0
25,512,1,3,155,0.006329113924050633,0.0189873417721519,0.9810126582278481,158,5400,4000,1400,0.7407407407407407,68,40,28,185.18698556857314,0.48417049638528314,0.6853313257145293,0.11313018317665872,17013948.212043,593152.356401608,17607100.568444606,24,0,17.132911392405063,81,77,66,37.42608652803782,0.6098251028806585,42.2002032520325,131993.4959349586,1629.549332530353,0
26,512,2,1,156,0.012738853503184714,0.006369426751592357,0.9936305732484076,157,6300,4300,2000,0.6825396825396826,83,43,40,183.4535204055152,0.4837497958517067,0.6803509974712347,0.11266276219883888,17039108.706788246,587476.8953665125,17626585.602154758,25,0,18.089171974522294,81,76,70,37.276730759761676,0.6117541152263375,42.00965447154471,132091.0569105688,1630.7537890193678,0
27,512,4,0,160,0.025,0.0,1.0,160,5200,3600,1600,0.6923076923076923,68,36,32,182.5265730029271,0.4835511661425576,0.6825322569555865,0.11290564908434464,17073486.60611788,586072.9998852103,17659559.60600309,26,0,18.625,87,73,75,37.03576912499425,0.6121886973180077,41.749526515151494,132224.24242424153,1519.8188784395577,0
28,512,0,0,160,0.0,0.0,1.0,160,4800,3000,1800,0.625,66,30,36,185.84539550200222,0.48317446278825993,0.6875397266291134,0.11552503207064778,17096811.354006976,598672.7335817136,17695484.08758869,27,1,19.625,77,83,77,36.770440373451855,0.6178300865800865,41.57318376068378,132314.52991453078,1718.3705183705297,0
29,512,1,0,161,0.006211180124223602,0.0,1.0,161,6000,4100,1900,0.6833333333333333,79,41,38,184.46319713313534,0.48277691511387166,0.6863191877559223,0.11523362631718657,17120183.279987898,593408.7486663662,17713592.028654262,28,0,20.496894409937887,80,81,80,36.62632403401463,0.618359375,41.39660493827162,132404.93827160564,1655.0617283950705,0
30,512,2,3,160,0.012269938650306749,0.018404907975460124,0.9815950920245399,163,5000,2700,2300,0.54,73,27,46,180.48995084237612,0.4822089045418971,0.6826199191156503,0.11335073078933436,17145186.169375323,581306.761778794,17726492.931154117,29,0,21.233128834355828,83,80,67,36.53689882920439,0.6191014056224899,41.20783730158733,132501.5873015886,1596.4046662842,0
31,512,1,3,158,0.006211180124223602,0.018633540372670808,0.9813664596273292,161,4850,3300,1550,0.6804123711340206,64,33,31,183.0792770176591,0.4812176501035197,0.6809684038704755,0.11573013121556867,17175884.299321186,591859.6959317459,17767743.995252933,30,0,22.043478260869566,85,76,71,36.234071779284534,0.6207107843137255,40.97625968992252,132620.1550387615,1560.2371181030765,0
32,512,1,0,159,0.006289308176100629,0.0,1.0,159,5600,3700,1900,0.6607142857142857,75,37,38,187.39066759800397,0.480395669134623,0.6870790705849104,0.11902561282071014,17198380.54353721,607163.2023315986,17805543.74586881,31,0,23.0188679245283,85,74,72,35.94964523264329,0.6224264705882353,40.80668604651166,132706.97674418733,1561.2585499316156,0
33,512,0,1,158,0.0,0.006289308176100629,0.9937106918238994,159,6450,4400,2050,0.6821705426356589,85,44,41,185.34085601364885,0.47964267706923547,0.6856530255541762,0.11838044900393391,17224369.420095693,600225.8745231678,17824595.29461886,32,1,24.0188679245283,73,86,73,35.80338407409417,0.6294235159817352,40.61092342342341,132807.2072072066,1819.2768110576249,0
34,512,1,2,157,0.006289308176100629,0.012578616352201259,0.9874213836477987,159,4550,3000,1550,0.6593406593406593,61,30,31,184.16117945792445,0.47898090650956665,0.6836064557946842,0.11803421000806409,17240470.05303495,598655.059875187,17839125.112910137,33,0,24.830188679245282,76,83,76,35.71054666458144,0.6292489035087719,40.489718614718605,132869.26406926377,1748.2797903850496,0
35,512,1,0,158,0.006329113924050633,0.0,1.0,158,5650,4200,1450,0.7433628318584071,71,42,29,182.82893846828077,0.4782109167136983,0.6803580552797264,0.11778920324281233,17264550.95337277,594041.9047873343,17858592.858160105,34,0,25.746835443037973,78,80,77,35.560632986375595,0.6302083333333333,40.308544303797454,132962.02531645502,1704.641350210962,0
36,512,3,1,160,0.018633540372670808,0.006211180124223602,0.9937888198757764,161,5350,3800,1550,0.7102803738317757,69,38,31,179.35678824824456,0.4772289078674948,0.6805131446421802,0.11635709187469656,17296686.86224485,582905.6405895669,17879592.502834417,35,0,26.248447204968944,83,78,68,35.404888841181254,0.6306475903614458,40.06696428571428,133085.7142857139,1603.4423407917338,0
37,512,1,2,159,0.006211180124223602,0.012422360248447204,0.9875776397515528,161,5250,3800,1450,0.7238095238095238,67,38,29,174.74807651174035,0.47659646739130435,0.6727442299840696,0.11393238937998322,17319628.895641554,567864.3670821027,17887493.26272366,36,0,27.062111801242235,86,75,72,35.3493448106549,0.6312984496124031,39.894636015325666,133173.94636015306,1548.5342600017798,0
38,512,0,0,159,0.0,0.0,1.0,159,6150,4700,1450,0.7642276422764228,76,47,29,172.30648753595278,0.4757831780909163,0.6647938032162004,0.11282713100563285,17339512.894375842,559592.1124828524,17899105.006858695,37,1,28.0062893081761,89,70,76,35.26101426072516,0.6317883895131087,39.74537037037037,133250.37037037025,1497.1951727007893,0
39,512,0,1,158,0.0,0.006289308176100629,0.9937106918238994,159,4250,2800,1450,0.6588235294117647,57,28,29,172.90716011350716,0.47540170633972884,0.6678501460684572,0.11356550265035248,17353480.692079518,564058.212910407,17917538.904989924,38,2,29.0062893081761,90,69,76,35.13876676192569,0.6325231481481481,39.64056776556775,133304.02930402872,1481.1558811558748,0
40,512,1,0,159,0.006289308176100629,0.0,1.0,159,5500,3600,1900,0.6545454545454545,74,36,38,175.45709383091736,0.4744563198259162,0.6703757703296531,0.11592135176171012,17380455.45585639,572604.8407484533,17953060.296604842,39,0,29.77358490566038,78,81,78,34.86655111920787,0.6390224358974359,39.4382911392405,133407.59493670854,1710.353781239853,0
41,512,2,1,160,0.012422360248447204,0.006211180124223602,0.9937888198757764,161,4650,3000,1650,0.6451612903225806,63,30,33,232.0998433538945,0.47403920807453415,0.7496589780995646,0.15035014374922492,17289811.010373805,765742.4854252402,18055553.495799046,40,0,30.391304347826086,71,90,56,34.08679183135706,0.6354166666666667,40.11863425925926,133059.2592592593,1874.0740740740746,7
42,512,0,0,160,0.0,0.0,1.0,160,5150,3400,1750,0.6601941747572816,69,34,35,228.5208002976255,0.47369955450733753,0.7423460358659748,0.1403581379219327,17039740.681396514,741637.0354753466,17781377.71687186,41,1,31.525,76,84,59,36.10914477478895,0.6138980263157895,42.00487012987013,132093.5064935064,1738.0724538619263,8
43,512,1,0,161,0.006211180124223602,0.0,1.0,161,5450,3700,1750,0.6788990825688074,72,37,35,229.37569041653924,0.4734892598343685,0.744925136769365,0.1413703234812137,17056194.024399117,744805.256044998,17800999.280444115,42,0,32.32298136645963,77,84,62,35.95970440121414,0.6147186147186148,41.880341880341874,132157.26495726468,1716.3281163281126,0
44,512,2,1,162,0.012269938650306749,0.006134969325153374,0.9938650306748467,163,5950,4100,1850,0.6890756302521008,78,41,37,229.90374609781432,0.4733662172738519,0.7479220265188995,0.1425403225806451,17084444.444444474,747005.5555555568,17831450.00000003,43,0,32.91411042944785,81,82,67,35.72748655913979,0.6152263374485596,41.66666666666667,132266.6666666669,1632.9218106995913,0
45,512,1,0,163,0.006134969325153374,0.0,1.0,163,5450,4100,1350,0.7522935779816514,68,41,27,225.6307600690588,0.47294491151001034,0.7415371299512605,0.14063811896628556,17109680.67402856,734044.051003992,17843724.725032553,44,0,33.68098159509202,70,93,70,35.64284092843766,0.6221726190476191,41.47593896713616,132364.3192488266,1890.9188464118085,0
46,512,1,0,164,0.006097560975609756,0.0,1.0,164,5650,4100,1550,0.7256637168141593,72,41,31,222.3478995787516,0.47257734176268146,0.7378307233851191,0.13923670393660786,17131611.45737151,723385.5647891666,17854997.022160675,45,0,34.46951219512195,75,89,67,35.558396029811746,0.6213888888888889,41.31030701754386,132449.12280701764,1765.9883040935686,0
47,512,1,1,164,0.006060606060606061,0.006060606060606061,0.9939393939393939,165,5650,3700,1950,0.6548672566371682,76,37,39,188.1492752779976,0.47185575264843554,0.7004878884663157,0.11678462816166658,17089812.831468716,604437.1797754937,17694250.01124421,46,0,35.25454545454546,76,89,76,36.76479571356266,0.6177357456140351,41.62608225108226,132287.4458874462,1740.624287992713,8
48,512,2,2,164,0.012048192771084338,0.012048192771084338,0.9879518072289156,166,5300,3400,1900,0.6415094339622641,72,34,38,198.52113849626514,0.4720974808324206,0.721581292099305,0.12271012327056692,17070028.88197814,639252.3135628814,17709281.19554102,47,0,35.78915662650602,85,81,72,36.64937966133492,0.6126225490196078,41.77567829457362,132210.85271317745,1555.421796625617,8
49,512,2,1,165,0.012048192771084338,0.006024096385542169,0.9939759036144579,166,5400,3800,1600,0.7037037037037037,70,38,32,234.3626539926681,0.4715909090909091,0.7525342714287415,0.14170707974201874,16964591.893423993,756573.3560090677,17721165.24943306,48,0,36.21084337349398,69,97,69,36.54131019134056,0.6115640096618358,42.57440476190475,131801.9047619044,1910.1725327812235,8
50,512,2,1,166,0.011976047904191617,0.005988023952095809,0.9940119760479041,167,5950,4200,1750,0.7058823529411765,77,42,35,232.5874031267792,0.4717928600630065,0.7510027470460598,0.1416415502873855,16998906.135865543,751396.286827365,17750302.42269291,49,0,36.952095808383234,73,94,69,36.3207418332787,0.6121575342465753,42.31418918918918,131935.1351351347,1807.3306182895167,0
51,512,3,2,167,0.01775147928994083,0.011834319526627219,0.9881656804733728,169,5400,3500,1900,0.6481481481481481,73,35,38,228.4396252286395,0.47249225133840517,0.7500574155334627,0.1402564082632483,17037976.0850694,739229.7743055528,17777205.85937495,50,0,37.22485207100592,79,90,63,36.12490326216793,0.6124736286919832,42.01822916666666,132086.6666666663,1671.9831223628646,0
52,512,0,0,167,0.0,0.0,1.0,167,6000,4300,1700,0.7166666666666667,77,43,34,232.42521805555313,0.47179586609912705,0.7553003922681829,0.1432605815067852,17056551.478573546,753474.5393366431,17810026.01791019,51,1,38.64670658682635,78,89,63,35.8782224833129,0.6143162393162394,41.87763713080168,132158.6497890292,1694.341663961913,0
53,512,3,0,170,0.01764705882352941,0.0,1.0,170,5550,3400,2150,0.6126126126126126,77,34,43,227.6928954381253,0.47202256642301893,0.7557883504683185,0.14146286687953633,17094287.131519243,738899.5464852592,17833186.678004503,52,0,38.94705882352941,69,101,69,35.708501295709745,0.6215277777777778,41.5922619047619,132304.76190476166,1917.460317460314,0
54,512,1,0,171,0.005847953216374269,0.0,1.0,171,5800,3800,2000,0.6551724137931034,78,38,40,226.56513298819286,0.47180942552459576,0.7565987393336038,0.14161112997541736,17122737.482853223,735883.0589849113,17858620.541838136,53,0,39.71345029239766,71,100,68,35.51782650854032,0.6226525821596245,41.37731481481482,132414.81481481483,1864.9973917579555,0
55,512,3,4,170,0.017241379310344827,0.022988505747126436,0.9770114942528736,174,5350,3700,1650,0.6915887850467289,70,37,33,223.1244293756011,0.47177997585985426,0.7572250763554187,0.14010017795280116,17144321.377731644,724913.3848876596,17869234.7626193,54,0,40.01149425287356,75,99,55,35.440224299560406,0.6223611111111111,41.214364035087726,132498.24561403535,1766.6432748538045,0
56,512,0,0,170,0.0,0.0,1.0,170,4450,2700,1750,0.6067415730337079,62,27,35,221.81294996223582,0.4707071586030862,0.751381131789697,0.13979165020946627,17161687.111111153,722886.8888888913,17884574.000000045,55,1,41.6,74,96,59,35.340226370561105,0.6241554054054055,41.08333333333334,132565.33333333366,1791.423423423428,0
57,512,1,2,169,0.005847953216374269,0.011695906432748537,0.9883040935672515,171,4900,2800,2100,0.5714285714285714,70,28,42,216.743017723154,0.4703216374269006,0.7472509793511737,0.1372028305761242,17182479.41674367,705736.4881502027,17888215.90489387,56,0,42.35087719298246,75,96,63,35.31129862801113,0.6252777777777778,40.92653508771931,132645.61403508816,1768.6081871345089,0
58,512,1,1,169,0.0058823529411764705,0.0058823529411764705,0.9941176470588236,170,5400,3500,1900,0.6481481481481481,73,35,38,213.18013370868638,0.47016837800208844,0.7421492398034204,0.1355848291490065,17204539.317104295,694133.198403331,17898672.515507627,57,0,43.21764705882353,76,94,66,35.2338055975926,0.6265076754385965,40.760281385281395,132730.73593073626,1746.457051720214,0
59,512,0,2,167,0.0,0.011834319526627219,0.9881656804733728,169,4950,3300,1650,0.6666666666666666,66,33,33,212.89679247015576,0.4695835681412604,0.7417911376083837,0.13604506730904234,17226568.867743194,694746.2514417547,17921315.11918495,58,1,44.44378698224852,67,102,67,35.071699933073525,0.632773631840796,40.594362745098046,132815.68627450996,1982.3236757389548,0
60,512,0,0,167,0.0,0.0,1.0,167,5100,3300,1800,0.6470588235294118,69,33,36,212.7543846039302,0.46892510160402084,0.7393852521585731,0.13654963230034048,17246920.415224895,695371.5878508256,17942292.00307572,59,2,45.4311377245509,67,100,67,34.91894869373623,0.6343283582089552,40.44117647058823,132894.11764705868,1983.4942932396818,0
61,512,1,0,168,0.005952380952380952,0.0,1.0,168,5300,3800,1500,0.7169811320754716,68,38,30,212.30038987780682,0.4688420777492634,0.7409223973765062,0.1369361051340442,17269961.22448978,694383.9002267562,17964345.124716535,60,0,46.154761904761905,69,99,66,34.753733623620185,0.634963768115942,40.26785714285714,132982.85714285698,1927.2877846790868,0
62,512,0,3,165,0.0,0.017857142857142856,0.9821428571428571,168,5550,3600,1950,0.6486486486486487,75,36,39,211.00960440955163,0.46819976119190193,0.7404031689487562,0.13685915353148012,17295586.63408778,690756.9787379971,17986343.612825777,61,1,47.154761904761905,71,97,59,34.59056922334781,0.635856807511737,40.07523148148148,133081.48148148137,1874.387063119456,0
63,512,1,0,166,0.006024096385542169,0.0,1.0,166,5150,3100,2050,0.6019417475728155,72,31,41,207.96833718659127,0.4670971765851284,0.7335016202386986,0.13539635415444143,17312996.345679007,681761.0123456788,17994757.358024687,62,0,48.01807228915663,74,92,61,34.536112297942026,0.6356981981981982,39.94444444444444,133148.4444444444,1799.3033033033028,0
64,512,0,1,165,0.0,0.006024096385542169,0.9939759036144579,166,5900,4100,1800,0.6949152542372882,77,41,36,211.21164157311995,0.4667670682730924,0.7384252560177498,0.13807306486308893,17331883.65650967,693039.1197291461,18024922.776238818,63,1,49.01807228915663,75,91,63,34.30696024722573,0.6366666666666667,39.80263157894736,133221.05263157876,1776.2807017543835,0
65,512,0,0,165,0.0,0.0,1.0,165,5050,3600,1450,0.7128712871287128,65,36,29,209.09545185238284,0.46618625277161857,0.7342988139047861,0.1370830626321828,17345089.16831033,687305.8514135443,18032395.019723874,64,2,50.236363636363635,77,88,65,34.26084474885844,0.6367694805194806,39.70352564102564,133271.79487179493,1730.8025308025317,0
66,512,2,1,166,0.011976047904191617,0.005988023952095809,0.9940119760479041,167,4700,3100,1600,0.6595744680851063,63,31,32,205.93550577316267,0.4659506288627564,0.7341783748219839,0.1358418611476186,17373190.506196205,677451.3547574062,18050641.86095361,65,0,50.622754491017965,68,99,68,34.12798446917016,0.6433823529411764,39.49275362318841,133379.71014492775,1961.4663256607023,0
67,512,0,0,166,0.0,0.0,1.0,166,5650,4100,1550,0.7256637168141593,72,41,31,206.5399478888524,0.4652260557381039,0.7337343895190278,0.13688839452020574,17394857.653061274,679696.5986394584,18074554.251700733,66,1,51.54216867469879,69,97,69,33.946487697665134,0.6444746376811594,39.33035714285715,133462.85714285754,1934.2443064182253,0
68,512,1,0,167,0.005988023952095809,0.0,1.0,167,5800,4200,1600,0.7241379310344828,74,42,32,206.10732279166302,0.46506986027944114,0.7347817318730416,0.137167976892383,17413703.43316294,678618.3588994428,18092321.792062383,67,0,52.22754491017964,73,94,64,33.81368739205528,0.6438356164383562,39.1891891891892,133535.1351351355,1829.2484265087055,0
69,512,2,1,168,0.011834319526627219,0.005917159763313609,0.9940828402366864,169,4950,3100,1850,0.6262626262626263,68,31,37,209.02070488744627,0.4642431553489246,0.7422717884766332,0.1406609532681049,17464077.18183693,691320.7445512649,18155397.926388193,68,0,52.59763313609467,76,93,58,33.35286424612836,0.6462445175438596,38.81222943722944,133728.1385281386,1759.580770107087,0
70,512,1,2,167,0.005917159763313609,0.011834319526627219,0.9881656804733728,169,6300,4400,1900,0.6984126984126984,82,44,38,209.80838843690475,0.46367814877430263,0.7425871286697101,0.1417171997969526,17480866.848261546,693426.5003827758,18174293.348644324,69,0,53.585798816568044,78,91,61,33.20413681165273,0.6466346153846154,38.6867088607595,133792.40506329152,1715.2872444011732,0
71,512,1,0,168,0.005952380952380952,0.0,1.0,168,5750,4500,1250,0.782608695652174,70,45,25,210.622973206375,0.4633077594810379,0.7414458931261667,0.14261233694200692,17491776.100535452,697483.9777910004,18189260.078326453,70,0,54.416666666666664,81,87,64,33.09960757156049,0.6462191358024691,38.60518292682928,133834.14634146387,1652.2734116230108,0
72,512,0,0,168,0.0,0.0,1.0,168,5050,3500,1550,0.693069306930693,66,35,31,209.9261197694335,0.4627411842980705,0.7408695719861991,0.14280578701500912,17512767.567634437,696627.4683794943,18209395.03601393,71,1,55.416666666666664,66,102,66,32.95773147872952,0.655145202020202,38.44838308457711,133914.4278606963,2029.0064827378228,0
73,512,1,1,168,0.005917159763313609,0.005917159763313609,0.9940828402366864,169,6000,4400,1600,0.7333333333333333,76,44,32,200.41609764072683,0.4619875316990702,0.728793967276425,0.13062892603234538,17318270.63117062,654372.0435570402,17972642.67472766,72,0,56.082840236686394,80,89,65,34.6921096003296,0.6334635416666667,39.90483539094648,133168.72427983457,1664.609053497932,8
74,512,1,0,169,0.005917159763313609,0.0,1.0,169,5750,3700,2050,0.6434782608695652,78,37,41,224.6835651970959,0.46155166948436177,0.7529183654251388,0.1430109773165842,17208130.704072285,733726.831393716,17941857.535466,73,0,56.76331360946745,76,93,64,34.907926776241446,0.6267817982456141,40.73322510822511,132744.58874458892,1746.6393255866963,8
75,512,0,0,169,0.0,0.0,1.0,169,5900,4100,1800,0.6949152542372882,77,41,36,227.96490286399703,0.4611862496477881,0.7580280422713792,0.14581287287496073,17231013.87245237,745913.2807363602,17976927.15318873,74,1,57.76331360946745,64,105,64,34.6465964543826,0.6349283854166667,40.560897435897445,132832.82051282082,2075.5128205128253,0
76,512,0,0,169,0.0,0.0,1.0,169,5600,3600,2000,0.6428571428571429,76,36,40,229.0824328552355,0.46062711327134404,0.7585240929890256,0.14735173261720647,17257100.69444446,751259.7222222227,18008360.416666683,75,2,58.76331360946745,67,102,67,34.416792042795045,0.6351057213930349,40.364583333333336,132933.33333333343,1984.0796019900513,0
77,512,0,0,169,0.0,0.0,1.0,169,4850,3100,1750,0.6391752577319587,66,31,35,262.3835080489681,0.4604495397764628,0.7874208111508894,0.16323978641431575,17100794.870567232,858743.3097130471,17959538.18028028,76,3,59.76331360946745,58,111,58,34.761595737413764,0.6291307471264368,41.543079096045204,132329.94350282504,2281.550750048708,8
78,512,1,0,170,0.0058823529411764705,0.0,1.0,170,5200,3600,1600,0.6923076923076923,68,36,32,261.9205324897321,0.4604442220675253,0.7871630658239643,0.16376948323098856,17124467.8575558,857849.9479708645,17982317.805526663,77,0,60.40588235294118,61,109,59,34.590045905331074,0.6287568306010929,41.36424731182796,132421.5053763442,2170.844350431872,0
79,512,1,1,170,0.005847953216374269,0.005847953216374269,0.9941520467836258,171,5700,4100,1600,0.7192982456140351,73,41,32,260.1203428556356,0.46047184955853687,0.7850546140312229,0.16360950465445775,17152372.527907807,852436.2045493975,18004808.732457206,78,0,61.046783625730995,66,105,52,34.42048571485776,0.6276830808080809,41.15360696517415,132529.3532338315,2008.0205035429015,0
80,512,0,2,168,0.0,0.011764705882352941,0.9882352941176471,170,6050,4200,1850,0.6942148760330579,79,42,37,218.98799195071078,0.45976838960436245,0.7445571369442014,0.13285762241070181,16980796.94960489,703668.1251433461,17684465.074748237,79,1,61.94705882352941,72,98,72,36.81148078379226,0.611255787037037,42.45148401826484,131864.84018264845,1831.456113647895,8
81,512,2,0,170,0.011764705882352941,0.0,1.0,170,5700,3900,1800,0.6842105263157895,75,39,36,215.46438177309005,0.4591890010442046,0.7403577369251044,0.13184483406025238,17021875.573920995,693821.5794306683,17715697.153351665,80,0,62.470588235294116,76,94,63,36.584190231362456,0.6125274122807017,42.14015151515151,132024.24242424217,1737.1610845295022,0
82,512,1,2,169,0.005847953216374269,0.011695906432748537,0.9883040935672515,171,4300,3000,1300,0.6976744186046512,56,30,26,224.67493457191006,0.4590743607384474,0.7570607701774692,0.1369963407020046,17004975.25843642,725618.3407172321,17730593.599153653,81,0,63.099415204678365,70,101,56,36.47760478928296,0.6141369047619047,42.26819248826292,131958.6854460097,1885.1240778001386,7
83,512,4,0,173,0.023121387283236993,0.0,1.0,173,5800,4300,1500,0.7413793103448276,73,43,30,223.1071305694488,0.46033573060895283,0.7590312863060718,0.13715699112241037,17044053.530864295,720129.9753086473,17764183.50617294,82,0,63.17341040462428,74,99,61,36.21543851150107,0.6151463963963963,41.97222222222224,132110.22222222298,1785.2732732732834,0
84,512,2,0,175,0.011428571428571429,0.0,1.0,175,5900,4500,1400,0.7627118644067796,73,45,28,218.59224168698339,0.4607183908045977,0.7564508478333138,0.1350744964211519,17068550.70677195,705310.5522682493,17773861.2590402,83,0,63.44,77,98,64,36.14252004137576,0.6156655844155844,41.78685897435899,132205.12820512892,1716.9497169497263,0
85,512,0,0,175,0.0,0.0,1.0,175,5000,3500,1500,0.7,65,35,30,216.8075673140737,0.4604830322933771,0.7548335715744323,0.13422334477079934,17077469.066567026,700504.904840751,17777973.97140778,84,1,64.44,78,97,65,36.11969062691445,0.6159188034188035,41.71940928270043,132239.66244725784,1695.380287785357,0
86,512,1,0,176,0.005681818181818182,0.0,1.0,176,5200,3900,1300,0.75,65,39,26,211.32704668050405,0.460443722943723,0.7502259983752002,0.13152055129832546,17102420.184835237,682440.7897500596,17784860.974585295,85,0,65.06818181818181,68,108,68,36.068643770807775,0.6227022058823529,41.5307971014493,132336.2318840589,1946.1210571185134,0
87,512,2,1,177,0.011235955056179775,0.0056179775280898875,0.9943820224719101,178,5800,4100,1700,0.7068965517241379,75,41,34,206.75550283167115,0.46085798472248674,0.7477568061157893,0.12957774012585735,17135441.34817885,667169.3584370702,17802610.706615917,86,0,65.32584269662921,72,106,66,35.93224311951908,0.623119212962963,41.28139269406395,132463.9269406402,1839.7767630644473,0
88,512,2,1,178,0.0111731843575419,0.00558659217877095,0.994413407821229,179,6850,4900,1950,0.7153284671532847,88,49,39,208.0083950865728,0.46115801477203777,0.7509997453831956,0.13150361248693604,17176419.75308657,671917.9012345753,17848337.654321145,87,0,65.65921787709497,77,102,65,35.5842269883825,0.623917748917749,40.97222222222225,132622.22222222338,1722.3665223665375,0
89,512,0,0,178,0.0,0.0,1.0,178,5200,3000,2200,0.5769230769230769,74,30,44,212.07365395891037,0.4603296462049557,0.7539683642471187,0.1346324305652794,17195907.70874433,688559.7961867246,17884467.50493105,88,1,67.02808988764045,77,101,67,35.328908383572994,0.6254058441558441,40.82532051282053,132697.43589743655,1723.3433233433318,0
90,512,1,0,179,0.00558659217877095,0.0,1.0,179,5200,3400,1800,0.6538461538461539,70,34,36,245.15148382565596,0.4602883790513255,0.7889960776230773,0.14953753134669612,17006755.18846119,792846.2539021916,17799601.44236338,89,0,67.64804469273743,61,118,52,35.93604013210788,0.6197062841530054,42.25470430107529,131965.59139785022,2163.37035078443,8
91,512,2,0,181,0.011049723756906077,0.0,1.0,181,5550,4300,1250,0.7747747747747747,68,43,25,239.62904526434806,0.4607658072437078,0.786454811009976,0.14720841799835854,17040634.182736564,774936.1799816404,17815570.362718206,90,0,67.88950276243094,65,116,55,35.81563130849697,0.6197115384615385,41.998106060606084,132096.96969697054,2032.2610722610852,0
92,512,2,0,183,0.01092896174863388,0.0,1.0,183,5100,3100,2000,0.6078431372549019,71,31,40,237.5637910750385,0.4613720751015833,0.7842366213755023,0.1467415215002849,17066734.750566933,769187.6417233584,17835922.39229029,91,0,68.13661202185793,69,114,59,35.66671229323959,0.6194142512077294,41.80059523809525,132198.09523809556,1915.9144237405153,0
93,512,2,0,185,0.010810810810810811,0.0,1.0,185,5200,3800,1400,0.7307692307692307,66,38,28,237.61543285444358,0.46152688014101056,0.7852932495678215,0.14787523539776554,17102226.847034354,770550.6070065919,17872777.454040945,92,0,68.3891891891892,61,124,61,35.390665626625086,0.6270491803278688,41.532258064516135,132335.48387096787,2169.4341618191456,0
94,512,2,0,187,0.0106951871657754,0.0,1.0,187,6300,4700,1600,0.746031746031746,79,47,32,229.48515832620112,0.46189839572192515,0.7794135592003728,0.143669279792454,17130401.23456795,742534.5679012379,17872935.80246919,93,0,68.6470588235294,65,122,61,35.38310961968681,0.6266025641025641,41.31944444444446,132444.44444444485,2037.6068376068438,0
95,512,0,0,187,0.0,0.0,1.0,187,6000,3900,2100,0.65,81,39,42,225.80660849117328,0.4615090659919882,0.7753789118561856,0.14181326557062787,17145282.823913924,730903.6332179958,17876186.45713192,94,1,69.6470588235294,67,120,60,35.36339331518096,0.6265547263681592,41.207107843137265,132501.96078431405,1977.6412057360308,0
96,512,0,0,187,0.0,0.0,1.0,187,5900,4100,1800,0.6949152542372882,77,41,36,223.6639789597973,0.4610262971268664,0.7720922056541719,0.14106476614278482,17165238.15192744,724549.092970522,17889787.24489796,95,2,70.6470588235294,69,118,63,35.264915330536546,0.6269625603864735,41.05654761904762,132579.04761904763,1921.4354727398209,0
97,512,1,0,188,0.005319148936170213,0.0,1.0,188,5350,3800,1550,0.7102803738317757,69,38,31,224.7636507840192,0.4608127583722077,0.7748478334451698,0.14273806465068073,17197532.20378943,730126.02451989,17927658.228309322,96,0,71.26595744680851,71,117,65,34.98749883710112,0.6283744131455399,40.8130787037037,132703.70370370365,1869.0662493479388,0
98,512,1,0,189,0.005291005291005291,0.0,1.0,189,6200,4400,1800,0.7096774193548387,80,44,36,219.1680011193573,0.4609975984089459,0.7693078618451763,0.13987427851140116,17220630.681357,710842.2408895366,17931472.922246538,97,0,71.88359788359789,73,116,68,34.954715061058344,0.6291381278538812,40.63907657657657,132792.79279279255,1819.0793533259252,0
99,512,1,0,190,0.005263157894736842,0.0,1.0,190,5700,3800,1900,0.6666666666666666,76,38,38,217.96451656128067,0.46087846932145177,0.7694305866162052,0.13969434782477674,17240290.30612246,707854.3083900232,17948144.61451248,98,0,72.5,69,121,69,34.83469761263069,0.6326992753623188,40.49107142857143,132868.5714285715,1925.6314699792972,0
100,512,1,1,190,0.005235602094240838,0.005235602094240838,0.9947643979057592,191,5800,3900,1900,0.6724137931034483,77,39,38,222.55791224595595,0.46042527785432164,0.7726090952575477,0.14329037791346583,17261489.1776323,724336.1987260017,17985825.3763583,99,0,73.1151832460733,70,121,69,34.552446465901994,0.6337797619047619,40.33157276995305,132950.234741784,1899.2890677397713,0
101,512,0,1,189,0.0,0.005263157894736842,0.9947368421052631,190,7200,5100,2100,0.7083333333333334,93,51,42,221.1049491958181,0.45993049754014664,0.7702837566313476,0.14278877616565658,17275600.22726793,718744.1421154656,17994344.369383395,100,1,74.0,72,118,68,34.4817128993866,0.6338252314814814,40.225456621004554,133004.56621004522,1847.2856418061835,0
102,512,0,0,189,0.0,0.0,1.0,189,5050,3600,1450,0.7128712871287128,65,36,29,219.6640558114932,0.4594133457165372,0.7677472081534076,0.1422115738488937,17287116.049382675,716621.6049382688,18003737.654320944,101,2,75.31746031746032,74,115,61,34.4306743274541,0.6337274774774775,40.13888888888888,133048.88888888856,1797.9579579579536,0
103,512,1,1,189,0.005263157894736842,0.005263157894736842,0.9947368421052631,190,6000,4000,2000,0.6666666666666666,80,40,40,217.05874191097934,0.45924359509885826,0.7665782041753948,0.14142586144919042,17316623.97728094,707744.9229308158,18024368.900211755,102,0,75.91578947368421,77,113,63,34.2718763371844,0.6346049783549783,39.91720085470084,133162.39316239246,1729.3817293817203,0
104,512,1,1,189,0.005263157894736842,0.005263157894736842,0.9947368421052631,190,5950,4300,1650,0.7226890756302521,76,43,33,220.98395326626138,0.4588995637241251,0.7699686637419496,0.14455148550578892,17334749.817514922,722190.3087112065,18056940.126226127,103,0,76.89473684210526,78,112,64,34.030698420741466,0.6355502136752137,39.7811181434599,133232.0675105479,1708.103429622409,0
105,512,0,0,189,0.0,0.0,1.0,189,5450,3800,1650,0.6972477064220184,71,38,33,219.68540288444174,0.4580659687042666,0.7684188188979271,0.14431377893570344,17354253.077952087,719245.215837688,18073498.293789774,104,1,78.27513227513228,80,109,68,33.91492969804732,0.6361979166666667,39.63477366255142,133306.9958847727,1666.337448559659,0
106,512,1,0,190,0.005263157894736842,0.0,1.0,190,6650,5200,1450,0.7819548872180451,81,52,29,218.2923943192856,0.45801946997122434,0.7689199586448996,0.14436315745163608,17384928.798185907,714349.5464852592,18099278.344671167,105,0,78.8578947368421,69,121,69,33.71616605756055,0.643719806763285,39.4047619047619,133424.76190476166,1933.692201518285,0
107,512,0,0,190,0.0,0.0,1.0,190,7300,5400,1900,0.7397260273972602,92,54,38,214.62569311757403,0.4578686299081036,0.7655073799409604,0.14268041257634292,17408708.377640165,701971.2203665478,18110679.598006714,106,1,79.8578947368421,72,118,67,33.6297309621523,0.6439525462962963,39.22659817351598,133515.98173515982,1854.388635210553,0
108,512,1,0,191,0.005235602094240838,0.0,1.0,191,5900,3800,2100,0.6440677966101694,80,38,42,217.6362103705923,0.45748828878478914,0.7657208527552388,0.14540993632969695,17431528.691366345,714646.3690710436,18146175.06043739,107,0,80.43455497382199,76,115,63,33.37664385573813,0.6437774122807017,39.05573593073593,133603.46320346312,1757.9403053087253,0
109,512,0,0,191,0.0,0.0,1.0,191,5450,3900,1550,0.7155963302752294,70,39,31,216.97826553825632,0.4571599154955452,0.7661544113278067,0.1454334696106886,17445990.93907531,713430.1709113376,18159421.109986648,108,1,81.43455497382199,76,115,65,33.28323919089324,0.6448739035087719,38.947510822510814,133658.8744588741,1758.6694007746594,0
110,512,0,0,191,0.0,0.0,1.0,191,6850,5000,1850,0.7299270072992701,87,50,37,216.90309386623997,0.45674313401304306,0.7670226647726737,0.1463273147723827,17475258.236540206,713037.5155234085,18188295.752063613,109,2,82.43455497382199,77,114,69,33.06157568322769,0.6466450216450217,38.72863247863246,133770.94017093952,1737.284937284929,0
111,512,0,0,191,0.0,0.0,1.0,191,6150,4200,1950,0.6829268292682927,81,42,39,215.05156903239026,0.456421649673923,0.7653047265716273,0.1454407000813729,17486508.196582455,707750.2049145597,18194258.401497014,110,3,83.43455497382199,80,111,70,33.02405730781214,0.6462239583333333,38.64454732510287,133813.99176954696,1672.674897119337,0
112,512,0,1,190,0.0,0.005235602094240838,0.9947643979057592,191,6350,4600,1750,0.7244094488188977,81,46,35,217.14413276669026,0.456267796454487,0.7677384730300025,0.14762371147135964,17509962.759344958,715887.135630999,18225849.894975957,111,4,84.43455497382199,71,120,71,32.79034362265124,0.6521420187793427,38.469328703703695,133903.70370370342,1885.9676577986397,0
113,512,1,0,191,0.005235602094240838,0.0,1.0,191,5950,3900,2050,0.6554621848739496,80,39,41,215.9661168888632,0.45608064664278497,0.762729497646937,0.147494860873033,17530440.91388682,713046.2503043563,18243487.164191175,112,0,84.98429319371728,73,118,73,32.66496324188634,0.6526826484018264,38.316441441441434,133981.98198198166,1835.3696161915295,0
114,512,2,0,193,0.010362694300518135,0.0,1.0,193,6000,4300,1700,0.7166666666666667,77,43,34,217.03659439160106,0.45628688111686816,0.7664378916528771,0.1486871934318358,17544340.566328112,716952.7854724539,18261293.351800565,113,0,85.09326424870466,75,118,73,32.53097731239094,0.6527777777777778,38.21271929824562,134035.08771929832,1787.1345029239776,0
115,512,0,0,193,0.0,0.0,1.0,193,5750,4000,1750,0.6956521739130435,75,40,35,215.13258958948282,0.45573816206102474,0.7650324232278278,0.1479638389712964,17561904.808755532,711277.6119263171,18273182.42068185,114,1,86.09326424870466,76,117,64,32.44699395692373,0.6536458333333333,38.08170995670997,134102.16450216508,1764.502164502172,0
116,512,0,2,191,0.0,0.010362694300518135,0.9896373056994818,193,5150,3500,1650,0.6796116504854369,68,35,33,219.2321951487337,0.4552130559153713,0.7676980320510591,0.1513374062733776,17578235.977586646,726993.0520417546,18305229.0296284,115,2,87.09326424870466,76,117,66,32.21519531922217,0.6548793859649122,37.959956709956714,134164.5021645023,1765.322396901346,0
117,512,1,0,192,0.005208333333333333,0.0,1.0,192,6200,4300,1900,0.6935483870967742,81,43,38,200.60972964007266,0.45438902068789994,0.7542352346185126,0.1301176163954697,17295719.418388013,649337.9192906804,17945057.337678693,116,0,88.52083333333333,86,106,64,34.859869946412424,0.6294815891472868,40.07423371647512,133081.99233716587,1547.4650271763473,8
118,512,0,0,192,0.0,0.0,1.0,192,6200,4200,2000,0.6774193548387096,82,42,40,234.8098992840516,0.4540475930773706,0.7843286415578161,0.14694775247925027,17128632.524289586,759794.4955803936,17888427.01986998,117,1,89.52083333333333,77,115,72,35.25903720722116,0.6202651515151515,41.33279914529915,132437.6068376069,1719.9689199689208,8
119,512,1,0,193,0.0051813471502590676,0.0,1.0,193,5950,3800,2150,0.6386554621848739,81,38,43,232.07834130246786,0.45397956246401844,0.7828261818661075,0.1459772766792527,17152550.593574885,751597.0981727064,17904147.69174759,118,0,90.05181347150258,80,113,59,35.144968037890834,0.6208333333333333,41.15226337448561,132530.04115226382,1656.6255144032978,0
120,512,0,1,192,0.0,0.0051813471502590676,0.9948186528497409,193,5900,4100,1800,0.6949152542372882,77,41,36,227.09967337957002,0.45372206930051817,0.7766284102567871,0.14349033174520837,17173711.072664388,735528.8350634386,17909239.907727826,119,1,91.05181347150258,84,109,66,35.110598533238715,0.6209077380952381,40.992647058823536,132611.76470588258,1578.7114845938402,0
121,512,1,1,192,0.0051813471502590676,0.0051813471502590676,0.9948186528497409,193,5800,4100,1700,0.7068965517241379,75,41,34,236.86725840708021,0.45398406016119747,0.788957494836581,0.15395170237827754,17305239.82871383,775408.9428608898,18080648.77157472,120,0,91.61139896373057,76,117,58,33.84422099658325,0.6341831140350878,40.00270562770562,133118.61471861452,1751.56071998177,7
122,512,1,1,192,0.0051813471502590676,0.0051813471502590676,0.9948186528497409,193,6000,4200,1800,0.7,78,42,36,239.1320732905818,0.4535095531088083,0.7911359548510051,0.1562118493620192,17328547.519856293,784162.2991075158,18112709.818963807,121,0,92.60621761658031,80,113,60,33.606120145651026,0.6342447916666667,39.82767489711932,133208.23045267415,1665.1028806584268,0
123,512,1,0,193,0.0051813471502590676,0.0,1.0,193,6450,4500,1950,0.6976744186046512,84,45,39,237.52910311597645,0.4533251475244675,0.7901347070323155,0.15581368301175058,17347726.810857765,779067.9980967988,18126794.808954563,122,0,92.97409326424871,82,111,62,33.50046604313309,0.6349085365853658,39.68373493975901,133281.9277108424,1625.3893623273464,0
124,512,0,0,193,0.0,0.0,1.0,193,5100,3400,1700,0.6666666666666666,68,34,34,243.39532029619258,0.45310026266551523,0.7938628468431019,0.16035282289314995,17367521.959237307,801734.7140039426,18169256.67324125,123,1,93.97409326424871,64,129,64,33.195666441067296,0.6453450520833333,39.5352564102564,133357.94871794843,2083.717948717944,0
125,512,0,0,193,0.0,0.0,1.0,193,5150,3400,1750,0.6601941747572816,69,34,35,242.53148953814713,0.4527989169545193,0.793404366967692,0.160722646387216,17394294.448157176,799982.8283953343,18194277.27655251,124,2,94.97409326424871,66,127,66,33.012619786074985,0.6461489898989898,39.33457711442785,133460.69651741258,2022.1317654153422,0
126,512,2,0,195,0.010256410256410256,0.0,1.0,195,6600,4400,2200,0.6666666666666666,88,44,44,234.66890202788446,0.45288791964049696,0.787043893583933,0.1564346795820412,17421223.11500686,772043.8600762902,18193266.97508315,125,0,94.98974358974358,73,122,59,33.011142887977556,0.644406392694064,39.132882882882875,133563.96396396367,1829.6433419721052,0
127,512,0,0,195,0.0,0.0,1.0,195,4900,3200,1700,0.6530612244897959,66,32,34,235.326623761348,0.4528416600581549,0.7868938986935099,0.1575158135777627,17439781.90404739,776908.9989227443,18216690.90297013,126,1,95.98974358974358,75,120,61,32.85180249960614,0.6448611111111111,38.99396929824561,133635.08771929814,1781.8011695906418,0
128,512,0,0,195,0.0,0.0,1.0,195,6000,4200,1800,0.7,78,42,36,236.4458005734073,0.45241651246805886,0.7869426676422688,0.15888182764303757,17457398.093359582,780545.6936226136,18237943.786982197,127,2,96.98974358974358,77,118,63,32.68768538406462,0.6452922077922079,38.862179487179475,133702.5641025637,1736.396936396931,0
129,512,0,0,195,0.0,0.0,1.0,195,7000,4600,2400,0.6571428571428571,94,46,48,206.49612968656385,0.4518735130848533,0.7591259688820684,0.1327715440774898,17255278.739611987,666629.6552785364,17921908.394890524,128,3,97.98974358974358,75,120,75,35.01720163305527,0.6308333333333334,40.37828947368417,132926.3157894721,1772.3508771929614,8
130,512,0,0,195,0.0,0.0,1.0,195,5100,3300,1800,0.6470588235294118,69,33,36,217.76291542020599,0.4517787910829148,0.782347243671287,0.1337876749477655,17041062.58209793,698082.2939471646,17739144.876045093,129,4,98.98974358974358,72,123,62,36.37646793134597,0.6158854166666667,41.99486301369863,132098.63013698612,1834.7031963470295,8
131,512,5,0,200,0.025,0.0,1.0,200,6000,3700,2300,0.6166666666666667,83,37,46,215.04552842333771,0.4529485971524288,0.7850988002822863,0.13323151757845675,17081000.17361116,688638.5416666691,17769638.71527783,130,0,97.49,79,121,67,36.13792553012737,0.6157700421940928,41.69270833333334,132253.33333333372,1674.0928270042243,0
132,512,0,0,200,0.0,0.0,1.0,200,6200,4800,1400,0.7741935483870968,76,48,28,212.41813673644992,0.4529182370184255,0.7823423553124103,0.13197284237668866,17094287.131519243,680027.324263037,17774314.45578228,131,1,98.49,69,131,69,36.10321288031479,0.6215277777777778,41.5922619047619,132304.76190476166,1917.460317460314,0
133,512,2,0,202,0.009900990099009901,0.0,1.0,202,6500,4800,1700,0.7384615384615385,82,48,34,209.71311502411984,0.45396419306109714,0.7812058235460944,0.13080178764619713,17112766.675006777,670854.321219324,17783620.996226102,132,0,98.5049504950495,72,130,72,36.03054804349027,0.6213831018518519,41.452625570776256,132376.25570776255,1838.5591070522578,0
134,512,1,0,203,0.0049261083743842365,0.0,1.0,203,6450,4900,1550,0.7596899224806202,80,49,31,210.6035434292978,0.45398132793574925,0.7831639548298137,0.13189985204822133,17132240.79012346,674572.1234567905,17806812.91358025,133,0,99.01477832512315,74,129,68,35.85735888900823,0.6219031531531531,41.30555555555556,132451.55555555556,1789.885885885886,0
135,512,1,0,204,0.004901960784313725,0.0,1.0,204,6150,4400,1750,0.7154471544715447,79,44,35,207.72244903660032,0.45433288257831866,0.7812972898610537,0.13073025818589173,17155172.766454842,665752.9001387989,17820925.66659364,134,0,99.52450980392157,77,127,62,35.75521908102902,0.6222943722943723,41.13247863247864,132540.17094017114,1721.3009213009238,0
136,512,0,1,203,0.0,0.004901960784313725,0.9950980392156863,204,6150,4100,2050,0.6666666666666666,82,41,41,210.166178474054,0.45384691232814967,0.7833830658386332,0.13310965098135116,17184948.47499541,675388.9896526638,17860337.46464807,135,1,100.52450980392157,80,124,65,35.46268261610493,0.6233072916666667,40.9079218106996,132655.1440329223,1658.1893004115288,0
137,512,2,0,205,0.00975609756097561,0.0,1.0,205,5700,4300,1400,0.7543859649122807,71,43,28,208.074686360978,0.45367945958871353,0.7828723008126228,0.13247776525245938,17209482.852749005,669471.549404078,17878954.402153082,136,0,101.00975609756098,84,121,69,35.32814198610388,0.6236359126984127,40.723039215686285,132749.8039215691,1580.3548085901084,0
138,512,0,0,205,0.0,0.0,1.0,205,6750,4200,2550,0.6222222222222222,93,42,51,207.22628030119017,0.45362366491311973,0.7828634391196114,0.13241508217392484,17226342.80692725,666200.1886145372,17892542.995541785,137,1,102.00975609756098,71,134,71,35.22053355642311,0.630575117370892,40.5960648148148,132814.81481481442,1870.631194574851,0
139,512,0,0,205,0.0,0.0,1.0,205,6450,5000,1450,0.7751937984496124,79,50,29,206.35916930905717,0.45392256496094374,0.7822803651094412,0.13239742259479456,17245247.23212602,664292.9786701651,17909540.210796185,138,2,103.00975609756098,72,133,72,35.09779262191435,0.6315104166666667,40.453767123287655,132887.67123287608,1845.6621004566123,0
140,512,0,0,205,0.0,0.0,1.0,205,7150,5700,1450,0.7972027972027972,86,57,29,203.43273778047276,0.4532839151920931,0.7795030990205838,0.1310379590284272,17263650.6777047,654248.344290235,17917899.021994933,139,3,104.00975609756098,73,132,69,35.03247867880893,0.6324200913242009,40.31531531531531,132958.55855855832,1821.350117240525,0
141,512,4,0,209,0.019138755980861243,0.0,1.0,209,6900,4800,2100,0.6956521739130435,90,48,42,196.22805462413828,0.4542320344129555,0.7723921901678894,0.12730559460111246,17296807.621124852,630123.782140254,17926931.403265107,140,0,103.0,81,128,64,34.96542371224708,0.6314300411522633,40.06605691056908,133086.17886178754,1643.0392452072535,0
142,512,1,0,210,0.004761904761904762,0.0,1.0,210,6500,4600,1900,0.7076923076923077,84,46,38,197.54004769075163,0.45411919951393637,0.7753548653463846,0.12867387636872646,17315389.61937706,635596.578239134,17950986.197616197,141,0,103.5047619047619,84,126,66,34.78897684792509,0.6316964285714286,39.926470588235276,133157.64705882274,1585.210084033604,0
143,512,1,0,211,0.004739336492890996,0.0,1.0,211,6900,4800,2100,0.6956521739130435,90,48,42,196.37031037505722,0.45355450236966827,0.7766217164438911,0.12852638504303754,17337444.939451322,631811.8887741041,17969256.828225426,142,0,104.00947867298578,87,124,68,34.650566674247585,0.6323036398467433,39.76089015151515,133242.42424242417,1531.5221177290134,0
144,512,0,0,211,0.0,0.0,1.0,211,6800,5100,1700,0.75,85,51,34,196.8165878146156,0.4533457458812909,0.7782233672276782,0.12917990982533215,17350310.322359327,633965.7750342907,17984276.097393617,143,1,105.00947867298578,89,122,69,34.54051445634937,0.6326076779026217,39.66435185185184,133291.85185185133,1497.6612567623745,0
145,512,0,0,211,0.0,0.0,1.0,211,5700,4000,1700,0.7017543859649122,74,40,34,198.9175921619472,0.45280034604679154,0.7813890559626007,0.13114285048977917,17370757.51243147,643169.8516803869,18013927.364111856,144,2,106.00947867298578,71,140,71,34.32941081181151,0.6415786384976525,39.51099537037038,133370.3703703708,1878.4559207094478,0
146,512,0,0,211,0.0,0.0,1.0,211,6200,4600,1600,0.7419354838709677,78,46,32,203.6471022880639,0.45255115474309787,0.7859809196796397,0.1292439068605712,17194494.516548254,651921.7967206097,17846416.313268863,145,3,107.00947867298578,78,133,64,35.55817010090732,0.6248664529914529,40.835970464135016,132691.9831223627,1701.1792707995216,8
147,512,1,0,212,0.0047169811320754715,0.0,1.0,212,6450,4500,1950,0.6976744186046512,84,45,39,190.95115875611975,0.452452010492116,0.7727595202996427,0.11956018525653414,17130998.482037593,605386.8021588874,17736385.28419648,146,0,107.5,76,136,69,36.37531377470976,0.6208881578947368,41.31493506493509,132446.7532467544,1742.7204374572948,8
148,512,2,1,213,0.009345794392523364,0.004672897196261682,0.9953271028037384,214,6450,4300,2150,0.6666666666666666,86,43,43,186.33501109501591,0.45277878329165017,0.7689060365556601,0.11710023183374063,17148352.33657224,589817.6845792898,17738170.02115153,147,0,107.48598130841121,81,133,63,36.361293805830975,0.6201131687242798,41.18394308943091,132513.8211382121,1635.9731004717544,0
149,512,0,0,213,0.0,0.0,1.0,213,6050,4200,1850,0.6942148760330579,79,42,37,194.17802343086097,0.452102156966959,0.7740884318633983,0.11950282606784167,17049252.709190655,613468.038408778,17662720.747599434,148,1,108.9906103286385,89,124,70,36.92177385597463,0.6096676029962547,41.93287037037037,132130.37037037025,1484.610903037868,8
150,512,0,0,213,0.0,0.0,1.0,213,6750,4800,1950,0.7111111111111111,87,48,39,193.3703717942431,0.45181887973543566,0.7738457991538978,0.11929968700526156,17061000.955686312,610468.4195965984,17671469.37528291,149,2,109.9906103286385,93,120,71,36.85199891254579,0.6093189964157706,41.84397163120567,132175.8865248225,1421.246091664758,0
151,512,1,1,213,0.004672897196261682,0.004672897196261682,0.9953271028037384,214,6850,5000,1850,0.7299270072992701,87,50,37,195.75962539021822,0.45215673584602106,0.7799216159179971,0.1213709677419355,17084444.444444474,619238.88888889,17703683.333333366,150,0,110.47196261682242,80,134,73,36.60954301075269,0.615625,41.66666666666667,132266.6666666669,1653.3333333333362,0
152,512,0,0,213,0.0,0.0,1.0,213,6100,4900,1200,0.8032786885245902,73,49,24,196.59820182429212,0.451844716095314,0.7781102272819402,0.1223982353293179,17104132.65306131,623828.3446712063,17727960.997732516,151,1,111.52112676056338,76,137,76,36.43614469391671,0.6188322368421053,41.51785714285716,132342.85714285783,1741.3533834586556,0
153,512,3,1,215,0.013888888888888888,0.004629629629629629,0.9953703703703703,216,6650,4800,1850,0.7218045112781954,85,48,37,191.6326861046089,0.45226008469710016,0.7755204515730312,0.12015509296632111,17137604.8773408,606975.051208857,17744579.92854966,152,0,110.95833333333333,82,134,74,36.30685309145003,0.6189024390243902,41.26506024096388,132472.28915662738,1615.515721422285,0
154,512,3,1,217,0.013761467889908258,0.0045871559633027525,0.9954128440366973,218,7350,4800,2550,0.6530612244897959,99,48,51,189.65809515636073,0.45256635874237233,0.7758915133796982,0.11965943063132442,17166893.615772083,600218.06858385,17767111.684355933,153,0,110.90366972477064,86,132,67,36.13275229640591,0.6196705426356589,41.04406130268202,132585.44061302795,1541.6911699189297,0
155,512,0,0,217,0.0,0.0,1.0,217,6650,5000,1650,0.7518796992481203,83,50,33,190.47199008128482,0.4518315838880355,0.7759282938568057,0.1207231430978987,17188322.21661141,604728.7877512733,17793051.004362684,154,1,112.41013824884793,88,129,71,35.94702786937083,0.6206202651515151,40.88249063670415,132668.16479400868,1507.5927817500988,0
156,512,1,0,218,0.0045871559633027525,0.0,1.0,218,5750,3600,2150,0.6260869565217392,79,36,43,189.61075047332105,0.45192778576361,0.7751828771821849,0.12059243730103283,17204461.247637156,603080.161730734,17807541.40936789,155,0,112.88990825688073,91,127,75,35.84541695783838,0.6208791208791209,40.76086956521741,132730.43478260952,1458.5762064023024,0
157,512,0,0,218,0.0,0.0,1.0,218,7450,5500,1950,0.738255033557047,94,55,39,192.96787420380682,0.45186569004636484,0.7799186525525363,0.12339262832965676,17229686.8967973,613905.2107344328,17843592.107531734,156,1,113.88990825688073,76,142,76,35.56473901027274,0.6284265350877193,40.57088744588745,132827.70562770576,1747.732968785602,0
158,512,3,0,221,0.013574660633484163,0.0,1.0,221,7800,5300,2500,0.6794871794871795,103,53,50,191.6796851030859,0.4524312697106814,0.7796190918488377,0.12323660773443015,17254963.843587566,609485.2072008012,17864449.05078837,157,0,113.33031674208145,80,141,80,35.40428307245227,0.6286458333333333,40.380658436214,132925.10288065873,1661.563786008234,0
159,512,4,0,225,0.017777777777777778,0.0,1.0,225,5400,3300,2100,0.6111111111111112,75,33,42,176.21992915607657,0.4538558201058201,0.7668459934714245,0.10523500585914142,16904531.152206693,545383.0564117167,17449914.20861841,158,0,112.29777777777778,96,129,72,38.50218354298134,0.5964626736111112,43.03049828178697,131568.38487972645,1370.5040091638173,8
160,512,5,0,230,0.021739130434782608,0.0,1.0,230,6750,4600,2150,0.6814814814814815,89,46,43,179.10879043944158,0.4550099677235618,0.7782078868973845,0.1078425685204496,16944280.040008117,554223.900566611,17498503.940574728,159,0,110.83478260869565,102,128,78,38.12060222493024,0.597937091503268,42.728559870550185,131722.97734627954,1291.401738689015,0
161,512,4,0,234,0.017094017094017096,0.0,1.0,234,7850,5200,2650,0.6624203821656051,105,52,53,172.2074897770035,0.4560513798711224,0.7714908590283553,0.10437766363839193,16976251.735891905,530037.539452088,17506289.27534399,160,0,109.92307692307692,88,146,88,38.05137032996998,0.6044034090909092,42.48595505617977,131847.19101123573,1498.263534218588,0
162,512,4,1,237,0.01680672268907563,0.004201680672268907,0.9957983193277311,238,8800,6000,2800,0.6818181818181818,116,60,56,164.45732267851193,0.45687109231878403,0.7646684298511142,0.10051658357601095,17016333.770267215,503292.13873241836,17519625.908999633,161,0,109.05882352941177,96,142,71,37.94212692991226,0.6050347222222222,42.182130584192436,132002.7491408933,1375.0286368843053,0
163,512,0,0,237,0.0,0.0,1.0,237,7800,5600,2200,0.717948717948718,100,56,44,170.1028823383549,0.4565484278528689,0.7724998133976124,0.10449301324927081,17040440.742315292,524525.6173167542,17564966.359632045,162,1,110.51898734177215,96,141,74,37.61090877558101,0.6068793402777778,41.9995704467354,132096.2199312716,1376.0022909507459,0
164,512,1,0,238,0.004201680672268907,0.0,1.0,238,8300,6500,1800,0.7831325301204819,101,65,36,169.23095964422336,0.4565128266496472,0.7726514334547374,0.1043169945269616,17056900.000000007,521411.11111111124,17578311.11111112,163,0,111.05042016806723,99,139,77,37.50672585418345,0.6073232323232323,41.875,132160.00000000006,1334.9494949494956,0
165,512,0,1,237,0.0,0.004201680672268907,0.9957983193277311,238,7150,4500,2650,0.6293706293706294,98,45,53,169.39771756791941,0.45628198536798686,0.7724014944379016,0.10476328500968288,17072523.447772898,523659.3010355048,17596182.748808403,164,1,112.05042016806723,103,135,80,37.38223021629241,0.6075040453074434,41.756810897435905,132220.51282051322,1283.6942992282836,0
166,512,1,0,238,0.004201680672268907,0.0,1.0,238,7300,4700,2600,0.6438356164383562,99,47,52,194.61939824663753,0.45600017433133594,0.7932919941178678,0.11923186264824957,17027583.62213824,607879.6156269702,17635463.237765208,165,0,112.95378151260505,91,147,68,37.07762607194077,0.6073717948717949,42.09692028985508,132046.37681159447,1451.0590858416974,8
167,512,1,0,239,0.0041841004184100415,0.0,1.0,239,6600,4000,2600,0.6060606060606061,92,40,52,192.30141225036866,0.45640683051463266,0.7943660271241533,0.11831236425559659,17047821.06659624,601264.0133796079,17649085.079975847,166,0,113.47698744769875,93,146,70,36.98124668985559,0.6083109318996416,41.94370567375886,132124.8226950354,1420.697018226187,0
168,512,2,1,240,0.008298755186721992,0.004149377593360996,0.995850622406639,241,7700,5800,1900,0.7532467532467533,96,58,38,186.00416233090488,0.45638687183033655,0.7909249096506483,0.11532258064516128,17084444.444444478,579655.5555555567,17664100.000000034,167,0,113.52697095435684,100,141,78,36.86155913978495,0.6091666666666666,41.66666666666667,132266.66666666692,1322.6666666666692,0
169,512,1,0,241,0.004149377593360996,0.0,1.0,241,8000,5700,2300,0.7125,103,57,46,184.83770553345323,0.4561671565237437,0.7896064300365262,0.11512894000306827,17106294.244497314,576177.6356666002,17682471.880163915,168,0,113.8298755186722,81,160,81,36.72349787868366,0.6168981481481481,41.5015243902439,132351.21951219506,1633.9656729900626,0
170,512,1,0,242,0.004132231404958678,0.0,1.0,242,6900,4500,2400,0.6521739130434783,93,45,48,186.35196612765247,0.45598216224866545,0.7918076432414451,0.11666572669336189,17130401.234567847,583156.7901234544,17713558.024691302,169,0,114.35537190082644,83,159,76,36.49888143176736,0.6179718875502008,41.319444444444436,132444.44444444403,1595.7161981258316,0
171,512,0,1,241,0.0,0.004132231404958678,0.9958677685950413,242,7750,5100,2650,0.6580645161290323,104,51,53,181.00031812184312,0.45583606243498737,0.7845288970107058,0.11385186041904617,17152660.551637143,564777.4032964564,17717437.9549336,170,1,115.35537190082644,92,150,68,36.466266407038795,0.6166213768115942,41.151433691756246,132530.46594981948,1440.5485429328205,0
172,512,0,1,240,0.0,0.004149377593360996,0.995850622406639,241,8350,5900,2450,0.7065868263473054,108,59,49,181.47329961579788,0.45512765099124025,0.7851830061311722,0.11470482145526734,17175470.294398792,566827.8533555267,17742298.14775432,171,3,116.8298755186722,96,145,71,36.27884881149805,0.6171875,40.97938144329894,132618.55670102948,1381.443298969057,0
173,512,1,0,241,0.004149377593360996,0.0,1.0,241,7350,5600,1750,0.7619047619047619,91,56,35,183.81132135775985,0.4551759163208852,0.7890825145309086,0.11669176463103897,17195961.40983334,576612.4777516982,17772573.88758504,172,0,117.81327800829875,98,143,73,36.06098435639272,0.6181972789115646,40.824915824915806,132697.64309764217,1354.0575826290017,0
174,512,0,1,240,0.0,0.004149377593360996,0.995850622406639,241,7250,4400,2850,0.6068965517241379,101,44,57,187.88944187344546,0.4546579644997695,0.7948808116245312,0.1198194272358037,17217021.88783216,591529.3266455287,17808551.214477688,173,1,118.81327800829875,100,141,76,35.79364684827999,0.6192708333333333,40.666254125412514,132778.87788778733,1327.7887788778733,0
175,512,2,0,242,0.008264462809917356,0.0,1.0,242,7600,6000,1600,0.7894736842105263,92,60,32,185.81860821695975,0.4544350759576146,0.7925067618513701,0.11931966078085676,17249176.989080902,585043.6121998074,17834220.601280708,174,0,118.92148760330579,82,160,82,35.60079533916745,0.6274136178861789,40.42419678714861,132902.81124498055,1620.7659907924458,0
176,512,2,0,244,0.00819672131147541,0.0,1.0,244,7700,6200,1500,0.8051948051948052,92,62,30,182.64877456860265,0.45491522183993344,0.7894329347213151,0.11793351830891126,17274798.90260648,574544.1700960295,17849343.07270251,175,0,118.93852459016394,89,155,80,35.48684132359056,0.62687265917603,40.23148148148151,133001.4814814828,1494.3986683312673,0
177,512,0,2,242,0.0,0.00819672131147541,0.9918032786885246,244,7300,5100,2200,0.6986301369863014,95,51,44,185.44400423574822,0.45454944736782926,0.7926686606654123,0.12007843080889874,17287928.323203187,585088.5306390858,17873016.853842273,176,1,119.93852459016394,90,154,67,35.31370217014651,0.6275462962962963,40.132783882783905,133052.01465201573,1478.3557183557302,0
178,512,0,2,240,0.0,0.008264462809917356,0.9917355371900827,242,7800,6300,1500,0.8076923076923077,93,63,30,189.33699551030475,0.4533002126127362,0.796229080184901,0.12314143590751037,17308313.149811134,599220.8018273546,17907533.95163849,177,2,121.85950413223141,91,151,68,35.05647180492056,0.6287774725274725,39.97961956521742,133130.43478261,1462.9718107979122,0
179,512,0,0,240,0.0,0.0,1.0,240,7050,5300,1750,0.75177304964539,88,53,35,189.89981858219045,0.4529786291259879,0.7961161111589568,0.12380273967197278,17319320.281085994,602737.1558690236,17922057.436955016,178,3,123.85,92,148,69,34.9576012689117,0.629302536231884,39.89695340501795,133172.7598566323,1447.5299984416554,0
180,512,2,0,242,0.008264462809917356,0.0,1.0,242,7750,5400,2350,0.6967741935483871,101,54,47,191.88229931067352,0.45305837991381187,0.8013960236626192,0.12596270192766515,17351089.648209233,609723.395448805,17960813.043658037,179,0,123.81818181818181,96,146,74,34.6630126909486,0.6305338541666667,39.65850515463919,133294.8453608253,1388.4879725085968,0
181,512,1,0,243,0.00411522633744856,0.0,1.0,243,6950,5200,1750,0.7482014388489209,87,52,35,180.50371834311346,0.4533940697661236,0.7888236210442445,0.11339893443169174,17146829.333585396,563463.2905013907,17710292.624086786,180,0,124.3045267489712,83,160,68,36.523917904488094,0.6192269076305221,41.19543650793653,132507.93650793735,1596.4811627462332,8
182,512,1,0,244,0.004098360655737705,0.0,1.0,244,6300,4300,2000,0.6825396825396826,83,43,40,176.01893795318333,0.45318192167577415,0.7849822416232952,0.11129218200605452,17176943.045512106,549593.4544306777,17726536.499942783,181,0,124.79098360655738,87,157,73,36.40882762875294,0.6200909961685823,40.968276515151544,132624.24242424374,1524.4165795890085,0
183,512,0,0,244,0.0,0.0,1.0,244,6950,4700,2250,0.6762589928057554,92,47,45,176.52614785990707,0.45291628718882815,0.7850731676248335,0.1120768366608147,17196380.2812073,551372.1536351242,17747752.434842426,182,1,125.79098360655738,89,155,76,36.246585614552195,0.6209035580524345,40.82175925925929,132699.25925926058,1491.0029130253997,0
184,512,1,1,244,0.004081632653061225,0.004081632653061225,0.9959183673469387,245,8100,5600,2500,0.691358024691358,106,56,50,175.27796049471073,0.4527921824467492,0.7852355050104614,0.1119882585924328,17225833.494621173,546761.7925517396,17772595.287172914,183,0,126.2734693877551,82,163,82,36.05318754334191,0.625635162601626,40.5998995983936,132812.85140562343,1619.6689195807735,0
185,512,0,0,244,0.0,0.0,1.0,244,6450,4600,1850,0.7131782945736435,83,46,37,177.81717605534362,0.45250729440734,0.7873186924714208,0.11425490373058825,17252155.6122449,558295.9183673474,17810451.53061225,184,1,127.6639344262295,83,161,83,35.785683576956146,0.6272590361445782,40.401785714285715,132914.28571428574,1601.3769363166957,0
186,512,2,1,245,0.008130081300813009,0.0040650406504065045,0.9959349593495935,246,7750,5800,1950,0.7483870967741936,97,58,39,205.50509121019473,0.4530871494939439,0.8095602318907862,0.12715467248251508,17074801.361111175,644841.7222222247,17719643.0833334,185,0,127.6178861788618,99,147,72,36.432200285026674,0.6086910774410774,41.73958333333334,132229.33333333384,1335.6498316498366,8
187,512,2,0,247,0.008097165991902834,0.0,1.0,247,7100,5000,2100,0.704225352112676,92,50,42,205.43280063594733,0.45314094335275334,0.8081577887529945,0.12756067919852404,17091602.48121291,645735.1530143763,17737337.634227287,186,0,127.9919028340081,76,171,76,36.304428446771404,0.6178728070175439,41.61255411255412,132294.3722943726,1740.7154249259552,0
188,512,2,0,249,0.008032128514056224,0.0,1.0,249,8500,6000,2500,0.7058823529411765,110,60,50,201.0432212468599,0.45347316686099237,0.8019558094287389,0.12568817213202976,17123832.199546494,630226.077097506,17754058.276644,187,0,127.95582329317268,83,166,78,36.16944764096662,0.6174698795180723,41.36904761904762,132419.04761904766,1595.4102122776826,0
189,512,2,1,250,0.00796812749003984,0.00398406374501992,0.9960159362549801,251,7850,5400,2450,0.6878980891719745,103,54,49,195.98476168884565,0.45371513944223113,0.7973738847427192,0.12329674248019762,17153402.77777775,614311.1111111097,17767713.88888886,188,0,127.92828685258964,89,162,69,36.07268611670017,0.617626404494382,41.14583333333333,132533.3333333331,1489.1385767790237,0
190,512,1,2,249,0.00398406374501992,0.00796812749003984,0.9920318725099602,251,7650,5800,1850,0.7581699346405228,95,58,37,197.07540062879548,0.45370053120849935,0.7999626686623658,0.12444406751957911,17170853.795167066,618940.5781642081,17789794.373331275,189,0,128.9243027888446,90,161,71,35.91022099447515,0.6186342592592593,41.01419413919415,132600.73260073326,1473.3414733414807,0
191,512,2,1,250,0.00796812749003984,0.00398406374501992,0.9960159362549801,251,7000,5300,1700,0.7571428571428571,87,53,34,193.2774921762013,0.4534754316069057,0.7949654510164499,0.12239903538048517,17184408.840066522,607071.8890277159,17791480.729094237,190,0,129.89641434262947,97,154,74,35.90440170940175,0.617590206185567,40.91198979591835,132653.0612244889,1367.5573322112257,0
192,512,2,0,252,0.007936507936507936,0.0,1.0,252,7350,5600,1750,0.7619047619047619,91,56,35,191.96059393896428,0.4536608855582959,0.7947482760992026,0.1222749493253959,17211652.035541803,603041.7894826741,17814693.82502448,191,0,129.69444444444446,101,151,80,35.72928974661938,0.6186056105610561,40.706699346405216,132758.16993463988,1314.4373260855434,0
193,512,1,0,253,0.003952569169960474,0.0,1.0,253,7900,6000,1900,0.759493670886076,98,60,38,190.0160271589678,0.4539128343476169,0.7921545718222276,0.12161139282259599,17233761.530256774,596438.1797968962,17830199.71005367,192,0,130.17786561264822,85,168,85,35.61006138835725,0.6251225490196078,40.54021317829461,132843.4108527146,1562.86365709076,0
194,512,1,1,253,0.003937007874015748,0.003937007874015748,0.9960629921259843,254,7200,5200,2000,0.7222222222222222,92,52,40,188.06825691474444,0.45378165426950084,0.7923809640799557,0.12107062679719736,17260947.359396596,591247.2565157819,17852194.615912378,193,0,130.66141732283464,89,165,81,35.45218594458062,0.6258192883895131,40.335648148148174,132948.1481481494,1493.799417394937,0
195,512,1,2,252,0.003937007874015748,0.007874015748031496,0.9921259842519685,254,7750,5900,1850,0.7612903225806451,96,59,37,185.60204512846005,0.45368018165219465,0.7895493113800494,0.11998954957636006,17280559.60226632,582911.4406289819,17863471.042895302,194,0,131.50787401574803,92,162,69,35.36601138127264,0.6263586956521738,40.18817204301078,133023.65591397978,1445.9093034128236,0
196,512,2,0,254,0.007874015748031496,0.0,1.0,254,8550,5700,2850,0.6666666666666666,114,57,57,182.4522385800987,0.45383709138630396,0.7857963428972501,0.11860880468953765,17306177.78260044,572160.175540129,17878337.95814057,195,0,132.22834645669292,95,159,76,35.251822329799964,0.6274122807017544,39.99565972222224,133122.22222222324,1401.286549707613,0
197,512,0,0,254,0.0,0.0,1.0,254,9050,6800,2250,0.7513812154696132,113,68,45,202.2659340158493,0.45349766061850966,0.8149365971317968,0.1274416829008949,17160544.325538322,634348.705245076,17794893.0307834,196,1,133.22834645669292,86,168,63,35.85512624861266,0.6191860465116279,41.091954022988496,132560.91954022943,1541.4060411654584,7
198,512,2,0,256,0.0078125,0.0,1.0,256,7200,5600,1600,0.7777777777777778,88,56,32,203.00678206884072,0.45380572150735293,0.8167248528144759,0.12852174821158163,17182998.866213042,639253.0612244852,17822251.92743753,197,0,133.1796875,90,166,66,35.66317250622246,0.6195601851851852,40.92261904761903,132647.6190476182,1473.8624338624245,0
199,512,2,1,257,0.007751937984496124,0.003875968992248062,0.9961240310077519,258,8600,5800,2800,0.6744186046511628,114,58,56,199.9641247157975,0.4540897505504781,0.8148525846188484,0.1269554664492954,17196299.44598323,627528.5934133523,17823828.039396584,198,0,133.13953488372093,94,164,71,35.63974559659286,0.6193484042553192,40.82236842105261,132698.9473684199,1411.6909294512757,0
200,512,1,2,256,0.003875968992248062,0.007751937984496124,0.9922480620155039,258,8300,6100,2200,0.7349397590361446,105,61,44,199.61222346531605,0.45410106174403525,0.8163429470203987,0.12732792384277256,17218221.915187534,627493.5121219609,17845715.427309494,199,0,134.10852713178295,96,162,74,35.48041752933055,0.6204427083333333,40.65721649484535,132783.50515463875,1383.161512027487,0
201,512,0,0,256,0.0,0.0,1.0,256,7700,5100,2600,0.6623376623376623,103,51,52,195.46045156131717,0.45355168760212417,0.8120609948394513,0.1253246424716675,17242267.57369606,615136.281179134,17857403.854875192,200,1,135.8828125,76,180,76,35.403526376146814,0.6293859649122807,40.47619047619046,132876.1904761898,1748.370927318287,0
202,512,1,0,257,0.0038910505836575876,0.0,1.0,257,7400,5300,2100,0.7162162162162162,95,53,42,192.5309393449384,0.45313576625324253,0.8099292972279988,0.12408898247061517,17266389.715116628,606062.8461894364,17872452.561306063,201,0,136.3501945525292,81,176,75,35.294585208374095,0.6291152263374485,40.294715447154466,132969.10569105664,1641.5938974204523,0
203,512,2,1,258,0.007722007722007722,0.003861003861003861,0.9961389961389961,259,8500,5700,2800,0.6705882352941176,113,57,56,194.19827640275082,0.4536093402372472,0.81182078348108,0.12571906523671178,17286901.177813888,611117.2826152301,17898018.460429117,202,0,136.28957528957528,85,174,62,35.09407725055158,0.6291666666666667,40.140503875969,133048.06201550429,1565.271317829462,0
204,512,1,1,258,0.003861003861003861,0.003861003861003861,0.9961389961389961,259,6300,4300,2000,0.6825396825396826,83,43,40,190.0002599291612,0.45323645905041254,0.8078693614017722,0.12363524022878608,17310642.79155191,599705.3259871454,17910348.117539056,203,0,137.28571428571428,87,172,68,35.021394756008775,0.6302681992337165,39.96212121212122,133139.39393939418,1530.3378613723469,0
205,512,0,0,258,0.0,0.0,1.0,258,6950,4700,2250,0.6762589928057554,92,47,45,193.18987414658892,0.4527826792949859,0.8107707653021103,0.12607826978277417,17324093.82716054,610817.9012345708,17934911.72839511,204,1,138.81007751937983,89,169,69,34.83549119060333,0.6306179775280899,39.86111111111112,133191.1111111115,1496.5293383270955,0
206,512,3,0,261,0.011494252873563218,0.0,1.0,261,7200,4700,2500,0.6527777777777778,97,47,50,191.0078588161404,0.4529969790745653,0.8108937865972667,0.12542285950582024,17352340.2893199,603486.6728224119,17955826.96214231,205,0,138.2030651340996,94,167,75,34.676216447664004,0.6312056737588653,39.64912280701756,133299.64912280784,1418.081373646892,0
207,512,0,0,261,0.0,0.0,1.0,261,7950,5500,2450,0.6918238993710691,104,55,49,195.77085974761894,0.45273418312211416,0.8154665504605954,0.12905059583842532,17370131.041397285,619963.0975806302,17990094.138977915,206,1,139.2030651340996,76,185,76,34.416168960443194,0.6391173245614035,39.51569264069264,133367.96536796543,1754.8416495784925,0
208,512,0,0,261,0.0,0.0,1.0,261,8150,6200,1950,0.7607361963190185,101,62,39,200.50283249421568,0.4525278760192553,0.8182206895020534,0.1328148809023567,17392375.17361116,637094.0972222247,18029469.270833384,207,2,140.2030651340996,79,182,79,34.12283111865985,0.6395042194092827,39.34895833333334,133453.33333333372,1689.282700421946,0
209,512,0,1,260,0.0,0.0038314176245210726,0.9961685823754789,261,8150,5200,2950,0.6380368098159509,111,52,59,198.72261046149484,0.45215455840455837,0.8167860941817622,0.1319904397361897,17404645.731520444,631389.3267850507,18036035.058305494,208,3,141.2030651340996,82,179,78,34.075475709151554,0.6392276422764227,39.257028112449795,133500.40160642558,1628.0536781271412,0
210,512,0,0,260,0.0,0.0,1.0,260,7650,5200,2450,0.6797385620915033,101,52,49,198.05906694837643,0.4517018735768736,0.8149733756656092,0.13211502765565392,17424152.732708313,630552.2865212398,18054705.019229554,209,4,142.56153846153848,85,175,63,33.943805422721574,0.6395833333333334,39.11094961240309,133575.19379844915,1571.472868217049,0
211,512,0,0,260,0.0,0.0,1.0,260,6750,4800,1950,0.7111111111111111,87,48,39,196.71464901673116,0.451503564003564,0.8148808887386669,0.1317911329834824,17443918.732202612,627544.8701763195,18071463.60237893,210,5,143.56153846153848,88,172,64,33.828035092438974,0.6400331439393939,38.96301498127339,133650.93632958713,1518.7606401089447,0
212,512,0,0,260,0.0,0.0,1.0,260,7900,5600,2300,0.7088607594936709,102,56,46,197.8014113193829,0.45098907286407286,0.8155648439297505,0.1331508829217046,17465434.027777668,631037.4999999949,18096471.527777664,211,6,144.56153846153848,91,169,68,33.635551678298405,0.6406822344322345,38.802083333333314,133733.33333333247,1469.59706959706,0
213,512,0,0,260,0.0,0.0,1.0,260,7250,4600,2650,0.6344827586206897,99,46,53,197.05802391991895,0.45075611325611326,0.8152110265971666,0.1331468507406779,17482289.5710486,629755.0872933257,18112044.658341926,212,7,145.56153846153848,92,168,72,33.52647764776478,0.6416440217391304,38.67607526881719,133797.849462365,1454.3244506778806,0
214,512,0,0,260,0.0,0.0,1.0,260,8500,6100,2400,0.7176470588235294,109,61,48,197.448149461679,0.4502756534006534,0.8162272205878174,0.1337734567866864,17494527.963769883,630352.4344303904,18124880.398200274,213,8,146.56153846153848,96,164,74,33.42302373029894,0.6413845486111112,38.58462199312714,133844.67353951867,1394.2153493699861,0
215,512,0,1,259,0.0,0.0038461538461538464,0.9961538461538462,260,7950,5000,2950,0.6289308176100629,109,50,59,197.64777274868928,0.4499879343629343,0.8172127169515602,0.13462187325260372,17518392.13095714,632544.2373643713,18150936.368321512,214,9,147.56153846153848,76,184,76,33.236045749944005,0.6503563596491229,38.4063852813853,133935.9307359313,1762.3148781043592,0
216,512,0,0,259,0.0,0.0,1.0,259,7750,5500,2250,0.7096774193548387,100,55,45,195.8659768563218,0.4497994672413277,0.8143210162676033,0.13407209318320726,17540622.288350288,627572.223835104,18168194.51218539,215,10,148.84942084942085,82,177,74,33.113483083217446,0.6495172764227642,38.240461847389575,134020.8835341373,1634.4010187089916,0
217,512,0,0,259,0.0,0.0,1.0,259,8150,5800,2350,0.7116564417177914,105,58,47,184.02928985016354,0.449707805812457,0.8026236219007308,0.11749562351971994,17222500.000000034,573938.8888888909,17796438.888888925,216,11,149.84942084942085,90,169,84,35.85174029451141,0.6225694444444445,40.62500000000001,132800.00000000026,1475.5555555555584,8
218,512,0,2,257,0.0,0.007722007722007722,0.9922779922779923,259,7450,5500,1950,0.738255033557047,94,55,39,180.63620101110982,0.4495070236349306,0.7974850188452931,0.11575334823174373,17239601.62156858,563569.2287730245,17803170.850341603,217,12,150.84942084942085,88,171,88,35.80867761140181,0.6245265151515151,40.49625468164795,132865.91760299652,1509.8399727613241,0
219,512,1,0,258,0.003875968992248062,0.0,1.0,258,8200,5600,2600,0.6829268292682927,108,56,52,181.90625079273585,0.4494681853829216,0.7978351357639744,0.11728533459040703,17268134.585195195,568436.3241154535,17836570.90931065,218,0,151.35658914728683,90,168,80,35.557153246066406,0.6260416666666666,40.28159340659344,132975.82417582552,1477.5091575091724,0
220,512,0,0,258,0.0,0.0,1.0,258,8300,6100,2200,0.7349397590361446,105,61,44,178.84974672967329,0.44920802793110726,0.7957303170842911,0.11573952206444117,17285170.944906287,558389.6891351253,17843560.634041414,219,1,152.35658914728683,94,164,67,35.506160857456344,0.6261081560283688,40.15350877192985,133041.4035087732,1415.334079880566,0
221,512,0,1,257,0.0,0.003875968992248062,0.9961240310077519,258,7600,4800,2800,0.631578947368421,104,48,56,177.70244739349965,0.44883413014407947,0.7949764633445187,0.11541265755220631,17301844.648196504,555716.0276813331,17857560.675877836,220,2,153.35658914728683,95,163,72,35.40844950401384,0.6270833333333333,40.02821180555558,133105.55555555658,1401.111111111122,0
222,512,0,0,257,0.0,0.0,1.0,257,6800,4700,2100,0.6911764705882353,89,47,42,179.30581626384165,0.4483998814445525,0.794760361476784,0.1167348616474506,17312958.605210967,562662.8349298973,17875621.440140866,221,3,154.88715953307394,97,160,74,35.28178560723725,0.6273625429553265,39.94472789115649,133148.29931972927,1372.6628795848378,0
223,512,2,0,259,0.007722007722007722,0.0,1.0,259,9300,7000,2300,0.7526881720430108,116,70,46,179.0251209675974,0.44875128450709845,0.7984986163095196,0.11743052839588532,17347497.22329037,560027.5577769304,17907524.7810673,222,0,154.6833976833977,101,158,80,35.02517327056362,0.6289191419141914,39.685457516339895,133281.0457516354,1319.6143143726276,0
224,512,0,0,259,0.0,0.0,1.0,259,7950,5500,2450,0.6918238993710691,104,55,49,177.22428551334554,0.448432651921024,0.797000492615848,0.11684489494018768,17370916.41676267,555959.6501345574,17926876.066897225,223,1,155.6833976833977,84,175,84,34.893285033245505,0.6359126984126984,39.509803921568604,133370.98039215597,1587.7497665732853,0
225,512,1,1,259,0.0038461538461538464,0.0038461538461538464,0.9961538461538462,260,7000,5000,2000,0.7142857142857143,90,50,40,176.74942051395033,0.4483788733788734,0.795832541588213,0.11687929455726444,17384527.241229303,555541.0231592507,17940068.264388554,224,0,156.08076923076922,88,172,88,34.801818998428054,0.6355350378787878,39.407771535580515,133423.22097378233,1516.172965611163,0
226,512,2,0,261,0.007662835249042145,0.0,1.0,261,8100,6000,2100,0.7407407407407407,102,60,42,176.41805411345075,0.4482463896257,0.7949631248886151,0.1173248087381737,17410429.240374554,554002.8095733586,17964432.049947914,225,0,155.93103448275863,92,169,85,34.61296868960186,0.6362092391304348,39.213709677419345,133522.58064516084,1451.3323983169655,0
227,512,0,1,260,0.0,0.0038314176245210726,0.9961685823754789,261,7850,5500,2350,0.7006369426751592,102,55,47,179.4982608058676,0.44803946851360643,0.7995217927435574,0.1199830980334191,17433586.1186559,565809.6775816063,17999395.796237506,226,1,156.93103448275863,93,168,69,34.356156312369954,0.6376568100358423,39.04033687943261,133611.3475177297,1436.6811561046204,0
228,512,0,1,259,0.0,0.0038461538461538464,0.9961538461538462,260,6300,4300,2000,0.6825396825396826,83,43,40,198.70475027434009,0.4473944411444411,0.8198037565423897,0.12943310061617963,17315409.51979624,629830.8249058014,17945240.344702043,227,2,158.53076923076924,81,179,64,34.75853359709534,0.6328446502057613,39.92632113821135,133157.7235772344,1643.92251329919,8
229,512,0,1,258,0.0,0.003861003861003861,0.9961389961389961,259,7550,5200,2350,0.6887417218543046,99,52,47,197.52982308713376,0.4467989584268654,0.818145829742702,0.1290536096116472,17329197.31066765,625256.6558036375,17954453.966471285,228,3,160.13127413127413,86,173,66,34.683521245589795,0.6320251937984496,39.82279693486588,133210.72796934762,1548.961953131949,0
230,512,1,0,259,0.003861003861003861,0.0,1.0,259,7400,5200,2200,0.7027027027027027,96,52,44,196.9762826918962,0.4471762044436463,0.8182498657276112,0.12923735928121308,17348628.960989635,624253.6885073369,17972882.649496973,229,0,160.28571428571428,88,171,68,34.54921994424958,0.6328125,39.67696629213481,133285.3932584259,1514.6067415730215,0
231,512,0,0,259,0.0,0.0,1.0,259,7000,5200,1800,0.7428571428571429,88,52,36,195.18815579732544,0.44701408218850075,0.8167411841328449,0.1285734178191478,17366819.342799373,619159.4879172666,17985978.83071664,230,1,161.28571428571428,72,187,72,34.45666465786442,0.6407696759259259,39.54052511415525,133355.2511415526,1852.1562658548974,0
232,512,0,0,259,0.0,0.0,1.0,259,9000,6600,2400,0.7333333333333333,114,66,48,196.69621200180174,0.44679022876697294,0.8169860810310259,0.13004429559204864,17383640.938235566,623059.2646700778,18006700.202905644,231,2,162.28571428571428,73,186,73,34.28879465571887,0.6415525114155252,39.41441441441442,133419.81981982008,1827.6687646550697,0
233,512,0,0,259,0.0,0.0,1.0,259,7650,5100,2550,0.6666666666666666,102,51,51,195.6751611059513,0.4465738579110672,0.8160374675211788,0.1300632553613213,17408040.329079296,621814.2191862983,18029854.548265595,232,3,163.28571428571428,76,183,68,34.129011897350786,0.6419956140350878,39.231601731601735,133513.41991342,1756.7555251765789,0
234,512,0,1,258,0.0,0.003861003861003861,0.9961389961389961,259,7750,5600,2150,0.7225806451612903,99,56,43,189.94356322629432,0.44647845519938545,0.8100071394109807,0.12648500719423494,17416375.90522732,602075.6995854899,18018451.60481281,233,4,164.28571428571428,82,177,76,34.214863109271995,0.6401168699186992,39.16917670682731,133545.3815261043,1628.6022137329792,8
235,512,0,1,257,0.0,0.003875968992248062,0.9961240310077519,258,8200,6000,2200,0.7317073170731707,104,60,44,187.44990959332625,0.44629193939211137,0.807190524705204,0.12539958033379373,17437252.614008594,593922.2852103816,18031174.899218976,234,5,165.15503875968992,83,175,69,34.120695935886474,0.6413152610441767,39.01289682539683,133625.39682539704,1609.9445400650245,0
236,512,3,1,259,0.011538461538461539,0.0038461538461538464,0.9961538461538462,260,7700,5500,2200,0.7142857142857143,99,55,44,181.63289895214194,0.4463131744381745,0.8018655609975565,0.12232983874816117,17467755.864197485,574843.8271604916,18042599.691357978,235,0,164.82692307692307,89,171,76,34.04019340688555,0.641502808988764,38.784722222222214,133742.22222222187,1502.721598002493,0
237,512,0,0,259,0.0,0.0,1.0,259,8600,6200,2400,0.7209302325581395,110,62,48,182.5464122893303,0.44605007831752014,0.8021698466269438,0.12341478054420212,17484957.566853188,577963.2545720465,18062920.821425233,236,1,166.25482625482624,90,169,79,33.88539704787352,0.6424768518518518,38.65613553113553,133808.05860805872,1486.756206756208,0
238,512,0,0,259,0.0,0.0,1.0,259,7050,4800,2250,0.6808510638297872,93,48,45,181.02650185511823,0.44562606626560114,0.8015702115974164,0.12289741141773688,17503679.027034324,574875.9567717703,18078554.983806092,237,2,167.25482625482624,81,178,81,33.782711491125816,0.647119341563786,38.516260162601654,133879.67479674914,1652.8354913178905,0
239,512,0,0,259,0.0,0.0,1.0,259,8950,6100,2850,0.6815642458100558,118,61,57,179.91325118458477,0.4453411052248262,0.8009621229626851,0.12290043396659121,17531461.591695596,570078.4505959293,18101540.042291526,238,3,168.25482625482624,84,175,84,33.60065249289754,0.6480654761904762,38.30882352941178,133985.8823529419,1595.070028011213,0
240,512,1,0,260,0.0038461538461538464,0.0,1.0,260,8300,5400,2900,0.6506024096385542,112,54,58,200.30240172193157,0.4454914736164736,0.8252001839285261,0.1278412914477417,17220891.510426115,629577.185866237,17850468.696292352,239,0,168.60384615384615,85,175,70,35.442011472781346,0.6241421568627451,40.63711240310079,132793.79844961286,1562.2799817601513,8
241,512,1,1,260,0.0038314176245210726,0.0038314176245210726,0.9961685823754789,261,8150,5600,2550,0.6871165644171779,107,56,51,199.83353482044168,0.4455422929560861,0.8240831489946787,0.12809913240436943,17241198.766333908,628723.9388036688,17869922.705137577,240,0,168.95402298850576,73,188,73,35.29823895277358,0.6307077625570776,40.484234234234236,132872.07207207213,1820.1653708503031,0
242,512,1,0,261,0.0038314176245210726,0.0,1.0,261,6600,4600,2000,0.696969696969697,86,46,40,195.66522127222393,0.4456405344336379,0.8198370775702972,0.12612202711570872,17266866.14252316,616905.0368909319,17883771.17941409,241,0,169.79310344827587,77,184,70,35.20953317563975,0.6308170995670996,40.29113247863247,132970.9401709399,1726.8953268953233,0
243,512,0,0,261,0.0,0.0,1.0,261,7700,5700,2000,0.7402597402597403,97,57,40,195.0864025597152,0.44548887415266725,0.8200585213622935,0.12633142187822216,17288271.006944485,614641.3194444469,17902912.326388933,242,1,170.79310344827587,79,182,61,35.06050205431406,0.6315928270042195,40.13020833333334,133053.33333333366,1684.2194092827046,0
244,512,0,0,261,0.0,0.0,1.0,261,8600,6600,2000,0.7674418604651163,106,66,40,194.4923009598511,0.44543115728460553,0.8180561774243806,0.12654235447112258,17310063.122972462,612534.8013094404,17922597.924281903,243,2,171.79310344827587,86,175,64,34.909023237253315,0.6305717054263567,39.96647509578546,133137.16475095868,1548.1065668716126,0
245,512,2,0,263,0.0076045627376425855,0.0,1.0,263,7750,5300,2450,0.6838709677419355,102,53,49,198.39421457879737,0.4457600450855755,0.8244750665597893,0.1300404398619234,17344139.951989092,627845.4046639263,17971985.35665302,244,0,171.47908745247148,89,174,67,34.546657995760896,0.6321395131086143,39.71064814814816,133268.14814814867,1497.3949230129065,0
246,512,0,1,262,0.0,0.0038022813688212928,0.9961977186311787,263,7150,5400,1750,0.7552447552447552,89,54,35,198.39999999999955,0.4456028260722337,0.824790874524715,0.13052631578947377,17361111.11111116,629138.8888888914,17990250.000000052,245,1,172.47908745247148,76,187,71,34.416666666666664,0.6384320175438596,39.58333333333334,133333.33333333372,1754.3859649122858,0
247,512,2,0,264,0.007575757575757576,0.0,1.0,264,9100,7300,1800,0.8021978021978022,109,73,36,191.5939840922484,0.44587990167838076,0.8168743049763696,0.1228455545062061,17242267.573696103,598802.9478458026,17841070.521541905,246,0,172.6060606060606,76,188,76,35.503870412844016,0.6293859649122807,40.47619047619047,132876.19047619015,1748.3709273182915,8
248,512,0,0,264,0.0,0.0,1.0,264,7450,5100,2350,0.6845637583892618,98,51,47,189.24392321324277,0.44559425048968776,0.8147244433098417,0.12181737626592912,17260562.67361109,593041.3194444437,17853603.993055534,247,1,173.6060606060606,79,185,74,35.42460635843947,0.6294831223628692,40.338541666666664,132946.6666666665,1682.8691983122344,0
249,512,1,1,264,0.0037735849056603774,0.0037735849056603774,0.9962264150943396,265,7850,5600,2250,0.7133757961783439,101,56,45,187.76646974318857,0.4457987897846389,0.8135446885247424,0.12150468644722942,17284975.25447815,588257.7566263472,17873233.011104498,248,0,173.94716981132075,81,184,65,35.27596146011573,0.6305298353909465,40.15497967479675,133040.65040650405,1642.4771655123957,0
250,512,0,0,264,0.0,0.0,1.0,264,7250,4900,2350,0.6758620689655173,96,49,47,188.84283842035896,0.44567436484618045,0.8147903346834178,0.12275673308925532,17305934.138159018,593570.3448331455,17899504.482992165,249,1,175.1590909090909,82,182,66,35.08752876059919,0.6317327235772358,39.99748995983935,133121.2851405619,1623.4303065922184,0
251,512,0,0,264,0.0,0.0,1.0,264,9200,6800,2400,0.7391304347826086,116,68,48,190.68269273771804,0.4457247738794792,0.8160392634141183,0.12435198380025785,17320759.90775793,598553.8278949577,17919313.735652886,250,2,176.1590909090909,85,179,67,34.92622235157158,0.6317401960784313,39.88614341085271,133178.29457364327,1566.8034655722738,0
252,512,0,1,263,0.0,0.003787878787878788,0.9962121212121212,264,8800,6000,2800,0.6818181818181818,116,60,56,193.77319334768015,0.4457133718362331,0.8195823529253217,0.12688363499172806,17339512.894375876,610386.5569272988,17949899.451303173,251,3,177.1590909090909,89,175,69,34.70233330368525,0.6317883895131087,39.745370370370374,133250.3703703705,1497.1951727007922,0
253,512,0,0,263,0.0,0.0,1.0,263,7650,5700,1950,0.7450980392156863,96,57,39,194.7259622110013,0.44538211476504225,0.8210639576197243,0.12802480500081775,17358091.91871454,615764.2302037381,17973856.148918275,252,4,178.7718631178707,91,172,71,34.535430617155114,0.632554945054945,39.60597826086956,133321.73913043464,1465.0740563784027,0
254,512,0,0,263,0.0,0.0,1.0,263,8250,6100,2150,0.7393939393939394,104,61,43,193.9542281663481,0.44511242368830967,0.820835136061377,0.12824012001353538,17383949.667438127,613488.108046121,17997437.77548425,253,5,179.7718631178707,72,191,72,34.35788796407842,0.6420717592592593,39.412100456621005,133421.00456621006,1853.0695078640285,0
255,512,0,0,263,0.0,0.0,1.0,263,8700,5900,2800,0.6781609195402298,115,59,56,192.37549357856454,0.44503865168974155,0.8200385150380618,0.1276451180616204,17400021.777777806,608167.5555555568,18008189.333333362,254,6,180.7718631178707,74,189,71,34.276277236162166,0.6423141891891893,39.29166666666667,133482.6666666669,1803.819819819823,0
256,512,2,2,263,0.007547169811320755,0.007547169811320755,0.9924528301886792,265,8050,5800,2250,0.7204968944099379,103,58,45,191.88995763422426,0.4453473413379074,0.819316602769081,0.1279644865406929,17422894.375857364,607605.6927297676,18030500.06858713,255,0,180.4,80,185,62,34.114352262644196,0.64140625,39.120370370370374,133570.37037037057,1669.629629629632,0
257,512,0,0,263,0.0,0.0,1.0,263,7950,5900,2050,0.7421383647798742,100,59,41,194.1925169372642,0.44474658713803344,0.8195719124107661,0.1299365373947024,17438170.997242,616722.4633473662,18054893.460589368,256,8,182.7718631178707,82,181,63,33.93771638776689,0.6417682926829269,39.006024096385545,133628.91566265075,1629.620922715253,0
258,512,0,0,263,0.0,0.0,1.0,263,7050,5100,1950,0.723404255319149,90,51,39,192.06731604048858,0.4442954895074449,0.8170409008047532,0.12909646317901677,17458629.534211174,610996.4232762287,18069625.9574874,257,9,183.7718631178707,86,177,67,33.837188421744365,0.6418362403100775,38.852969348659,133707.27969348652,1554.7358103893782,0
259,512,2,0,265,0.007547169811320755,0.0,1.0,265,7400,5300,2100,0.7162162162162162,95,53,42,188.18348848802597,0.4443443872689156,0.8151143958804443,0.12713365658535744,17481690.12345676,597553.0864197516,18079243.20987651,258,0,183.37735849056602,89,176,72,33.7629550890247,0.6425561797752809,38.68055555555555,133795.55555555533,1503.320848938824,0
260,512,0,0,265,0.0,0.0,1.0,265,7950,5400,2550,0.6792452830188679,105,54,51,190.85487143225396,0.4441085382123118,0.8175360139690555,0.12934241286959317,17495779.85894316,606880.9631171202,18102660.82206028,259,1,184.37735849056602,92,173,74,33.5858504712939,0.6426630434782609,38.57526881720429,133849.46236559085,1454.8854604955527,0
261,512,0,0,265,0.0,0.0,1.0,265,8750,5600,3150,0.64,119,56,63,188.20245599424368,0.44369044215742326,0.8144901094406205,0.12797379892512278,17510870.097384714,597367.7517847939,18108237.849169508,260,2,185.37735849056602,78,187,78,33.54035375178553,0.6489049145299146,38.46255274261604,133907.17299578086,1716.7586281510366,0
262,512,0,0,265,0.0,0.0,1.0,265,7650,5400,2250,0.7058823529411765,99,54,45,186.43182913174076,0.44296502763483897,0.8116012581029293,0.12737472152867166,17532213.35139756,593062.5207657949,18125275.872163355,261,3,186.37735849056602,82,183,82,33.42435178080443,0.6488821138211383,38.303212851405625,133988.75502008034,1634.0092075619552,0
263,512,0,1,264,0.0,0.0037735849056603774,0.9962264150943396,265,7250,5300,1950,0.7310344827586207,92,53,39,187.352546049663,0.44259159996188296,0.812497444535103,0.12829282355561017,17542304.31767236,597069.0754987852,18139373.393171147,262,4,187.37735849056602,82,183,78,33.32354492281137,0.6496443089430894,38.22791164658636,134027.3092369483,1634.479380938394,0
264,512,0,0,264,0.0,0.0,1.0,264,8400,6400,2000,0.7619047619047619,104,64,40,187.95198487447823,0.4423203638091946,0.8116135915366676,0.1294582875928718,17568406.1240238,599203.3604182468,18167609.484442044,263,5,188.25757575757575,83,181,67,33.109516765286,0.6512299196787148,38.03323412698415,134126.98412698501,1615.9877605660845,0
265,512,0,0,264,0.0,0.0,1.0,264,7950,5900,2050,0.7421383647798742,100,59,41,187.29320560172306,0.4420086079425433,0.8109507908027638,0.1294025784157364,17582116.527942996,597852.1931562988,18179968.721099295,264,6,189.25757575757575,86,178,69,33.02266081871347,0.6511627906976745,37.93103448275863,134179.31034482812,1560.2245388933502,0
266,512,0,0,264,0.0,0.0,1.0,264,8500,6300,2200,0.7411764705882353,107,63,44,184.88404799105726,0.44168755040903335,0.8095176985225172,0.12827368619212418,17600696.075130966,589517.5875661111,18190213.662697077,265,7,190.25757575757575,88,176,70,32.944806499129584,0.6518702651515151,37.79260299625471,134250.18726591882,1525.5703098399865,0
267,512,0,0,264,0.0,0.0,1.0,264,8050,5900,2150,0.7329192546583851,102,59,43,184.77123574768518,0.4413103828206015,0.8092126600024054,0.12880622968548094,17621743.85633282,590348.2776727633,18212092.134005584,266,8,191.25757575757575,91,173,74,32.78813510558724,0.6524725274725275,37.63586956521741,134330.4347826096,1476.1586239847209,0
268,512,0,0,264,0.0,0.0,1.0,264,7600,5600,2000,0.7368421052631579,96,56,40,186.8401580501127,0.4409512184583477,0.811529795501418,0.13074347876692796,17638494.65577279,598715.8258501358,18237210.481622927,267,9,192.25757575757575,92,172,75,32.60685584240099,0.653419384057971,37.5112007168459,134394.2652329759,1460.8072307932161,0
269,512,0,0,264,0.0,0.0,1.0,264,6950,4600,2350,0.6618705035971223,93,46,47,184.0394107013303,0.440627460440911,0.808876522663708,0.12930100076604642,17656157.544378597,590135.7659434527,18246293.31032205,268,10,193.25757575757575,77,187,77,32.546561149249925,0.6603084415584415,37.37980769230767,134461.53846153768,1746.2537462537362,0
270,512,0,0,264,0.0,0.0,1.0,264,6100,4400,1700,0.7213114754098361,78,44,34,182.18567573896382,0.4405086391481354,0.8077066074230874,0.1285621864775513,17675460.841389257,585143.1554772145,18260603.996866472,269,11,194.25757575757575,78,186,78,32.44910845711226,0.6613247863247863,37.2362869198312,134535.02109704548,1724.8079627826344,0
271,512,0,0,264,0.0,0.0,1.0,264,7650,5400,2250,0.7058823529411765,99,54,45,179.63112082386434,0.43998444521258206,0.8053661801460448,0.1272355984712892,17691889.955799274,575152.804450533,18267042.76024981,270,12,195.25757575757575,80,184,75,32.391950396243004,0.66171875,37.11419753086417,134597.5308641964,1682.469135802455,0
272,512,1,0,265,0.0037735849056603774,0.0,1.0,265,7950,5500,2450,0.6918238993710691,104,55,49,171.9741253073947,0.43980667524299605,0.7980830169661584,0.11538111855999822,17450406.925207578,539253.6934441292,17989660.618651707,271,0,195.51698113207547,94,171,72,34.42447818235268,0.6386303191489362,38.9144736842105,133675.78947368285,1422.0828667413068,7
273,512,0,0,265,0.0,0.0,1.0,265,7400,5300,2100,0.7162162162162162,95,53,42,170.5728636847618,0.4394010863350486,0.7966274813286194,0.11491224500868044,17468987.921699107,535547.0590957397,18004534.980794847,272,1,196.51698113207547,97,168,76,34.319729275173636,0.6391752577319587,38.775510204081606,133746.93877550878,1378.83442036607,0
274,512,1,1,265,0.0037593984962406013,0.0037593984962406013,0.9962406015037594,266,7500,5400,2100,0.72,96,54,42,171.11913978276206,0.4393873835532227,0.7986947283808175,0.11573152815328783,17486609.423725765,537758.7124610136,18024368.13618678,273,0,196.77443609022558,101,165,78,34.171485881004486,0.6394389438943895,38.64379084967318,133814.37908496615,1324.8948424254074,0
275,512,1,0,266,0.0037593984962406013,0.0,1.0,266,8050,6000,2050,0.7453416149068323,101,60,41,168.83214371901047,0.43926266137040715,0.7972165083084846,0.11491833897425266,17515401.525781844,530182.5575393955,18045584.08332124,274,0,197.45864661654136,82,184,82,34.01255077887602,0.6476117886178862,38.428714859437754,133924.4979919679,1633.2255852679011,0
276,512,0,0,266,0.0,0.0,1.0,266,8500,6000,2500,0.7058823529411765,110,60,50,171.91792647531128,0.4389032723317728,0.7935808085057947,0.11504111467665083,17438516.78652824,537898.7293489676,17976415.51587721,275,1,198.45864661654136,96,170,72,34.5164376234365,0.6371527777777778,39.003436426116835,133630.24054982798,1391.9816723940414,8
277,512,1,1,266,0.003745318352059925,0.003745318352059925,0.9962546816479401,267,8900,6100,2800,0.6853932584269663,117,61,56,175.70904694967288,0.4390059887546582,0.7966280483924895,0.1182428514013977,17464040.99999991,551417.9999999963,18015458.999999907,276,0,198.71161048689137,99,168,77,34.22319932998328,0.6382575757575757,38.812499999999986,133727.9999999993,1350.7878787878717,0
278,512,0,1,265,0.0,0.0037593984962406013,0.9962406015037594,266,8350,6100,2250,0.7305389221556886,106,61,45,178.07292356073344,0.43868958953988746,0.7996538874975891,0.12029835773432172,17481511.44395122,561046.7702169579,18042558.214168176,277,1,199.48872180451127,103,163,79,34.02852306119841,0.6385517799352751,38.68189102564101,133794.8717948708,1298.9793378142795,0
279,512,0,0,265,0.0,0.0,1.0,265,8550,6500,2050,0.7602339181286549,106,65,41,177.47156400664042,0.4382545978654469,0.7983974795030617,0.12021531392223526,17493638.19601906,559374.666162758,18053012.86218182,278,2,201.22641509433961,104,161,83,33.95200822264389,0.6392227564102564,38.59126984126983,133841.26984126915,1286.9352869352804,0
280,512,0,0,265,0.0,0.0,1.0,265,7800,5400,2400,0.6923076923076923,102,54,48,174.0978968781258,0.43818729750333524,0.794116848440966,0.11847986533156518,17514542.04688923,549048.9870293796,18063591.03391861,279,3,202.22641509433961,87,178,87,33.88134324418093,0.6457136015325671,38.43513257575756,133921.21212121123,1539.3242772553015,0
281,512,0,0,265,0.0,0.0,1.0,265,7150,4700,2450,0.6573426573426573,96,47,49,176.3120241272064,0.43811642367066894,0.7974619713934075,0.12036916631735681,17528812.126951277,557958.0693296585,18086770.196280934,280,4,203.22641509433961,87,178,87,33.715017039114564,0.6467911877394636,38.32859848484848,133975.75757575716,1539.951236502956,0
282,512,1,0,266,0.0037593984962406013,0.0,1.0,266,8100,6200,1900,0.7654320987654321,100,62,38,175.2238613670044,0.4381185865607415,0.7972340582177606,0.12030075187969917,17553951.347797424,553874.2274819161,18107825.57527934,281,0,203.45864661654136,90,176,83,33.552631578947356,0.6476851851851853,38.14102564102563,134071.79487179426,1489.6866096866029,0
283,512,1,1,266,0.003745318352059925,0.003745318352059925,0.9962546816479401,267,8150,6000,2150,0.7361963190184049,103,60,43,170.36930742142525,0.4378930706917106,0.790724845900799,0.11742829407937028,17571466.69444424,537177.722222214,18108644.41666645,282,0,203.69288389513108,99,168,70,33.5469182802539,0.6463594276094276,38.010416666666636,134138.66666666509,1354.9360269360109,0
284,512,0,0,266,0.0,0.0,1.0,266,7600,5500,2100,0.7236842105263158,97,55,42,171.25411647253583,0.43725794438927507,0.7910919565738443,0.11831340673102489,17581830.21272406,541392.1598100327,18123222.372534093,283,2,205.45864661654136,100,166,72,33.445165945165904,0.646875,37.933168316831654,134178.21782178077,1341.7821782178078,0
285,512,1,0,267,0.003745318352059925,0.0,1.0,267,7300,5400,1900,0.7397260273972602,92,54,38,170.5859470686233,0.43724186402335424,0.7914845173239229,0.11849622805883801,17606035.78198784,539968.4575988863,18146004.239586726,284,0,205.68539325842696,102,165,78,33.279263558417824,0.6481821895424836,37.75283171521033,134270.55016181077,1316.3779427628506,0
286,512,0,0,267,0.0,0.0,1.0,267,7250,4800,2450,0.6620689655172414,97,48,49,172.6620747343959,0.4368311931514179,0.7941267459504069,0.12025082402908026,17617554.314504746,547726.6959376519,18165281.0104424,285,1,206.68539325842696,105,162,80,33.13756477492662,0.6483134920634921,37.66705974842764,134314.46540880334,1279.185384845746,0
287,512,0,0,267,0.0,0.0,1.0,267,8450,5500,2950,0.650887573964497,114,55,59,177.35856114785736,0.4367285254334338,0.7984585593609725,0.1239704292390826,17633578.566151176,563643.224476047,18197221.790627223,286,2,207.68539325842696,108,159,83,32.89296811467548,0.6488233024691358,37.54778287461771,134375.5351681942,1244.2179182240204,0
288,512,1,2,266,0.0037313432835820895,0.007462686567164179,0.9925373134328358,268,6900,4700,2200,0.6811594202898551,91,47,44,172.39741987768565,0.4366120008571375,0.7937014717208932,0.1211852451493152,17658466.368796177,548354.8081954741,18206821.176991653,287,0,207.90671641791045,90,178,90,32.83483699442123,0.6555555555555556,37.362637362637386,134470.3296703307,1494.1147741147856,0
289,512,0,1,265,0.0,0.0037593984962406013,0.9962406015037594,266,8550,6300,2250,0.7368421052631579,108,63,45,171.628591313967,0.4360059937579799,0.7908650500381245,0.12124432657166397,17680235.683567382,545136.7888939262,18225372.47246131,288,1,209.3684210526316,93,173,87,32.69041218637993,0.65625,37.20079787234045,134553.19148936291,1446.808510638311,0
290,512,2,0,267,0.00749063670411985,0.0,1.0,267,7900,5800,2100,0.7341772151898734,100,58,42,170.90360134522558,0.43633486806904903,0.7921886681178081,0.12137724448207432,17703562.31031772,543820.5110945862,18247382.821412306,289,0,208.50187265917603,96,171,70,32.53319653163455,0.6571180555555556,37.027491408934736,134641.92439862678,1402.520045819029,0
291,512,0,0,267,0.0,0.0,1.0,267,7050,5000,2050,0.7092198581560284,91,50,41,169.24140870805743,0.43610254569006784,0.7910193025208305,0.12068603899345445,17721293.44444464,539385.3333333418,18260678.777777985,290,1,209.50187265917603,99,168,73,32.443021352970746,0.6576178451178452,36.895833333333364,134709.33333333486,1360.7003367003522,0
292,512,2,0,269,0.007434944237918215,0.0,1.0,269,7600,5700,1900,0.75,95,57,38,167.58098480558303,0.43641689322902216,0.7909765655830685,0.12000990306976507,17739756.019888427,533169.1568047414,18272925.176693168,291,0,208.9368029739777,103,166,77,32.347392385155864,0.6579692556634305,36.75881410256413,134779.4871794887,1308.538710480473,0
293,512,1,0,270,0.003703703703703704,0.0,1.0,270,8400,5700,2700,0.6785714285714286,111,57,54,167.4889640547054,0.43649519252834,0.7928156770172792,0.12039884995289242,17756190.70294807,532393.1972789204,18288583.90022699,292,0,209.15925925925927,104,166,81,32.225863562737835,0.6589543269230769,36.636904761904795,134841.9047619065,1296.5567765567935,0
294,512,1,1,270,0.0036900369003690036,0.0036900369003690036,0.996309963099631,271,8450,5900,2550,0.6982248520710059,110,59,51,151.74818797284794,0.4363309188647442,0.7758076860720597,0.09978391369595627,17358796.373456933,464183.17901235074,17822979.552469283,293,0,209.38376383763838,119,152,89,35.64918216770012,0.625875350140056,39.600694444444464,133324.44444444554,1120.3734827264332,8
295,512,0,0,270,0.0,0.0,1.0,270,7650,5500,2150,0.7189542483660131,98,55,43,152.30340185072632,0.43595506907154985,0.7765935494790008,0.10050081538766828,17374850.09191051,467599.7551288746,17842449.847039387,294,1,210.57777777777778,90,180,90,35.51250787234351,0.6341435185185185,39.48031135531135,133386.08058608044,1482.0675620675604,0
296,512,0,1,269,0.0,0.003703703703703704,0.9962962962962963,270,9150,6500,2650,0.7103825136612022,118,65,53,151.98181003860205,0.4357072375969526,0.7766337670106189,0.10082364719525086,17399143.61341947,465720.6678978132,17864864.281317282,295,2,211.57777777777778,94,176,87,35.33605316285333,0.6347517730496454,39.29824561403508,133479.2982456137,1419.9925345278052,0
297,512,0,0,269,0.0,0.0,1.0,269,7650,5000,2650,0.6535947712418301,103,50,53,156.64008768972562,0.4353840694298026,0.7803372742977017,0.10419075676650173,17411261.823785707,484010.31577331206,17895272.13955902,296,3,213.35315985130111,96,173,86,35.12241781621028,0.6350911458333333,39.207474226804116,133525.77319587604,1390.8934707903754,0
298,512,0,1,268,0.0,0.0037174721189591076,0.9962825278810409,269,9100,6200,2900,0.6813186813186813,120,62,58,154.46090763462976,0.43527772383435975,0.7763525182937188,0.10313471266053358,17428636.961451326,475508.61678004847,17904145.578231376,297,4,214.35315985130111,104,165,73,35.047146496330946,0.6343149038461539,39.07738095238096,133592.38095238156,1284.5421245421303,0
299,512,0,0,268,0.0,0.0,1.0,268,6900,4200,2700,0.6086956521739131,96,42,54,157.26969454352047,0.4345527162874765,0.7776008940928776,0.10532025899897045,17442013.2231406,488120.0183654767,17930133.241506077,298,5,216.1044776119403,109,159,74,34.87217626856285,0.6341743119266054,38.97727272727274,133643.63636363717,1226.0884070058455,0
300,512,0,1,267,0.0,0.0037313432835820895,0.996268656716418,268,8300,6100,2200,0.7349397590361446,105,61,44,156.62604225712187,0.4341881999180129,0.7767728894317552,0.1052821678730398,17458941.575696815,485004.98419994814,17943946.559896763,299,6,217.1044776119403,117,151,76,34.760356454720636,0.6338141025641026,38.85063559322036,133708.47457627257,1142.8074750108767,0
301,512,1,0,268,0.0037313432835820895,0.0,1.0,268,7900,5000,2900,0.6329113924050633,108,50,58,159.59432021677156,0.4341861618871932,0.7817810016428912,0.10769474994155474,17476478.28673426,496329.33439091034,17972807.62112517,300,0,217.55223880597015,122,146,80,34.549624011409335,0.6342213114754098,38.71951219512197,133775.60975609891,1096.5213914434337,0
302,512,0,1,267,0.0,0.0037313432835820895,0.996268656716418,268,8000,5200,2800,0.65,108,52,56,157.78622063848812,0.4337139210315464,0.7813013718996316,0.1069597782476082,17496957.829428125,490555.7697152953,17987513.59914342,301,1,218.55223880597015,125,143,89,34.44140736173041,0.63525,38.56646825396826,133853.9682539687,1070.8317460317496,0
303,512,0,0,267,0.0,0.0,1.0,267,8100,6100,2000,0.7530864197530864,101,61,40,153.1599051067566,0.4332343029859292,0.7716663345093664,0.10435776159685545,17520002.749152407,475172.391706054,17995175.14085846,302,2,220.20973782771534,98,169,98,34.38761077370655,0.642750850340136,38.39436026936024,133942.0875420862,1366.7559953274101,0
304,512,0,1,266,0.0,0.003745318352059925,0.9962546816479401,267,7150,5000,2150,0.6993006993006993,93,50,43,151.92891241172492,0.43296091351975446,0.7688870051008441,0.104119504788087,17545895.073142532,472595.7511505533,18018490.824293084,303,3,221.20973782771534,103,164,95,34.223639911240305,0.643406148867314,38.201121794871774,134041.02564102458,1301.369180980821,0
305,512,0,0,266,0.0,0.0,1.0,266,8000,5800,2200,0.725,102,58,44,155.71144864936718,0.4327490305953563,0.7739796203127141,0.10717948618711808,17565412.34567883,485827.16049381974,18051239.50617265,304,4,221.9699248120301,104,162,74,33.97678066454574,0.6446314102564102,38.05555555555553,134115.55555555414,1289.572649572636,0
306,512,1,0,267,0.003745318352059925,0.0,1.0,267,7250,5100,2150,0.7034482758620689,94,51,43,155.43848952794215,0.43257136286408904,0.7746921302547556,0.10732168543798237,17579126.681336448,485844.5797134493,18064971.261049896,305,0,222.13483146067415,107,160,76,33.8801038561105,0.6449571651090342,37.953317901234534,134167.90123456606,1253.9056190146362,0
307,512,0,0,267,0.0,0.0,1.0,267,7650,5400,2250,0.7058823529411765,99,54,45,159.6600901059088,0.43224810622060766,0.7800687339517882,0.11082701130191899,17602851.43707399,501044.56931282626,18103896.006386817,306,1,223.13483146067415,112,155,80,33.58988668588433,0.6456473214285714,37.77654867256635,134258.4070796447,1198.7357774968277,0
308,512,0,0,267,0.0,0.0,1.0,267,8000,5600,2400,0.7,104,56,48,160.5785461976378,0.4318679423277294,0.7804713693341871,0.11182314827345749,17617076.41778946,504384.90388425725,18121461.321673717,307,2,224.13483146067415,115,152,85,33.4581707344903,0.6461050724637681,37.67061781609193,134312.6436781593,1167.9360319839939,0
309,512,0,0,267,0.0,0.0,1.0,267,7100,4500,2600,0.6338028169014085,97,45,52,160.88824315406157,0.4315628725371481,0.781336785704164,0.11228934087237419,17626951.56643978,506693.8539372377,18133645.42037702,308,3,225.13483146067415,117,150,87,33.37535043453879,0.6464565527065527,37.59710451977398,134350.28248587373,1148.2930126997755,0
310,512,1,0,268,0.0037313432835820895,0.0,1.0,268,7300,5500,1800,0.7534246575342466,91,55,36,164.95805754399484,0.4312831325581829,0.788120592483502,0.11563021276693414,17646087.481621645,521272.86284394696,18167360.34446559,309,0,225.2910447761194,91,177,91,33.123814041745746,0.6543040293040293,37.45471014492756,134423.18840579817,1477.1778945692106,0
311,512,0,0,268,0.0,0.0,1.0,268,7650,5300,2350,0.6928104575163399,100,53,47,177.6776460056035,0.43098325088042927,0.8024380384073828,0.11678479458543846,17356859.670739144,555535.1936693089,17912394.864408452,310,1,226.2910447761194,97,171,82,34.988765631165755,0.6306915807560137,39.61522108843539,133317.00680272188,1374.4021319868234,8
312,512,0,0,268,0.0,0.0,1.0,268,7150,4600,2550,0.6433566433566433,97,46,51,178.19208556679413,0.430674925932137,0.8033872895996941,0.11769313237761994,17379089.61937704,558613.244905799,17937702.86428284,311,2,227.2910447761194,84,184,84,34.80570841760341,0.6365327380952381,39.44852941176468,133402.35294117552,1588.1232492997085,0
313,512,1,0,269,0.0037174721189591076,0.0,1.0,269,8250,5600,2650,0.6787878787878788,109,56,53,177.79913188114392,0.4310013593741331,0.8029493352012131,0.11798812532938167,17400590.600608274,556711.980601466,17957302.58120974,312,0,227.44237918215615,87,182,80,34.65195800227018,0.6370929118773947,39.28740530303029,133484.84848484787,1534.3086032741135,0
314,512,2,1,270,0.007380073800738007,0.0036900369003690036,0.996309963099631,271,7850,5600,2250,0.7133757961783439,101,56,45,174.9522620793295,0.4316842057309462,0.801987993259409,0.11662966681472882,17421348.456789996,547530.8641975247,17968879.320987523,313,0,226.75645756457564,89,182,69,34.56799880207637,0.6379915730337078,39.13194444444442,133564.44444444345,1500.7240948813871,0
315,512,0,0,270,0.0,0.0,1.0,270,7950,5700,2250,0.7169811320754716,102,57,45,196.99581495506695,0.43133117628160994,0.8253638531864547,0.12735700638519026,17280614.78602506,618891.7585395132,17899506.54456457,314,1,228.5962962962963,80,190,62,35.06956475110955,0.6305989583333333,40.18775720164607,133023.86831275639,1662.7983539094548,8
316,512,0,0,270,0.0,0.0,1.0,270,8350,5800,2550,0.6946107784431138,109,58,51,198.7046324305399,0.4312944605075956,0.8246864108823473,0.12897089012554447,17298906.394503936,625124.567314046,17924030.961817984,315,2,229.5962962962963,86,184,64,34.884966146193165,0.6297238372093024,40.050287356321846,133094.25287356353,1547.6075915530644,0
317,512,1,0,271,0.0036900369003690036,0.0,1.0,271,8700,6500,2200,0.7471264367816092,109,65,44,201.47229419950733,0.431445036672589,0.8271400689213493,0.13177377080075936,17334239.79650834,635573.8120013905,17969813.60850973,316,0,229.74538745387454,92,179,70,34.542333849862246,0.6304347826086957,39.78494623655915,133230.1075268823,1448.153342683503,0
318,512,2,0,273,0.007326007326007326,0.0,1.0,273,8650,5800,2850,0.6705202312138728,115,58,57,200.37876937589925,0.4319763161674926,0.8273262645048087,0.13174662083120744,17358276.759683497,632396.0271183315,17990672.78680183,317,0,229.05494505494505,97,176,77,34.386820692845674,0.6307989690721649,39.6045918367347,133322.4489795921,1374.4582369030113,0
319,512,1,0,274,0.0036496350364963502,0.0,1.0,274,8400,5700,2700,0.6785714285714286,111,57,54,185.85742854566703,0.4317545542454302,0.820714390763041,0.12271496558612634,17377562.37496148,582749.8114804534,17960312.186441936,318,0,229.21532846715328,75,199,75,34.61764821926458,0.6401388888888888,39.45997807017543,133396.49122806982,1778.619883040931,8
320,512,2,1,275,0.007246376811594203,0.0036231884057971015,0.9963768115942029,276,8000,5800,2200,0.725,102,58,44,184.2287147189701,0.4322340250329381,0.8199655737524607,0.12190427005090176,17387492.43354872,577455.0766436983,17964947.510192417,319,0,228.54710144927537,78,198,78,34.58428197993085,0.6395566239316239,39.385548523206744,133434.59915611788,1710.6999891809985,0
321,512,0,0,275,0.0,0.0,1.0,275,7450,4800,2650,0.6442953020134228,101,48,53,185.2632266458259,0.4314454766644548,0.8186206802634628,0.12314193959628111,17408017.751736082,582563.1076388874,17990580.85937497,320,1,230.3709090909091,79,196,72,34.40069447911986,0.6406909282700421,39.23177083333333,133513.3333333331,1690.0421940928243,0
322,512,2,1,276,0.007220216606498195,0.0036101083032490976,0.9963898916967509,277,7850,5100,2750,0.6496815286624203,106,51,55,182.8284039215752,0.4318657458274473,0.8186648485041057,0.12219707498364857,17433140.15096529,574204.6378284218,18007344.78879371,321,0,229.70036101083033,82,195,66,34.27265185398934,0.6413871951219512,39.04367469879518,133609.63855421674,1629.3858360270335,0
323,512,0,0,276,0.0,0.0,1.0,276,7800,5700,2100,0.7307692307692307,99,57,42,189.81015773256362,0.4315178963548529,0.8235782086660695,0.1218104424011551,17246417.763213575,591709.0551914503,17838126.818405025,322,1,231.4746376811594,80,196,80,35.518340517597345,0.6279947916666666,40.44495884773662,132892.18106995863,1661.152263374483,8
324,512,0,0,276,0.0,0.0,1.0,276,8050,5200,2850,0.6459627329192547,109,52,57,186.70977782440815,0.4315692248572683,0.8209558638476584,0.12029334976565946,17264700.61636591,581447.6832573198,17846148.29962323,323,2,232.4746376811594,81,195,80,35.4587042834548,0.6289866255144033,40.30741869918699,132962.60162601617,1641.5136003211874,0
325,512,3,1,278,0.010752688172043012,0.0035842293906810036,0.996415770609319,279,7450,5500,1950,0.738255033557047,94,55,39,181.68897837311098,0.43256362651814034,0.8180633133114306,0.11766184820389693,17288512.74713063,564976.4437233356,17853489.190853965,324,0,230.9641577060932,85,194,68,35.40681076672102,0.6292892156862745,40.12839147286822,133054.26356589183,1565.3442772457863,0
326,512,0,0,278,0.0,0.0,1.0,278,8200,5500,2700,0.6707317073170732,109,55,54,181.7064462341645,0.4323878442372456,0.8180951372322436,0.11812569881473578,17306244.96724957,565131.2541313627,17871376.22138093,325,1,232.79496402877697,85,193,70,35.27069940060252,0.6306372549019608,39.99515503875969,133122.48062015505,1566.1468308253536,0
327,512,2,0,280,0.007142857142857143,0.0,1.0,280,8350,5600,2750,0.6706586826347305,111,56,55,203.20627698812768,0.4328506357740229,0.8347289651745107,0.13025417789101681,17240949.382715926,636343.8271604872,17877293.209876414,326,0,232.125,74,206,74,35.21262599232893,0.6302083333333333,40.486111111111086,132871.11111111013,1795.5555555555425,8
328,512,2,0,282,0.0070921985815602835,0.0,1.0,282,7950,5600,2350,0.7044025157232704,103,56,47,196.04037135713097,0.4332027733609281,0.8289640136070182,0.1263190574086117,17265221.934325676,612586.1039136954,17877808.03823937,327,0,231.47163120567376,80,202,72,35.212398072034574,0.6294270833333333,40.30349794238682,132964.60905349752,1662.057613168719,0
329,512,1,0,283,0.0035335689045936395,0.0,1.0,283,8800,6200,2600,0.7045454545454546,114,62,52,191.80463017830277,0.4333477432774478,0.8255338051756704,0.12427744552982763,17290920.761245623,597895.7324106091,17888816.493656233,328,0,231.65017667844523,84,199,65,35.12548922525584,0.6298363095238095,40.11029411764705,133063.52941176432,1584.089635854337,0
330,512,1,0,284,0.0035211267605633804,0.0,1.0,284,7650,5300,2350,0.6928104575163399,100,53,47,187.11780578513793,0.43347367034954126,0.821053317247862,0.12173341994519514,17309651.17339283,583338.7892942813,17892989.96268711,329,0,231.83098591549296,88,196,69,35.103936925177386,0.6298532196969697,39.969569288389515,133135.5805243447,1512.9043241402806,0
331,512,0,0,284,0.0,0.0,1.0,284,8750,6100,2650,0.6971428571428572,114,61,53,189.53216167926246,0.4334145701653976,0.8246083464880685,0.12367229237662784,17323390.076927166,591117.9137786205,17914507.990705788,330,1,232.83098591549296,91,193,69,34.93602647805589,0.6299221611721612,39.86639492753624,133188.40579710185,1463.608854913207,0
332,512,1,0,285,0.0035087719298245615,0.0,1.0,285,7500,5100,2400,0.68,99,51,48,190.28384264781053,0.43394644180874725,0.8265596268228381,0.12498934586187345,17353878.06833536,595932.5207368869,17949810.58907225,331,0,233.01052631578946,95,190,73,34.68331075918595,0.6310307017543859,39.63758680555557,133305.55555555632,1403.2163742690138,0
333,512,0,0,285,0.0,0.0,1.0,285,7800,5500,2300,0.7051282051282052,101,55,46,193.21917176366446,0.4338311300551849,0.8300372729730796,0.12767777804654276,17381219.26939062,606876.9582948618,17988096.22768548,332,1,234.01052631578946,75,210,75,34.39790340679956,0.6404166666666666,39.43256578947369,133410.5263157898,1778.8070175438638,0
334,512,1,0,286,0.0034965034965034965,0.0,1.0,286,8150,5600,2550,0.6871165644171779,107,56,51,189.1032662160113,0.4338215147425674,0.8266126892834036,0.12537128011705376,17396290.658548307,592589.0767149142,17988879.73526322,333,0,234.1888111888112,78,208,78,34.3900691283089,0.640224358974359,39.31962025316456,133468.35443037972,1711.1327491074323,0
335,512,1,0,287,0.003484320557491289,0.0,1.0,287,8750,6100,2650,0.6971428571428572,114,61,53,185.36078573588648,0.4340009583912023,0.8241250384955063,0.12354377588725868,17420443.560380775,579663.4212439707,18000106.981624745,334,0,234.36933797909407,81,206,66,34.303374320266194,0.6408179012345678,39.13871951219513,133560.97560975648,1648.9009334537836,0
336,512,1,0,288,0.003472222222222222,0.0,1.0,288,8650,6400,2250,0.7398843930635838,109,64,45,183.08968100328306,0.4341842999903213,0.8223607925586134,0.1225846144309445,17441024.06012822,572404.306307889,18013428.36643611,335,0,234.55208333333334,86,202,69,34.205753058103944,0.6405038759689923,38.9846743295019,133639.8467432944,1553.9517063173766,0
337,512,0,0,288,0.0,0.0,1.0,288,7400,4700,2700,0.6351351351351351,101,47,54,183.34969291738588,0.43421177329332816,0.8232642667150283,0.12299150933655258,17449607.438016467,574876.0330578478,18024483.471074313,336,1,235.55208333333334,87,201,69,34.13356909684438,0.6408045977011494,38.92045454545453,133672.72727272677,1536.468129571572,0
338,512,1,0,289,0.0034602076124567475,0.0,1.0,289,8950,6700,2250,0.7486033519553073,112,67,45,182.3912790104954,0.4341779603998462,0.8239288741099822,0.12306611562708113,17476034.97164454,570745.2741020758,18046780.245746616,337,0,235.73356401384083,91,198,73,33.95735829433178,0.6414835164835164,38.72282608695651,133773.9130434777,1470.0430004777768,0
339,512,1,0,290,0.0034482758620689655,0.0,1.0,290,8200,5500,2700,0.6707317073170732,109,55,54,182.77456334818066,0.43410889710853917,0.8259367851502484,0.12391107615459308,17497402.752683513,573416.0295697933,18070818.782253306,338,0,235.91724137931035,96,194,74,33.78474361607448,0.6416015625,38.56314432989689,133855.6701030921,1394.3298969072093,0
340,512,0,0,290,0.0,0.0,1.0,290,9850,7300,2550,0.7411167512690355,124,73,51,182.21448278368013,0.43390779739887847,0.824920645818918,0.12405405193896318,17516371.219592523,570497.304405004,18086868.523997527,339,1,236.91724137931035,77,213,77,33.655134783274626,0.6497564935064934,38.421474358974386,133928.20512820626,1739.3273393273541,0
341,512,0,0,290,0.0,0.0,1.0,290,8250,6400,1850,0.7757575757575758,101,64,37,181.27056341906672,0.4337979258640576,0.8123344537252071,0.11759737391556366,17296636.851115126,560824.2214513319,17857461.072566457,340,2,237.91724137931035,98,192,70,35.35552609563902,0.6258503401360545,40.06734006734009,133085.52188552314,1358.0155294441136,8
342,512,1,0,291,0.003436426116838488,0.0,1.0,291,8200,5900,2300,0.7195121951219512,105,59,46,161.83911046003567,0.4336369830548643,0.8018986360362292,0.10212662037046968,17167758.09016525,489282.939581078,17657041.029746328,341,0,238.0962199312715,100,191,76,36.846515857527805,0.6155208333333333,41.03754125412538,132588.7788778862,1325.887788778862,8
343,512,2,0,293,0.006825938566552901,0.0,1.0,293,7900,5000,2900,0.6329113924050633,108,50,58,159.9869677841782,0.4343914122524039,0.8013201940423298,0.1013789084250267,17187282.17337103,483448.23187372927,17670730.405244756,342,0,237.4641638225256,105,188,80,36.744913149012056,0.6157738095238094,40.89033018867921,132664.15094339408,1263.4681042228008,0
344,512,0,0,293,0.0,0.0,1.0,293,7700,4800,2900,0.6233766233766234,106,48,58,162.05703662600826,0.4342516402512195,0.8040959694760332,0.10307072954173702,17204572.568967953,491324.4093888055,17695896.97835676,343,1,238.4641638225256,107,186,82,36.558864746880936,0.6166277258566979,40.7600308641975,132730.8641975294,1240.4753663320503,0
345,512,2,0,295,0.006779661016949152,0.0,1.0,295,7900,5900,2000,0.7468354430379747,99,59,40,177.71185297287596,0.4342850417002959,0.8189844891373932,0.11424032339196229,17254315.44604464,546359.2739390251,17800674.719983663,344,0,237.8406779661017,86,209,86,35.771879659948645,0.6263323643410852,40.38553639846745,132922.60536398547,1545.6116902789008,0
346,512,0,1,294,0.0,0.003389830508474576,0.9966101694915255,295,8150,5800,2350,0.7116564417177914,105,58,47,165.89947904198524,0.43433836811560783,0.8098809484477043,0.10353580626342805,17115569.719042532,500742.81997918244,17616312.539021716,345,1,238.8406779661017,92,203,92,37.14181286549706,0.6137907608695652,41.4314516129032,132387.0967741925,1438.9901823281793,8
347,512,1,1,294,0.003389830508474576,0.003389830508474576,0.9966101694915255,295,8950,6600,2350,0.7374301675977654,113,66,47,166.2795086030506,0.43450459279757103,0.809651138587361,0.10442112963524437,17144951.438058008,502220.8200286828,17647172.25808669,346,0,239.20677966101695,97,198,69,36.90645493626863,0.6145833333333333,41.20960884353738,132500.6802721072,1365.986394557806,0
348,512,0,0,294,0.0,0.0,1.0,294,8600,6500,2100,0.7558139534883721,107,65,42,168.1516200098246,0.43438668129367786,0.8110672449554395,0.10591080496006451,17158925.444444288,509660.2222222161,17668585.666666504,347,3,241.0204081632653,99,195,71,36.75079128778734,0.6151094276094276,41.10416666666664,132554.66666666543,1338.9360269360145,0
349,512,0,0,294,0.0,0.0,1.0,294,10200,7800,2400,0.7647058823529411,126,78,48,174.8218509756662,0.43458257876529455,0.81903618999953,0.11060894843341935,17180067.422583703,531690.2373405603,17711757.659924265,348,4,242.0204081632653,100,194,72,36.41586710725374,0.6164583333333333,40.944719471947174,132636.30363036194,1326.3630363036195,0
350,512,1,0,295,0.003389830508474576,0.0,1.0,295,7700,5300,2400,0.6883116883116883,101,53,48,174.19162182794042,0.4348649064145432,0.8141271802123531,0.10825453689773021,17095660.755062643,528884.1746289217,17624544.929691564,349,0,242.19661016949152,85,210,85,37.080452699007864,0.6145833333333333,41.581879844961215,132310.07751937865,1556.5891472868077,8
351,512,4,0,299,0.013377926421404682,0.0,1.0,299,8200,5500,2700,0.6707317073170732,109,55,54,175.39419510070815,0.43626686269668474,0.8124833216756511,0.1068514957305162,17000682.629699502,528364.209199742,17529046.838899244,350,0,239.94314381270902,91,208,81,37.78082893966018,0.6053113553113554,42.300724637681135,131942.02898550613,1449.9124064341333,8
352,512,2,1,300,0.006644518272425249,0.0033222591362126247,0.9966777408637874,301,9050,6400,2650,0.7071823204419889,117,64,53,181.65120499030073,0.43711840162421556,0.8176972667357183,0.11137556857942744,17031383.855372153,549504.2799961353,17580888.135368288,351,0,239.3421926910299,95,206,75,37.38277908656203,0.606469298245614,42.068142361111086,132061.11111110996,1390.1169590643153,0
353,512,1,0,301,0.0033222591362126247,0.0,1.0,301,9400,6400,3000,0.6808510638297872,124,64,60,183.72681692388292,0.43705518641565155,0.8214368808378754,0.11340636991776752,17063362.516775258,557399.4562450768,17620761.973020334,352,0,240.3388704318937,97,204,80,37.08275865618181,0.6083548109965635,41.826105442176846,132185.0340136042,1362.7323094186,0
354,512,1,1,301,0.0033112582781456954,0.0033112582781456954,0.9966887417218543,302,9550,6800,2750,0.7120418848167539,123,68,55,186.49908501650214,0.4372236034410684,0.8259003195181249,0.11566893825339392,17086065.39792377,567357.1126489759,17653422.510572746,353,0,240.53973509933775,84,218,84,36.836290182312645,0.6142113095238095,41.65441176470586,132272.94117646976,1574.6778711484494,0
355,512,4,0,305,0.013114754098360656,0.0,1.0,305,9300,6700,2600,0.7204301075268817,119,67,52,182.6370183133361,0.4380734109864826,0.821095581099015,0.1142286439476093,17125802.777777597,555261.1111111031,17681063.8888887,354,0,239.0295081967213,89,216,86,36.630336286749866,0.6155196629213483,41.354166666666636,132426.66666666526,1487.9400749063511,0
356,512,2,2,305,0.006514657980456026,0.006514657980456026,0.993485342019544,307,9450,7100,2350,0.7513227513227513,118,71,47,179.2604785951045,0.43871706301051,0.8186518371838274,0.112690037952508,17149844.829418432,544007.8783906572,17693852.70780909,355,0,238.4657980456026,96,211,70,36.53292949409454,0.615234375,41.1726804123711,132519.58762886433,1380.4123711340035,0
357,512,1,2,304,0.0032679738562091504,0.006535947712418301,0.9934640522875817,306,9850,7000,2850,0.7106598984771574,127,70,57,200.5261028852881,0.4384433372620451,0.8487628647942815,0.12393910927392533,17069632.84130464,613531.3902699068,17683164.231574547,356,0,240.24183006535947,92,214,67,36.60066221335418,0.6102807971014492,41.77867383512544,132209.31899641524,1437.0578151784266,8
358,512,0,0,304,0.0,0.0,1.0,304,8600,5500,3100,0.6395348837209303,117,55,62,194.98866165656787,0.43808149318221296,0.8460479424024838,0.11981799445071156,17041946.90003223,595197.2836119181,17637144.18364415,357,1,241.6578947368421,80,224,63,36.957230557078546,0.6123697916666666,41.988168724279845,132102.05761316913,1651.275720164614,8
359,512,0,0,304,0.0,0.0,1.0,304,8550,5200,3350,0.6081871345029239,119,52,67,195.19138934797195,0.4380140933501245,0.8456753374791433,0.12051852687499355,17064767.573696185,596829.138321997,17661596.71201818,358,2,242.6578947368421,83,221,68,36.77593659942362,0.6129518072289157,41.8154761904762,132190.4761904765,1592.6563396442953,0
360,512,3,0,307,0.009771986970684038,0.0,1.0,307,9050,6300,2750,0.6961325966850829,118,63,55,193.73366562670932,0.43957042643333116,0.8466681568891345,0.12054613141520508,17101434.967995014,592174.7367652991,17693609.704760313,359,0,241.27687296416937,72,235,72,36.530967629143,0.6205150462962963,41.53824200913246,132332.42009132565,1837.9502790461895,0
361,512,1,0,308,0.003246753246753247,0.0,1.0,308,9700,7000,2700,0.7216494845360825,124,70,54,190.75402463845256,0.4400126203872132,0.8437373903426812,0.1192555736768472,17123832.199546747,581987.9818594239,17705820.18140617,360,0,241.49025974025975,76,232,70,36.435558112773286,0.6203399122807017,41.36904761904767,132419.04761904967,1742.3558897243377,0
362,512,3,1,310,0.00964630225080386,0.003215434083601286,0.9967845659163987,311,8700,6400,2300,0.735632183908046,110,64,46,185.3117523481689,0.44080964975970677,0.8410844328854485,0.11685061352223325,17164216.06103151,565246.1911904762,17729462.252221987,361,0,240.15112540192925,82,229,65,36.265873400542866,0.6209349593495934,41.06425702811249,132575.10040160827,1616.7695170927839,0
363,512,1,0,311,0.003215434083601286,0.0,1.0,311,9450,6900,2550,0.7301587301587301,120,69,51,184.91340692778414,0.44030831863914527,0.8408100076410747,0.11706133116159852,17182771.979272377,563814.9814301113,17746586.960702486,362,0,241.14469453376205,86,225,67,36.13367301352557,0.6208817829457365,40.92432950191574,132646.74329502071,1542.4039918025665,0
364,512,0,0,311,0.0,0.0,1.0,311,9100,6700,2400,0.7362637362637363,115,67,48,182.944852101063,0.4403351139231753,0.8390206724527434,0.11619021605080108,17197916.186557114,557954.0466392408,17755870.233196355,363,1,242.14469453376205,89,222,72,36.06844095144535,0.6210205992509363,40.81018518518522,132705.18518518665,1491.0694964627714,0
365,512,3,1,313,0.009554140127388535,0.0031847133757961785,0.9968152866242038,314,9900,6700,3200,0.6767676767676768,131,67,64,178.9695794571974,0.4414181471005203,0.8369260602000093,0.11419388893717608,17219587.842413176,543656.4789165955,17763244.321329772,364,0,240.82165605095543,94,220,77,36.005298834538294,0.6211214539007093,40.646929824561425,132788.77192982554,1412.646509891761,0
366,512,3,0,316,0.00949367088607595,0.0,1.0,316,8850,6200,2650,0.7005649717514124,115,62,53,177.53805070406844,0.4420302139843279,0.8358372118492619,0.1142483586630323,17259186.182481013,540782.4543152575,17799968.63679627,365,0,239.73101265822785,82,234,82,35.73910048818213,0.6281758130081301,40.348895582329334,132941.36546184804,1621.2361641688785,0
367,512,0,1,315,0.0,0.0031645569620253164,0.9968354430379747,316,10150,7400,2750,0.729064039408867,129,74,55,175.34034759475983,0.44188726475118884,0.8336297188305133,0.11321976730404569,17275011.230017297,532451.2947549272,17807462.524772223,366,1,240.73101265822785,86,230,74,35.675066832595874,0.627906976744186,40.229885057471286,133002.29885057567,1546.538358727624,0
368,512,4,0,319,0.012539184952978056,0.0,1.0,319,9250,6800,2450,0.7351351351351352,117,68,49,172.1795214933502,0.44241413812819147,0.8314686436644749,0.11188776743851284,17304407.189013653,522842.90990609745,17827250.09891975,367,0,239.41692789968653,92,227,73,35.53244729737495,0.6281702898550725,40.00896057347673,133115.4121863811,1446.9066541997945,0
369,512,0,0,319,0.0,0.0,1.0,319,9250,6500,2750,0.7027027027027027,120,65,55,171.46472330322317,0.44240181581593424,0.8314735892482186,0.11193842725991335,17325668.225944456,521098.1816810054,17846766.407625463,368,1,240.41692789968653,93,226,75,35.38862384278979,0.6294802867383513,39.84929078014186,133197.16312056806,1432.2275604362158,0
370,512,1,1,319,0.003125,0.003125,0.996875,320,8800,6000,2800,0.6818181818181818,116,60,56,171.7351446148623,0.44234811748955066,0.8325616981560162,0.11266662085545025,17348226.904500466,523060.05125116813,17871286.955751635,369,0,240.6625,96,224,78,35.209373238177726,0.6303168402777778,39.67998281786942,133283.8487972512,1388.3734249713668,0
371,512,0,0,319,0.0,0.0,1.0,319,9100,6600,2500,0.7252747252747253,116,66,50,174.77191642753482,0.4419672489369952,0.8346880461619541,0.11487597917217061,17356902.61197846,533799.8265483152,17890702.438526776,370,1,242.40125391849529,98,221,78,35.06409867862769,0.6304209183673469,39.614898989899004,133317.17171717243,1360.3793032364533,0
372,512,0,0,319,0.0,0.0,1.0,319,9900,6500,3400,0.6565656565656566,133,65,68,172.59797161651503,0.4417113555857863,0.8329106223892624,0.11397245324709253,17378052.911626514,526183.3366382363,17904236.24826475,371,2,243.40125391849529,81,238,81,34.95936941329431,0.6376028806584362,39.4563008130081,133398.37398373857,1646.8935059720811,0
373,512,1,0,320,0.003125,0.0,1.0,320,10550,7500,3050,0.7109004739336493,136,75,61,170.9258348445341,0.44183769265935213,0.8305603154788936,0.1136239028854871,17408491.879017245,520562.2015610555,17929054.0805783,372,0,243.6375,87,233,79,34.77095627175063,0.6376915708812261,39.22821969696966,133515.15151514992,1534.6569139672404,0
374,512,0,0,320,0.0,0.0,1.0,320,8750,5900,2850,0.6742857142857143,116,59,57,175.1599796828217,0.4415052328239289,0.8354890390222034,0.11702702268589966,17431406.843972944,537906.9737266535,17969313.817699596,373,1,244.6375,88,232,68,34.48596471555655,0.6390861742424243,39.056647940074875,133602.99625468024,1518.2158665304573,0
375,512,0,1,319,0.0,0.003125,0.996875,320,8750,6300,2450,0.72,112,63,49,174.22848887602083,0.4414750277560084,0.8353273241696304,0.11700807834766319,17454836.30014684,535475.9504305734,17990312.250577413,374,2,245.6375,91,229,71,34.33190963489721,0.6398809523809523,38.88134057971011,133692.75362318696,1469.1511387163403,0
376,512,1,1,319,0.003125,0.003125,0.996875,320,9550,7200,2350,0.7539267015706806,119,72,47,177.66264468459417,0.44135502383751307,0.8380782913432596,0.11984984760310807,17475068.186962206,547383.3660278564,18022451.552990064,375,0,246.5125,93,227,74,34.08826221882909,0.6407930107526882,38.730053191489326,133770.21276595574,1438.3893845801692,0
377,512,1,0,320,0.003125,0.0,1.0,320,10050,7200,2850,0.7164179104477612,129,72,57,174.16094517689578,0.4412893074059561,0.8347408305773627,0.11803719257641139,17496094.694444284,535377.2777777715,18031471.972222056,376,0,247.35,99,221,80,34.01987787384945,0.6406776094276094,38.57291666666664,133850.6666666654,1352.0269360269233,0
378,512,0,0,320,0.0,0.0,1.0,320,9850,7100,2750,0.7208121827411168,126,71,55,173.91163946932238,0.4409123563218391,0.8330070810618617,0.11845870308703112,17518543.123267826,535485.7111363063,18054028.834404133,377,1,248.35,83,237,83,33.85582088962626,0.647464859437751,38.40525793650794,133936.50793650796,1613.692866704915,0
379,512,0,0,320,0.0,0.0,1.0,320,8350,5900,2450,0.7065868263473054,108,59,49,175.01706196483454,0.4407043903474399,0.8321618037135277,0.11996624065589584,17546790.123456825,541847.5308641992,18088637.654321022,378,2,249.35,89,231,79,33.61240053050398,0.6474719101123596,38.19444444444445,134044.4444444447,1506.1173533083675,0
380,512,0,1,319,0.0,0.003125,0.996875,320,9650,6200,3450,0.6424870466321243,131,62,69,176.48678570179445,0.4406331635318704,0.8340190454584746,0.1217727249466582,17576144.848771203,546741.4618777543,18122886.31064896,379,3,250.35,91,229,71,33.35115806758276,0.6490384615384616,37.97554347826086,134156.52173912997,1474.2474916387907,0
381,512,1,0,320,0.003125,0.0,1.0,320,9300,6900,2400,0.7419354838709677,117,69,48,171.3432446352681,0.4404286670585162,0.8290487928492454,0.11888854800395932,17601052.44978207,529864.2871482371,18130916.736930307,380,0,251.175,96,224,76,33.29715635281432,0.6494140625,37.78994845360824,134251.54639175217,1398.4536082474185,0
382,512,0,1,319,0.0,0.003125,0.996875,320,11000,7200,3800,0.6545454545454545,148,72,76,173.31258183247536,0.440138045323929,0.8322026017645872,0.12081490712867714,17621620.951376896,535809.7246312755,18157430.676008172,381,1,252.175,98,222,78,33.08969988637122,0.6504039115646258,37.63678451178452,134329.96632996673,1370.7139421425177,0
383,512,0,1,318,0.0,0.003134796238244514,0.9968652037617555,319,9300,6100,3200,0.6559139784946236,125,61,64,174.16459777239754,0.43969213935056484,0.833419645324798,0.1218393710382731,17637255.00875727,541257.0848818814,18178512.093639154,382,2,253.79623824451411,101,218,81,32.94895987342101,0.6507838283828382,37.5204248366013,134389.54248365978,1330.589529541186,0
384,512,0,1,317,0.0,0.0031446540880503146,0.9968553459119497,318,9150,6700,2450,0.73224043715847,116,67,49,171.44974582676875,0.4390770803986535,0.8304589999988405,0.120548517785592,17659540.292049784,532794.7388979042,18192335.03094769,383,3,255.5754716981132,85,233,85,32.85160333271843,0.6573529411764706,37.3546511627907,134474.41860465135,1582.0519835841335,0
385,512,0,0,317,0.0,0.0,1.0,317,8250,5200,3050,0.6303030303030303,113,52,61,206.98123603339633,0.4390269569673495,0.8580476276616973,0.13810466288382148,17425406.640624993,649696.4409722222,18075103.081597216,384,4,256.29968454258676,79,238,60,33.70145439270682,0.642009493670886,39.1015625,133579.99999999994,1690.8860759493664,8
386,512,0,0,317,0.0,0.0,1.0,317,10250,6900,3350,0.6731707317073171,136,69,67,208.05856075848928,0.4387915285708581,0.8585215049035095,0.13962742896837457,17451590.13564297,652540.5453137854,18104130.68095676,385,5,257.29968454258676,82,235,64,33.473330449272574,0.6427845528455285,38.90562248995984,133680.32128514056,1630.2478205504947,0
387,512,0,0,317,0.0,0.0,1.0,317,9450,7400,2050,0.783068783068783,115,74,41,206.0549665504979,0.4388031752053135,0.8568496671103609,0.13875773067198444,17467092.466616217,646986.2307886091,18114078.697404828,386,6,258.29968454258676,83,234,66,33.40731421698952,0.643574297188755,38.78968253968253,133739.68253968208,1611.3214763817118,0
388,512,1,0,318,0.0031446540880503146,0.0,1.0,318,9750,7000,2750,0.717948717948718,125,70,55,192.3649859783039,0.43894543314220713,0.8489766675636727,0.12660641145042478,17362938.644583,594654.289781474,17957592.934364475,387,0,258.4842767295597,75,243,75,34.55985869164781,0.6390277777777778,39.569627192982466,133340.35087719338,1777.871345029245,7
389,512,0,0,318,0.0,0.0,1.0,318,9450,6600,2850,0.6984126984126984,123,66,57,190.1525621262262,0.4387174787876383,0.8473760517220883,0.12590075062437842,17390272.866602305,588310.9883317236,17978583.85493403,388,1,259.4842767295597,80,238,80,34.408665153533626,0.6389322916666667,39.364711934156375,133445.26748971187,1668.0658436213985,0
390,512,0,1,317,0.0,0.0031446540880503146,0.9968553459119497,318,9300,6400,2900,0.6881720430107527,122,64,58,188.35533505222833,0.4384930377821426,0.8459855193389503,0.12527238128236423,17410749.71655326,582981.5192743749,17993731.235827636,389,2,260.4842767295597,83,235,77,34.299215406562055,0.6393072289156627,39.21130952380952,133523.8095238093,1608.7205966724011,0
391,512,0,0,317,0.0,0.0,1.0,317,8900,6100,2800,0.6853932584269663,117,61,56,186.17440099070208,0.4383381417295585,0.8430045991507389,0.12449460171798563,17435369.6410123,576903.8997933838,18012273.540805683,390,3,262.0820189274448,87,230,67,34.16833922982717,0.6397270114942528,39.02698863636362,133618.18181818107,1535.8411703239203,0
392,512,0,0,317,0.0,0.0,1.0,317,11100,8000,3100,0.7207207207207207,142,80,62,190.97144048824237,0.4379825034274381,0.8467057960174014,0.12825324615571013,17454870.316598643,592176.3455792619,18047046.662177905,391,4,263.0820189274448,88,229,69,33.89446063050949,0.6408617424242424,38.8810861423221,133692.88389513115,1519.2373169901266,0
393,512,0,0,317,0.0,0.0,1.0,317,9750,7200,2550,0.7384615384615385,123,72,51,189.72507637556865,0.43775206644571335,0.846003448064683,0.12774672522319558,17466582.1693569,589619.7272202764,18056201.89657718,392,5,264.0820189274448,90,227,71,33.8377558175205,0.6410879629629629,38.79349816849817,133737.72893772897,1485.9747659747663,0
394,512,0,0,317,0.0,0.0,1.0,317,9250,6900,2350,0.745945945945946,116,69,47,190.04742398397042,0.4375366037082884,0.8464255696844074,0.12824665605878757,17476550.601076327,591624.6843720103,18068175.28544834,393,6,265.0820189274448,93,224,72,33.7533929934685,0.640905017921147,38.71897163120566,133775.8865248221,1438.4503927400226,0
395,512,0,0,317,0.0,0.0,1.0,317,8550,5400,3150,0.631578947368421,117,54,63,186.6409140700565,0.43743344780311194,0.8455408593070217,0.11959420406261617,17239328.433162764,571562.8033438779,17810891.23650664,394,7,266.0820189274448,73,244,73,35.65494756351143,0.6305650684931507,40.498310810810786,132864.86486486386,1820.0666419844365,8
396,512,2,0,319,0.006269592476489028,0.0,1.0,319,8500,5900,2600,0.6941176470588235,111,59,52,182.49954002563263,0.4377111222833409,0.8423882673770728,0.11751980389832688,17262293.793402746,557772.1354166653,17820065.92881941,395,0,265.40752351097177,79,240,76,35.586473532902126,0.6296149789029536,40.32552083333333,132953.33333333308,1682.953586497887,0
397,512,1,0,320,0.003125,0.0,1.0,320,8900,6600,2300,0.7415730337078652,112,66,46,180.69983138451568,0.43805614060867293,0.8415809005442849,0.11712455395384985,17292591.745838087,552053.6825348376,17844645.428372923,396,0,265.575,80,240,68,35.40130710869205,0.6315104166666667,40.09773662551438,133069.95884773572,1663.3744855966966,0
398,512,3,1,322,0.009287925696594427,0.0030959752321981426,0.9969040247678018,323,9500,6600,2900,0.6947368421052632,124,66,58,176.17618941085317,0.4385740566249383,0.8386111330225297,0.1146507005292995,17311082.604711186,535860.1135749022,17846942.71828609,397,0,264.0990712074303,85,238,72,35.3775113729874,0.6310049019607843,39.95881782945735,133141.0852713173,1566.3657090743213,0
399,512,1,1,322,0.0030959752321981426,0.0030959752321981426,0.9969040247678018,323,10150,7600,2550,0.7487684729064039,127,76,51,174.05454108081904,0.4386469690851169,0.8359728003641977,0.11385709185685325,17334886.454046607,528693.1412894366,17863579.595336042,398,0,265.08978328173373,89,234,76,35.2508469362037,0.6314372659176031,39.78009259259259,133232.59259259235,1496.9954223886782,0
400,512,1,0,323,0.0030959752321981426,0.0,1.0,323,9950,7300,2650,0.7336683417085427,126,73,53,172.43236380760817,0.438624534481985,0.8333825667001131,0.11329459381208795,17355137.909328025,523967.49078249437,17879105.40011052,399,0,265.93498452012386,92,231,81,35.138482606326555,0.6320199275362319,39.62813620071685,133310.39426523328,1449.0260246221007,0
401,512,0,0,323,0.0,0.0,1.0,323,11550,7700,3850,0.6666666666666666,154,77,77,172.24106706223026,0.4386269381894634,0.8337582286957972,0.11344077641201014,17366131.554329645,522082.20593215653,17888213.7602618,400,1,266.93498452012386,82,241,82,35.05958977818468,0.636305894308943,39.54568273092367,133352.6104417661,1626.2513468508062,0
402,512,0,0,323,0.0,0.0,1.0,323,8950,6000,2950,0.6703910614525139,119,60,59,170.6020237263125,0.4384991410751944,0.8322667421420844,0.11276691804218236,17382612.473229893,519551.7731166477,17902164.24634654,401,2,267.93498452012386,83,240,83,34.97661170069322,0.6371736947791165,39.42212301587299,133415.87301587194,1607.4201568177343,0
403,512,0,0,323,0.0,0.0,1.0,323,9250,6500,2750,0.7027027027027027,120,65,55,168.77507974870144,0.43847390214667104,0.8294830265206101,0.11223313558537937,17410072.349919543,513827.26985766256,17923899.619777206,402,3,268.93498452012386,87,236,78,34.81500499296445,0.6378113026819923,39.21638257575756,133521.21212121128,1534.7265761058768,0
404,512,1,0,324,0.0030864197530864196,0.0,1.0,324,9900,7100,2800,0.7171717171717171,127,71,56,167.55478915339026,0.43888136394908844,0.8268731411216415,0.11181717561868973,17426183.793571535,509268.11025601334,17935451.903827548,403,0,269.10185185185185,93,231,71,34.7241689319288,0.6370967741935484,39.09574468085103,133582.97872340257,1436.376115305404,0
405,512,0,0,324,0.0,0.0,1.0,324,9400,6600,2800,0.7021276595744681,122,66,56,165.5089209644234,0.438859864121087,0.8255549398109678,0.11098507910824908,17448025.17361088,503360.7638888789,17951385.93749976,404,1,270.10185185185185,95,229,75,34.6113881961762,0.638157894736842,38.93229166666663,133666.66666666488,1407.0175438596302,0
406,512,0,0,324,0.0,0.0,1.0,324,8900,6000,2900,0.6741573033707865,118,60,58,165.76607362399275,0.4386257548828498,0.8264111554809883,0.11142836286916107,17459037.929797567,505123.2333749747,17964161.163172543,405,2,271.10185185185185,97,227,76,34.52093254372042,0.6384235395189004,38.849914965986365,133708.84353741343,1378.4416859527157,0
407,512,0,0,324,0.0,0.0,1.0,324,9350,6300,3050,0.6737967914438503,124,63,61,169.05392377565767,0.43862157436073845,0.8297891192628044,0.11397506473907128,17472399.99999982,516605.55555554817,17989005.55555537,406,3,272.10185185185185,99,225,78,34.33346624136091,0.6388888888888888,38.74999999999997,133759.99999999863,1351.1111111110972,0
408,512,0,1,323,0.0,0.0030864197530864196,0.9969135802469136,324,10200,7300,2900,0.7156862745098039,131,73,58,172.0727759794628,0.4382363691090471,0.8330920420737005,0.11655829426886434,17493638.196019053,527035.7772738689,18020673.97329292,407,4,273.10185185185185,104,220,81,34.09313725490196,0.6392227564102564,38.59126984126983,133841.2698412691,1286.9352869352797,0
409,512,0,0,323,0.0,0.0,1.0,323,10050,7100,2950,0.7064676616915423,130,71,59,173.3075482478572,0.43804524097968706,0.8328478771141732,0.11786550832491305,17511629.747310903,532329.5234661406,18043959.270777043,408,5,274.92260061919507,85,238,85,33.92414015344481,0.6462009803921569,38.45687984496125,133910.07751938017,1575.4126766985903,0
410,512,0,0,323,0.0,0.0,1.0,323,8600,6000,2600,0.6976744186046512,112,60,52,172.26268605214577,0.4379943625047273,0.8321346196101316,0.11776111044977194,17534764.164176837,530917.1148424034,18065681.27901924,409,6,275.92260061919507,88,235,88,33.77578894801962,0.6468986742424243,38.28417602996255,133998.50187265946,1522.7102485529483,0
411,512,0,0,323,0.0,0.0,1.0,323,9500,6700,2800,0.7052631578947368,123,67,56,171.954450134325,0.4378553480888923,0.8311926853314957,0.11818456652089368,17558803.329864796,529762.8743207338,18088566.20418553,410,7,276.92260061919507,92,231,65,33.60143486442563,0.6474184782608696,38.10483870967743,134090.32258064573,1457.5035063113667,0
412,512,0,0,323,0.0,0.0,1.0,323,9400,6500,2900,0.6914893617021277,123,65,58,170.87214062344438,0.4375392605554808,0.8307097730218544,0.11775737109650881,17570804.8322561,526472.2068328726,18097277.039088972,411,8,277.92260061919507,94,229,68,33.5387630965834,0.6477171985815603,38.015350877192986,134136.14035087737,1426.9802164986954,0
413,512,0,0,323,0.0,0.0,1.0,323,8700,6000,2700,0.6896551724137931,114,60,54,170.10839263263406,0.4372395983565051,0.829360099580627,0.11764906599559988,17586638.354530618,525026.9564601302,18111665.310990747,412,9,278.92260061919507,96,227,71,33.43875049507654,0.6483289930555556,37.89733676975946,134196.56357388382,1397.8808705612898,0
414,512,0,0,323,0.0,0.0,1.0,323,8550,5900,2650,0.6900584795321637,112,59,53,180.75302863784432,0.43698640783544535,0.8451566825002639,0.11838164056297926,17340431.693576906,553717.1093003423,17894148.802877247,413,10,279.92260061919507,93,230,69,35.03416929234437,0.630600358422939,39.738475177304984,133253.90070922082,1432.8376420346324,8
415,512,2,0,325,0.006153846153846154,0.0,1.0,325,9950,7500,2450,0.7537688442211056,124,75,49,182.79296875212455,0.4371885881608104,0.8479133568510002,0.1201834030992829,17358247.540770818,559643.1200623586,17917890.660833176,414,0,279.19384615384615,96,229,72,34.844970031892714,0.6310763888888888,39.6048109965636,133322.3367697607,1388.774341351674,0
416,512,0,0,325,0.0,0.0,1.0,325,10300,7700,2600,0.7475728155339806,129,77,52,185.64216706182071,0.4373539886039886,0.8452023478529496,0.1185253835856246,17222500.00000009,564144.4444444483,17786644.444444537,415,1,280.19384615384615,93,232,78,35.809906291834,0.6216397849462365,40.625000000000014,132800.0000000007,1427.9569892473194,8
417,512,2,1,326,0.0061162079510703364,0.0030581039755351682,0.9969418960244648,327,10100,7200,2900,0.7128712871287128,130,72,58,180.11094410400625,0.4381922165312721,0.8404835969440878,0.11536031543851696,17237324.617347036,545426.1621315241,17782750.77947856,416,0,279.47400611620793,83,244,83,35.83975507765832,0.6261295180722892,40.513392857142875,132857.14285714363,1600.688468158357,0
418,512,0,0,326,0.0,0.0,1.0,326,9550,6500,3050,0.680628272251309,126,65,61,183.3747581208996,0.437873407267579,0.8435922758289236,0.11786768686708786,17253803.89424298,558032.4231544517,17811836.31739743,417,1,281.32515337423314,83,243,83,35.628781546055286,0.6273845381526104,40.38938492063494,132920.63492063567,1601.453432778743,0
419,512,0,0,326,0.0,0.0,1.0,326,8650,5800,2850,0.6705202312138728,115,58,57,180.07598372484136,0.4378818625137644,0.8399621470971226,0.11627230663752523,17274798.902606476,548305.2812071405,17823104.183813617,418,2,282.32515337423314,89,237,81,35.55367433018475,0.62687265917603,40.23148148148151,133001.48148148277,1494.3986683312671,0
420,512,1,2,325,0.0030581039755351682,0.0061162079510703364,0.9938837920489296,327,9350,6400,2950,0.6844919786096256,123,64,59,178.75430219155632,0.4383266730455339,0.839550660954937,0.11584207375790564,17291736.111111265,543444.4444444515,17835180.555555716,419,0,282.45871559633025,91,236,69,35.45841683366737,0.627518315018315,40.10416666666669,133066.66666666785,1462.2710622710754,0
421,512,0,0,325,0.0,0.0,1.0,325,10700,8000,2700,0.7476635514018691,134,80,54,179.981853864787,0.43775561886673,0.8399548115435962,0.11722296395193606,17314845.67901248,547571.6049382779,17862417.283950757,420,4,284.99384615384616,95,230,72,35.2497774810859,0.6280701754385964,39.93055555555558,133155.5555555566,1401.637426900596,0
422,512,0,0,325,0.0,0.0,1.0,325,9750,7500,2250,0.7692307692307693,120,75,45,177.69228820616564,0.43790519151630264,0.8389224610050883,0.11613990965598107,17331055.402038373,541168.9782832101,17872224.380321585,421,5,285.99384615384616,96,229,74,35.18545269442956,0.6290147569444444,39.80884879725088,133217.86941580861,1387.6861397480063,0
423,512,1,0,326,0.003067484662576687,0.0,1.0,326,8200,6200,2000,0.7560975609756098,102,62,40,178.63563028574617,0.4381394525719679,0.8405364217621554,0.11723614760026399,17349889.58042838,546461.6921175878,17896351.272545967,422,0,286.1134969325153,98,228,78,35.01704254573869,0.6298894557823129,39.66750841750843,133290.2356902363,1360.1044458187378,0
424,512,0,0,326,0.0,0.0,1.0,326,10200,7400,2800,0.7254901960784313,130,74,56,181.40734871372115,0.4378551203397829,0.843520864508361,0.11948275259534225,17366319.83506935,554675.607638884,17920995.442708235,423,1,287.1134969325153,79,247,79,34.81941250479092,0.6375263713080168,39.544270833333314,133353.33333333262,1688.0168776371218,0
425,512,0,0,326,0.0,0.0,1.0,326,10500,7200,3300,0.6857142857142857,138,72,66,178.0441935286603,0.43763980651250595,0.8403953725680668,0.1178223621037646,17387895.19523866,543462.7554394217,17931357.950678084,424,2,288.1134969325153,82,244,82,34.74238739606405,0.6379573170731707,39.3825301204819,133436.14457831226,1627.2700558330764,0
426,512,2,0,328,0.006097560975609756,0.0,1.0,328,10150,7400,2750,0.729064039408867,129,74,55,174.16396633836266,0.4379661743865145,0.8369611139568596,0.1159220378101561,17414210.326978702,530835.5882394096,17945045.91521811,425,0,287.3506097560976,88,240,77,34.6429426195177,0.6377840909090908,39.18539325842693,133537.07865168373,1517.4668028600424,0
427,512,0,1,327,0.0,0.003048780487804878,0.9969512195121951,328,9400,6500,2900,0.6914893617021277,123,65,58,179.32985673301317,0.437863810260809,0.8403705615801513,0.11977216771839996,17429860.35637115,550138.8721168851,17979999.228488036,426,1,288.3506097560976,90,238,68,34.38893763252176,0.6383101851851851,39.06822344322341,133597.06959706807,1484.4118844118675,0
428,512,0,0,327,0.0,0.0,1.0,327,9950,6800,3150,0.6834170854271356,131,68,63,179.39934920595763,0.43704620926436655,0.8389917824291255,0.12044084304035545,17453338.534933563,550873.5149276591,18004212.049861223,427,2,290.22935779816515,94,233,73,34.20829308920896,0.63885195035461,38.89254385964908,133687.01754385763,1422.2023142963578,0
429,512,0,0,327,0.0,0.0,1.0,327,9200,6400,2800,0.6956521739130435,120,64,56,198.98636578329183,0.4369023720630632,0.8535966440680749,0.12958607994445404,17314326.193381973,614462.9690415116,17928789.162423484,428,3,291.22935779816515,88,239,70,34.75950720072009,0.6302083333333333,39.93445692883897,133153.55805243528,1513.1086142322192,8
430,512,0,0,327,0.0,0.0,1.0,327,9400,6400,3000,0.6808510638297872,124,64,60,199.59484640207577,0.43654786026528586,0.8551425211525241,0.13048577663404132,17332124.441492703,617080.5431442851,17949204.98463699,429,4,292.22935779816515,90,237,72,34.607382722566825,0.6309027777777778,39.8008241758242,133221.978021979,1480.2442002442112,0
431,512,1,0,328,0.003048780487804878,0.0,1.0,328,9400,6300,3100,0.6702127659574468,125,63,62,197.20763448948986,0.4369213610427389,0.8546593528137194,0.1294247027198674,17349889.580428466,609306.136562036,17959195.7169905,430,0,292.3353658536585,98,230,74,34.53355293293459,0.6298894557823129,39.667508417508444,133290.23569023696,1360.1044458187446,0
432,512,0,0,328,0.0,0.0,1.0,328,9250,6200,3050,0.6702702702702703,123,62,61,200.92518549190646,0.4366408794535193,0.8575819256842343,0.13250052643260823,17371935.308558725,623241.864845114,17995177.17340384,431,1,293.3353658536585,76,252,76,34.26810691040023,0.6392543859649122,39.50216450216451,133374.8917748921,1754.9327865117382,0
433,512,2,0,330,0.006060606060606061,0.0,1.0,330,9850,6400,3450,0.649746192893401,133,64,69,194.16027163133322,0.4368028691166989,0.8529562545495879,0.12883127237923891,17400089.604402177,599831.2248000542,17999920.82920223,432,0,292.55151515151516,81,249,76,34.22922858906265,0.6392746913580247,39.29115853658537,133482.92682926857,1647.937368262575,0
434,512,1,1,330,0.0030211480362537764,0.0030211480362537764,0.9969788519637462,331,9050,6100,2950,0.6740331491712708,120,61,59,193.8874374338,0.4371528731422991,0.8533159547419749,0.12928630425539187,17422534.85367454,600352.1272759996,18022886.980950538,433,0,292.66465256797585,85,246,65,34.06498591636486,0.6394607843137254,39.123062015503855,133568.99224806108,1571.3999088007185,0
435,512,1,0,331,0.0030211480362537764,0.0,1.0,331,9450,6700,2750,0.708994708994709,122,67,55,191.2913058406948,0.43693277182703166,0.8514485286702129,0.12796088322741545,17436951.331496667,591457.4380165235,18028408.76951319,434,0,293.66163141993957,87,244,68,34.022738268021286,0.6398467432950192,39.015151515151494,133624.2424242415,1535.910832462546,0
436,512,0,0,331,0.0,0.0,1.0,331,9600,7000,2600,0.7291666666666666,122,70,52,192.25703805044733,0.4369690103451433,0.8516882961762409,0.12907199102820952,17453305.594130814,595304.1675433738,18048609.761674188,435,1,294.66163141993957,88,243,71,33.87282038639112,0.6407433712121212,38.89279026217226,133686.89138576685,1519.1692202928052,0
437,512,0,0,331,0.0,0.0,1.0,331,9400,6400,3000,0.6808510638297872,124,64,60,189.95685029257015,0.4367100003051665,0.8507369432604279,0.12792329499488864,17467306.464459457,588006.903816748,18055313.368276205,436,2,295.66163141993957,92,239,72,33.826183125366256,0.6405117753623188,38.78808243727596,133740.50179211356,1453.701106436017,0
438,512,0,1,330,0.0,0.0030211480362537764,0.9969788519637462,331,9350,6600,2750,0.7058823529411765,121,66,55,190.0134989862155,0.43663637889468704,0.8495352383862271,0.12852724375402838,17487207.302517273,589011.0894097179,18076218.39192699,437,3,296.66163141993957,95,236,78,33.67311724166561,0.6411184210526315,38.63932291666665,133816.66666666596,1408.5964912280626,0
439,512,0,0,330,0.0,0.0,1.0,330,8800,5800,3000,0.6590909090909091,118,58,60,191.04338995218325,0.43618345307175094,0.8505448388571732,0.12964995990638062,17502020.87673616,593929.0798611138,18095949.956597276,438,4,298.53939393939396,79,251,79,33.533408445794535,0.6478111814345991,38.52864583333334,133873.33333333372,1694.5991561181484,0
440,512,1,0,331,0.0030211480362537764,0.0,1.0,331,9450,6800,2650,0.7195767195767195,121,68,53,190.81353995353084,0.4363609661570387,0.850400048818436,0.12992899749269698,17517082.3454461,592849.298398416,18109931.643844515,439,0,298.6344410876133,82,249,82,33.42479089702382,0.6477388211382114,38.41616465863455,133930.92369477957,1633.3039474973118,0
441,512,0,0,331,0.0,0.0,1.0,331,8750,6400,2350,0.7314285714285714,111,64,47,190.3445069033709,0.43610691507217186,0.8503897604466937,0.130181826399953,17536817.995716818,592657.3948097765,18129475.390526593,440,1,299.6344410876133,83,248,83,33.286940522442286,0.6488453815261044,38.26884920634921,134006.34920634932,1614.5343277873412,0
442,512,0,0,331,0.0,0.0,1.0,331,9900,6900,3000,0.696969696969697,129,69,60,188.97340582667798,0.4357273642772132,0.8484702416780312,0.12990585414999237,17559631.978391413,587560.6920039352,18147192.67039535,441,2,300.6344410876133,86,245,67,33.1494201639694,0.6494670542635659,38.09865900383142,134093.48659003846,1559.2265882562613,0
443,512,0,0,331,0.0,0.0,1.0,331,9350,6000,3350,0.6417112299465241,127,60,67,186.82876504346393,0.43535048368885226,0.8471953260241238,0.12912885710543617,17583740.581022877,581479.7075194286,18165220.288542304,442,3,301.6344410876133,91,240,70,33.022502916144646,0.6496108058608059,37.91893115942029,134185.50724637668,1474.566013696447,0
444,512,0,2,329,0.0,0.006042296072507553,0.9939577039274925,331,9950,7300,2650,0.7336683417085427,126,73,53,187.42585377300992,0.4350796484482285,0.8478419458614304,0.1300867673489457,17602385.66436712,583678.4323171603,18186064.09668428,443,4,302.6344410876133,92,239,74,32.86533751939974,0.6507019927536232,37.78001792114696,134256.63082437287,1459.3112046127485,0
445,512,0,0,329,0.0,0.0,1.0,329,9300,5900,3400,0.6344086021505376,127,59,68,185.11642333009465,0.43454041255838094,0.8455198869259248,0.12897773863121254,17619374.453678034,577227.1160357024,18196601.569713738,444,10,304.39209726443767,94,235,77,32.79704435899579,0.6513741134751774,37.65350877192982,134321.40350877176,1428.9511011571465,0
446,512,0,0,329,0.0,0.0,1.0,329,8650,5700,2950,0.6589595375722543,116,57,59,183.92542202065977,0.4342821002298169,0.8456602499155692,0.12874779541446213,17640000.00000004,574438.8888888909,18214438.888888933,445,11,305.39209726443767,97,232,79,32.67195767195767,0.6520618556701031,37.50000000000001,134400.00000000032,1385.5670103092816,0
447,512,1,0,330,0.0030303030303030303,0.0,1.0,330,8450,5900,2550,0.6982248520710059,110,59,51,182.6183205369569,0.4343215590556016,0.8442308627878568,0.12831754453655156,17656670.60342651,570436.3063743997,18227106.90980091,446,0,305.46363636363634,83,247,83,32.579996537287116,0.6578815261044177,37.375992063492056,134463.4920634917,1620.0420730541168,0
448,512,0,0,330,0.0,0.0,1.0,330,9000,6700,2300,0.7444444444444445,113,67,46,180.99465236179503,0.4339189770040834,0.8432016909680453,0.12759034788364307,17670943.790938053,564669.265669131,18235613.056607183,447,1,306.46363636363634,85,245,85,32.514589384230035,0.6582107843137255,37.269864341085274,134517.82945736442,1582.562699498405,0
449,512,0,1,329,0.0,0.0030303030303030303,0.996969696969697,330,8050,6200,1850,0.7701863354037267,99,62,37,183.18401325785507,0.43374973135611433,0.8451822245683707,0.12951808092806105,17683980.868036766,573834.5171564198,18257815.385193184,448,2,307.46363636363634,85,245,81,32.358394012012816,0.6591911764705882,37.172965116279066,134567.441860465,1583.1463748290003,0
450,512,0,0,329,0.0,0.0,1.0,329,9750,6700,3050,0.6871794871794872,128,67,61,185.26605751142148,0.4333361133763313,0.8461831680701575,0.13140964544414793,17697978.596908454,580216.9441141501,18278195.541022602,449,3,309.0060790273556,86,243,66,32.19774590163934,0.6598837209302326,37.06896551724138,134620.68965517252,1565.3568564554944,0
451,512,0,0,329,0.0,0.0,1.0,329,10150,7300,2850,0.7192118226600985,130,73,57,187.22654341776803,0.43329788778510886,0.8475846750319691,0.13350168710704918,17720981.61865581,587617.6268861505,18308599.24554196,450,4,310.0060790273556,89,240,69,31.972183119244534,0.6605805243445693,36.89814814814817,134708.14814814902,1513.5746982938092,0
452,512,0,1,328,0.0,0.00303951367781155,0.9969604863221885,329,9400,6700,2700,0.7127659574468085,121,67,54,186.07561654812162,0.4329739355524254,0.8458696455349553,0.13296936394205325,17730438.200948272,584640.443981971,18315078.644930243,451,5,311.0060790273556,92,237,71,31.930966973101793,0.6603260869565217,36.82795698924734,134744.0860215068,1464.6096306685522,0
453,512,0,0,328,0.0,0.0,1.0,328,8650,6200,2450,0.7167630057803468,111,62,49,185.17998750758215,0.4325828314189106,0.8443005018945411,0.132568103206364,17738280.842219833,582704.9249536583,18320985.76717349,452,6,312.5823170731707,96,232,72,31.895262184508308,0.6597222222222222,36.769759450171854,134773.88316151363,1403.894616265767,0
454,512,0,0,328,0.0,0.0,1.0,328,9400,6800,2600,0.723404255319149,120,68,52,187.68678837835145,0.43230623461624523,0.8466131719161609,0.13484508875781898,17753846.463854533,591432.4848326507,18345278.948687185,453,7,313.5823170731707,100,228,74,31.711639382783737,0.6597916666666667,36.65429042904294,134833.00330033177,1348.3300330033176,0
455,512,0,0,328,0.0,0.0,1.0,328,10300,7300,3000,0.7087378640776699,133,73,60,188.55590811279058,0.43189600115611243,0.8490495611703124,0.13616997621360646,17776184.16229427,594460.9095003279,18370645.071794596,454,8,314.5823170731707,102,226,77,31.52001138573334,0.6609477124183006,36.48867313915861,134917.79935275234,1322.7235230661993,0
456,512,0,1,327,0.0,0.003048780487804878,0.9969512195121951,328,8800,6400,2400,0.7272727272727273,112,64,48,186.92478606612363,0.43161085782302777,0.8481141097989204,0.13571904438738697,17799370.692137085,591028.7117478726,18390399.40388496,455,9,315.5823170731707,80,248,80,31.387981206918983,0.6697916666666667,36.31687242798355,135005.76131687278,1687.5720164609097,0
457,512,0,0,327,0.0,0.0,1.0,327,8900,6100,2800,0.6853932584269663,117,61,56,185.36615110998224,0.43137050274228755,0.8462491689934857,0.1351959158335571,17818784.052972987,586299.8834719044,18405083.936444893,456,10,317.31804281345563,83,244,80,31.282657657657644,0.6700552208835342,36.17311507936507,135079.36507936465,1627.4622298718632,0
458,512,1,0,328,0.003048780487804878,0.0,1.0,328,9850,7700,2150,0.7817258883248731,120,77,43,185.16825872694238,0.4311876103279382,0.8375714970770203,0.13002141764014521,17653698.31049159,578330.9152489019,18232029.225740492,457,0,317.3475609756098,91,237,91,32.53554412969433,0.6548763736263736,37.398097826086975,134452.17391304424,1477.4964166268599,8
459,512,0,0,328,0.0,0.0,1.0,328,9000,6200,2800,0.6888888888888889,118,62,56,183.96160639591685,0.43080185102309737,0.8369922300210075,0.12956012600183095,17666818.696242753,575403.2694532508,18242221.965696003,458,1,318.3475609756098,93,235,93,32.46787030006467,0.655241935483871,37.30053191489363,134502.1276595753,1446.2594371997343,0
460,512,0,0,328,0.0,0.0,1.0,328,8500,6200,2300,0.7294117647058823,108,62,46,192.21020964634852,0.43074396770343854,0.8489536631493448,0.13489560164853356,17651397.18917138,604455.7508563218,18255852.940027703,459,2,319.3475609756098,85,243,85,32.3680654858004,0.6567401960784314,37.415213178294586,134443.41085271363,1581.6871865025132,8
461,512,0,1,327,0.0,0.003048780487804878,0.9969512195121951,328,9950,7400,2550,0.7437185929648241,125,74,51,191.26791010143415,0.43053341227219616,0.8494120854142044,0.134821450412971,17670587.96112807,600413.2859177088,18271001.24704578,460,3,320.3475609756098,86,242,86,32.247375776633405,0.6578246124031008,37.272509578544074,134516.47509578604,1564.145059253326,0
462,512,0,0,327,0.0,0.0,1.0,327,8700,6300,2400,0.7241379310344828,111,63,48,189.35821814949102,0.43031087596855594,0.8479319850788987,0.13380430169812282,17681387.884527177,595523.2208448163,18276911.105371993,461,4,322.0428134556575,87,240,82,32.21575383599078,0.6582854406130267,37.192234848484865,134557.57575757644,1546.6388018112234,0
463,512,0,0,327,0.0,0.0,1.0,327,9450,6900,2550,0.7301587301587301,120,69,51,188.24077261490442,0.4302667085670688,0.8471618894274564,0.13372428911734224,17704674.556213174,591698.323471407,18296372.879684582,462,5,323.0428134556575,90,237,64,32.06886045094454,0.6590277777777778,37.019230769230795,134646.15384615504,1496.0683760683894,0
464,512,0,0,327,0.0,0.0,1.0,327,8550,5900,2650,0.6900584795321637,112,59,53,184.37128282233513,0.4297601514668268,0.8440336388888661,0.13160446297354064,17725577.22376131,579667.4823022536,18305244.70606356,463,6,324.0428134556575,94,233,70,32.012563546962284,0.6593528368794326,36.86403508771932,134725.6140350889,1433.2512131392434,0
465,512,0,0,327,0.0,0.0,1.0,327,8700,6200,2500,0.7126436781609196,112,62,50,198.31803923271752,0.4296616542528908,0.8510988103867763,0.13458817643457194,17502065.57272273,620095.0653809686,18122160.638103697,464,7,325.0428134556575,77,250,77,33.342856717231065,0.6486742424242424,38.52831196581199,133873.5042735051,1738.6169386169493,7
466,512,0,0,327,0.0,0.0,1.0,327,10250,7800,2450,0.7609756097560976,127,78,49,193.52612263176428,0.429311051074714,0.8473240600132919,0.13207286843697824,17527168.95695245,602743.0097901722,18129911.96674262,465,8,326.0428134556575,82,245,82,33.27707563911941,0.6485010162601625,38.34086345381529,133969.4779116477,1633.7741208737525,0
467,512,1,1,327,0.003048780487804878,0.003048780487804878,0.9969512195121951,328,8700,6400,2300,0.735632183908046,110,64,46,191.87998465346715,0.4290968182044206,0.8465127501892529,0.13173240356377666,17553826.430202603,599345.5892073842,18153172.019409988,466,0,326.0457317073171,85,243,77,33.11742564410938,0.6493872549019608,38.1419573643411,134071.31782945807,1577.3096215230362,0
468,512,0,2,325,0.0,0.0061162079510703364,0.9938837920489296,327,9750,7300,2450,0.7487179487179487,122,73,49,186.22190655026705,0.4288568694771205,0.8405769318544882,0.121072771725481,17306687.59878694,569426.872143199,17876114.470930137,467,1,327.70030581039754,101,226,71,35.14990835297204,0.6258250825082508,39.9918300653595,133124.18300653712,1318.061217886506,8
469,512,2,0,327,0.0061162079510703364,0.0,1.0,327,8550,5100,3450,0.5964912280701754,120,51,69,181.803073588779,0.42888383895236487,0.836845630039774,0.11862236038867652,17323133.99885305,555929.8010363576,17879063.799889408,468,0,327.48623853211006,105,222,77,35.1390436704318,0.6260912698412698,39.86831761006292,133187.42138364902,1268.4516322252289,0
470,512,0,0,327,0.0,0.0,1.0,327,10500,7800,2700,0.7428571428571429,132,78,54,186.8167926561111,0.42845701769197575,0.8410666221132923,0.12242882975894863,17343276.753734004,572103.0674559837,17915379.82118999,469,1,328.48623853211006,108,219,82,34.854604200323124,0.626929012345679,39.71712538226303,133264.83180428302,1233.9336278174353,0
471,512,0,0,327,0.0,0.0,1.0,327,8850,6300,2550,0.711864406779661,114,63,51,183.53640905060925,0.42828152067190733,0.8414198532877999,0.12096078690264592,17369186.98545754,563325.6414878882,17932512.62694543,470,2,329.48623853211006,85,242,85,34.742065798651446,0.6354166666666667,39.522771317829445,133364.3410852708,1568.9922480620094,0
472,512,0,0,327,0.0,0.0,1.0,327,9500,6700,2800,0.7052631578947368,123,67,56,176.25179039260973,0.42815331794900663,0.8412830361955985,0.11574866420065022,17352942.137639582,536797.424067675,17889739.56170726,471,3,330.48623853211006,101,226,77,35.055797442535514,0.6293316831683169,39.64460784313729,133301.9607843154,1319.8213939041127,8
473,512,0,0,327,0.0,0.0,1.0,327,9850,6900,2950,0.700507614213198,128,69,59,173.96581636467818,0.4280090898857432,0.8393798639215451,0.11466572113460943,17369685.557757072,529096.3056105922,17898781.863367666,472,4,331.48623853211006,80,247,80,34.98755451328889,0.6373697916666667,39.51903292181069,133366.25514403256,1667.078189300407,0
474,512,1,0,328,0.003048780487804878,0.0,1.0,328,9650,6900,2750,0.7150259067357513,124,69,55,168.60358290809805,0.4281584480122324,0.8340195616148924,0.11163113529281356,17390193.047292776,511159.7710474097,17901352.818340186,473,0,331.4725609756098,85,243,85,34.97091582241222,0.6370098039215686,39.36531007751937,133444.96124030967,1569.9407204742315,0
475,512,1,0,329,0.00303951367781155,0.0,1.0,329,9450,6900,2550,0.7301587301587301,120,69,51,166.86002079989257,0.42850733313564143,0.83213739274365,0.1108086750373167,17403872.452334035,505552.1038790283,17909424.556213062,474,0,331.46200607902733,90,239,86,34.91215939356689,0.6363425925925925,39.26282051282052,133497.43589743623,1483.304843304847,0
476,512,0,0,329,0.0,0.0,1.0,329,9900,6900,3000,0.696969696969697,129,69,60,166.43947349324372,0.4284127344502928,0.832025689352339,0.11093855400519265,17420685.941043112,504197.9591836744,17924883.900226787,475,1,332.46200607902733,90,239,71,34.79511313938011,0.6376157407407408,39.136904761904766,133561.90476190497,1484.0211640211662,0
477,512,1,1,329,0.0030303030303030303,0.0030303030303030303,0.996969696969697,330,9750,7500,2250,0.7692307692307693,120,75,45,168.58625502126637,0.42872916091001195,0.8346513710474301,0.112799530632411,17438028.26819577,512212.37613802095,17950240.64433379,476,0,332.45151515151514,93,237,72,34.60711050724632,0.6379928315412187,39.00709219858156,133628.3687943263,1436.8641805841537,0
478,512,1,0,330,0.0030303030303030303,0.0,1.0,330,9700,7100,2600,0.7319587628865979,123,71,52,169.80556534593921,0.42873568511866383,0.8353239389376623,0.11428737762930032,17464723.292378142,517421.442454531,17982144.734832674,477,0,333.44242424242424,97,233,78,34.37220221381191,0.6388530927835052,38.80739795918367,133730.6122448977,1378.6661056175021,0
479,512,0,0,330,0.0,0.0,1.0,330,9250,6300,2950,0.6810810810810811,122,63,59,199.79170460676303,0.42839661815725644,0.8618340385401804,0.1405353892729862,17661395.37251368,630470.0574416989,18291865.429955382,478,1,334.44242424242424,71,259,71,32.09314468006978,0.6635856807511737,37.340856481481474,134481.4814814812,1894.1053729786083,8
480,512,0,0,330,0.0,0.0,1.0,330,8750,6600,2150,0.7542857142857143,109,66,43,209.829578574192,0.42833195173620703,0.8618262177352363,0.14263477694243584,17509452.956679057,660050.2269929247,18169503.18367198,479,2,335.44242424242424,75,255,75,32.98552879828101,0.6501388888888888,38.473135964912295,133901.75438596553,1785.356725146207,8
481,512,0,0,330,0.0,0.0,1.0,330,8500,5400,3100,0.6352941176470588,116,54,62,208.92216604164966,0.42808364803045656,0.8611076444296235,0.14225042950071,17516794.831101965,657429.3436442026,18174224.174746167,480,3,336.44242424242424,75,255,75,32.95329010566762,0.6506944444444445,38.41831140350879,133929.82456140418,1785.7309941520557,0
482,512,0,1,329,0.0,0.0030303030303030303,0.996969696969697,330,9100,5600,3500,0.6153846153846154,126,56,70,212.39608496459783,0.42782191213042275,0.8631416202844784,0.1453548626154374,17539630.36014322,669969.7640441257,18209600.124187343,481,4,337.44242424242424,77,253,71,32.68835034013606,0.6515151515151515,38.24786324786326,134017.09401709432,1740.4817404817445,0
483,512,0,0,329,0.0,0.0,1.0,329,9300,6800,2500,0.7311827956989247,118,68,50,197.95305677383598,0.4278119362690587,0.8566866600150775,0.1275330537507589,17264550.95337286,608414.1270095605,17872965.080382418,482,5,338.9696048632219,78,251,75,35.16787255648642,0.6302083333333333,40.30854430379747,132962.02531645572,1704.6413502109708,8
484,512,2,2,329,0.006042296072507553,0.006042296072507553,0.9939577039274925,331,7000,4500,2500,0.6428571428571429,95,45,50,196.79218041100629,0.42857426226006284,0.8564979055215092,0.12725230685887826,17281595.321898375,606976.5648754066,17888571.88677378,483,0,337.9154078549849,81,250,64,35.067339347121035,0.630272633744856,40.180386178861795,133027.64227642302,1642.3165713138644,0
485,512,0,1,328,0.0,0.00303951367781155,0.9969604863221885,329,9850,6600,3250,0.6700507614213198,131,66,65,192.4470078561369,0.4275937801171325,0.8522643245998796,0.12498324264857659,17301638.32199546,590279.7052154198,17891918.02721088,484,7,340.9696048632219,83,246,69,35.02671245945432,0.6310240963855422,40.029761904761905,133104.76190476186,1603.6718301778537,0
486,512,0,0,328,0.0,0.0,1.0,328,10300,7900,2400,0.7669902912621359,127,79,48,189.44224072592706,0.42756990284925783,0.8479486313832358,0.1234389776751886,17316878.027345214,580209.6351755761,17897087.66252079,485,8,342.6341463414634,90,238,72,34.988190073793696,0.6297453703703704,39.915293040293065,133163.36996337117,1479.592999593013,0
487,512,0,0,328,0.0,0.0,1.0,328,10050,7700,2350,0.7661691542288557,124,77,47,186.0799753809187,0.4274995882126253,0.8456815800360542,0.12169781061957037,17333916.728664212,569448.9596249528,17903365.688289165,486,9,343.6341463414634,96,232,74,34.945335176702045,0.6292317708333333,39.787371134020646,133228.86597938274,1387.8006872852368,0
488,512,3,0,331,0.00906344410876133,0.0,1.0,331,9800,7200,2600,0.7346938775510204,124,72,52,189.13351437853447,0.4285197137538527,0.8510996633218793,0.12439223167453406,17359722.25000022,580661.0555555648,17940383.305555783,487,0,341.5105740181269,99,232,77,34.66859507713646,0.6303661616161615,39.593750000000036,133328.00000000172,1346.747474747492,0
489,512,3,1,333,0.008982035928143712,0.0029940119760479044,0.9970059880239521,334,9850,7100,2750,0.7208121827411168,126,71,55,184.5944652290597,0.4295067897238556,0.8483917351196277,0.12206749923618392,17384546.055708677,565168.1964806966,17949714.25218937,488,0,339.4341317365269,82,252,82,34.59723961343346,0.6377032520325203,39.40763052208833,133423.29317268997,1627.113331374268,0
490,512,1,1,333,0.0029940119760479044,0.0029940119760479044,0.9970059880239521,334,9100,6400,2700,0.7032967032967034,118,64,54,182.87901182372264,0.4298443278607949,0.8467925695853509,0.12110116794300521,17390885.770974964,560185.6009070249,17951071.371881988,489,0,340.39820359281435,83,251,83,34.59356266057663,0.6378012048192772,39.36011904761903,133447.61904761833,1607.8026391279316,0
491,512,0,0,333,0.0,0.0,1.0,333,9550,6800,2750,0.7120418848167539,123,68,55,177.41307042119684,0.42943432890722044,0.8412823756838852,0.11796301468381562,17409521.840676565,541585.3448638587,17951107.185540423,490,1,342.35735735735733,88,245,79,34.593936537857374,0.6374289772727273,39.22050561797751,133519.1011235946,1517.2625127681204,0
492,512,0,0,333,0.0,0.0,1.0,333,9100,6900,2200,0.7582417582417582,113,69,44,178.47174506275465,0.4292458874537188,0.8432253526686264,0.11907553634222803,17425152.58314736,546279.477899811,17971432.06104717,491,2,343.35735735735733,88,245,70,34.44719842088735,0.6386126893939394,39.103464419475635,133579.0262172276,1517.9434797412227,0
493,512,0,0,333,0.0,0.0,1.0,333,9350,6800,2550,0.7272727272727273,119,68,51,180.88407971683696,0.42905895353184514,0.8449359886201988,0.12101399699365767,17437507.547397524,554883.5010532746,17992391.048450798,492,3,344.35735735735733,90,243,70,34.290113304093545,0.6388888888888888,39.010989010988986,133626.37362637257,1484.737484737473,0
494,512,1,0,334,0.0029940119760479044,0.0,1.0,334,8950,5900,3050,0.659217877094972,120,59,61,180.8231410675308,0.42906248314182444,0.8454565687243201,0.12166202146219275,17463211.137518127,555800.5382022992,18019011.675720427,493,0,344.32335329341316,93,241,75,34.09594347094348,0.6398969534050178,38.81870567375885,133724.82269503464,1437.9013193014478,0
495,512,1,0,335,0.0029850746268656717,0.0,1.0,335,9500,6400,3100,0.6736842105263158,126,64,62,176.604308896753,0.42899313313671167,0.8432477052629783,0.11942259143151553,17485905.01411163,541117.234090285,18027022.248201914,494,0,344.29253731343283,96,239,78,34.0334846803906,0.6407335069444444,38.649054982817844,133811.68384879606,1393.8717067582922,0
496,512,0,1,334,0.0,0.0029850746268656717,0.9970149253731343,335,9750,7500,2250,0.7692307692307693,120,75,45,175.7190574559728,0.4288125242053207,0.8426647825958975,0.1191674185796916,17498897.166944254,538227.9433388816,18037125.110283136,495,1,345.29253731343283,100,235,81,33.95784023668637,0.640625,38.55198019801978,133861.3861386126,1338.613861386126,0
497,512,0,1,333,0.0,0.0029940119760479044,0.9970059880239521,334,10450,7600,2850,0.7272727272727273,133,76,57,176.41395577695448,0.42843554632476794,0.8428433974822487,0.11980968652440152,17505318.3013178,540386.4897340409,18045704.791051842,496,2,347.3023952095808,82,252,82,33.89086196966792,0.646849593495935,38.504016064257044,133885.943775101,1632.7554118914757,0
498,512,0,0,333,0.0,0.0,1.0,333,10700,8300,2400,0.7757009345794392,131,83,48,200.31999999999903,0.4282577004715559,0.8608528528528532,0.1317894736842106,17361111.111111205,618255.5555555599,17979366.666666765,497,3,349.04804804804803,96,237,73,34.36666666666672,0.6312934027777778,39.58333333333335,133333.33333333407,1388.8888888888966,8
499,512,1,0,334,0.0029940119760479044,0.0,1.0,334,10350,7600,2750,0.7342995169082126,131,76,55,198.13354205797958,0.42843161275047503,0.8591570688002466,0.1308143258997128,17377348.672251236,611457.1288019316,17988805.801053166,498,0,349.0,76,258,76,34.29944008861657,0.6396655701754386,39.46158008658008,133395.67099567072,1755.206197311457,0
500,512,1,0,335,0.0029850746268656717,0.0,1.0,335,10350,7300,3050,0.7053140096618358,134,73,61,196.73894491184467,0.4282762832543867,0.858480546510286,0.13055609264149898,17400571.093498465,607323.9995596799,18007895.093058143,499,0,348.95522388059703,80,255,75,34.15832223482793,0.6397135416666666,39.28755144032919,133484.77366255023,1668.559670781878,0
501,512,0,1,334,0.0,0.0029850746268656717,0.9970149253731343,335,10100,7100,3000,0.7029702970297029,131,71,60,197.1669609774544,0.4278916048500015,0.8569023890134009,0.13130480592753702,17416711.111110862,609699.9999999882,18026411.11111085,500,1,349.95522388059703,84,251,63,34.023895101171455,0.6393849206349207,39.16666666666662,133546.66666666474,1589.841269841247,0
502,512,0,0,334,0.0,0.0,1.0,334,10500,7500,3000,0.7142857142857143,135,75,60,194.87647559896214,0.4275531144917373,0.8544061918297619,0.13026622873791133,17433717.72976659,602184.2935528017,18035902.02331939,501,2,350.5059880239521,89,245,65,33.95384271373867,0.6389279026217228,39.03935185185181,133611.85185185017,1501.2567623803388,0
503,512,0,1,333,0.0,0.0029940119760479044,0.9970059880239521,334,9750,7100,2650,0.7282051282051282,124,71,53,192.12440895800825,0.42723899048749353,0.8531549751145411,0.1290832412232547,17456822.111740325,594226.3261006296,18051048.437840953,502,3,351.5059880239521,92,242,69,33.8494752795173,0.6397192028985508,38.86648745519709,133700.35842293696,1453.264765466706,0
504,512,0,0,333,0.0,0.0,1.0,333,9900,6900,3000,0.696969696969697,129,69,60,181.15140164139967,0.4269574544423942,0.84244580362104,0.11432932832069741,17168412.098298583,545516.3831127873,17713928.48141137,503,5,353.5525525525525,91,242,75,36.34137810423222,0.6181318681318682,41.03260869565216,132591.30434782535,1457.0473005255533,8
505,512,2,0,335,0.005970149253731343,0.0,1.0,335,9500,7000,2500,0.7368421052631579,120,70,50,184.54057429234027,0.4274372895999046,0.8459990794924068,0.1168990291934216,17185728.868014604,557792.8549871701,17743521.723001774,504,0,352.4358208955224,93,242,77,36.120630355131645,0.618839605734767,40.902039007092185,132658.15602836813,1426.4317852512702,0
506,512,0,0,335,0.0,0.0,1.0,335,10300,7500,2800,0.7281553398058253,131,75,56,183.90172900554666,0.427698707063485,0.8461662689040303,0.11694909742344226,17203965.47041237,555467.7991521073,17759433.269564476,505,1,353.4358208955224,96,239,79,35.997221071527186,0.6193576388888888,40.764604810996545,132728.52233676883,1382.588774341342,0
507,512,2,0,337,0.005934718100890208,0.0,1.0,337,10450,8300,2150,0.7942583732057417,126,83,43,180.9570971135958,0.4286567990203005,0.8456095158638157,0.11557494962824737,17224146.864764515,545516.3233812087,17769663.188145723,506,0,352.33234421364983,83,254,83,35.91880009880319,0.6251255020080322,40.61259920634922,132806.3492063499,1600.076496462047,0
508,512,0,0,337,0.0,0.0,1.0,337,9400,6200,3200,0.6595744680851063,126,62,64,181.4118545787295,0.42854051858131975,0.8454320210673254,0.1165228358732018,17250488.8902917,549088.6363955202,17799577.52668722,507,1,353.33234421364983,88,249,88,35.70513398560199,0.6253551136363636,40.41432584269664,132907.86516853987,1510.3166496424985,0
509,512,1,0,338,0.0029585798816568047,0.0,1.0,338,9700,6600,3100,0.6804123711340206,128,66,62,177.47405656715844,0.42859481355971885,0.8421269007225365,0.11450080957549258,17271098.064735256,535734.3669835564,17806832.43171881,508,0,353.28402366863907,93,245,80,35.64958509322073,0.6253360215053764,40.25930851063831,132987.23404255384,1429.9702585220844,0
510,512,1,0,339,0.0029498525073746312,0.0,1.0,339,9900,7500,2400,0.7575757575757576,123,75,48,193.23356067219197,0.4290588108661628,0.8593027234994548,0.11989762160187228,17088118.71604947,582699.6049382762,17670818.320987746,509,0,353.23893805309734,74,265,74,36.64648514496649,0.6185247747747749,41.63888888888891,132280.88888888957,1787.5795795795889,8
511,512,3,0,342,0.008771929824561403,0.0,1.0,342,9450,6400,3050,0.6772486772486772,125,64,61,185.7818424845009,0.4298095556584521,0.85472871504037,0.11602601860824535,17118906.250000067,558226.3888888928,17677132.63888896,510,0,351.13157894736844,79,263,79,36.602047667002374,0.6186708860759493,41.406250000000014,132400.00000000052,1675.9493670886143,0
512,512,4,3,343,0.011560693641618497,0.008670520231213872,0.9913294797687862,346,10250,6800,3450,0.6634146341463415,137,68,69,182.76265382069624,0.4313309807042529,0.8538642458482915,0.11482180606253553,17146982.190072782,547315.5940147861,17694297.78408757,511,0,348.0606936416185,85,261,66,36.46428097845589,0.6185049019607843,41.19428294573645,132508.5271317835,1558.9238486092179,0
513,512,0,0,343,0.0,0.0,1.0,343,9250,6000,3250,0.6486486486486487,125,60,65,182.82698130123856,0.4299265027648486,0.8530256560575742,0.11515490290348643,17158957.18647704,549574.0689361593,17708531.255413197,512,1,352.1049562682216,86,257,67,36.37060845704421,0.6190649224806202,41.10392720306514,132554.78927203093,1541.3347589771038,0
514,512,0,0,343,0.0,0.0,1.0,343,10550,7500,3050,0.7109004739336493,136,75,61,180.57012003101696,0.4299222404082769,0.8512026955238792,0.1140934102338639,17173803.410525832,541065.148645552,17714868.559171386,513,2,353.1049562682216,87,256,71,36.31503930350533,0.6198515325670498,40.99195075757578,132612.12121212215,1524.2772553117488,0
515,512,0,0,343,0.0,0.0,1.0,343,9300,6700,2600,0.7204301075268817,119,67,52,178.47956136893384,0.42984693877551017,0.8493398753229495,0.11315972189886096,17189875.015780963,535708.2705606812,17725583.286341645,514,3,354.1049562682216,88,255,75,36.24585968081901,0.6207386363636364,40.870786516853954,132674.1573033718,1507.6608784474067,0
516,512,1,0,344,0.0029069767441860465,0.0,1.0,344,10450,7700,2750,0.7368421052631579,132,77,55,179.65143284361375,0.4302950623771103,0.8453444833020887,0.10858381092788513,16962720.78360575,530225.4187401878,17492946.202345937,515,0,354.07267441860466,86,258,86,37.96416887607177,0.6040455426356589,42.58860153256707,131794.6360153265,1532.4957676200756,8
517,512,1,0,345,0.002898550724637681,0.0,1.0,345,9700,6700,3000,0.6907216494845361,127,67,60,176.93978988044825,0.43082062408718125,0.8429688803949662,0.10745809449493382,16985746.8231465,522390.8947700104,17508137.71791651,516,0,354.04347826086956,91,254,84,37.856227106227124,0.6041666666666667,42.413949275362334,131884.05797101528,1449.2753623188491,0
518,512,4,0,349,0.011461318051575931,0.0,1.0,349,9850,7200,2650,0.7309644670050761,125,72,53,171.1342282144117,0.4324620014491322,0.8373195152251975,0.10461149456419058,17016973.06591496,502787.3104361626,17519760.37635112,517,0,350.974212034384,101,248,75,37.76505849111414,0.6037541254125413,42.17728758169937,132005.22875817103,1306.9824629521884,0
519,512,0,0,349,0.0,0.0,1.0,349,9850,6600,3250,0.6700507614213198,131,66,65,171.70540763147702,0.43240539472384154,0.8408636305180042,0.1053966749036311,17036785.420775965,505411.63708087377,17542197.05785684,518,1,351.974212034384,103,246,76,37.59771186001969,0.6047734627831716,42.02724358974361,132082.05128205253,1282.350012447112,0
520,512,3,0,352,0.008522727272727272,0.0,1.0,352,10200,7400,2800,0.7254901960784313,130,74,56,175.0798247853096,0.4332699996762497,0.846045983595251,0.10823225681820757,17070543.09401566,517141.5387780683,17587684.63279373,519,0,349.96590909090907,108,244,83,37.25073399701468,0.6061921296296297,41.77178899082569,132212.84403669732,1224.19300033979,0
521,512,4,0,356,0.011235955056179775,0.0,1.0,356,9600,6700,2900,0.6979166666666666,125,67,58,172.0917711521187,0.43491981853668826,0.8452449486511622,0.10697285819277497,17096693.552811924,507640.05486967746,17604333.607681602,520,0,347.02247191011236,89,267,89,37.12677654365216,0.6132958801498127,41.57407407407405,132314.0740740729,1486.6749895963248,0
522,512,2,0,358,0.00558659217877095,0.0,1.0,358,9900,6400,3500,0.6464646464646465,134,64,70,167.34576520417087,0.4356275331361595,0.842087687809606,0.10459334409038278,17122574.442935247,491578.0644836684,17614152.507418916,521,0,346.0782122905028,93,265,89,37.050625589167836,0.6140232974910393,41.378546099290745,132414.1843971614,1423.8084343780797,0
523,512,1,0,359,0.002785515320334262,0.0,1.0,359,10700,7700,3000,0.719626168224299,137,77,60,166.85831536912275,0.43583621221788227,0.8398017339125274,0.10486625154490554,17148619.007940147,489777.93571435317,17638396.9436545,522,0,346.1114206128134,100,259,74,36.863335989905,0.6140625,41.18193069306927,132514.85148514656,1325.1485148514655,0
524,512,0,0,359,0.0,0.0,1.0,359,9900,7200,2700,0.7272727272727273,126,72,54,169.15774187404654,0.4358391300062765,0.8415528370699723,0.10686293012541441,17172944.503777213,499287.3027174431,17672231.806494657,523,1,347.1114206128134,105,254,78,36.61721556128897,0.6146825396825397,40.99842767295593,132608.805031444,1262.9410002994666,0
525,512,1,1,359,0.002777777777777778,0.002777777777777778,0.9972222222222222,360,8950,6100,2850,0.6815642458100558,118,61,57,170.54600080878197,0.43588059682244923,0.8445204360574523,0.10814395571700443,17190493.279415984,505403.9761469186,17695897.2555629,524,0,347.14444444444445,107,253,81,36.44670196399541,0.6155568535825545,40.86612654320984,132676.54320987448,1239.9676935502287,0
526,512,0,1,358,0.0,0.002785515320334262,0.9972144846796658,359,10600,7900,2700,0.7452830188679245,133,79,54,171.38505050338932,0.4356617933116509,0.8465728570115476,0.10919138958031158,17212620.46485238,507597.1655328715,17720217.630385254,525,1,349.02785515320335,111,248,84,36.2553802008608,0.6163663663663663,40.69940476190473,132761.904761903,1196.05319605318,0
527,512,1,0,359,0.002785515320334262,0.0,1.0,359,10600,7800,2800,0.7358490566037735,134,78,56,166.79756262946447,0.43555934651914324,0.8417513527632319,0.106932168607157,17241636.51853537,492772.5894069756,17734409.107942343,526,0,348.7075208913649,93,266,93,36.15222504519126,0.6230958781362007,40.48093971631207,132873.75886524888,1428.7500953252568,0
528,512,1,0,360,0.002777777777777778,0.0,1.0,360,11450,8600,2850,0.7510917030567685,143,86,57,163.68478219324203,0.43562783709893743,0.8397471556131633,0.10567599118166277,17274239.13659617,482056.0141255484,17756295.150721718,527,0,348.7361111111111,98,262,87,35.98374378915535,0.6241496598639455,40.23569023569026,132999.3265993276,1357.1359857074247,0
529,512,0,0,360,0.0,0.0,1.0,360,11150,8100,3050,0.726457399103139,142,81,61,162.41474958850836,0.4353837821108016,0.8386527145457459,0.10526851575473112,17292408.987128377,478558.45508530724,17770967.442213684,528,1,349.7361111111111,102,258,74,35.87793623617004,0.6244893790849673,40.09911003236247,133069.2556634308,1304.6005457199099,0
530,512,0,0,360,0.0,0.0,1.0,360,11900,9000,2900,0.7563025210084033,148,90,58,172.4571022255352,0.43524918111007943,0.852321834723275,0.10780612219691083,17123368.55055756,506709.30411380675,17630077.854671367,529,2,350.7361111111111,84,276,77,36.91233494440237,0.6170634920634921,41.37254901960786,132417.25490196142,1576.395891690017,8
531,512,0,0,360,0.0,0.0,1.0,360,10400,7300,3100,0.7019230769230769,135,73,62,174.92402661859757,0.4351921167337254,0.8537944624860883,0.10986394696818175,17145559.60887285,517434.0650826462,17662993.673955496,530,3,351.7361111111111,87,273,66,36.67807292381342,0.6176963601532567,41.205018939393945,132503.03030303054,1523.023336816443,0
532,512,2,0,362,0.0055248618784530384,0.0,1.0,362,11100,8100,3000,0.7297297297297297,141,81,60,169.19577271599812,0.4358256110252368,0.8495740355813828,0.10698824771527665,17177389.227454595,497768.3287165279,17675157.556171123,531,0,350.78729281767954,94,268,72,36.58214809797945,0.6179078014184397,40.96491228070175,132625.96491228064,1410.9145203434111,0
533,512,2,0,364,0.005494505494505495,0.0,1.0,364,10450,7900,2550,0.7559808612440191,130,79,51,165.6320498827173,0.43658519510792243,0.8468662911847449,0.10528568390875588,17201961.572394818,486589.2314478956,17688550.803842712,532,0,349.8543956043956,100,264,79,36.48618405347335,0.618125,40.77970297029702,132720.79207920757,1327.2079207920758,0
534,512,0,0,364,0.0,0.0,1.0,364,11150,7900,3250,0.7085201793721974,144,79,65,166.17744711427616,0.43663375765648493,0.8486124951828644,0.10597700642075954,17217179.898093358,488271.4003944771,17705451.298487835,533,1,350.8543956043956,103,261,80,36.35550234306604,0.618527508090615,40.6650641025641,132779.48717948716,1289.1212347523026,0
535,512,2,0,366,0.00546448087431694,0.0,1.0,366,9000,6100,2900,0.6777777777777778,119,61,58,177.14840112689163,0.4366341667290466,0.8540271105111703,0.11297355669895179,17217179.898093216,527799.1781722495,17744979.076265465,534,0,349.93169398907105,103,263,79,36.070987177506545,0.618527508090615,40.66506410256408,132779.48717948605,1289.1212347522917,8
536,512,2,0,368,0.005434782608695652,0.0,1.0,368,10600,7700,2900,0.7264150943396226,135,77,58,173.80000276185567,0.4371982733088497,0.8515912580719776,0.11108367523461858,17227500.362897415,514627.9221302894,17742128.285027705,535,0,349.0244565217391,82,286,82,36.07875745847444,0.6257621951219512,40.587349397590366,132819.27710843406,1619.7472818101714,0
537,512,1,1,368,0.0027100271002710027,0.0027100271002710027,0.997289972899729,369,9300,5800,3500,0.6236559139784946,128,58,70,172.38672963195444,0.437200215525706,0.8494022529718661,0.11069600568372306,17249233.851297133,511607.8024563852,17760841.65375352,536,0,349.0758807588076,87,282,87,35.9490191831213,0.6255986590038314,40.42376893939395,132903.03030303086,1527.621037965872,0
538,512,1,1,368,0.0027100271002710027,0.0027100271002710027,0.997289972899729,369,11300,8900,2400,0.7876106194690266,137,89,48,173.09657363478632,0.4372290586583402,0.8499137608885563,0.11180295238080003,17276338.305898584,512994.99314129463,17789333.299039878,537,0,349.9918699186992,89,280,85,35.7232030147769,0.6269897003745318,40.219907407407426,133007.40740740814,1494.4652517686309,0
539,512,0,0,368,0.0,0.0,1.0,368,12050,8500,3550,0.7053941908713693,156,85,71,168.70450124917355,0.4369295576156063,0.8443201303450791,0.10947549560978935,17297912.405102104,497997.1369909354,17795909.54209304,538,1,351.8695652173913,100,268,74,35.67241310903032,0.6254166666666667,40.05775577557759,133090.4290429059,1330.9042904290588,0
540,512,0,1,367,0.0,0.002717391304347826,0.9972826086956522,368,11800,8200,3600,0.6949152542372882,154,82,72,170.45817613708294,0.4369253926766181,0.8467097849563334,0.11098740617056635,17313485.86547924,504845.0446409562,17818330.910120193,539,2,352.8695652173913,101,267,77,35.50784573597751,0.6263407590759076,39.94076797385623,133150.32679738678,1318.3200673008591,0
541,512,1,2,366,0.002717391304347826,0.005434782608695652,0.9945652173913043,368,10500,7500,3000,0.7142857142857143,135,75,60,167.23707228392686,0.43649316456383525,0.8434595502488937,0.10936078705896658,17333344.44444458,495655.55555556086,17829000.000000138,540,0,353.8478260869565,109,259,83,35.440018681611974,0.6259556574923548,39.791666666666686,133226.6666666677,1222.2629969419056,0
542,512,1,0,367,0.0027247956403269754,0.0,1.0,367,10450,7400,3050,0.7081339712918661,135,74,61,166.58663549818584,0.43618289136056143,0.8425253485436894,0.10924148908911148,17346233.34750588,494080.13038549473,17840313.477891374,541,0,355.7602179836512,111,256,87,35.35860606926776,0.6265015015015015,39.6949404761905,133276.1904761921,1200.6864006864153,0
543,512,1,0,368,0.002717391304347826,0.0,1.0,368,10350,7300,3050,0.7053140096618358,134,73,61,166.13214039590923,0.43644904706195947,0.8435751055155363,0.10940560050177792,17365640.391986985,493048.2015332911,17858688.593520276,542,0,355.7907608695652,91,277,91,35.222443811676705,0.6331272893772895,39.549365942028984,133350.7246376812,1465.3925784360572,0
544,512,1,0,369,0.0027100271002710027,0.0,1.0,369,10100,6800,3300,0.6732673267326733,134,68,66,161.38031008419412,0.4367187806841837,0.8391984386199627,0.10671006406888806,17384266.97530868,477195.67901234725,17861462.654321026,543,0,355.8238482384824,95,274,95,35.20430823895183,0.6333333333333333,39.40972222222223,133422.2222222225,1404.4444444444475,0
545,512,0,1,368,0.0,0.0027100271002710027,0.997289972899729,369,10250,7400,2850,0.7219512195121951,131,74,57,161.88529954229796,0.43661445445976194,0.838696601579894,0.10751262756283567,17404193.361111186,479446.6111111142,17883639.972222302,544,1,356.8238482384824,99,270,93,35.03942611162161,0.633733164983165,39.26041666666668,133498.66666666727,1348.4713804713865,0
546,512,0,0,368,0.0,0.0,1.0,368,9600,6700,2900,0.6979166666666666,125,67,58,161.5603725041475,0.4362354011175611,0.8396147179617677,0.10784207115742576,17427247.331929933,479910.5141337029,17907157.846063636,545,2,357.95380434782606,102,266,72,34.87247567735184,0.6347017973856209,39.08778317152104,133587.0550161814,1309.6770099625628,0
547,512,0,0,368,0.0,0.0,1.0,368,10000,7100,2900,0.71,129,71,58,179.66556142860344,0.4361269584468665,0.851079571562986,0.1126168676841106,17136150.173610877,532155.2083333232,17668305.381944202,546,3,358.95380434782606,95,273,81,36.627663143767776,0.6144736842105263,41.27604166666663,132466.66666666485,1394.3859649122617,8
548,512,4,0,372,0.010752688172043012,0.0,1.0,372,11150,8200,2950,0.7354260089686099,141,82,59,174.46676582796957,0.4376254419905516,0.8567861432454631,0.10861431596350477,17103900.96116881,511262.45674740593,17615163.417916216,547,0,356.0833333333333,84,288,84,37.009984038181905,0.6155753968253967,41.51960784313726,132341.96078431394,1575.4995331465946,8
549,512,1,0,373,0.002680965147453083,0.0,1.0,373,10450,7200,3250,0.6889952153110048,137,72,65,169.12315974202545,0.43773122123247526,0.8520222694989696,0.10603053231018757,17137119.190899014,494606.74928810855,17631725.940187123,548,0,356.1260053619303,88,285,79,36.892981543472374,0.6167140151515151,41.2687265917603,132470.4119850187,1505.3455907388488,0
550,512,2,2,373,0.005333333333333333,0.005333333333333333,0.9946666666666667,375,9850,7100,2750,0.7208121827411168,126,71,55,170.37949554753033,0.4386625074272133,0.8526838910066363,0.10727093039672439,17157036.01108022,499791.42813172826,17656827.43921195,549,0,355.22133333333335,94,281,72,36.707609769871546,0.6163563829787234,41.11842105263156,132547.36842105177,1410.0783874579975,0
551,512,1,0,374,0.00267379679144385,0.0,1.0,374,12200,8600,3600,0.7049180327868853,158,86,72,168.45593673079674,0.43853373667283146,0.8512819800699345,0.10662921382249425,17182176.408178914,491887.9243827119,17674064.332561627,550,0,357.0855614973262,95,279,78,36.564611604400525,0.6179824561403509,40.92881944444443,132644.44444444368,1396.2573099415124,0
552,512,0,0,374,0.0,0.0,1.0,374,11050,7900,3150,0.7149321266968326,142,79,63,170.18780634598903,0.4385891420911528,0.8522263874075058,0.10811292278037368,17198991.36111108,499561.7222222209,17698553.0833333,551,1,358.0855614973262,99,275,80,36.39085084863828,0.6181607744107744,40.80208333333333,132709.33333333308,1340.498316498314,0
553,512,2,0,376,0.005319148936170213,0.0,1.0,376,10850,8100,2750,0.7465437788018433,136,81,55,193.52366057897262,0.43925930851063827,0.8713333632316651,0.11873279856104274,17034517.60388553,573266.4405801678,17607784.0444657,552,0,357.1755319148936,90,286,64,37.05236299090303,0.6082175925925926,42.044413919413884,132073.26007325848,1467.4806674806498,8
554,512,2,0,378,0.005291005291005291,0.0,1.0,378,12000,9100,2900,0.7583333333333333,149,91,58,189.34370744418774,0.4396526871383193,0.8685230703424502,0.11704620938038288,17070388.37984153,558834.1246702672,17629222.504511796,553,0,356.2804232804233,97,281,74,36.88359265662298,0.6088917525773196,41.772959183673436,132212.2448979576,1363.0128339995629,0
555,512,1,0,379,0.002638522427440633,0.0,1.0,379,11250,8300,2950,0.7377777777777778,142,83,59,209.88828399974201,0.43977816866998926,0.8789067846998133,0.13079478940774877,17108564.062499996,631127.4305555555,17739691.493055552,554,0,356.3377308707124,79,300,79,36.05843490816293,0.6178797468354431,41.484375,132359.99999999997,1675.4430379746832,8
556,512,0,0,379,0.0,0.0,1.0,379,10700,7400,3300,0.6915887850467289,140,74,66,206.5672717445171,0.4398156873420726,0.8757344477696509,0.12932152726862547,17130401.234567784,621216.0493827098,17751617.283950493,555,1,357.3377308707124,86,293,74,35.975950782997714,0.6168846899224807,41.31944444444442,132444.4444444435,1540.0516795865524,0
557,512,0,1,378,0.0,0.002638522427440633,0.9973614775725593,379,10100,7400,2700,0.7326732673267327,128,74,54,185.60143798403135,0.43990817523139425,0.8654019881963624,0.11682094405813649,17155678.49427728,550923.719625913,17706602.213903192,556,2,358.3377308707124,90,289,70,36.32397376372614,0.6174768518518519,41.128663003662986,132542.12454212364,1472.6902726902626,8
558,512,0,2,376,0.0,0.005291005291005291,0.9947089947089947,378,10350,6900,3450,0.6666666666666666,138,69,69,186.17647650370415,0.4396260800714824,0.8672860158940583,0.11775219852651861,17178443.96141104,553694.4337103697,17732138.39512141,557,3,360.16137566137564,90,288,72,36.13418765650317,0.619212962962963,40.956959706959715,132630.03663003698,1473.6670736670776,0
559,512,2,0,378,0.005291005291005291,0.0,1.0,378,10800,7800,3000,0.7222222222222222,138,78,60,186.23142806756755,0.4393054795353646,0.8671425585227528,0.11822965905657598,17196020.82390217,554087.9030229846,17750108.726925157,558,0,361.1296296296296,93,285,76,35.997805142238164,0.6196236559139785,40.824468085106375,132697.87234042518,1426.8588423701633,0
560,512,1,0,379,0.002638522427440633,0.0,1.0,379,11000,7100,3900,0.6454545454545455,149,71,78,183.81121568945338,0.43936342738013806,0.8668091202995887,0.1173999111173329,17224229.21006951,546401.3020833366,17770630.512152847,559,0,361.17414248021106,79,300,79,35.844136422201025,0.6267141350210971,40.61197916666668,132806.66666666718,1681.0970464135087,0
561,512,2,0,381,0.005249343832020997,0.0,1.0,381,10000,7300,2700,0.73,127,73,54,179.89783977076135,0.4396374384123037,0.8663421567011957,0.11585017748822975,17262523.225431852,534898.1274495568,17797421.35288141,560,0,360.2729658792651,82,299,81,35.652276352037106,0.6284298780487805,40.32379518072289,132954.2168674699,1621.3928886276817,0
562,512,0,0,381,0.0,0.0,1.0,381,11600,8000,3600,0.6896551724137931,152,80,72,180.2105042429442,0.4394492218078003,0.866564747149005,0.11632879606708639,17273589.419564124,534776.4518770479,17808365.87144117,561,1,361.2729658792651,83,298,74,35.5594377078659,0.628890562248996,40.2405753968254,132996.8253968254,1602.3713903231978,0
563,512,2,0,383,0.005221932114882507,0.0,1.0,383,11150,8000,3150,0.7174887892376681,143,80,63,178.71973970195788,0.43998252520972025,0.865617560969185,0.11576117562258702,17289400.047693238,530241.4152253522,17819641.46291859,562,0,360.38120104438644,88,295,67,35.47718504173419,0.6283143939393939,40.121722846441955,133057.6779026221,1512.019067075251,0
564,512,0,2,381,0.0,0.005221932114882507,0.9947780678851175,383,11950,8600,3350,0.7196652719665272,153,86,67,179.42300598936157,0.43984895811973995,0.8657193094389284,0.11673169279183254,17309820.547154024,532606.0071413603,17842426.554295383,563,1,361.38120104438644,91,292,71,35.30273012279024,0.6288919413919414,39.96829710144929,133136.23188405848,1463.035515209434,0
565,512,1,1,381,0.002617801047120419,0.002617801047120419,0.9973821989528796,382,10600,7500,3100,0.7075471698113207,137,75,62,177.72781405705157,0.43963870108513925,0.8644851915355727,0.11614715780115085,17330422.930132393,529019.6368113279,17859442.56694372,564,0,363.14921465968587,94,288,75,35.18936041693004,0.629543439716312,39.813596491228076,133215.43859649156,1417.1855169839528,0
566,512,0,0,381,0.0,0.0,1.0,381,12150,8200,3950,0.6748971193415638,161,82,79,173.0968497843308,0.4393421628217526,0.8608356728518178,0.11353517785066786,17347225.00000009,512200.0000000041,17859425.000000093,565,1,365.08923884514434,99,282,79,35.18157262905163,0.6294191919191919,39.687500000000014,133280.0000000007,1346.2626262626334,0
567,512,2,0,383,0.005221932114882507,0.0,1.0,383,11900,8500,3400,0.7142857142857143,153,85,68,172.78907409412923,0.43973788953745346,0.8605437238484592,0.11399838667535309,17374033.41145353,511908.6292891007,17885942.040742632,566,0,364.177545691906,85,298,85,34.985044324592394,0.6357843137254902,39.48643410852711,133382.9457364333,1569.2111263109798,0
568,512,0,1,382,0.0,0.0026109660574412533,0.9973890339425587,383,11400,8400,3000,0.7368421052631579,144,84,60,172.2220862934181,0.43969403168701215,0.8601193491975552,0.11421844303583846,17397848.277329963,511258.74546762026,17909107.022797585,567,1,365.177545691906,86,297,86,34.81825732175937,0.6372335271317829,39.30795019157087,133474.32950191505,1552.0270872315705,0
569,512,1,1,382,0.0026109660574412533,0.0026109660574412533,0.9973890339425587,383,10750,7100,3650,0.6604651162790698,144,71,73,170.0700179823527,0.4395260048573993,0.858868289960139,0.11355061819715981,17428380.448606767,505458.9952595675,17933839.443866335,568,0,366.15143603133157,92,291,68,34.64182227945912,0.6375679347826086,39.079301075268816,133591.3978494623,1452.0804114071987,0
570,512,0,1,381,0.0,0.002617801047120419,0.9973821989528796,382,13350,10200,3150,0.7640449438202247,165,102,63,165.96135598806808,0.43935112659346903,0.8551453683568762,0.11135979218585851,17450926.046489157,489485.8699845663,17940411.916473724,569,3,368.10994764397907,95,287,75,34.577515030615366,0.6383771929824562,38.91059027777777,133677.77777777746,1407.1345029239733,0
571,512,0,0,381,0.0,0.0,1.0,381,11300,8100,3200,0.7168141592920354,145,81,64,169.89635191956077,0.43850094396095224,0.85832101099265,0.11442046720808972,17467566.32074593,506035.15896154183,17973601.479707472,570,4,370.0236220472441,97,284,76,34.34821125805359,0.6390678694158076,38.786139455782305,133741.49659863903,1378.7783154498868,0
572,512,2,1,382,0.005221932114882507,0.0026109660574412533,0.9973890339425587,383,10550,7400,3150,0.7014218009478673,137,74,63,164.29760587108927,0.43877956702618715,0.8540514600657461,0.11112446157595163,17486872.226331398,487460.24819197983,17974332.474523377,571,0,369.08616187989554,103,280,80,34.347774711938875,0.6389563106796117,38.64182692307693,133815.3846153849,1299.1784914115037,0
573,512,0,0,382,0.0,0.0,1.0,382,11250,8400,2850,0.7466666666666667,141,84,57,165.20304697902637,0.4381764942994691,0.854651132834725,0.11223393248918984,17506840.484429102,490786.67820069374,17997627.162629794,572,1,371.0392670157068,84,298,84,34.172465907493304,0.6462053571428572,38.492647058823536,133891.76470588264,1593.9495798319363,0
574,512,0,0,382,0.0,0.0,1.0,382,11400,8400,3000,0.7368421052631579,144,84,60,206.9801419101329,0.4381315473654798,0.8831519329989168,0.13237639518889593,17230520.257182203,625475.1056033983,17855995.3627856,573,2,372.0392670157068,68,314,68,35.19481621569201,0.6325061274509804,40.56461352657005,132830.91787439617,1953.3958510940613,8
575,512,2,0,384,0.005208333333333333,0.0,1.0,384,11300,7900,3400,0.6991150442477876,147,79,68,201.98865235446806,0.4386703451370757,0.8802097081441602,0.12987335549553017,17255278.739612117,608974.0997229884,17864252.839335106,574,0,371.0963541666667,75,309,75,35.13422553056702,0.6308333333333334,40.3782894736842,132926.31578947316,1772.3508771929753,0
576,512,2,1,385,0.0051813471502590676,0.0025906735751295338,0.9974093264248705,386,9300,6100,3200,0.6559139784946236,125,61,64,198.086048201006,0.43914090011887935,0.8774638879589898,0.12800555617266016,17278579.332015816,598029.0996813158,17876608.43169713,575,0,370.1683937823834,78,308,63,35.05684413541085,0.6312767094017093,40.203059071729946,133016.03375527376,1705.3337660932534,0
577,512,1,1,385,0.0025906735751295338,0.0025906735751295338,0.9974093264248705,386,10500,7400,3100,0.7047619047619048,136,74,62,194.94329603116532,0.43923748962609066,0.875661088948908,0.1264720901518611,17296807.621124964,586679.3376958151,17883486.95882078,576,0,371.1658031088083,81,305,64,34.99881894894603,0.6314300411522633,40.0660569105691,133086.17886178842,1643.0392452072645,0
578,512,0,0,385,0.0,0.0,1.0,385,10850,7700,3150,0.7096774193548387,140,77,63,197.6836492053333,0.43912196744227994,0.8776281196896087,0.12761304027799716,17273772.67184883,595098.4834628884,17868871.15531172,577,1,373.1246753246753,80,305,73,35.10415119560376,0.630078125,40.2391975308642,132997.53086419773,1662.4691358024716,8
579,512,2,1,386,0.00516795865633075,0.002583979328165375,0.9974160206718347,387,11250,8300,2950,0.7377777777777778,142,83,59,191.90472527751757,0.43980700486002333,0.8755398558496692,0.12490196968242169,17311657.234920245,575787.7651531846,17887445.00007343,578,0,372.19121447028425,86,301,67,34.96410592875669,0.6306928294573644,39.95450191570882,133143.29501915732,1548.1778490599688,0
580,512,0,1,385,0.0,0.0025906735751295338,0.9974093264248705,386,11300,8200,3100,0.7256637168141593,144,82,62,191.83187461462543,0.4395756229953121,0.8744399781765233,0.12531789332932775,17328718.827160507,576340.1234567912,17905058.9506173,579,1,374.0025906735751,89,297,71,34.8354297344188,0.6309691011235955,39.82638888888889,133208.888888889,1496.7290886392022,0
581,512,2,0,387,0.00516795865633075,0.0,1.0,387,10150,7100,3050,0.6995073891625616,132,71,61,194.126574525224,0.43975624015387843,0.8774569621517643,0.1275520099246261,17355263.650354024,586273.5764850752,17941537.2268391,580,0,373.86821705426354,94,293,73,34.57266486987282,0.631427304964539,39.62719298245615,133310.877192983,1418.2008212019468,0
582,512,0,0,387,0.0,0.0,1.0,387,11300,7700,3600,0.6814159292035398,149,77,72,196.702098624275,0.4396669835276896,0.8789396100362319,0.12977149561095386,17373905.865266167,594796.7489996884,17968702.614265855,581,1,374.86821705426354,75,312,75,34.36305264727031,0.6398611111111111,39.48739035087718,133382.45614035032,1778.4327485380043,0
583,512,1,0,388,0.002577319587628866,0.0,1.0,388,10500,7500,3000,0.7142857142857143,135,75,60,197.76734471405672,0.4399438472877097,0.8805544018580989,0.13177606535797198,17419176.458544776,600888.8550624024,18020065.31360718,582,0,374.89948453608247,78,310,62,33.98941009958046,0.6419604700854701,39.14820675105486,133556.11814346013,1712.2579249161556,0
584,512,2,0,390,0.005128205128205128,0.0,1.0,390,11400,8400,3000,0.7368421052631579,144,84,60,191.6176973383072,0.44051960428888454,0.8767107114790644,0.12814091008848655,17435595.59240361,578793.7358276629,18014389.32823127,583,0,373.9717948717949,83,307,66,34.024560465668785,0.6411897590361446,39.02529761904761,133619.04761904746,1609.8680436029815,0
585,512,0,0,390,0.0,0.0,1.0,390,11400,7600,3800,0.6666666666666666,152,76,76,189.78972260180842,0.4402672038758157,0.8757794586366012,0.1275519457386218,17458145.544137966,573275.3199927877,18031420.864130754,584,1,374.9717948717949,85,305,70,33.900355596784166,0.642156862745098,38.85658914728682,133705.42635658907,1573.0050159598713,0
586,512,0,0,390,0.0,0.0,1.0,390,10450,7800,2650,0.7464114832535885,131,78,53,190.6005966380487,0.44027805242458196,0.8770032410182906,0.12871593831037723,17479915.414720345,577886.4614456636,18057801.87616601,585,2,375.9717948717949,88,302,71,33.713308847681326,0.6427556818181819,38.6938202247191,133788.76404494367,1520.3268641470872,0
587,512,0,0,390,0.0,0.0,1.0,390,11300,7500,3800,0.6637168141592921,151,75,76,192.95119325483626,0.44000670138202275,0.8789301270824919,0.1308493246419375,17498745.454789378,585980.7631928495,18084726.21798223,586,3,376.9717948717949,90,300,73,33.50846468184471,0.6435185185185186,38.55311355311355,133860.80586080562,1487.3422873422846,0
588,512,0,0,390,0.0,0.0,1.0,390,10400,6700,3700,0.6442307692307693,141,67,74,191.77839276419377,0.43981554720629273,0.8781945804898177,0.13047084025380096,17513123.70152358,583327.7431517411,18096451.44467532,587,4,377.9717948717949,75,315,75,33.429677810966126,0.6504166666666666,38.445723684210535,133915.78947368448,1785.5438596491263,0
589,512,0,0,390,0.0,0.0,1.0,390,11650,8500,3150,0.7296137339055794,148,85,63,191.6434523771271,0.4396621569661416,0.8777452547796876,0.13079631813261836,17527452.821348995,582154.3140121101,18109607.135361105,588,5,378.9717948717949,76,314,76,33.32417795470997,0.6510416666666667,38.3387445887446,133970.5627705633,1762.7705627705698,0
590,512,0,0,390,0.0,0.0,1.0,390,10350,7900,2450,0.7632850241545893,128,79,49,192.48148093850847,0.4397034913101751,0.8787431815651789,0.13168782507773227,17538328.741965137,586810.6978879723,18125139.43985311,589,6,379.9717948717949,76,314,73,33.21951881331407,0.6518640350877193,38.257575757575765,134012.12121212145,1763.317384370019,0
591,512,1,2,389,0.0025575447570332483,0.005115089514066497,0.9948849104859335,391,11300,8300,3000,0.7345132743362832,143,83,60,189.55164022407416,0.4397485080988917,0.876684348651922,0.13036535959533294,17561753.62969263,576271.8411438657,18138025.470836494,590,0,379.99744245524295,83,308,60,33.118154522355326,0.6507279116465863,38.082837301587304,134101.5873015874,1615.6817747179205,0
592,512,0,1,388,0.0,0.002570694087403599,0.9974293059125964,389,11400,8400,3000,0.7368421052631579,144,84,60,190.60538175815,0.439061409553088,0.8766076456207661,0.13155339808756572,17577467.281814784,580871.9723183438,18158339.254133128,591,8,382.9151670951157,84,305,62,32.971171234371596,0.6515376984126984,37.96568627450982,134161.56862745175,1597.1615312791876,0
593,512,0,0,388,0.0,0.0,1.0,388,10100,6400,3700,0.6336633663366337,138,64,74,191.16669129524183,0.43887815005727376,0.8763452095599358,0.13257176619253663,17598660.611799873,585155.5440771381,18183816.155877013,592,9,384.7912371134021,87,301,65,32.79552294958617,0.6520593869731801,37.80776515151516,134242.4242424247,1543.0163706025826,0
594,512,1,0,389,0.002570694087403599,0.0,1.0,389,11600,8100,3500,0.6982758620689655,151,81,70,188.05044106381587,0.43901696348907676,0.8745267832663279,0.13105958764162054,17620643.610733904,573313.9605653654,18193957.57129927,593,0,384.7994858611825,93,296,69,32.7104452657515,0.6517697132616487,37.64406028368795,134326.24113475208,1444.368184244646,0
595,512,0,0,389,0.0,0.0,1.0,389,11250,8100,3150,0.72,144,81,63,186.25434902794166,0.43887534342176165,0.8736478661323435,0.13020929745747328,17634286.177055936,567842.4984960003,18202128.675551936,594,1,385.7994858611825,97,292,72,32.654132242561694,0.6516323024054983,37.54251700680273,134378.23129251762,1385.3425906445116,0
596,512,0,0,389,0.0,0.0,1.0,389,11050,7600,3450,0.6877828054298643,145,76,69,182.3429838001046,0.4388270324826191,0.8712405767370006,0.12811524952990944,17656367.431269858,555052.9440977406,18211420.375367597,595,2,386.7994858611825,76,313,76,32.58952334346399,0.6607730263157895,37.37824675324672,134462.33766233636,1769.2412850307417,0
597,512,0,0,389,0.0,0.0,1.0,389,11000,7600,3400,0.6909090909090909,144,76,68,182.78292346166472,0.43868596454032277,0.8705411499551172,0.12917683918593154,17682024.99999982,557594.4444444345,18239619.444444254,596,3,387.7994858611825,79,310,74,32.38373629277314,0.6613924050632911,37.187499999999964,134559.9999999986,1703.2911392404887,0
598,512,0,0,389,0.0,0.0,1.0,389,10800,7500,3300,0.6944444444444444,141,75,66,183.71334281386504,0.43850376328412793,0.870639081944554,0.1301271016563058,17691889.955799185,561447.2488949735,18253337.20469416,597,4,388.7994858611825,80,309,75,32.28463457587316,0.66171875,37.11419753086415,134597.5308641957,1682.469135802446,0
599,512,0,0,389,0.0,0.0,1.0,389,10650,7600,3050,0.7136150234741784,137,76,61,181.93861603927297,0.4382994770271822,0.8695900052544556,0.12943150533811296,17710894.6174546,556009.1311034113,18266903.74855801,598,5,389.7994858611825,84,305,65,32.18756309307488,0.6615823412698413,36.973039215686235,134669.8039215669,1603.211951447225,0
600,512,0,1,388,0.0,0.002570694087403599,0.9974293059125964,389,10550,7500,3050,0.7109004739336493,136,75,61,182.61735984210213,0.43807614245708887,0.8704788705836779,0.13034692163851386,17725390.444943387,559042.8010451904,18284433.245988578,599,6,390.7994858611825,86,303,65,32.06012725425061,0.6619428294573644,36.865421455938666,134724.90421455808,1566.568653657652,0
601,512,0,0,388,0.0,0.0,1.0,388,10300,7400,2900,0.7184466019417476,132,74,58,181.15914049658267,0.43757284091211807,0.8688457872158983,0.12968080904082172,17737985.15563771,554779.628987292,18292764.784625005,600,7,392.52061855670104,92,296,67,32.00333673744379,0.6608922101449275,36.77195340501791,134772.75985663035,1464.9213027894602,0
602,512,0,0,388,0.0,0.0,1.0,388,10550,8000,2550,0.7582938388625592,131,80,51,182.41633671661316,0.43729174436363955,0.8707202267971832,0.13122492406417796,17759350.133293003,559769.1187565974,18319119.2520496,601,8,393.52061855670104,93,295,71,31.808874677437412,0.6621863799283154,36.61347517730495,134853.90070921916,1450.0419431098835,0
603,512,0,0,388,0.0,0.0,1.0,388,10550,7500,3050,0.7109004739336493,136,75,61,179.92614012128186,0.4369303146949395,0.8693199425064388,0.12997282090973883,17777349.657600172,551571.9810956733,18328921.638695844,602,9,394.52061855670104,95,293,75,31.73862170248976,0.662938596491228,36.4800347222222,134922.22222222117,1420.2339181286438,0
604,512,0,1,387,0.0,0.002577319587628866,0.9974226804123711,388,11200,7400,3800,0.6607142857142857,150,74,76,180.02275542040232,0.43664241966132994,0.8687557886900901,0.1305019953095915,17792578.515625037,551813.8020833351,18344392.317708373,603,10,395.52061855670104,79,309,79,31.62119696745198,0.6696993670886076,36.36718750000001,134980.0000000003,1708.6075949367125,0
605,512,0,0,387,0.0,0.0,1.0,387,12050,8900,3150,0.7385892116182573,152,89,63,180.6419957585704,0.4361921114993774,0.868450884864886,0.13147506504642625,17809789.327507723,553989.1776321391,18363778.50513986,604,11,397.43669250645996,80,307,80,31.475093450349434,0.6705729166666667,36.23971193415639,135045.2674897124,1688.0658436214048,0
606,512,0,0,387,0.0,0.0,1.0,387,10200,7100,3100,0.696078431372549,133,71,62,180.7795237828347,0.43588584970076716,0.8673037899618408,0.1319535481141467,17822134.39310911,556775.3936759895,18378909.7867851,605,12,398.43669250645996,83,304,81,31.378415268443224,0.6703062248995983,36.148313492063494,135092.0634920636,1627.6152227959471,0
607,512,0,0,387,0.0,0.0,1.0,387,10350,7100,3250,0.6859903381642513,136,71,65,213.52515047482407,0.435753638323225,0.8828375599809015,0.14276351897523862,17434718.377546985,656800.1730103749,18091518.55055736,606,13,399.43669250645996,84,303,59,33.4595366674493,0.6407490079365079,39.03186274509802,133615.68627450892,1590.6629318393918,8
608,512,0,1,386,0.0,0.002583979328165375,0.9974160206718347,387,10200,6500,3700,0.6372549019607843,139,65,74,211.05808131944917,0.4355059511855512,0.8816068074521863,0.14154725080912794,17448611.847549967,648934.1076463345,18097545.955196302,607,14,400.43669250645996,88,299,61,33.41776502585256,0.6403882575757576,38.92790262172282,133668.91385767676,1518.9649302008722,0
609,512,0,1,385,0.0,0.0025906735751295338,0.9974093264248705,386,10950,8000,2950,0.730593607305936,139,80,59,209.35121565042905,0.43544638651503936,0.8805795811324044,0.14079729724029455,17461315.020361852,642959.5052735631,18104274.525635414,608,15,402.3238341968912,92,294,63,33.36532000972108,0.6400588768115942,38.83288530465947,133717.56272401306,1453.4517687392724,0
610,512,0,0,385,0.0,0.0,1.0,385,11650,8800,2850,0.7553648068669528,145,88,57,211.59612051750747,0.4350536616161616,0.8812953959700096,0.14278138219268266,17476340.96294021,650935.189719866,18127276.152660076,609,16,403.82337662337665,98,287,65,33.19196668277489,0.6394557823129252,38.720538720538705,133775.08417508352,1365.051879337587,0
611,512,2,1,386,0.00516795865633075,0.002583979328165375,0.9974160206718347,387,12150,9000,3150,0.7407407407407407,153,90,63,213.77499240149177,0.4351980158251998,0.8829169440855971,0.1452053562175597,17506008.840516366,658919.3813723713,18164928.221888736,610,0,402.7312661498708,72,315,72,32.908617992651614,0.6513310185185186,38.49885844748861,133888.5844748867,1859.5636732623154,0
612,512,1,0,387,0.002583979328165375,0.0,1.0,387,10550,7300,3250,0.6919431279620853,138,73,65,213.8308684753298,0.4351427882877455,0.881015112979292,0.14593919047458867,17527452.821348995,661632.0917898879,18189084.91313888,611,0,403.4935400516796,76,311,76,32.743619239651196,0.6510416666666667,38.3387445887446,133970.5627705633,1762.7705627705698,0
613,512,0,0,387,0.0,0.0,1.0,387,11150,8100,3050,0.726457399103139,142,81,61,210.1214611640221,0.43488617548745273,0.8789148597638285,0.14404746742669647,17547371.91840284,648865.8854166698,18196237.803819507,612,1,404.4935400516796,79,308,73,32.68891638069663,0.6512394514767932,38.19010416666668,134046.66666666715,1696.793248945154,0
614,512,0,0,387,0.0,0.0,1.0,387,11900,8600,3300,0.7226890756302521,152,86,66,208.49060705350334,0.4344730846643728,0.878491325946132,0.14365859636700357,17570069.444444522,643338.8888888931,18213408.333333414,613,2,405.4935400516796,83,304,64,32.55881378396291,0.651355421686747,38.02083333333335,134133.33333333395,1616.06425702812,0
615,512,1,1,387,0.002577319587628866,0.002577319587628866,0.9974226804123711,388,10250,6600,3650,0.6439024390243903,139,66,73,207.71575147072213,0.43441376523970626,0.8789720684327296,0.1439104583109412,17594411.51510061,643077.281908854,18237488.797009464,614,0,405.4458762886598,88,300,66,32.3939312766939,0.6513967803030303,37.83941947565545,134226.21722846522,1525.297923050741,0
616,512,0,0,387,0.0,0.0,1.0,387,11750,9000,2750,0.7659574468085106,145,90,55,209.7826107234515,0.43407840302044426,0.8793554098763685,0.1459007839415236,17611409.44360954,649763.490320017,18261172.933929555,615,1,407.4857881136951,92,295,68,32.210484548262684,0.6513813405797102,37.71281362007171,134291.0394265243,1459.685211157873,0
617,512,1,0,388,0.002577319587628866,0.0,1.0,388,9600,6000,3600,0.625,132,60,72,209.39273608305564,0.4343024920749088,0.8827571276805171,0.137260610487978,17344508.801984966,639162.8308128585,17983671.632797826,616,0,407.4329896907216,91,297,70,34.25755252512072,0.6315247252747253,39.70788043478262,133269.565217392,1464.5007166746373,8
618,512,0,0,388,0.0,0.0,1.0,388,11250,8100,3150,0.72,144,81,63,209.59999999999926,0.4343880974897218,0.882515463917525,0.13789473684210524,17361111.11111117,638927.7777777802,18000038.88888895,617,1,408.4329896907216,94,294,75,34.12500000000002,0.6318705673758865,39.58333333333334,133333.3333333338,1418.4397163120618,0
619,512,1,0,389,0.002570694087403599,0.0,1.0,389,11500,8500,3000,0.7391304347826086,145,85,60,208.06076570280337,0.4346325387150063,0.8814248001406015,0.137462012405653,17380455.455856357,633938.1740817846,18014393.62993814,618,0,408.38046272493574,78,311,78,34.01702427340044,0.6390224358974359,39.43829113924049,133407.59493670828,1710.3537812398497,0
620,512,1,0,390,0.002564102564102564,0.0,1.0,390,10200,7000,3200,0.6862745098039216,134,70,64,204.10345779231983,0.4346233493727067,0.8799420182959945,0.13550953709659808,17402802.777777717,622194.4444444412,18024997.222222157,619,0,408.33076923076925,79,311,78,33.949260886935676,0.640295358649789,39.27083333333332,133493.33333333285,1689.7890295358588,0
621,512,1,0,391,0.0025575447570332483,0.0,1.0,391,11100,8100,3000,0.7297297297297297,141,81,60,204.08403460505838,0.4347134784794631,0.8807917834760897,0.13594208452855142,17417741.57902755,621636.595031243,18039378.17405879,620,0,408.2838874680307,80,311,63,33.835601242419756,0.641015625,39.15895061728394,133550.61728395033,1669.382716049379,0
622,512,1,0,392,0.002551020408163265,0.0,1.0,392,10700,7800,2900,0.7289719626168224,136,78,58,200.60903964312848,0.43479837587208797,0.8787336173001308,0.13431440614926846,17441024.060128216,610665.4174190001,18051689.477547217,621,0,408.23979591836735,86,306,66,33.74847094801222,0.6405038759689923,38.9846743295019,133639.84674329436,1553.9517063173762,0
623,512,0,0,392,0.0,0.0,1.0,392,11300,8000,3300,0.7079646017699115,146,80,66,198.79889529107018,0.4347323168397794,0.8778884903796504,0.13385792282931983,17466634.958382778,604769.5468357725,18071404.50521855,622,1,409.23979591836735,86,306,70,33.60033920058669,0.6424418604651163,38.79310344827584,133737.93103448197,1555.0922213311858,0
624,512,0,0,392,0.0,0.0,1.0,392,10400,7200,3200,0.6923076923076923,136,72,64,197.09636648842192,0.43466381117664454,0.8774712451553848,0.13329692653032066,17486489.286049634,600504.700183817,18086993.98623345,623,2,410.23979591836735,90,302,73,33.49347042163045,0.6425925925925926,38.64468864468863,133813.91941391872,1486.821326821319,0
625,512,0,0,392,0.0,0.0,1.0,392,11250,8600,2650,0.7644444444444445,139,86,53,195.9562767050422,0.43464953916349147,0.8769973570063292,0.13314419883546721,17507429.50544247,596488.1401125069,18103917.64555498,624,3,411.23979591836735,77,315,77,33.363760936914865,0.6490800865800865,38.48824786324789,133894.01709401823,1738.8833388833536,0
626,512,2,0,394,0.005076142131979695,0.0,1.0,394,11000,8000,3000,0.7272727272727273,140,80,60,194.98288572600978,0.43497538350921156,0.8767991413520699,0.1330356067398198,17526110.349032316,593658.3142813671,18119768.663313683,625,0,410.1472081218274,80,314,80,33.24701415511649,0.64921875,38.348765432098794,133965.43209876664,1674.5679012345831,0
627,512,0,0,394,0.0,0.0,1.0,394,10500,7400,3100,0.7047619047619048,136,74,62,199.41092797586757,0.43477437215570275,0.8790869249929048,0.1366176995919785,17544519.79641763,610413.7946989303,18154933.591116562,626,1,411.1472081218274,81,313,80,32.99103099120084,0.6502057613168724,38.211382113821166,134035.77235772478,1654.762621700306,0
628,512,1,1,394,0.002531645569620253,0.002531645569620253,0.9974683544303797,395,10500,7100,3400,0.6761904761904762,139,71,68,195.40496711728736,0.43478335368073845,0.8773716265745801,0.1346669048044296,17570891.349481132,597187.8892733642,18168079.238754496,627,0,411.10379746835446,84,311,65,32.89538310412576,0.6510416666666667,38.01470588235297,134136.47058823655,1596.8627450980541,0
629,512,0,0,394,0.0,0.0,1.0,394,11450,8300,3150,0.7248908296943232,146,83,63,194.87553780192732,0.43438122946831825,0.8771701692313252,0.13471938935968486,17584694.57965281,595115.3626585016,18179809.94231131,628,3,413.1472081218274,85,309,68,32.80436423575813,0.6517156862745098,37.911821705426384,134189.14728682282,1578.6958504332097,0
630,512,0,1,393,0.0,0.0025380710659898475,0.9974619289340102,394,11850,8100,3750,0.6835443037974683,156,81,75,196.97290778081256,0.4343061529386945,0.8779436054499425,0.13640281475027846,17592305.01033071,602391.4944903648,18194696.504821077,629,4,414.1472081218274,87,307,68,32.691569583672035,0.6515804597701149,37.85511363636366,134218.18181818284,1542.7377220480787,0
631,512,0,0,393,0.0,0.0,1.0,393,10350,6700,3650,0.6473429951690821,140,67,73,172.13532314607082,0.43404373517854977,0.8625824441754166,0.1144262266743879,17408424.626527794,510370.95971027424,17918795.586238068,630,5,416.19083969465646,93,300,82,34.739928607853145,0.635752688172043,39.22872340425531,133514.89361702092,1435.6440173873218,8
632,512,1,1,393,0.0025380710659898475,0.0025380710659898475,0.9974619289340102,394,12150,8900,3250,0.7325102880658436,154,89,65,171.1158729548895,0.43416084352651946,0.8613615128913656,0.11419821146141163,17426365.056226578,505435.5338053589,17931800.590031937,631,0,416.1319796954315,97,297,68,34.62987859529047,0.6359536082474226,39.09438775510204,133583.6734693878,1377.1512728802868,0
633,512,0,1,392,0.0,0.002544529262086514,0.9974554707379135,393,10900,8100,2800,0.7431192660550459,137,81,56,172.7583225229389,0.4336764444963736,0.862000894174735,0.11572175365149201,17443152.24999996,513189.94444444275,17956342.194444403,632,7,418.19083969465646,99,294,72,34.45921791239343,0.6366792929292929,38.96874999999999,133647.99999999968,1349.9797979797947,0
634,512,0,0,392,0.0,0.0,1.0,392,10700,7500,3200,0.7009345794392523,139,75,64,173.28246165239156,0.4335478756720079,0.8622986698101085,0.11645218993201836,17457923.26135245,515930.3836131393,17973853.64496559,633,8,419.9311224489796,101,291,74,34.33312313427973,0.637273102310231,38.858251633986924,133704.57516339852,1323.8076748851338,0
635,512,0,0,392,0.0,0.0,1.0,392,10350,7700,2650,0.7439613526570048,130,77,53,173.7727706474417,0.43328812503262176,0.8625190658064832,0.11708763041679737,17469746.132527106,518403.23759133357,17988149.37011844,634,9,420.9311224489796,104,288,77,34.23037242392021,0.6374198717948718,38.76984126984127,133749.84126984142,1286.0561660561675,0
636,512,0,0,392,0.0,0.0,1.0,392,11750,8500,3250,0.723404255319149,150,85,65,174.46730617478303,0.43337824260138835,0.8634772819203287,0.11776875358926898,17477921.19081523,519715.1655393381,17997636.35635457,635,10,421.9311224489796,105,287,78,34.15004795216068,0.6377976190476191,38.70872641509434,133781.13207547166,1274.1060197663967,0
637,512,0,0,392,0.0,0.0,1.0,392,11200,7800,3400,0.6964285714285714,146,78,68,175.826462583768,0.43330688253562294,0.8646591093900398,0.11917697310604926,17496509.211914673,525669.8644590556,18022179.07637373,636,11,422.9311224489796,110,282,83,33.973185440448,0.6380681818181818,38.56981981981983,133852.25225225269,1216.8386568386609,0
638,512,0,0,392,0.0,0.0,1.0,392,10800,7900,2900,0.7314814814814815,137,79,58,174.81512136256956,0.4330200830332133,0.864089253919168,0.11889433779859639,17511763.32179928,523064.2060745857,18034827.527873863,637,12,423.9311224489796,84,308,84,33.88369568612753,0.6465773809523809,38.455882352941174,133910.5882352939,1594.1736694677845,0
639,512,1,1,392,0.002544529262086514,0.002544529262086514,0.9974554707379135,393,11200,7900,3300,0.7053571428571429,145,79,66,178.2147308539996,0.43308439788128994,0.8665200012105714,0.12189530714857434,17537161.81500567,535276.114560856,18072437.92956653,638,0,423.8498727735369,86,307,86,33.601803141201586,0.6477713178294573,38.26628352490422,134007.66283524918,1558.2286376191767,0
640,512,0,0,392,0.0,0.0,1.0,392,10350,7200,3150,0.6956521739130435,135,72,63,178.6519337016574,0.4328749162708561,0.8668863456985003,0.12267071320182096,17554548.18244171,538480.7956104259,18093028.978052136,639,1,425.7142857142857,89,303,79,33.45833333333333,0.6480571161048689,38.136574074074076,134074.07407407416,1506.4502704952154,0
641,512,1,0,393,0.002544529262086514,0.0,1.0,393,11400,8100,3300,0.7105263157894737,147,81,66,178.0112221981848,0.4329689095740077,0.8663581711122723,0.12275838829511138,17573746.53739605,535664.8199445955,18109411.357340645,640,0,425.62849872773535,94,299,67,33.329409918392955,0.647938829787234,37.99342105263157,134147.3684210521,1427.0996640537455,0
642,512,0,1,392,0.0,0.002544529262086514,0.9974554707379135,393,10900,7900,3000,0.7247706422018348,139,79,60,179.86240630863708,0.43283665247269393,0.8666292801668711,0.12438568964875438,17586303.5517917,543122.9749798747,18129426.526771575,641,1,426.62849872773535,98,295,69,33.185634952495654,0.6477465986394557,37.89983164983164,134195.28619528568,1369.3396550539355,0
643,512,0,0,392,0.0,0.0,1.0,392,11850,8000,3850,0.6751054852320675,157,80,77,178.7289945126454,0.4324678240861562,0.8651457593557366,0.12383566882514803,17594695.792390943,538686.4575459779,18133382.24993692,642,2,428.7091836734694,104,288,69,33.15169403869925,0.6468349358974359,37.837301587301575,134227.3015873009,1290.647130647124,0
644,512,0,0,392,0.0,0.0,1.0,392,11400,8700,2700,0.7631578947368421,141,87,54,176.37958019160985,0.43224626807244637,0.863530540851281,0.12253692252197733,17606621.30946683,531289.6950312749,18137911.004498105,643,3,429.7091836734694,108,284,73,33.12288948813251,0.6467978395061729,37.748470948012205,134272.7828746162,1243.2665080982983,0
645,512,0,0,392,0.0,0.0,1.0,392,10950,7600,3350,0.6940639269406392,143,76,67,174.1949714923547,0.4320203624928232,0.8622558488946133,0.12131156534871024,17617304.601898994,524419.1745799781,18141723.776478972,644,4,430.7091836734694,110,282,77,33.099243399871185,0.647159090909091,37.66891891891889,134313.51351351198,1221.031941031927,0
646,512,2,0,394,0.005076142131979695,0.0,1.0,394,10550,7400,3150,0.7014218009478673,137,74,63,173.92749341964648,0.43248117435837824,0.8613749601327563,0.1214854691004137,17630428.64911795,523933.25257099606,18154361.90168895,645,0,429.51776649746193,116,278,83,33.006867168770036,0.6469109195402298,37.57122507122505,134363.53276353155,1158.306316926996,0
647,512,1,0,395,0.002531645569620253,0.0,1.0,395,11950,8300,3650,0.694560669456067,156,83,73,169.81387963497255,0.4322246674805628,0.8581456610301745,0.11932241557507504,17656743.101501968,508722.0095568239,18165465.11105879,646,0,429.4278481012658,91,304,91,32.91572357548323,0.6551053113553114,37.375452898550755,134463.76811594344,1477.6238254499278,0
648,512,0,0,395,0.0,0.0,1.0,395,12700,9000,3700,0.7086614173228346,164,90,74,170.92655769425735,0.43181129388078565,0.8587798133881923,0.12065552150641892,17676861.341951575,512589.012003702,18189450.353955276,647,1,430.4278481012658,94,301,94,32.73436956672926,0.6556959219858156,37.22587719298249,134540.35087719455,1431.280328480793,0
649,512,1,0,396,0.0025252525252525255,0.0,1.0,396,11000,7500,3500,0.6818181818181818,145,75,70,171.9303102043041,0.4319285950219494,0.8583694598214617,0.12193573924885896,17697446.69444466,518345.5000000088,18215792.194444668,648,0,430.33838383838383,99,297,69,32.552403166805355,0.6558291245791246,37.0729166666667,134618.66666666832,1359.7845117845284,0
650,512,0,0,396,0.0,0.0,1.0,396,11550,8400,3150,0.7272727272727273,147,84,63,175.00498538750298,0.43146509930528915,0.8590443475203573,0.12485254997779718,17723266.346436836,529581.9935954077,18252848.340032242,649,1,431.33838383838383,100,296,78,32.2764777359674,0.6575,36.88118811881191,134716.83168316993,1347.1683168316993,0
651,512,0,0,396,0.0,0.0,1.0,396,11100,8500,2600,0.7657657657657657,137,85,52,175.31066854710417,0.4311190757788859,0.860073408415948,0.12556743820962218,17740520.153475117,531720.4896958261,18272240.64317094,650,2,432.33838383838383,105,291,80,32.13814643372654,0.6575396825396825,36.753144654088075,134782.38993710827,1283.6418089248407,0
652,512,0,0,396,0.0,0.0,1.0,396,12350,8500,3850,0.6882591093117408,162,85,77,169.21540538015097,0.43095472126326556,0.8587161082068036,0.11529067272556805,17519740.550447725,501371.9998798174,18021112.550327543,651,3,433.33838383838383,85,311,85,33.96958051671454,0.646813725490196,38.396317829457374,133941.0852713181,1575.7774737802129,8
653,512,0,1,395,0.0,0.0025252525252525255,0.9974747474747475,396,10450,7600,2850,0.7272727272727273,133,76,57,166.78092129110203,0.430741486595917,0.8570407232953603,0.11433412284280367,17547313.084767744,495661.4084921984,18042974.493259944,652,4,434.33838383838383,88,308,82,33.82406082822957,0.6478456439393939,38.190543071161066,134046.44194756637,1523.2550221314361,0
654,512,0,0,395,0.0,0.0,1.0,395,12350,8400,3950,0.680161943319838,163,84,79,164.42302693837686,0.4305510934052989,0.8546109112275315,0.11300193551586486,17558555.763528384,486056.1774611272,18044611.940989513,653,5,434.79240506329114,90,305,73,33.8005558226613,0.6480324074074074,38.106684981685,134089.37728937803,1489.881969881978,0
655,512,0,0,395,0.0,0.0,1.0,395,12000,8700,3300,0.725,153,87,66,162.63938296134273,0.43030853091734667,0.8532194303878633,0.11212195127759488,17572323.100936644,480590.3572667408,18052913.458203383,654,6,435.79240506329114,92,303,75,33.74294600487365,0.6484375,38.004032258064534,134141.93548387187,1458.064516129042,0
656,512,0,1,394,0.0,0.002531645569620253,0.9974683544303797,395,11500,8400,3100,0.7304347826086957,146,84,62,163.82031583062994,0.42998859474394396,0.8551818259125503,0.11348415295281922,17593844.66409235,485945.83790933207,18079790.502001684,655,7,436.79240506329114,96,299,77,33.54898888524766,0.6488715277777778,37.843642611683855,134224.05498281826,1398.167239404357,0
657,512,0,0,394,0.0,0.0,1.0,394,11950,8400,3550,0.702928870292887,155,84,71,162.2878666088531,0.42937774204242607,0.8532585573980815,0.11276902913927182,17607489.74027601,480746.38925733516,18088236.129533343,656,8,438.6269035532995,98,296,80,33.485874289535275,0.6493409863945578,37.74200336700338,134276.09427609484,1370.1642273070902,0
658,512,0,1,393,0.0,0.0025380710659898475,0.9974619289340102,394,10150,7300,2850,0.7192118226600985,130,73,57,163.428258313735,0.42930656733961065,0.8545121562660907,0.11407695956862515,17627526.95814147,487217.20582949836,18114744.163970966,657,9,439.6269035532995,100,294,83,33.30434697166213,0.6503125000000001,37.592821782178234,134352.4752475256,1343.524752475256,0
659,512,0,0,393,0.0,0.0,1.0,393,11050,8100,2950,0.7330316742081447,140,81,59,166.29457917561587,0.4291431903550224,0.8568331892834378,0.11649220132683669,17643255.964185003,497145.5651703696,18140401.529355373,658,10,441.3562340966921,85,308,85,33.11013964504322,0.6561274509803922,37.475775193798476,134412.40310077643,1581.322389420899,0
660,512,0,0,393,0.0,0.0,1.0,393,12450,8900,3550,0.714859437751004,160,89,71,163.62375344715358,0.4288892242647695,0.8535238126916005,0.11525982632327228,17667703.175945107,487121.18168767286,18154824.35763278,659,11,442.3562340966921,90,303,90,32.995461147421935,0.65625,37.29395604395607,134505.49450549585,1494.5054945055094,0
661,512,0,0,393,0.0,0.0,1.0,393,11850,8500,3350,0.7172995780590717,152,85,67,163.20520207449687,0.42853545680358657,0.8540792646187423,0.11540975191969677,17684643.595110785,486795.1663111078,18171438.761421893,660,12,443.3562340966921,90,303,84,32.87848598347927,0.6575231481481482,37.16804029304032,134569.9633699646,1495.2218152218288,0
662,512,0,0,393,0.0,0.0,1.0,393,11500,8200,3300,0.7130434782608696,148,82,66,163.68976550276304,0.4282476826608506,0.8549245150151257,0.11618888560021161,17701116.67546909,489398.3275489188,18190515.003018007,661,13,444.3562340966921,93,300,74,32.741362538103886,0.6578181003584229,37.0456560283688,134632.62411347555,1447.6626248760813,0
663,512,0,0,393,0.0,0.0,1.0,393,11300,7700,3600,0.6814159292035398,149,77,72,161.63260284914512,0.42818953281057975,0.8542094693527948,0.11523967738271519,17720517.202354066,482942.6638499098,18203459.866203975,662,14,445.3562340966921,93,300,78,32.64906775615648,0.6592741935483871,36.90159574468086,134706.38297872388,1448.4557309540203,0
664,512,0,1,392,0.0,0.002544529262086514,0.9974554707379135,393,11200,8300,2900,0.7410714285714286,141,83,58,162.76485838482589,0.4278920219487286,0.8547345648912488,0.11657126902135995,17740141.72335614,487694.3310657653,18227836.054421905,663,15,446.3562340966921,97,296,81,32.47126436781612,0.6595790378006873,36.7559523809524,134780.9523809534,1389.4943544428183,0
665,512,0,0,392,0.0,0.0,1.0,392,10900,7900,3000,0.7247706422018348,139,79,60,162.96601083966902,0.4275873392835395,0.8552889864334541,0.11708424650478738,17753846.463854477,489354.707054871,18243201.17090935,664,16,448.23724489795916,100,292,82,32.36265045299082,0.6597916666666667,36.65429042904293,134833.00330033133,1348.3300330033132,0
666,512,0,0,392,0.0,0.0,1.0,392,11700,7700,4000,0.6581196581196581,157,77,80,164.44679394208714,0.4274221917027681,0.8567362096260605,0.11864669960047693,17772091.018108424,494412.67791498237,18266503.696023405,665,17,449.23724489795916,102,290,84,32.186152586394414,0.660641339869281,36.519012944983835,134902.26537216912,1322.571229138913,0
667,512,0,0,392,0.0,0.0,1.0,392,11400,8300,3100,0.7280701754385965,145,83,62,165.4622653036335,0.4270475853384832,0.857938508555079,0.11987438944356937,17789972.58554617,498913.83273879683,18288886.418284968,666,18,450.23724489795916,86,306,86,32.02468547031838,0.6667877906976745,36.38649425287354,134970.11494252767,1569.4199411921823,0
668,512,1,0,393,0.002544529262086514,0.0,1.0,393,11000,7800,3200,0.7090909090909091,142,78,64,165.3516976240506,0.4270814400823943,0.8577289689864245,0.1204287142872501,17812728.46811295,499472.9783037412,18312201.44641669,667,0,450.089058524173,90,303,90,31.85626771972457,0.6671296296296296,36.217948717948694,135056.4102564092,1500.626780626769,0
669,512,0,0,393,0.0,0.0,1.0,393,10900,7800,3100,0.7155963302752294,140,78,62,164.25800355305682,0.42700733283135134,0.8570200773905492,0.12000617651434188,17826140.647972926,496117.2547783993,18322257.902751327,668,1,451.089058524173,91,302,85,31.78419720243711,0.6678113553113554,36.11865942028982,135107.24637681016,1484.695015129782,0
670,512,0,0,393,0.0,0.0,1.0,393,11150,8500,2650,0.7623318385650224,138,85,53,162.8393639058718,0.4268518157899292,0.8564454262572774,0.11956949551253568,17847691.092785243,491511.33294752054,18339202.42573276,669,2,452.089058524173,95,298,69,31.659577819785774,0.6682017543859649,35.95920138888885,135188.88888888698,1423.0409356724945,0
671,512,0,1,392,0.0,0.002544529262086514,0.9974554707379135,393,11450,8300,3150,0.7248908296943232,146,83,63,170.85006885753336,0.4266530244413287,0.8620495282350502,0.12607238734352127,17868778.238329563,520526.39848371415,18389304.63681328,670,3,453.089058524173,96,297,72,31.28946156139068,0.6694878472222222,35.80326460481097,135268.7285223355,1409.0492554409948,0
672,512,0,0,392,0.0,0.0,1.0,392,11300,7600,3700,0.672566371681416,150,76,74,170.8271270064829,0.4261090305687492,0.8616960377008529,0.12649753841998695,17883693.021426067,521303.97982321406,18404997.00124928,671,23,455.23724489795916,97,295,75,31.177947129949878,0.6703178694158076,35.693027210884324,135325.17006802576,1395.1048460621212,0
673,512,0,0,392,0.0,0.0,1.0,392,11650,8400,3250,0.721030042918455,149,84,65,167.86001006154376,0.42561236451102175,0.8593473261335098,0.12477047952844202,17899737.016630813,510880.00714212214,18410617.023772936,672,24,456.23724489795916,98,294,79,31.13584815566429,0.6712372448979591,35.57449494949493,135385.8585858575,1381.4883529169133,0
674,512,0,0,392,0.0,0.0,1.0,392,11300,8100,3200,0.7168141592920354,145,81,64,167.67516197688795,0.42523069010212783,0.8591318434010933,0.12489557147079029,17908662.29334852,510867.5701653131,18419529.863513835,673,25,457.23724489795916,101,291,81,31.07371423607085,0.6711014851485149,35.50857843137252,135419.6078431358,1340.788196466691,0
675,512,0,0,392,0.0,0.0,1.0,392,10300,7700,2600,0.7475728155339806,129,77,52,168.7363643409917,0.4249392691859353,0.8604094105463267,0.12645274104915938,17934394.617455,516536.90888120787,18450931.526336204,674,26,458.23724489795916,84,308,84,30.852490199709848,0.6783234126984127,35.31862745098042,135516.86274509938,1613.295985060707,0
676,512,0,0,392,0.0,0.0,1.0,392,10100,7100,3000,0.7029702970297029,131,71,60,168.78342058171006,0.4244426031282078,0.8600666218460733,0.12723809100218145,17959314.455978695,517746.90503653575,18477061.36101523,675,27,459.23724489795916,84,308,83,30.664318542852314,0.6801835317460317,35.13480392156867,135610.98039215858,1614.4164332399832,0
677,512,1,0,393,0.002544529262086514,0.0,1.0,393,11100,8100,3000,0.7297297297297297,141,81,60,168.30392329546865,0.42456909608627164,0.859174306341844,0.1275796061042859,17982516.27809293,515605.60806553706,18498121.886158466,676,0,459.06615776081424,91,302,71,30.503104351788583,0.6794871794871795,34.963768115942045,135698.5507246384,1491.1928651059163,0
678,512,0,0,393,0.0,0.0,1.0,393,10450,6900,3550,0.6602870813397129,140,69,71,168.34063980588985,0.42422560627304357,0.859231651905701,0.12812380382236485,17999421.11032362,516956.8131695091,18516377.92349313,677,1,460.06615776081424,91,302,74,30.375487495907866,0.680746336996337,34.83922101449278,135762.3188405809,1491.8936136327573,0
679,512,0,0,393,0.0,0.0,1.0,393,10550,6900,3650,0.6540284360189573,142,69,73,167.67924743979924,0.4240473702203528,0.8577260856822939,0.12802992491121215,18012800.192394882,514924.5561088532,18527724.748503737,678,2,461.06615776081424,93,300,77,30.292843366615138,0.6811155913978495,34.74069148936172,135812.76595744782,1460.3523221230948,0
680,512,0,0,393,0.0,0.0,1.0,393,10900,7000,3900,0.6422018348623854,148,70,78,169.48500573613438,0.42386805230998253,0.8588751439871705,0.12987607898122686,18027822.78217427,521589.1295293702,18549411.911703642,679,3,462.06615776081424,97,296,78,30.132480173035326,0.6810567010309279,34.630102040816354,135869.3877551034,1400.7153376814786,0
681,512,0,0,393,0.0,0.0,1.0,393,10500,8000,2500,0.7619047619047619,130,80,50,170.13322851879084,0.4236341005867996,0.8607050252183719,0.13078797548839544,18041041.730435867,524776.1350882645,18565817.86552413,680,4,463.06615776081424,98,295,79,30.016349583828777,0.6817602040816326,34.53282828282831,135919.1919191934,1386.9305297876876,0
682,512,0,0,393,0.0,0.0,1.0,393,11400,8300,3100,0.7280701754385965,145,83,62,171.33476838522435,0.4231532148482802,0.8616694995202432,0.1320039536373353,18050242.46486698,528526.822403029,18578769.28727001,681,5,464.06615776081424,103,290,79,29.915608929626707,0.681128640776699,34.46514423076925,135953.84615384703,1319.940253920845,0
683,512,0,0,393,0.0,0.0,1.0,393,11550,7800,3750,0.6753246753246753,153,78,75,170.80473586558446,0.4228362305481989,0.8617568807352285,0.13190109279990814,18059852.12197092,526791.6542929534,18586643.776263874,682,6,465.06615776081424,106,287,80,29.857802172292892,0.6811124213836478,34.39447040498443,135990.0311526484,1282.924822194796,0
684,512,0,0,393,0.0,0.0,1.0,393,10050,7300,2750,0.7263681592039801,128,73,55,171.93954685180026,0.4224102490869121,0.8622916911561287,0.1334056657868956,18079369.01612485,533061.7031997928,18612430.71932464,683,7,466.06615776081424,83,310,83,29.681715663400215,0.6895080321285141,34.25099206349204,136063.49206349114,1639.319181487845,0
685,512,0,0,393,0.0,0.0,1.0,393,10350,8000,2350,0.7729468599033816,127,80,47,169.46749452154873,0.4219642532585553,0.8598879031703457,0.13172893481717,18086933.544721853,524079.462280352,18611013.007002205,684,8,467.06615776081424,86,307,86,29.690878378378358,0.688953488372093,34.19540229885057,136091.9540229882,1582.4645816626537,0
686,512,0,0,393,0.0,0.0,1.0,393,11350,7900,3450,0.6960352422907489,148,79,69,170.84856688866634,0.42164808035173357,0.8612051474055722,0.13347098751232767,18107603.87970609,528781.634527086,18636385.514233176,685,9,468.06615776081424,87,306,85,29.4997329535339,0.6901340996168582,34.043560606060595,136169.6969696965,1565.1689306861665,0
687,512,0,0,393,0.0,0.0,1.0,393,11500,7900,3600,0.6869565217391305,151,79,72,168.80615145014949,0.421291608246352,0.8598240874952026,0.13248034424747362,18126384.2262743,521869.03218881105,18648253.25846311,686,10,469.06615776081424,90,303,68,29.413841807909577,0.6905092592592592,33.90567765567765,136240.29304029277,1513.7810337810308,0
688,512,0,0,393,0.0,0.0,1.0,393,11450,7800,3650,0.6812227074235808,151,78,73,140.21724738007,0.42109930804382817,0.8336630070360174,0.10591496575456427,17967721.745687477,413826.8969742609,18381548.64266174,687,11,470.06615776081424,102,291,95,31.35807947778285,0.6752450980392157,35.07281553398056,135642.71844660083,1329.8305730058905,7
689,512,0,0,393,0.0,0.0,1.0,393,11050,8100,2950,0.7330316742081447,140,81,59,139.59262470781567,0.42065114850011254,0.8329091828120541,0.1057981518665238,17981827.039721858,412376.0867033439,18394203.126425203,688,12,471.06615776081424,106,287,78,31.269207929278053,0.675314465408805,34.968847352024895,135695.95015576176,1280.1504731675639,0
690,512,0,0,393,0.0,0.0,1.0,393,10700,7400,3300,0.6915887850467289,140,74,66,139.92748746489715,0.4204845424174759,0.8324374653318927,0.10641853651935464,17996276.407709554,414334.748290914,18410611.15600047,689,13,472.06615776081424,108,285,82,31.15238129565555,0.6759259259259259,34.86238532110089,135750.45871559455,1256.9486918110606,0
691,512,0,0,393,0.0,0.0,1.0,393,10050,7300,2750,0.7263681592039801,128,73,55,140.7780021894312,0.42014051167540806,0.8324232492088055,0.10747704059220801,18012307.64462787,418497.3370064198,18430804.98163429,690,14,473.06615776081424,109,284,88,31.010101686242265,0.6768922018348624,34.74431818181815,135810.90909090734,1245.9716430358471,0
692,512,0,0,393,0.0,0.0,1.0,393,9700,7200,2500,0.7422680412371134,122,72,50,159.1016675519764,0.4198773497948798,0.851343756772607,0.11371501891405239,17731249.77750116,475914.2814762177,18207164.058977377,691,15,474.06615776081424,105,288,77,32.634727045293324,0.6568452380952381,36.82193396226419,134747.16981132282,1283.3063791554555,6
693,512,0,0,393,0.0,0.0,1.0,393,10850,7200,3650,0.663594470046083,145,72,73,177.56896302219423,0.4197962104689204,0.8621247800077056,0.12461285373999914,17651138.1212697,537408.8584710833,18188546.979740784,692,16,475.06615776081424,87,306,87,32.7544835384454,0.6560105363984674,37.417140151515184,134442.42424242568,1545.3152211773067,8
694,512,0,0,393,0.0,0.0,1.0,393,11000,8600,2400,0.7818181818181819,134,86,48,175.57029609700092,0.4196439390005366,0.8597318819502382,0.12376698631304131,17670960.941828407,530899.1689750763,18201860.110803485,693,17,476.06615776081424,94,299,94,32.65697383247782,0.6552526595744681,37.26973684210529,134517.8947368433,1431.0414333706733,0
695,512,0,0,393,0.0,0.0,1.0,393,10700,7400,3300,0.6915887850467289,140,74,66,174.97153480647754,0.41972913529279393,0.8606096430380552,0.12391217111243959,17691078.589168712,529787.0346257769,18220865.62379449,694,18,477.06615776081424,95,298,84,32.520577936462125,0.656469298245614,37.120225694444464,134594.44444444534,1416.7836257310037,0
696,512,1,0,394,0.0025380710659898475,0.0,1.0,394,10700,8100,2600,0.7570093457943925,133,81,52,174.93913051649042,0.4195829458415676,0.8596907661344249,0.12448793484075342,17712152.83904641,530209.723447598,18242362.56249401,695,0,476.8527918781726,100,294,72,32.36216214450023,0.6566666666666667,36.963696369636985,134674.5874587469,1346.745874587469,0
697,512,0,0,394,0.0,0.0,1.0,394,10500,7600,2900,0.7238095238095238,134,76,58,180.38297595737822,0.419306454321179,0.864629584726258,0.12984727187010853,17762191.07059225,551499.3769674016,18313690.44755965,696,1,477.8527918781726,100,294,81,31.840984729835554,0.6604166666666667,36.5924092409241,134864.68646864718,1348.6468646864719,8
698,512,0,0,394,0.0,0.0,1.0,394,12000,9000,3000,0.75,150,90,60,182.31811151556704,0.4190109918497565,0.8666258702674501,0.13178994918125359,17780277.77777789,557533.3333333379,18337811.11111123,697,2,478.8527918781726,106,288,82,31.65349143610014,0.6602790880503144,36.45833333333335,134933.33333333422,1272.9559748427757,0
699,512,0,0,394,0.0,0.0,1.0,394,11300,8200,3100,0.7256637168141593,144,82,62,181.00002812357042,0.41875831492747445,0.8652347179913358,0.1315744758894301,17804519.7516183,554423.7151539102,18358943.46677221,698,3,479.8527918781726,86,308,86,31.50538000544807,0.6678779069767442,36.27873563218388,135025.28735632074,1570.0614808874504,0
700,512,0,0,394,0.0,0.0,1.0,394,11000,8500,2500,0.7727272727272727,135,85,50,179.55019015478234,0.4184121287075428,0.8647327360065418,0.13106646445592512,17822469.44444429,550205.5555555486,18372674.99999984,699,4,480.8527918781726,89,305,83,31.40832675352019,0.668188202247191,36.14583333333331,135093.33333333215,1517.9026217228331,0
701,512,0,0,394,0.0,0.0,1.0,394,10800,7300,3500,0.6759259259259259,143,73,70,181.53923647100245,0.418317408498125,0.8659980783459167,0.13327129307575197,17846756.16203082,558377.2974278438,18405133.459458664,700,5,481.8527918781726,90,304,71,31.17286626781122,0.669675925925926,35.966117216117205,135185.34798534747,1502.0594220594164,0
702,512,0,0,394,0.0,0.0,1.0,394,11500,8100,3400,0.7043478260869566,149,81,68,179.82806735984326,0.4182540374489265,0.8646970263254037,0.13266311864568395,17867677.316097148,552321.975992608,18419999.292089757,701,6,482.8527918781726,94,300,74,31.060551036219213,0.6699911347517731,35.81140350877191,135264.5614035079,1438.9846957819989,0
703,512,0,0,394,0.0,0.0,1.0,394,10050,6700,3350,0.6666666666666666,134,67,67,183.8267753062173,0.4180507388176335,0.8671181156625776,0.13594382054787105,17878060.97260684,568443.2594644459,18446504.232071288,702,7,483.8527918781726,94,300,75,30.876744395114994,0.6707668439716312,35.734649122807,135303.85964912194,1439.4027622247015,0
704,512,0,0,394,0.0,0.0,1.0,394,10700,7400,3300,0.6915887850467289,140,74,66,183.63725793081957,0.4179038148564343,0.8661101172566807,0.13607542700308647,17886569.947706807,567428.1317969302,18453998.079503737,703,8,484.8527918781726,97,297,78,30.81771754865692,0.67053264604811,35.67176870748297,135336.05442176742,1395.2170558945095,0
705,512,0,0,394,0.0,0.0,1.0,394,11450,7900,3550,0.6899563318777293,150,79,71,185.29385647069364,0.41783008378433073,0.8672342825599118,0.13750754611772395,17892899.999999817,572838.8888888815,18465738.888888698,704,9,485.8527918781726,99,295,78,30.726293669556036,0.6704545454545454,35.62499999999997,135359.99999999863,1367.2727272727134,0
706,512,0,1,393,0.0,0.0025380710659898475,0.9974619289340102,394,12000,9000,3000,0.75,150,90,60,188.6073724292508,0.41743599927668207,0.8687995653046396,0.14054359317240495,17910361.400856502,584805.240614759,18495166.641471263,705,10,486.8527918781726,104,290,82,30.50729190108265,0.6704727564102564,35.496031746031726,135426.03174603073,1302.1733821733724,0
707,512,0,0,393,0.0,0.0,1.0,393,11100,8400,2700,0.7567567567567568,138,84,54,190.6090694725019,0.41706722447248623,0.8700529124191834,0.14261736129572689,17927675.019530088,593735.4906556101,18521410.510185696,706,11,488.53689567430024,85,308,85,30.32409526424997,0.6774509803921569,35.36821705426357,135491.47286821716,1594.0173278613784,0
708,512,0,0,393,0.0,0.0,1.0,393,11150,8400,2750,0.7533632286995515,139,84,55,190.1482948946168,0.4169030525696284,0.8711587148526487,0.14277125666477652,17942448.20773995,592595.186587346,18535043.394327294,707,12,489.53689567430024,85,308,85,30.225204358634155,0.6785539215686274,35.259205426356594,135547.28682170564,1594.6739626083017,0
709,512,0,0,393,0.0,0.0,1.0,393,11450,8400,3050,0.7336244541484717,145,84,61,190.38286610108366,0.416630153969985,0.8725156730723309,0.14375062561883506,17966038.223140582,594035.1698806285,18560073.39302121,708,13,490.53689567430024,87,306,81,30.041703902293698,0.6795977011494253,35.08522727272729,135636.36363636432,1559.0386624869461,0
710,512,0,1,392,0.0,0.002544529262086514,0.9974554707379135,393,11250,8300,2950,0.7377777777777778,142,83,59,193.8684147997643,0.41624366031399834,0.8738998609732782,0.1469044346137293,17980979.868987672,607338.8127494252,18588318.6817371,709,14,491.53689567430024,91,302,61,29.837094672533876,0.6793727106227105,34.975090579710155,135692.75362318888,1491.1291606943832,0
711,512,0,0,392,0.0,0.0,1.0,392,11950,8400,3550,0.702928870292887,155,84,71,199.21921773366722,0.41590087121805247,0.8747573234644868,0.13650668115783843,17545185.221884556,608717.6149792264,18153902.836863782,710,15,493.7066326530612,86,306,81,32.990986355667346,0.6483769379844961,38.206417624521066,134038.31417624495,1558.5850485609878,8
712,512,1,0,393,0.002544529262086514,0.0,1.0,393,10550,7500,3050,0.7109004739336493,136,75,61,195.99317192114697,0.41602945249346557,0.8732989522279093,0.13483342128568532,17563005.547840454,599295.8331579895,18162301.380998444,711,0,493.4478371501272,88,305,64,32.93992135484158,0.6490293560606061,38.07350187265917,134106.3670411983,1523.9359891045262,0
713,512,0,0,393,0.0,0.0,1.0,393,11150,7500,3650,0.672645739910314,148,75,73,183.0209192159106,0.41603783689048135,0.868744164547157,0.11656887157596658,17211183.677685793,540251.3314967807,17751435.009182572,712,1,494.4478371501272,109,284,78,35.964682017944305,0.6166857798165137,40.71022727272725,132756.36363636242,1217.9482902418572,8
714,512,1,0,394,0.0025380710659898475,0.0,1.0,394,10450,7100,3350,0.6794258373205742,138,71,67,183.56347435371836,0.41639219333255834,0.8707533506135661,0.11754237454887316,17236165.26105447,543536.0759708077,17779701.337025277,713,0,494.1903553299492,80,314,80,35.75905321240355,0.6272135416666667,40.5221193415638,132852.67489712004,1660.6584362140006,0
715,512,1,0,395,0.002531645569620253,0.0,1.0,395,11800,8500,3300,0.7203389830508474,151,85,66,182.14714283799663,0.41687308573753984,0.869787884578636,0.11695411024187027,17248859.284454636,537566.0871756172,17786425.371630255,714,0,493.9367088607595,83,312,83,35.6985317536149,0.6270080321285141,40.426587301587325,132901.5873015882,1601.223943392629,0
716,512,1,0,396,0.0025252525252525255,0.0,1.0,396,12100,8500,3600,0.7024793388429752,157,85,72,179.553164925646,0.4170003036696075,0.8672067344868322,0.11585773798911418,17271720.301783457,528938.4087791578,17800658.710562617,715,0,493.6868686868687,89,307,81,35.59081929715119,0.6266385767790262,40.25462962962966,132989.62962963115,1494.2655014565298,0
717,512,1,1,396,0.0025188916876574307,0.0025188916876574307,0.9974811083123426,397,11950,8100,3850,0.6778242677824268,158,81,77,176.35053828621034,0.4173899469082089,0.8648602780086712,0.11439147426607692,17296067.979600925,518684.1796875098,17814752.159288436,716,0,493.44080604534,95,302,70,35.48776351492386,0.6266447368421053,40.07161458333337,133083.33333333512,1400.877192982475,0
718,512,1,0,397,0.0025188916876574307,0.0,1.0,397,10850,8000,2850,0.7373271889400922,137,80,57,178.40019139692177,0.4172455028878203,0.8654585415679035,0.11625054332422824,17317134.59464783,527626.0252262948,17844760.619874123,717,0,494.43828715365237,100,297,74,35.273415814101064,0.6268750000000001,39.9133663366337,133164.3564356455,1331.6435643564548,0
719,512,0,0,397,0.0,0.0,1.0,397,12000,8600,3400,0.7166666666666667,154,86,68,181.76189680624262,0.41722748051463415,0.868845147512856,0.11882480133185915,17332022.776518233,538660.2670697991,17870683.04358803,718,1,495.43828715365237,104,293,74,35.07217159778352,0.6270032051282051,39.80158730158733,133221.587301589,1280.9768009768172,0
720,512,1,0,398,0.002512562814070352,0.0,1.0,398,11450,8600,2850,0.7510917030567685,143,86,57,186.44259579118446,0.41784278234159883,0.8647561159330379,0.11137833036032066,16906209.875938207,539357.5308521,17445567.40679031,719,0,495.19095477386935,100,298,74,38.22649529772179,0.5955208333333333,43.01773927392741,131574.9174917501,1315.749174917501,8
721,512,1,0,399,0.002506265664160401,0.0,1.0,399,11950,9200,2750,0.7698744769874477,147,92,55,188.0427400483207,0.41842881911646784,0.8672671299762555,0.11279518119214231,16926040.841521963,544813.8196019208,17470854.661123883,720,0,494.94736842105266,104,295,77,38.03186529830112,0.5960536858974359,42.867063492063515,131652.0634920648,1265.8852258852385,0
722,512,3,0,402,0.007462686567164179,0.0,1.0,402,11950,9000,2950,0.7531380753138075,149,90,59,186.90715840069885,0.41953496234538035,0.869358641366305,0.11290584923646343,16960015.747039456,541639.6699420464,17501655.416981503,721,0,492.24626865671644,83,319,83,37.79830731675982,0.6049196787148594,42.609126984126966,131784.1269841262,1587.7605660738095,0
723,512,1,0,403,0.0024813895781637717,0.0,1.0,403,10100,6900,3200,0.6831683168316832,133,69,64,182.69430521612605,0.41982112802406496,0.8652667460342596,0.1108318887587035,16980504.252400585,529748.2853223607,17510252.537722945,722,0,492.0223325062035,89,314,89,37.748479537419854,0.6044007490636705,42.45370370370371,131863.70370370397,1481.6146483562243,0
724,512,4,1,406,0.009828009828009828,0.002457002457002457,0.9975429975429976,407,10800,7800,3000,0.7222222222222222,138,78,60,179.53689560357373,0.42137037395658083,0.862653989578464,0.10962249088333767,17011500.25000015,518638.3888888943,17530138.638889045,723,0,488.1769041769042,99,308,72,37.59062546301911,0.6038510101010102,42.21875000000002,131984.00000000116,1333.171717171729,0
725,512,1,0,407,0.002457002457002457,0.0,1.0,407,10850,7800,3050,0.7188940092165899,139,78,61,179.71362465159828,0.4209812981364705,0.8629445989968658,0.11013510290162881,17029108.062070183,519822.5468836786,17548930.608953863,724,0,489.17444717444715,101,306,76,37.45029862073516,0.6046823432343233,42.08537581699347,132052.28758169964,1307.4483918980163,0
726,512,1,1,407,0.0024509803921568627,0.0024509803921568627,0.9975490196078431,408,13050,9500,3550,0.7279693486590039,166,95,71,185.71886963153293,0.42149636267283325,0.8674945840667785,0.1144554629221462,17055861.022111557,538869.0459238194,17594730.068035375,725,0,488.9730392156863,105,303,79,37.08913931825681,0.6057539682539683,41.88286163522014,132155.974842768,1258.6283318358855,0
727,512,1,0,408,0.0024509803921568627,0.0,1.0,408,12050,8900,3150,0.7385892116182573,152,89,63,191.6149474045991,0.4217930748261631,0.8715022013838096,0.1185485883393299,17074333.810285475,560689.5150052897,17635023.325290766,726,0,488.796568627451,108,300,81,36.794531404183985,0.6064814814814814,41.74311926605507,132227.52293578096,1224.328916072046,0
728,512,1,0,409,0.0024449877750611247,0.0,1.0,409,11600,8200,3400,0.7068965517241379,150,82,68,195.64552205383285,0.42235415967528006,0.8823675378891787,0.11436690337201957,16800338.089083683,563982.1832239263,17364320.27230761,727,0,488.59902200489,98,311,73,38.81167768787394,0.5879039115646258,43.82365319865317,131162.289562288,1338.3907098192653,8
729,512,3,0,412,0.007281553398058253,0.0,1.0,412,12100,8200,3900,0.6776859504132231,160,82,78,194.559428580158,0.4234681473869873,0.8808798949522729,0.11446173319412756,16831673.648291484,560452.161411864,17392125.809703346,728,0,486.0339805825243,81,331,81,38.596059367517135,0.5958076131687242,43.58485772357726,131284.55284552943,1620.7969487102398,0
730,512,1,0,413,0.002421307506053269,0.0,1.0,413,10250,7300,2950,0.7121951219512195,132,73,59,193.2536797423342,0.423878186291795,0.8809065090012651,0.11422672856198762,16854525.569376953,558589.817318676,17413115.38669563,729,0,485.8547215496368,85,328,79,38.45217302366569,0.596078431372549,43.410852713178315,131373.6434108536,1545.572275421807,0
731,512,4,3,414,0.009592326139088728,0.007194244604316547,0.9928057553956835,417,11950,8900,3050,0.7447698744769874,150,89,61,205.79671288434116,0.42520839097952406,0.8870308328277627,0.12276549328681033,16899311.29578341,600214.5429362922,17499525.838719703,730,0,482.18465227817745,94,323,66,37.782644104927755,0.5966312056737588,43.07017543859651,131548.07017543932,1399.4475550578652,0
732,512,2,0,416,0.004807692307692308,0.0,1.0,416,10200,6500,3700,0.6372549019607843,139,65,74,201.71074319613754,0.4254766662805067,0.885833093351964,0.12110076822542017,16930315.52902786,589605.3055810721,17519920.83460893,731,0,484.3389423076923,98,318,73,37.64729348226344,0.5978954081632653,42.834595959595994,131668.68686868853,1343.5580292723319,0
733,512,2,0,418,0.004784688995215311,0.0,1.0,418,11550,7700,3850,0.6666666666666666,154,77,77,182.432100181938,0.42649875315058955,0.8783391124111335,0.10990421645107146,16946944.444444686,523183.3333333435,17470127.77777803,732,0,483.01674641148327,101,317,79,38.01450742240222,0.5983910891089108,42.70833333333337,131733.33333333523,1304.290429042923,8
734,512,3,0,421,0.007125890736342043,0.0,1.0,421,12400,9300,3100,0.75,155,93,62,175.71558739435096,0.42747638841759983,0.8747126966922634,0.1064629735389299,16974399.999999937,499933.33333332965,17474333.333333265,733,0,480.56769596199524,84,337,84,37.97532362459546,0.6056547619047619,42.499999999999986,131839.9999999995,1569.5238095238037,0
735,512,3,2,422,0.007075471698113208,0.0047169811320754715,0.9952830188679245,424,12500,8100,4400,0.648,169,81,88,174.97696873013376,0.42872523956614184,0.8734395541725439,0.10666378581240765,17003670.578659926,497750.14702793397,17501420.72568786,734,0,478.16037735849056,91,333,66,37.76853967138213,0.6055402930402931,42.27807971014492,131953.62318840565,1450.039815257205,0
736,512,1,1,422,0.002364066193853428,0.002364066193853428,0.9976359338061466,423,10600,7900,2700,0.7452830188679245,133,79,54,176.70115860893617,0.42857569680197494,0.8750254921133112,0.10813434538795626,17022278.876170594,506371.2799167505,17528650.156087346,735,0,480.2434988179669,92,331,69,37.58062939796714,0.6066576086956521,42.13709677419354,132025.8064516124,1435.0631136044829,0
737,512,2,0,424,0.0047169811320754715,0.0,1.0,424,11900,8700,3200,0.7310924369747899,151,87,64,174.57540306383632,0.4290941602732801,0.8735031441358319,0.10718744264513905,17038081.383914,498185.9850062424,17536267.368920244,736,0,480.10141509433964,97,327,72,37.513690893109704,0.6064218213058419,42.0174319727891,132087.0748299311,1361.7224209271249,0
738,512,1,0,425,0.002352941176470588,0.0,1.0,425,12150,8400,3750,0.691358024691358,159,84,75,179.08953375466015,0.42964553274139844,0.8764993984300999,0.110437817631533,17058789.59481393,513860.13499081385,17572649.729804747,737,0,479.9694117647059,101,324,75,37.237697973124405,0.6069513201320131,41.86070261437908,132167.32026143768,1308.587329321165,0
739,512,2,0,427,0.00468384074941452,0.0,1.0,427,12050,8500,3550,0.7053941908713693,156,85,71,177.51659223109272,0.43028526349352947,0.8764966403754118,0.11002986301131674,17083132.30032751,509057.88611740863,17592190.18644492,738,0,478.7166276346604,104,323,81,37.09091811001446,0.6080729166666667,41.6765873015873,132261.58730158707,1271.7460317460295,0
740,512,2,0,429,0.004662004662004662,0.0,1.0,429,12400,9300,3100,0.75,155,93,62,174.41425567931356,0.4310198498282611,0.8756449482341797,0.10904550902833117,17124058.69702437,499135.99037007487,17623194.687394448,739,0,477.4801864801865,86,343,79,36.85641482647408,0.6164001937984496,41.36733716475095,132419.9233716472,1539.766550833107,0
741,512,2,0,431,0.004640371229698376,0.0,1.0,431,12900,8800,4100,0.6821705426356589,170,88,82,170.07203139321334,0.4315183276677638,0.8721320040584217,0.10696056972985524,17151902.206731718,484311.77011131827,17636213.976843037,740,0,476.25986078886314,91,340,73,36.754962964583044,0.6168727106227105,41.15715579710144,132527.53623188357,1456.3465519987205,0
742,512,2,0,433,0.004618937644341801,0.0,1.0,433,11350,7900,3450,0.6960352422907489,148,79,69,168.8303975092412,0.43206958522225075,0.8724449038784463,0.1067986738611896,17179210.738133226,482124.59556280856,17661335.333696034,741,0,475.0554272517321,98,335,75,36.577646899539666,0.616921768707483,40.95117845117844,132632.99663299607,1353.3979248264905,0
743,512,1,0,434,0.002304147465437788,0.0,1.0,434,12350,8500,3850,0.6882591093117408,162,85,77,170.57068226592685,0.43254725808225397,0.8747518942335923,0.10843421944048111,17202360.260156322,487693.66523182037,17690053.925388142,742,0,474.9585253456221,102,332,78,36.3551094985435,0.6176470588235294,40.77669902912619,132722.3300970862,1301.1993146773157,0
744,512,1,0,435,0.0022988505747126436,0.0,1.0,435,12700,8400,4300,0.6614173228346457,170,84,86,171.04945387002252,0.4331671433868319,0.8758474198192281,0.10911513941996798,17218509.846523702,489343.3411406978,17707853.1876644,743,0,474.86436781609194,103,332,81,36.218966837884075,0.618628640776699,40.65504807692308,132784.61538461564,1289.171023151608,0
745,512,1,1,435,0.0022935779816513763,0.0022935779816513763,0.9977064220183486,436,12250,9200,3050,0.7510204081632653,153,92,61,168.37779685968735,0.43347492442616614,0.8743859968292731,0.1080679314390364,17246920.41522503,481349.6924259949,17728270.107651025,744,0,474.7729357798165,84,352,84,36.07078218445072,0.6264880952380952,40.44117647058825,132894.1176470597,1582.0728291316632,0
746,512,0,0,435,0.0,0.0,1.0,435,13100,9800,3300,0.7480916030534351,164,98,66,167.61504763371667,0.433513206914208,0.8737116133928624,0.10793453542399199,17262273.89498102,478583.3722347021,17740857.26721572,745,1,475.2206896551724,86,349,82,35.97313798721265,0.626937984496124,40.3256704980843,132953.2567049811,1545.9681012207104,0
747,512,3,3,435,0.00684931506849315,0.00684931506849315,0.9931506849315068,438,12800,9000,3800,0.703125,166,90,76,165.90824120066102,0.43436312515455805,0.8729880739070952,0.10743238569551114,17288088.642659474,473247.27608495805,17761335.918744434,746,0,472.958904109589,94,344,67,35.820147679324926,0.6263297872340425,40.13157894736845,133052.63157894887,1415.4535274356263,0
748,512,1,0,436,0.0022935779816513763,0.0,1.0,436,13250,9800,3450,0.7396226415094339,167,98,69,180.5296511454165,0.43415442985693703,0.8804804235643098,0.11332522074370893,17143089.832797583,518517.20541389857,17661607.038211484,747,0,474.6857798165138,86,350,65,36.551978747358866,0.6178536821705427,41.22365900383143,132493.48659003878,1540.6219370934741,8
749,512,0,0,436,0.0,0.0,1.0,436,14600,10300,4300,0.7054794520547946,189,103,86,180.28226252095178,0.43443464620900557,0.879702819230616,0.11352910045238376,17158004.93827171,516856.7901234614,17674861.72839517,748,1,475.6857798165138,89,347,67,36.44380364806867,0.6179775280898876,41.11111111111113,132551.11111111194,1489.3383270911454,0
750,512,1,0,437,0.002288329519450801,0.0,1.0,437,13600,9500,4100,0.6985294117647058,177,95,82,180.8767253554312,0.4346931661523174,0.8810086857624966,0.114596851280508,17186494.53245565,520727.3702739204,17707221.90272957,749,0,475.5949656750572,95,342,70,36.20968389240199,0.618311403508772,40.896267361111114,132661.1111111112,1396.4327485380127,0
751,512,0,1,436,0.0,0.002288329519450801,0.9977116704805492,437,11750,8300,3450,0.7063829787234043,152,83,69,181.64364348480933,0.43468638688864164,0.8818813899236462,0.11552684271419478,17204521.36111108,525868.3888888883,17730389.749999966,750,1,476.5949656750572,99,338,73,36.05149442145165,0.6185816498316499,40.760416666666664,132730.66666666642,1340.7138047138023,0
752,512,0,0,436,0.0,0.0,1.0,436,12800,9300,3500,0.7265625,163,93,70,179.94009942591953,0.4346055661007417,0.8806273678630125,0.11465590041933602,17213190.360987805,519468.63699868385,17732658.997986488,751,2,478.63761467889907,103,333,75,36.02917744988219,0.6182241100323624,40.695112179487175,132764.10256410233,1288.9718695543916,0
753,512,0,0,436,0.0,0.0,1.0,436,13450,9700,3750,0.7211895910780669,172,97,75,174.85718864463942,0.4347095899680129,0.8775934444652049,0.11213196453884516,17242999.923792057,502362.49809480034,17745362.421886858,752,3,479.63761467889907,80,356,80,35.932622268470354,0.627734375,40.47067901234567,132879.01234567864,1660.987654320983,0
754,512,1,0,437,0.002288329519450801,0.0,1.0,437,12400,9000,3400,0.7258064516129032,158,90,68,174.47467816525233,0.4351985493250478,0.8780417243025196,0.11239819553534865,17264191.86787309,502632.86398606456,17766824.731859155,753,0,479.5377574370709,82,355,78,35.78033378439335,0.6285569105691057,40.31124497991968,132960.64257028108,1621.4712508570863,0
755,512,1,0,438,0.00228310502283105,0.0,1.0,438,11800,8300,3500,0.7033898305084746,153,83,70,172.8038176818693,0.43554973894931887,0.875969326652448,0.11200430146922248,17292497.719008803,498241.92461995094,17790739.643628754,754,0,479.4406392694064,90,348,71,35.607245100198185,0.6278935185185186,40.09844322344324,133069.59706959783,1478.5510785510871,0
756,512,0,0,438,0.0,0.0,1.0,438,12950,9000,3950,0.694980694980695,169,90,79,173.0227846144268,0.43556465053342114,0.8765650126349642,0.11258119303835622,17310371.655040484,498467.7412931525,17808839.396333635,755,1,480.4406392694064,92,346,74,35.46494515276822,0.6286231884057971,39.964157706093204,133138.35125448092,1447.1559918965318,0
757,512,0,0,438,0.0,0.0,1.0,438,12700,8500,4200,0.6692913385826772,169,85,84,171.56890804213648,0.43551719468912503,0.8755014199201931,0.1121027913712219,17329624.827293135,494344.9616797202,17823969.788972855,756,2,481.4406392694064,96,342,78,35.35570070441911,0.62890625,39.819587628865996,133212.37113402152,1387.6288659793909,0
758,512,0,0,438,0.0,0.0,1.0,438,11700,8600,3100,0.7350427350427351,148,86,62,168.66277241578334,0.4355020654176636,0.873247570284448,0.11076083378245156,17352778.777777836,486053.5555555582,17838832.333333395,757,3,482.4406392694064,99,339,84,35.25462777733326,0.6298400673400674,39.64583333333334,133301.3333333338,1346.4781144781193,0
759,512,0,0,438,0.0,0.0,1.0,438,12800,9100,3700,0.7109375,165,91,74,170.2399999999993,0.4354772490587198,0.8747945205479448,0.11200000000000015,17361111.111111213,490711.1111111156,17851822.22222233,758,4,483.4406392694064,101,337,85,35.150000000000034,0.629950495049505,39.58333333333335,133333.33333333413,1320.132013201328,0
760,512,0,0,438,0.0,0.0,1.0,438,13050,9700,3350,0.7432950191570882,164,97,67,170.93301235951594,0.43571082759509455,0.8747025524968579,0.1131878457399358,17390774.207801968,493881.4845207499,17884655.692322716,759,5,484.4406392694064,88,350,88,34.90577334710434,0.6360085227272727,39.36095505617976,133447.19101123535,1516.4453524004018,0
761,512,0,0,438,0.0,0.0,1.0,438,12100,8000,4100,0.6611570247933884,162,80,82,173.60896275315406,0.43564290913903775,0.8764141047067753,0.11531486202190616,17404833.985607713,504627.0350264343,17909461.02063415,760,6,485.4406392694064,88,350,87,34.72886180686474,0.6370738636363636,39.25561797752806,133501.12359550435,1517.0582226761858,0
762,512,1,1,438,0.002277904328018223,0.002277904328018223,0.9977220956719818,439,12800,8800,4000,0.6875,168,88,80,172.5589110685976,0.4355844107439421,0.8766134014634506,0.11506068129684156,17422395.684793208,500677.9255148246,17923073.610308032,761,0,485.33257403189066,92,347,68,34.6224578878823,0.637115036231884,39.124103942652305,133568.45878136082,1451.8310737104437,0
763,512,0,1,437,0.0,0.00228310502283105,0.997716894977169,438,13000,9500,3500,0.7307692307692307,165,95,70,171.6559876833368,0.43545722182167745,0.8759296156763627,0.11483293476219077,17437217.728531685,498040.5663280934,17935258.294859778,762,8,487.4406392694064,94,344,71,34.533162479343474,0.6376329787234043,39.013157894736814,133625.2631578934,1421.5453527435468,0
764,512,0,0,437,0.0,0.0,1.0,437,12300,9100,3200,0.7398373983739838,155,91,64,176.76329333681178,0.4354137362752713,0.8790955165134358,0.11877184316306219,17457177.200316355,517457.62685843976,17974634.827174794,763,9,489.27688787185355,96,341,72,34.24790270181352,0.6385633680555556,38.863831615120255,133701.71821305744,1392.726231386015,0
765,512,0,0,437,0.0,0.0,1.0,437,11750,8100,3650,0.6893617021276596,154,81,73,172.4829285497978,0.43526481116033006,0.8759088345959563,0.11634266256280551,17474564.468323432,503662.8109257294,17978227.27924916,764,10,490.27688787185355,102,335,78,34.22742316327319,0.6382761437908497,38.73381877022652,133768.2847896432,1311.4537724474824,0
766,512,0,0,437,0.0,0.0,1.0,437,13500,8800,4700,0.6518518518518519,182,88,94,173.34953207698155,0.4351755873029202,0.8770586750673581,0.11745909965134628,17495016.118824378,505650.57157549,18000666.690399867,765,11,491.27688787185355,105,332,82,34.0492882740646,0.6390873015873015,38.58097484276729,133846.54088050287,1274.728960766694,0
767,512,0,0,437,0.0,0.0,1.0,437,12950,9300,3650,0.7181467181467182,166,93,73,177.39845811413744,0.43516990146886964,0.8801941615587645,0.12061358788386754,17510359.550652556,520912.15706199023,18031271.707714546,766,12,492.27688787185355,82,355,82,33.82679911064193,0.6472306910569106,38.46636546184742,133905.22088353528,1632.9904985796986,0
768,512,0,0,437,0.0,0.0,1.0,437,12250,7900,4350,0.6448979591836734,166,79,87,176.3734787115588,0.43501704000727787,0.87986216432028,0.1203058712617193,17524894.271434225,518535.3133410305,18043429.584775254,767,13,493.27688787185355,84,353,84,33.74316939890711,0.6475694444444444,38.35784313725493,133960.78431372673,1594.7712418300803,0
769,512,0,0,437,0.0,0.0,1.0,437,11650,8500,3150,0.7296137339055794,148,85,63,176.01092351763782,0.43487664364341244,0.8791152551334778,0.12054758667056645,17543088.017963875,518505.0246786109,18061593.042642485,768,14,494.27688787185355,87,350,84,33.61448677368303,0.6478687739463602,38.22206439393942,134030.30303030417,1540.5781957506226,0
770,512,1,0,438,0.00228310502283105,0.0,1.0,438,12800,9500,3300,0.7421875,161,95,66,174.42519222276482,0.43516965682023206,0.8777524011694287,0.1197774894812388,17554885.52825046,512002.85654274665,18066888.384793207,769,0,494.14611872146116,91,347,80,33.566456243514345,0.6474358974358974,38.13405797101451,134075.36231884127,1473.3556298773767,0
771,512,0,1,437,0.0,0.00228310502283105,0.997716894977169,438,12650,8100,4550,0.6403162055335968,172,81,91,172.96834017785332,0.43501727566882264,0.876887981024689,0.11924014115058201,17572230.1637912,507637.8969308353,18079868.060722034,770,1,495.14611872146116,96,342,68,33.4730363022776,0.6472439236111112,38.00472508591066,134141.58075601398,1397.3081328751457,0
772,512,1,0,438,0.00228310502283105,0.0,1.0,438,13050,9000,4050,0.6896551724137931,171,90,81,186.52035138023783,0.43480252708901496,0.8786419047081002,0.1210333903440111,17297792.466564134,544628.0657931988,17842420.53235733,771,0,496.1415525114155,102,336,70,35.210221893682984,0.6248978758169934,40.05865695792882,133089.96763754127,1304.8036042896204,8
773,512,2,0,440,0.004545454545454545,0.0,1.0,440,14250,10800,3450,0.7578947368421053,177,108,69,190.8621906244967,0.4352165950507352,0.8805586079979866,0.12440011693622252,17318208.356290143,558828.236914599,17877036.59320474,772,0,494.8818181818182,109,331,74,34.94107866695791,0.6248088685015291,39.905303030303024,133168.4848484846,1221.7292187934368,0
774,512,0,0,440,0.0,0.0,1.0,440,13050,9100,3950,0.6973180076628352,170,91,79,193.19244533087723,0.43513041865120455,0.8840607911603873,0.1263402728131987,17333583.717300843,568693.4849385659,17902277.20223941,773,1,495.8818181818182,115,325,75,34.76280757152223,0.6247282608695652,39.789870689655174,133227.58620689664,1158.500749625188,0
775,512,1,0,441,0.0022675736961451248,0.0,1.0,441,12400,9300,3100,0.75,155,93,62,178.67054886198514,0.4355139404246547,0.8788211762164266,0.11422823071351491,17228788.452709015,515055.41781451466,17743843.87052353,774,0,495.7551020408163,87,354,87,35.9425381760662,0.6240421455938697,40.57765151515154,132824.24242424328,1526.7154301637158,7
776,512,3,0,444,0.006756756756756757,0.0,1.0,444,13650,10000,3650,0.7326007326007326,173,100,73,175.94211333564695,0.4362542918200367,0.8774695504396011,0.11284683269191387,17243788.62590416,504331.7225509592,17748120.34845512,775,0,493.39864864864865,90,354,90,35.89842543995058,0.6241898148148148,40.46474358974361,132882.05128205245,1476.4672364672494,0
777,512,0,0,444,0.0,0.0,1.0,444,11250,7700,3550,0.6844444444444444,148,77,71,174.1931767599513,0.4361866098604248,0.8758436434745538,0.11208952243683916,17258922.74546029,501227.3160972671,17760150.061557557,776,1,494.39864864864865,94,350,94,35.82796663851353,0.624113475177305,40.35087719298248,132940.35087719414,1414.259051885044,0
778,512,0,1,443,0.0,0.0022522522522522522,0.9977477477477478,444,12250,8500,3750,0.6938775510204082,160,85,75,169.20913409563994,0.4359415143134105,0.8724164590639547,0.10937465809135057,17279837.204820592,483731.2581482705,17763568.462968864,777,2,495.39864864864865,98,346,71,35.79744114153036,0.6245748299319728,40.19360269360273,133020.87542087713,1357.3558716416032,0
779,512,1,0,444,0.0022522522522522522,0.0,1.0,444,12800,9300,3500,0.7265625,163,93,70,171.2640107258988,0.43586239314935704,0.87387652837091,0.11115130364653375,17298531.440898918,490923.1748472858,17789454.615746204,778,0,496.31306306306305,101,343,73,35.60114978654303,0.6252062706270627,40.05310457516342,133092.81045751725,1317.7505985892797,0
780,512,0,0,444,0.0,0.0,1.0,444,11900,7600,4300,0.6386554621848739,162,76,86,169.1209668648031,0.4357027738799748,0.8722326394217184,0.11009560865725525,17312601.355243605,484884.7760287447,17797486.13127235,779,1,497.31306306306305,102,342,79,35.54937647455347,0.6260212418300654,39.94741100323627,133146.92556634423,1305.362015356316,0
781,512,2,0,446,0.004484304932735426,0.0,1.0,446,12850,8800,4050,0.6848249027237354,169,88,81,169.65405128814888,0.43620992257436053,0.8732192117641229,0.1110840879861238,17339255.85371912,486285.0003810454,17825540.854100164,780,0,496.07847533632287,107,339,84,35.332006880875625,0.6268496884735202,39.74729938271607,133249.38271605072,1245.3213337948666,0
782,512,2,0,448,0.004464285714285714,0.0,1.0,448,13750,9300,4450,0.6763636363636364,182,93,89,168.0223227933582,0.4362399462021945,0.8733205707567588,0.11065157483407513,17365690.167585857,480214.71977351414,17845904.88735937,781,0,494.859375,90,358,90,35.172834351514055,0.6334490740740741,39.548992673992686,133350.9157509164,1481.6768416768489,0
783,512,2,0,450,0.0044444444444444444,0.0,1.0,450,14400,10900,3500,0.7569444444444444,179,109,70,167.06088048774555,0.4366562525777448,0.8713068696755473,0.11059213794707193,17389467.351566583,476619.94539312733,17866087.29695971,782,0,493.65555555555557,97,353,97,35.01665307232193,0.6331615120274914,39.37074829931974,133442.17687074913,1375.6925450592694,0
784,512,0,0,450,0.0,0.0,1.0,450,13550,10000,3550,0.7380073800738007,171,100,71,165.6833403107879,0.43645127031262887,0.8708872983862113,0.11029128699972475,17414782.891655628,473517.8800553377,17888300.771710966,783,1,494.65555555555557,100,350,91,34.85977104670016,0.6342708333333333,39.181105610561076,133539.27392739372,1335.3927392739372,0
785,512,1,0,451,0.0022172949002217295,0.0,1.0,451,12000,8700,3300,0.725,153,87,66,170.08936558569482,0.43658454463332513,0.8762638121374928,0.1140097843122191,17446166.488620847,491281.4779903882,17937447.966611236,784,0,494.55654101995566,102,349,74,34.505949844393655,0.6361315359477124,38.94619741100325,133659.54692556692,1310.3877149565385,0
786,512,1,1,451,0.0022123893805309734,0.0022123893805309734,0.9977876106194691,452,13300,9300,4000,0.6992481203007519,173,93,80,169.48541483373143,0.4366428626323673,0.8759991080194904,0.11422026525930938,17470593.87383794,488502.170019818,17959096.043857757,785,0,494.46017699115043,107,345,80,34.335925481508816,0.6367795950155763,38.76350308641977,133753.08641975393,1250.0288450444293,0
787,512,1,0,452,0.0022123893805309734,0.0,1.0,452,14250,9300,4950,0.6526315789473685,192,93,99,169.4285853196718,0.43632052910935387,0.8775248615313209,0.11480720486830773,17495207.438016515,488187.6492194669,17983395.087235983,786,0,495.4513274336283,109,343,86,34.15033567581925,0.6381880733944953,38.57954545454545,133847.27272727262,1227.9566305254368,0
788,512,0,0,452,0.0,0.0,1.0,452,11900,7900,4000,0.6638655462184874,159,79,80,167.48374970632042,0.4364112812236329,0.8766641867021701,0.11401002239044666,17515775.034293495,484421.53635116346,18000196.570644658,787,1,496.4513274336283,89,363,89,34.044985250737454,0.6451310861423221,38.42592592592592,133925.9259259255,1504.7856845609606,0
789,512,0,2,450,0.0,0.004424778761061947,0.995575221238938,452,13200,9900,3300,0.75,165,99,66,165.56015927930775,0.43642109226301434,0.8754520500319842,0.11321756634122254,17536281.94010863,477061.92623424524,18013343.866342876,788,2,497.4513274336283,92,360,92,33.9396905892926,0.6457201086956521,38.272849462365585,134004.30107526842,1456.5684899485698,0
790,512,0,0,450,0.0,0.0,1.0,450,12150,7500,4650,0.6172839506172839,168,75,93,164.32131568639176,0.4362180359646952,0.8736418374940806,0.11279062724809794,17552964.765838183,474715.2529038777,18027680.018742062,789,3,500.3888888888889,97,353,83,33.845604153981455,0.6455111683848798,38.14838435374148,134068.0272108834,1382.1446104214783,0
791,512,1,1,450,0.0022172949002217295,0.0022172949002217295,0.9977827050997783,451,12200,8900,3300,0.7295081967213115,155,89,66,165.38891334233585,0.43618974295803564,0.8745900908281994,0.11406499894384267,17574179.161860723,478914.87889273,18053094.040753454,790,0,500.2771618625277,101,350,69,33.65684440286875,0.6460396039603961,37.99019607843136,134149.01960784238,1328.2081149291325,0
792,512,0,0,450,0.0,0.0,1.0,450,12750,9500,3250,0.7450980392156863,160,95,65,168.01353770341925,0.4358748865792295,0.8761984945052066,0.11636425344265672,17592902.76552405,488419.16642159177,18081321.93194564,791,5,502.3888888888889,100,350,75,33.44619626511396,0.6477083333333333,37.8506600660066,134220.4620462044,1342.204620462044,0
793,512,0,0,450,0.0,0.0,1.0,450,12450,7700,4750,0.6184738955823293,172,77,95,168.99863776089188,0.4357830157551761,0.8767240786709951,0.11747356861611236,17609052.047378372,492731.1616535181,18101783.20903189,792,6,503.3888888888889,103,347,78,33.29804754630513,0.6481593851132685,37.73036858974359,134282.0512820513,1303.709235748071,0
794,512,0,0,450,0.0,0.0,1.0,450,13850,10600,3250,0.7653429602888087,171,106,65,169.47739472204847,0.4356957848717314,0.8775319092267302,0.11817385640334181,17622834.366718028,493484.4112179083,18116318.777935937,793,7,504.3888888888889,105,345,80,33.181135061238216,0.6487103174603175,37.627751572327035,134334.5911949681,1279.3770589996961,0
795,512,0,1,449,0.0,0.0022222222222222222,0.9977777777777778,450,13850,10500,3350,0.7581227436823105,172,105,67,169.39663202047703,0.43546935577002394,0.8777467491375281,0.11854279610278379,17638703.727518585,493737.40092973365,18132441.12844832,794,8,505.3888888888889,107,343,84,33.063146855288174,0.6494353582554517,37.509645061728385,134395.06172839442,1256.02861428406,0
796,512,0,0,449,0.0,0.0,1.0,449,12100,8100,4000,0.6694214876033058,161,81,80,170.15476908539506,0.4351131234091632,0.8781178451790943,0.11933112692813791,17648236.255286556,498686.31295656075,18146922.568243116,795,9,507.47216035634744,84,365,84,32.97112018669777,0.6568700396825398,37.4387254901961,134431.37254902057,1600.3734827264354,0
797,512,0,0,449,0.0,0.0,1.0,449,12950,9400,3550,0.7258687258687259,165,94,71,171.1536528062871,0.4348214699994697,0.8795871364160506,0.12060827580793938,17669314.494321294,502083.5436572342,18171398.03797853,796,10,508.47216035634744,85,364,85,32.785461810358065,0.6580882352941176,37.28197674418605,134511.62790697705,1582.489740082083,0
798,512,0,0,449,0.0,0.0,1.0,449,12400,9300,3100,0.75,155,93,62,169.0298012647243,0.43466487200392406,0.8783062946002207,0.11965715003779821,17689352.652949948,495805.5526859503,18185158.205635898,797,11,509.47216035634744,87,362,78,32.68981439786256,0.6588840996168582,37.13304924242424,134587.87878787876,1546.9871125043535,0
799,512,1,1,449,0.0022222222222222222,0.0022222222222222222,0.9977777777777778,450,12750,9000,3750,0.7058823529411765,165,90,75,171.83243023776438,0.43476387857790977,0.8803757269666359,0.12230425916923247,17713119.09262762,505987.66015543044,18219106.75278305,798,0,509.3377777777778,91,359,71,32.43658172635445,0.6593406593406593,36.95652173913044,134678.26086956536,1479.9808886765425,0
800,512,0,0,449,0.0,0.0,1.0,449,13050,9500,3550,0.7279693486590039,166,95,71,172.94029042692807,0.43414909289161097,0.8808184241775603,0.12355903082222498,17729598.02080759,510382.3661742336,18239980.386981823,799,13,511.47216035634744,96,353,71,32.28299532087378,0.6590711805555556,36.834192439862555,134740.89347079105,1403.5509736540735,0
801,512,0,0,449,0.0,0.0,1.0,449,11500,8500,3000,0.7391304347826086,145,85,60,173.30272913265043,0.43409606499893943,0.8813414549150649,0.12421104513400397,17743383.356573746,513695.3519482203,18257078.708521966,800,14,512.4721603563474,98,351,72,32.16939437539137,0.6595450680272108,36.73190235690238,134793.26599326715,1375.4414897272159,0
802,512,0,0,449,0.0,0.0,1.0,449,14350,11500,2850,0.8013937282229965,172,115,57,165.51408951438106,0.4339253814694029,0.8751400990668932,0.11473199833628943,17596727.60123293,478351.26947013196,18075078.870703064,801,15,513.4721603563474,96,353,78,33.48275238251275,0.6490885416666667,37.82216494845362,134235.0515463923,1398.2817869415865,8
803,512,0,0,449,0.0,0.0,1.0,449,13050,9300,3750,0.7126436781609196,168,93,75,167.10638456877234,0.4338178757026196,0.8769172684899744,0.11634614549614043,17616208.027777806,485906.1666666673,18102114.194444474,802,16,514.4721603563474,99,350,80,33.293499913963124,0.649726430976431,37.677083333333336,134309.33333333355,1356.6599326599348,0
804,512,0,0,449,0.0,0.0,1.0,449,12900,9500,3400,0.7364341085271318,163,95,68,168.24619534599694,0.4335490077155584,0.8775385730408185,0.11748807706685065,17629334.945830155,490513.70622322895,18119848.652053386,803,17,515.4721603563474,104,345,82,33.16423773879735,0.6494391025641026,37.579365079365076,134359.36507936486,1291.9169719169697,0
805,512,0,0,449,0.0,0.0,1.0,449,14150,10200,3950,0.7208480565371025,181,102,79,164.56509925772346,0.43348790135486265,0.874870568118348,0.11544257150555991,17649439.464714244,476946.35147078265,18126385.816185027,804,18,516.4721603563474,88,361,88,33.10878577159669,0.6555397727272727,37.42977528089891,134435.95505618126,1527.6813074566053,0
806,512,0,0,449,0.0,0.0,1.0,449,13450,9700,3750,0.7211895910780669,172,97,75,163.02919887773535,0.4333213606294411,0.874109627653449,0.11461075259449897,17658881.454361957,472532.6593163103,18131414.113678265,805,19,517.4721603563474,88,361,88,33.07774435531788,0.65625,37.359550561797775,134471.91011236058,1528.089887640461,0
807,512,0,0,449,0.0,0.0,1.0,449,12700,8700,4000,0.6850393700787402,167,87,80,163.80765955236294,0.4331428057720861,0.8738866542094521,0.1154615107002755,17670447.910103094,476410.9430791923,18146858.853182286,806,20,518.4721603563474,91,358,91,32.96989024880766,0.6561355311355311,37.27355072463771,134515.94202898684,1478.1971651537015,0
808,512,0,0,449,0.0,0.0,1.0,449,13200,9500,3700,0.7196969696969697,169,95,74,162.65454295986078,0.43303012150015907,0.8737027421129728,0.11523286380352907,17692727.515062883,472560.50153518573,18165288.01659807,807,21,519.4721603563474,92,357,87,32.83191669152002,0.6574954710144927,37.10797491039428,134600.7168458791,1463.0512700639033,0
809,512,0,0,449,0.0,0.0,1.0,449,13750,10300,3450,0.7490909090909091,172,103,69,162.33749246176012,0.43281241714391766,0.8731181858911472,0.11550326591313242,17711500.879263416,471498.1280947814,18182999.007358197,808,22,520.4721603563474,97,352,73,32.69855060750561,0.6574312714776632,36.96853741496601,134672.10884353853,1388.3722561189538,0
810,512,0,0,449,0.0,0.0,1.0,449,11550,7800,3750,0.6753246753246753,153,78,75,162.00335749869018,0.43286150937268003,0.8726100947764364,0.1157378574822223,17729328.4901107,473092.1483190252,18202420.638429724,809,23,521.4721603563474,101,348,76,32.572850776773144,0.6576938943894389,36.836192810457526,134739.8692810462,1334.0581116935268,0
811,512,0,0,449,0.0,0.0,1.0,449,12150,8900,3250,0.7325102880658436,154,89,65,162.15810417386555,0.43265374774631454,0.871549372404556,0.11614682605907833,17740520.15347502,473403.8230291552,18213923.976504177,810,24,522.4721603563474,105,344,80,32.484383554825556,0.6575396825396825,36.75314465408806,134782.3899371075,1283.6418089248334,0
812,512,0,0,449,0.0,0.0,1.0,449,12300,8300,4000,0.6747967479674797,163,83,80,165.278260264418,0.4324031080973592,0.8745461598827875,0.11878606526761624,17755328.073291384,484813.94687552174,18240142.020166904,811,25,523.4721603563474,106,343,81,32.29058849622949,0.6584119496855345,36.64330218068538,134838.62928349042,1272.062540410287,0
813,512,0,0,449,0.0,0.0,1.0,449,12650,8100,4550,0.6403162055335968,172,81,91,167.00542405911438,0.4320648481413724,0.8766331493687998,0.12050527471169567,17772541.616399866,491172.1698510303,18263713.786250897,812,26,524.4721603563474,108,341,83,32.11534160289197,0.6592399691358024,36.515672782874645,134903.9755351697,1249.1108845849046,0
814,512,0,1,448,0.0,0.0022271714922048997,0.9977728285077951,449,12000,8200,3800,0.6833333333333333,158,82,76,169.96718221647416,0.43182000841817797,0.8780244668518253,0.12300152484910745,17785181.216573354,502779.4273180614,18287960.643891416,813,27,525.4721603563474,85,364,85,31.94203506272687,0.6667892156862745,36.421996124030976,134951.9379844948,1587.6698586411155,0
815,512,0,0,448,0.0,0.0,1.0,448,12150,8400,3750,0.691358024691358,159,84,75,166.8053449908452,0.43179885995925216,0.8752206080683067,0.12126943336207177,17804999.42975203,492243.8144883133,18297243.244240344,814,28,525.8526785714286,90,358,90,31.87611224445504,0.6665509259259259,36.275183150183125,135027.1062271051,1500.3011803011677,0
816,512,1,1,448,0.0022271714922048997,0.0022271714922048997,0.9977728285077951,449,13250,9900,3350,0.7471698113207547,166,99,67,163.0117286260628,0.4317760946945593,0.8718145952626069,0.11905755113686352,17824767.024156507,478079.2169929157,18302846.24114942,815,0,525.6792873051224,97,352,88,31.827416918429,0.6659149484536082,36.12882653061223,135102.0408163258,1392.8045444982042,0
817,512,1,0,449,0.0022271714922048997,0.0,1.0,449,13150,10000,3150,0.7604562737642585,163,100,63,161.90484210583034,0.43179432303266513,0.8701433636623339,0.11850554075970512,17834060.217224162,474534.14071511035,18308594.357939273,816,0,526.467706013363,101,348,92,31.78673341071775,0.6655321782178218,36.060049019607845,135137.25490196093,1337.9926227916924,0
818,512,0,1,448,0.0,0.0022271714922048997,0.9977728285077951,449,12200,7600,4600,0.6229508196721312,168,76,92,166.31760887544237,0.4313657499469721,0.8735578648582374,0.1223234698247921,17854687.731139086,491909.79413215094,18346597.525271237,817,1,527.467706013363,103,346,71,31.515127811279267,0.6665655339805825,35.90745192307693,135215.38461538486,1312.7707244212122,0
819,512,0,0,448,0.0,0.0,1.0,448,12350,8700,3650,0.7044534412955465,160,87,73,164.7486722774051,0.4308653673298178,0.8726992560447182,0.1217593572803899,17875409.831771024,487040.00723974826,18362449.83901077,818,3,529.6428571428571,107,341,75,31.40083007871908,0.6671534267912773,35.75424382716049,135293.82716049347,1264.4282912195652,0
820,512,0,0,448,0.0,0.0,1.0,448,12300,8700,3600,0.7073170731707317,159,87,72,162.93119465424513,0.43054598447320763,0.871114212564086,0.12088318895456239,17891883.798212606,481129.2003715421,18373012.998584148,819,4,530.6428571428571,110,338,80,31.32513636955262,0.6677083333333333,35.632507507507505,135356.156156156,1230.5105105105092,0
821,512,0,0,448,0.0,0.0,1.0,448,11350,8000,3350,0.7048458149779736,147,80,67,197.29784331043186,0.43039035035155004,0.8934260033444814,0.13885150842257354,17663622.360929657,596048.9193722677,18259671.280301925,820,5,531.6428571428571,82,366,82,32.14176222328393,0.6587906504065041,37.32429718875502,134489.95983935738,1640.121461455578,8
822,512,0,0,448,0.0,0.0,1.0,448,11800,8400,3400,0.711864406779661,152,84,68,195.94447016317662,0.4303314673884095,0.8923928071695097,0.13819241579929303,17672956.5551711,591183.6216839685,18264140.17685507,821,6,532.6428571428571,84,364,84,32.10655705845773,0.6587301587301587,37.254901960784316,134525.49019607852,1601.4939309056967,0
823,512,0,1,447,0.0,0.002232142857142857,0.9977678571428571,448,12200,8500,3700,0.6967213114754098,159,85,74,197.51888808092477,0.42997952204511564,0.8926373381482697,0.14008856011659074,17697602.50342949,597322.1536351227,18294924.657064613,822,7,533.6428571428571,89,359,61,31.878429883640727,0.6588249063670413,37.07175925925928,134619.25925926032,1512.575946733262,0
824,512,0,0,447,0.0,0.0,1.0,447,13550,9900,3650,0.7306273062730627,172,99,73,195.64659317469176,0.4299024304197055,0.8916549206046378,0.13941635610455677,17718191.720529586,590350.7694675364,18308542.489997122,823,8,535.1543624161073,94,353,64,31.771766765306552,0.6587987588652482,36.91885964912284,134697.5438596506,1432.9525942516022,0
825,512,0,0,447,0.0,0.0,1.0,447,12000,8200,3800,0.6833333333333333,158,82,76,194.4507823617301,0.4296641703701474,0.8913098712871885,0.1392003192714154,17738136.111111276,588438.888888895,18326575.00000017,824,9,536.1543624161073,99,348,68,31.652321593457323,0.6588804713804715,36.77083333333336,134773.3333333346,1361.3468013468141,0
826,512,0,0,447,0.0,0.0,1.0,447,13600,9500,4100,0.6985294117647058,177,95,82,198.04227101870694,0.4295230953408038,0.8928825726725693,0.1423018967253639,17754359.506079946,600222.7354133365,18354582.24149328,825,10,537.1543624161073,102,345,72,31.435051843318007,0.6593137254901961,36.650485436893234,134834.95145631224,1321.9112887873748,0
827,512,0,1,446,0.0,0.0022371364653243847,0.9977628635346756,447,13650,10800,2850,0.7912087912087912,165,108,57,200.98888579930838,0.42952267734071686,0.8960057920786269,0.14510643641520832,17774923.683547787,611462.421264814,18386386.1048126,826,11,538.1543624161073,104,343,75,31.201918853456874,0.6603565705128205,36.498015873015916,134913.01587301813,1297.240537240559,0
828,512,0,0,446,0.0,0.0,1.0,446,11250,8300,2950,0.7377777777777778,142,83,59,198.3652802316891,0.4291278278833073,0.8946120176463863,0.14350942707670877,17783881.949010152,605090.9452845354,18388972.894294687,827,12,540.1726457399103,77,369,77,31.2033424537225,0.6699134199134199,36.43162393162393,134947.00854700853,1752.5585525585523,0
829,512,0,0,446,0.0,0.0,1.0,446,10750,7600,3150,0.7069767441860465,139,76,63,197.67317464196435,0.4289082313027997,0.8934623815921627,0.14351528807426606,17799137.790005997,603732.4145680506,18402870.20457405,828,13,541.1726457399103,81,365,81,31.10632356955888,0.6693672839506173,36.31859756097562,135004.87804878084,1666.7268894911215,0
830,512,0,0,446,0.0,0.0,1.0,446,13250,9200,4050,0.6943396226415094,173,92,81,196.9189107830174,0.4286912589644111,0.8921007996930619,0.14366205456616646,17819986.19761626,599368.454440598,18419354.652056858,829,14,542.1726457399103,84,362,79,30.96879015901034,0.6697668650793651,36.1642156862745,135083.92156862712,1608.1419234360371,0
831,512,0,0,446,0.0,0.0,1.0,446,12700,8700,4000,0.6850393700787402,167,87,80,196.46862311802784,0.42853264977074623,0.8905612270766678,0.14390895931084316,17837177.159168925,598989.127354847,18436166.28652377,830,15,543.1726457399103,88,358,64,30.850940007981194,0.669625946969697,36.036985018726575,135149.06367041127,1535.7848144364916,0
832,512,0,0,446,0.0,0.0,1.0,446,14350,10600,3750,0.7386759581881533,181,106,75,197.0685607566175,0.428226348230631,0.8916244167380087,0.14513650217871735,17860469.546896778,600397.405608865,18460866.952505644,831,16,544.1726457399103,92,354,66,30.659418907076,0.6700634057971014,35.864695340501775,135237.2759856623,1469.9703911485033,0
833,512,0,0,446,0.0,0.0,1.0,446,12450,8900,3550,0.714859437751004,160,89,71,192.64224155699068,0.4281623167229304,0.8881000684334357,0.14246937081366842,17878250.058738124,587171.2332863437,18465421.292024467,832,17,545.1726457399103,101,345,71,30.642357756566327,0.6688325082508251,35.73325163398693,135304.57516339893,1339.6492590435537,0
834,512,1,0,447,0.0022371364653243847,0.0,1.0,447,13350,9400,3950,0.704119850187266,173,94,79,195.11491117220226,0.4278878790006788,0.8889037191869071,0.1448415705498387,17894242.88233819,595536.7220962482,18489779.604434438,833,0,544.9507829977629,104,343,76,30.456535334584114,0.6692708333333333,35.615079365079374,135365.0793650799,1301.5873015873067,0
835,512,0,0,447,0.0,0.0,1.0,447,12500,8800,3700,0.704,162,88,74,196.03479763964395,0.42778463297920366,0.8904128932598256,0.14612762802731322,17911793.664214168,600366.9692654534,18512160.63347962,834,1,545.9507829977629,105,342,79,30.30005046377134,0.6703373015873015,35.48545597484276,135431.44654088002,1289.8233003893336,0
836,512,0,0,447,0.0,0.0,1.0,447,12850,9500,3350,0.7392996108949417,162,95,67,197.4971620700863,0.42756685493390584,0.8924341623139938,0.14796308420461218,17933159.205829944,606099.6100204942,18539258.81585044,835,2,546.9507829977629,81,366,81,30.10054195664349,0.6793981481481481,35.32774390243904,135512.19512195184,1672.9900632339734,0
837,512,1,0,448,0.002232142857142857,0.0,1.0,448,13800,9600,4200,0.6956521739130435,180,96,84,192.89853625980308,0.42753036529908384,0.888538654700876,0.14530319835175867,17956009.48252889,589337.5892493948,18545347.071778286,836,0,546.7276785714286,88,360,88,30.05043530139653,0.6785037878787878,35.15917602996255,135598.5018726594,1540.8920667347659,0
838,512,0,1,447,0.0,0.002232142857142857,0.9977678571428571,448,13100,9600,3500,0.732824427480916,166,96,70,190.71647434325243,0.42723803115345693,0.8878499350989737,0.1441836701012462,17971319.067215372,582785.3223593967,18554104.38957477,837,1,547.7276785714286,89,359,79,29.993192672840586,0.6793071161048689,35.0462962962963,135656.29629629635,1524.2280482729927,0
839,512,0,0,447,0.0,0.0,1.0,447,13600,9500,4100,0.6985294117647058,177,95,82,191.4433082589036,0.426900980795404,0.887443331036188,0.14533303284557259,17988662.570888497,585761.8147448027,18574424.3856333,838,2,549.6957494407159,91,356,69,29.843669912865174,0.679945054945055,34.91847826086957,135721.739130435,1491.4476827520327,0
840,512,0,1,446,0.0,0.0022371364653243847,0.9977628635346756,447,12900,8800,4100,0.6821705426356589,170,88,82,192.10368943211427,0.42670786475523587,0.8885220254376573,0.1466817073466042,18012877.770692326,589768.0554079412,18602645.826100267,839,3,550.6957494407159,96,351,71,29.644380119563305,0.6802300347222222,34.740120274914084,135813.0584192437,1414.7193585337884,0
841,512,0,0,446,0.0,0.0,1.0,446,14100,10300,3800,0.7304964539007093,179,103,76,197.21991338645952,0.4260310122436641,0.8911885186274859,0.1511292927442095,18027822.782174088,607789.1295293622,18635611.91170345,840,7,552.9237668161435,97,349,73,29.39647921172795,0.6810567010309279,34.630102040816325,135869.38775510198,1400.7153376814638,0
842,512,0,0,446,0.0,0.0,1.0,446,12400,9300,3100,0.75,155,93,62,197.56204716178544,0.4257136888866495,0.8915386403241781,0.15178662596567247,18038662.985110372,611151.0374799849,18649814.022590358,841,8,553.9237668161435,100,346,75,29.306052011293286,0.6810416666666667,34.5503300330033,135910.23102310218,1359.1023102310219,0
843,512,0,0,446,0.0,0.0,1.0,446,13750,10400,3350,0.7563636363636363,171,104,67,202.41707296791114,0.42523618179069883,0.8941685273092306,0.15605703367525997,18053056.790123384,627899.3827160472,18680956.172839433,842,9,554.9237668161435,104,342,77,29.069146617852173,0.6810897435897436,34.444444444444436,135964.4444444439,1307.3504273504223,0
844,512,0,0,446,0.0,0.0,1.0,446,12950,9500,3450,0.7335907335907336,164,95,69,187.57263552829767,0.4251475873767656,0.8882990632925805,0.13653901292562895,17810409.580498815,565999.0929705186,18376408.673469335,843,10,555.9237668161435,83,363,83,31.28761165961446,0.6694277108433735,36.23511904761904,135047.61904761865,1627.0797475616705,8
845,512,0,0,446,0.0,0.0,1.0,446,12400,8600,3800,0.6935483870967742,162,86,76,185.02400963640372,0.42502351320938514,0.8869117244187055,0.13522704119249634,17827706.004747253,558110.7295234634,18385816.734270718,844,11,556.9237668161435,85,361,79,31.22442090849284,0.6699754901960784,36.10707364341084,135113.1782945732,1589.566803465567,0
846,512,0,0,446,0.0,0.0,1.0,446,12600,9200,3400,0.7301587301587301,160,92,68,190.31634621246513,0.42486763322752386,0.8803091332320743,0.13540689321432375,17711392.84442869,572353.514497056,18283746.358925745,845,12,557.9237668161435,105,341,68,31.963436200154423,0.6553571428571429,36.96933962264152,134671.69811320805,1282.587601078172,8
847,512,0,0,446,0.0,0.0,1.0,446,11450,8100,3350,0.7074235807860262,148,81,67,189.5500761055823,0.424787436388371,0.8803872323233868,0.13532526629460576,17726355.428890258,571356.4041241487,18297711.833014406,846,13,558.9237668161435,111,335,69,31.870405223906964,0.6551238738738738,36.85825892857142,134728.57142857107,1213.7709137709105,0
848,512,0,0,446,0.0,0.0,1.0,446,14150,9800,4350,0.6925795053003534,185,98,87,191.66502358957757,0.4245377135083388,0.8813588278790199,0.13753062761389484,17748401.321312767,576999.5515853371,18325400.8728981,847,14,559.9237668161435,118,328,76,31.64803579343971,0.655367231638418,36.69467787114845,134812.32492997142,1142.477329915012,0
849,512,0,0,446,0.0,0.0,1.0,446,13250,9700,3550,0.7320754716981132,168,97,71,195.62110295214347,0.42439705413076706,0.8850201121227617,0.14095866688747452,17766567.684579123,592653.1132262495,18359220.797805373,848,15,560.9237668161435,122,324,82,31.406516218214527,0.6559938524590163,36.55995934959348,134881.3008130069,1105.5844328934993,0
850,512,0,0,446,0.0,0.0,1.0,446,14050,10700,3350,0.7615658362989324,174,107,67,197.31600243715633,0.4240134949026721,0.8874581258086807,0.14263128176171636,17780277.777777854,598416.6666666691,18378694.444444522,849,16,561.9237668161435,116,330,87,31.25823451910411,0.658135775862069,36.45833333333334,134933.33333333393,1163.218390804603,0
851,512,0,0,446,0.0,0.0,1.0,446,12050,8900,3150,0.7385892116182573,152,89,63,195.69215836998686,0.423793268504056,0.8847230477463257,0.14228499979186565,17805438.719605997,595626.9467528453,18401065.666358843,850,17,562.9237668161435,94,352,94,31.11097829702313,0.6653368794326241,36.2719298245614,135028.77192982432,1436.4762971257906,0
852,512,0,0,446,0.0,0.0,1.0,446,13350,9700,3650,0.7265917602996255,170,97,73,195.61254542254414,0.42351205471859726,0.8854912831672039,0.1430114333848918,17829075.385256145,594968.1637280763,18424043.548984222,851,18,563.9237668161435,97,349,80,30.934663820417818,0.6662371134020619,36.0969387755102,135118.3673469388,1392.9728592467916,0
853,512,1,0,447,0.0022371364653243847,0.0,1.0,447,12450,9000,3450,0.7228915662650602,159,90,69,193.5272808812072,0.4236146641118501,0.8841850355071799,0.14211047851226727,17847916.76939518,588961.7603550316,18436878.529750213,852,0,563.6599552572707,103,344,63,30.847589965354217,0.6660598705501618,35.95753205128206,135189.74358974394,1312.5217824246986,0
854,512,0,0,447,0.0,0.0,1.0,447,13500,9600,3900,0.7111111111111111,174,96,78,188.87175916140026,0.4232464060352525,0.8814741423430834,0.13927239284249376,17865764.501509156,571967.6740326685,18437732.175541826,853,1,564.6599552572707,106,341,72,30.83603577044025,0.6666666666666667,35.82554517133957,135257.32087227452,1276.0124610591936,0
855,512,1,0,448,0.002232142857142857,0.0,1.0,448,11350,7900,3450,0.6960352422907489,148,79,69,191.8404385161293,0.4232085014514754,0.8838444542812107,0.14227995966036866,17890336.45546376,585467.9981634535,18475804.453627214,854,0,564.3973214285714,109,339,78,30.57252113483308,0.6678134556574924,35.6439393939394,135350.30303030327,1241.7458993605806,0
856,512,0,0,448,0.0,0.0,1.0,448,12350,8500,3850,0.6882591093117408,162,85,77,191.35449017094624,0.42294196761478636,0.8850095908954048,0.14241123705368264,17905023.10540003,583291.3135665704,18488314.4189666,855,1,565.3973214285714,113,335,80,30.474805364567157,0.6680494100294985,35.53545321637428,135405.84795321696,1198.2818402939554,0
857,512,0,0,448,0.0,0.0,1.0,448,12000,9000,3000,0.75,150,90,60,192.4258917444767,0.4226666949637797,0.8871498483570175,0.14371214318041975,17919894.656658888,588050.3418549395,18507944.99851383,856,2,566.3973214285714,115,333,82,30.334550962223815,0.66875,35.42564655172416,135462.06896551838,1177.9310344827686,0
858,512,0,0,448,0.0,0.0,1.0,448,12000,8300,3700,0.6916666666666667,157,83,74,192.24662471195194,0.4225779543850538,0.8878420360555683,0.144306643612896,17941275.510204136,588229.9319727919,18529505.442176927,857,3,567.3973214285714,83,365,83,30.178471051152336,0.6792168674698795,35.26785714285715,135542.85714285757,1633.0464716006936,0
859,512,0,0,448,0.0,0.0,1.0,448,13000,9200,3800,0.7076923076923077,168,92,76,193.40038223460917,0.42234346286752955,0.8867659532533685,0.14597325983232148,17964432.71493349,592265.6307392134,18556698.3456727,858,4,568.3973214285714,87,361,82,29.973831493811154,0.679477969348659,35.097064393939405,135630.3030303035,1558.969000348316,0
860,512,0,0,448,0.0,0.0,1.0,448,13400,9800,3600,0.7313432835820896,170,98,72,194.7764911505589,0.42209919220064984,0.888189675030663,0.1478091550834925,17987125.899233393,597693.8537072061,18584819.7529406,859,5,569.3973214285714,91,357,65,29.76685639229421,0.6798305860805861,34.92980072463769,135715.9420289858,1491.3839783405033,0
861,512,0,1,447,0.0,0.002232142857142857,0.9977678571428571,448,11900,8300,3600,0.6974789915966386,155,83,72,190.97517446305372,0.4217911489959518,0.885575413875346,0.1453910066519662,18000574.001736138,586032.5520833347,18586606.553819474,860,6,570.3973214285714,95,353,69,29.76665439070304,0.6796052631578947,34.83072916666667,135766.6666666669,1429.1228070175462,0
862,512,0,1,446,0.0,0.0022371364653243847,0.9977628635346756,447,11250,7900,3350,0.7022222222222222,146,79,67,192.80986313957771,0.421417028654742,0.886399785958133,0.14735881037510304,18016782.437548272,594112.6711998478,18610895.10874812,861,7,572.4765100671141,95,352,73,29.59634511295625,0.680811403508772,34.711371527777786,135827.77777777813,1429.7660818713487,0
863,512,0,0,446,0.0,0.0,1.0,446,11950,9100,2850,0.7615062761506276,148,91,57,190.86783715740088,0.421112027846358,0.8850640161599261,0.1462740115754127,18028172.890521467,587049.6735027076,18615222.564024173,862,8,573.0313901345291,98,348,76,29.562418222909496,0.6808035714285714,34.62752525252527,135870.70707070778,1386.4357864357937,0
864,512,0,0,446,0.0,0.0,1.0,446,12250,8500,3750,0.6938775510204082,160,85,75,180.7785841279108,0.420800897700744,0.8816233757361027,0.1318410575513122,17818492.733931836,542790.3775467288,18361283.111478563,863,9,574.0313901345291,91,355,90,31.40588565583737,0.667239010989011,36.175271739130416,135078.26086956437,1484.3764930721359,8
865,512,0,0,446,0.0,0.0,1.0,446,12350,8200,4150,0.6639676113360324,165,82,83,179.69303889353668,0.4205568431836886,0.8803186135157433,0.1314937869448367,17833025.173611045,539344.0972222188,18372369.270833265,864,10,575.0313901345291,95,351,86,31.32502877816146,0.6671052631578948,36.06770833333332,135133.33333333282,1422.4561403508717,0
866,512,0,0,446,0.0,0.0,1.0,446,12450,8200,4250,0.6586345381526104,167,82,85,177.3528890300424,0.42045869652844253,0.8786507779001769,0.1302096734172103,17847139.196592957,531398.3394874148,18378537.53608037,865,11,576.0313901345291,100,346,66,31.28051638607868,0.6667708333333333,35.96328382838284,135186.7986798682,1351.867986798682,0
867,512,0,0,446,0.0,0.0,1.0,446,13550,9600,3950,0.7084870848708487,175,96,79,177.46758746042815,0.42015900807846696,0.8788837689785538,0.13078963330497706,17863369.33736458,531283.8120433358,18394653.149407916,866,12,577.0313901345291,104,342,68,31.15532792528886,0.6669671474358974,35.84325396825397,135248.25396825402,1300.463980463981,0
868,512,0,1,445,0.0,0.002242152466367713,0.9977578475336323,446,11700,8300,3400,0.7094017094017094,151,83,68,180.98950396931187,0.4199556817990964,0.8799109685444013,0.13388532421055951,17879324.798048995,546294.025301018,18425618.823350012,867,13,578.0313901345291,107,339,73,30.94221411192214,0.6674454828660437,35.725308641975296,135308.641975308,1264.5667474327852,0
869,512,0,0,445,0.0,0.0,1.0,445,12050,8600,3450,0.7136929460580913,155,86,69,166.29154677322785,0.41949906367041195,0.870828061787668,0.12115941206485353,17814368.17671673,491425.7677788004,18305793.94449553,868,16,580.3011235955056,98,347,98,31.819133660404432,0.6648596938775511,36.20580808080809,135062.62626262679,1378.190063904355,8
870,512,0,0,445,0.0,0.0,1.0,445,14450,10600,3850,0.7335640138408305,183,106,77,167.80829397198463,0.4191892735432061,0.8714524552967737,0.12284181519825631,17834593.122678652,495108.5291202404,18329701.651798893,869,17,581.3011235955056,100,345,89,31.626908148379677,0.6658333333333333,36.05610561056106,135139.2739273931,1351.392739273931,0
871,512,0,0,445,0.0,0.0,1.0,445,13550,10000,3550,0.7380073800738007,171,100,71,168.82367193364038,0.41894485777912743,0.8719901632133622,0.12391002539138501,17845839.722039007,500010.0381227707,18345849.760161776,870,18,582.3011235955056,102,343,73,31.5154939288314,0.666156045751634,35.97289644012946,135181.87702265425,1325.3125198299438,0
872,512,0,0,445,0.0,0.0,1.0,445,12750,9600,3150,0.7529411764705882,159,96,63,168.54527238560416,0.4188217009143975,0.870491516113457,0.12426073931007556,17864972.01741349,500461.31496723,18365433.33238072,871,19,583.3011235955056,107,338,79,31.37896752954348,0.6663746105919003,35.83140432098765,135254.3209876542,1264.059074650974,0
873,512,0,0,445,0.0,0.0,1.0,445,14350,10500,3850,0.7317073170731707,182,105,77,175.00256632239407,0.4184100533117387,0.8745159745395521,0.12963634407190475,17885232.400567647,522642.3138743528,18407874.714442,872,20,584.3011235955056,113,332,81,31.056013124992788,0.6665744837758112,35.68165204678362,135330.9941520464,1197.6194172747469,0
874,512,0,0,445,0.0,0.0,1.0,445,12800,8700,4100,0.6796875,169,87,82,175.53846616288826,0.418210134291595,0.8747301461810544,0.1306573144788561,17905568.34322828,526823.2005490108,18432391.54377729,873,21,585.3011235955056,117,328,88,30.88898578056677,0.667289886039886,35.53142655367231,135407.9096045195,1157.3325607223887,0
875,512,0,0,445,0.0,0.0,1.0,445,12150,8200,3950,0.6748971193415638,161,82,79,179.37106427064703,0.4178556365354118,0.8758784310782004,0.13396411589671128,17919954.48132226,541714.2613992661,18461668.742721524,874,22,586.3011235955056,121,324,93,30.679498660728683,0.6676136363636364,35.42520491803279,135462.2950819675,1119.523099850971,0
876,512,0,0,445,0.0,0.0,1.0,445,14150,9900,4250,0.6996466431095406,184,99,85,176.98150286192222,0.41777634375948985,0.8789626749764516,0.11909914661191168,17464040.99999996,515012.44444444234,17979053.444444403,875,23,587.3011235955056,99,346,74,34.189964372125154,0.6382575757575757,38.81249999999999,133727.99999999968,1350.7878787878756,8
877,512,0,0,445,0.0,0.0,1.0,445,13500,9800,3700,0.725925925925926,172,98,74,164.36758359353266,0.41818419543138646,0.8753934007314474,0.1048303293931964,17217515.37573579,463500.2795588276,17681015.655294616,876,24,588.3011235955056,110,335,81,36.39987033351423,0.6169507575757576,40.662537537537496,132780.78078077838,1207.0980070979854,8
878,512,2,0,447,0.0044742729306487695,0.0,1.0,447,12000,8600,3400,0.7166666666666667,154,86,68,161.4022644765273,0.41852133305243727,0.8739812046316866,0.10319484635846424,17229087.931468863,454762.7614008562,17683850.69286972,877,0,586.6644295302013,83,364,83,36.38822498406631,0.6255020080321285,40.57539682539682,132825.39682539666,1600.3059858481524,0
879,512,1,1,447,0.002232142857142857,0.002232142857142857,0.9977678571428571,448,11400,8300,3100,0.7280701754385965,145,83,62,159.87390124934788,0.41878697350724403,0.8726334294987363,0.10286086500335087,17258267.61491958,450829.314480495,17709096.929400075,878,0,586.3526785714286,88,360,88,36.20477220819803,0.6259469696969697,40.355805243445694,132937.82771535602,1510.6571331290456,0
880,512,0,0,447,0.0,0.0,1.0,447,12500,9200,3300,0.736,158,92,66,157.91794013320882,0.41884674612012324,0.8709725432306714,0.10205311985373887,17278791.34296718,443826.22737457993,17722617.57034176,879,1,588.5234899328859,90,357,72,36.09878025496418,0.6268518518518518,40.201465201465204,133016.84981684992,1477.9649979649992,0
881,512,0,0,447,0.0,0.0,1.0,447,13300,9900,3400,0.7443609022556391,167,99,68,156.02811555463214,0.4189290921372512,0.8694150030164116,0.10125810389963492,17298302.523853485,437104.30901815905,17735406.832871642,880,2,589.5234899328859,94,353,74,35.99894897428324,0.6271054964539007,40.05482456140351,133091.92982456135,1415.8715938783123,0
882,512,0,0,447,0.0,0.0,1.0,447,14050,9800,4250,0.697508896797153,183,98,85,156.53813216806938,0.4189171791347733,0.8690990763919204,0.10214291820464472,17323375.43595067,438903.7667179884,17762279.20266866,881,3,590.5234899328859,102,345,76,35.79442370992402,0.6268382352941176,39.86650485436894,133188.3495145636,1305.7681324957216,0
883,512,1,1,447,0.002232142857142857,0.002232142857142857,0.9977678571428571,448,13450,10000,3450,0.7434944237918215,169,100,69,157.48388489469517,0.41924492899089166,0.8693258052968817,0.1032129733326865,17343598.012426943,443217.43860978505,17786815.45103673,882,0,590.203125,110,338,80,35.615640923949655,0.6265151515151515,39.71471471471473,133266.06606606685,1211.5096915096985,0
884,512,0,0,447,0.0,0.0,1.0,447,14000,10600,3400,0.7571428571428571,174,106,68,156.97328283799914,0.4189318091378163,0.8690084338203103,0.10330831203856085,17362726.13574884,441696.8241091182,17804422.95985796,883,1,592.5123042505593,85,362,85,35.48318489062523,0.6349264705882354,39.57122093023252,133339.5348837193,1568.7004103966974,0
885,512,0,0,447,0.0,0.0,1.0,447,13600,10000,3600,0.7352941176470589,172,100,72,155.54651454441773,0.41883378811742794,0.867538565797169,0.10297742934420229,17389806.53355368,437984.75897919736,17827791.292532876,884,2,593.5123042505593,91,356,91,35.314169816238746,0.6349587912087913,39.3682065217391,133443.47826086805,1466.411849020528,0
886,512,0,0,447,0.0,0.0,1.0,447,12500,8900,3600,0.712,161,89,72,157.86561914541747,0.41883525111773223,0.8695532993245518,0.10474572837026012,17399961.973766968,447471.1540190866,17847433.127786055,885,3,594.5123042505593,92,355,86,35.176433522369194,0.6354166666666667,39.29211469534049,133482.4372759851,1450.8960573476643,0
887,512,0,0,447,0.0,0.0,1.0,447,11400,8200,3200,0.7192982456140351,146,82,64,156.7647824106563,0.4187681621037777,0.8688286797209441,0.10438536951765404,17416131.486303814,445247.2125771523,17861378.698880967,886,4,595.5123042505593,95,352,87,35.08212691017001,0.6357456140350877,39.171006944444414,133544.4444444429,1405.7309941520305,0
888,512,0,0,447,0.0,0.0,1.0,447,11100,7700,3400,0.6936936936936937,145,77,68,154.71657916180965,0.41882501011560214,0.867102792068444,0.10322148506459836,17424945.19066109,438685.5823962153,17863630.773057308,887,5,596.5123042505593,97,350,70,35.068539077884154,0.6358462199312716,39.10501700680269,133578.2312925154,1377.0951679640764,0
889,512,1,0,448,0.002232142857142857,0.0,1.0,448,12800,9400,3400,0.734375,162,94,68,151.71341417085205,0.4189147266498881,0.8644251589737961,0.10158405892323735,17441331.77186059,426816.79815910413,17868148.570019692,888,0,596.1785714285714,103,345,75,35.02238424149398,0.6355177993527508,38.98237179487179,133641.0256410254,1297.485685835198,0
890,512,0,0,448,0.0,0.0,1.0,448,12650,9000,3650,0.7114624505928854,163,90,73,153.80522639493248,0.418735997090391,0.8665257776766075,0.10349737694882476,17463806.66433749,434954.94754515134,17898761.611882642,889,1,597.1785714285714,106,342,80,34.797079031396414,0.6364976415094339,38.8142523364486,133727.10280373826,1261.5764415447006,0
891,512,0,0,448,0.0,0.0,1.0,448,12750,8900,3850,0.6980392156862745,166,89,77,153.5572752016356,0.4190522589418877,0.863627253831279,0.09763670015490729,17203229.43727777,425986.20741138404,17629215.644689154,890,2,598.1785714285714,121,327,85,36.789487335726726,0.6137224517906337,40.770150273224026,132725.6830601082,1096.906471571142,8
892,512,2,0,450,0.0044444444444444444,0.0,1.0,450,13100,9700,3400,0.7404580152671756,165,97,68,149.47259689546743,0.41962189639528175,0.8606695227110477,0.09538897902824155,17220371.860617716,411694.740302423,17632066.60092014,891,0,596.5155555555556,129,321,94,36.764319698467595,0.6136950904392765,40.64102564102561,132791.79487179258,1029.3937586960665,0
893,512,1,0,451,0.0022172949002217295,0.0,1.0,451,13650,10200,3450,0.7472527472527473,171,102,69,151.32833233850923,0.4200441405929211,0.8616272899979822,0.0968838146784073,17235337.442874,417788.9745043224,17653126.41737832,892,0,596.1906873614191,96,355,96,36.60180931490219,0.6217447916666667,40.52835051546394,132849.48453608368,1383.8487972508717,0
894,512,3,0,454,0.006607929515418502,0.0,1.0,454,13950,10300,3650,0.7383512544802867,176,103,73,148.74520942168698,0.4211411401555303,0.8622414056799901,0.09434849565122667,17191908.876532145,406692.81723965413,17598601.6937718,893,0,593.2444933920705,112,342,84,37.00080629861501,0.6145833333333333,40.85545722713859,132682.00589970167,1184.6607669616221,8
895,512,0,0,454,0.0,0.0,1.0,454,13350,9900,3450,0.7415730337078652,168,99,69,150.72594291711394,0.42125094815765673,0.8649502450559736,0.0960117273710919,17211768.913495548,414702.0197516081,17626470.933247156,894,1,594.2444933920705,115,339,87,36.79758297258295,0.6154891304347826,40.7058189655172,132758.62068965292,1154.4227886056776,0
896,512,0,2,452,0.0,0.004405286343612335,0.9955947136563876,454,12100,8800,3300,0.7272727272727273,154,88,66,155.10509392466454,0.42128549108083485,0.8683525246535462,0.09926009590421452,17233381.868170552,431697.06266044546,17665078.930830996,895,2,595.2444933920705,88,366,88,36.51876202935163,0.6240530303030303,40.543071161048715,132841.94756554422,1509.5675859720934,0
897,512,1,0,453,0.002207505518763797,0.0,1.0,453,13500,10200,3300,0.7555555555555555,168,102,66,155.19364940661603,0.4210200189493836,0.8681152769501017,0.09960998230088171,17247101.37174229,431228.120713314,17678329.4924556,896,0,597.5386313465783,89,364,89,36.41160557686019,0.6247659176029963,40.439814814814845,132894.8148148162,1493.200166458609,0
898,512,0,0,453,0.0,0.0,1.0,453,12300,8600,3700,0.6991869918699187,160,86,74,152.57266782990817,0.4209945821693463,0.8662317973111642,0.09827894166921668,17263730.320406597,423894.6783361077,17687624.998742703,897,1,598.5386313465783,93,360,86,36.35262865921314,0.6247759856630825,40.31471631205677,132958.86524822834,1429.6652177228852,0
899,512,0,0,453,0.0,0.0,1.0,453,13950,9800,4150,0.7025089605734767,181,98,83,154.42289995054776,0.42110650400151073,0.8680860355201758,0.0999321104049184,17285170.94490629,429295.24469068064,17714466.18959697,898,2,599.5386313465783,94,359,76,36.140883900188506,0.6261081560283688,40.15350877192985,133041.40350877322,1415.3340798805662,0
900,512,1,1,453,0.0022026431718061676,0.0022026431718061676,0.9977973568281938,454,13650,10300,3350,0.7545787545787546,170,103,67,153.93669340136864,0.42143642643431134,0.8676008117750516,0.10001634912580726,17303639.11278911,428282.9977666746,17731922.110555783,899,0,599.215859030837,98,356,79,36.012603369892226,0.6263818027210885,40.014730639730665,133112.45791245918,1358.2903868618284,0
901,512,0,1,452,0.0,0.002207505518763797,0.9977924944812362,453,12600,8500,4100,0.6746031746031746,167,85,82,154.61868438094263,0.42128211953088884,0.867306239896138,0.10064443198047934,17312126.10534424,432155.6324490645,17744281.737793304,900,1,601.523178807947,101,352,80,35.93013666352498,0.6262376237623762,39.950980392156886,133145.0980392168,1318.2682974179882,0
902,512,2,0,454,0.004405286343612335,0.0,1.0,454,13100,9300,3800,0.7099236641221374,169,93,76,154.65126093364836,0.4215984033673374,0.8682828366510638,0.10119397185035743,17336224.857600663,432313.80681144306,17768538.664412107,901,0,601.1850220264317,105,349,84,35.74555813602207,0.6270833333333333,39.770047169811335,133237.73584905732,1268.9308176100697,0
903,512,0,0,454,0.0,0.0,1.0,454,11950,8200,3750,0.6861924686192469,157,82,75,160.99184036004579,0.4215236447828638,0.8739135764356214,0.1056511376354625,17349645.114983007,455880.25933096383,17805525.374313973,902,1,602.1850220264317,108,346,84,35.47823134246172,0.6274112654320987,39.66934250764528,133289.29663608695,1234.1601540378422,0
904,512,2,0,456,0.0043859649122807015,0.0,1.0,456,12550,8900,3650,0.7091633466135459,162,89,73,155.65575939788778,0.4219159678041257,0.8698587121829346,0.10260573527656681,17370072.840790838,437000.3757659844,17807073.21655682,903,0,600.5394736842105,92,364,92,35.46154755761954,0.6331521739130435,39.516129032258064,133367.74193548382,1449.6493688639546,0
905,512,1,0,457,0.002188183807439825,0.0,1.0,457,12900,9600,3300,0.7441860465116279,162,96,66,150.9413450739124,0.42201875951731993,0.865440918595497,0.09991494167506215,17389180.809214566,420649.2682152643,17809830.07742983,904,0,600.2231947483589,98,359,98,35.43895505315569,0.6328656462585034,39.37289562289563,133441.0774410781,1361.6436473579397,0
906,512,0,0,457,0.0,0.0,1.0,457,13500,9900,3600,0.7333333333333333,171,99,72,152.09796290077944,0.4219679738185727,0.8655718777071608,0.10102406838664668,17404711.43577256,424544.23085138114,17829255.666623943,905,1,601.2231947483589,101,356,96,35.29068097550784,0.6332508250825082,39.256535947712415,133500.6535947712,1321.7886494531801,0
907,512,3,2,458,0.006521739130434782,0.004347826086956522,0.9956521739130435,460,13100,9200,3900,0.7022900763358778,170,92,78,151.20811837068328,0.42287808641975305,0.8658023862702657,0.10090389000331419,17425986.419753134,421890.1234567918,17847876.543209925,906,0,598.295652173913,104,356,74,35.15216041167599,0.6341145833333333,39.09722222222223,133582.2222222226,1284.444444444448,0
908,512,1,0,459,0.002178649237472767,0.0,1.0,459,11750,7600,4150,0.6468085106382979,159,76,83,148.8614102728149,0.4226855023102561,0.862821763729777,0.09971724846099979,17443278.81083564,415776.21671258076,17859055.02754822,907,0,600.2091503267974,109,350,81,35.082040933551,0.634269877675841,38.96780303030303,133648.48484848492,1226.1328885182104,0
909,512,2,1,460,0.004338394793926247,0.0021691973969631237,0.9978308026030369,461,12600,8700,3900,0.6904761904761905,165,87,78,147.987040618484,0.4234123990065705,0.862253729460305,0.09968323512273095,17468385.541351512,412218.9361294668,17880604.477480978,908,0,598.6008676789588,117,344,87,34.914296858279016,0.6345263532763532,38.78001412429379,133744.63276836197,1143.116519387709,0
910,512,0,0,460,0.0,0.0,1.0,460,13950,10200,3750,0.7311827956989247,177,102,75,149.39034236448302,0.4230855909191374,0.8630522157383447,0.10090330334071004,17480691.89263026,416339.3093216149,17897031.201951876,909,1,600.8913043478261,120,340,90,34.78426786145704,0.6348958333333333,38.688016528925615,133791.7355371899,1114.9311294765826,0
911,512,0,0,460,0.0,0.0,1.0,460,13550,10600,2950,0.7822878228782287,165,106,59,149.9976190854108,0.4230478000378895,0.8643079854495055,0.10175514159577893,17500277.777777825,419450.00000000134,17919727.777777825,910,2,601.8913043478261,122,338,96,34.6198539176627,0.6360143442622951,38.54166666666667,133866.66666666704,1097.2677595628445,0
912,512,1,1,460,0.0021691973969631237,0.0021691973969631237,0.9978308026030369,461,14300,11500,2800,0.8041958041958042,171,115,56,145.698161016625,0.4234487487817913,0.8606745340289677,0.09938197245063594,17524894.271433838,404168.9734717326,17929063.24490557,911,0,601.5835140997831,101,360,101,34.545765027322396,0.6423267326732673,38.35784313725487,133960.78431372374,1326.3443991457796,0
913,512,1,0,461,0.0021691973969631237,0.0,1.0,461,12800,9200,3600,0.71875,164,92,72,142.56636529002074,0.42367372441761764,0.8578913968467081,0.09782850381541447,17551620.41157363,395454.1454056298,17947074.55697926,912,0,601.3882863340564,105,356,93,34.42543160067551,0.6433531746031746,38.158411949685494,134062.89308175884,1276.7894579215128,0
914,512,0,2,459,0.0,0.004338394793926247,0.9956616052060737,461,13850,10300,3550,0.7436823104693141,174,103,71,144.38421177301723,0.42361438586563555,0.8578392318561321,0.09954144035026861,17572520.79699714,401388.9128278704,17973909.709825013,913,1,602.3882863340564,113,348,78,34.21972907148417,0.6431600294985251,38.002558479532134,134142.6900584778,1187.1034518449362,0
915,512,0,0,459,0.0,0.0,1.0,459,11650,8200,3450,0.703862660944206,151,82,69,143.37749593259034,0.42276280154630186,0.8568267063116319,0.0991093018930075,17584291.839611206,400788.3463422571,17985080.185953464,914,3,605.9847494553377,112,347,83,34.1571113690455,0.6442522321428572,37.91482300884951,134187.61061946632,1198.103666245235,0
916,512,1,0,460,0.002173913043478261,0.0,1.0,460,13350,9300,4050,0.6966292134831461,174,93,81,142.94897714010125,0.4229958992453664,0.8561448520893342,0.09914071816001417,17598989.38102753,397801.50614346727,17996790.887170997,915,0,605.6652173913044,115,345,87,34.05726990433131,0.6447463768115942,37.805316091953976,134243.67816091687,1167.3363318340598,0
917,512,1,0,461,0.0021691973969631237,0.0,1.0,461,11500,7800,3700,0.6782608695652174,152,78,74,139.48254055447265,0.4231673818730548,0.852515478127261,0.09703133255963135,17612469.766191546,387626.40568543796,18000096.171876986,916,0,605.349240780911,121,340,93,34.046359592013836,0.6446280991735538,37.70491803278684,134295.0819672105,1109.8767104728142,0
918,512,0,0,461,0.0,0.0,1.0,461,14100,10800,3300,0.7659574468085106,174,108,66,141.7876688222155,0.42309153855826964,0.8544098981731367,0.09899783635825406,17628711.48398624,393606.7811307556,18022318.265116997,917,1,606.349240780911,123,338,95,33.86327016240901,0.6454945799457994,37.584005376344045,134356.98924730916,1092.3332459130827,0
919,512,0,0,461,0.0,0.0,1.0,461,13900,9600,4300,0.6906474820143885,182,96,86,140.9496945403257,0.42286007890848504,0.853206963959489,0.09888228915134133,17649704.304589,391444.08609178197,18041148.390680782,918,2,607.349240780911,100,361,100,33.72685821647877,0.6519791666666667,37.42780528052807,134436.9636963706,1344.369636963706,0
920,512,0,0,461,0.0,0.0,1.0,461,12450,8700,3750,0.6987951807228916,162,87,75,138.18700078424928,0.42272489704171773,0.8504555529559465,0.09735446799812256,17668280.556582987,383655.3398257777,18051935.896408767,919,3,608.349240780911,103,358,103,33.659348113411404,0.6526092233009708,37.28966346153848,134507.69230769342,1305.8999253174118,0
921,512,0,0,461,0.0,0.0,1.0,461,13350,9700,3650,0.7265917602996255,170,97,73,139.42566371197728,0.42252664340281054,0.8521192618080595,0.0986103452852417,17685362.459057838,387608.67976820894,18072971.138826046,920,4,609.349240780911,104,357,101,33.498071890490934,0.6536458333333333,37.16269841269843,134572.69841269948,1293.9682539682642,0
922,512,0,0,461,0.0,0.0,1.0,461,13100,9300,3800,0.7099236641221374,169,93,76,137.11482324140678,0.4222260209374706,0.8504259321073351,0.09746733577024762,17707471.803078894,380291.37326627405,18087763.176345166,921,5,610.349240780911,107,354,85,33.39231577917947,0.654595015576324,36.99845679012347,134656.7901234575,1258.4746740510047,0
923,512,0,0,461,0.0,0.0,1.0,461,13100,9000,4100,0.6870229007633588,172,90,82,169.5372967991202,0.42215764406300105,0.8739423950724576,0.1137997560537812,17452537.746723115,486471.214372811,17939008.961095925,922,6,611.349240780911,107,354,80,34.4718902761873,0.6354166666666667,38.89853395061729,133683.9506172844,1249.382716049387,8
924,512,1,0,462,0.0021645021645021645,0.0,1.0,462,12500,8700,3800,0.696,163,87,76,188.13040599391454,0.4225850071837057,0.8875205254515595,0.12199447063287121,17294623.963155996,545828.9255401294,17840452.888696127,923,0,611.0238095238095,95,367,67,35.19262614455485,0.6265350877192982,40.0824652777778,133077.77777777883,1400.8187134503034,8
925,512,0,0,462,0.0,0.0,1.0,462,13800,10000,3800,0.7246376811594203,176,100,76,187.08726925912072,0.4226441866761823,0.8871049487624998,0.12187426075219207,17315734.816732597,541710.7084155234,17857445.52514812,924,1,612.0238095238095,103,359,70,35.0581850625177,0.6260113268608414,39.92387820512823,133158.9743589758,1292.805576300736,0
926,512,2,0,464,0.004310344827586207,0.0,1.0,464,13350,9300,4050,0.6966292134831461,174,93,81,180.53387654519764,0.42337675485961124,0.8816606643574856,0.11597366734524511,17251080.688143477,516730.89424491616,17767811.582388394,925,0,610.3814655172414,91,373,91,35.72339199779008,0.6244276556776557,40.40987318840583,132910.144927538,1460.5510431597581,8
927,512,1,0,465,0.002150537634408602,0.0,1.0,465,13300,9500,3800,0.7142857142857143,171,95,76,179.5590051782018,0.42352749196638245,0.8815056696840655,0.11605853626172269,17279591.909637526,514241.26663597056,17793833.176273495,926,0,610.0666666666667,96,369,68,35.53042202289918,0.6251085069444444,40.195446735395215,133019.93127147906,1385.6242840779069,0
928,512,0,0,465,0.0,0.0,1.0,465,13150,9700,3450,0.7376425855513308,166,97,69,179.36483575878145,0.42333109318996415,0.8812991481278449,0.1163074683433774,17294508.44444464,514255.33333334146,17808763.777777985,927,1,611.0666666666667,99,366,72,35.42134231056968,0.6254208754208754,40.083333333333364,133077.33333333486,1344.2154882155037,0
929,512,1,0,466,0.002145922746781116,0.0,1.0,466,13400,9900,3500,0.7388059701492538,169,99,70,182.83462958723518,0.4236263017828849,0.8835965823899463,0.11917293326107889,17318402.366864134,526680.7363576685,17845083.103221804,928,0,610.7532188841202,103,363,75,35.14838775929352,0.6262135922330097,39.90384615384619,133169.23076923256,1292.9051530993452,0
930,512,0,0,466,0.0,0.0,1.0,466,13100,9900,3200,0.7557251908396947,163,99,64,181.62759838620337,0.4238904079560663,0.8823062584263563,0.11863315111482867,17327997.456256237,523148.5125644203,17851145.968820658,929,1,611.7532188841202,108,358,77,35.106431824860465,0.6257716049382716,39.8318042813456,133206.11620795276,1233.3899648884515,0
931,512,1,0,467,0.0021413276231263384,0.0,1.0,467,12600,9600,3000,0.7619047619047619,156,96,60,182.8145876689537,0.42434014024317396,0.8828286748614507,0.11976731331691204,17341792.81663532,528066.5406427283,17869859.35727805,930,0,611.441113490364,114,353,79,34.970113802463985,0.6255482456140351,39.72826086956524,133259.13043478387,1168.939740655999,0
932,512,3,0,470,0.006382978723404255,0.0,1.0,470,13150,8900,4250,0.6768060836501901,174,89,85,181.94158550134372,0.4248470791936972,0.8843653681178569,0.11982511219097654,17365956.410371922,524767.9286100564,17890724.33898198,931,0,608.531914893617,85,385,85,34.808272876652836,0.635171568627451,39.546996124031,133351.93798449574,1568.8463292293618,0
933,512,1,0,471,0.0021231422505307855,0.0,1.0,471,15850,11800,4050,0.7444794952681388,199,118,81,182.35494750444744,0.42513382572164254,0.8849718875823747,0.12046248787370896,17379842.752738785,523810.0625622438,17903652.815301027,932,0,608.2377919320594,88,383,88,34.69149597220977,0.6351799242424243,39.442883895131075,133405.24344569238,1515.9686755192315,0
934,512,1,0,472,0.00211864406779661,0.0,1.0,472,13850,10200,3650,0.7364620938628159,175,102,73,177.36981469330615,0.4255243381673804,0.8815878889485262,0.11784279836590669,17405989.613474164,509209.43045910535,17915199.04393327,933,0,607.9470338983051,95,377,88,34.62198999902905,0.6349780701754386,39.24696180555556,133505.55555555565,1405.3216374269016,0
935,512,3,1,474,0.00631578947368421,0.002105263157894737,0.9978947368421053,475,12850,9600,3250,0.7470817120622568,161,96,65,176.73595358248613,0.4262687837737804,0.8813890396093325,0.11807718991028802,17431300.57288892,508297.50578649447,17939598.07867541,934,0,605.1010526315789,102,373,73,34.445650207994234,0.6350081699346406,39.0574433656958,133602.5889967643,1309.8293038898462,0
936,512,0,1,473,0.0,0.002109704641350211,0.9978902953586498,474,14250,10000,4250,0.7017543859649122,185,100,85,176.48135602146314,0.42595479374254763,0.882064557025543,0.11854051041967442,17455578.89323999,507066.8466437253,17962645.739883713,935,1,607.3776371308016,105,369,79,34.26743062873203,0.6361111111111111,38.875786163522015,133695.5974842768,1273.29140461216,0
937,512,1,1,473,0.002109704641350211,0.002109704641350211,0.9978902953586498,474,12750,9500,3250,0.7450980392156863,160,95,65,180.43379189414938,0.42597923226970913,0.884786637379056,0.12169644817952514,17474223.100513455,523038.0668859988,17997261.167399455,936,0,608.3691983122363,106,368,83,34.022291984946136,0.6372838050314465,38.73637071651091,133766.97819314693,1261.9526244636504,0
938,512,1,1,473,0.002109704641350211,0.002109704641350211,0.9978902953586498,474,14650,9900,4750,0.6757679180887372,194,99,95,178.85267768330743,0.42599475026984596,0.882297324152906,0.1211605104461633,17493997.060123272,516319.6435173942,18010316.703640666,937,0,608.9388185654009,110,364,91,33.91317549779819,0.6378787878787879,38.5885885885886,133842.6426426433,1216.7512967513028,0
939,512,0,0,473,0.0,0.0,1.0,473,12050,8300,3750,0.6887966804979253,158,83,75,183.37246843686307,0.4259010209505381,0.8858063546499277,0.12464794808577459,17509373.16215062,535497.3955051379,18044870.55765576,938,1,611.2135306553911,91,382,91,33.67806014950787,0.6440018315018314,38.47373188405794,133901.44927536088,1471.4444975314382,0
940,512,0,0,473,0.0,0.0,1.0,473,13700,9200,4500,0.6715328467153284,182,92,90,182.6120244311303,0.42574537003858054,0.886950581704063,0.12476239197980102,17532121.960984886,532015.2567737781,18064137.217758663,939,2,612.2135306553911,91,382,91,33.52500937423384,0.6457188644688645,38.3038949275362,133988.4057970999,1472.4000637043946,0
941,512,1,0,474,0.002109704641350211,0.0,1.0,474,13700,9800,3900,0.7153284671532847,176,98,78,179.89390320409132,0.4258811993945935,0.8862946872583839,0.12350066626126227,17553722.77551418,523061.5411699554,18076784.316684138,940,0,611.9198312236286,93,381,83,33.43207786711805,0.6467293906810037,38.14273049645388,134070.9219858146,1441.62281705177,0
942,512,1,2,473,0.002105263157894737,0.004210526315789474,0.9957894736842106,475,13300,9100,4200,0.6842105263157895,175,91,84,180.2360252620275,0.42610481900954916,0.8865087144089743,0.12437101290705427,17576552.00103906,525285.5740957183,18101837.57513478,941,0,611.6294736842106,96,379,73,33.24982923497267,0.6475694444444444,37.97250859106527,134158.07560137354,1397.4799541809743,0
943,512,0,0,473,0.0,0.0,1.0,473,12300,8400,3900,0.6829268292682927,162,84,78,178.39568439980758,0.42559587797565723,0.8854962687089596,0.12356765295582964,17593364.19753081,520816.04938271403,18114180.246913522,942,2,614.799154334038,98,375,76,33.17052980132452,0.6482780612244898,37.847222222222214,134222.2222222218,1369.614512471651,0
944,512,1,0,474,0.002109704641350211,0.0,1.0,474,13200,8900,4300,0.6742424242424242,175,89,86,180.8476775423563,0.42553357760709837,0.8871610876126705,0.12597772261141948,17618468.11308339,529251.8080210346,18147719.921104424,943,0,614.5,103,371,81,32.91590307473021,0.6488673139158576,37.660256410256395,134317.94871794787,1304.0577545431831,0
945,512,0,0,474,0.0,0.0,1.0,474,13750,9700,4050,0.7054545454545454,178,97,81,181.51344314181765,0.42549194848098293,0.888085330885019,0.12691153774049996,17634862.75940094,531642.9317584501,18166505.69115939,944,1,615.5,108,366,84,32.77419227594906,0.6489197530864197,37.538226299694166,134380.42813455535,1244.263223468105,0
946,512,0,0,474,0.0,0.0,1.0,474,14550,10900,3650,0.7491408934707904,182,109,73,182.53978134723695,0.42525499698188834,0.8880523283474415,0.1282350536590274,17655733.8439312,535224.7590792484,18190958.60301045,945,2,616.5,88,386,88,32.58915307365483,0.6560132575757576,37.382958801498155,134459.9250936342,1527.9536942458433,0
947,512,0,0,474,0.0,0.0,1.0,474,14100,9700,4400,0.6879432624113475,185,97,88,178.41842052922,0.4250952637948517,0.8858799403269346,0.1260966813041462,17682175.71716721,522065.1725954264,18204240.889762636,946,3,617.5,92,382,87,32.49730082963972,0.6567028985507246,37.18637992831544,134560.57347670378,1462.6149290946064,0
948,512,0,0,474,0.0,0.0,1.0,474,13250,9400,3850,0.7094339622641509,171,94,77,176.99974415064193,0.42483982078661203,0.8848852011139154,0.1254576646293011,17694887.991403215,518348.1294505338,18213236.12085375,947,4,618.5,96,378,87,32.43845818696732,0.6564670138888888,37.09192439862546,134608.9347079052,1402.1764032073459,0
949,512,0,0,474,0.0,0.0,1.0,474,13350,9300,4050,0.6966292134831461,174,93,81,178.93053524770397,0.42458623622150266,0.8849159933524016,0.1274643479327634,17716814.21042915,525865.8099112489,18242680.020340398,948,5,619.5,103,371,70,32.22194460308398,0.65625,36.92908653846156,134692.30769230888,1307.6923076923192,0
950,512,0,0,474,0.0,0.0,1.0,474,13550,9300,4250,0.6863468634686347,178,93,85,184.19871663040163,0.4245355936462059,0.8874104947675971,0.13181047680309638,17736461.787728406,545056.6997727501,18281518.487501156,949,6,620.5,108,366,74,31.934838252913632,0.6565393518518519,36.78325688073396,134766.972477065,1247.8423377506017,0
951,512,1,0,475,0.002105263157894737,0.0,1.0,475,11850,8200,3650,0.6919831223628692,155,82,73,182.84388771157413,0.4245364201643349,0.8868206084389096,0.13120802561154374,17748635.21178841,542195.8927395879,18290831.104527995,950,0,620.1915789473684,110,365,79,31.87853434552236,0.6570075757575757,36.69294294294295,134813.21321321357,1225.5746655746689,0
952,512,0,0,475,0.0,0.0,1.0,475,13400,9400,4000,0.7014925373134329,174,94,80,187.13437438118999,0.4244884891553779,0.8898351820854926,0.13485534613659994,17766951.731569607,556561.4793896175,18323513.210959226,951,1,621.1915789473684,115,360,82,31.627190067150718,0.6573369565217391,36.55711206896552,134882.75862069,1172.8935532233913,0
953,512,1,0,476,0.0021008403361344537,0.0,1.0,476,14400,10400,4000,0.7222222222222222,184,104,80,188.5845491034478,0.42459328468229396,0.8922626284217987,0.1365238029764016,17786740.689361427,561260.8945846289,18348001.583946057,952,0,620.8844537815127,86,390,86,31.439548792489976,0.6665455426356589,36.41044061302679,134957.85440612913,1569.277376815455,0
954,512,0,0,476,0.0,0.0,1.0,476,13050,9200,3850,0.7049808429118773,169,92,77,186.16934956301876,0.4244820691434468,0.8903550930094211,0.13520867998387737,17800586.042523906,554534.7050754412,18355120.74759935,953,1,621.8844537815127,89,387,89,31.39873114456683,0.6665496254681649,36.30787037037035,135010.37037036958,1516.9704535996582,0
955,512,0,0,476,0.0,0.0,1.0,476,13100,9400,3700,0.7175572519083969,168,94,74,185.78859559478335,0.42429548135043493,0.8899311804029346,0.13542202408846887,17816182.410341445,553708.7017755604,18369891.112117007,954,2,622.8844537815127,93,383,93,31.291131087400935,0.6664426523297491,36.19237588652481,135069.50354609863,1452.3602531838562,0
956,512,0,0,476,0.0,0.0,1.0,476,13700,9700,4000,0.708029197080292,177,97,80,183.44054663904208,0.4239155793896506,0.8892692858733249,0.13438237567061806,17837693.669304375,545531.2554953916,18383224.924799766,955,3,623.8844537815127,97,379,63,31.190941182787014,0.6668814432989691,36.03316326530611,135151.0204081626,1393.3094887439445,0
957,512,0,0,476,0.0,0.0,1.0,476,13650,9700,3950,0.7106227106227107,176,97,79,179.70773573189223,0.4236734298982751,0.8877900918293287,0.1324129610922094,17862479.27763063,533155.1411081656,18395634.418738797,956,4,624.8844537815127,100,376,71,31.102852178666215,0.6679166666666667,35.84983498349833,135244.88448844806,1352.4488448844806,0
958,512,0,0,476,0.0,0.0,1.0,476,13750,10200,3550,0.7418181818181818,173,102,71,168.91048091313132,0.4235288589119859,0.8842737468935842,0.11706992078838725,17596105.77128436,485483.33760518656,18081589.108889546,957,5,625.8844537815127,101,375,76,33.398417212007836,0.6476897689768977,37.826797385620885,134232.67973856063,1329.0364330550558,8
959,512,0,1,475,0.0,0.0021008403361344537,0.9978991596638656,476,12800,9100,3700,0.7109375,165,91,74,170.45468043921528,0.4233772851245761,0.8857719712721224,0.11871348015457286,17617554.31450468,492598.9181598721,18110153.23266455,958,6,626.8844537815127,105,371,80,33.19547199850155,0.6483134920634921,37.66705974842763,134314.46540880282,1279.185384845741,0
960,512,0,2,473,0.0,0.004210526315789474,0.9957894736842106,475,13200,9500,3700,0.7196969696969697,169,95,74,172.47496003853118,0.423338700125842,0.8880786568484884,0.12066282035204273,17637454.63728162,500203.8567493006,18137658.49403092,959,7,627.2084210526316,109,366,82,32.99179835004929,0.6488914373088686,37.518939393939355,134390.3030303008,1232.9385599110165,0
961,512,0,0,473,0.0,0.0,1.0,473,13650,9600,4050,0.7032967032967034,177,96,81,170.32989566574994,0.42307186966233085,0.8854776036999161,0.11953268192196634,17651138.12126963,493053.302915524,18144191.424185153,960,8,629.2177589852008,87,386,87,32.944569039354455,0.6560105363984674,37.41714015151517,134442.42424242513,1545.3152211773004,0
962,512,0,0,473,0.0,0.0,1.0,473,13500,9200,4300,0.6814814814814815,178,92,86,169.89545885446677,0.4229499991041674,0.8852826046747433,0.11976168831780568,17670782.648365226,492337.1452723176,18163119.793637544,961,9,630.2177589852008,90,383,90,32.807416928081814,0.6564814814814814,37.2710622710623,134517.21611721735,1494.6357346357483,0
963,512,0,0,473,0.0,0.0,1.0,473,12300,8400,3900,0.6829268292682927,162,84,78,171.32844802108693,0.42294701299554477,0.8859285274411208,0.12112750927432472,17683682.924166095,499043.59013888024,18182726.514304973,962,10,631.2177589852008,92,381,88,32.67224234675762,0.6568161231884058,37.17517921146956,134566.30824372888,1462.6772635187922,0
964,512,0,0,473,0.0,0.0,1.0,473,13900,9700,4200,0.697841726618705,181,97,84,172.0133743462543,0.42274209129131285,0.886677534174326,0.12199670817654121,17697520.49861508,500342.0437057609,18197862.54232084,963,11,632.2177589852008,94,379,63,32.549661509376264,0.6572473404255319,37.07236842105265,134618.94736842197,1432.116461366191,0
965,512,1,0,474,0.002109704641350211,0.0,1.0,474,12100,8500,3600,0.7024793388429752,157,85,72,169.523679690674,0.4225555154131839,0.8851674940919065,0.12077067787272232,17717084.027777936,493793.055555562,18210877.0833335,964,0,631.8818565400844,99,375,68,32.467374447304174,0.6573021885521886,36.92708333333336,134693.33333333457,1360.538720538733,0
966,512,0,0,474,0.0,0.0,1.0,474,12550,8900,3650,0.7091633466135459,162,89,73,169.72790233604428,0.4224398273283319,0.8853119101047056,0.12121808723379224,17727952.496903054,494435.6380024838,18222388.13490554,965,1,632.8818565400844,101,373,70,32.37995446548692,0.6575907590759076,36.846405228758194,134734.64052287702,1334.0063418106636,0
967,512,0,0,474,0.0,0.0,1.0,474,12200,8500,3700,0.6967213114754098,159,85,74,169.57154284622067,0.4223669763576299,0.8851997994941996,0.12164204410920548,17747143.3339268,494882.09524940205,18242025.429176204,966,2,633.8818565400844,105,369,74,32.239258699411565,0.6580357142857143,36.704009433962284,134807.54716981234,1283.8814016172605,0
968,512,0,0,474,0.0,0.0,1.0,474,14100,10100,4000,0.7163120567375887,181,101,80,168.43815304221474,0.422120453876415,0.8847320182909952,0.1211778631165888,17759651.754902948,489380.5880537614,18249032.34295671,967,3,634.8818565400844,108,366,77,32.1747668807373,0.658275462962963,36.611238532110114,134855.04587156087,1248.657832144082,0
969,512,0,0,474,0.0,0.0,1.0,474,12800,9300,3500,0.7265625,163,93,70,169.15704911444644,0.422252775027282,0.886418610479816,0.12213819100988799,17775389.22495285,493766.4776307539,18269155.702583604,968,4,635.8818565400844,114,360,79,32.03718504004675,0.6581688596491229,36.49456521739132,134914.7826086965,1183.4630053394428,0
970,512,0,0,474,0.0,0.0,1.0,474,12300,8900,3400,0.7235772357723578,157,89,68,151.48853655773624,0.4222691293268273,0.8718620989912924,0.1047037520517418,17583770.37143828,425647.92814729206,18009418.299585573,969,5,636.8818565400844,101,373,76,33.948478029328854,0.6467615511551155,37.91870915032679,134185.62091503225,1328.5705041092303,8
971,512,0,0,474,0.0,0.0,1.0,474,13550,9900,3650,0.7306273062730627,172,99,73,153.90371726927253,0.42206869623524024,0.8735365999767839,0.10685225396110733,17603722.37463792,433505.66224660526,18037228.036884524,970,6,637.8818565400844,107,367,78,33.73424550046589,0.6468068535825545,37.77006172839505,134261.728395061,1254.7825083650562,0
972,512,0,0,474,0.0,0.0,1.0,474,14850,11300,3550,0.7609427609427609,184,113,71,152.0450284572058,0.4220556871333292,0.8717544701167326,0.10595914701609818,17620356.348961882,426167.5165007973,18046523.86546268,971,7,638.8818565400844,113,361,84,33.65723971394074,0.6467551622418879,37.64619883040933,134325.14619882894,1188.7181079542383,0
973,512,0,0,474,0.0,0.0,1.0,474,12700,9100,3600,0.7165354330708661,163,91,72,155.53634464864894,0.42192782624597464,0.8747482617822007,0.10869994185247538,17632882.074116513,441010.8046857501,18073892.878802262,972,8,639.8818565400844,117,357,86,33.47096087005267,0.6469017094017093,37.5529661016949,134372.88135593128,1148.48616543531,0
974,512,0,0,474,0.0,0.0,1.0,474,12250,8500,3750,0.6938775510204082,160,85,75,158.9854165726908,0.42193553878496476,0.8776902990490385,0.11149084808722359,17647955.4422063,454103.5095270958,18102058.951733395,973,9,640.8818565400844,87,387,87,33.26650624408278,0.6557710727969348,37.44081439393942,134430.30303030417,1545.175896900048,0
975,512,0,0,474,0.0,0.0,1.0,474,13450,9500,3950,0.7063197026022305,174,95,79,158.61761806474505,0.4219906416237738,0.8774402977679223,0.11184204883598972,17671970.99480158,452367.18914094014,18124338.183942523,974,10,641.8818565400844,91,383,91,33.09474430797964,0.65625,37.26222826086958,134521.7391304353,1478.2608695652232,0
976,512,0,0,474,0.0,0.0,1.0,474,13400,9500,3900,0.7089552238805971,173,95,78,156.56216916504945,0.42170063157331333,0.8763026387850563,0.110925962408429,17693092.520775687,445813.7888581129,18138906.3096338,975,11,642.8818565400844,94,380,85,32.989326131687235,0.6569148936170213,37.10526315789475,134602.1052631584,1431.9372900335998,0
977,512,0,0,474,0.0,0.0,1.0,474,12600,9200,3400,0.7301587301587301,160,92,68,157.13315784103608,0.42158670900943496,0.8770065209052558,0.11194719794374391,17717227.197001353,449392.7715303854,18166619.96853174,976,12,643.8818565400844,97,377,74,32.79225589225594,0.657860824742268,36.92602040816328,134693.8775510212,1388.5966757837236,0
978,512,0,0,474,0.0,0.0,1.0,474,13900,9600,4300,0.6906474820143885,182,96,86,159.6143973615762,0.4213587709595216,0.8789948631481479,0.11434626698440256,17741333.22985779,457654.44237493625,18198987.67223273,977,13,644.8818565400844,100,374,77,32.545217107411005,0.6588541666666667,36.74711221122114,134785.47854785595,1347.8547854785595,0
979,512,1,0,475,0.002105263157894737,0.0,1.0,475,14150,10000,4150,0.7067137809187279,183,100,83,160.87844925646377,0.42126896883559106,0.8789983009864863,0.11588080531891129,17764947.75022976,462449.44903582026,18227397.19926558,978,0,644.5221052631579,109,366,81,32.33398039638605,0.6584480122324159,36.571969696969724,134875.151515153,1237.3867111481927,0
980,512,0,1,474,0.0,0.002105263157894737,0.9978947368421053,475,13600,10400,3200,0.7647058823529411,168,104,64,163.1444087705318,0.42095417869568436,0.8815647318752478,0.11820139363633858,17790200.730488177,471874.3560169122,18262075.08650509,979,1,645.5221052631579,84,391,84,32.08406939085432,0.6675347222222222,36.38480392156861,134970.98039215614,1606.7973856209064,0
981,512,0,0,474,0.0,0.0,1.0,474,16050,12400,3650,0.7725856697819314,197,124,73,159.68848926638364,0.4206238496237024,0.8786835577843393,0.11623836544273893,17810296.67971203,457969.87403385685,18268266.55374589,980,2,647.7658227848101,88,386,88,32.02394687019289,0.6676136363636364,36.235955056179755,135047.191011235,1534.627170582216,0
982,512,0,0,474,0.0,0.0,1.0,474,12000,8900,3100,0.7416666666666667,151,89,62,157.87223849146682,0.42036849953761934,0.8770423522109954,0.1154903308157221,17831700.80677264,456226.10449505434,18287926.911267698,981,3,648.7658227848101,92,382,84,31.91090551570964,0.6679121376811594,36.077508960573454,135128.31541218533,1468.786037088971,0
983,512,0,0,474,0.0,0.0,1.0,474,13950,10600,3350,0.7598566308243727,173,106,67,158.0411270662022,0.4202058857637309,0.877450436702992,0.11606551939253382,17848401.385041386,455406.29424437607,18303807.67928576,982,4,649.7658227848101,94,380,71,31.78093379289342,0.6685505319148937,35.95394736842103,135191.57894736718,1438.2082866741189,0
984,512,0,0,474,0.0,0.0,1.0,474,14200,10100,4100,0.7112676056338029,183,101,82,183.33201544276454,0.4198648614493478,0.885162677091345,0.12622526051045582,17566611.143787403,535104.4450979655,18101715.588885367,983,5,650.7658227848101,100,374,70,33.24417299893695,0.6457291666666667,38.046617161716135,134120.13201319944,1341.2013201319944,7
985,512,0,0,474,0.0,0.0,1.0,474,12050,8600,3450,0.7136929460580913,155,86,69,185.70323329530058,0.4198288076526228,0.8864995832337148,0.12839816070213245,17585375.686570678,546282.2247417391,18131657.911312416,984,6,651.7658227848101,104,370,73,33.03958956306696,0.6461338141025641,37.906746031745996,134191.74603174414,1290.3052503052322,0
986,512,1,0,475,0.002105263157894737,0.0,1.0,475,14300,10500,3800,0.7342657342657343,181,105,76,184.31407081369406,0.4197642312532386,0.8861944522625662,0.12765456015614887,17592928.640055582,539224.8590366822,18132153.499092266,985,0,651.3915789473684,106,369,75,33.01868253614572,0.6462264150943396,37.85046728971958,134220.5607476611,1266.2317051666141,0
987,512,0,0,475,0.0,0.0,1.0,475,13000,9000,4000,0.6923076923076923,170,90,80,183.78566280932665,0.4196409800873491,0.8872764509831776,0.1278302407872454,17611754.435185675,539357.5924211285,18151112.027606804,986,1,652.3915789473684,108,367,79,32.88973499477758,0.6471836419753086,37.710244648318,134292.35474005892,1243.4477290746197,0
988,512,0,0,475,0.0,0.0,1.0,475,13700,9600,4100,0.7007299270072993,178,96,82,184.35945207929282,0.41949293063883336,0.888925154507668,0.12862162356435652,17625266.23576464,541176.8851954378,18166443.12096008,987,2,653.3915789473684,113,362,80,32.77223499094583,0.6471238938053097,37.60964912280699,134343.8596491212,1188.8837137090372,0
989,512,1,0,476,0.0021008403361344537,0.0,1.0,476,14150,9600,4550,0.6784452296819788,187,96,91,187.32070282242384,0.41965677060297807,0.8910985903025856,0.12500789759782038,17426183.79357156,543506.999144904,17969690.792716466,988,0,653.0168067226891,93,383,65,34.20846783327669,0.6370967741935484,39.095744680851034,133582.9787234028,1436.3761153054065,8
990,512,0,0,476,0.0,0.0,1.0,476,14000,10300,3700,0.7357142857142858,177,103,74,187.1777071767713,0.41984400339083,0.8915520647900013,0.12535486981749333,17442224.151234377,543759.1049382635,17985983.256172642,989,1,654.0168067226891,95,381,68,34.089901341314686,0.637719298245614,38.975694444444414,133644.44444444295,1406.7836257309784,0
991,512,0,0,476,0.0,0.0,1.0,476,15100,11500,3600,0.7615894039735099,187,115,72,188.6525624193127,0.4199180856553148,0.8935934008122586,0.1270588535783156,17467800.949927114,548769.081806847,18016570.03173396,990,2,655.0168067226891,102,374,69,33.85648560403676,0.637765522875817,38.78438511326859,133742.3948220057,1311.19994923535,0
992,512,0,0,476,0.0,0.0,1.0,476,12950,9400,3550,0.7258687258687259,165,94,71,187.5926600837201,0.4199822165708389,0.8919624057020288,0.12689090817000823,17487248.012926873,547945.874457739,18035193.887384612,991,3,656.0168067226891,106,370,79,33.73607851901514,0.6382665094339622,38.63901869158878,133816.82242990637,1262.4228531123242,0
993,512,1,0,477,0.0020964360587002098,0.0,1.0,477,12400,8000,4400,0.6451612903225806,168,80,88,187.6880982589613,0.4202559692640159,0.8926180955198619,0.12751181108521198,17506918.619299583,549368.0524061482,18056286.67170573,992,0,655.6394129979036,83,394,83,33.58387076378351,0.6465863453815262,38.492063492063494,133892.06349206358,1613.1573914706455,0
994,512,1,0,478,0.0020920502092050207,0.0,1.0,478,13600,9400,4200,0.6911764705882353,178,94,84,183.9268821236924,0.42058304752214126,0.8905497868275893,0.12560284760297857,17530059.476216532,535649.8365806798,18065709.31279721,993,0,655.2656903765691,88,390,88,33.506276649670546,0.6465435606060606,38.31928838951311,133980.52434456933,1522.505958461015,0
995,512,0,1,477,0.0,0.0020920502092050207,0.997907949790795,478,13100,9000,4100,0.6870229007633588,172,90,82,183.3540679059314,0.42038568429485773,0.8903600309451016,0.1255936495425914,17543687.37997262,534641.2894375883,18078328.66941021,994,1,656.2656903765691,89,389,83,33.41770566215697,0.6472378277153559,38.2175925925926,134032.59259259302,1505.9841864336295,0
996,512,2,1,478,0.0041753653444676405,0.0020876826722338203,0.9979123173277662,479,10950,7700,3250,0.7031963470319634,142,77,65,179.45181103982452,0.4204962686675809,0.8878705230326924,0.12360927457730311,17568614.034770407,523793.9211998439,18092407.95597025,995,0,655.7265135699374,95,384,69,33.33061515415098,0.6472587719298246,38.03168402777777,134127.77777777746,1411.8713450292364,0
997,512,0,1,477,0.0,0.0020920502092050207,0.997907949790795,478,12350,8700,3650,0.7044534412955465,160,87,73,180.92203225703918,0.42011504083225876,0.8888696482296958,0.12500626486978442,17582315.27733495,528255.6423518857,18110570.919686835,996,1,658.0983263598326,96,382,71,33.18812148281701,0.6480034722222222,37.92955326460481,134180.06872852243,1397.7090492554419,0
998,512,0,0,477,0.0,0.0,1.0,477,14450,10800,3650,0.7474048442906575,181,108,73,182.64893570344157,0.42003153462642917,0.8890978846415798,0.126594256771145,17596188.852611452,532935.0332732502,18129123.885884702,997,2,660.4716981132076,98,379,73,33.037601503658806,0.6484906462585034,37.82617845117846,134232.99663299695,1369.7244554387444,0
999,512,0,0,477,0.0,0.0,1.0,477,12850,9200,3650,0.7159533073929961,165,92,73,183.7446601078051,0.41995904756032393,0.8893013865429684,0.1276849835526209,17607707.10059166,538814.431295198,18146521.531886857,998,3,661.4716981132076,103,374,75,32.92150422649962,0.6480582524271845,37.740384615384606,134276.92307692263,1303.6594473487635,0
1000,512,1,0,478,0.0020920502092050207,0.0,1.0,478,12900,9300,3600,0.7209302325581395,165,93,72,185.76574214786626,0.42015350838720616,0.8919662589948569,0.12962058404457227,17625874.388612837,546356.7273611401,18172231.115973976,999,0,661.0857740585774,108,370,78,32.730724405433925,0.6482445987654322,37.605122324159,134346.17737002927,1243.9460867595303,0
1001,512,0,0,478,0.0,0.0,1.0,478,13850,9100,4750,0.6570397111913358,186,91,95,175.5950507313306,0.42016757965433654,0.8889297800053673,0.11572463885671228,17369094.14864714,500535.3936377859,17869629.54228493,1000,1,662.0857740585774,86,392,86,34.94962843790697,0.6350532945736433,39.52346743295017,133363.98467432856,1550.7440078410298,8
1002,512,1,0,479,0.0020876826722338203,0.0,1.0,479,14150,9500,4650,0.6713780918727915,188,95,93,173.25095414215718,0.42044840774160486,0.8875949797696239,0.11496473977168001,17400384.50430575,492976.6435622736,17893361.147868022,1001,0,661.7014613778706,91,388,84,34.77210544601752,0.6357600732600732,39.288949275362306,133484.05797101397,1466.8577799012523,0
1003,512,0,0,479,0.0,0.0,1.0,479,13350,9500,3850,0.7116104868913857,172,95,77,171.6865196169395,0.4203392193173248,0.8870090839209697,0.11429080319611346,17414916.175280344,488831.2695109242,17903747.44479127,1002,1,662.7014613778706,92,387,83,34.702181568324306,0.6365489130434783,39.18010752688171,133539.7849462363,1451.519401589525,0
1004,512,0,0,479,0.0,0.0,1.0,479,13400,9500,3900,0.7089552238805971,173,95,78,169.47047635266543,0.4203621488864237,0.8855348301945267,0.1132611026879271,17432822.43767313,481669.7445367798,17914492.18220991,1003,2,663.7014613778706,94,385,72,34.623653654915444,0.6373005319148937,39.046052631578945,133608.42105263157,1421.3661814109741,0
1005,512,1,0,480,0.0020833333333333333,0.0,1.0,480,13500,9500,4000,0.7037037037037037,175,95,80,166.5010310864575,0.4209054598700997,0.8834589688436978,0.11186104479455387,17456557.841001336,471806.9759494221,17928364.816950757,1004,0,663.3166666666667,101,379,76,34.520597053839154,0.6371699669966997,38.868464052287585,133699.34640522886,1323.755905002266,0
1006,512,1,1,480,0.002079002079002079,0.002079002079002079,0.997920997920998,481,12450,8000,4450,0.642570281124498,169,80,89,165.16679673669753,0.42104051166551165,0.8827082512955837,0.11145824344252095,17476606.542462774,468661.02408923913,17945267.566552013,1005,0,662.935550935551,105,376,80,34.4030515019307,0.6376984126984127,38.718553459119505,133776.10062893125,1274.0581012279167,0
1007,512,0,0,480,0.0,0.0,1.0,480,13800,10500,3300,0.7608695652173914,171,105,66,168.23085883618467,0.42104192037810256,0.885332727017903,0.11386493986707555,17490044.819459785,478673.0522122215,17968717.871672004,1006,1,665.23125,108,372,80,34.22086943804618,0.6380208333333333,38.61811926605507,133827.52293578093,1239.1437308868606,0
1008,512,1,0,481,0.002079002079002079,0.0,1.0,481,13500,10100,3400,0.7481481481481481,169,101,68,167.64795893176534,0.421308868965119,0.8852514172291155,0.11406153610075481,17513404.421376437,477517.30103806464,17990921.7224145,1007,0,664.8461538461538,84,397,84,34.05868825063642,0.6467013888888888,38.4436274509804,133916.86274509836,1594.2483660130758,0
1009,512,1,0,482,0.002074688796680498,0.0,1.0,482,15300,11400,3900,0.7450980392156863,192,114,78,159.11431511254864,0.4215595463002102,0.8757333708886115,0.10343603315105333,17306123.27439605,439030.39041178144,17745153.664807834,1008,0,664.4647302904565,105,377,79,35.85903444452844,0.6248015873015873,39.996069182389974,133122.01257861836,1267.8286912249368,8
1010,512,2,0,484,0.004132231404958678,0.0,1.0,484,14350,10400,3950,0.7247386759581882,183,104,79,157.094453980124,0.42212069880054065,0.8740119718611781,0.10262051402481562,17328517.727368362,433292.80613317154,17761810.533501536,1009,0,662.7148760330579,114,370,86,35.740739128921106,0.6245431286549707,39.82789855072466,133208.11594203024,1168.4922451055284,0
1011,512,1,0,485,0.002061855670103093,0.0,1.0,485,12850,9100,3750,0.708171206225681,166,91,75,155.04583207215447,0.42229026440600953,0.8732798079659849,0.10166698805578149,17345941.690401785,428033.1924926873,17773974.88289447,1010,0,662.3463917525773,118,367,91,35.661241326742186,0.6250882768361582,39.69712885154063,133275.07002801224,1129.4497460001037,0
1012,512,0,0,485,0.0,0.0,1.0,485,15550,10900,4650,0.7009646302250804,202,109,93,152.88179405197218,0.4221498608389424,0.8719871000242325,0.10050457780243544,17357667.755693886,418184.2774097164,17775852.033103604,1011,1,663.3463917525773,120,365,94,35.62825789885501,0.6256076388888889,39.60915977961435,133320.11019283909,1111.000918273659,0
1013,512,0,0,485,0.0,0.0,1.0,485,13700,9300,4400,0.6788321167883211,181,93,88,151.94877746475206,0.42208613785464766,0.8711159026657858,0.1003879161576765,17380368.373471253,417485.1452472073,17797853.51871846,1012,2,664.3463917525773,100,385,100,35.47975050137221,0.6316666666666666,39.438943894389475,133407.26072607448,1334.072607260745,0
1014,512,1,0,486,0.00205761316872428,0.0,1.0,486,13400,10300,3100,0.7686567164179104,165,103,62,149.68371014371374,0.42232819637124713,0.8675696683277241,0.09929105954764776,17398774.298580308,410262.61779292254,17809036.91637323,1013,0,663.977366255144,106,380,95,35.39877329250534,0.6315841194968553,39.30101246105921,133477.8816199387,1259.2252983013086,0
1015,512,0,0,486,0.0,0.0,1.0,486,11850,8100,3750,0.6835443037974683,156,81,75,148.63535004842473,0.4221774991868539,0.8673582177104007,0.09888490255537682,17412116.918703273,408561.2186591179,17820678.13736239,1014,1,664.977366255144,108,378,99,35.32467631611094,0.6321373456790124,39.20107033639147,133529.0519877692,1236.3801109978629,0
1016,512,0,0,486,0.0,0.0,1.0,486,14600,10200,4400,0.6986301369863014,190,102,88,149.06578318179433,0.421954944635357,0.8667679403727822,0.0996423483403143,17433650.493594,407952.1529090598,17841602.646503057,1015,2,665.977366255144,114,372,79,35.14983223417795,0.6324926900584795,39.039855072463794,133611.59420290022,1172.0315280956158,0
1017,512,0,0,486,0.0,0.0,1.0,486,15000,10400,4600,0.6933333333333334,196,104,92,147.8179873130366,0.4219657276596948,0.8656087770156566,0.09921500732613164,17452266.86753146,403751.79248170275,17856018.66001316,1016,3,666.977366255144,118,368,86,35.04104085646597,0.6331214689265536,38.90056022408965,133682.91316526712,1132.9060437734502,0
1018,512,0,0,486,0.0,0.0,1.0,486,12350,8200,4150,0.6639676113360324,165,82,83,150.14971391127207,0.42192524712570534,0.8679398888870644,0.10116056844708657,17469303.84087785,415052.1947873771,17884356.035665225,1017,4,667.977366255144,125,361,89,34.850834440998334,0.6331666666666667,38.77314814814814,133748.14814814765,1069.9851851851813,0
1019,512,0,0,486,0.0,0.0,1.0,486,15100,10700,4400,0.7086092715231788,195,107,88,151.99050653744087,0.4218032752110645,0.8707903675024598,0.10276891783395195,17485491.340169378,419225.7371696763,17904717.077339053,1018,5,668.977366255144,131,355,92,34.679907200515295,0.6334287531806615,38.652146464646464,133810.10101010106,1021.451152748863,0
1020,512,0,0,486,0.0,0.0,1.0,486,14700,10700,4000,0.7278911564625851,187,107,80,153.00990844609717,0.4217992094805764,0.8735588639249932,0.10389928947992288,17504635.687933862,423776.5407986043,17928412.228732467,1019,6,669.977366255144,95,391,95,34.50804493962402,0.6424342105263158,38.50911458333331,133883.33333333206,1409.2982456140217,0
1021,512,0,0,486,0.0,0.0,1.0,486,13700,9700,4000,0.708029197080292,177,97,80,151.38033843723733,0.42184048548357445,0.871534839745947,0.10319981309157157,17522374.957792696,419608.6102669628,17941983.568059657,1020,7,670.977366255144,100,386,100,34.416187040906195,0.6423958333333333,38.376650165016486,133951.1551155107,1339.5115511551069,0
1022,512,1,1,486,0.002053388090349076,0.002053388090349076,0.997946611909651,487,14450,10600,3850,0.7335640138408305,183,106,77,149.7361760881251,0.4218318249803534,0.870163807004724,0.10297806956735342,17561582.67097539,414070.8470414602,17975653.518016852,1021,0,670.5975359342916,106,381,78,34.16228379918725,0.6438679245283019,38.08411214953268,134100.93457943742,1265.103156409787,0
1023,512,1,0,487,0.002053388090349076,0.0,1.0,487,14400,10200,4200,0.7083333333333334,186,102,84,146.76183712001688,0.4218335854296764,0.8677670302262679,0.10144307203130729,17584044.444444247,404333.33333332674,17988377.777777575,1022,0,671.5954825462012,114,373,82,34.07028351881293,0.6438230994152047,37.91666666666664,134186.66666666514,1177.0760233917995,0
1024,512,0,0,487,0.0,0.0,1.0,487,14150,10400,3750,0.734982332155477,179,104,75,149.4016959020623,0.4217041924044358,0.8716252883557909,0.10381990460455243,17607707.10059142,414574.26035501907,18022281.36094644,1023,1,672.5954825462012,116,371,84,33.82218148487626,0.6452047413793103,37.74038461538458,134276.92307692082,1157.5596816975933,0
1025,512,1,1,487,0.0020491803278688526,0.0020491803278688526,0.9979508196721312,488,13600,9700,3900,0.7132352941176471,175,97,78,150.3874671183643,0.42185965919929086,0.8725645903404353,0.10487602763237774,17623393.740623355,418867.50933638524,18042261.24995974,1024,0,672.2151639344262,117,371,90,33.67777516093573,0.6461894586894588,37.623587570621424,134336.72316383914,1148.177121058454,0
1026,512,0,1,486,0.0,0.002053388090349076,0.997946611909651,487,14250,9800,4450,0.6877192982456141,187,98,89,175.46540355296582,0.42146441920664296,0.8872638106295774,0.11717346734901847,17429175.377362985,499993.4582368804,17929168.835599866,1025,1,674.564681724846,95,392,71,34.4949907126322,0.6367324561403509,39.073350694444436,133594.44444444403,1406.257309941516,8
1027,512,0,0,486,0.0,0.0,1.0,486,14050,10700,3350,0.7615658362989324,174,107,67,173.70512850538267,0.4212095901743668,0.886078527579941,0.11631065711988489,17441386.969922375,494681.6729844932,17936068.642906867,1026,2,676.7119341563786,96,390,75,34.44794152335501,0.6373697916666667,38.98195876288659,133641.23711340176,1392.0962199312683,0
1028,512,0,1,485,0.0,0.00205761316872428,0.9979423868312757,486,14000,9900,4100,0.7071428571428572,181,99,82,169.8539934344746,0.42124220440371646,0.8836206820997612,0.11426098933173494,17462391.07780604,482011.3718959788,17944402.44970202,1027,3,677.7119341563786,102,384,81,34.38867376573088,0.6373570261437909,38.82483818770226,133721.68284789633,1310.9968906656502,0
1029,512,0,0,485,0.0,0.0,1.0,485,13750,10100,3650,0.7345454545454545,174,101,73,168.94560899892628,0.4209744469057965,0.8832595217006209,0.11421532488610033,17484787.37997254,480045.61042523925,17964832.990397777,1028,6,680.1030927835052,107,378,86,34.242139061116035,0.6378504672897196,38.657407407407405,133807.4074074072,1250.5365178262357,0
1030,512,0,1,484,0.0,0.002061855670103093,0.9979381443298969,485,12200,8500,3700,0.6967213114754098,159,85,74,170.03748881951384,0.4209048663769845,0.8835164481980544,0.11546650409546123,17504825.174595498,486095.3029825594,17990920.47757806,1029,7,681.1030927835052,91,394,91,34.06134985927689,0.643658424908425,38.50769927536229,133884.05797101316,1471.2533842968478,0
1031,512,0,0,484,0.0,0.0,1.0,484,13400,8900,4500,0.664179104477612,179,89,90,172.85011266475647,0.42057993472272126,0.8843468788317532,0.1178343910908871,17522302.24684499,495546.38350260793,18017848.630347595,1030,8,683.448347107438,94,390,94,33.855039815590914,0.6440602836879432,38.37719298245611,133950.87719298096,1425.009331840223,0
1032,512,0,0,484,0.0,0.0,1.0,484,13450,10000,3450,0.7434944237918215,169,100,69,173.9428230015068,0.4206596063685985,0.8851337329247904,0.11894877896163504,17536235.51918354,499810.4622052082,18036045.981388748,1031,9,684.448347107438,96,388,96,33.720645959844624,0.64453125,38.273195876288625,134004.1237113385,1395.876288659776,0
1033,512,0,0,484,0.0,0.0,1.0,484,14350,10300,4050,0.7177700348432056,184,103,81,169.95876119528594,0.4204027677965425,0.8832698043706801,0.11681528633055861,17558893.44444424,485707.55555554735,18044600.999999788,1032,10,685.448347107438,99,385,69,33.65301752711267,0.6454124579124579,38.104166666666636,134090.66666666509,1354.4511784511624,0
1034,512,0,0,484,0.0,0.0,1.0,484,14050,10600,3450,0.7544483985765125,175,106,69,167.57984343579247,0.4203813794352332,0.8813664822178786,0.11545181554150824,17569391.187775332,478005.1649019079,18047396.35267724,1033,11,686.448347107438,102,382,73,33.63573193329212,0.6454248366013071,38.025889967637504,134130.74433656767,1315.0072974173302,0
1035,512,0,0,484,0.0,0.0,1.0,484,12450,8800,3650,0.7068273092369478,161,88,73,167.40286502657992,0.4201445033337326,0.8815928854979136,0.11567568625182108,17582713.252708312,479429.3146888314,18062142.567397144,1034,12,687.448347107438,104,380,75,33.539403288286536,0.6459334935897436,37.926587301587276,134181.58730158594,1290.2075702075572,0
1036,512,0,1,483,0.0,0.002066115702479339,0.9979338842975206,484,14800,10600,4200,0.7162162162162162,190,106,84,166.22155961373306,0.4199876553507977,0.8814979998600723,0.11525950163535026,17598155.685600646,473438.5768771565,18071594.262477804,1035,13,688.448347107438,106,378,78,33.45338878162283,0.6466194968553459,37.811526479750746,134240.49844236582,1266.4197966260926,0
1037,512,1,1,483,0.002066115702479339,0.002066115702479339,0.9979338842975206,484,13200,9200,4000,0.696969696969697,172,92,80,169.60006523029773,0.4199455024553839,0.8843995161132494,0.11822158845259474,17621420.82387008,487718.82423577056,18109139.648105852,1036,0,689.3842975206611,112,372,83,33.1886177576332,0.6470424107142857,37.63827433628315,134329.20353982123,1199.3678887484039,0
1038,512,0,1,482,0.0,0.002070393374741201,0.9979296066252588,483,13150,9300,3850,0.7072243346007605,170,93,77,167.78990970950832,0.4196680927467505,0.8828510356731651,0.1172651998347417,17632941.882635172,481975.94528006524,18114917.827915236,1037,1,691.2774327122153,118,365,88,33.148917128054585,0.6467161016949152,37.55252100840333,134373.10924369568,1138.7551630821667,0
1039,512,0,0,482,0.0,0.0,1.0,482,13450,9800,3650,0.7286245353159851,171,98,73,174.4818695878593,0.41900779050675313,0.8874941628236681,0.12274307341682898,17661784.49931425,506482.23593964893,18168266.735253897,1038,2,693.6182572614108,89,393,89,32.75498663376516,0.6561329588014981,37.33796296296298,134482.96296296388,1511.0445276737514,0
1040,512,0,0,482,0.0,0.0,1.0,482,14200,10400,3800,0.7323943661971831,180,104,76,171.31821439218845,0.41881926412528075,0.8852556208261282,0.12092314840674971,17676540.64272221,495062.67590842687,18171603.31863064,1039,3,694.6182572614108,91,391,91,32.72650235550958,0.6565934065934066,37.22826086956523,134539.13043478335,1478.451982799817,0
1041,512,1,0,483,0.002070393374741201,0.0,1.0,483,14200,9700,4500,0.6830985915492958,187,97,90,168.66478233852715,0.41907031319353166,0.8840953287003033,0.12010501477222693,17715131.375397287,486783.75550596666,18201915.130903255,1040,0,694.1780538302278,96,387,76,32.504711653603316,0.6579861111111112,36.94158075601378,134685.91065292255,1402.9782359679432,0
1042,512,0,0,483,0.0,0.0,1.0,483,13100,8700,4400,0.6641221374045801,175,87,88,167.55482545234958,0.4188684283623847,0.8829886105903793,0.11958252701599362,17724909.624630388,484278.8276627304,18209188.452293117,1041,1,695.1780538302278,103,380,76,32.46010334589474,0.6568567961165048,36.868990384615415,134723.07692307854,1307.991038088141,0
1043,512,0,0,483,0.0,0.0,1.0,483,15500,10900,4600,0.7032258064516129,201,109,92,169.1980493196897,0.418638265336804,0.884243693247081,0.1214512168293994,17749900.373346526,488549.70375782007,18238450.077104345,1042,2,696.1780538302278,110,373,80,32.22829573398912,0.6571022727272727,36.68355855855859,134818.01801801962,1225.61834561836,0
1044,512,0,0,483,0.0,0.0,1.0,483,15650,12000,3650,0.7667731629392971,193,120,73,166.88021322834953,0.41834367098213393,0.8831378510749468,0.12019226749456638,17764529.350806132,480659.6891927673,18245189.0399989,1043,3,697.1780538302278,115,368,84,32.17903102096474,0.6571557971014492,36.575071839080486,134873.56321839243,1172.8135932034124,0
1045,512,0,0,483,0.0,0.0,1.0,483,14100,10100,4000,0.7163120567375887,181,101,80,166.25092834083694,0.4180802184365237,0.8831010769168004,0.12004441582739908,17775553.535139743,480340.4553978523,18255893.990537595,1044,4,698.1780538302278,118,365,87,32.11252477604672,0.6573975988700564,36.4933473389356,134915.4061624665,1143.3508996819196,0
1046,512,0,1,482,0.0,0.002070393374741201,0.9979296066252588,483,13950,9300,4650,0.6666666666666666,186,93,93,168.34372472990975,0.4178777966776343,0.884307568687672,0.12221234475743649,17798817.406647015,488713.84360450064,18287531.250251517,1045,5,699.1780538302278,90,393,90,31.882099703349954,0.666087962962963,36.320970695970686,135003.66300366254,1500.040700040695,0
1047,512,0,0,482,0.0,0.0,1.0,482,13150,9200,3950,0.6996197718631179,171,92,79,168.72739355672658,0.41742571449521654,0.8829426126352022,0.12310244220018039,17820247.58387194,491802.78547245235,18312050.36934439,1046,6,701.6099585062241,94,388,89,31.71061563183996,0.666445035460993,36.16228070175438,135084.9122807016,1437.0735349010808,0
1048,512,0,0,482,0.0,0.0,1.0,482,13950,10400,3550,0.7455197132616488,175,104,71,168.16339854471175,0.41730575133064757,0.8831896776572246,0.12312446150820566,17835383.40950152,489501.7376979476,18324885.147199467,1047,7,702.6099585062241,96,386,85,31.6115891614793,0.6669921875,36.05025773195876,135142.26804123694,1407.7319587628847,0
1049,512,0,0,482,0.0,0.0,1.0,482,13600,9600,4000,0.7058823529411765,176,96,80,167.07760310919826,0.4170023838073631,0.8822999398152778,0.12298192454339955,17858146.018579587,486739.2465516692,18344885.265131257,1048,8,703.6099585062241,102,380,75,31.469054730178183,0.6670751633986929,35.88187702265372,135228.47896440112,1325.7694016117757,0
1050,512,0,0,482,0.0,0.0,1.0,482,12650,8800,3850,0.6956521739130435,165,88,77,167.4613294882918,0.4168715475769418,0.8821600764232709,0.12375177964336245,17874982.99220698,489623.6832911169,18364606.675498098,1049,9,704.6099585062241,106,376,79,31.332357022682334,0.6673545597484276,35.75739875389408,135292.2118380062,1276.341621113266,0
1051,512,0,0,482,0.0,0.0,1.0,482,15400,11700,3700,0.7597402597402597,191,117,74,169.70728923514665,0.41665471528023396,0.8841002651808691,0.12594067253766145,17892900.000000004,495511.111111111,18388411.111111116,1050,10,705.6099585062241,109,373,82,31.138363540845816,0.6680045871559632,35.625,135360.00000000003,1241.8348623853215,0
1052,512,0,0,482,0.0,0.0,1.0,482,11500,8000,3500,0.6956521739130435,150,80,70,168.73960354086327,0.4165671017330768,0.8839409928918132,0.12555283790496302,17904084.5058793,496325.6242568394,18400410.13013614,1051,11,706.6099585062241,115,367,83,31.079937747594823,0.667572463768116,35.54238505747127,135402.29885057514,1177.4112943528273,0
1053,512,0,1,481,0.0,0.002074688796680498,0.9979253112033195,482,11800,8300,3500,0.7033898305084746,153,83,70,169.06217751507478,0.41630758591339506,0.884757094577288,0.12622803836887872,17918719.477161735,497675.54661814915,18416395.023779884,1052,12,707.6099585062241,117,365,87,30.96151707262819,0.6682692307692308,35.434322033898304,135457.62711864407,1157.7574967405476,0
1054,512,0,0,481,0.0,0.0,1.0,481,14550,10200,4350,0.7010309278350515,189,102,87,164.18771151900773,0.41598268942018946,0.8810008129718754,0.12332077970050082,17943878.194010746,478482.85929008585,18422361.05330083,1053,13,709.0956340956341,92,389,92,30.90176418327198,0.6762907608695652,35.248655913978475,135552.68817204208,1473.3987844787182,0
1055,512,0,1,480,0.0,0.002079002079002079,0.997920997920998,481,14000,10400,3600,0.7428571428571429,176,104,72,165.89026046130954,0.41583055411180414,0.8820276246293401,0.12529148430777332,17967187.47306848,485916.28193289647,18453103.755001377,1054,14,710.0956340956341,94,387,91,30.68193576424817,0.6774157801418439,35.07675438596489,135640.70175438476,1442.9861888764337,0
1056,512,0,0,480,0.0,0.0,1.0,480,12750,9200,3550,0.7215686274509804,163,92,71,160.6621995553993,0.41569368331013684,0.8807724450811827,0.112662194649591,17647778.635116793,458316.1865569359,18106094.82167373,1055,15,711.45625,89,391,89,33.22381713320107,0.6550795880149813,37.44212962962966,134429.62962963115,1510.4452767374287,8
1057,512,0,0,480,0.0,0.0,1.0,480,12900,9700,3200,0.751937984496124,161,97,64,160.37461522994843,0.4156552641498492,0.8802909211755405,0.11268976674518902,17656743.10150196,457438.6762234905,18114181.77772545,1056,16,712.45625,91,389,91,33.163621829417266,0.6551053113553114,37.375452898550755,134463.76811594339,1477.6238254499274,0
1058,512,0,0,480,0.0,0.0,1.0,480,15700,11600,4100,0.7388535031847133,198,116,82,162.3048507823505,0.41538451780329394,0.8814572207387619,0.1146852200339449,17681287.288396593,462251.7389966218,18143539.027393214,1057,17,713.45625,94,386,88,32.92749707943929,0.6560283687943262,37.19298245614038,134557.1929824574,1431.4594998133766,0
1059,512,0,0,480,0.0,0.0,1.0,480,13950,9800,4150,0.7025089605734767,181,98,83,163.37876201460807,0.415170403473672,0.8812133986928081,0.11611366865586827,17706597.392412722,468626.39229270286,18175223.784705427,1058,18,714.45625,100,380,70,32.708169934640544,0.65625,37.004950495049535,134653.46534653628,1346.5346534653627,0
1060,512,0,1,479,0.0,0.0020833333333333333,0.9979166666666667,480,13750,9300,4450,0.6763636363636364,182,93,89,163.72259752344223,0.4151437637729065,0.8810604645951592,0.11683998590852156,17724629.563704118,470634.4784620923,18195264.04216621,1059,19,715.45625,105,375,73,32.56305397868743,0.6563492063492063,36.87106918238996,134722.01257861752,1283.066786463024,0
1061,512,0,0,479,0.0,0.0,1.0,479,14450,11400,3050,0.7889273356401384,175,114,61,162.4367369421024,0.41500645667548913,0.8806262635023081,0.11647059648827444,17745156.25000016,466243.0555555617,18211399.305555724,1060,20,717.615866388309,107,372,79,32.44209528519619,0.6574182242990654,36.71875000000002,134800.00000000122,1259.813084112161,0
1062,512,0,0,479,0.0,0.0,1.0,479,13750,9800,3950,0.7127272727272728,177,98,79,157.86888392324192,0.4148947205213092,0.877452288624119,0.11385671333273628,17770415.59796192,451529.1354604887,18221944.73342241,1061,21,718.615866388309,113,366,88,32.37208388245358,0.6580014749262537,36.53143274853803,134895.9064327497,1193.769083475661,0
1063,512,0,0,479,0.0,0.0,1.0,479,12250,8400,3850,0.6857142857142857,161,84,77,157.2468906496054,0.4147247505408467,0.8761966341987237,0.11370637884826858,17781773.081082385,451175.7054474099,18232948.786529794,1062,22,719.615866388309,93,386,93,32.30296675496507,0.6638664874551972,36.447251773049636,134939.00709219815,1450.957065507507,0
1064,512,0,0,479,0.0,0.0,1.0,479,13100,8900,4200,0.6793893129770993,173,89,84,154.42714082894577,0.4145999117757532,0.873988281713465,0.1122242930277136,17803233.02790503,440960.4748021656,18244193.502707195,1063,23,720.615866388309,97,382,97,32.21584038694076,0.6643041237113403,36.28826530612245,135020.40816326524,1391.9629707553117,0
1065,512,0,0,479,0.0,0.0,1.0,479,14550,10500,4050,0.7216494845360825,186,105,81,152.77417756707524,0.41441592928084137,0.8732255696495967,0.11134750523144507,17815789.318550255,434008.5121699594,18249797.830720216,1064,24,721.615866388309,98,381,98,32.165031376302906,0.6649659863945578,36.195286195286194,135068.01346801344,1378.2450353878921,0
1066,512,0,0,479,0.0,0.0,1.0,479,14000,10000,4000,0.7142857142857143,180,100,80,151.93724243657584,0.41424850703027866,0.8726264653609443,0.11087347777804728,17821062.24999996,431736.6111111092,18252798.861111067,1065,25,722.615866388309,99,380,93,32.14748081908748,0.6650883838383839,36.15624999999999,135087.99999999968,1364.5252525252492,0
1067,512,1,1,479,0.0020833333333333333,0.0020833333333333333,0.9979166666666667,480,15000,10700,4300,0.7133333333333334,193,107,86,149.45286231365716,0.414428931802366,0.8710956754651444,0.10955259940953013,17840371.61843706,422258.9206229465,18262630.539060004,1066,0,722.1083333333333,102,378,73,32.067993461798764,0.6657475490196079,36.01334951456309,135161.16504854278,1325.1094612602233,0
1068,512,0,0,479,0.0,0.0,1.0,479,13600,10100,3500,0.7426470588235294,171,101,70,148.1029973227598,0.41390620132016087,0.8696942247470687,0.10904574670135923,17859344.318468094,419604.4847568639,18278948.80322496,1067,27,724.615866388309,104,375,80,31.961216070713114,0.6666666666666667,35.873015873015866,135233.0158730156,1300.3174603174577,0
1069,512,0,0,479,0.0,0.0,1.0,479,12350,8900,3450,0.7206477732793523,158,89,69,147.82609551231948,0.4138541548379207,0.869679610504325,0.10930916269904357,17877617.283411346,420405.6720140481,18298022.955425393,1068,28,725.615866388309,106,373,84,31.83144532449194,0.6675511006289307,35.73792834890964,135302.1806853574,1276.4356668429944,0
1070,512,0,0,479,0.0,0.0,1.0,479,12300,8200,4100,0.6666666666666666,164,82,82,149.20649753445156,0.4134674458352623,0.8711826861675167,0.11060127954080014,17888073.298523646,425703.35290244815,18313776.651426096,1069,29,726.615866388309,110,369,84,31.716545962321305,0.6674242424242425,35.660660660660646,135341.74174174096,1230.3794703794633,0
1071,512,0,0,479,0.0,0.0,1.0,479,14150,8900,5250,0.6289752650176679,194,89,105,155.01412667559092,0.41320266390638327,0.8753316616463833,0.11524112568079059,17900437.000429332,445014.1217465958,18345451.12217593,1070,30,727.615866388309,115,364,84,31.470275693053047,0.6673007246376812,35.56932471264367,135388.50574712604,1177.291354322835,0
1072,512,0,0,479,0.0,0.0,1.0,479,14700,11000,3700,0.7482993197278912,184,110,74,158.1069076750419,0.412956625990339,0.8785814931518314,0.11801509131041887,17917523.7200357,456076.85371381004,18373600.57374951,1071,31,728.615866388309,117,362,86,31.26032316727284,0.6681801994301995,35.44314971751412,135453.1073446324,1157.7188661934392,0
1073,512,0,0,479,0.0,0.0,1.0,479,12650,8800,3850,0.6956521739130435,165,88,77,158.77589215659222,0.4128536249101015,0.8796102992345167,0.11879497473402927,17927525.826446384,460841.7814508777,18388367.607897263,1072,32,729.615866388309,87,392,87,31.167620922049274,0.6767241379310345,35.3693181818182,135490.90909090987,1557.3667711598837,0
1074,512,0,0,479,0.0,0.0,1.0,479,13250,9800,3450,0.7396226415094339,167,98,69,163.1030061649587,0.4126478047303337,0.8822376060106649,0.12258193373633601,17946488.37829127,476375.24092076323,18422863.619212035,1073,33,730.615866388309,88,391,88,30.910912680871146,0.6777935606060606,35.229400749063686,135562.5468164801,1540.4834865509104,0
1075,512,0,0,479,0.0,0.0,1.0,479,12250,8300,3950,0.6775510204081633,162,83,79,159.5323551633744,0.41239321372105414,0.8794491038960448,0.12034388093329068,17962102.266158044,465057.2956411194,18427159.561799165,1074,34,731.615866388309,92,387,86,30.888462514271204,0.6776494565217391,35.114247311827974,135621.5053763449,1474.1467975689663,0
1076,512,1,1,479,0.0020833333333333333,0.0020833333333333333,0.9979166666666667,480,14800,10600,4200,0.7162162162162162,190,106,84,155.77937307597645,0.41243856558803066,0.876413937748237,0.11783262572889788,17973520.506371018,449180.75129013817,18422701.257661156,1075,0,731.0895833333333,96,384,88,30.902383750776774,0.6773003472222222,35.030068728522345,135664.60481099694,1413.172966781218,0
1077,512,0,1,478,0.0,0.0020876826722338203,0.9979123173277662,479,12800,9600,3200,0.75,160,96,64,155.5607270366148,0.4118752966285526,0.8756094337893874,0.11821964956132847,17993150.027777806,451205.50000000116,18444355.527777806,1076,1,733.473903966597,99,380,76,30.761274933532412,0.6779250841750841,34.88541666666667,135738.6666666669,1371.0976430976455,0
1078,512,0,0,478,0.0,0.0,1.0,478,13450,9800,3650,0.7286245353159851,171,98,73,155.1579762290216,0.4115733248247853,0.8749844475414601,0.11834945775985412,18008572.05845297,449784.7190728133,18458356.777525786,1077,37,736.0062761506276,104,374,78,30.65659871579078,0.6777844551282051,34.77182539682539,135796.82539682512,1305.7387057387032,0
1079,512,0,0,478,0.0,0.0,1.0,478,13200,9500,3700,0.7196969696969697,169,95,74,154.46176503084558,0.4110681297860583,0.8739484742591326,0.11820497365811411,18022231.948302053,447949.1513060035,18470181.099608056,1078,38,737.0062761506276,108,370,83,30.572939177832215,0.6778549382716049,34.67125382262996,135848.31804281278,1257.854796692711,0
1080,512,0,0,478,0.0,0.0,1.0,478,13650,9900,3750,0.7252747252747253,174,99,75,157.6836039375772,0.4109297927832309,0.8765391323774805,0.12117946751713227,18039739.317601886,459664.22193877,18499403.539540656,1079,39,738.0062761506276,111,367,86,30.3565797771705,0.678490990990991,34.542410714285694,135914.28571428452,1224.4530244530138,0
1081,512,0,0,478,0.0,0.0,1.0,478,14900,10700,4200,0.7181208053691275,191,107,84,160.3757506458998,0.41063365657044115,0.8777784411795972,0.123671240517631,18053952.160952386,468583.22598757443,18522535.38693996,1080,40,739.0062761506276,115,363,90,30.178886427935392,0.6787137681159421,34.437859195402275,135967.8160919526,1182.3288355821967,0
1082,512,0,0,478,0.0,0.0,1.0,478,13000,9400,3600,0.7230769230769231,166,94,72,160.81934816925718,0.41033021060849273,0.8787109132831379,0.12463630828550565,18074688.435400575,472751.9225087132,18547440.35790929,1081,41,740.0062761506276,92,386,92,30.012189295901337,0.6860280797101449,34.28539426523301,136045.8781362023,1478.7595449587204,0
1083,512,0,0,478,0.0,0.0,1.0,478,12800,9100,3700,0.7109375,165,91,74,187.63873891800762,0.41037014011327183,0.8923193893120676,0.13305292396004212,17696674.66229017,555716.3433348791,18252391.00562505,1082,42,741.0062761506276,88,390,66,32.14522866215574,0.6590909090909092,37.07865168539327,134615.73033707906,1529.7242083758983,8
1084,512,0,0,478,0.0,0.0,1.0,478,13800,10000,3800,0.7246376811594203,176,100,76,186.1386138613853,0.41005143504995484,0.8915820870790008,0.13239436619718323,17710069.444444552,549905.5555555605,18259975.00000011,1083,43,742.0062761506276,91,387,68,32.08333333333337,0.6591117216117216,36.979166666666686,134666.6666666675,1479.853479853489,0
1085,512,0,0,478,0.0,0.0,1.0,478,14400,10600,3800,0.7361111111111112,182,106,76,184.84518844813516,0.40999140373498943,0.8904492901784296,0.13205264233865638,17729203.397612706,545431.588613416,18274634.986226123,1084,44,743.0062761506276,98,380,71,31.972682019911275,0.6584821428571428,36.83712121212125,134739.3939393956,1374.891774891792,0
1086,512,0,0,478,0.0,0.0,1.0,478,13050,8900,4150,0.6819923371647509,172,89,83,198.58327178027264,0.4098319598314664,0.9008716129700711,0.1373289391106289,17586194.937541157,589814.8257725209,18176009.763313677,1085,45,744.0062761506276,90,388,64,32.695786201976944,0.6501157407407407,37.900641025641036,134194.8717948723,1491.0541310541366,8
1087,512,0,0,478,0.0,0.0,1.0,478,12500,8900,3600,0.712,161,89,72,197.57225673084952,0.4097574003900482,0.9003579298075592,0.13700350510703105,17598322.51898798,587288.0589507567,18185610.577938735,1086,46,745.0062761506276,93,385,67,32.63014229360382,0.650089605734767,37.81028368794326,134241.13475177306,1443.4530618470221,0
1088,512,0,0,478,0.0,0.0,1.0,478,12950,9100,3850,0.7027027027027027,168,91,77,196.91187119920428,0.4093795777304106,0.8993714626703768,0.1369247170650301,17610612.249999907,584997.7222222184,18195609.972222127,1087,47,746.0062761506276,99,379,70,32.55412082820337,0.6493055555555556,37.718749999999986,134287.9999999993,1356.4444444444373,0
1089,512,0,0,478,0.0,0.0,1.0,478,12650,9000,3650,0.7114624505928854,163,90,73,198.0756244760239,0.40943303027113326,0.9000179743536363,0.13798503197165257,17618673.11665391,589715.9360040254,18208389.052657936,1088,48,747.0062761506276,104,374,71,32.46238907376593,0.6486378205128205,37.65873015873014,134318.73015872895,1291.52625152624,0
1090,512,0,0,478,0.0,0.0,1.0,478,12600,9200,3400,0.7301587301587301,160,92,68,197.52211185435257,0.4094580661620016,0.8999780914816242,0.13806438681231945,17633578.56615118,588404.3355871581,18221982.90173834,1089,49,748.0062761506276,108,370,76,32.363771255871484,0.6488233024691358,37.54778287461771,134375.53516819424,1244.2179182240207,0
1091,512,0,0,478,0.0,0.0,1.0,478,12950,8900,4050,0.6872586872586872,170,89,81,195.9095110630426,0.4092754138048999,0.899701526976699,0.13735463772862241,17647000.694444396,582893.0555555528,18229893.749999948,1090,50,749.0062761506276,79,399,79,32.30427163922502,0.6587552742616034,37.44791666666666,134426.66666666628,1701.6033755274213,0
1092,512,0,0,478,0.0,0.0,1.0,478,13400,9200,4200,0.6865671641791045,176,92,84,190.39550455910413,0.409136802686479,0.8966062647739199,0.13408704682779465,17666676.74477199,563731.166540691,18230407.91131268,1091,51,750.0062761506276,83,395,83,32.29992761832829,0.6586345381526104,37.301587301587304,134501.58730158737,1620.501051826354,0
1093,512,0,0,478,0.0,0.0,1.0,478,14500,10400,4100,0.7172413793103448,186,104,82,190.36361171620436,0.4090351058013093,0.8970540332130004,0.13457526306581785,17683359.945830114,563153.6533131738,18246513.59914329,1092,52,751.0062761506276,83,395,81,32.17439684187348,0.6598895582329317,37.17757936507935,134565.07936507883,1621.266016446733,0
1094,512,0,0,478,0.0,0.0,1.0,478,14400,10600,3800,0.7361111111111112,182,106,76,187.16553489419226,0.4088088690648492,0.8946997711837334,0.1329823415842983,17705393.8271606,552767.9012345729,18258161.728395175,1093,53,752.0062761506276,89,389,64,32.091695273303415,0.6594101123595506,37.01388888888891,134648.88888888972,1512.9088639201093,0
1095,512,0,0,478,0.0,0.0,1.0,478,14550,10600,3950,0.7285223367697594,185,106,79,184.68941500397733,0.40896940943074594,0.8931725372223873,0.13152260766474982,17715349.109081503,544217.4927095049,18259566.60179101,1094,54,753.0062761506276,92,386,66,32.08152374464223,0.6591938405797102,36.93996415770612,134686.7383512558,1463.9862864266936,0
1096,512,0,0,478,0.0,0.0,1.0,478,13700,9600,4100,0.7007299270072993,178,96,82,184.20142314520922,0.4088911951147485,0.8919627913631352,0.13173556067393277,17733924.694444608,544022.83333334,18277947.527777947,1095,55,754.0062761506276,99,379,70,31.953940251447865,0.6585648148148149,36.80208333333336,134757.3333333346,1361.185185185198,0
1097,512,0,0,478,0.0,0.0,1.0,478,14500,11200,3300,0.7724137931034483,178,112,66,183.64831017387726,0.408809782783494,0.8924482129199358,0.1319592162507672,17754359.5060799,542011.6243022234,18296371.130382124,1096,56,755.0062761506276,102,376,75,31.81411610343065,0.6593137254901961,36.65048543689323,134834.9514563119,1321.9112887873714,0
1098,512,0,0,478,0.0,0.0,1.0,478,13350,9100,4250,0.6816479400749064,176,91,85,183.18817779199645,0.40867446105219457,0.8918426974945026,0.1318574760978476,17761892.08664529,541803.7290981327,18303695.815743424,1097,57,756.0062761506276,106,372,78,31.769351122938012,0.6589033018867925,36.59462616822432,134863.55140187044,1272.2976547346268,0
1099,512,0,0,478,0.0,0.0,1.0,478,13250,9300,3950,0.7018867924528301,172,93,79,181.81169870282952,0.40862183085825227,0.8913679537402031,0.13115720938509048,17771494.140625164,537363.1076388947,18308857.24826406,1098,58,757.0062761506276,111,367,80,31.733125360349238,0.6585022522522522,36.52343750000002,134900.00000000125,1215.3153153153266,0
1100,512,0,0,478,0.0,0.0,1.0,478,14100,10700,3400,0.7588652482269503,175,107,68,182.63519906801983,0.40852826606902154,0.8928267390333453,0.13227517637440833,17788645.164084088,540066.5501385707,18328711.71422266,1099,59,758.0062761506276,83,395,83,31.581998478932427,0.6677961847389557,36.39632936507935,134965.07936507885,1626.085293555167,0
1101,512,0,0,478,0.0,0.0,1.0,478,13200,9000,4200,0.6818181818181818,174,90,84,182.2570424043641,0.4081571135554913,0.8918036471505675,0.1326766963703502,17810637.949093085,540422.8391873225,18351060.78828041,1100,60,759.0062761506276,87,391,87,31.426096501069587,0.6679837164750958,36.23342803030301,135048.48484848393,1552.2814350400452,0
1102,512,0,0,478,0.0,0.0,1.0,478,12700,8300,4400,0.6535433070866141,171,83,88,184.59817627732357,0.40814377326327667,0.8940610318432991,0.13534232731306492,17841237.34567892,550391.9753086377,18391629.32098756,1101,61,760.0062761506276,89,389,65,31.133680783901077,0.6695926966292135,36.00694444444443,135164.44444444377,1518.7016229712783,0
1103,512,0,0,478,0.0,0.0,1.0,478,12600,9300,3300,0.7380952380952381,159,93,66,184.39150903382736,0.40819119526094344,0.8941219690371671,0.13591604181658481,17864111.58895416,550598.0986871842,18414709.687641345,1102,62,761.0062761506276,93,385,69,30.966838660961482,0.6700268817204301,35.83776595744679,135251.06382978635,1454.3125142987778,0
1104,512,0,0,478,0.0,0.0,1.0,478,14500,10600,3900,0.7310344827586207,184,106,78,186.06646477940822,0.40810073711510514,0.8954802897347212,0.13774404382809619,17882512.03447196,555367.159125877,18437879.193597835,1103,63,762.0062761506276,94,384,72,30.78405036508462,0.6710992907801419,35.70175438596488,135320.70175438453,1439.5819335572821,0
1105,512,0,0,478,0.0,0.0,1.0,478,14050,10400,3650,0.7402135231316725,177,104,73,184.59509910523437,0.4078481852816738,0.8945630765750727,0.13689814217102853,17890080.111110944,550834.2222222155,18440914.33333316,1104,64,763.0062761506276,99,379,73,30.76598497386187,0.6702441077441077,35.64583333333331,135349.33333333206,1367.1649831649704,0
1106,512,0,0,478,0.0,0.0,1.0,478,12550,8400,4150,0.6693227091633466,167,84,83,184.62719540938585,0.40776878313143805,0.8945892609853228,0.1373807039140613,17904285.296785742,552973.5960310113,18457258.892816752,1105,65,764.0062761506276,108,370,76,30.658267986846383,0.6690779320987654,35.540902140672785,135403.0581039757,1253.7320194812564,0
1107,512,0,0,478,0.0,0.0,1.0,478,13400,9200,4200,0.6865671641791045,176,92,84,185.3074997940252,0.40750161179968947,0.8957479829110091,0.13839511623770956,17919873.315721083,555137.3841523887,18475010.699873473,1106,66,765.0062761506276,113,365,80,30.523045818223665,0.669155604719764,35.42580409356725,135461.98830409363,1198.7786575583507,0
1108,512,0,1,477,0.0,0.0020920502092050207,0.997907949790795,478,12800,8500,4300,0.6640625,171,85,86,186.4992477624124,0.40736574183720314,0.8969601229613189,0.1396708340229416,17931565.310166057,560444.688309705,18492009.998475764,1107,67,766.0062761506276,80,398,80,30.40360787172011,0.6796875,35.33950617283949,135506.1728395056,1693.82716049382,0
1109,512,1,0,478,0.0020920502092050207,0.0,1.0,478,13550,9600,3950,0.7084870848708487,175,96,79,183.63519326597256,0.4074185547748743,0.8946360827938924,0.1380421363409264,17947373.955891985,550003.8970013778,18497377.852893364,1108,0,765.8054393305439,85,393,85,30.360628240317148,0.678921568627451,35.22286821705425,135565.89147286754,1594.8928408572651,0
1110,512,0,0,478,0.0,0.0,1.0,478,12550,9200,3350,0.7330677290836654,159,92,67,162.42239279811372,0.4074330829013271,0.8820185562601721,0.11303417284982764,17614219.95229278,464038.75038472604,18078258.702677507,1109,1,766.8054393305439,113,365,76,33.43141481171841,0.6462942477876106,37.69188596491225,134301.75438596314,1188.5111007607356,8
1111,512,0,1,477,0.0,0.0020920502092050207,0.997907949790795,478,12000,8600,3400,0.7166666666666667,154,86,68,162.3409620278754,0.40744185460031757,0.8823021101217898,0.11323563068733476,17624313.833564393,464629.6125644024,18088943.446128797,1110,2,767.8054393305439,115,363,79,33.35718339664829,0.6466485507246377,37.61673850574711,134340.22988505635,1168.1759120439683,0
1112,512,0,0,477,0.0,0.0,1.0,477,13750,9900,3850,0.72,176,99,77,162.5374511465877,0.4074079579420867,0.8826007090422092,0.11353179858284036,17630509.75134831,463973.6234798334,18094483.37482814,1111,3,769.9832285115303,117,360,80,33.30516123968421,0.6467236467236468,37.57062146892652,134363.84180790745,1148.4089043410893,0
1113,512,0,0,477,0.0,0.0,1.0,477,14500,11100,3400,0.7655172413793103,179,111,68,164.04556407193837,0.4073055584917405,0.8840749092155067,0.11491874888825046,17643333.490803707,468962.1189216422,18112295.60972535,1112,4,770.9832285115303,83,394,83,33.16859549677218,0.6568775100401607,37.47519841269841,134412.69841269826,1619.4301013578104,0
1114,512,0,0,477,0.0,0.0,1.0,477,12150,8300,3850,0.6831275720164609,160,83,77,161.29284154850296,0.407129203882811,0.8809560443471762,0.11343066929457758,17660455.364782874,462151.0057652696,18122606.370548144,1113,5,771.9832285115303,88,389,88,33.11145522332635,0.6563683712121212,37.34784644194758,134477.90262172354,1528.1579843377674,0
1115,512,0,0,477,0.0,0.0,1.0,477,14400,10000,4400,0.6944444444444444,188,100,88,161.64728177770908,0.40708571164314783,0.8817966961999295,0.11432102528464666,17685139.95198908,461950.96021948115,18147090.91220856,1114,6,772.9832285115303,89,388,88,32.91568504410881,0.6578885767790262,37.16435185185186,134571.85185185226,1512.0432792342951,0
1116,512,0,0,477,0.0,0.0,1.0,477,13700,10300,3400,0.7518248175182481,171,103,68,165.38302724147445,0.40699010212051273,0.883500808890689,0.11736795488273521,17700266.440564867,476364.72938426334,18176631.16994913,1115,7,773.9832285115303,92,385,68,32.7032572272392,0.6580615942028986,37.051971326164896,134629.39068100456,1463.3629421848323,0
1117,512,0,0,477,0.0,0.0,1.0,477,12700,9700,3000,0.7637795275590551,157,97,60,163.86579356987616,0.40695651950507666,0.8818326079473893,0.1167566665469396,17717709.157054488,472565.2942522045,18190274.451306693,1116,8,774.9832285115303,100,377,68,32.6115009670169,0.6570833333333334,36.92244224422445,134695.7095709584,1346.9570957095839,0
1118,512,0,0,477,0.0,0.0,1.0,477,13300,10100,3200,0.7593984962406015,165,101,64,163.83138472239298,0.406939452930019,0.8814907245343806,0.11717844754906462,17734331.382653628,472388.0135091903,18206719.39616282,1117,9,775.9832285115303,106,371,71,32.487008063323024,0.6568396226415094,36.799065420560765,134758.8785046738,1271.3101745723943,0
1119,512,0,0,477,0.0,0.0,1.0,477,13150,9200,3950,0.6996197718631179,171,92,79,167.3632589497626,0.4069159634503697,0.8846511732194282,0.1201828431311536,17751657.616979282,485645.0541076113,18237302.671086892,1118,10,776.9832285115303,107,370,74,32.26335677483946,0.657904984423676,36.67052469135805,134824.69135802594,1260.0438444675322,0
1120,512,0,0,477,0.0,0.0,1.0,477,13700,10000,3700,0.7299270072992701,174,100,74,168.3188934757509,0.40680402139891597,0.8848886939247658,0.12119456114918267,17763318.222354423,488880.4135288711,18252198.635883294,1119,11,777.9832285115303,115,362,76,32.15026363037206,0.6570652173913043,36.58405172413794,134868.96551724203,1172.773613193409,0
1121,512,0,0,477,0.0,0.0,1.0,477,12750,9400,3350,0.7372549019607844,161,94,67,177.13600512937828,0.4067276805900557,0.8890563948746633,0.12422443167873047,17648140.47382983,517074.22029926634,18165214.694129094,1120,12,778.9832285115303,85,392,85,32.788545078501,0.6564950980392157,37.439437984496145,134431.00775193897,1581.5412676698702,8
1122,512,0,0,477,0.0,0.0,1.0,477,11800,8400,3400,0.711864406779661,152,84,68,171.35153831160088,0.406569860648662,0.8841991936949409,0.12064568081723234,17665600.679590605,498205.5703292682,18163806.249919873,1121,13,779.9832285115303,92,385,92,32.80834719083556,0.6554574275362319,37.3095878136201,134497.49103942775,1461.9292504285625,0
1123,512,0,0,477,0.0,0.0,1.0,477,13700,9500,4200,0.6934306569343066,179,95,84,168.5124380369014,0.4066357412986159,0.8812005861180876,0.11912690376993548,17683325.539377395,486872.0598481445,18170197.59922554,1122,14,780.9832285115303,96,381,88,32.74895467298632,0.6555989583333333,37.177835051546424,134564.9484536098,1401.7182130584354,0
1124,512,0,0,477,0.0,0.0,1.0,477,12550,9000,3550,0.7171314741035857,161,90,71,167.72356967569354,0.4063239551585833,0.8776118740362515,0.10814201610354549,17268180.250000156,471306.16666667245,17739486.416666828,1123,15,781.9832285115303,99,378,86,35.925154413829034,0.6234217171717171,40.28125000000002,132976.0000000012,1343.1919191919312,8
1125,512,0,0,477,0.0,0.0,1.0,477,13800,9700,4100,0.7028985507246377,179,97,82,170.1564624322905,0.4065160917616522,0.8785550821048091,0.11022301409189714,17289756.00907045,479192.7437641787,17768948.752834626,1124,16,782.9832285115303,104,373,71,35.69700526797982,0.6237980769230769,40.11904761904764,133059.04761904883,1279.4139194139311,0
1126,512,0,0,477,0.0,0.0,1.0,477,12700,9000,3700,0.7086614173228346,164,90,74,171.137552880134,0.40660858158777136,0.8793471133093771,0.11115747511524585,17302198.909259994,484111.1961552184,17786310.10541521,1125,17,783.9832285115303,105,372,73,35.57641120141121,0.6245039682539683,40.02555031446542,133106.9182389943,1267.6849356094694,0
1127,512,1,0,478,0.0020920502092050207,0.0,1.0,478,12350,8700,3650,0.7044534412955465,160,87,73,170.47814829380766,0.4070621131315258,0.8784026191496592,0.11102303501524474,17314425.367309585,482396.23507805786,17796821.602387644,1126,0,783.3410041841004,109,369,77,35.500150202090076,0.6245221712538227,39.93371212121214,133153.93939394038,1221.5957742563337,0
1128,512,1,0,479,0.0020876826722338203,0.0,1.0,479,13100,9600,3500,0.732824427480916,166,96,70,169.77061706001263,0.40758855909131936,0.8766552076439731,0.11098841023363555,17332137.7021635,479597.54253308434,17811735.244696584,1127,0,782.7035490605427,114,365,84,35.38330548399827,0.6248172514619883,39.80072463768117,133222.02898550793,1168.6142893465608,0
1129,512,0,0,479,0.0,0.0,1.0,479,12850,8900,3950,0.6926070038910506,168,89,79,188.1198838455569,0.4078107575347292,0.8914569093628759,0.11970229792217801,17206728.758421168,538735.5630792297,17745464.3215004,1128,1,783.7035490605427,113,366,80,35.86666167365683,0.6155051622418879,40.74378654970757,132739.18128654794,1174.6830202349377,8
1130,512,1,0,480,0.0020833333333333333,0.0,1.0,480,11750,8800,2950,0.7489361702127659,147,88,59,186.7008717951828,0.4081872680352587,0.8920189471295681,0.1191414338258562,17220155.44702975,535253.6068817975,17755409.053911548,1129,0,783.06875,117,363,84,35.80043113228953,0.6157407407407407,40.64265536723162,132790.96045197616,1134.9654739485143,0
1131,512,1,0,481,0.002079002079002079,0.0,1.0,481,14050,10400,3650,0.7402135231316725,177,104,73,186.87651065294838,0.40858003436128437,0.8905485863808407,0.1201171315561303,17253750.722626984,534614.146144067,17788364.86877105,1130,0,782.4386694386694,92,389,92,35.538279834325635,0.6243206521739131,40.389784946236574,132920.4301075276,1444.7872837774737,0
1132,512,4,1,484,0.008247422680412371,0.002061855670103093,0.9979381443298969,485,13800,10100,3700,0.7318840579710145,175,101,74,182.8946760074365,0.4097073712760217,0.8891365130434987,0.1184724947566941,17289677.591521595,521637.99627487775,17811315.587796472,1131,0,776.9773195876288,100,385,68,35.36656348387439,0.6247916666666666,40.11963696369638,133058.74587458797,1330.5874587458798,0
1133,512,0,0,484,0.0,0.0,1.0,484,13200,9800,3400,0.7424242424242424,166,98,68,182.54145363528826,0.4094397176165951,0.8889697844243309,0.11873271541764314,17308739.765040923,521912.50346109667,17830652.26850202,1132,1,779.5743801652893,105,379,72,35.22990677752587,0.625,39.97641509433962,133132.075471698,1267.9245283018856,0
1134,512,1,1,484,0.002061855670103093,0.002061855670103093,0.9979381443298969,485,13550,10500,3050,0.7749077490774908,166,105,61,182.24159992205423,0.4098704950157621,0.8888473692453684,0.11908920247184021,17330122.96715567,521103.86727607937,17851226.83443175,1133,0,778.9649484536083,111,374,79,35.07421060470663,0.6252815315315315,39.81584821428572,133214.28571428615,1200.128700128704,0
1135,512,2,0,486,0.00411522633744856,0.0,1.0,486,14000,9800,4200,0.7,182,98,84,178.7940545514886,0.4099275416118677,0.8932629605170368,0.12291473298613423,17559866.49412957,516719.9455736532,18076586.439703222,1134,0,778.343621399177,88,398,66,33.41423857830212,0.6487926136363636,38.09691011235956,134094.38202247221,1523.7997957099115,8
1136,512,0,0,486,0.0,0.0,1.0,486,14800,11200,3600,0.7567567567567568,184,112,72,180.69742919437473,0.4098510882016037,0.8938394391168165,0.12470138232404096,17576979.464369606,523223.00044278253,18100202.46481239,1135,1,779.343621399177,90,396,69,33.234495362078256,0.6494212962962963,37.96932234432235,134159.7069597072,1490.6634106634133,0
1137,512,0,2,484,0.0,0.00411522633744856,0.9958847736625515,486,13600,9800,3800,0.7205882352941176,174,98,76,180.3144764817975,0.4098753941990865,0.8937965109805626,0.1250902255906362,17600232.963988945,523915.35857186955,18124148.322560813,1136,2,780.343621399177,94,392,73,33.068135881459185,0.6499335106382979,37.79605263157895,134248.42105263178,1428.1746920492742,0
1138,512,2,0,486,0.00411522633744856,0.0,1.0,486,14000,9700,4300,0.6928571428571428,183,97,86,179.69603678665322,0.4096717541329034,0.8934550749596584,0.1255025587616885,17630001.417233586,522408.2766439917,18152409.693877578,1137,0,781.3189300411523,97,389,79,32.858720820338334,0.6513101374570447,37.574404761904766,134361.90476190497,1385.1742758959274,0
1139,512,1,0,487,0.002053388090349076,0.0,1.0,487,13250,9700,3550,0.7320754716981132,168,97,71,179.74253262984448,0.40992238531024755,0.8941794704512234,0.12591726031621586,17643414.799391896,523604.41205631604,18167019.21144821,1138,0,780.7125256673511,81,406,81,32.755895351462954,0.6576646090534979,37.47459349593496,134413.00813008132,1659.419853457794,0
1140,512,0,0,487,0.0,0.0,1.0,487,12550,9300,3250,0.7410358565737052,158,93,65,182.03025754610022,0.4097304963340403,0.8959846421903235,0.12811510093731282,17663910.53605653,533123.2368299271,18197033.772886455,1139,1,781.7125256673511,81,406,81,32.54062288422476,0.6592078189300412,37.32215447154471,134491.05691056873,1660.3834186489967,0
1141,512,0,0,487,0.0,0.0,1.0,487,13200,9300,3900,0.7045454545454546,171,93,78,182.95895823207235,0.4096984561563617,0.8968115817365285,0.12953787563805766,17690035.430838887,536710.0907029419,18226745.52154183,1140,2,782.7125256673511,83,404,73,32.3184970280215,0.6603915662650602,37.12797619047617,134590.47619047528,1621.5720022948829,0
1142,512,0,0,487,0.0,0.0,1.0,487,14450,10600,3850,0.7335640138408305,183,106,77,183.7596461838471,0.40969863220129404,0.8968582579997715,0.13065457851388446,17708475.414657906,538970.6353305768,18247446.049988482,1141,3,783.7125256673511,87,400,63,32.15795977916798,0.6603208812260537,36.99100378787878,134660.60606060576,1547.8230581678822,0
1143,512,0,0,487,0.0,0.0,1.0,487,14300,9500,4800,0.6643356643356644,191,95,96,181.02637868604154,0.4097764440613707,0.8916969319087118,0.12835461189217068,17696349.276675146,529001.2051039739,18225350.48177912,1142,4,784.7125256673511,91,396,68,32.32154264100027,0.6580815018315018,37.081068840579725,134614.4927536238,1479.2801401497122,8
1144,512,0,0,487,0.0,0.0,1.0,487,14050,9300,4750,0.6619217081850534,188,93,95,179.22119656625839,0.40959212501725245,0.8898425869940008,0.12745312271489073,17709346.370496478,523328.04938534636,18232674.419881824,1143,5,785.7125256673511,96,391,70,32.27074146660138,0.6575520833333333,36.98453608247425,134663.91752577433,1402.7491408934827,0
1145,512,0,1,486,0.0,0.002053388090349076,0.997946611909651,487,13450,9200,4250,0.6840148698884758,177,92,85,184.3386181723688,0.4094166082197492,0.8927885235877508,0.13158843228013845,17725818.40899641,542660.5742977529,18268478.983294163,1144,6,786.7125256673511,97,390,71,32.011599881510215,0.6585051546391752,36.86224489795921,134726.53061224613,1388.933305280888,0
1146,512,0,0,486,0.0,0.0,1.0,486,13450,9300,4150,0.6914498141263941,176,93,83,180.55379749554564,0.4088322691725708,0.8903795935297103,0.12945034730468719,17744801.66422945,530128.2652563874,18274929.929485835,1145,7,789.3045267489712,98,388,78,31.967785015852776,0.6596513605442177,36.7213804713805,134798.65319865453,1375.4964612107606,0
1147,512,0,0,486,0.0,0.0,1.0,486,13700,9700,4000,0.708029197080292,177,97,80,178.69929722474168,0.40862739171015233,0.8890769358587045,0.12834642368618226,17752442.7682847,523569.80934299296,18276012.577627692,1146,8,790.3045267489712,105,381,79,31.958917975892835,0.6584325396825397,36.664701257861665,134827.67295597654,1284.0730757712051,0
1148,512,0,0,486,0.0,0.0,1.0,486,15100,11300,3800,0.7483443708609272,189,113,76,177.8897092792758,0.4086318109824219,0.8895525811797262,0.12825354529789046,17768984.928607125,519883.9126275603,18288868.841234684,1147,9,791.3045267489712,111,375,82,31.85539267600994,0.6583145645645645,36.542038690476225,134890.47619047822,1215.2295152295335,0
1149,512,0,0,486,0.0,0.0,1.0,486,13600,9400,4200,0.6911764705882353,178,94,84,176.81636337155666,0.4084650276469673,0.8887921305501165,0.12759451086542217,17772880.88642681,517707.2329947756,18290588.119421586,1148,10,792.3045267489712,113,373,84,31.854279373006,0.6581858407079646,36.51315789473687,134905.2631578964,1193.8518863530655,0
1150,512,0,0,486,0.0,0.0,1.0,486,14500,10200,4300,0.7034482758620689,188,102,86,176.07998199659536,0.4083381061473845,0.8883912375229692,0.127566731280652,17789972.585546177,514791.6105165746,18304764.19606275,1149,11,793.3045267489712,86,400,86,31.74478811827222,0.6667877906976745,36.38649425287354,134970.11494252773,1569.419941192183,0
1151,512,0,0,486,0.0,0.0,1.0,486,14300,9800,4500,0.6853146853146853,188,98,90,178.1688072349143,0.4082221444430303,0.8887755951352476,0.12986893582684358,17816215.672153622,523358.7791495192,18339574.45130314,1150,12,794.3045267489712,89,397,89,31.491896269322428,0.6677200374531835,36.192129629629626,135069.62962962952,1517.6362879733654,0
1152,512,0,0,486,0.0,0.0,1.0,486,13450,9500,3950,0.7063197026022305,174,95,79,178.21904021025927,0.40803724209127035,0.8881771359059973,0.13054906929223029,17837424.316406205,525143.7282986091,18362568.044704814,1151,13,795.3045267489712,95,391,69,31.330800139762406,0.6674342105263158,36.03515624999999,135149.99999999965,1422.6315789473647,0
1153,512,0,0,486,0.0,0.0,1.0,486,13450,9100,4350,0.6765799256505576,178,91,87,176.98019202627,0.40782211191718637,0.8871626796142402,0.13010559336298164,17852716.64542694,521265.44401965005,18373982.08944659,1152,14,796.3045267489712,100,386,72,31.2483727136627,0.6671875,35.9220297029703,135207.92079207936,1352.0792079207936,0
1154,512,0,0,486,0.0,0.0,1.0,486,15150,11000,4150,0.7260726072607261,193,110,83,175.6045482651267,0.40759752450044545,0.885527806901083,0.1295137742389964,17866571.956212245,515140.25948340923,18381712.215695653,1153,15,797.3045267489712,105,381,75,31.180447060719924,0.6669642857142857,35.81957547169812,135260.3773584911,1288.1940700808675,0
1155,512,1,0,487,0.002053388090349076,0.0,1.0,487,13850,9900,3950,0.7148014440433214,178,99,79,178.55162105156248,0.40748944434585926,0.8870231970288787,0.13236291532414043,17888368.144132785,527549.426020413,18415917.5701532,1154,0,796.6652977412731,111,376,79,30.938621490394777,0.6672297297297297,35.65848214285716,135342.85714285815,1219.3050193050283,0
1156,512,0,0,487,0.0,0.0,1.0,487,15050,11200,3850,0.7441860465116279,189,112,77,184.66092723993452,0.40729597096526143,0.8928313614596157,0.1375603517162499,17909052.361588214,548970.4430158928,18458022.804604106,1155,1,797.6652977412731,116,371,80,30.621521700103244,0.6677442528735632,35.50569800569804,135421.08262108444,1167.4231260438314,0
1157,512,1,0,488,0.0020491803278688526,0.0,1.0,488,12550,9000,3550,0.7171314741035857,161,90,71,185.2100151145951,0.40732034958090685,0.8946093393498051,0.13841707983174847,17922771.280276783,553745.3479430974,18476516.62821988,1156,0,797.0286885245902,84,404,84,30.503836475074504,0.6774553571428572,35.40441176470588,135472.9411764703,1612.773109243694,0
1158,512,0,0,488,0.0,0.0,1.0,488,14650,10900,3750,0.7440273037542662,184,109,75,185.72361595345924,0.4070707766687986,0.8944748630703749,0.13953913732049136,17945172.212178625,554318.4544306708,18499490.666609295,1157,1,798.0286885245902,87,401,87,30.32187486028523,0.6780411877394636,35.23910984848485,135557.57575757592,1558.1330546847807,0
1159,512,0,0,488,0.0,0.0,1.0,488,14600,10700,3900,0.7328767123287672,185,107,78,183.25839684559935,0.4070805947812524,0.8924225372414447,0.13859209193668506,17972737.2464383,546531.0029418962,18519268.249380194,1158,2,799.0286885245902,92,396,82,30.180151617630504,0.6784420289855073,35.03584229390682,135661.64874552004,1474.5831385382612,0
1160,512,0,0,488,0.0,0.0,1.0,488,13800,9700,4100,0.7028985507246377,179,97,82,180.61207648067312,0.4069698780309916,0.8906726346006442,0.13699653570055234,17985177.430592448,538268.0483225274,18523445.478914976,1159,3,800.0286885245902,96,392,67,30.156929476271497,0.6781684027777778,34.94415807560137,135708.591065292,1413.6311569301251,0
1161,512,0,0,488,0.0,0.0,1.0,488,13250,9300,3950,0.7018867924528301,172,93,79,177.8679613851413,0.40665990619494846,0.8894498029690583,0.1354268387561433,18001020.41741779,529510.9608996839,18530531.378317475,1160,4,801.0286885245902,98,390,71,30.11087083035738,0.6787840136054422,34.82744107744109,135768.35016835068,1385.3913282484764,0
1162,512,0,2,486,0.0,0.004098360655737705,0.9959016393442623,488,13800,10200,3600,0.7391304347826086,174,102,72,178.4214495352119,0.40646161538806785,0.8902332947307834,0.1362987259725335,18014841.70941853,531446.8341883724,18546288.543606903,1161,5,802.0286885245902,100,388,73,29.99259684045465,0.6792708333333333,34.72566006600661,135820.46204620512,1358.2046204620513,0
1163,512,0,0,486,0.0,0.0,1.0,486,12900,9500,3400,0.7364341085271318,163,95,68,180.22456599472235,0.4061838876868468,0.8903549116027931,0.1381039778695081,18027768.284482345,539709.3429848476,18567477.627467193,1162,6,804.9094650205761,105,381,75,29.847892904754843,0.678968253968254,34.63050314465408,135869.18238993656,1293.9922132374911,0
1164,512,0,2,484,0.0,0.00411522633744856,0.9958847736625515,486,13650,9300,4350,0.6813186813186813,180,93,87,180.68310747822107,0.4062376260376452,0.8912834245759089,0.13889031913977967,18040809.81882775,541083.9158978766,18581893.734725624,1163,7,805.9094650205761,110,376,77,29.738022011689257,0.6787878787878787,34.53453453453452,135918.31831831764,1235.6210756210694,0
1165,512,0,0,484,0.0,0.0,1.0,484,12400,8200,4200,0.6612903225806451,166,82,84,183.41407458638994,0.40568891198831913,0.8934196556122886,0.1414393747870419,18054025.210834127,553072.4653208916,18607097.67615502,1164,10,809.5826446280992,116,368,78,29.566528653167012,0.6785201149425287,34.43732193732191,135968.09116808965,1172.13871696629,0
1166,512,0,0,484,0.0,0.0,1.0,484,12400,8100,4300,0.6532258064516129,167,81,86,185.00576701268702,0.405441430824336,0.8950170150704913,0.1429590017825312,18062500.000000045,559133.3333333355,18621633.33333338,1165,11,810.5826446280992,103,381,80,29.4607843137255,0.6820388349514563,34.37500000000001,136000.00000000035,1320.3883495145665,0
1167,512,0,0,484,0.0,0.0,1.0,484,13700,10100,3600,0.7372262773722628,173,101,72,150.06698438818626,0.40522701250221016,0.8681072194037973,0.11266655227435801,17942074.333670724,428002.5977845206,18370076.931455243,1166,12,811.5826446280992,100,384,100,31.289119820276053,0.6738541666666666,35.2619636963696,135545.87458745672,1355.4587458745673,8
1168,512,0,0,484,0.0,0.0,1.0,484,13100,9100,4000,0.6946564885496184,171,91,80,150.14762766298887,0.40501785215223945,0.869441180069441,0.11320432764730325,17959868.42667326,429426.3274808738,18389294.754154135,1167,13,812.5826446280992,101,383,98,31.15376953526626,0.6749174917491749,35.13071895424833,135613.071895423,1342.703682132901,0
1169,512,0,0,484,0.0,0.0,1.0,484,14650,10500,4150,0.7167235494880546,188,105,83,150.0691631873828,0.4048034338301137,0.8693323574377112,0.11353717497711917,17974400.142399136,428030.63763299363,18402430.780032128,1168,14,813.5826446280992,105,379,92,31.04710601790039,0.675,35.023584905660336,135667.92452829966,1292.0754716980919,0
1170,512,0,0,484,0.0,0.0,1.0,484,12850,8900,3950,0.6926070038910506,168,89,79,149.04486973228256,0.40449098551865353,0.8689880055056709,0.113212066987225,17991087.544071015,426645.85986962286,18417733.403940637,1169,15,814.5826446280992,108,376,79,30.949441240086493,0.6755401234567902,34.90061162079507,135730.88685015074,1256.767470834729,0
1171,512,1,0,485,0.002061855670103093,0.0,1.0,485,12650,9300,3350,0.7351778656126482,160,93,67,151.1876624475251,0.40450409673113513,0.8721589296922703,0.11546115113030596,18013639.2826374,435038.003062965,18448677.285700362,1170,0,813.901030927835,112,373,81,30.72402638773047,0.6763392857142857,34.73451327433625,135815.929203538,1212.6422250315893,0
1172,512,0,0,485,0.0,0.0,1.0,485,14000,9500,4500,0.6785714285714286,185,95,90,150.85340518785281,0.4041363139359859,0.871590153027282,0.1155620122310594,18026501.005457845,432871.81205910235,18459372.817516945,1171,1,814.901030927835,117,368,85,30.63678199157239,0.6762820512820513,34.63983050847453,135864.40677965828,1161.2342459799854,0
1173,512,0,0,485,0.0,0.0,1.0,485,14250,10300,3950,0.7228070175438597,182,103,79,149.8803598681766,0.40376835363948765,0.8706189612402877,0.11518549731244128,18039840.444444127,429513.5555555454,18469353.999999672,1172,2,815.901030927835,124,361,89,30.56296761366605,0.6759912634408602,34.54166666666663,135914.66666666427,1096.086021505357,0
1174,512,0,0,485,0.0,0.0,1.0,485,13700,9500,4200,0.6934306569343066,179,95,84,150.8422675209498,0.403670195393485,0.8723676462039687,0.11631107924724872,18053646.91840251,433950.6076388804,18487597.526041392,1173,3,816.901030927835,127,358,93,30.434338481653974,0.6765091863517061,34.440104166666636,135966.66666666465,1070.6036745406666,0
1175,512,0,0,485,0.0,0.0,1.0,485,14450,10300,4150,0.71280276816609,186,103,83,159.6703877145124,0.40341690096844735,0.8792311022257626,0.11656635553760786,17822895.877971645,457707.7390062241,18280603.61697787,1174,4,817.901030927835,98,387,91,31.929656657494924,0.6654974489795918,36.14267676767677,135094.94949494957,1378.519892805608,8
1176,512,0,0,485,0.0,0.0,1.0,485,14150,10100,4050,0.7137809187279152,182,101,81,158.26549386643003,0.4032401096248332,0.8768374756639201,0.11616320611586264,17845930.86419758,453729.01234568073,18299659.876543257,1175,5,818.901030927835,104,381,73,31.793573557776604,0.6656650641025641,35.97222222222223,135182.2222222226,1299.8290598290635,0
1177,512,0,0,485,0.0,0.0,1.0,485,13550,9200,4350,0.6789667896678967,179,92,87,157.2178913183249,0.40301006787651583,0.8763981498739764,0.11601979801532894,17869026.887247603,451316.14542470337,18320343.03267231,1176,6,819.901030927835,110,375,77,31.647752163771745,0.6660037878787879,35.801426426426424,135269.66966966962,1229.7242697242693,0
1178,512,0,0,485,0.0,0.0,1.0,485,14600,10300,4300,0.7054794520547946,189,103,86,160.92830865079588,0.4029933827497089,0.8788781207570713,0.10772670802768633,17440176.961852383,449723.6362082995,17889900.598060682,1177,7,820.901030927835,101,384,77,34.79063959099561,0.6359323432343233,38.99101307189544,133636.60130719034,1323.134666407825,7
1179,512,1,0,486,0.00205761316872428,0.0,1.0,486,14650,9900,4750,0.6757679180887372,194,99,95,151.06567679649726,0.4035776660585748,0.8674285880405537,0.09899859363756922,17343228.513034347,412143.31063156715,17755371.823665913,1178,0,820.2098765432099,131,355,92,35.78551198091947,0.6226940203562341,39.71748737373737,133264.64646464618,1017.2873775927189,8
1180,512,1,0,487,0.002053388090349076,0.0,1.0,487,14900,10900,4000,0.7315436241610739,189,109,80,154.55549808620538,0.40410990978049305,0.870518336296719,0.10161427515684736,17358091.91871441,424257.7084646033,17782349.627179015,1179,0,819.523613963039,137,350,96,35.5814454880134,0.6229470802919708,39.60597826086955,133321.73913043368,973.1513805141144,0
1181,512,1,0,488,0.0020491803278688526,0.0,1.0,488,14050,10300,3750,0.7330960854092526,178,103,75,160.06013625682576,0.40456724565478397,0.8736720440058949,0.10601978647512657,17392138.985766828,445107.6271718991,17837246.61293873,1180,0,818.8422131147541,102,386,102,35.17877235866992,0.632046568627451,39.35072815533981,133452.42718446624,1308.357129259473,0
1182,512,0,0,488,0.0,0.0,1.0,488,14900,10900,4000,0.7315436241610739,189,109,80,159.5755845055792,0.4045838137195498,0.8728996640553808,0.10614426148699524,17411301.654663913,443183.7277091902,17854485.382373102,1181,1,819.8422131147541,107,381,96,35.04555919227783,0.6323014018691588,39.207175925925924,133525.92592592584,1247.905849775008,0
1183,512,0,0,488,0.0,0.0,1.0,488,13600,10000,3600,0.7352941176470589,172,100,72,163.3043623754059,0.4049008861547783,0.8737906904011057,0.10904293411266475,17428777.7038139,458039.0859808032,17886816.789794702,1182,2,820.8422131147541,112,376,75,34.815330035918294,0.6325334821428572,39.076327433628315,133592.9203539821,1192.793931731983,0
1184,512,0,0,488,0.0,0.0,1.0,488,13750,9600,4150,0.6981818181818182,179,96,83,162.17629560661405,0.4048864219712525,0.8818008611162274,0.10613007580138806,17336753.189015582,450972.0820081453,17787725.271023728,1183,3,821.8422131147541,113,375,82,35.54570458801501,0.6253687315634218,39.76608187134505,133239.76608187257,1179.1129741758634,8
1185,512,0,0,488,0.0,0.0,1.0,488,12850,8500,4350,0.6614785992217899,172,85,87,162.80272125765975,0.40492823661089977,0.8824404023888643,0.10686992214780514,17350949.996695064,454506.3751735068,17805456.37186857,1184,4,822.8422131147541,122,366,85,35.42113952051009,0.6247438524590163,39.65955284552845,133294.3089430892,1092.5763028122067,0
1186,512,0,0,488,0.0,0.0,1.0,488,14500,10500,4000,0.7241379310344828,185,105,80,163.4824571812826,0.40468304678470846,0.8832173419940192,0.10792169326380019,17376720.11109702,456057.7803027083,17832777.891399726,1185,5,823.8422131147541,88,400,88,35.20702306079665,0.6349431818181819,39.46629213483145,133393.2584269658,1515.8324821246113,0
1187,512,0,0,488,0.0,0.0,1.0,488,15500,11600,3900,0.7483870967741936,194,116,78,161.7839962379257,0.4047713221350748,0.8821698166953895,0.10714233582845345,17391317.47532028,449627.3681999564,17840944.843520235,1186,6,824.8422131147541,91,397,91,35.14009556907035,0.63507326007326,39.35688405797101,133449.27536231859,1466.4755534320723,0
1188,512,0,0,488,0.0,0.0,1.0,488,13750,9900,3850,0.72,176,99,77,155.26890866686188,0.40488589600094255,0.8730863766980443,0.10081461874935473,17300557.943067145,425897.7502295725,17726455.693296716,1187,7,825.8422131147541,109,379,76,36.00147530234595,0.6234709480122325,40.0378787878788,133100.60606060692,1221.106477620247,8
1189,512,1,0,489,0.002044989775051125,0.0,1.0,489,13400,8900,4500,0.664179104477612,179,89,90,160.4053733807217,0.4052636486305274,0.877887381189689,0.10457481551087028,17319346.681633566,444423.25423552195,17763769.935869087,1188,0,825.1513292433538,112,377,77,35.7245593516681,0.6242559523809523,39.8967551622419,133172.8613569329,1189.0434049726152,0
1190,512,1,0,490,0.0020408163265306124,0.0,1.0,490,12950,8700,4250,0.6718146718146718,172,87,85,145.88381826434463,0.4059396867131311,0.8709615987975445,0.09520229577353677,17323928.66000596,394506.17205216544,17718434.832058124,1189,0,824.465306122449,111,379,82,36.06736384221195,0.6248123123123124,39.86235119047623,133190.47619047848,1199.9141999142205,8
1191,512,0,0,490,0.0,0.0,1.0,490,12500,8300,4200,0.664,167,83,84,146.75210970179643,0.4059747262913345,0.8720301275199451,0.09616697542260427,17342999.89498039,398524.3646292914,17741524.25960968,1190,1,825.465306122449,114,376,86,35.89952728960037,0.625639619883041,39.71920289855077,133263.76811594467,1168.9804220696901,0
1192,512,1,0,491,0.002036659877800407,0.0,1.0,491,11950,8500,3450,0.7112970711297071,154,85,69,148.5942405915938,0.40636438893276255,0.8745981357798536,0.09770829452777981,17358716.55766966,405731.0609063366,17764447.618575994,1191,0,824.7820773930754,115,376,90,35.73191829321567,0.6266304347826087,39.601293103448306,133324.13793103618,1159.3403298350972,0
1193,512,1,0,492,0.0020325203252032522,0.0,1.0,492,13250,9200,4050,0.6943396226415094,173,92,81,147.99420589098798,0.4063578870895634,0.8745698522241865,0.0977467693763816,17379036.882876616,402749.3525263028,17781786.23540292,1192,0,824.1036585365854,92,400,92,35.59291978333762,0.6338315217391304,39.44892473118279,133402.15053763427,1450.0233754090682,0
1194,512,0,0,492,0.0,0.0,1.0,492,15150,10600,4550,0.6996699669966997,197,106,91,146.52511758576458,0.4065628811838016,0.8736067196748096,0.09712557851248906,17395476.96586627,396224.8615768015,17791701.827443074,1193,1,825.1036585365854,92,400,92,35.506183846803864,0.6350769927536232,39.32571684587813,133465.23297491003,1450.709054075109,0
1195,512,2,1,493,0.004048582995951417,0.0020242914979757085,0.9979757085020243,494,14350,10000,4350,0.6968641114982579,187,100,87,143.5971045899974,0.40726009271501423,0.8710936024272027,0.09568331641985121,17419266.30686285,387121.24114951957,17806387.54801237,1194,0,822.7591093117409,97,397,76,35.40176812952473,0.6354166666666667,39.14753401360544,133556.46258503376,1376.870748299317,0
1196,512,0,0,493,0.0,0.0,1.0,493,15600,11500,4100,0.7371794871794872,197,115,82,142.32166810700053,0.4070254223079756,0.8705650591028928,0.09537473501340409,17445095.82393875,382363.027589884,17827458.851528633,1195,1,825.4279918864097,100,393,80,35.23896066268943,0.6365624999999999,38.954207920792065,133655.44554455383,1336.5544554455382,0
1197,512,0,0,493,0.0,0.0,1.0,493,12700,8600,4100,0.6771653543307087,168,86,82,147.53898250578544,0.4070362445510865,0.8744945413364225,0.09933095630708598,17466091.135635335,404085.8629009879,17870176.998536322,1196,2,826.4279918864097,105,388,81,34.943409831953815,0.6369047619047619,38.797169811320735,133735.8490566028,1273.6747529200268,0
1198,512,0,0,493,0.0,0.0,1.0,493,13300,9500,3800,0.7142857142857143,171,95,76,149.4388312403923,0.40704277225328034,0.875929621517054,0.10098090593426803,17482694.609023366,410618.68986102956,17893313.298884396,1197,3,827.4279918864097,110,383,84,34.767808620916675,0.6370265151515151,38.67304804804804,133799.39939939886,1216.3581763581715,0
1199,512,0,0,493,0.0,0.0,1.0,493,12550,8300,4250,0.6613545816733067,168,83,85,151.79541875033075,0.40727570815261904,0.8777359595803775,0.10301022243883161,17501827.19478728,420189.437585729,17922016.63237301,1198,4,828.4279918864097,89,404,89,34.56109918404079,0.6440777153558053,38.530092592592574,133872.5925925918,1504.186433624627,0
1200,512,0,0,493,0.0,0.0,1.0,493,14300,10400,3900,0.7272727272727273,182,104,78,151.5935125312173,0.40716748572151035,0.8780568427084725,0.10322452170331876,17517137.75845643,418196.8884595246,17935334.646915957,1199,5,829.4279918864097,90,403,90,34.450303401598624,0.6449074074074075,38.41575091575091,133931.13553113546,1488.1237281237272,0
1201,512,1,0,494,0.0020242914979757085,0.0,1.0,494,15800,11800,4000,0.7468354430379747,198,118,80,148.76265797264867,0.40728883519064474,0.8759756929072271,0.101662459886836,17533280.180110674,407059.47251448256,17940339.65262516,1200,0,828.7469635627531,92,402,92,34.40206148798063,0.6454936594202898,38.29525089605734,133992.83154121813,1456.443821100197,0
1202,512,0,1,493,0.0,0.0020242914979757085,0.9979757085020243,494,12700,9500,3200,0.7480314960629921,159,95,64,147.38163443218866,0.40718002439004364,0.8751078189350672,0.10103448996087717,17547280.05540157,405729.36288088304,17953009.418282453,1201,1,829.7469635627531,94,400,86,34.33220253800732,0.6459441489361701,38.1907894736842,134046.31578947298,1426.0246360582232,0
1203,512,0,0,493,0.0,0.0,1.0,493,14250,10300,3950,0.7228070175438597,182,103,79,146.25171543338078,0.4071683446296938,0.8736762420696731,0.10075747678086072,17569363.78374085,401059.91848904133,17970423.70222989,1202,2,831.4726166328601,98,395,79,34.194680965003855,0.6464710884353742,38.02609427609427,134130.63973063944,1368.6799972514227,0
1204,512,1,1,493,0.0020242914979757085,0.0020242914979757085,0.9979757085020243,494,13300,9200,4100,0.6917293233082706,174,92,82,150.2095256205458,0.4072627445505635,0.8762262483965553,0.10411639215459874,17596442.016731754,416530.64158853865,18012972.658320293,1203,0,830.7874493927126,105,389,82,33.88616358684107,0.6467261904761905,37.824292452830164,134233.96226414957,1278.418688229996,0
1205,512,0,0,493,0.0,0.0,1.0,493,13500,9600,3900,0.7111111111111111,174,96,78,149.0283135098176,0.4073147025841455,0.8750221799175035,0.10364953811524802,17611515.93268399,412822.9035598296,18024338.83624382,1204,1,832.6247464503043,112,381,84,33.80318712730932,0.6462983630952381,37.712020648967524,134291.44542772704,1199.030762747563,0
1206,512,0,0,493,0.0,0.0,1.0,493,13200,9000,4200,0.6818181818181818,174,90,84,148.03682569736333,0.40710358295266524,0.8737641403797745,0.10320906630427523,17622207.87848285,409947.1432219233,18032155.02170477,1205,2,833.6247464503043,117,376,88,33.748408813072636,0.6461004273504274,37.632415254237245,134332.20338982783,1148.138490511349,0
1207,512,0,0,493,0.0,0.0,1.0,493,12450,8300,4150,0.6666666666666666,166,83,83,150.85663895187673,0.4071229942776102,0.8771853569013808,0.10559964726631407,17640000.00000005,421172.22222222434,18061172.222222272,1206,3,834.6247464503043,104,389,90,33.540013227513214,0.6502403846153846,37.50000000000001,134400.00000000038,1292.307692307696,0
1208,512,0,0,493,0.0,0.0,1.0,493,13650,9700,3950,0.7106227106227107,176,97,79,149.62464842290996,0.40689899102337884,0.8760308853137302,0.10530589864063775,17663837.83511906,416339.1051758005,18080176.94029486,1207,4,835.6247464503043,93,400,93,33.39239509506132,0.6550179211469533,37.32269503546101,134490.7801418448,1446.1374208800514,0
1209,512,0,0,493,0.0,0.0,1.0,493,12950,9000,3950,0.694980694980695,169,90,79,150.51522184491813,0.4068076031926648,0.8764174536688967,0.10626392032732739,17677545.730447304,420597.9434583954,18098143.6739057,1208,5,836.6247464503043,96,397,89,33.265563274758236,0.6551649305555556,37.22079037800689,134542.9553264612,1401.4891179839708,0
1210,512,1,0,494,0.0020242914979757085,0.0,1.0,494,14850,10800,4050,0.7272727272727273,189,108,81,149.63832659931396,0.407171726711067,0.8757798457723489,0.10604477573931462,17694100.82344885,415893.1275800918,18109993.951028943,1209,0,835.9291497975709,100,394,90,33.16374733566095,0.6553125,37.09777227722775,134605.94059406072,1346.0594059406073,0
1211,512,0,1,493,0.0,0.0020242914979757085,0.9979757085020243,494,13900,9800,4100,0.7050359712230215,180,98,82,145.13033454691825,0.40712869854070344,0.8713384778113098,0.10327301841251561,17712036.009937957,401410.7423258769,18113446.752263833,1210,1,836.9291497975709,106,388,79,33.1471217785016,0.6551690251572326,36.96456386292837,134674.14330218194,1270.510785869641,0
1212,512,0,0,493,0.0,0.0,1.0,493,13300,9100,4200,0.6842105263157895,175,91,84,144.90504491125483,0.4065992320673714,0.8709096143215944,0.10347783497604678,17727447.558660667,401859.31692993484,18129306.875590604,1211,8,839.6247464503043,108,385,83,33.03697886403258,0.6558641975308642,36.85015290519881,134732.7217125401,1247.5252010420381,0
1213,512,0,1,492,0.0,0.002028397565922921,0.9979716024340771,493,13050,9400,3650,0.7203065134099617,167,94,73,146.3054409691875,0.40654409016199694,0.8717878342709393,0.10486593870591732,17743575.016457994,407546.31343055185,18151121.329888545,1212,9,840.6247464503043,110,383,88,32.878704165775545,0.6566287878787879,36.730480480480495,134793.99399399472,1225.399945399952,0
1214,512,0,0,492,0.0,0.0,1.0,492,14950,11300,3650,0.7558528428093646,186,113,73,146.34304719309404,0.4065732300652945,0.8718677871549068,0.10528300017710793,17759685.084720787,406451.28649756254,18166136.37121835,1213,10,842.7113821138212,115,377,91,32.7564763674383,0.6567934782608695,36.61099137931037,134855.17241379473,1172.6536731634324,0
1215,512,0,0,492,0.0,0.0,1.0,492,13450,9500,3950,0.7063197026022305,174,95,79,143.81952949802314,0.40641506465981153,0.8697396947890603,0.10379073741117291,17773191.649208825,399376.41213348514,18172568.06134231,1214,11,843.7113821138212,118,374,96,32.721365846095914,0.65722104519774,36.51085434173671,134906.44257703176,1143.2749370934896,0
1216,512,0,0,492,0.0,0.0,1.0,492,14450,10900,3550,0.754325259515571,180,109,71,144.6872977796757,0.40604431598032886,0.8705897707697992,0.10493283995558148,17794478.142819937,402076.9915768252,18196555.13439676,1215,12,844.7113821138212,98,394,98,32.53847893469558,0.6633715986394557,36.353114478114485,134987.20538720573,1377.4204631347523,0
1217,512,0,1,491,0.0,0.0020325203252032522,0.9979674796747967,492,13900,10100,3800,0.7266187050359713,177,101,76,145.43241691948455,0.4059714426064831,0.8713169083893202,0.10571688218300375,17804421.771021146,405568.0180027004,18209989.789023846,1216,13,845.7113821138212,98,394,98,32.44410974571764,0.6641156462585034,36.27946127946129,135024.9158249162,1377.8052635195531,0
1218,512,0,0,491,0.0,0.0,1.0,491,11850,7800,4050,0.6582278481012658,159,78,81,147.33421684495931,0.40579495545672445,0.8713341823023948,0.10757684613535533,17823551.93951353,415153.8132807381,18238705.75279427,1217,14,846.9511201629327,103,388,95,32.250227755845714,0.6642394822006472,36.13782051282052,135097.43589743628,1311.6255912372455,0
1219,512,0,0,491,0.0,0.0,1.0,491,12750,8900,3850,0.6980392156862745,166,89,77,148.9146893332819,0.4055862670933954,0.8728221520382007,0.10912891678516427,17839226.026707057,420354.560342658,18259580.587049715,1218,15,847.9511201629327,104,387,76,32.0908026106455,0.6651642628205128,36.021825396825406,135156.825396826,1299.5848595848654,0
1220,512,0,0,491,0.0,0.0,1.0,491,12500,8900,3600,0.712,161,89,72,150.3604371151022,0.405532752815994,0.874526486621112,0.11048223422805362,17850625.000000056,426105.55555555754,18276730.55555561,1219,16,848.9511201629327,105,386,77,31.967044707429356,0.6657738095238095,35.93750000000001,135200.00000000044,1287.6190476190518,0
1221,512,0,0,491,0.0,0.0,1.0,491,13250,9200,4050,0.6943396226415094,173,92,81,149.21757623297603,0.4054111766906355,0.8732301488765233,0.10996568760168662,17863201.61918943,421650.7298752863,18284852.349064715,1220,17,849.9511201629327,111,380,79,31.902829612938064,0.6653528528528528,35.84449404761906,135247.6190476197,1218.4470184470242,0
1222,512,0,0,491,0.0,0.0,1.0,491,14400,10600,3800,0.7361111111111112,182,106,76,149.29175578920092,0.40526639372653334,0.8736213278603546,0.11040778137262253,17878189.981096484,421213.27452216105,18299403.255618643,1221,18,850.9511201629327,114,377,82,31.78841759497285,0.6658442982456141,35.73369565217392,135304.34782608753,1186.8802440884872,0
1223,512,0,0,491,0.0,0.0,1.0,491,14950,9800,5150,0.6555183946488294,201,98,103,152.47334298204132,0.405187074829932,0.8772336845833706,0.113125383502805,17891927.599418715,432458.4026952053,18324386.00211392,1222,19,851.9511201629327,115,376,82,31.60127943840582,0.6666666666666667,35.63218390804598,135356.32183908072,1177.0114942528758,0
1224,512,0,0,491,0.0,0.0,1.0,491,14950,9700,5250,0.6488294314381271,202,97,105,153.28551163714423,0.40499882233952644,0.8740879841879197,0.10679521448628806,17619179.700839736,427002.99501398986,18046182.695853725,1223,20,852.9511201629327,120,371,88,33.63358928923014,0.6453125,37.654958677685904,134320.66115702194,1119.3388429751828,8
1225,512,0,0,491,0.0,0.0,1.0,491,11200,7800,3400,0.6964285714285714,146,78,68,151.54547107432268,0.4049960513737063,0.8737914909805267,0.1059732922615502,17635484.160018194,425115.5509307332,18060599.71094893,1224,21,853.9511201629327,123,368,93,33.55604276020993,0.6460027100271002,37.5336021505376,134382.7956989224,1092.5430544627836,0
1226,512,0,0,491,0.0,0.0,1.0,491,13600,9400,4200,0.6911764705882353,178,94,84,160.07112162789548,0.4050370963049171,0.8807738794038038,0.10969884857997964,17545868.487838652,449917.3697567681,17995785.85759542,1225,22,854.9511201629327,100,391,90,34.01067929929609,0.6441666666666667,38.201320132013166,134040.92409240745,1340.4092409240745,8
1227,512,0,0,491,0.0,0.0,1.0,491,13750,10300,3450,0.7490909090909091,172,103,69,157.63819699940598,0.40517096859110246,0.8787358917572115,0.1085078272361971,17565499.38859257,441848.7306023698,18007348.11919494,1226,23,855.9511201629327,106,385,70,33.92565131750102,0.6441627358490566,38.05490654205603,134115.88785046482,1265.244225004385,0
1228,512,0,0,491,0.0,0.0,1.0,491,13850,9000,4850,0.6498194945848376,187,90,97,158.93651017650973,0.4051966000249387,0.8797002008403629,0.10992115763781513,17586585.950412907,446980.11937556276,18033566.06978847,1227,24,856.9511201629327,109,382,74,33.7319652190669,0.6450688073394495,37.89772727272723,134196.3636363612,1231.1592994161579,0
1229,512,0,0,491,0.0,0.0,1.0,491,13800,9600,4200,0.6956521739130435,180,96,84,162.34082784152736,0.40520422018094404,0.8823414894001687,0.1126563758953936,17601613.826019354,459492.1119725628,18061105.937991917,1228,25,857.9511201629327,112,379,76,33.52895939532427,0.6455543154761905,37.78576696165188,134253.6873156322,1198.6936367467163,0
1230,512,0,0,491,0.0,0.0,1.0,491,14900,11400,3500,0.7651006711409396,184,114,70,165.84148799920277,0.40528301952145424,0.8850070021200274,0.1154308471750645,17614880.743662674,471155.6066915006,18086036.350354176,1229,26,858.9511201629327,116,375,78,33.336727420832915,0.6457435344827587,37.6869658119658,134304.2735042726,1157.7954612437293,0
1231,512,0,0,491,0.0,0.0,1.0,491,12550,8600,3950,0.6852589641434262,165,86,79,164.9855042119366,0.4053798301397952,0.8846347458628776,0.1151489577999473,17626951.56643982,470888.2983816841,18097839.8648215,1230,27,859.9511201629327,117,374,82,33.267837118026364,0.6464565527065527,37.597104519773985,134350.28248587402,1148.293012699778,0
1232,512,0,0,491,0.0,0.0,1.0,491,12750,9200,3550,0.7215686274509804,163,92,71,163.93723203942548,0.4054546462169389,0.8839085905729838,0.1145539826346361,17632223.079560887,467165.5692729717,18099388.64883386,1231,28,860.9511201629327,125,366,84,33.25546674016904,0.6454166666666667,37.55787037037035,134370.37037036917,1074.9629629629533,0
1233,512,0,0,491,0.0,0.0,1.0,491,14250,10100,4150,0.7087719298245614,184,101,83,162.99123750232243,0.40533497513058175,0.8838935010450186,0.11433850600772792,17649439.464714248,462890.7959152271,18112330.260629475,1232,29,861.9511201629327,88,403,88,33.15011069507591,0.6555397727272727,37.42977528089891,134435.9550561813,1527.6813074566055,0
1234,512,0,0,491,0.0,0.0,1.0,491,12700,8600,4100,0.6771653543307087,168,86,82,165.6509098823671,0.4050480069828339,0.8842752695583034,0.11686250295212235,17674271.949348763,474651.84598360845,18148923.795332372,1233,30,862.9511201629327,93,398,93,32.892565686812056,0.6558019713261649,37.2451241134752,134530.49645390175,1446.5644779989436,0
1235,512,0,0,491,0.0,0.0,1.0,491,13050,9400,3650,0.7203065134099617,167,94,73,165.4134288690837,0.4051489740499051,0.8835337259575933,0.1170261361251376,17686697.530864332,473873.45679012954,18160570.987654462,1234,31,863.9511201629327,95,396,87,32.8049317481286,0.656140350877193,37.1527777777778,134577.77777777883,1416.608187134514,0
1236,512,0,0,491,0.0,0.0,1.0,491,13400,9200,4200,0.6865671641791045,176,92,84,164.24805606988878,0.4051966000249387,0.882147712864197,0.11659949177244959,17701653.777777944,469892.4444444513,18171546.222222395,1235,32,864.9511201629327,99,392,71,32.72262715892886,0.6561447811447811,37.04166666666669,134634.66666666794,1359.9461279461407,0
1237,512,0,0,491,0.0,0.0,1.0,491,12750,9400,3350,0.7372549019607844,161,94,67,164.2420626841968,0.40523643265860315,0.8824032728887798,0.1168936946271596,17712820.0959035,470888.02170106396,18183708.117604565,1236,33,865.9511201629327,101,390,73,32.63849794877769,0.6564562706270627,36.95874183006539,134677.12418300819,1333.436873099091,0
1238,512,0,0,491,0.0,0.0,1.0,491,12850,9200,3650,0.7159533073929961,165,92,73,164.484288656504,0.40515416961081785,0.883009317400256,0.11733330564141581,17722763.51725893,471973.23003276094,18194736.74729169,1237,34,866.9511201629327,104,387,73,32.55709096850416,0.6564503205128205,36.88492063492066,134714.920634922,1295.3357753357884,0
1239,512,0,0,491,0.0,0.0,1.0,491,13450,9200,4250,0.6840148698884758,177,92,85,165.03522356313914,0.40501285035399087,0.882959603321366,0.11810565848676469,17736769.519931234,473788.3446019494,18210557.864533182,1238,35,867.9511201629327,112,379,74,32.436932362074195,0.6556919642857143,36.780973451327455,134768.1415929215,1203.2869785082278,0
1240,512,1,0,492,0.0020325203252032522,0.0,1.0,492,14300,10600,3700,0.7412587412587412,180,106,74,167.71114599685882,0.4049982165427561,0.8849915125524874,0.12036052275799917,17749056.927297838,482642.93552812666,18231699.862825964,1239,0,867.1849593495934,116,376,75,32.27380952380954,0.6558010057471264,36.68981481481484,134814.8148148161,1162.1966794380699,0
1241,512,0,0,492,0.0,0.0,1.0,492,13800,10100,3700,0.7318840579710145,175,101,74,169.78022875971334,0.40504659756373534,0.8859361418314369,0.12208600302923188,17757614.753150586,490778.37900335103,18248393.132153936,1240,1,868.1849593495934,123,369,77,32.15478013098578,0.6551490514905149,36.6263440860215,134847.31182795647,1096.3196083573696,0
1242,512,0,0,492,0.0,0.0,1.0,492,13900,10300,3600,0.7410071942446043,175,103,72,168.87409428852203,0.4050360762008842,0.8874813314549588,0.12201031806743137,17778098.688647043,488152.06284344156,18266250.751490485,1241,2,869.1849593495934,128,364,83,32.02421990705273,0.6558430989583333,36.47448320413435,134925.06459948214,1054.1020671834542,0
1243,512,1,0,493,0.002028397565922921,0.0,1.0,493,13800,9800,4000,0.7101449275362319,178,98,80,166.92194855691005,0.40529420697350993,0.8869055388197715,0.12141443475730773,17807135.60296811,482080.3546129097,18289215.95758102,1242,0,868.4198782961461,88,405,88,31.85695319665102,0.6673768939393939,36.259363295880135,135035.20599250868,1534.4909771875987,0
1244,512,0,0,493,0.0,0.0,1.0,493,13650,9700,3950,0.7106227106227107,176,97,79,165.46157330357465,0.4050863511931266,0.8859330232833595,0.12108498488588215,17833214.37288819,477892.3414395951,18311106.714327782,1243,1,869.4198782961461,92,401,82,31.69921985514625,0.6680253623188406,36.066308243727576,135134.05017921043,1468.848371513157,0
1245,512,0,1,492,0.0,0.002028397565922921,0.9979716024340771,493,13400,9300,4100,0.6940298507462687,175,93,82,172.55060669951752,0.4051944018425986,0.8894794938038919,0.11923937125363364,17582958.80855863,494790.0419978786,18077748.85055651,1244,2,870.4198782961461,102,391,69,33.40263306835428,0.6464460784313726,37.924757281553376,134182.52427184358,1315.5149438416038,8
1246,512,0,0,492,0.0,0.0,1.0,492,12900,9400,3500,0.7286821705426356,164,94,70,172.01256028360714,0.40502865950248096,0.8888331935887632,0.11912336635040614,17592509.071439765,493926.5054381818,18086435.576877948,1245,6,873.1849593495934,108,384,69,33.34434581313114,0.6457368827160495,37.85359327217123,134218.96024464705,1242.7681504133986,0
1247,512,0,0,492,0.0,0.0,1.0,492,13550,9800,3750,0.7232472324723247,173,98,75,169.8762890099148,0.405182857836725,0.8865026783216188,0.11799962305699074,17605898.84973587,486214.95225540776,18092113.80199128,1246,7,874.1849593495934,118,374,74,33.298911289873914,0.6446857344632768,37.75385154061623,134270.02801120369,1137.8815933152855,0
1248,512,0,0,492,0.0,0.0,1.0,492,12550,8800,3750,0.701195219123506,163,88,75,170.91774631679343,0.4051628499991721,0.8880398265127321,0.11901749464728743,17616867.093170516,491257.0441454328,18108124.137315948,1247,8,875.1849593495934,120,372,76,33.188528266386605,0.6451388888888889,37.67217630853993,134311.84573002672,1119.265381083556,0
1249,512,0,0,492,0.0,0.0,1.0,492,14150,9900,4250,0.6996466431095406,184,99,85,169.20767552317403,0.4052057116166885,0.8884386896592258,0.11832320125934455,17635447.44824121,484260.61390558997,18119708.0621468,1248,9,876.1849593495934,122,370,84,33.09274705300289,0.6461748633879781,37.53387533875336,134382.65582655667,1101.4971789062022,0
1250,512,0,1,491,0.0,0.0020325203252032522,0.9979674796747967,492,16050,12200,3850,0.7601246105919003,199,122,77,163.22543297571173,0.4050233988210554,0.8829928169170151,0.11494146981797593,17666259.765625145,462266.5798611168,18128526.34548626,1249,10,877.1849593495934,95,397,95,33.01683188764971,0.6546052631578947,37.30468750000002,134500.0000000011,1415.7894736842222,0
1251,512,1,0,492,0.0020325203252032522,0.0,1.0,492,12550,9500,3050,0.7569721115537849,156,95,61,161.51240330500755,0.4051080009272598,0.8810378274133535,0.11437388647797056,17690820.86483845,460507.3988636909,18151328.263702143,1250,0,878.1626016260162,101,391,90,32.876337036893126,0.6548061056105611,37.12214052287584,134593.46405228868,1332.6085549731552,0
1252,512,0,0,492,0.0,0.0,1.0,492,13300,9500,3800,0.7142857142857143,171,95,76,144.83664594832558,0.4051794082095607,0.8713567953212182,0.0988540536464113,17527602.295674257,396027.8256043231,17923630.12127858,1251,1,879.1626016260162,96,396,96,34.5477988453857,0.6438802083333333,38.33762886597937,133971.13402061778,1395.532646048102,8
1253,512,1,0,493,0.002028397565922921,0.0,1.0,493,14500,10500,4000,0.7241379310344828,185,105,80,143.59674362009795,0.4054055214740788,0.8688926490185616,0.09864053835119613,17556373.857277,391107.6231363957,17947481.480413396,1252,0,878.3772819472616,101,392,77,34.362488463388296,0.6446988448844885,38.12295751633985,134081.0457516331,1327.535106451813,0
1254,512,1,0,494,0.0020242914979757085,0.0,1.0,494,13600,10100,3500,0.7426470588235294,171,101,70,142.27816813678317,0.4057992734997112,0.8669228377973197,0.0981674758837176,17576058.04988657,387737.8684807234,17963795.918367293,1253,0,877.5971659919028,104,390,82,34.248163713463526,0.6454326923076923,37.97619047619047,134156.1904761901,1289.9633699633664,0
1255,512,0,0,494,0.0,0.0,1.0,494,13700,9900,3800,0.7226277372262774,175,99,76,143.68191112332659,0.40576300323284414,0.8674913560657402,0.0994953016706994,17592137.773160778,393034.3951985153,17985172.168359295,1254,1,878.5971659919028,113,381,83,34.08982972567876,0.6446349557522124,37.85635964912278,134217.54385964765,1187.7658748641384,0
1256,512,0,0,494,0.0,0.0,1.0,494,12750,9300,3450,0.7294117647058823,162,93,69,146.94213374793367,0.40571184846966846,0.8693868862014837,0.10217746933138304,17610600.495099828,405997.8426664718,18016598.3377663,1255,2,879.5971659919028,118,376,86,33.8648221695646,0.6450388418079096,37.71883753501398,134287.95518207148,1138.0335184921312,0
1257,512,0,0,494,0.0,0.0,1.0,494,14100,10200,3900,0.723404255319149,180,102,78,147.4602331551678,0.4054826785523647,0.8706282159717762,0.10295848822756164,17628711.48398648,407006.7811307634,18035718.265117243,1256,3,880.5971659919028,123,371,91,33.71441300125916,0.6454945799457994,37.584005376344074,134356.989247311,1092.3332459130975,0
1258,512,0,0,494,0.0,0.0,1.0,494,13550,9500,4050,0.7011070110701108,176,95,81,146.393911524246,0.405319120179134,0.8701406714443869,0.10267941655257205,17648751.085069604,404383.9409722283,18053135.02604183,1257,4,881.5971659919028,95,399,95,33.59110257046033,0.6532894736842105,37.43489583333336,134433.33333333457,1415.0877192982587,0
1259,512,0,0,494,0.0,0.0,1.0,494,13850,10400,3450,0.7509025270758123,173,104,69,145.93480562980028,0.4052990175548092,0.8699837888016255,0.10268084801979614,17662633.518121906,402868.5978755083,18065502.115997415,1258,5,882.5971659919028,98,396,98,33.498404368957985,0.6534863945578231,37.33164983164986,134486.19528619663,1372.3081151652716,0
1260,512,0,0,494,0.0,0.0,1.0,494,14650,10800,3850,0.7372013651877133,185,108,77,143.58134331227095,0.4051347748369207,0.8683163465292165,0.10143044660216285,17680220.9206071,394259.9739677025,18074480.894574802,1259,6,883.5971659919028,100,394,95,33.42760291982268,0.6542708333333334,37.20090759075911,134553.1353135328,1345.5313531353281,0
1261,512,0,0,494,0.0,0.0,1.0,494,13550,10000,3550,0.7380073800738007,171,100,71,146.31995393578146,0.40529302953905283,0.8702064428176581,0.10364799818973361,17692195.416293047,405394.2436669736,18097589.65996002,1260,7,884.5971659919028,101,393,92,33.265351047574676,0.6549092409240924,37.11192810457519,134598.69281045883,1332.660324856028,0
1262,512,0,0,494,0.0,0.0,1.0,494,13300,9000,4300,0.6766917293233082,176,90,86,142.97603035542372,0.40537258460553005,0.8669436544189495,0.10163141865383729,17707371.897600442,394245.9483892245,18101617.845989667,1261,8,885.5971659919028,103,391,82,33.23891766318836,0.6555420711974109,36.999198717948744,134656.41025641162,1307.3437888972003,0
1263,512,0,0,494,0.0,0.0,1.0,494,13050,9100,3950,0.6973180076628352,170,91,79,142.16494828780543,0.40548729787880533,0.865873611447497,0.10137123002620098,17721010.226412144,392011.3004891175,18113021.52690126,1262,9,886.5971659919028,108,386,84,33.15754664438874,0.6553819444444444,36.89793577981654,134708.25688073566,1247.2986748216265,0
1264,512,1,0,495,0.00202020202020202,0.0,1.0,495,13850,9300,4550,0.6714801444043321,184,93,91,141.08545437615243,0.4054783666625772,0.8651704224878767,0.10099511530987944,17738011.873374168,387665.09297692415,18125676.96635109,1263,0,885.8040404040404,112,383,88,33.05798750948457,0.6557849702380952,36.771755162241924,134772.86135693433,1203.3291192583422,0
1265,512,1,0,496,0.0020161290322580645,0.0,1.0,496,14250,10700,3550,0.7508771929824561,178,107,71,141.60408381904924,0.4057906857554035,0.8665361500489752,0.10190985656036755,17761224.504452966,389562.38469150855,18150786.889144477,1264,0,885.016129032258,117,379,92,32.86971870321964,0.656517094017094,36.59957627118647,134861.01694915426,1152.658264522686,0
1266,512,0,0,496,0.0,0.0,1.0,496,14900,10500,4400,0.7046979865771812,193,105,88,145.76161496066706,0.4055800783371348,0.869710954757767,0.10522338468670187,17774470.17128485,404067.09544734453,18178537.266732194,1265,1,886.016129032258,120,376,94,32.66057893361213,0.6569444444444444,36.50137741046835,134911.29476584218,1124.2607897153514,0
1267,512,0,0,496,0.0,0.0,1.0,496,13700,10200,3500,0.7445255474452555,172,102,70,150.7648210846347,0.4054589917997176,0.8747308691419591,0.10017836981557988,17406520.303020384,411958.1838381853,17818478.48685857,1266,2,887.016129032258,100,396,96,35.31168835449378,0.6336458333333334,39.242986798679866,133507.59075907577,1335.0759075907577,8
1268,512,1,0,497,0.002012072434607646,0.0,1.0,497,13750,10200,3550,0.7418181818181818,173,102,71,148.45780916536796,0.40597634868349886,0.8723583565033133,0.09918429653230064,17431287.704711527,404412.15671453805,17835699.861426063,1267,0,886.2293762575453,104,393,80,35.18364508484455,0.6345152243589743,39.057539682539684,133602.5396825398,1284.6398046398058,0
1269,512,0,0,497,0.0,0.0,1.0,497,13100,8600,4500,0.6564885496183206,176,86,90,148.26108088544788,0.405755264111551,0.872452078309228,0.0994157144729669,17447865.499537095,404867.87962105765,17852733.379158154,1268,1,887.2293762575453,108,389,82,35.06288588720502,0.634837962962963,38.93348623853211,133666.0550458717,1237.6486578321453,0
1270,512,0,0,497,0.0,0.0,1.0,497,12300,8600,3700,0.6991869918699187,160,86,74,146.76166884649064,0.4057290652517254,0.8712301556285551,0.09868079375424486,17460286.158370104,400800.147027936,17861086.30539804,1269,2,888.2293762575453,114,383,84,35.00776047447283,0.6345029239766082,38.84057971014493,133713.6231884059,1172.926519196543,0
1271,512,0,0,497,0.0,0.0,1.0,497,14350,10300,4050,0.7177700348432056,184,103,81,148.70678940090298,0.40560821244672335,0.8723336163740694,0.10025195684820333,17472165.82711522,405895.9368060969,17878061.763921317,1270,3,889.2293762575453,118,379,87,34.866811861283324,0.6346221751412429,38.75175070028012,133759.10364145704,1133.5517257750596,0
1272,512,0,0,497,0.0,0.0,1.0,497,14700,10600,4100,0.7210884353741497,188,106,82,150.05509630413957,0.4056501306224443,0.8747860904096716,0.10164158656491523,17493531.116313994,410898.6992715907,17904429.815585583,1271,4,890.2293762575453,123,374,92,34.66951067977801,0.6353319783197833,38.59206989247311,133840.86021505352,1088.1370749191342,0
1273,512,0,0,497,0.0,0.0,1.0,497,13950,10200,3750,0.7311827956989247,177,102,75,152.59605356532063,0.40546403420523136,0.8764990462714233,0.10365318375047829,17506149.615266036,420923.8688827244,17927073.48414876,1272,5,891.2293762575453,94,403,94,34.5073867527639,0.6428413120567376,38.49780701754383,133889.122807016,1424.3523702874045,0
1274,512,2,0,499,0.004008016032064128,0.0,1.0,499,14250,10800,3450,0.7578947368421053,177,108,69,148.14404330088075,0.4059814743275037,0.8718650433021629,0.10118445298266707,17530836.07961689,405367.7878558773,17936203.867472768,1273,0,888.6533066132265,104,395,104,34.43676232719184,0.6420272435897436,38.31349206349204,133983.49206349096,1288.3028083027978,0
1275,512,0,0,499,0.0,0.0,1.0,499,13600,9900,3700,0.7279411764705882,173,99,74,146.12221345626364,0.40606245959120385,0.8703643398904464,0.1002730447579103,17551822.182542738,399542.2215007738,17951364.40404351,1274,1,889.6533066132265,110,389,94,34.33079767280716,0.6422348484848485,38.15690690690688,134063.6636636624,1218.7605787605671,0
1276,512,0,1,498,0.0,0.002004008016032064,0.9979959919839679,499,12850,9100,3750,0.708171206225681,166,91,75,144.7613299002605,0.4059150764715509,0.8693084313416923,0.09988392435562635,17576198.146438044,396220.7636537677,17972418.91009181,1275,2,890.6533066132265,113,386,80,34.182039568512614,0.6434365781710915,37.97514619883039,134156.72514619745,1187.2276561610395,0
1277,512,0,1,497,0.0,0.002008032128514056,0.9979919678714859,498,13900,10500,3400,0.7553956834532374,173,105,68,141.62672036014516,0.40567854920688795,0.8656580592449923,0.09806548417900691,17591836.19994621,384794.81322225044,17976631.01316846,1276,3,893.437751004016,121,377,85,34.1459839749853,0.6430785123966942,37.858606557377044,134216.39344262262,1109.2263920877901,0
1278,512,0,0,497,0.0,0.0,1.0,497,14250,10500,3750,0.7368421052631579,180,105,75,143.22274921618697,0.4053181657147184,0.8672876973611079,0.0996686058452288,17614041.81480509,390896.29870504944,18004938.11351014,1277,10,896.2293762575453,123,374,93,33.93638243928474,0.6443936314363143,37.693212365591386,134301.0752688165,1091.8786607220852,0
1279,512,0,0,497,0.0,0.0,1.0,497,14900,10800,4100,0.7248322147651006,190,108,82,149.11501290206195,0.40532847623374657,0.8735067990995449,0.10425019221876908,17634488.619532708,411613.3996045747,18046102.019137282,1278,11,897.2293762575453,126,371,95,33.627352938112644,0.6454199735449735,37.541010498687655,134379.00262467127,1066.5000208307242,0
1280,512,0,0,497,0.0,0.0,1.0,497,13800,9500,4300,0.6884057971014492,181,95,86,147.32341257479618,0.4053144471668722,0.8726203013015685,0.10360981263361242,17660594.24259912,407163.8023837036,18067758.04498282,1279,12,898.2293762575453,101,396,101,33.47731735292976,0.6525371287128713,37.346813725490215,134478.43137254994,1331.4696175499994,0
1281,512,0,0,497,0.0,0.0,1.0,497,13650,9700,3950,0.7106227106227107,176,97,79,173.4563104844843,0.4053533228943554,0.8907894869930943,0.11775594857938959,17503598.041068308,494171.90728143207,17997769.94834974,1280,13,899.2293762575453,83,414,83,33.98127509564005,0.6463353413654618,38.51686507936508,133879.3650793653,1613.0043985465697,8
1282,512,0,0,497,0.0,0.0,1.0,497,13150,9900,3250,0.752851711026616,164,99,65,172.2735786439311,0.40533929382748096,0.8894454038895654,0.11749445195153513,17524328.180737235,491245.7458052597,18015573.926542494,1281,14,900.2293762575453,86,411,86,33.85473869668681,0.6468023255813953,38.362068965517246,133958.6206896553,1557.658380112271,0
1283,512,0,1,496,0.0,0.002012072434607646,0.9979879275653923,497,12300,8800,3500,0.7154471544715447,158,88,70,172.028433031117,0.40520103145756253,0.8884445464360926,0.11785094518851708,17544260.692344006,491922.3351186708,18036183.027462676,1282,15,901.2293762575453,91,406,86,33.70983990023496,0.6466346153846154,38.2133152173913,134034.78260869536,1472.9096989966522,0
1284,512,0,0,496,0.0,0.0,1.0,496,14200,10900,3300,0.7676056338028169,175,109,66,181.55546097471117,0.4049732031334854,0.8951059478261922,0.12374987167586662,17521611.0726644,522828.83506343915,18044439.907727838,1283,16,903.9858870967741,84,412,84,33.632541690088075,0.6473214285714286,38.38235294117648,133948.23529411794,1594.6218487394992,7
1285,512,0,0,496,0.0,0.0,1.0,496,15100,10900,4200,0.7218543046357616,193,109,84,176.05566488951956,0.4051550450743999,0.891195520794096,0.12088121554925318,17554297.895710453,503806.7175395985,18058104.61325005,1284,17,904.9858870967741,92,404,78,33.52821976987895,0.6470788043478262,38.13844086021505,134073.11827956964,1457.3165030388004,0
1286,512,0,0,496,0.0,0.0,1.0,496,15050,11000,4050,0.7308970099667774,191,110,81,175.02472432576496,0.4051638698816118,0.8902866889888608,0.12055982651631736,17568614.034770362,500738.3656442865,18069352.40041465,1285,18,905.9858870967741,95,401,71,33.44659079926548,0.6472587719298246,38.031684027777764,134127.7777777771,1411.8713450292328,0
1287,512,0,0,496,0.0,0.0,1.0,496,14900,11200,3700,0.7516778523489933,186,112,74,174.0800842068344,0.404916690425763,0.8895561845759465,0.1205784069506045,17593364.197530713,498430.86419752537,18091795.06172824,1286,19,906.9858870967741,101,395,75,33.28366445916113,0.647483498349835,37.8472222222222,134222.22222222105,1328.9328932893175,0
1288,512,0,0,496,0.0,0.0,1.0,496,12300,9200,3100,0.7479674796747967,154,92,62,178.44416880490138,0.4049532624633431,0.8849217497835342,0.11790782625561684,17380958.049886756,508806.1224489853,17889764.17233574,1287,20,907.9858870967741,97,399,97,34.784884827717526,0.6325171821305842,39.43452380952383,133409.52380952486,1375.355915562112,8
1289,512,1,0,497,0.002012072434607646,0.0,1.0,497,13450,9900,3550,0.7360594795539034,170,99,71,180.92388384741923,0.40549581088682635,0.8868603103482431,0.12013439996120887,17403348.097953852,516886.2659660844,17920234.363919936,1288,0,907.1569416498994,101,396,94,34.549461112634326,0.633147689768977,39.26674836601308,133495.4248366019,1321.7368795703158,0
1290,512,2,1,498,0.004008016032064128,0.002004008016032064,0.9979959919839679,499,13250,9700,3550,0.7320754716981132,168,97,71,181.84314435286166,0.40607436425729637,0.8889167888014824,0.12134950868169109,17426073.116526518,520712.38584641344,17946785.50237293,1289,0,904.5170340681362,106,393,66,34.35222325870647,0.6336477987421384,39.09657320872275,133582.55451713462,1260.212778463534,0
1291,512,1,1,498,0.002004008016032064,0.002004008016032064,0.9979959919839679,499,14250,10500,3750,0.7368421052631579,180,105,75,182.16574688325483,0.4057904966559625,0.888132347565854,0.12189051104271477,17438216.73553732,521279.1551882503,17959495.89072557,1290,0,905.5150300601202,109,390,71,34.251259327794095,0.6338876146788991,39.005681818181834,133629.0909090919,1225.9549624687331,0
1292,512,0,0,498,0.0,0.0,1.0,498,14000,10400,3600,0.7428571428571429,176,104,72,182.73979492168394,0.4055471550858026,0.8893430892333603,0.1226166679431926,17450873.301193886,524193.8016528968,17975067.102846783,1291,1,908.3293172690763,109,389,75,34.13984953997559,0.6348432721712538,38.910984848484865,133677.57575757676,1226.3997775924474,0
1293,512,0,0,498,0.0,0.0,1.0,498,13000,9000,4000,0.6923076923076923,170,90,80,192.16961793244766,0.40549976566224655,0.8950122400885603,0.1294392789006845,17468207.921093713,558771.7684322305,18026979.689525943,1292,2,909.3293172690763,112,386,76,33.761513215936795,0.6355096726190477,38.78134218289087,133743.95280236058,1194.1424357353624,0
1294,512,1,0,499,0.002004008016032064,0.0,1.0,499,15500,11300,4200,0.7290322580645161,197,113,84,192.64687578347076,0.40579502378250476,0.8963827825023347,0.13038413298979856,17489821.0069446,558571.8750000049,18048392.881944604,1293,0,908.5050100200401,119,380,82,33.58438361396173,0.6357668067226891,38.619791666666686,133826.66666666788,1124.5938375350242,0
1295,512,1,0,500,0.002,0.0,1.0,500,13150,8900,4250,0.6768060836501901,174,89,85,191.86025331069314,0.40611047094188374,0.8967823489477265,0.13047560162818558,17511371.70712803,558797.2423094551,18070168.949437484,1294,0,907.686,87,413,87,33.44087086067739,0.6454741379310345,38.458806818181806,133909.09090909036,1539.1849529780502,0
1296,512,0,0,500,0.0,0.0,1.0,500,14350,10500,3850,0.7317073170731707,182,105,77,188.56378032134694,0.4058371743486974,0.8952024668678644,0.12888292106089505,17534005.856780518,546905.6857062322,18080911.54248675,1295,1,908.686,90,410,90,33.35492936185101,0.6461805555555555,38.289835164835154,133995.6043956039,1488.8400488400434,0
1297,512,1,0,501,0.001996007984031936,0.0,1.0,501,13150,9700,3450,0.7376425855513308,166,97,69,188.31629538263348,0.405875748502994,0.8946370776669106,0.12965281945437648,17566468.54075877,548260.4557102504,18114728.99646902,1296,0,907.8702594810379,96,405,67,33.11469137320816,0.6468098958333333,38.04768041237112,134119.58762886538,1397.0790378006811,0
1298,512,0,0,501,0.0,0.0,1.0,501,14450,10100,4350,0.698961937716263,188,101,87,187.56255304338822,0.40564604125083165,0.8935270438219376,0.12966841018457867,17584850.86394627,545001.904585793,18129852.768532064,1297,1,908.8702594810379,103,398,70,32.99484242238947,0.6463389967637541,37.91065705128203,134189.74358974246,1302.8130445606064,0
1299,512,0,1,500,0.0,0.001996007984031936,0.998003992015968,501,14250,10300,3950,0.7228070175438597,182,103,79,190.7051043748005,0.40559946773120426,0.895833080959866,0.13236404576557717,17602427.435794692,556924.5522786102,18159351.988073304,1298,2,909.8702594810379,107,394,73,32.77903195154544,0.6467095015576324,37.779706790123434,134256.7901234556,1254.7363562939777,0
1300,512,0,0,500,0.0,0.0,1.0,500,14750,10100,4650,0.6847457627118644,194,101,93,193.8186996686468,0.4050481796927188,0.8986802458054284,0.13515051648054785,17622960.638521105,568381.8630539725,18191342.50157508,1299,3,912.682,114,386,76,32.54152857373007,0.6467470760233918,37.62681159420287,134335.07246376647,1178.3778286295303,0
1301,512,0,0,500,0.0,0.0,1.0,500,12950,8700,4250,0.6718146718146718,172,87,85,194.22192156192872,0.4049261857047428,0.8999321293907543,0.13573984226775976,17633000.694444235,571993.0555555488,18204993.749999784,1300,4,913.682,119,381,78,32.45476946484089,0.6465336134453781,37.55208333333331,134373.33333333174,1129.1876750700146,0
1302,512,0,0,500,0.0,0.0,1.0,500,13500,9300,4200,0.6888888888888889,177,93,84,190.76827420539814,0.4050136105544422,0.8990065465666368,0.13410170219336132,17658559.095821034,560238.5687327628,18218797.6645538,1301,5,914.682,82,418,82,32.35164699511001,0.6584095528455285,37.36194779116466,134470.6827309237,1639.8863747673622,0
1303,512,0,0,500,0.0,0.0,1.0,500,13750,10000,3750,0.7272727272727273,175,100,75,186.09984237304758,0.40510855043420174,0.894502831257078,0.13146092865232178,17680022.67573711,544299.886621322,18224322.56235843,1302,6,915.682,90,410,82,32.311721404303526,0.657175925925926,37.20238095238098,134552.38095238208,1495.0264550264676,0
1304,512,0,0,500,0.0,0.0,1.0,500,12650,8900,3750,0.7035573122529645,164,89,75,186.00591194653884,0.4052741315965264,0.8934561474415956,0.1321699676444944,17705775.4870657,546025.7832384708,18251801.27030417,1303,7,916.682,97,403,70,32.119304556354926,0.6570017182130584,37.011054421768726,134650.34013605537,1388.147836454179,0
1305,512,0,0,500,0.0,0.0,1.0,500,13300,9700,3600,0.7293233082706767,169,97,72,185.704527210449,0.4050832498329993,0.8937031286032739,0.13251948406367217,17724372.492956817,544999.2427812908,18269371.735738106,1304,8,917.682,102,398,72,31.986589412458045,0.6570669934640523,36.87297734627833,134721.0355987063,1320.7944666539834,0
1306,512,0,0,500,0.0,0.0,1.0,500,13650,10200,3450,0.7472527472527473,171,102,69,183.9942612477538,0.4049608383433534,0.8935992899933431,0.13183817733603037,17742203.685911532,539242.7320192972,18281446.41793083,1305,9,918.682,106,394,76,31.896833321006852,0.6574292452830188,36.74065420560749,134788.78504672972,1271.5923117616012,0
1307,512,0,0,500,0.0,0.0,1.0,500,13700,9500,4200,0.6934306569343066,179,95,84,180.983186522384,0.4050467601870407,0.8922801364395097,0.1300869758524753,17755785.708273884,528999.7353384092,18284785.443612292,1306,10,919.682,108,392,80,31.873533396231007,0.6579861111111112,36.63990825688076,134840.36697247837,1248.5219164118369,0
1308,512,0,0,500,0.0,0.0,1.0,500,13750,10000,3750,0.7272727272727273,175,100,75,183.06214067728462,0.4049740313961256,0.8943607610575717,0.1320592661891226,17771494.140625168,536907.5520833392,18308401.692708507,1307,11,920.682,111,389,82,31.700179145045713,0.6585022522522522,36.52343750000002,134900.00000000128,1215.3153153153269,0
1309,512,0,1,499,0.0,0.002,0.998,500,14900,10600,4300,0.7114093959731543,192,106,86,181.36249067342646,0.40474198396793587,0.8940076297742865,0.1314922845616775,17793204.775326107,530503.9870230838,18323708.762349192,1308,12,921.682,86,414,86,31.58115339782306,0.6670300387596899,36.36254789272028,134982.37547892603,1569.5625055689072,0
1310,512,0,0,499,0.0,0.0,1.0,499,13850,9600,4250,0.6931407942238267,181,96,85,179.77193800580335,0.40432169560003545,0.8927281727674197,0.1309053365698465,17811877.32328951,526765.141185868,18338642.46447538,1309,13,924.2705410821643,88,411,88,31.482303175518766,0.6677320075757576,36.224250936329554,135053.18352059773,1534.6952672795196,0
1311,512,0,0,499,0.0,0.0,1.0,499,13650,10300,3350,0.7545787545787546,170,103,67,181.89783431425,0.4042199190885117,0.8936388697050277,0.13302227126470498,17830288.2030177,535208.1618655632,18365496.364883263,1310,14,925.2705410821643,89,410,83,31.287460164313053,0.6687734082397003,36.08796296296294,135122.96296296196,1518.235538909685,0
1312,512,0,0,499,0.0,0.0,1.0,499,13650,9300,4350,0.6813186813186813,180,93,87,183.4252295894069,0.4041634138424104,0.8939964871828607,0.13473046765278565,17849126.804486595,541346.0364166748,18390472.84090327,1311,15,926.2705410821643,93,406,71,31.10521235521234,0.6689068100358423,35.94858156028367,135194.326241134,1453.7024327003655,0
1313,512,0,1,498,0.0,0.002004008016032064,0.9979959919839679,499,12550,8700,3850,0.6932270916334662,164,87,77,181.22646193882832,0.4041389338248116,0.8926558593543852,0.13339078651505878,17857960.82296477,534917.0114776182,18392877.83444239,1312,16,927.2705410821643,95,404,73,31.09675205072371,0.668969298245614,35.88324652777776,135227.77777777685,1423.450292397651,0
1314,512,0,1,497,0.0,0.002008032128514056,0.9979919678714859,498,13450,9300,4150,0.6914498141263941,176,93,83,178.3480262553855,0.4039274973805349,0.8908561556191148,0.13189802444728768,17878250.058738023,524660.1221752288,18402910.18091325,1313,17,929.781124497992,101,397,78,31.020106336386238,0.6688325082508251,35.73325163398692,135304.57516339817,1339.6492590435462,0
1315,512,0,0,497,0.0,0.0,1.0,497,13200,9400,3800,0.7121212121212122,170,94,76,176.13085214856497,0.4037153025680968,0.8901470036980725,0.13082448607253236,17896696.35519388,517832.075936881,18414528.43113076,1314,18,932.5251509054326,103,394,81,30.940001767810678,0.6697006472491909,35.59695512820512,135374.35897435845,1314.3141647995965,0
1316,512,0,0,497,0.0,0.0,1.0,497,13000,9100,3900,0.7,169,91,78,176.913182998846,0.4036803144133619,0.891180563949066,0.13175376523334983,17907925.583020177,521229.6231597065,18429155.206179883,1315,19,933.5251509054326,106,391,82,30.834913010404392,0.6698113207547169,35.51401869158876,135416.8224299052,1277.5171927349547,0
1317,512,0,0,497,0.0,0.0,1.0,497,13250,9700,3550,0.7320754716981132,168,97,71,176.35583572421922,0.40344841224767963,0.8916530057821328,0.13170751238091505,17919804.550563753,519402.4215058608,18439206.972069614,1316,20,934.5251509054326,107,390,83,30.760400337817302,0.6704633956386292,35.426311728395035,135461.72839506032,1265.9974616360778,0
1318,512,0,0,497,0.0,0.0,1.0,497,13150,8900,4250,0.6768060836501901,174,89,85,176.54350051498938,0.4031446744986045,0.8911887458543675,0.13244019798781376,17938754.340277877,520844.0972222266,18459598.437500104,1317,21,935.5251509054326,87,410,87,30.61311280537792,0.6775622605363985,35.28645833333335,135533.3333333341,1557.854406130277,0
1319,512,0,0,497,0.0,0.0,1.0,497,14500,9900,4600,0.6827586206896552,191,99,92,178.13617735202345,0.4031585345405768,0.8923323375237724,0.13408214067754198,17952835.50056826,525709.8977401915,18478545.398308452,1318,22,936.5251509054326,88,409,88,30.46522805621852,0.6782670454545454,35.18258426966295,135586.51685393372,1540.7558733401559,0
1320,512,0,0,497,0.0,0.0,1.0,497,13450,9500,3950,0.7063197026022305,174,95,79,174.76004809463143,0.4025412555981048,0.8899219773230957,0.1319739673542226,17966659.729448613,515120.8636836683,18481780.59313228,1319,23,937.5251509054326,92,405,89,30.450913242009122,0.6779891304347826,35.08064516129034,135638.7096774203,1474.3338008415249,0
1321,512,0,0,497,0.0,0.0,1.0,497,13150,8900,4250,0.6768060836501901,174,89,85,170.90542106392047,0.4023519477077519,0.8867961499140842,0.12943541792119284,17978753.760007415,501983.2963117224,18480737.056319136,1320,24,938.5251509054326,97,400,70,30.46235761270657,0.677405498281787,34.99149659863946,135684.35374149668,1398.8077705308935,0
1322,512,1,0,498,0.002008032128514056,0.0,1.0,498,14600,10200,4400,0.6986301369863014,190,102,88,166.51110178981506,0.40218873481854983,0.8838947259295329,0.12680460828608983,18001836.73469386,485301.1337868474,18487137.868480705,1321,0,937.6385542168674,104,394,76,30.4059109614665,0.6772836538461539,34.82142857142857,135771.42857142843,1305.4945054945042,0
1323,512,0,0,498,0.0,0.0,1.0,498,15000,11100,3900,0.74,189,111,78,166.35371837394854,0.4018740959815115,0.8833869509451424,0.1270942408376963,18015308.64197525,484782.7160493808,18500091.35802463,1322,1,938.6385542168674,107,391,79,30.30922774869111,0.677570093457944,34.722222222222214,135822.22222222178,1269.3665628245026,0
1324,512,0,0,498,0.0,0.0,1.0,498,13700,9900,3800,0.7226277372262774,175,99,76,164.64531621455848,0.4017503616073954,0.8817276034340331,0.1263293226581692,18033157.57198629,480514.9861573246,18513672.558143616,1323,2,939.6385542168674,110,388,85,30.221003347240895,0.678219696969697,34.590840840840826,135889.48948948865,1235.3589953589878,0
1325,512,0,0,498,0.0,0.0,1.0,498,14400,10700,3700,0.7430555555555556,181,107,74,168.5460620506711,0.4014925395747982,0.8847653423204966,0.12996207695740697,18053646.918402653,494574.2187499956,18548221.13715265,1324,3,940.6385542168674,111,387,86,29.96419669853722,0.6795232732732732,34.44010416666665,135966.6666666657,1224.9249249249162,0
1326,512,0,0,498,0.0,0.0,1.0,498,12900,9600,3300,0.7441860465116279,162,96,66,172.0818398439186,0.4013545799563108,0.8885392396572627,0.13318186063120785,18069013.99715221,509369.83455909725,18578383.831711307,1325,4,941.6385542168674,86,412,86,29.755359262096853,0.6876211240310077,34.3271072796935,136024.52107279756,1581.6804775906694,0
1327,512,0,0,498,0.0,0.0,1.0,498,12050,8100,3950,0.6721991701244814,160,81,79,172.94832574948376,0.4010948219437105,0.889193331315641,0.1342681815258444,18081823.34710749,513794.21487603546,18595617.561983526,1326,5,942.6385542168674,87,411,87,29.636557990379494,0.6882183908045977,34.232954545454554,136072.72727272767,1564.0543364681341,0
1328,512,0,0,498,0.0,0.0,1.0,498,13150,8200,4950,0.623574144486692,181,82,99,173.0349803486411,0.4009619968808837,0.8897448950732509,0.1350053143379509,18102315.925318085,513716.77608046174,18616032.701398548,1327,6,943.6385542168674,88,410,87,29.48109228286388,0.6893939393939394,34.08239700374532,136149.8127340825,1547.156962887301,0
1329,512,0,0,498,0.0,0.0,1.0,498,13750,9400,4350,0.6836363636363636,181,94,87,171.1460299027426,0.4006472738708018,0.8884380897082291,0.13401057058422386,18117028.270874545,506781.4924391895,18623809.763313733,1328,7,944.6385542168674,90,408,87,29.421435742971877,0.6898148148148149,33.97435897435899,136205.12820512912,1513.3903133903236,0
1330,512,0,0,498,0.0,0.0,1.0,498,12500,8600,3900,0.688,164,86,78,173.21771605960186,0.40078203491363174,0.8887990335760094,0.13612554544788646,18131892.761933565,516053.01041195367,18647945.77234552,1329,8,945.6385542168674,93,405,76,29.255322840328677,0.6899641577060932,33.865248226950364,136260.99290780188,1465.1719667505579,0
1331,512,0,0,498,0.0,0.0,1.0,498,14350,10300,4050,0.7177700348432056,184,103,81,172.21473458494262,0.4006433177377518,0.8879574562821198,0.13607813667219296,18154198.579510134,511334.09799454047,18665532.677504674,1330,9,946.6385542168674,98,400,79,29.11554848736286,0.6901573129251701,33.70159932659934,136344.78114478197,1391.273276987571,0
1332,512,0,0,498,0.0,0.0,1.0,498,13500,9300,4200,0.6888888888888889,177,93,84,175.0299596233772,0.400390461914728,0.8902382206545054,0.13894276203943629,18173005.03883158,523064.0676364323,18696069.106468014,1331,10,947.6385542168674,103,395,79,28.900268473616315,0.6902305825242718,33.563701923076955,136415.38461538628,1324.4212098581193,0
1333,512,0,0,498,0.0,0.0,1.0,498,13900,10300,3600,0.7410071942446043,175,103,72,169.65579644688648,0.4001451816656296,0.8852293339512445,0.12281440267900089,17786525.240054745,490017.4211248232,18276542.66117957,1332,11,948.6385542168674,89,409,89,31.940114458007706,0.6654962546816479,36.41203703703702,134957.0370370361,1516.3712026633268,8
1334,512,0,1,497,0.0,0.002008032128514056,0.9979919678714859,498,15100,11200,3900,0.7417218543046358,190,112,78,165.88619734860302,0.39993415984528324,0.8818201443401026,0.12083351216907151,17813280.606460206,476295.4764218578,18289576.082882065,1333,12,949.6385542168674,97,401,97,31.838012585458873,0.6650558419243986,36.213860544217674,135058.50340136004,1392.3557051686603,0
1335,512,0,0,497,0.0,0.0,1.0,497,13950,10100,3850,0.7240143369175627,178,101,77,165.53825082945212,0.3998385474135133,0.8803188183770081,0.121036409372703,17829506.24999995,476943.05555555364,18306449.305555504,1334,13,952.148893360161,99,398,89,31.72509209920399,0.665719696969697,36.09374999999999,135119.99999999962,1364.8484848484811,0
1336,512,0,0,497,0.0,0.0,1.0,497,14900,10200,4700,0.6845637583892618,196,102,94,167.55246490487315,0.39968219937907007,0.8817227440490492,0.12289848542685292,17843105.565505102,483631.26381164556,18326736.829316746,1335,14,953.148893360161,102,395,76,31.569622677647956,0.6659517973856209,35.99312297734627,135171.52103559813,1325.2109905450798,0
1337,512,0,0,497,0.0,0.0,1.0,497,12500,8000,4500,0.64,170,80,90,166.12814602899195,0.39954528920836846,0.8810631145659404,0.12218193203018943,17854611.07155569,481330.68707725115,18335941.75863294,1336,15,954.148893360161,105,392,78,31.520707747265025,0.6660714285714286,35.908018867924525,135215.09433962245,1287.7628032344994,0
1338,512,0,0,497,0.0,0.0,1.0,497,14600,11000,3600,0.7534246575342466,182,110,72,166.89153522273932,0.3994104073364921,0.8825251297992687,0.12316826969481709,17869364.62512508,482449.13914840634,18351813.764273487,1337,16,955.148893360161,108,389,79,31.389637440015417,0.6664737654320987,35.79892966360856,135270.94801223237,1252.5087778910404,0
1339,512,0,0,497,0.0,0.0,1.0,497,15100,11300,3800,0.7483443708609272,189,113,76,167.06060331873763,0.3992653839704896,0.8829533389202997,0.1238444566386321,17888368.14413263,483188.3149092963,18371556.459041927,1338,17,956.148893360161,111,386,84,31.242376797316638,0.6672297297297297,35.65848214285714,135342.85714285696,1219.3050193050176,0
1340,512,0,0,497,0.0,0.0,1.0,497,13700,9900,3800,0.7226277372262774,175,99,76,169.75154809460315,0.3990867246489691,0.8844781963698596,0.12629202726854338,17903622.266997706,494733.5192647789,18398355.786262486,1339,18,957.148893360161,120,377,85,31.05664789435426,0.6665798611111111,35.545798898071645,135400.55096418853,1128.3379247015712,0
1341,512,0,0,497,0.0,0.0,1.0,497,13000,8300,4700,0.6384615384615384,177,83,94,167.15212991909075,0.3989346022370784,0.8824608965454019,0.12473933983101809,17916595.840000197,486559.4311111172,18403155.271111313,1340,19,958.148893360161,124,373,92,31.027990402990433,0.6668346774193548,35.450000000000024,135449.60000000152,1092.33548387098,0
1342,512,0,0,497,0.0,0.0,1.0,497,14200,10100,4100,0.7112676056338029,183,101,82,171.09062062362943,0.3988296377728738,0.8853347110586296,0.12817459343926554,17932996.121883497,500033.48722683196,18433029.60911033,1341,20,959.148893360161,94,403,94,30.800673902836422,0.6748670212765957,35.32894736842103,135511.5789473672,1441.6125419932682,0
1343,512,0,0,497,0.0,0.0,1.0,497,14000,10700,3300,0.7642857142857142,173,107,66,172.36442992968952,0.3986051727028839,0.8834849306689447,0.12967375475710538,17950756.69444424,505414.38888888014,18456171.08333312,1342,21,960.148893360161,99,398,99,30.633670652872286,0.6747685185185186,35.197916666666636,135578.66666666509,1369.4814814814656,0
1344,512,0,0,497,0.0,0.0,1.0,497,14600,11100,3500,0.7602739726027398,181,111,70,169.17738371752242,0.3983245913653967,0.8811978536869849,0.12770698527656302,17964978.26792744,493853.60438201565,18458831.872309458,1343,22,961.148893360161,102,395,94,30.611415464101157,0.6750408496732025,35.09304207119738,135632.36245954534,1329.729043721033,0
1345,512,0,0,497,0.0,0.0,1.0,497,15800,11500,4300,0.7278481012658228,201,115,86,167.03987827604922,0.39796406124921574,0.8792225325084746,0.12674473387977325,17986595.06427892,485695.7300275393,18472290.794306457,1344,23,962.148893360161,109,388,75,30.506048074976427,0.6749808868501529,34.93371212121209,135713.9393939376,1245.0820127884183,0
1346,512,0,0,497,0.0,0.0,1.0,497,13900,10400,3500,0.7482014388489209,174,104,70,166.72096261024845,0.39788174612189264,0.8793389574366068,0.1269046967315096,17999870.01940443,486891.1312988845,18486761.150703315,1345,24,963.148893360161,112,385,78,30.41507329509237,0.6753162202380952,34.83591445427726,135764.01179940847,1212.1786767804329,0
1347,512,0,0,497,0.0,0.0,1.0,497,13400,9800,3600,0.7313432835820896,170,98,72,168.25176236119697,0.3977573437939465,0.8828986372970975,0.1287577006600935,18022220.756539535,493654.0807900538,18515874.83732959,1346,25,964.148893360161,115,382,80,30.207134678083445,0.6763586956521739,34.67133620689651,135848.2758620667,1181.2893553223191,0
1348,512,0,0,497,0.0,0.0,1.0,497,13300,9500,3800,0.7142857142857143,171,95,76,167.70791175359625,0.39766285887367214,0.8832800561894589,0.1286587998691448,18032498.344185565,492138.52820069704,18524636.87238626,1347,26,965.148893360161,117,380,82,30.144651865402686,0.676727207977208,34.59569209039544,135887.005649715,1161.4273987155127,0
1349,512,0,0,497,0.0,0.0,1.0,497,13950,10200,3750,0.7311827956989247,177,102,75,165.83516117994205,0.3975065108392289,0.8824734428453431,0.12757709123509026,18044076.516035877,485118.4674759938,18529194.983511873,1348,27,966.148893360161,122,375,85,30.107751975076273,0.6766564207650273,34.51050135501352,135930.62330623087,1114.1854369363186,0
1350,512,0,0,497,0.0,0.0,1.0,497,11750,8100,3650,0.6893617021276596,154,81,73,167.28251049196217,0.3973298798165336,0.8832035022100504,0.12902409017494382,18054813.479424812,492900.9050604544,18547714.384485267,1349,28,967.148893360161,128,369,88,29.989028419686985,0.6764322916666667,34.4315245478036,135971.05943152326,1062.2739018087755,0
1351,512,0,2,495,0.0,0.004024144869215292,0.9959758551307847,497,13050,9300,3750,0.7126436781609196,168,93,75,167.65549141262767,0.39710017497457867,0.8838678916437983,0.12993029648002605,18074558.74955998,493609.80584478047,18568168.55540476,1350,29,968.148893360161,93,404,93,29.831512219534574,0.6857078853046594,34.28634751773051,136045.39007092273,1462.8536566765886,0
1352,512,0,1,494,0.0,0.00202020202020202,0.997979797979798,495,13550,10200,3350,0.7527675276752768,169,102,67,155.69878069560397,0.39654473207104785,0.8759221595132676,0.11162293710415737,17744517.998163626,440009.96326906077,18184527.961432688,1351,30,971.4464646464646,109,386,87,32.624301608996994,0.6569189602446484,36.72348484848487,134797.57575757708,1236.6750069502484,8
1353,512,0,0,494,0.0,0.0,1.0,494,15350,11900,3450,0.7752442996742671,188,119,69,148.86821354228482,0.3966215272930336,0.8743162531394677,0.10290501059741725,17584303.29313351,409398.7635268956,17993702.056660403,1352,31,973.7105263157895,107,387,77,34.0131211742048,0.6453465732087227,37.914737654320966,134187.65432098642,1254.0902272989385,8
1354,512,0,0,494,0.0,0.0,1.0,494,13900,10800,3100,0.7769784172661871,170,108,62,149.84906051983268,0.39674676236542367,0.8742998710948788,0.10399561039268673,17601950.365069427,414827.1451044704,18016777.5101739,1353,32,974.7105263157895,113,381,80,33.85396702326606,0.645372418879056,37.78326023391811,134254.97076023262,1188.09708637374,0
1355,512,0,0,494,0.0,0.0,1.0,494,13450,9200,4250,0.6840148698884758,177,92,85,151.4738770394034,0.3968994567672106,0.876473701522734,0.10551605817595748,17618468.113083266,421497.5345167569,18039965.64760002,1354,33,975.7105263157895,116,378,84,33.686494603950294,0.6460129310344828,37.66025641025638,134317.9487179469,1157.9133510167837,0
1356,512,0,0,494,0.0,0.0,1.0,494,14700,9800,4900,0.6666666666666666,196,98,98,154.60853655108576,0.39701913153925533,0.8799280206905102,0.10813942077173418,17636470.764776256,431849.7869736053,18068320.551749863,1355,34,976.7105263157895,118,376,85,33.468192429548125,0.6469809322033898,37.52626050420165,134386.55462184688,1138.8691069648041,0
1357,512,0,0,494,0.0,0.0,1.0,494,14400,10600,3800,0.7361111111111112,182,106,76,154.44171690200935,0.3968636142157547,0.879987685614521,0.10838918681510723,17651397.189171333,432022.4175229847,18083419.60669432,1356,35,977.7105263157895,85,409,85,33.35980864738529,0.6567401960784314,37.41521317829457,134443.41085271325,1581.687186502509,0
1358,512,0,0,494,0.0,0.0,1.0,494,14250,10700,3550,0.7508771929824561,178,107,71,151.97717050938942,0.3969784130321122,0.8783487997618551,0.10715645732612517,17671832.529843964,424093.02112029644,18095925.55096426,1357,36,978.7105263157895,87,407,87,33.270258905508456,0.6575670498084292,37.263257575757585,134521.21212121265,1546.2208289794557,0
1359,512,0,0,494,0.0,0.0,1.0,494,13250,9400,3850,0.7094339622641509,171,94,77,152.43516057952866,0.39703102202768586,0.8778329835257646,0.10785681965418357,17687205.45184838,427180.40065112576,18114385.852499507,1358,37,979.7105263157895,91,403,83,33.14223023906957,0.6573946886446886,37.14900362318841,134579.71014492778,1478.897913680525,0
1360,512,0,0,494,0.0,0.0,1.0,494,13500,9700,3800,0.7185185185185186,173,97,76,151.44678265021213,0.3969941529592432,0.8775290560908449,0.1075554690050357,17703425.330871142,423925.3616497435,18127350.692520887,1359,38,980.7105263157895,94,400,74,33.045890144407856,0.6576906028368794,37.02850877192984,134641.40350877275,1432.3553564763058,0
1361,512,0,0,494,0.0,0.0,1.0,494,12850,9000,3850,0.7003891050583657,167,90,77,149.1218014225747,0.39711322892971235,0.8753612112085449,0.1062662994867762,17718322.03960022,416787.6201461006,18135109.65974632,1360,39,981.7105263157895,101,393,76,32.994764372501045,0.6568688118811881,36.917892156862756,134698.0392156868,1333.6439526305624,0
1362,512,0,0,494,0.0,0.0,1.0,494,15300,11800,3500,0.7712418300653595,188,118,70,145.88823194436802,0.39723102175394803,0.8723242486236449,0.10438620476564826,17736056.33668658,403396.3801249852,18139452.716811568,1361,40,982.7105263157895,107,387,81,32.94628679614026,0.6567367601246106,36.78626543209878,134765.4320987662,1259.4900196146375,0
1363,512,0,0,494,0.0,0.0,1.0,494,14800,10800,4000,0.7297297297297297,188,108,80,155.92959109157474,0.3970264027012453,0.8790260215738552,0.11237965234001954,17767395.852623556,440492.55401234905,18207888.406635907,1362,41,983.7105263157895,119,375,87,32.44591392357795,0.6566001400560224,36.55381944444446,134884.4444444452,1133.4827264239093,8
1364,512,1,0,495,0.00202020202020202,0.0,1.0,495,13650,10100,3550,0.73992673992674,172,101,71,157.44393028877005,0.39707483062746224,0.8808344637195917,0.1138899878577361,17783333.46460807,447325.58286073396,18230659.047468804,1363,0,982.7212121212121,91,404,91,32.286028295672594,0.6646062271062272,36.435688405797066,134944.9275362303,1482.9112916069264,0
1365,512,2,0,497,0.004024144869215292,0.0,1.0,497,13400,10300,3100,0.7686567164179104,165,103,62,154.648177747451,0.3977664711386599,0.8783424824469801,0.112422383184646,17804668.222731084,437891.89920865576,18242560.12193974,1364,0,979.7625754527163,97,400,97,32.19921775287845,0.6644115120274914,36.27763605442174,135025.85034013464,1392.019075671491,0
1366,512,0,0,497,0.0,0.0,1.0,497,12300,8700,3600,0.7073170731707317,159,87,72,153.26412318509932,0.39758713571753096,0.8772653289759484,0.11191506210440214,17823876.694444247,434652.16666665854,18258528.861110903,1365,1,980.7625754527163,99,398,95,32.091319266248185,0.6652988215488216,36.135416666666636,135098.66666666514,1364.6329966329813,0
1367,512,0,0,497,0.0,0.0,1.0,497,15550,11700,3850,0.752411575562701,194,117,77,152.22384206800268,0.3973677413946042,0.8764106623960233,0.11158888257381641,17840566.893423967,428201.92743763933,18268768.820861608,1366,2,981.7625754527163,104,393,73,31.993376550169124,0.6652644230769231,36.01190476190475,135161.90476190424,1299.6336996336945,0
1368,512,0,0,497,0.0,0.0,1.0,497,13750,9400,4350,0.6836363636363636,181,94,87,150.62020678285612,0.3973770377642197,0.8744095616591532,0.11063998540392912,17849344.719926484,424544.3985307601,18273889.118457243,1367,3,982.7625754527163,109,388,75,31.96979749438149,0.6647553516819572,35.94696969696969,135195.1515151511,1240.322490964689,0
1369,512,0,0,497,0.0,0.0,1.0,497,12150,8000,4150,0.6584362139917695,163,80,83,147.2524183565043,0.39729269433807146,0.8717527819715905,0.10856821160931421,17865196.938168824,414588.6907121146,18279785.628880937,1368,4,983.7625754527163,115,382,78,31.939770435334363,0.6646739130434782,35.82974137931034,135255.17241379293,1176.131934032982,0
1370,512,0,0,497,0.0,0.0,1.0,497,12600,8800,3800,0.6984126984126984,164,88,76,145.34747774715788,0.39711572526557193,0.8704699620664456,0.10750628310336456,17878802.77777783,407727.77777777903,18286530.555555608,1369,5,984.7625754527163,119,378,82,31.888056759952704,0.6649159663865547,35.72916666666667,135306.66666666706,1137.0308123249333,0
1371,512,0,0,497,0.0,0.0,1.0,497,13300,9000,4300,0.6766917293233082,176,90,86,144.30938188399006,0.39698912561389843,0.8701163062812654,0.10713899151097026,17894734.193344694,403775.606083976,18298509.799428668,1370,6,985.7625754527163,122,375,88,31.796075039772813,0.665556693989071,35.61144986449865,135366.93766937708,1109.5650628637466,0
1372,512,0,0,497,0.0,0.0,1.0,497,12750,8700,4050,0.6823529411764706,168,87,81,147.45696081573652,0.3968461305467212,0.8722971470762759,0.1099909904129582,17914648.589502092,416177.92701798154,18330826.516520076,1371,7,986.7625754527163,130,367,94,31.56361468478217,0.6657051282051283,35.464376590330794,135442.23918575107,1041.8633783519313,0
1373,512,0,0,497,0.0,0.0,1.0,497,12900,9600,3300,0.7441860465116279,162,96,66,142.2259838752872,0.39673001043897793,0.8668571787506532,0.106691479554238,17938586.268581297,397966.6162761322,18336552.88485743,1372,8,987.7625754527163,104,393,104,31.52280165898387,0.6725761217948718,35.28769841269838,135532.6984126968,1303.1990231990078,0
1374,512,0,0,497,0.0,0.0,1.0,497,14600,10300,4300,0.7054794520547946,189,103,86,143.76488967584362,0.39644300615521083,0.8686499493454112,0.10825146722196903,17954407.484869875,402242.6822514861,18356650.167121362,1373,9,988.7625754527163,105,392,105,31.363679233614103,0.6735119047619047,35.17099056603771,135592.45283018725,1291.356693620831,0
1375,512,0,1,496,0.0,0.002012072434607646,0.9979879275653923,497,13300,9400,3900,0.706766917293233,172,94,78,141.27039551919802,0.39640413042772765,0.8659146062745116,0.10665744838489973,17965633.223313212,394902.4222420549,18360535.64555527,1374,10,989.7625754527163,110,387,101,31.345793923506573,0.6732007575757576,35.08821321321319,135634.83483483337,1233.0439530439396,0
1376,512,0,0,496,0.0,0.0,1.0,496,14050,10200,3850,0.7259786476868327,179,102,77,144.02616159200437,0.39633872325404584,0.8677772613909585,0.10923725202465974,17984855.009092968,404807.9267496715,18389662.93584264,1375,11,992.3467741935484,112,384,77,31.129070589735512,0.6742001488095238,34.946533923303804,135707.37463126666,1211.6729877791665,0
1377,512,0,0,496,0.0,0.0,1.0,496,14250,10600,3650,0.743859649122807,179,106,73,140.64302490749603,0.3962513237210818,0.8640458675344955,0.10704418368084972,17999459.8623761,392849.6963491208,18392309.558725223,1376,12,993.3467741935484,118,378,83,31.109630155376532,0.6740819209039548,34.838935574229666,135762.4649859927,1150.5293642880738,0
1378,512,0,0,496,0.0,0.0,1.0,496,13900,9800,4100,0.7050359712230215,180,98,82,140.94104147530254,0.3962200974801781,0.8648765247511203,0.10763904317980952,18013762.42945423,394675.6875391846,18408438.116993416,1377,13,994.3467741935484,121,375,86,30.994914381357006,0.6745867768595042,34.73360655737702,135816.39344262128,1122.449532583647,0
1379,512,0,0,496,0.0,0.0,1.0,496,13050,9100,3950,0.6973180076628352,170,91,79,140.98302817556205,0.39597368170956876,0.8643272735769709,0.1079726140622993,18025415.87931447,396005.54295791674,18421421.422272388,1378,14,995.3467741935484,125,371,90,30.906802037573552,0.67475,34.647817460317434,135860.3174603158,1086.8825396825264,0
1380,512,0,0,496,0.0,0.0,1.0,496,13500,10300,3200,0.762962962962963,167,103,64,138.9286221391053,0.3958661717986314,0.8625376361938488,0.10670736066779675,18037444.59237316,388483.4648257643,18425928.057198923,1379,15,996.3467741935484,129,367,95,30.871563729485494,0.6749838501291989,34.55929487179484,135905.6410256389,1053.532100973945,0
1381,512,0,0,496,0.0,0.0,1.0,496,12800,9200,3600,0.71875,164,92,72,139.9490837190299,0.3956793234767025,0.8642332237198038,0.1077762869821438,18048444.211357415,393172.6459866896,18441616.857344106,1380,16,997.3467741935484,130,366,98,30.76242063967412,0.6756410256410257,34.47837150127222,135947.07379134573,1045.7467214718902,0
1382,512,0,1,495,0.0,0.0020161290322580645,0.9979838709677419,496,14950,11100,3850,0.7424749163879598,188,111,77,139.7801166566236,0.3953175063810144,0.8648376586332567,0.10804816090209456,18063888.91558826,390844.4999786504,18454733.41556691,1381,17,998.3467741935484,101,395,101,30.651735483705615,0.6826526402640264,34.36478758169938,136005.22875817175,1346.5864233482353,0
1383,512,0,1,494,0.0,0.00202020202020202,0.997979797979798,495,13650,9600,4050,0.7032967032967034,177,96,81,157.56098107433473,0.395447048078627,0.8789281041135764,0.11171598616796477,17696319.391046412,444999.888931617,18141319.27997803,1382,18,1000.9535353535354,101,394,72,32.93871787402085,0.6552186468646864,37.08129084967324,134614.3790849691,1332.8156345046448,8
1384,512,1,0,495,0.00202020202020202,0.0,1.0,495,14150,10500,3650,0.7420494699646644,178,105,73,189.1581837791172,0.39566651671914826,0.9003198485197401,0.13651876233188814,17773455.347137287,559248.9065887515,18332704.25372604,1383,0,1001.7111111111111,102,393,75,31.524749878457598,0.6607434640522876,36.50889967637543,134907.44336569702,1322.6219937813432,8
1385,512,0,0,495,0.0,0.0,1.0,495,12800,9100,3700,0.7109375,165,91,74,187.26152094900362,0.39555490805490806,0.8993418978405145,0.13580484513522287,17794336.1111111,554638.8888888883,18348974.99999999,1384,1,1002.7111111111111,79,416,79,31.417094692479917,0.669831223628692,36.354166666666664,134986.6666666666,1708.691983122362,0
1386,512,0,0,495,0.0,0.0,1.0,495,13150,9500,3650,0.7224334600760456,168,95,73,185.8509217402852,0.39560449297291406,0.8986761707857915,0.1353504737746816,17812467.702133834,549942.7081821265,18362410.41031596,1385,2,1003.7111111111111,82,413,82,31.31750166523934,0.6699695121951219,36.21987951807229,135055.42168674697,1647.0173376432556,0
1387,512,0,0,495,0.0,0.0,1.0,495,12350,8300,4050,0.6720647773279352,164,83,81,184.86681423389464,0.39567384370015946,0.8982609523782723,0.13497346141980282,17823297.23183391,547637.2356785858,18370934.467512496,1386,3,1004.7111111111111,84,411,79,31.261804684718193,0.6700148809523809,36.13970588235294,135096.47058823527,1608.2913165266104,0
1388,512,0,1,494,0.0,0.00202020202020202,0.997979797979798,495,13950,9900,4050,0.7096774193548387,180,99,81,180.92197885012052,0.3956150574571627,0.8957031959223987,0.13269550924666354,17842801.783264685,532681.0013717392,18375482.784636423,1387,4,1005.7111111111111,89,406,65,31.218946368551798,0.6697097378277154,35.99537037037036,135170.37037036993,1518.768206408651,0
1389,512,0,1,493,0.0,0.0020242914979757085,0.9979757085020243,494,14400,10400,4000,0.7222222222222222,184,104,80,180.09021288471126,0.39543478811320704,0.8945822767070977,0.13225690587364966,17848353.56688621,529662.7587004218,18378016.325586632,1388,5,1008.5485829959514,92,402,66,31.1990964622041,0.6691576086956521,35.954301075268795,135191.39784946133,1469.4717157550144,0
1390,512,0,0,493,0.0,0.0,1.0,493,13800,10000,3800,0.7246376811594203,176,100,76,177.6677797369406,0.39539254165361126,0.8930047775810595,0.13108651821318137,17868233.506944254,522521.8749999916,18390755.381944247,1389,6,1011.1967545638945,95,398,71,31.11343847543944,0.6697368421052632,35.807291666666636,135266.6666666652,1423.8596491227916,0
1391,512,0,0,493,0.0,0.0,1.0,493,12900,9000,3900,0.6976744186046512,168,90,78,178.04062790555653,0.39546795379211397,0.8934217861859619,0.13161665329646144,17876501.71803397,525048.7181266991,18401550.43616067,1390,7,1012.1967545638945,97,396,72,31.041381749192166,0.6697809278350515,35.74617346938773,135297.95918367206,1394.8243214811553,0
1392,512,0,0,493,0.0,0.0,1.0,493,13850,10100,3750,0.7292418772563177,176,101,75,159.73339311529298,0.3953020127310807,0.8831291483521255,0.11806572129934605,17875877.63537827,458624.9179225476,18334502.55330082,1391,8,1013.1967545638945,105,388,75,31.529843808107113,0.6676587301587302,35.750786163522,135295.59748427614,1288.5294998502488,8
1393,512,1,1,493,0.0020242914979757085,0.0020242914979757085,0.9979757085020243,494,13550,9300,4250,0.6863468634686347,178,93,85,158.08110475459375,0.39554539531853505,0.8827849571832049,0.11731983359184373,17893154.054955732,453363.91211030417,18346517.967066035,1392,0,1012.1437246963562,110,384,78,31.443824246296582,0.6678030303030302,35.62312312312311,135360.96096096002,1230.554190554182,0
1394,512,0,0,493,0.0,0.0,1.0,493,13750,10000,3750,0.7272727272727273,175,100,75,158.02492503791495,0.3951601210991826,0.8825585382528638,0.11763713283180453,17906128.992960237,453572.93836635066,18359701.931326587,1393,1,1015.1784989858012,112,381,83,31.347958057395132,0.6683407738095238,35.527286135693195,135410.02949852397,1209.0181205225356,0
1395,512,0,0,493,0.0,0.0,1.0,493,12400,8200,4200,0.6612903225806451,166,82,84,156.19858478271044,0.3948019563867038,0.8818205215774364,0.11690851375444782,17929039.57833608,449098.1217298605,18378137.70006594,1394,2,1016.1784989858012,88,405,88,31.224477761561456,0.6764914772727273,35.35814606741573,135496.62921348325,1539.7344228804914,0
1396,512,1,0,494,0.0020242914979757085,0.0,1.0,494,12250,8200,4050,0.6693877551020408,163,82,81,155.30842030912888,0.39488859553314554,0.8809027548685959,0.11648878916930129,17937987.062854424,446134.0868515016,18384121.149705924,1395,0,1015.1194331983805,91,403,91,31.18098328984706,0.6761675824175823,35.29211956521739,135530.43478260856,1489.3454371715227,0
1397,512,0,1,493,0.0,0.0020242914979757085,0.9979757085020243,494,11100,7100,4000,0.6396396396396397,151,71,80,177.14484836173747,0.3949177657241872,0.8957828581819776,0.12454474507858448,17659255.251736015,515749.21874999517,18175004.47048601,1396,1,1016.1194331983805,79,415,79,32.70418133293671,0.6596782700421941,37.356770833333314,134473.3333333326,1702.1940928269948,8
1398,512,0,0,493,0.0,0.0,1.0,493,15350,11600,3750,0.755700325732899,191,116,75,172.30480518451105,0.39469991809451566,0.8878709136254075,0.1152220082026658,17435447.94083371,486892.2921500084,17922340.23298372,1397,5,1019.1784989858012,100,393,69,34.52970215512703,0.6358333333333333,39.02640264026403,133618.481848185,1336.18481848185,8
1399,512,3,0,496,0.006048387096774193,0.0,1.0,496,14150,10400,3750,0.734982332155477,179,104,75,168.90064949473623,0.3960914589442815,0.8855884198183746,0.11337241464101208,17452537.746723115,476198.9921505889,17928736.738873705,1398,0,1014.008064516129,107,389,75,34.48851323064042,0.6354166666666667,38.89853395061729,133683.9506172844,1249.382716049387,0
1400,512,2,0,498,0.004016064257028112,0.0,1.0,498,13650,9200,4450,0.673992673992674,181,92,89,162.46415714724833,0.3967172344643497,0.8805459704899614,0.10950897265356249,17471439.09367159,454446.5253005691,17925885.61897216,1399,0,1010.9317269076305,115,383,85,34.51292451533066,0.6351449275362319,38.75718390804598,133756.32183908075,1163.0984507746152,0
1401,512,0,0,498,0.0,0.0,1.0,498,12700,8300,4400,0.6535433070866141,171,83,88,161.7995379386445,0.396628516076378,0.8810694124681593,0.10936212825805444,17483876.393694848,453476.6243752439,17937353.01807009,1400,1,1011.9317269076305,118,380,87,34.435814771395094,0.6355049435028248,38.664215686274524,133803.92156862834,1133.9315387171894,0
1402,512,0,0,498,0.0,0.0,1.0,498,14150,10300,3850,0.7279151943462897,180,103,77,161.60680944200345,0.39673482663046555,0.8803861468158205,0.10960293104335567,17499144.10146818,451846.16924082796,17950990.270709008,1401,2,1012.9317269076305,122,376,94,34.32492765828803,0.6359289617486339,38.55013550135502,133862.33062330674,1097.2322182238258,0
1403,512,0,0,498,0.0,0.0,1.0,498,14000,10200,3800,0.7285714285714285,178,102,76,161.11738075373793,0.396606126046776,0.8796497652536199,0.10971496237823573,17517356.772640795,450870.1281873196,17968226.900828116,1402,3,1013.9317269076305,97,401,97,34.19951239333603,0.6428264604810996,38.414115646258466,133931.97278911382,1380.7419875166372,0
1404,512,1,0,499,0.002004008016032064,0.0,1.0,499,12300,8600,3700,0.6991869918699187,160,86,74,160.97637160080396,0.3970523040726701,0.8804525608456977,0.11026157521667387,17543532.249999814,452718.8333333258,17996251.08333314,1403,0,1012.8977955911823,99,400,97,34.00469042218774,0.6442550505050505,38.21874999999997,134031.99999999857,1353.8585858585714,0
1405,512,2,0,501,0.003992015968063872,0.0,1.0,501,13500,9500,4000,0.7037037037037037,175,95,80,160.3361082694075,0.39769843646041253,0.8800573930333722,0.11022628605927244,17559896.96903024,449397.1083252063,18009294.077355444,1404,0,1009.8502994011976,102,399,75,33.89742698639479,0.6447099673202614,38.0966828478964,134094.4983818751,1314.6519449203442,0
1406,512,0,0,501,0.0,0.0,1.0,501,14900,11200,3700,0.7516778523489933,186,112,74,160.75728552462624,0.39795642049234864,0.8808671604300677,0.11080180019677444,17571412.953032296,449846.5298323376,18021259.482864633,1405,1,1010.8502994011976,103,398,77,33.79915032304923,0.6453276699029127,38.01081730769227,134138.4615384596,1302.3151605675691,0
1407,512,0,0,501,0.0,0.0,1.0,501,13850,10000,3850,0.7220216606498195,177,100,77,162.85462206928736,0.39805339321357286,0.8830257533855057,0.11278124559410686,17592509.071439713,458954.28321595764,18051463.354655672,1406,2,1011.8502994011976,108,393,78,33.584417872723066,0.6457368827160495,37.853593272171224,134218.96024464667,1242.7681504133952,0
1408,512,0,0,501,0.0,0.0,1.0,501,14400,9800,4600,0.6805555555555556,190,98,92,168.07926753768405,0.39789238190286097,0.8882003963897351,0.11707339457494834,17618093.76181453,477647.2589791977,18095741.02079373,1407,3,1012.8502994011976,114,387,78,33.25370312823696,0.6463815789473684,37.66304347826084,134316.52173912877,1178.2151029748138,0
1409,512,0,0,501,0.0,0.0,1.0,501,14150,10100,4050,0.7137809187279152,182,101,81,174.17487587752584,0.3980542248835662,0.8930453776087441,0.12162275741383237,17629139.603150822,499760.64044126734,18128900.24359209,1408,4,1013.8502994011976,115,386,78,33.01013613706094,0.6470108695652175,37.58081896551722,134358.62068965373,1168.3358320839454,0
1410,512,0,0,501,0.0,0.0,1.0,501,13400,9900,3500,0.7388059701492538,169,99,70,174.69575881851696,0.39809514304723886,0.8936775985154204,0.12247213926177677,17646667.29654834,502959.5867976871,18149626.88334603,1409,5,1014.8502994011976,83,418,83,32.863766609988055,0.6571285140562249,37.450396825396844,134425.39682539753,1619.583094281898,0
1411,512,0,1,500,0.0,0.001996007984031936,0.998003992015968,501,14550,10400,4150,0.7147766323024055,187,104,83,169.4174300552706,0.3982168995342648,0.8900943606658331,0.11928019060236658,17665463.72819115,483817.49311295396,18149281.221304104,1410,6,1015.8502994011976,87,414,87,32.86018985820714,0.657088122605364,37.310606060606084,134496.96969697083,1545.942180424952,0
1412,512,0,0,500,0.0,0.0,1.0,500,13150,9700,3450,0.7376425855513308,166,97,69,165.93918965982982,0.3980107715430861,0.8878051648303797,0.11742562749333435,17687724.54346645,473867.3355338264,18161591.879000276,1411,7,1018.79,90,410,85,32.78335438168653,0.6577546296296296,37.14514652014655,134581.68498168612,1495.352055352068,0
1413,512,0,0,500,0.0,0.0,1.0,500,12300,8100,4200,0.6585365853658537,165,81,84,165.56834360960667,0.3979067301269205,0.8872061877162976,0.11758441174975519,17703425.330871206,473925.361649745,18177350.69252095,1412,8,1019.79,94,406,71,32.67453335001182,0.6576906028368794,37.02850877192985,134641.40350877322,1432.3553564763108,0
1414,512,0,0,500,0.0,0.0,1.0,500,13450,9500,3950,0.7063197026022305,174,95,79,167.68058598308656,0.39767017368069474,0.888590497737556,0.11954003065245973,17720090.70294803,480813.0385487603,18200903.74149679,1413,9,1020.79,97,403,72,32.49316553544497,0.6580756013745704,36.90476190476193,134704.76190476332,1388.7088856161167,0
1415,512,0,0,500,0.0,0.0,1.0,500,13050,9300,3750,0.7126436781609196,168,93,75,163.7590716745164,0.3975903473613895,0.8858559788934572,0.11717729909325461,17736209.25712353,467843.03259430925,18204052.28971784,1414,10,1021.79,101,399,76,32.47474845451489,0.6582095709570956,36.78513071895428,134766.01307189697,1334.3169611078908,0
1416,512,0,0,500,0.0,0.0,1.0,500,14950,10600,4350,0.7090301003344481,193,106,87,178.92068868091295,0.3977021543086172,0.8935214150113442,0.12185903858220389,17518118.239589002,511920.7559641867,18030038.995553188,1415,11,1022.79,85,415,85,33.728015850966955,0.6466911764705883,38.408430232558146,133934.8837209305,1575.7045143638882,8
1417,512,0,1,499,0.0,0.002,0.998,500,14150,10500,3650,0.7420494699646644,178,105,73,177.56536843856483,0.397688126252505,0.8920623351070949,0.12147122466783807,17537900.97350223,508674.7695997978,18046575.74310203,1416,12,1023.79,88,412,84,33.61318547004724,0.6471354166666667,38.26076779026217,134010.4868913858,1522.846441947566,0
1418,512,1,1,499,0.002,0.002,0.998,500,12400,8800,3600,0.7096774193548387,160,88,72,176.6560575174575,0.3976172344689379,0.8915006770480716,0.12135860323408548,17556694.331270993,507899.2807202833,18064593.611991275,1417,0,1024.752,93,407,68,33.494308564658105,0.6469534050179211,38.120567375886516,134082.26950354557,1441.7448333714578,0
1419,512,0,0,499,0.0,0.0,1.0,499,14600,10800,3800,0.7397260273972602,184,108,76,174.9328900756644,0.39744951750891344,0.8905421390448243,0.12065181142599632,17574346.915636927,500466.25942893844,18074813.175065864,1418,14,1027.805611222445,97,402,70,33.405510480054076,0.6471219931271477,37.98894557823128,134149.65986394498,1382.9861841643813,0
1420,512,0,0,499,0.0,0.0,1.0,499,15550,10600,4950,0.6816720257234726,205,106,99,176.49598516468896,0.3973899941784506,0.8909181982450649,0.12250642704919994,17602594.10842064,506007.43772396597,18108601.546144605,1419,15,1028.805611222445,100,399,78,33.15036053752868,0.6484375,37.77846534653464,134257.42574257345,1342.5742574257345,0
1421,512,2,0,501,0.003992015968063872,0.0,1.0,501,14000,10400,3600,0.7428571428571429,176,104,72,173.55928336498351,0.3978829008649368,0.8901022951262034,0.12116169449161182,17628002.04081629,497700.680272107,18125702.721088395,1420,0,1025.6946107784431,104,397,84,33.03490416241351,0.6493389423076923,37.58928571428571,134354.28571428542,1291.868131868129,0
1422,512,1,1,501,0.00199203187250996,0.00199203187250996,0.99800796812749,502,13500,9300,4200,0.6888888888888889,177,93,84,173.21743512219663,0.39802069168436033,0.8909125403149314,0.12125220458553798,17640000.000000045,497211.111111113,18137211.111111157,1421,0,1024.6494023904384,103,399,85,32.953042328042315,0.6504854368932038,37.50000000000001,134400.00000000035,1304.8543689320422,0
1423,512,0,0,501,0.0,0.0,1.0,501,14250,9600,4650,0.6736842105263158,189,96,93,169.54025944473395,0.3979727212242183,0.8870578443612167,0.11260509769090446,17404541.015624862,475704.07986110565,17880245.095485967,1422,1,1027.4950099800399,95,406,89,34.837182688306285,0.6348684210526316,39.25781249999998,133499.99999999895,1405.2631578947257,8
1424,512,1,1,501,0.00199203187250996,0.00199203187250996,0.99800796812749,502,13200,9500,3700,0.7196969696969697,169,95,74,165.92713525252205,0.3984617087206728,0.8848386640529362,0.11077273003832434,17427896.348626554,464752.1829210972,17892648.53154765,1423,0,1026.4462151394423,101,401,71,34.75360255456837,0.6350041254125413,39.0829248366013,133589.5424836598,1322.6687374619783,0
1425,512,1,0,502,0.00199203187250996,0.0,1.0,502,15900,12100,3800,0.7610062893081762,197,121,76,165.72214033197966,0.3989079444033579,0.884785583367516,0.11117552953274715,17449959.0620713,462068.9128943746,17912027.974965677,1424,0,1027.4402390438247,107,395,75,34.591114374376616,0.6352219626168225,38.91782407407407,133674.07407407384,1249.290411907232,0
1426,512,0,0,502,0.0,0.0,1.0,502,15100,11000,4100,0.7284768211920529,192,110,82,172.40173745198678,0.3990190270190032,0.8894664810665334,0.11559073142464599,17447380.567939468,486091.7447797637,17933472.31271923,1425,1,1028.4402390438247,107,395,72,34.43634468787331,0.6350272585669782,38.93711419753088,133664.1975308652,1249.1981077650953,8
1427,512,0,0,502,0.0,0.0,1.0,502,13400,8800,4600,0.6567164179104478,180,88,92,173.38370707062654,0.39890695037547746,0.8913300937991724,0.11679583783988345,17468600.20661155,491954.13223140367,17960554.338842954,1426,2,1029.4402390438247,109,393,76,34.249252311038596,0.6361811926605505,38.778409090909086,133745.45454545438,1227.0225187656365,0
1428,512,0,0,502,0.0,0.0,1.0,502,13300,9800,3500,0.7368421052631579,168,98,70,173.26693364762454,0.3989675032405309,0.891856917540873,0.11699916178326189,17479489.60791362,492023.51321774535,17971513.121131368,1427,3,1030.4402390438247,113,389,78,34.169486018346944,0.6361541297935103,38.69700292397662,133787.13450292457,1183.9569425037573,0
1429,512,0,0,502,0.0,0.0,1.0,502,14150,10400,3750,0.734982332155477,179,104,75,176.63236803940558,0.39916340956864493,0.8946157702000663,0.11957422675186383,17490904.61674873,503341.98032154265,17994246.597070273,1428,4,1031.4402390438247,118,384,79,33.994731143185675,0.636034604519774,38.61169467787116,133830.8123249305,1134.1594264824619,0
1430,512,1,0,503,0.0019880715705765406,0.0,1.0,503,12850,8700,4150,0.6770428015564203,170,87,83,176.90831415674688,0.3997335706874292,0.8960757242140001,0.12023808067167234,17508781.52058963,506039.8043492646,18014821.324938897,1429,0,1030.3876739562625,81,422,81,33.85161145383004,0.6475051440329218,38.47815040650407,133899.1869918702,1653.0763826156815,0
1431,512,0,0,503,0.0,0.0,1.0,503,14250,10400,3850,0.7298245614035088,181,104,77,163.35198356054784,0.4000631008108058,0.8804094850044555,0.10287675371024549,17158423.347107194,445722.4977043069,17604145.844811503,1430,1,1031.3876739562625,109,394,74,36.87890163014983,0.6126720183486238,41.10795454545451,132552.72727272537,1216.080066722251,8
1432,512,3,0,506,0.005928853754940711,0.0,1.0,506,16150,12200,3950,0.7554179566563467,201,122,79,163.05635603162463,0.40113848341355873,0.8814358103754918,0.10333186030597441,17187643.704540435,443160.9102464442,17630804.61478688,1431,0,1026.2667984189723,118,388,81,36.662612749569234,0.613082627118644,40.88760504201678,132665.5462184858,1124.2842899871678,0
1433,512,1,0,507,0.0019723865877712033,0.0,1.0,507,13250,9200,4050,0.6943396226415094,173,92,81,163.98215877867688,0.4015942483751848,0.8828966205325253,0.10426162933157662,17203070.221372064,449549.31850434636,17652619.53987641,1432,0,1025.240631163708,120,387,86,36.52046249557208,0.6138888888888889,40.77134986225893,132725.06887052197,1106.042240587683,0
1434,512,0,0,507,0.0,0.0,1.0,507,15150,12100,3050,0.7986798679867987,182,121,61,163.10878949455247,0.4017987308121087,0.8836969315528773,0.10427025565449215,17228387.027815647,445470.27061013714,17673857.298425786,1433,1,1026.240631163708,93,414,93,36.34931653139684,0.6220878136200717,40.580673758865274,132822.69503546212,1428.2010218866894,0
1435,512,0,0,507,0.0,0.0,1.0,507,12850,9300,3550,0.7237354085603113,164,93,71,163.7596258286746,0.4018045778079223,0.8841486526944731,0.1051058226307425,17247005.238474376,450622.6249035583,17697627.863377936,1434,2,1027.240631163708,95,412,95,36.19000215988743,0.6229166666666667,40.44053819444448,132894.44444444618,1398.888888888907,0
1436,512,1,0,508,0.001968503937007874,0.0,1.0,508,14250,10000,4250,0.7017543859649122,185,100,85,161.97855792927888,0.4024792990003469,0.8819254154514367,0.10430424888857862,17262242.372752313,443372.6252328289,17705614.997985143,1435,0,1026.216535433071,100,408,95,36.11974408875482,0.6227083333333333,40.32590759075911,132953.1353135328,1329.5313531353281,0
1437,512,0,1,507,0.0,0.001968503937007874,0.9980314960629921,508,15300,11300,4000,0.738562091503268,193,113,80,157.5210440424393,0.40261947887061456,0.8774398049909669,0.10191202993523872,17284036.351166096,427619.89026063506,17711656.241426732,1436,1,1027.216535433071,107,401,76,36.06904231625835,0.6226635514018692,40.16203703703705,133037.03703703792,1243.336794738672,0
1438,512,2,1,508,0.003929273084479371,0.0019646365422396855,0.9980353634577603,509,15350,11000,4350,0.7166123778501629,197,110,87,156.68920548339923,0.4029947815953261,0.8763159023877625,0.10198119247841589,17311629.510607086,425359.09472800075,17736988.605335087,1437,0,1024.8035363457761,114,395,84,35.88008115921835,0.6232638888888888,39.954710144927546,133143.18840579767,1167.9227053140146,0
1439,512,1,1,508,0.0019646365422396855,0.0019646365422396855,0.9980353634577603,509,16200,12000,4200,0.7407407407407407,204,120,84,158.7071208463756,0.4032049100443977,0.8791527726517461,0.10376742132146063,17332661.937501796,432163.3745408923,17764825.312042687,1438,0,1025.7347740667976,121,388,88,35.66717938200714,0.6235365013774105,39.79678961748633,133224.04371584646,1101.025154676417,0
1440,512,0,0,508,0.0,0.0,1.0,508,15650,12400,3250,0.792332268370607,189,124,65,149.4478668737356,0.40334820388575693,0.8745293124560449,0.09550253265694894,17226692.174267996,397648.4797469673,17624340.654014964,1439,1,1028.6062992125985,98,410,98,36.71665855439281,0.6205357142857143,40.59343434343435,132816.1616161621,1355.2669552669602,8
1441,512,1,0,509,0.0019646365422396855,0.0,1.0,509,13500,9000,4500,0.6666666666666666,180,90,90,148.16011149542348,0.40371476158800385,0.8741092812843771,0.09509185337797249,17246920.415225048,395761.1303344915,17642681.54555954,1440,0,1027.5834970530452,101,408,101,36.59555004721434,0.6212871287128713,40.44117647058825,132894.11764705984,1315.7833430401965,0
1442,512,0,1,508,0.0,0.0019646365422396855,0.9980353634577603,509,14500,11400,3100,0.7862068965517242,176,114,62,149.59995072391325,0.4039461607083004,0.8760836264729461,0.09639233405491168,17265090.401052054,400271.3346482623,17665361.735700317,1441,1,1028.5834970530452,103,406,98,36.41944358737017,0.622168284789644,40.3044871794872,132964.10256410344,1290.9136171272178,0
1443,512,0,0,508,0.0,0.0,1.0,508,12750,9000,3750,0.7058823529411765,165,90,75,147.0195736300758,0.40361845255659606,0.8729985419121367,0.09508364716411818,17282371.763655502,393819.38560181716,17676191.14925732,1442,2,1031.6023622047244,110,398,75,36.35460685520285,0.621875,40.174549549549546,133030.6306306303,1209.3693693693663,0
1444,512,0,0,508,0.0,0.0,1.0,508,13100,10000,3100,0.7633587786259542,162,100,62,157.06299965287008,0.40368745049620275,0.8814612532243655,0.0977039328475234,17100235.12852024,422462.84481094766,17522697.973331187,1443,3,1032.6023622047244,95,413,95,37.4879735365324,0.6117324561403509,41.54730902777774,132327.77777777612,1392.9239766081696,7
1445,512,1,0,509,0.0019646365422396855,0.0,1.0,509,15100,10600,4500,0.7019867549668874,196,106,90,157.93953802500843,0.40412857282820003,0.8823703347476235,0.09864498160204818,17119254.526181962,423861.4302395375,17543115.9564215,1444,0,1031.5717092337918,98,411,98,37.31936024196066,0.6123511904761905,41.4036195286195,132401.34680134544,1351.034151034137,0
1446,512,3,0,512,0.005859375,0.0,1.0,512,14500,10100,4400,0.696551724137931,189,101,88,156.07114213293315,0.405118002894651,0.8815906158084701,0.09804819454346735,17146766.1335057,418323.07486849953,17565089.2083742,1445,0,1026.521484375,103,409,73,37.156728524065706,0.6131674757281553,41.19591346153843,132507.69230769062,1286.4824495892294,0
1447,512,1,1,512,0.001949317738791423,0.001949317738791423,0.9980506822612085,513,14550,10900,3650,0.7491408934707904,182,109,73,158.46134092738356,0.4056741517422027,0.8816713733982064,0.10025747548833337,17180055.423036028,427324.9239082074,17607380.346944235,1446,0,1025.5185185185185,113,400,80,36.83978666243401,0.6134771386430679,40.944809941520454,132636.25730994059,1173.772188583545,0
1448,512,0,1,511,0.0,0.001953125,0.998046875,512,13550,9900,3650,0.7306273062730627,172,99,73,157.62422283614305,0.4056078767123288,0.8809537065573507,0.100062992918793,17195773.682021767,426144.0925389748,17621917.774560742,1447,1,1028.517578125,118,394,84,36.74112570926778,0.6137005649717514,40.82633053221288,132696.91876750652,1124.5501590466654,0
1449,512,3,0,514,0.005836575875486381,0.0,1.0,514,13500,10500,3000,0.7777777777777778,165,105,60,156.30800896995248,0.406761111237526,0.8814401651093984,0.09974893486850485,17220268.889466815,422033.18880794867,17642302.078274764,1448,0,1024.4571984435797,123,391,92,36.58782470687307,0.6146680216802167,40.641801075268795,132791.397849461,1079.6048605647236,0
1450,512,1,0,515,0.001941747572815534,0.0,1.0,515,13050,8100,4950,0.6206896551724138,180,81,99,162.3396137931216,0.4072344893153514,0.8853646560663395,0.10127561147115181,17113771.44006825,439598.60922488145,17553370.04929313,1449,0,1023.4660194174758,93,422,93,37.24766415223726,0.6133512544802867,41.445035460992884,132380.1418439704,1423.4423854190366,8
1451,512,2,2,515,0.0038684719535783366,0.0038684719535783366,0.9961315280464217,517,13600,9500,4100,0.6985294117647058,177,95,82,160.45862526859463,0.40769739702817387,0.8843346597029083,0.1004352135940452,17129462.72386486,432714.00805219205,17562176.731917053,1450,0,1020.5029013539652,97,420,92,37.17589168310321,0.6134020618556701,41.326530612244866,132440.81632652908,1365.3692404796811,0
1452,512,3,3,515,0.005791505791505791,0.005791505791505791,0.9942084942084942,518,15050,10900,4150,0.7242524916943521,192,109,83,159.51587875322832,0.40811430040153446,0.8834613697482896,0.10036795556950784,17154072.956923127,428619.4043841086,17582692.361307237,1451,0,1019.519305019305,102,416,73,37.01156105120591,0.6139705882352942,41.14077669902909,132535.9223300952,1299.3717875499528,0
1453,512,3,0,518,0.005791505791505791,0.0,1.0,518,13000,9500,3500,0.7307692307692307,165,95,70,156.90385511470478,0.40851042047850555,0.8821174970410204,0.09924066272277406,17178571.6607949,422476.823788577,17601048.484583475,1452,0,1020.5096525096525,106,412,81,36.89149661142218,0.6148781446540881,40.95599688473516,132630.5295950131,1251.2314112737085,0
1454,512,0,0,518,0.0,0.0,1.0,518,14500,10800,3700,0.7448275862068966,182,108,74,157.80503028484983,0.40889697206186565,0.8839091458943857,0.09730750846616151,17058547.333219606,420284.91570685006,17478832.248926457,1453,1,1021.5096525096525,116,402,85,37.78899657400382,0.6036278735632183,41.8625356125356,132166.38176638106,1139.3653600550092,6
1455,512,2,0,520,0.0038461538461538464,0.0,1.0,520,13650,9700,3950,0.7106227106227107,176,97,79,159.094124124506,0.4096708876784744,0.8854850614887169,0.0987877021584575,17091621.123890746,426185.2985146582,17517806.422405403,1454,0,1018.5769230769231,95,425,95,37.50161851369702,0.6110745614035088,41.612413194444436,132294.44444444389,1392.5730994151988,0
1456,512,3,1,522,0.0057361376673040155,0.0019120458891013384,0.9980879541108987,523,15750,11200,4550,0.7111111111111111,203,112,91,158.8298422814433,0.41068297644252016,0.8849656953807825,0.0992079246731794,17119582.318766218,423470.1119227629,17543052.43068898,1455,0,1013.7284894837476,101,422,101,37.2938222362636,0.6115924092409242,41.401143790849666,132402.61437908444,1310.916974050341,0
1457,512,2,4,520,0.003816793893129771,0.007633587786259542,0.9923664122137404,524,14900,10500,4400,0.7046979865771812,193,105,88,161.2184445930257,0.41139303246585807,0.886494695182847,0.10120474657068002,17143177.96448705,433059.297363205,17576237.261850256,1456,0,1012.6812977099237,107,417,65,37.05103118399803,0.6119548286604362,41.22299382716049,132493.8271604933,1238.260066920498,0
1458,512,1,0,521,0.0019193857965451055,0.0,1.0,521,14750,10100,4650,0.6847457627118644,194,101,93,158.2250053041827,0.41050002460751017,0.8840762810226772,0.09982911449545288,17166964.485012643,424298.6093395649,17591263.094352208,1457,0,1019.4932821497121,111,410,75,36.94618785092597,0.6128941441441442,41.04352678571427,132585.71428571342,1194.4658944658865,0
1459,512,1,1,521,0.0019157088122605363,0.0019157088122605363,0.9980842911877394,522,14100,9700,4400,0.6879432624113475,185,97,88,157.92530491654315,0.4111403124946377,0.8831071064132929,0.10008641935793622,17187934.027777705,424381.94444444164,17612315.972222146,1458,0,1018.5383141762452,115,407,84,36.79334170854271,0.613677536231884,40.88541666666666,132666.66666666607,1153.623188405792,0
1460,512,2,0,523,0.0038240917782026767,0.0,1.0,523,14100,10200,3900,0.723404255319149,180,102,78,161.52309829918778,0.4115573467249804,0.8863601140202311,0.10302609382065343,17217964.779479776,437519.8035175714,17655484.58299735,1459,0,1017.5793499043978,121,402,92,36.47019929325518,0.6148415977961432,40.659153005464475,132782.51366120178,1097.3761459603454,0
1461,512,0,0,523,0.0,0.0,1.0,523,13700,9100,4600,0.6642335766423357,183,91,92,159.4500467603705,0.4115687933598529,0.8852160732143985,0.10205225376893605,17233910.82415192,431289.57735501946,17665200.401506938,1460,1,1018.5793499043978,96,427,96,36.40198391346935,0.6216362847222222,40.539089347079056,132843.98625429635,1383.7915234822538,0
1462,512,0,0,523,0.0,0.0,1.0,523,14050,10300,3750,0.7330960854092526,178,103,75,161.9574695491215,0.41166876063773933,0.8863509124997198,0.10405767418531153,17251855.93306822,440163.38638915075,17692019.31945737,1461,2,1019.5793499043978,98,425,98,36.19968993190664,0.6224489795918368,40.40404040404043,132913.1313131326,1356.2564419707408,0
1463,512,1,0,524,0.0019083969465648854,0.0,1.0,524,13800,9300,4500,0.6739130434782609,183,93,90,160.72796827663896,0.41224384423394106,0.8843672682298462,0.10370082960618515,17271280.52406162,436595.56563366594,17707876.089695286,1462,0,1018.6316793893129,104,420,89,36.083155093830385,0.6223958333333333,40.25793650793653,132987.93650793761,1278.7301587301695,0
1464,512,1,0,525,0.0019047619047619048,0.0,1.0,525,15600,11100,4500,0.7115384615384616,201,111,90,158.68120996977385,0.41261874469889737,0.8820349425102609,0.10286071869599486,17292952.01942481,428213.310078315,17721165.329503126,1463,0,1017.6895238095238,113,412,73,35.970825716026816,0.6220501474926254,40.095029239766085,133071.34502923998,1177.6225223826548,0
1465,512,1,0,526,0.0019011406844106464,0.0,1.0,526,14300,10900,3400,0.7622377622377622,177,109,68,164.35450418350848,0.4128271169050637,0.8857473111111314,0.10699932240313767,17312886.64256761,449590.18002489815,17762476.822592508,1464,0,1016.7528517110267,117,409,76,35.671151713681176,0.6227742165242165,39.945268361581924,133148.02259887022,1138.017287169831,0
1466,512,1,0,527,0.0018975332068311196,0.0,1.0,527,15500,11700,3800,0.7548387096774194,193,117,76,167.30754716629252,0.4130357404828729,0.8884342866905091,0.10947186394448877,17336074.606587324,459191.2239839983,17795265.830571324,1465,0,1015.8216318785579,121,406,82,35.41735021983075,0.6237947658402203,39.77117486338799,133237.15846994604,1101.133541073934,0
1467,512,0,0,527,0.0,0.0,1.0,527,15000,10400,4600,0.6933333333333334,196,104,92,166.7057985111171,0.41329442668763816,0.8893743714769631,0.10962293754128218,17358941.040039297,458367.22547743854,17817308.265516736,1466,1,1016.8216318785579,127,400,91,35.258583869825266,0.624507874015748,39.59960937500003,133325.0000000018,1049.8031496063134,0
1468,512,1,1,527,0.001893939393939394,0.001893939393939394,0.9981060606060606,528,14450,10600,3850,0.7335640138408305,183,106,77,166.346413989028,0.41341479009736837,0.8893182646969575,0.10999969045251122,17384510.803324167,458320.2062173006,17842831.009541467,1467,0,1015.8939393939394,94,434,94,35.073038514404345,0.6336436170212766,39.40789473684212,133423.15789473738,1419.3952967525254,0
1469,512,1,0,528,0.001893939393939394,0.0,1.0,528,15950,11500,4450,0.7210031347962382,204,115,89,164.12758867100706,0.413505908228394,0.8863540676415202,0.10904683116151025,17406074.826989688,449813.41791618883,17855888.244905878,1468,0,1016.876893939394,101,427,95,34.96663631379001,0.6333539603960396,39.246323529411775,133505.8823529417,1321.8404193360564,0
1470,512,0,0,528,0.0,0.0,1.0,528,13500,9800,3700,0.725925925925926,172,98,74,160.1277116460201,0.4137079853324517,0.8836400351524558,0.10687428393132245,17426759.473594002,439001.423182443,17865760.896776445,1469,1,1017.876893939394,107,421,77,34.91356604192081,0.6334696261682242,39.09143518518519,133585.1851851855,1248.4596746279017,0
1471,512,0,0,528,0.0,0.0,1.0,528,14750,10000,4750,0.6779661016949152,195,100,95,157.3161783543448,0.41380771364019703,0.8817663598617602,0.10546661028961568,17446965.78449908,428587.9962192824,17875553.78071836,1470,2,1018.876893939394,114,414,82,34.833324659102765,0.6334978070175439,38.94021739130435,133662.60869565236,1172.4790236460733,0
1472,512,0,0,528,0.0,0.0,1.0,528,15450,11700,3750,0.7572815533980582,192,117,75,154.87209344152728,0.4134704941971901,0.880864510006955,0.10421197699919209,17463663.239331,419876.81700660835,17883540.056337606,1471,3,1019.876893939394,117,411,86,34.7703031173601,0.6341702279202279,38.815324858757066,133726.55367231663,1142.9619971992875,0
1473,512,0,0,528,0.0,0.0,1.0,528,15300,11300,4000,0.738562091503268,193,113,80,156.38220265250138,0.41358429827209475,0.8830499022371991,0.10565985608163497,17482143.36337143,425879.21725017065,17908022.580621604,1472,4,1020.876893939394,122,406,89,34.590544014864236,0.6346482240437159,38.67716802168023,133797.28997290073,1096.6990981385306,0
1474,512,0,0,528,0.0,0.0,1.0,528,14000,9900,4100,0.7071428571428572,181,99,82,154.9285810140787,0.4136378311099611,0.8831077710987105,0.10502264774722855,17496957.829428073,422555.7697152931,17919513.599143367,1473,5,1021.876893939394,125,403,92,34.51611564367705,0.63525,38.56646825396825,133853.96825396828,1070.8317460317462,0
1475,512,0,0,528,0.0,0.0,1.0,528,13850,9800,4050,0.7075812274368231,179,98,81,187.88539652366708,0.4136647098355471,0.9017137852719999,0.1220823487672156,17303968.6658977,530782.6028450587,17834751.26874276,1474,6,1022.876893939394,101,427,70,35.1274648440569,0.6256188118811881,40.01225490196078,133113.72549019582,1317.9576781207506,8
1476,512,1,0,529,0.001890359168241966,0.0,1.0,529,13600,10100,3500,0.7426470588235294,171,101,70,185.9759254246287,0.41388885905367473,0.9011486292574691,0.12117279276928164,17316590.4236383,524693.7858470791,17841284.209485378,1475,0,1021.9413988657845,105,424,72,35.080543590518666,0.6255952380952381,39.91745283018868,133162.26415094335,1268.2120395327938,0
1477,512,0,0,529,0.0,0.0,1.0,529,13350,9400,3950,0.704119850187266,173,94,79,186.9399934213934,0.41382307240648447,0.9021048181528408,0.1223793449072595,17338391.27640044,529097.7502295714,17867489.02663001,1476,1,1022.9413988657845,109,420,78,34.888745360599714,0.6263379204892967,39.75378787878789,133246.06060606116,1222.4409229913867,0
1478,512,1,1,529,0.0018867924528301887,0.0018867924528301887,0.9981132075471698,530,14150,9900,4250,0.6996466431095406,184,99,85,188.51880694352405,0.41424813639119734,0.902424240321428,0.1241120184211721,17364304.10592911,534549.5786908568,17898853.684619967,1477,0,1022.0094339622641,86,444,86,34.64959160843447,0.6346899224806202,39.55938697318007,133345.59386973144,1550.530161275947,0
1479,512,0,0,529,0.0,0.0,1.0,529,14000,9700,4300,0.6928571428571428,183,97,86,187.46342843833088,0.41415976279811345,0.9013260363522253,0.12392178654248773,17382965.67492876,531934.0683695916,17914899.74329835,1478,1,1024.8412098298677,88,441,88,34.53454380764164,0.6354166666666667,39.4194756554307,133417.22846441905,1516.104868913853,0
1480,512,0,0,529,0.0,0.0,1.0,529,16050,12500,3550,0.778816199376947,196,125,71,182.82070877543188,0.41412560147791716,0.8986374774452384,0.12140787476637854,17403872.452333983,514507.65943458205,17918380.111768566,1479,2,1025.8412098298677,90,439,84,34.49600491702522,0.6363425925925925,39.26282051282051,133497.43589743582,1483.3048433048425,0
1481,512,1,0,530,0.0018867924528301887,0.0,1.0,530,13550,10000,3550,0.7380073800738007,171,100,71,179.96126663618702,0.4146975425330813,0.8960100479252504,0.1198390643686679,17416427.212041356,507306.46027118625,17923733.672312543,1480,0,1024.9037735849056,97,433,85,34.47484106931826,0.6352018900343643,39.168792517006814,133545.5782312931,1376.7585384669392,0
1482,512,1,1,530,0.0018832391713747645,0.0018832391713747645,0.9981167608286252,531,14150,10000,4150,0.7067137809187279,183,100,83,180.54473608166788,0.41482014473699796,0.8960990173310701,0.1208055285902353,17438204.20655932,509325.19524229877,17947529.401801616,1481,0,1023.9717514124294,100,431,75,34.293662240838806,0.6360416666666666,39.00577557755776,133629.0429042908,1336.290429042908,0
1483,512,0,0,530,0.0,0.0,1.0,530,13950,9800,4150,0.7025089605734767,181,98,83,182.67792489872227,0.4144962460320291,0.8971273277315783,0.12267937924033241,17454719.859467514,517768.40072321077,17972488.260190725,1482,1,1026.9018867924528,103,427,78,34.112165963431806,0.6365291262135923,38.88221153846155,133692.30769230815,1297.9835698282345,0
1484,512,0,0,530,0.0,0.0,1.0,530,15100,10900,4200,0.7218543046357616,193,109,84,184.85831382511188,0.4144625108487594,0.8977505611058547,0.12461603504895473,17471883.954427753,524864.601432711,17996748.555860464,1483,2,1027.9018867924528,107,423,81,33.92450589480423,0.6368769470404985,38.75385802469137,133758.0246913586,1250.0749971155008,0
1485,512,1,0,531,0.0018832391713747645,0.0,1.0,531,15750,11000,4750,0.6984126984126984,205,110,95,183.3775346646358,0.4147247983512774,0.8983703480938134,0.12409808021301072,17489366.435622934,519481.37996219855,18008847.815585133,1484,0,1026.9642184557438,114,417,83,33.83012487293229,0.6366959064327485,38.62318840579712,133824.92753623315,1173.9028731248522,0
1486,512,0,0,531,0.0,0.0,1.0,531,16050,12300,3750,0.7663551401869159,198,123,75,178.20137987327098,0.4149698267183077,0.9002276810576049,0.11601273506035412,17312835.538752384,494784.23650493694,17807619.775257323,1485,1,1027.9642184557438,91,440,74,35.31144781144781,0.6291208791208791,39.94565217391305,133147.8260869567,1463.162924032491,8
1487,512,1,0,532,0.0018796992481203006,0.0,1.0,532,16300,12700,3600,0.7791411042944786,199,127,72,177.0542998564774,0.41529391392794607,0.9001838537950715,0.11586280608481733,17336609.9577087,491204.2675893939,17827814.225298095,1486,0,1027.03007518797,101,431,76,35.159622478612405,0.6280940594059405,39.76715686274512,133239.2156862755,1319.2001553096584,0
1488,512,1,0,533,0.001876172607879925,0.0,1.0,533,15400,10000,5400,0.6493506493506493,208,100,108,177.75877693964804,0.4158267385160838,0.9004534768884744,0.11677794995697374,17354497.984379083,494982.8672209679,17849480.85160005,1487,0,1026.1013133208255,104,429,81,35.00468343176476,0.6287059294871795,39.63293650793653,133307.93650793764,1281.8070818070928,0
1489,512,1,0,534,0.0018726591760299626,0.0,1.0,534,14800,10100,4700,0.6824324324324325,195,101,94,174.22421185124006,0.41636626824349493,0.8977662203804828,0.11485853822643374,17370582.09940297,483675.1951331434,17854257.294536114,1488,0,1025.1779026217228,87,447,87,34.973984367899675,0.6348180076628352,39.51231060606058,133369.6969696958,1532.9850226401816,0
1490,512,1,0,535,0.001869158878504673,0.0,1.0,535,15900,11700,4200,0.7358490566037735,201,117,84,177.42733086688224,0.4165354055094683,0.8987543270573419,0.11765803185135601,17397361.898760695,494453.49716445844,17891815.395925153,1489,0,1024.2598130841122,91,444,91,34.68626940004633,0.6355311355311355,39.31159420289854,133472.4637681154,1466.7303710781914,0
1491,512,1,0,536,0.0018656716417910447,0.0,1.0,536,15950,11300,4650,0.7084639498432602,206,113,93,172.84123714145048,0.41679707478960343,0.8963065799312011,0.1152575397715413,17422734.999586657,479123.41434324044,17901858.4139299,1490,0,1023.3470149253732,96,440,71,34.61250840434144,0.6359592013888888,39.12156357388316,133569.7594501716,1391.3516609392875,0
1492,512,0,0,536,0.0,0.0,1.0,536,16400,12600,3800,0.7682926829268293,202,126,76,171.17482386421375,0.41689689694053095,0.894952293618297,0.11477160787612486,17447518.2497041,473715.17265214975,17921233.42235625,1491,1,1024.347014925373,102,434,77,34.467327160972054,0.636233660130719,38.93608414239482,133664.72491909363,1310.4384795989572,0
1493,512,0,0,536,0.0,0.0,1.0,536,13550,10000,3550,0.7380073800738007,171,100,71,173.92075220238124,0.41689195668852,0.8970136196767593,0.11699042853157895,17462148.673905298,486656.0064870846,17948804.680392385,1492,2,1025.347014925373,105,431,79,34.28430441108226,0.6366071428571429,38.826650943396224,133720.7547169811,1273.5309973045817,0
1494,512,1,0,537,0.00186219739292365,0.0,1.0,537,16250,11200,5050,0.6892307692307692,213,112,101,173.06607275752594,0.4172955057116651,0.8972432245295412,0.11680571452143973,17477257.829961963,481294.0750404481,17958551.90500241,1493,0,1024.4357541899442,108,429,82,34.191705375321575,0.6370563271604939,38.71368501529052,133778.59327217145,1238.6906784460318,0
1495,512,1,1,537,0.0018587360594795538,0.0018587360594795538,0.9981412639405205,538,15450,11300,4150,0.7313915857605178,196,113,83,173.37580002415206,0.41766021358734906,0.8987759916663263,0.11774028210595357,17505086.5371911,483941.67657550133,17989028.2137666,1494,0,1023.5297397769517,86,452,86,33.972069597069556,0.6453488372093024,38.505747126436766,133885.05747126378,1556.8029938519044,0
1496,512,1,1,537,0.0018587360594795538,0.0018587360594795538,0.9981412639405205,538,17100,12700,4400,0.7426900584795322,215,127,88,171.91166569057697,0.41789882926165145,0.8966565011241481,0.11483699268130379,17430624.99999974,474605.5555555441,17905230.555555284,1495,0,1024.514869888476,91,447,71,34.57667997338657,0.6380494505494505,39.06249999999996,133599.99999999796,1468.1318681318457,8
1497,512,0,0,537,0.0,0.0,1.0,537,16150,11900,4250,0.7368421052631579,204,119,85,174.781753568365,0.4176772388059702,0.8988308223149861,0.11742874599040228,17456728.515624724,486673.524305544,17943402.03993027,1496,1,1027.4022346368715,95,442,74,34.30306241170117,0.6388157894736842,38.86718749999996,133699.99999999785,1407.368421052609,0
1498,512,1,0,538,0.0018587360594795538,0.0,1.0,538,16750,12200,4550,0.7283582089552239,213,122,91,173.58552048358393,0.4179312071515764,0.898755404672708,0.11730604875778707,17483017.485512614,482609.7379692568,17965627.22348187,1497,0,1026.4907063197027,104,434,78,34.13433553514028,0.6384214743589743,38.6706349206349,133800.63492063407,1286.5445665445584,0
1499,512,2,0,540,0.003703703703703704,0.0,1.0,540,15100,10500,4600,0.695364238410596,197,105,92,173.9114299742901,0.4184810835108454,0.899942726231385,0.11819330941564846,17508481.353325706,485885.0057670157,17994366.35909272,1498,0,1023.6851851851852,84,456,84,33.93226726023119,0.6463293650793651,38.480392156862756,133898.03921568676,1594.0242763772233,0
1500,512,0,0,540,0.0,0.0,1.0,540,16200,11700,4500,0.7222222222222222,207,117,90,174.75287348405178,0.4187492126480222,0.9004071982361035,0.11923599409357263,17526230.545039468,488351.8298179249,18014582.374857392,1499,1,1024.6851851851852,85,455,85,33.775422028824515,0.6473039215686274,38.347868217054284,133965.89147286903,1576.069311445518,0
1501,512,0,0,540,0.0,0.0,1.0,540,14500,11000,3500,0.7586206896551724,180,110,70,179.35171942706944,0.41893610137657755,0.9024176977990777,0.12292289986267516,17546261.22733027,506890.4241276468,18053151.651457917,1500,2,1025.6851851851852,87,453,80,33.50293326400507,0.6481082375478927,38.19839015151518,134042.42424242542,1540.7175200278784,0
1502,512,0,0,540,0.0,0.0,1.0,540,14300,9700,4600,0.6783216783216783,189,97,92,180.91163043323044,0.4187766268123411,0.9030969866680771,0.12444331688408912,17562476.665879007,513151.25761394686,18075627.923492953,1501,3,1026.6851851851852,91,449,67,33.338962016743785,0.6480082417582418,38.077445652173914,134104.3478260869,1473.6741519350207,0
1503,512,0,0,540,0.0,0.0,1.0,540,14350,9800,4550,0.6829268292682927,189,98,91,179.35785437929962,0.4188479895325133,0.9019200371920024,0.12389169710015233,17581101.877500813,508311.74207448564,18089413.6195753,1502,4,1027.6851851851852,94,446,71,33.238319386331916,0.6484929078014184,37.938596491228076,134175.43859649156,1427.3982829413994,0
1504,512,1,0,541,0.0018484288354898336,0.0,1.0,541,14600,10900,3700,0.7465753424657534,183,109,74,177.733382544935,0.4191263891741403,0.9015205569186506,0.12326574337982815,17599013.734426167,502786.4480948651,18101800.18252103,1503,0,1026.7837338262477,98,443,74,33.14505665021337,0.648703231292517,37.80513468013468,134243.77104377086,1369.8343984058251,0
1505,512,0,1,540,0.0,0.0018484288354898336,0.9981515711645101,541,12500,8000,4500,0.64,170,80,90,178.46382709626675,0.4191765934141165,0.9024777488899751,0.12408836312492728,17610315.529027667,507860.8611366196,18118176.390164286,1504,1,1027.7837338262477,98,443,75,33.04022746419547,0.6495535714285714,37.7209595959596,134286.8686868688,1370.2741702741714,0
1506,512,0,1,539,0.0,0.001851851851851852,0.9981481481481481,540,14700,10400,4300,0.7074829931972789,190,104,86,179.11551949695584,0.41906601445291924,0.9026118207205982,0.12481981268624874,17620194.241722886,508510.04904868704,18128704.290771574,1505,2,1030.6759259259259,105,435,77,32.94826353772583,0.6485119047619048,37.64740566037734,134324.52830188564,1279.2812219227203,0
1507,512,0,0,539,0.0,0.0,1.0,539,14550,10100,4450,0.6941580756013745,190,101,89,182.6049321927736,0.41872742675982183,0.9053768848454182,0.1277869041372036,17638738.761283636,521834.13909404323,18160572.90037768,1506,3,1033.5658627087198,110,429,80,32.71617627781153,0.6487689393939393,37.50938438438436,134395.1951951939,1221.7745017744899,0
1508,512,1,0,540,0.001851851851851852,0.0,1.0,540,14950,10900,4050,0.7290969899665551,190,109,81,178.53869404842092,0.41881978801621655,0.9035814564272675,0.12568068659861822,17664714.53287209,507817.01268743275,18172531.54555952,1507,0,1032.65,84,456,84,32.62625379052949,0.6581101190476191,37.31617647058825,134494.1176470597,1601.1204481792822,0
1509,512,0,0,540,0.0,0.0,1.0,540,14050,9900,4150,0.7046263345195729,182,99,83,179.16211740393442,0.41886545443093065,0.90347518298338,0.12669158136423478,17684573.576675903,511631.12947658706,18196204.70615249,1508,1,1033.65,87,453,83,32.45961688584642,0.6585249042145593,37.168560606060616,134569.6969696974,1546.7781260884758,0
1510,512,0,0,540,0.0,0.0,1.0,540,13900,10200,3700,0.7338129496402878,176,102,74,179.38562604049258,0.4188948727639204,0.9029399246458407,0.12738874766702493,17703133.31052351,513237.530357315,18216370.840880826,1509,2,1034.65,90,450,69,32.31338600385963,0.658912037037037,37.03067765567767,134640.29304029373,1496.0032560032637,0
1511,512,1,0,541,0.0018484288354898336,0.0,1.0,541,15400,10400,5000,0.6753246753246753,204,104,100,176.6810725761593,0.4188402820565482,0.9020261090767652,0.1259688295826786,17720517.202354107,502575.99718324497,18223093.19953735,1510,0,1033.735674676525,93,448,71,32.253144918990266,0.6592741935483871,36.90159574468087,134706.3829787242,1448.4557309540237,0
1512,512,0,0,541,0.0,0.0,1.0,541,16000,11600,4400,0.725,204,116,88,176.0652968453204,0.4186046644302959,0.901730351703476,0.12602285548981318,17737585.57072081,500394.6537656516,18237980.224486463,1511,1,1034.735674676525,101,440,71,32.140438086000664,0.6583127062706271,36.77491830065362,134771.2418300665,1334.3687309907573,0
1513,512,0,0,541,0.0,0.0,1.0,541,14250,9800,4450,0.6877192982456141,187,98,89,179.32975097737824,0.4185082494694325,0.9030999242223698,0.1285328215155052,17743452.205150917,513935.77308575116,18257387.978236668,1512,2,1035.735674676525,102,439,72,32.01020218705187,0.6584967320261438,36.73139158576054,134793.5275080918,1321.5051716479588,0
1514,512,0,1,540,0.0,0.0018484288354898336,0.9981515711645101,541,16250,11200,5050,0.6892307692307692,213,112,101,179.80567212072324,0.41845918623491024,0.9035830603017754,0.12935019215681626,17759460.829142023,514200.3581771123,18273661.187319133,1513,3,1036.735674676525,107,434,74,31.876800449196853,0.6584890965732086,36.61265432098767,134854.32098765526,1260.3207568939745,0
1515,512,0,0,540,0.0,0.0,1.0,540,14300,10000,4300,0.6993006993006993,186,100,86,179.42323323272933,0.41842038583110014,0.9038686861743157,0.12966069417965867,17779055.57655966,515695.12707414886,18294750.703633808,1514,4,1038.9481481481482,114,426,79,31.73900403290486,0.6584429824561404,36.46739130434784,134928.6956521748,1183.5850495804807,0
1516,512,0,0,540,0.0,0.0,1.0,540,15100,11000,4100,0.7284768211920529,192,110,82,177.1581627331009,0.41825003149407913,0.9024412778007,0.1284121589500177,17792133.836551007,507304.3483169621,18299438.18486797,1515,5,1039.9481481481482,82,458,82,31.700069821320888,0.6684451219512195,36.37048192771084,134978.31325301193,1646.0769908903894,0
1517,512,1,0,541,0.0018484288354898336,0.0,1.0,541,14350,10500,3850,0.7317073170731707,182,105,77,174.3944399365886,0.4180880742109947,0.901485160350258,0.12720230003319166,17819072.862993743,498959.4464262099,18318032.309419952,1516,0,1039.0240295748613,86,455,80,31.569945541184488,0.668968023255814,36.170977011494244,135080.45977011457,1570.7030205827275,0
1518,512,1,0,542,0.0018450184501845018,0.0,1.0,542,15000,11400,3600,0.76,186,114,72,173.90187047926221,0.4181072702593939,0.9018621304319099,0.12752050034233536,17841922.877302248,497148.7522619199,18339071.629564166,1517,0,1038.1051660516605,88,454,70,31.410895844416853,0.6699810606060606,36.00187265917603,135167.04119850186,1535.9891045284303,0
1519,512,0,0,542,0.0,0.0,1.0,542,15650,11600,4050,0.7412140575079872,197,116,81,171.15341305380485,0.41775408223121047,0.9008238157126751,0.12629119531463137,17868608.25033943,487604.65771339054,18356212.90805282,1518,1,1039.1051660516605,93,449,71,31.282725486906273,0.6703629032258065,35.80452127659573,135268.0851063823,1454.4955387783043,0
1520,512,0,0,542,0.0,0.0,1.0,542,14100,9700,4400,0.6879432624113475,185,97,88,171.67082623163847,0.41773802500039786,0.9005456101858322,0.12703641141141123,17880816.326530438,491422.9024943238,18372239.22902476,1519,2,1040.1051660516605,97,445,73,31.177271021021014,0.6701030927835052,35.71428571428569,135314.28571428437,1394.9926362297358,0
1521,512,0,0,542,0.0,0.0,1.0,542,16050,11400,4650,0.7102803738317757,207,114,93,170.77162961524434,0.41738043189119506,0.9003650519944353,0.12691856247641087,17899197.64141537,486885.0300059614,18386082.67142133,1520,3,1041.1051660516605,102,440,77,31.062909559142234,0.6701388888888888,35.57847896440126,135383.81877022499,1327.2923408845586,0
1522,512,0,0,542,0.0,0.0,1.0,542,14600,10400,4200,0.7123287671232876,188,104,84,191.92151714801392,0.41754235414350444,0.9096804585067111,0.1318088691467615,17555450.39360612,550853.7347515153,18106304.128357634,1521,4,1042.1051660516605,85,457,78,33.10399321615789,0.6495098039215687,38.1298449612403,134077.51937984469,1577.3825809393493,8
1523,512,0,0,542,0.0,0.0,1.0,542,14650,10200,4450,0.6962457337883959,191,102,89,193.95523092468238,0.4176354292424625,0.9102624332335134,0.13373635584654342,17573174.5198902,558631.8244170073,18131806.344307207,1522,5,1043.1051660516605,89,453,66,32.916013237914335,0.6494616104868913,37.997685185185176,134145.1851851847,1507.2492717436483,0
1524,512,0,1,541,0.0,0.0018450184501845018,0.9981549815498155,542,13600,10100,3500,0.7426470588235294,171,101,70,193.81860015492236,0.4177704947104924,0.9099962993541661,0.13404086347556132,17586423.721140683,559715.2054725575,18146138.92661324,1523,6,1044.1051660516605,93,449,67,32.81893004115223,0.6491935483870968,37.89893617021275,134195.74468085027,1442.9649965682825,0
1525,512,0,0,541,0.0,0.0,1.0,541,15950,12100,3850,0.7586206896551724,198,121,77,192.59209756654255,0.4176212603546245,0.909181983907583,0.13367879007997013,17602594.10842059,553874.1043906313,18156468.212811224,1524,7,1046.8983364140481,100,441,69,32.72828580793178,0.6484375,37.77846534653463,134257.4257425731,1342.574257425731,0
1526,512,0,0,541,0.0,0.0,1.0,541,13150,9700,3450,0.7376425855513308,166,97,69,189.63699646895225,0.4173877821135985,0.9073421824967456,0.13190772295823677,17612011.111110922,546627.7777777712,18158638.888888694,1525,8,1047.8983364140481,109,432,71,32.73431294678312,0.646980122324159,37.70833333333331,134293.3333333319,1232.0489296635953,0
1527,512,0,0,541,0.0,0.0,1.0,541,15800,11400,4400,0.7215189873417721,202,114,88,191.9490552543397,0.4173663882613359,0.9098770505905971,0.13413818367920924,17632567.15482787,552910.921415573,18185478.076243445,1526,9,1048.8983364140481,112,429,75,32.51770869921551,0.6478794642857143,37.555309734513244,134371.68141592745,1199.7471554993522,0
1528,512,0,0,541,0.0,0.0,1.0,541,15450,11200,4250,0.7249190938511327,197,112,85,193.7857997625558,0.4170185242235458,0.9089356411927179,0.1362532841132064,17659540.292049866,560783.627786797,18220323.919836663,1527,10,1049.8983364140481,85,456,85,32.26495726495729,0.6573529411764706,37.35465116279072,134474.41860465202,1582.0519835841415,0
1529,512,1,0,542,0.0018450184501845018,0.0,1.0,542,16300,11600,4700,0.7116564417177914,210,116,94,191.19038001357782,0.4173043376690699,0.9086607010313561,0.13506397331567555,17680252.82218415,551358.8511619075,18231611.673346058,1528,0,1048.9594095940959,86,456,83,32.176200130605764,0.6585513565891472,37.20067049808431,134553.25670498158,1564.572752383507,0
1530,512,0,0,542,0.0,0.0,1.0,542,13850,10300,3550,0.7436823104693141,174,103,71,189.55089947177083,0.4173663640518106,0.9073831545948783,0.13451925380892754,17700266.440564867,548770.284939819,18249036.725504685,1529,1,1049.9594095940959,92,450,62,32.06776779121943,0.6580615942028986,37.051971326164896,134629.39068100456,1463.3629421848323,0
1531,512,0,1,541,0.0,0.0018450184501845018,0.9981549815498155,542,15950,11800,4150,0.7398119122257053,201,118,83,188.57126805891468,0.41741212005465705,0.906986181754643,0.13421637750868012,17713054.20376249,543684.6184799606,18256738.82224245,1530,2,1050.9594095940959,93,449,67,31.99676840656643,0.6587141577060932,36.95700354609931,134678.01418439797,1448.1506901548169,0
1532,512,0,0,541,0.0,0.0,1.0,541,16150,11700,4450,0.7244582043343654,206,117,89,186.49349524000593,0.41721491978731656,0.9064652500692494,0.13334534900940992,17732964.265928093,537066.4973838158,18270030.763311908,1531,14,1053.8983364140481,94,447,72,31.900873501923403,0.659906914893617,36.80921052631581,134753.68421052722,1433.5498320268853,0
1533,512,0,0,541,0.0,0.0,1.0,541,16250,12500,3750,0.7692307692307693,200,125,75,185.1654132029298,0.4170738629880651,0.9059496247751488,0.1330172204834374,17753312.700518217,533009.8963824608,18286322.59690068,1532,15,1054.8983364140481,98,443,77,31.78207074742957,0.6602891156462585,36.65824915824918,134830.97643097743,1375.8262901120147,0
1534,512,0,0,541,0.0,0.0,1.0,541,14600,10300,4300,0.7054794520547946,189,103,86,184.12115168969936,0.4168589260856667,0.9056750710153698,0.1327996745243647,17770726.74144596,531593.3347995942,18302320.076245554,1533,16,1055.8983364140481,102,439,80,31.678070141767737,0.6605392156862745,36.529126213592235,134897.0873786409,1322.5204644964792,0
1535,512,0,0,541,0.0,0.0,1.0,541,15100,11200,3900,0.7417218543046358,190,112,78,184.69185160946452,0.4170096814312772,0.9054501711758018,0.13381294779289904,17790200.73048819,533841.0226835785,18324041.753171768,1534,17,1056.8983364140481,84,457,84,31.51604605395689,0.6675347222222222,36.38480392156861,134970.9803921562,1606.797385620907,0
1536,512,0,0,541,0.0,0.0,1.0,541,14700,9800,4900,0.6666666666666666,196,98,98,181.7469457460099,0.417099678236462,0.9054960442779374,0.12114159539648484,17420685.941043068,510331.29251700605,17931017.233560074,1535,18,1057.8983364140481,90,451,64,34.39579768016734,0.6376157407407408,39.13690476190476,133561.90476190465,1484.0211640211628,8
1537,512,0,0,541,0.0,0.0,1.0,541,16650,12300,4350,0.7387387387387387,210,123,87,172.70385615263004,0.4171983752082335,0.8946822936695522,0.10738460370029954,17098073.53513374,465730.6464597572,17563804.1815935,1536,19,1058.8983364140481,90,451,90,37.10034917541451,0.6130787037037038,41.56364468864465,132319.4139194121,1470.21571021569,8
1538,512,3,0,544,0.0055147058823529415,0.0,1.0,544,14050,10800,3250,0.7686832740213523,173,108,65,169.6169709167525,0.4182414102841874,0.8939178025739409,0.1060128780732488,17122574.442935195,458005.84226144454,17580580.28519664,1537,0,1054.0533088235295,93,451,93,36.99188733681832,0.6140232974910393,41.37854609929074,132414.184397161,1423.8084343780754,0
1539,512,1,0,545,0.001834862385321101,0.0,1.0,545,13650,9100,4550,0.6666666666666666,182,91,91,166.8381437591423,0.41878274532289983,0.8924274999589703,0.10478935096781947,17145733.882029947,449462.4828532137,17595196.364883162,1538,0,1053.1174311926607,98,447,76,36.88599433512217,0.6143707482993197,41.20370370370367,132503.7037037019,1352.078609221448,0
1540,512,1,0,546,0.0018315018315018315,0.0,1.0,546,14000,9200,4800,0.6571428571428571,188,92,96,161.0800769707088,0.41908990601651147,0.8885038338252296,0.10170350619276455,17170338.29753542,429959.88291601354,17600298.180451434,1539,0,1052.1868131868132,105,441,82,36.84639902861045,0.614484126984127,41.01808176100625,132598.7421383626,1262.845163222501,0
1541,512,2,0,548,0.0036496350364963502,0.0,1.0,548,15100,11300,3800,0.7483443708609272,189,113,76,159.89548149042807,0.41963964024072914,0.887714014424076,0.10138217980241318,17190112.838062897,425024.2738233583,17615137.111886255,1540,0,1049.3430656934306,110,438,86,36.7256062965511,0.6148674242424242,40.86899399399394,132675.07507507203,1206.1370461370184,0
1542,512,1,0,549,0.0018214936247723133,0.0,1.0,549,16000,11100,4900,0.69375,209,111,98,155.8904401560074,0.4199956844783039,0.8872833962984652,0.09582855153828379,17043734.42554103,405591.05229994305,17449325.47784097,1541,0,1048.4298724954463,114,435,81,37.95226895082966,0.6028874269005848,41.97463768115944,132108.98550724774,1158.8507500635767,8
1543,512,1,0,550,0.0018181818181818182,0.0,1.0,550,15100,10300,4800,0.6821192052980133,199,103,96,152.9384581546116,0.4203358723850527,0.8857816411767203,0.094504246268839,17068506.93258668,396986.2266542244,17465493.159240905,1542,0,1047.5218181818182,120,430,91,37.838123180191616,0.6036458333333333,41.78719008264464,132204.9586776868,1101.7079889807235,0
1544,512,1,1,550,0.0018148820326678765,0.0018148820326678765,0.9981851179673321,551,13600,9700,3900,0.7132352941176471,175,97,78,149.7930039345613,0.4206166474179178,0.8843791428034733,0.092981826854986,17090068.4899807,388194.5393123105,17478263.029293012,1543,0,1046.6188747731399,97,454,97,37.75386018320444,0.6103951890034365,41.624149659863896,132288.43537414714,1363.7983028262593,0
1545,512,2,0,552,0.0036231884057971015,0.0,1.0,552,12350,7900,4450,0.6396761133603239,168,79,89,172.41758838839655,0.42125373716650444,0.8980046724387585,0.10287659301842886,16900396.431276724,460035.11909771536,17360431.55037444,1544,0,1045.713768115942,108,444,76,38.63186230752067,0.5931712962962963,43.061926605504574,131552.29357798083,1218.0767923887115,8
1546,512,3,0,555,0.005405405405405406,0.0,1.0,555,16250,11300,4950,0.6953846153846154,212,113,99,173.57308835597394,0.4224688587504472,0.8991497694071584,0.1040446683916656,16922737.408688787,460216.35909265047,17382953.767781436,1545,0,1041.055855855856,118,437,82,38.42945662535743,0.592867231638418,42.892156862745075,131639.21568627312,1115.586573612484,0
1547,512,1,0,556,0.0017985611510791368,0.0,1.0,556,15800,11700,4100,0.740506329113924,199,117,82,175.86703101354246,0.4229431994944585,0.9001405559357154,0.10590135458864923,16944766.38391968,469005.1510316012,17413771.53495128,1546,0,1040.181654676259,125,431,90,38.20024635818334,0.5933333333333333,42.72486772486771,131724.86772486658,1053.7989417989327,0
1548,512,6,0,562,0.010676156583629894,0.0,1.0,562,15650,11500,4150,0.7348242811501597,198,115,83,168.47936542194415,0.42465442313019247,0.8956241909654348,0.10218844386571256,16979567.389907397,444091.34779815,17423658.737705547,1547,0,1030.0658362989325,100,462,100,38.12180462670035,0.6011458333333333,42.4608085808581,131860.06600660135,1318.6006600660135,0
1549,512,2,0,564,0.0035460992907801418,0.0,1.0,564,16100,11800,4300,0.7329192546583851,204,118,86,170.41055453134248,0.4251249349146962,0.896151272649774,0.10380199701452784,17000062.522250045,450498.01629682863,17450560.538546875,1548,0,1027.409574468085,105,459,92,37.91403697771679,0.6014880952380952,42.305424528301906,131939.62264151048,1256.567834681052,0
1550,512,2,1,565,0.0035335689045936395,0.0017667844522968198,0.9982332155477032,566,16200,11900,4300,0.7345679012345679,205,119,86,179.66698516269219,0.42587166578066854,0.9060929882680469,0.10725767977474353,16902910.903496634,477979.0085009651,17380889.911997598,1549,0,1024.7756183745582,108,458,71,38.42614115342649,0.5933641975308642,43.04281345565748,131562.07951070275,1218.1674028768773,8
1551,512,1,0,566,0.0017667844522968198,0.0,1.0,566,15700,12100,3600,0.7707006369426752,193,121,72,174.61175410372385,0.4260413083586103,0.9038760813415083,0.10469198292048709,16923879.534636825,462121.65835660987,17386001.192993436,1550,0,1025.7703180212013,112,454,80,38.39392418375638,0.5941220238095238,42.8834808259587,131643.65781710905,1175.3898019384737,0
1552,512,4,0,570,0.007017543859649123,0.0,1.0,570,17150,11900,5250,0.6938775510204082,224,119,105,172.48822212569752,0.4274155566860913,0.9046587567183857,0.10433728121589397,16966553.28798186,454156.12244897976,17420709.41043084,1551,0,1019.5649122807017,90,480,90,38.11897880539503,0.6030092592592593,42.55952380952381,131809.52380952382,1464.5502645502647,0
1553,512,2,0,572,0.0034965034965034965,0.0,1.0,572,16650,11600,5050,0.6966966966966966,217,116,101,167.75524734635613,0.42788538081883093,0.9017868923529289,0.10202819141885036,16992716.04938288,439073.4567901302,17431789.50617301,1552,0,1016.9965034965035,98,474,84,38.0390835579515,0.6026785714285714,42.361111111111136,131911.1111111124,1346.0317460317592,0
1554,512,1,0,573,0.0017452006980802793,0.0,1.0,573,15150,10300,4850,0.6798679867986799,200,103,97,168.7209970864118,0.4283650286595313,0.9043237315625441,0.09885510078794209,16811627.023494672,437544.89480978035,17249171.91830445,1553,0,1016.2198952879581,83,490,83,39.41391442858297,0.5934989959839357,43.73759920634922,131206.3492063499,1580.799388028312,8
1555,512,8,0,581,0.013769363166953529,0.0,1.0,581,15650,11500,4150,0.7348242811501597,198,115,83,160.91395659238796,0.4302797396482481,0.9004356032015828,0.09517968053154424,16858012.95835233,410687.9130828489,17268700.87143518,1554,0,1003.2134251290878,93,488,87,39.255003886513805,0.59375,43.38430851063832,131387.23404255428,1412.7659574468203,0
1556,512,2,4,579,0.003430531732418525,0.00686106346483705,0.9931389365351629,583,17350,12000,5350,0.69164265129683,227,120,107,155.79971980235246,0.43103693028318585,0.8973669154470962,0.09263346555946524,16883244.595222875,392130.9554580661,17275375.550680943,1555,0,1000.7684391080618,98,485,78,39.19128392127939,0.594281462585034,43.19234006734009,131485.52188552317,1341.688998831869,0
1557,512,4,0,583,0.00686106346483705,0.0,1.0,583,16350,11800,4550,0.7217125382262997,209,118,91,167.014251774168,0.4311969382602528,0.9025046821374758,0.10020066931595109,16926966.516898707,432458.92952524853,17359425.446423955,1556,0,1001.7564322469983,102,481,84,38.56542843283778,0.596609477124183,42.860032362459556,131655.66343042115,1290.7417983374623,0
1558,512,2,0,585,0.003418803418803419,0.0,1.0,585,14550,9300,5250,0.6391752577319587,198,93,105,165.46802332421527,0.4315985637903446,0.9026696768555962,0.09984387752065914,16954654.434765406,429540.6310931503,17384195.065858558,1557,0,999.3282051282051,88,497,88,38.39149005518162,0.6027462121212122,42.649812734082374,131763.29588014883,1497.3101804562366,0
1559,512,3,0,588,0.00510204081632653,0.0,1.0,588,15200,10400,4800,0.6842105263157895,200,104,96,170.2408915253094,0.4321805454152132,0.9058211121692727,0.10364746413410861,16997694.94328918,445940.54820415674,17443635.491493337,1558,0,995.2244897959183,91,497,86,37.93665963617193,0.6050824175824177,42.323369565217384,131930.43478260832,1449.7849976110806,0
1560,512,3,0,591,0.005076142131979695,0.0,1.0,591,15800,11100,4700,0.7025316455696202,205,111,94,166.35497539541367,0.43304797958071645,0.9037228563228838,0.10185346220250356,17024653.97521805,432427.17863256944,17457081.15385062,1559,0,991.1675126903554,98,493,76,37.82913079549006,0.605123299319728,42.11910774410776,132035.01683501762,1347.296090153241,0
1561,512,2,1,592,0.003372681281618887,0.0016863406408094434,0.9983136593591906,593,17400,12700,4700,0.7298850574712644,221,127,94,164.3880323540128,0.43384982263038757,0.902817042187003,0.10121249355105112,17051291.819082484,424605.66224661015,17475897.481329095,1560,0,988.8212478920742,107,486,81,37.6748698208636,0.6049454828660437,41.917438271604944,132138.2716049385,1234.9371178031636,0
1562,512,3,0,595,0.005042016806722689,0.0,1.0,595,16450,11300,5150,0.6869300911854104,216,113,103,163.728371410451,0.4344929217478237,0.9032086225540603,0.10133401528159988,17076131.27972638,423719.4328841279,17499850.712610506,1561,0,986.4705882352941,115,480,87,37.50090545066813,0.6051630434782609,41.72952586206895,132234.48275861962,1149.8650674662576,0
1563,512,4,0,599,0.00667779632721202,0.0,1.0,599,18300,13500,4800,0.7377049180327869,231,135,96,161.59584313737165,0.43541981898481863,0.9022181325169625,0.10064569336108672,17105979.003906075,414751.01996527,17520730.023871344,1562,0,980.8764607679466,95,504,95,37.32671682827516,0.6121710526315789,41.50390624999997,132349.99999999863,1393.1578947368278,0
1564,512,4,3,600,0.006633499170812604,0.004975124378109453,0.9950248756218906,603,18300,13400,4900,0.73224043715847,232,134,98,155.70058811373295,0.43639154724715296,0.8983858757357615,0.09763496906823232,17138066.700960137,394781.4128943725,17532848.11385451,1563,0,975.363184079602,107,496,91,37.23300156564526,0.6115654205607477,41.26157407407406,132474.07407407343,1238.0754586362002,0
1565,512,4,1,603,0.006622516556291391,0.0016556291390728477,0.9983443708609272,604,16900,11600,5300,0.6863905325443787,222,116,106,156.93963238646336,0.4367446020449628,0.9005917757476471,0.09939743748756097,17184903.581443597,401698.4901337066,17586602.071577303,1564,0,974.5331125827814,113,491,78,36.842083994592336,0.6138458702064897,40.90826023391809,132654.97076023184,1173.937794338335,0
1566,512,0,1,602,0.0,0.001658374792703151,0.9983416252072969,603,17550,12900,4650,0.7350427350427351,222,129,93,156.80981686900665,0.436575198940697,0.9010171960334834,0.09967977208256701,17202056.79479074,401340.27515226905,17603397.06994301,1565,1,977.1475953565506,114,489,84,36.71414552612568,0.6149488304093567,40.77898550724634,132721.15942028776,1164.2206966691908,0
1567,512,2,3,601,0.0033112582781456954,0.004966887417218543,0.9950331125827815,604,18300,13000,5300,0.7103825136612022,236,130,106,163.68010316175312,0.4368063792516446,0.9046569512548168,0.10407052977533751,17203112.93562744,424061.4600013538,17627174.395628795,1566,0,976.5215231788079,106,498,84,36.527965550047576,0.616745283018868,40.77102803738316,132725.23364485888,1252.1248457062159,8
1568,512,1,0,602,0.0016611295681063123,0.0,1.0,602,16400,10700,5700,0.6524390243902439,221,107,114,160.023667377405,0.4364979556037096,0.9017458964252845,0.1021138910096066,17219984.94031199,414321.0284664742,17634305.968778465,1567,0,980.7225913621262,109,493,92,36.49362859646555,0.6173547400611621,40.64393939393936,132790.3030303013,1218.2596608284523,0
1569,512,1,1,602,0.001658374792703151,0.001658374792703151,0.9983416252072969,603,18050,13600,4450,0.7534626038781164,225,136,89,159.66717886831705,0.4368827007450749,0.9006857440052001,0.10260358844254354,17252645.192737192,412286.2371880793,17664931.42992527,1568,0,980.094527363184,100,503,100,36.253112046932316,0.6219791666666667,40.39810231023104,132916.17161716247,1329.1617161716247,0
1570,512,1,1,602,0.001658374792703151,0.001658374792703151,0.9983416252072969,603,16150,11100,5050,0.6873065015479877,212,111,101,159.80799889088328,0.43669824557537157,0.9008893134906892,0.10312835787722308,17272228.401462216,415298.05144479586,17687526.45290701,1569,0,981.0547263681592,102,501,95,36.09980921974772,0.6229575163398693,40.250809061488695,132991.5857605189,1303.8390760835186,0
1571,512,1,0,603,0.001658374792703151,0.0,1.0,603,17500,11900,5600,0.68,231,119,112,159.51553775584966,0.4368146348361552,0.9010827663860381,0.10350484504541849,17297566.041672856,413746.10980095784,17711312.151473813,1570,0,982.0381426202322,106,497,75,35.91391708175726,0.6239190251572326,40.06035825545173,133089.09657320968,1255.5575148416008,0
1572,512,0,1,602,0.0,0.001658374792703151,0.9983416252072969,603,18550,13300,5250,0.7169811320754716,238,133,105,159.71800329797696,0.436778822755914,0.901486788377436,0.10398709830652149,17313164.46281005,413894.811753907,17727059.274563957,1571,1,983.0381426202322,109,494,78,35.789606243779254,0.6244266055045872,39.943181818181834,133149.09090909193,1221.5512927439627,0
1573,512,0,0,602,0.0,0.0,1.0,602,17200,12400,4800,0.7209302325581395,220,124,96,161.77849394090944,0.4366484177349305,0.9035935607910881,0.10582580463523257,17334844.777209777,423281.01615129184,17758125.793361068,1572,2,985.656146179402,110,492,82,35.570611994662634,0.6258522727272727,39.780405405405425,133232.43243243347,1211.2039312039408,0
1574,512,0,0,602,0.0,0.0,1.0,602,18250,12100,6150,0.663013698630137,244,121,123,162.7135632081133,0.43677101011050246,0.9047134121475346,0.10673605116822371,17347712.13792285,425891.61109401454,17773603.749016862,1573,3,986.656146179402,113,489,84,35.448148115646994,0.626198377581121,39.68384502923978,133281.87134502977,1179.4855871241573,0
1575,512,1,0,603,0.001658374792703151,0.0,1.0,603,18250,13900,4350,0.7616438356164383,226,139,87,161.91397561692105,0.4369267771515255,0.9042318956698543,0.10663009052699896,17365741.04938261,423501.2345678962,17789242.283950504,1574,0,986.0182421227197,89,514,89,35.33153912811626,0.6337780898876404,39.54861111111109,133351.11111111028,1498.3270911360705,0
1576,512,1,1,603,0.0016556291390728477,0.0016556291390728477,0.9983443708609272,604,16000,10500,5500,0.65625,215,105,110,162.17414076324874,0.43701258927950387,0.9044273086824617,0.10749868350848951,17395476.96586621,427419.30602124403,17822896.271887455,1575,0,985.384105960265,92,512,92,35.09825405691863,0.6350769927536232,39.32571684587812,133465.23297490957,1450.709054075104,0
1577,512,0,0,603,0.0,0.0,1.0,603,18350,13800,4550,0.7520435967302452,229,138,91,164.008730963462,0.4367352054786973,0.90462010202171,0.10928423205469187,17419266.3068628,432432.35226062895,17851698.659123432,1576,1,987.9950248756219,97,506,71,34.86932582209366,0.6354166666666667,39.14753401360543,133556.46258503338,1376.8707482993132,0
1578,512,1,2,602,0.0016556291390728477,0.0033112582781456954,0.9966887417218543,604,16900,12100,4800,0.7159763313609467,217,121,96,164.73132125236432,0.43672000556452467,0.905190507237883,0.11042582636493162,17446474.310797293,437096.1528826101,17883570.463679902,1577,0,987.3576158940398,100,504,76,34.64348266961649,0.6366666666666667,38.943894389438924,133660.7260726063,1336.607260726063,0
1579,512,0,1,601,0.0,0.0016611295681063123,0.9983388704318937,602,16650,12700,3950,0.7627627627627628,206,127,79,157.71202297623435,0.43658974153450414,0.9028329199576561,0.10304079254926839,17329270.473865982,409556.8606271508,17738827.334493134,1578,1,991.5681063122923,108,494,81,35.718931741659055,0.6258680555555556,39.82224770642204,133211.00917431308,1233.4352701325286,8
1580,512,0,0,601,0.0,0.0,1.0,601,16550,11600,4950,0.7009063444108762,215,116,99,155.9729038880051,0.4366426326492882,0.9018193863752497,0.10221915203304094,17343438.842975333,404271.3039485811,17747710.146923915,1579,2,994.1514143094842,109,492,86,35.656182541415,0.6267201834862386,39.71590909090911,133265.45454545555,1222.6188490408765,0
1581,512,1,2,600,0.0016611295681063123,0.0033222591362126247,0.9966777408637874,602,17450,12100,5350,0.6934097421203438,228,121,107,157.35973531779598,0.43665907043078817,0.9029675188357236,0.10366425643952246,17367216.65391983,408730.12317352416,17775946.777093355,1580,0,993.4983388704319,90,512,90,35.43891550203625,0.6335648148148147,39.53754578754577,133356.7765567756,1481.7419617419512,0
1582,512,0,0,600,0.0,0.0,1.0,600,16750,11700,5050,0.6985074626865672,218,117,101,155.17774176829283,0.43632402383602303,0.9015622224132493,0.10262550710577255,17385014.195603736,402803.4486966966,17787817.64430043,1581,1,997.74,92,508,92,35.3602538754692,0.6342844202898551,39.40412186379926,133425.0896057338,1450.2727131058023,0
1583,512,1,0,601,0.0016638935108153079,0.0,1.0,601,16600,11400,5200,0.6867469879518072,218,114,104,156.16872884720112,0.4364389212423738,0.9025229304843465,0.10380113777093652,17407926.254231934,406914.74299783976,17814840.997229774,1582,0,997.0782029950083,94,507,90,35.16008255543407,0.6354166666666667,39.232456140350855,133512.9824561393,1420.3508771929712,0
1584,512,1,2,600,0.0016611295681063123,0.0033222591362126247,0.9966777408637874,602,15000,10500,4500,0.7,195,105,90,153.63768866280589,0.4365173607848123,0.9009036241620909,0.10240565331783195,17420685.94104303,399894.7845804965,17820580.725623526,1583,0,996.4202657807309,97,505,73,35.129064460924106,0.6355240549828178,39.13690476190475,133561.90476190436,1376.9268532155088,0
1585,512,0,1,599,0.0,0.0016666666666666668,0.9983333333333333,600,16300,11600,4700,0.7116564417177914,210,116,94,154.80762525440767,0.43615794843257283,0.9011935815350565,0.10345859836732747,17432691.892951645,403442.7267479212,17836134.619699568,1584,1,1000.47,100,500,74,35.00727873949358,0.635625,39.04702970297029,133607.920792079,1336.0792079207902,0
1586,512,2,0,601,0.0033277870216306157,0.0,1.0,601,17350,12600,4750,0.7262247838616714,221,126,95,158.16870116364333,0.4362703364762433,0.9029070511310491,0.10648687537702672,17466067.240587752,414967.03397612664,17881034.27456388,1585,0,999.7454242928453,109,492,79,34.66594007178335,0.6359900611620795,38.79734848484849,133735.75757575803,1226.9335557408995,0
1587,512,0,1,600,0.0,0.0016638935108153079,0.9983361064891847,601,15600,11000,4600,0.7051282051282052,202,110,92,157.09193737727196,0.43617628027361804,0.9023983909793887,0.10610970033708564,17480882.188615873,413421.1300147038,17894303.318630576,1586,1,1000.7454242928453,114,487,84,34.58157128496655,0.6360562865497076,38.686594202898554,133792.46376811623,1173.6181032290897,0
1588,512,1,0,601,0.0016638935108153079,0.0,1.0,601,18100,12600,5500,0.6961325966850829,236,126,110,157.79709930531908,0.43617269828064337,0.9033782988445889,0.10701915750777302,17499144.101468172,413962.83590749465,17913106.937375665,1587,0,999.2196339434277,122,479,89,34.42453247818956,0.6359289617486339,38.55013550135502,133862.33062330668,1097.2322182238254,0
1589,512,1,0,602,0.0016611295681063123,0.0,1.0,602,17000,11400,5600,0.6705882352941176,226,114,112,154.63808391315135,0.4361234989487805,0.9017987396832865,0.10542450254419866,17522536.624163803,404530.2977717429,17927066.921935547,1588,0,998.5581395348837,93,509,93,34.32973124655848,0.6443772401433692,38.37544326241135,133951.77304964562,1440.3416456951143,0
1590,512,0,0,602,0.0,0.0,1.0,602,18150,12900,5250,0.7107438016528925,234,129,105,152.71096570884052,0.4359938815521565,0.9008662882967342,0.10454027629852658,17540972.704475347,397189.7762345693,17938162.480709918,1589,1,999.5581395348837,95,507,89,34.24045210855027,0.6451754385964912,38.23784722222223,134022.2222222225,1410.7602339181317,0
1591,512,0,0,602,0.0,0.0,1.0,602,16850,12100,4750,0.7181008902077152,216,121,95,154.99336040127957,0.4358891972220533,0.9016071497256399,0.10654849469491286,17559695.563615713,407077.24460564664,17966772.80822136,1590,2,1000.5581395348837,100,502,67,34.038880575464006,0.6452083333333334,38.09818481848184,134093.72937293688,1340.9372937293688,0
1592,512,0,0,602,0.0,0.0,1.0,602,17000,11600,5400,0.6823529411764706,224,116,108,164.8763115211574,0.43575076975804444,0.9040109642933989,0.1077842172853829,17331945.032914963,434125.4337028873,17766070.46661785,1591,3,1001.5581395348837,118,484,78,35.51212503504341,0.62402895480226,39.80217086834732,133221.28851540489,1128.993970469533,8
1593,512,1,0,603,0.001658374792703151,0.0,1.0,603,16400,11300,5100,0.6890243902439024,215,113,102,164.94558612550946,0.43599830305835163,0.9046027486731323,0.10817288629145222,17346553.232309937,435247.47803213715,17781800.710342076,1592,0,1000.8955223880597,123,480,84,35.39888367164726,0.6242378048780488,39.692540322580626,133277.4193548375,1083.556254917378,0
1594,512,0,0,603,0.0,0.0,1.0,603,15400,11400,4000,0.7402597402597403,194,114,80,164.7932077704935,0.435898672014604,0.9047094439370502,0.10852623805851336,17365741.04938265,436351.2345678982,17802092.28395055,1593,1,1001.8955223880597,89,514,89,35.25654912678312,0.6337780898876404,39.5486111111111,133351.1111111106,1498.3270911360742,0
1595,512,0,0,603,0.0,0.0,1.0,603,16350,11400,4950,0.6972477064220184,213,114,99,162.90038542753683,0.43584529824116774,0.9040092643196276,0.10780336086825634,17388003.23736831,429552.48583650595,17817555.723204818,1594,2,1002.8955223880597,92,511,92,35.13623861096783,0.6345108695652174,39.3817204301075,133436.55913978364,1450.39738195417,0
1596,512,0,0,603,0.0,0.0,1.0,603,17000,12600,4400,0.7411764705882353,214,126,88,160.65796707636372,0.4358766338113787,0.9021478566839201,0.10670772131115952,17404628.807717983,421638.456393336,17826267.264111318,1595,3,1003.8955223880597,98,505,86,35.068113339520835,0.6340348639455782,39.25715488215487,133500.3367003363,1362.2483336769012,0
1597,512,0,0,603,0.0,0.0,1.0,603,18200,13300,4900,0.7307692307692307,231,133,98,158.72750660735574,0.4357315489734788,0.9002963685914767,0.10587683028673585,17424061.152644306,414335.55634666496,17838396.708990972,1596,4,1004.8955223880597,105,498,70,34.970619255687836,0.6337301587301587,39.11163522012579,133574.8427672958,1272.1413596885316,0
1598,512,0,0,603,0.0,0.0,1.0,603,17100,11500,5600,0.672514619883041,227,115,112,157.75670027851677,0.435545486851457,0.8998690930885442,0.10572863093164793,17445538.90306126,412730.1303854885,17858269.033446748,1597,5,1005.8955223880597,111,492,74,34.83266828179185,0.634009009009009,38.95089285714286,133657.14285714313,1204.1184041184065,0
1599,512,0,0,603,0.0,0.0,1.0,603,16900,11800,5100,0.6982248520710059,220,118,102,152.20073349454535,0.43556086768079133,0.8986650293842811,0.09857714007113148,17289070.615549225,388781.8458251239,17677852.46137435,1598,6,1006.8955223880597,103,500,76,36.168869960687566,0.6239886731391586,40.12419871794875,133056.41025641214,1291.809808314681,8
1600,512,0,0,603,0.0,0.0,1.0,603,18100,13100,5000,0.7237569060773481,231,131,100,155.88746466098982,0.4355897928225245,0.9001390754741674,0.10154870326018661,17315686.317722864,401159.6877869673,17716846.00550983,1599,7,1007.8955223880597,109,494,81,35.86998737741534,0.6246177370030581,39.92424242424245,133158.7878787893,1221.6402557687093,0
1601,512,0,0,603,0.0,0.0,1.0,603,17650,13100,4550,0.7422096317280453,222,131,91,156.58313445217087,0.4353967289796863,0.9010801185616548,0.10244270815675208,17335535.741766877,404640.50477070495,17740176.24653758,1600,8,1008.8955223880597,113,490,85,35.700538115804605,0.6252765486725664,39.77521929824564,133235.08771929966,1179.071572737165,0
1602,512,2,0,605,0.003305785123966942,0.0,1.0,605,16600,11500,5100,0.6927710843373494,217,115,102,157.3625747617493,0.43569180668819446,0.9028559387621637,0.10336863652612602,17354049.68240299,408575.58811325347,17762625.270516243,1601,0,1006.5570247933885,117,488,89,35.53914920548815,0.6258903133903133,39.63629943502826,133306.21468926634,1139.3693563185157,0
1603,512,0,0,605,0.0,0.0,1.0,605,14700,10200,4500,0.6938775510204082,192,102,90,157.78502291859718,0.4355203145239268,0.9037881118573781,0.10390977211192007,17365690.16758576,412309.1642179548,17777999.331803717,1602,1,1007.5570247933885,90,515,90,35.4394658579821,0.6334490740740741,39.54899267399267,133350.91575091565,1481.6768416768405,0
1604,512,0,0,605,0.0,0.0,1.0,605,16950,12500,4450,0.7374631268436578,214,125,89,153.99519266421876,0.43537767044314307,0.9011123107215009,0.10173002920071209,17379924.075279716,397334.9512924386,17777259.026572157,1603,2,1008.5570247933885,95,510,95,35.42981058870889,0.6330043859649123,39.44227430555556,133405.55555555562,1404.2690058479538,0
1605,512,0,0,605,0.0,0.0,1.0,605,17900,13000,4900,0.7262569832402235,228,130,98,150.59766300719895,0.4353875905350921,0.8987498911548455,0.09999763157963101,17403348.097953852,385280.7104105288,17788628.80836438,1604,3,1009.5570247933885,101,504,90,35.34016652957843,0.633147689768977,39.26674836601308,133495.4248366019,1321.7368795703158,0
1606,512,1,0,606,0.0016501650165016502,0.0,1.0,606,16150,11600,4550,0.718266253869969,207,116,91,147.41559843210052,0.43549514042313325,0.8969052072426276,0.09844514510988801,17429312.131640434,376520.4956291308,17805832.627269566,1605,0,1008.8894389438943,105,501,76,35.22584613839507,0.6341269841269841,39.072327044025165,133594.96855345965,1272.3330338424728,0
1607,512,0,1,605,0.0,0.0016501650165016502,0.9983498349834984,606,17200,11900,5300,0.6918604651162791,225,119,106,151.711992114064,0.4353771740810444,0.8995412670528629,0.10182578010148466,17452139.210284736,391139.76124885504,17843278.971533593,1606,1,1009.8894389438943,109,497,79,34.94033802408245,0.6349388379204892,38.90151515151516,133682.4242424248,1226.4442591048148,0
1608,512,0,0,605,0.0,0.0,1.0,605,15050,10900,4150,0.7242524916943521,192,109,83,150.1761345751002,0.43521872092386843,0.8969421652793421,0.09925114944243506,17381950.69444462,386020.8333333399,17767971.52777796,1607,2,1012.3305785123966,99,506,99,35.513899993337326,0.6320496632996633,39.42708333333336,133413.33333333468,1347.6094276094411,8
1609,512,1,0,606,0.0016501650165016502,0.0,1.0,606,15900,11300,4600,0.710691823899371,205,113,92,147.18492680447744,0.4354500222749547,0.8954990867409791,0.09766487073597527,17400237.769818142,375110.5445062393,17775348.314324383,1608,0,1011.6584158415842,102,504,99,35.452791031459725,0.6326593137254901,39.29004854368933,133483.49514563158,1308.6617171140351,0
1610,512,0,1,605,0.0,0.0016501650165016502,0.9983498349834984,606,15250,10600,4650,0.6950819672131148,199,106,93,145.08242170156694,0.43548252552527983,0.8942799133285206,0.09659057860106157,17415386.268581618,368883.2829428111,17784269.55152443,1609,1,1012.6584158415842,104,502,96,35.39249806651201,0.6333133012820513,39.17658730158732,133541.58730158818,1284.0537240537326,0
1611,512,0,1,604,0.0,0.001652892561983471,0.9983471074380166,605,17750,11900,5850,0.6704225352112676,236,119,117,142.46739195959617,0.43539169540072614,0.8922050855532009,0.09520838484700833,17432540.19021979,357963.70722629427,17790503.897446085,1610,2,1015.3190082644628,108,497,80,35.33045240362319,0.6336805555555556,39.048165137614696,133607.33944954217,1237.1049949031683,0
1612,512,0,1,603,0.0,0.0016556291390728477,0.9983443708609272,604,16950,12500,4450,0.7374631268436578,214,125,89,173.95834136449164,0.43516716683323636,0.9081494575212337,0.11077742133210916,17210367.63448571,461027.40159364865,17671395.03607936,1611,3,1017.9221854304636,113,491,83,36.2059193214923,0.6157817109144543,40.71637426900583,132753.21637426812,1174.8072245510452,8
1613,512,0,0,603,0.0,0.0,1.0,603,16000,10600,5400,0.6625,214,106,108,175.4853078470452,0.43483337740973976,0.909513035158078,0.11207972317111008,17224127.489427287,467916.2629757852,17692043.752403073,1612,7,1020.6053067993366,84,519,84,36.06087987023215,0.6247519841269842,40.61274509803924,132806.27450980502,1581.0270774976789,0
1614,512,3,0,606,0.0049504950495049506,0.0,1.0,606,17000,12500,4500,0.7352941176470589,215,125,90,174.67851583685655,0.4353333060578785,0.9090302772477266,0.11248815101365514,17262486.145404816,464877.09190672764,17727363.237311542,1613,0,1016.5478547854785,89,517,86,35.78809354014382,0.6259363295880149,40.3240740740741,132954.07407407524,1493.866000832306,0
1615,512,0,0,606,0.0,0.0,1.0,606,16600,11100,5500,0.6686746987951807,221,111,110,174.34983750788388,0.4354064383711098,0.9092507414217879,0.11271512906446239,17280559.60226632,464772.55174009275,17745332.15400641,1614,1,1017.5478547854785,92,514,69,35.65835704431799,0.6263586956521738,40.18817204301078,133023.65591397978,1445.9093034128236,0
1616,512,1,1,606,0.0016474464579901153,0.0016474464579901153,0.9983525535420099,607,17550,12600,4950,0.717948717948718,225,126,99,173.09856764616217,0.4355194168510756,0.9089663335115412,0.11240263212388196,17301025.7318644,460006.5545990284,17761032.28646343,1615,0,1016.8698517298188,96,511,73,35.534396342806744,0.6267361111111112,40.0343642611684,133102.40549828263,1386.4833906071108,0
1617,512,1,0,607,0.0016474464579901153,0.0,1.0,607,16250,11100,5150,0.683076923076923,214,111,103,175.46765188965247,0.43556495270614376,0.9091788066310953,0.11444193556526908,17321255.024017368,470213.9893692392,17791469.013386607,1616,0,1017.8649093904448,100,507,77,35.31820374555601,0.6271875,39.88242574257428,133180.1980198029,1331.801980198029,0
1618,512,0,0,607,0.0,0.0,1.0,607,16950,12300,4650,0.7256637168141593,216,123,93,176.53096952494343,0.4356303113836919,0.9105410818352015,0.11554357723577849,17337534.21541887,473772.3448439614,17811306.560262833,1617,1,1018.8649093904448,105,502,78,35.16618206077089,0.6271825396825397,39.76022012578619,133242.76729559887,1268.9787361485605,0
1619,512,1,1,607,0.001644736842105263,0.001644736842105263,0.9983552631578947,608,18600,13500,5100,0.7258064516129032,237,135,102,178.08824639188984,0.4360816854352727,0.9112567016065054,0.11709992302677731,17358631.040958215,478073.63236962084,17836704.673327837,1618,0,1018.1875,111,497,84,34.964551039359975,0.62743993993994,39.60193452380955,133323.80952381078,1201.1154011154124,0
1620,512,0,0,607,0.0,0.0,1.0,607,16750,11900,4850,0.7104477611940299,216,119,97,168.12051229303833,0.4360806859104362,0.9091439678043978,0.11154387450370122,17399712.791495036,446899.72565156996,17846612.517146606,1619,1,1020.6474464579901,89,518,83,34.91097854236031,0.6363529962546817,39.29398148148145,133481.48148148024,1499.791926758205,8
1621,512,0,0,607,0.0,0.0,1.0,607,17050,11700,5350,0.6862170087976539,224,117,107,166.43114241576384,0.4362039272296258,0.9078708772104691,0.11081442147213011,17415823.17916587,441257.06956389797,17857080.24872977,1620,2,1021.6474464579901,93,514,83,34.83234729716332,0.6363127240143369,39.17331560283685,133543.26241134622,1435.9490581865184,0
1622,512,0,1,606,0.0,0.0016474464579901153,0.9983525535420099,607,18600,13400,5200,0.7204301075268817,238,134,104,163.2264413289202,0.4363219579783349,0.9060823986294306,0.10903526280771761,17430624.99999982,429027.77777777036,17859652.77777759,1621,3,1022.6474464579901,97,510,70,34.80331004657351,0.6362757731958764,39.06249999999997,133599.99999999863,1377.3195876288519,0
1623,512,0,0,606,0.0,0.0,1.0,606,18200,13300,4900,0.7307692307692307,231,133,98,165.07823754568247,0.4361627071798089,0.9065720651487539,0.11067602091757027,17447196.397077344,436630.4862685816,17883826.883345924,1622,4,1025.2590759075908,104,502,71,34.62893470137439,0.6357171474358974,38.93849206349206,133663.492063492,1285.2258852258847,0
1624,512,1,0,607,0.0016474464579901153,0.0,1.0,607,18250,13800,4450,0.7561643835616438,227,138,89,164.17549243098026,0.43624504542711273,0.9062525210895416,0.11042086398524809,17461564.643347062,433702.1947873801,17895266.83813444,1623,0,1024.5683690280066,107,500,76,34.543263904276515,0.6360981308411215,38.83101851851852,133718.51851851863,1249.705780546903,0
1625,512,0,0,607,0.0,0.0,1.0,607,16800,12900,3900,0.7678571428571429,207,129,78,166.65010718534378,0.43602869347890305,0.9086159689052111,0.11268059119512717,17485472.6507775,444591.1782876936,17930063.829065192,1624,1,1025.5683690280066,112,495,78,34.29692368288015,0.6368117559523809,38.65228613569322,133810.02949852514,1194.7324062368316,0
1626,512,0,0,607,0.0,0.0,1.0,607,16000,11500,4500,0.71875,205,115,90,163.17892821887438,0.4359682055520215,0.9070297992398282,0.11089695433345093,17508385.951865982,433999.9308935809,17942385.882759564,1625,2,1026.5683690280066,85,522,85,34.21366734596206,0.6459558823529412,38.48110465116281,133897.6744186055,1575.2667578659468,0
1627,512,1,0,608,0.001644736842105263,0.0,1.0,608,17600,12100,5500,0.6875,231,121,110,159.71560977125284,0.43595405123702996,0.904494952585057,0.1092740418701509,17538462.326869737,421033.24099722714,17959495.567866966,1626,0,1025.8782894736842,94,514,85,34.07612793766493,0.6452792553191489,38.25657894736841,134012.63157894686,1425.6662933930518,0
1628,512,1,2,607,0.0016420361247947454,0.003284072249589491,0.9967159277504105,609,17650,12900,4750,0.7308781869688386,224,129,95,159.1786077520386,0.43592109314233857,0.9035248258357462,0.10933743712803907,17556099.99999991,419461.11111110705,17975561.11111102,1627,0,1025.192118226601,99,510,69,33.95651020949349,0.6452020202020202,38.124999999999986,134079.99999999933,1354.3434343434276,0
1629,512,1,0,608,0.001644736842105263,0.0,1.0,608,17300,13200,4100,0.7630057803468208,214,132,82,173.3935096733658,0.43570533107893294,0.9107076583884475,0.11569335493617033,17425387.938233048,465389.834406032,17890777.77263908,1628,0,1027.8618421052631,92,516,70,34.57789536198285,0.6373414855072463,39.10170250896057,133579.92831541205,1451.9557425588266,8
1630,512,1,0,609,0.0016420361247947454,0.0,1.0,609,16900,11400,5500,0.6745562130177515,224,114,110,173.57131909504614,0.43590331342004435,0.9113638193360438,0.11644221605515354,17449998.9371878,467063.86674696766,17917062.803934768,1629,0,1027.1724137931035,96,513,73,34.38588282878139,0.6380208333333333,38.91752577319588,133674.2268041237,1392.439862542955,0
1631,512,1,2,608,0.001639344262295082,0.003278688524590164,0.9967213114754099,610,15850,12000,3850,0.7570977917981072,197,120,77,171.8553912518058,0.4356112658932048,0.910485430237413,0.11564193159117075,17463743.467286676,462397.6932583438,17926141.16054502,1630,0,1026.4868852459017,102,508,75,34.32611515526986,0.6374591503267975,38.81472491909385,133726.86084142388,1311.0476553080773,0
1632,512,0,0,608,0.0,0.0,1.0,608,18700,13200,5500,0.7058823529411765,242,132,110,164.04348421249924,0.4353104045637157,0.9039241528935082,0.10883703921059246,17399636.31016575,430559.39286998316,17830195.703035735,1631,1,1030.6924342105262,100,508,91,35.01785149141547,0.6331249999999999,39.29455445544556,133481.1881188125,1334.8118811881252,8
1633,512,1,0,609,0.0016420361247947454,0.0,1.0,609,16800,11400,5400,0.6785714285714286,222,114,108,163.94806112970406,0.43536969669144127,0.9044871603315952,0.10932389145377097,17422597.078402456,432680.2021696291,17855277.280572087,1632,0,1029.9983579638752,103,506,70,34.845561698533395,0.6341019417475728,39.12259615384617,133569.23076923148,1296.7886482449658,0
1634,512,0,1,608,0.0,0.0016420361247947454,0.9983579638752053,609,17850,13500,4350,0.7563025210084033,222,135,87,163.25004932049828,0.43540143011983984,0.9037609073390469,0.10926415394297237,17439482.1854914,429749.2653810885,17869231.45087249,1633,1,1030.9983579638752,109,500,73,34.73532399680724,0.6339831804281346,38.99621212121214,133633.93939394035,1225.9994439811042,0
1635,512,1,0,609,0.0016420361247947454,0.0,1.0,609,15600,10400,5200,0.6666666666666666,208,104,104,164.21090827628302,0.4354124580488578,0.9041792467821379,0.11035432367378255,17457863.894140005,435954.337324095,17893818.2314641,1634,0,1030.6059113300494,114,495,78,34.570470574632935,0.6343201754385965,38.85869565217393,133704.34782608788,1172.845156369192,0
1636,512,0,0,609,0.0,0.0,1.0,609,17500,13300,4200,0.76,217,133,84,166.89126516545159,0.4353935530276842,0.905831038178381,0.11252275547602775,17472630.30378938,443905.8754335299,17916536.17922291,1635,1,1031.6059113300494,120,489,80,34.388215199745225,0.6342881944444445,38.74827823691462,133760.88154270107,1114.6740128558422,0
1637,512,1,0,610,0.001639344262295082,0.0,1.0,610,19100,14100,5000,0.7382198952879581,241,141,100,157.93012015212767,0.4356929751361634,0.9021635830769632,0.10037219928605298,17201138.06449712,402215.56025587185,17603353.62475299,1636,0,1030.9131147540984,122,488,84,36.692136587384525,0.6133879781420766,40.785907859078584,132717.61517615133,1087.849304722552,8
1638,512,3,1,612,0.004893964110929853,0.0016313213703099511,0.99836867862969,613,17650,12800,4850,0.7252124645892352,225,128,97,157.53797957204708,0.43620031844530455,0.9030645940364477,0.10053606708966775,17220371.86061776,402322.51808020286,17622694.37869796,1637,0,1026.862969004894,129,484,91,36.55513676058661,0.6136950904392765,40.641025641025614,132791.79487179292,1029.3937586960692,0
1639,512,0,0,612,0.0,0.0,1.0,612,15950,11100,4850,0.6959247648902821,208,111,97,158.96232113613684,0.4362045327314414,0.9033712621490735,0.10158850324263148,17226962.654642336,409337.5939415044,17636300.248583842,1638,1,1029.5277777777778,92,520,92,36.467778497409334,0.6222826086956521,40.591397849462396,132817.20430107668,1443.6652641421379,0
1640,512,0,1,611,0.0,0.0016339869281045752,0.9983660130718954,612,17900,13600,4300,0.7597765363128491,222,136,86,157.4501908238863,0.43617712133043796,0.9020645603149315,0.10110678701315166,17249330.169142645,402882.0653431506,17652212.234485794,1639,2,1030.5277777777778,97,515,97,36.336000095546225,0.6225300687285223,40.4230442176871,132903.40136054545,1370.1381583561388,0
1641,512,0,1,610,0.0,0.0016366612111292963,0.9983633387888707,611,16500,11300,5200,0.6848484848484848,217,113,104,153.7692640206503,0.4361751316930947,0.899030828333131,0.09900149506003607,17261470.240152597,392156.71494852746,17653626.955101125,1640,3,1033.1931260229132,102,509,95,36.33881510619516,0.622140522875817,40.331715210356,132950.16181229855,1303.4329589441033,0
1642,512,1,1,610,0.0016366612111292963,0.0016366612111292963,0.9983633387888707,611,17750,12800,4950,0.7211267605633803,227,128,99,150.16321014375367,0.43617803833185764,0.896429899154338,0.0970332034171135,17278386.242272995,378965.5888486793,17657351.831121676,1641,0,1034.152209492635,108,503,74,36.30333823799896,0.6220100308641976,40.20451070336393,133015.29051987836,1231.623060369244,0
1643,512,1,0,611,0.0016366612111292963,0.0,1.0,611,15900,10700,5200,0.6729559748427673,211,107,104,148.07283652388836,0.4362579708978384,0.8953047664724654,0.09597162190700077,17292349.440050237,374005.44635010546,17666354.886400342,1642,0,1035.150572831424,112,499,77,36.251137948972605,0.6222098214285714,40.09955752212391,133069.02654867346,1188.1163084702987,0
1644,512,0,1,610,0.0,0.0016366612111292963,0.9983633387888707,611,17750,13700,4050,0.7718309859154929,218,137,81,152.44097266034112,0.43608927405578957,0.8969616346271616,0.09920183953605148,17310960.6391576,387829.93550361233,17698790.574661214,1643,1,1036.150572831424,118,493,81,35.995654783945405,0.6224399717514124,39.95973389355742,133140.61624649842,1128.3103071737155,0
1645,512,0,0,610,0.0,0.0,1.0,610,17150,11900,5250,0.6938775510204082,224,119,105,154.41151822547153,0.43610892397283013,0.8992610278915278,0.10096390503250957,17332893.137535755,396129.6689213523,17729022.806457106,1644,2,1038.7196721311475,122,488,86,35.7771901274749,0.6233777322404371,39.79505420054201,133224.93224932285,1092.0076413878921,0
1646,512,1,0,611,0.0016366612111292963,0.0,1.0,611,15750,10700,5050,0.6793650793650794,208,107,101,159.41496414482526,0.43604500371155414,0.904083191446549,0.10475610232327874,17355769.641683236,415403.8790269605,17771173.520710196,1645,0,1038.0180032733224,129,482,89,35.47260475970665,0.6239502583979328,39.62339743589745,133312.82051282155,1033.4327171536554,0
1647,512,0,0,611,0.0,0.0,1.0,611,15900,11000,4900,0.6918238993710691,208,110,98,159.59009260121962,0.4358983302478245,0.9030374375625683,0.10525656515281097,17372567.75427782,416397.9393252323,17788965.693603054,1646,1,1039.0180032733224,96,515,96,35.34005963668344,0.6321614583333333,39.49742268041237,133377.31958762888,1389.3470790378008,0
1648,512,0,0,611,0.0,0.0,1.0,611,17900,13200,4700,0.7374301675977654,226,132,94,157.97407847878694,0.4358590906245248,0.9023440858519114,0.10477018189992236,17397895.28066136,409583.294886585,17807478.575547945,1647,2,1040.0180032733224,101,510,101,35.18933384259805,0.6327351485148515,39.3075980392157,133474.50980392215,1321.5298000388332,0
1649,512,2,2,611,0.0032626427406199023,0.0032626427406199023,0.9967373572593801,613,17350,12500,4850,0.7204610951008645,222,125,97,152.4903544806401,0.43634836796781423,0.8983752500302622,0.10168419019326387,17422620.75686778,391406.3230393061,17814027.079907086,1648,0,1037.621533442088,112,501,68,35.144287396937585,0.6320684523809523,39.12241887905605,133569.32153392347,1192.5832279814597,0
1650,512,0,0,611,0.0,0.0,1.0,611,17500,12700,4800,0.7257142857142858,223,127,96,145.24006807399226,0.436056071297613,0.8928715546376571,0.0962602919672716,17394838.370985005,365585.5018275971,17760423.872812603,1649,1,1041.1342062193125,102,509,102,35.5445360491433,0.632250816993464,39.33050161812301,133462.78317152258,1308.458658544339,8
1651,512,3,3,611,0.004885993485342019,0.004885993485342019,0.995114006514658,614,19400,13800,5600,0.711340206185567,250,138,112,142.93654935374306,0.4366442647806395,0.8913962310266588,0.09520034597513728,17417221.61434252,355711.51137671794,17772933.125719234,1650,0,1037.042345276873,108,506,77,35.434527735033356,0.6325231481481481,39.16284403669729,133548.62385321324,1236.5613319741967,0
1652,512,1,0,612,0.0016339869281045752,0.0,1.0,612,15950,10800,5150,0.677115987460815,211,108,103,143.46990616772194,0.43599437865708207,0.8907275747150953,0.09594109084655533,17435508.382921565,361944.15033686656,17797452.53325843,1651,0,1041.4297385620914,113,499,82,35.28175805002158,0.6328355457227139,39.0259502923977,133618.7134502949,1182.4664907105744,0
1653,512,0,0,612,0.0,0.0,1.0,612,17000,12500,4500,0.7352941176470589,215,125,90,146.5563401111296,0.4358622245042771,0.8919780090613307,0.09848772496972903,17457761.259536054,372309.1193462982,17830070.378882352,1652,1,1042.4297385620914,117,495,87,35.03228314515587,0.6337250712250713,38.85946327683618,133703.95480226114,1142.7688444637704,0
1654,512,0,1,611,0.0,0.0016339869281045752,0.9983660130718954,612,15750,10700,5050,0.6793650793650794,208,107,101,144.1257195475268,0.4358851230526763,0.8903039684773422,0.09716863027559128,17472400.000000115,365494.44444444776,17837894.444444563,1653,2,1043.4297385620914,119,493,92,34.984715576820854,0.634453781512605,38.750000000000014,133760.00000000087,1124.0336134453855,0
1655,512,0,0,611,0.0,0.0,1.0,611,17650,12400,5250,0.7025495750708215,229,124,105,144.76808457173323,0.4355891086009677,0.890691805716624,0.09813507263476774,17496957.829428047,366750.2141597373,17863708.043587785,1654,3,1046.1292962356792,125,486,98,34.78174509059867,0.63525,38.56646825396825,133853.9682539681,1070.8317460317448,0
1656,512,0,0,611,0.0,0.0,1.0,611,17200,12200,5000,0.7093023255813954,222,122,100,143.70105557280996,0.4355793825404917,0.890743926471695,0.09781390690922083,17515468.091363396,363998.2507161525,17879466.34207955,1655,4,1047.1292962356792,100,511,100,34.66940370107507,0.641875,38.42821782178215,133924.752475246,1339.24752475246,0
1657,512,1,0,612,0.0016339869281045752,0.0,1.0,612,16400,11600,4800,0.7073170731707317,212,116,96,141.80341666823665,0.43559914191172017,0.8890031876027809,0.09696149925866733,17535814.668129962,358527.68680035457,17894342.354930315,1656,0,1046.4166666666667,105,507,105,34.56500550695251,0.6421626984126985,38.276336477987385,134002.51572326847,1276.2144354596996,0
1658,512,1,1,612,0.0016313213703099511,0.0016313213703099511,0.99836867862969,613,18100,12800,5300,0.7071823204419889,234,128,106,143.41436862255586,0.4356005679415141,0.8905421638799644,0.09852053004171119,17556612.54196692,362874.1005714014,17919486.64253832,1657,0,1045.7079934747146,108,505,82,34.36545876972107,0.6430362654320987,38.12117737003056,134081.95718654298,1241.4996035791016,0
1659,512,0,1,611,0.0,0.0016339869281045752,0.9983660130718954,612,18350,12600,5750,0.6866485013623979,241,126,115,141.1089131897473,0.4353775107060464,0.8884567466933317,0.0973614797343011,17576092.470108155,355278.6613158875,17931371.131424043,1658,2,1048.4166666666667,115,497,86,34.27854078846658,0.6430253623188406,37.97593390804595,134156.32183907906,1166.5767116441657,0
1660,512,0,0,611,0.0,0.0,1.0,611,17350,13100,4250,0.7550432276657061,216,131,85,142.17520865930834,0.43526557734789334,0.888916627777268,0.09844441557734625,17591797.679855905,360673.5011651602,17952471.181021065,1659,8,1051.1292962356792,118,493,89,34.131896906757454,0.6436264124293785,37.858893557422924,134216.24649859674,1137.4258177847182,0
1661,512,0,0,611,0.0,0.0,1.0,611,17600,13100,4500,0.7443181818181818,221,131,90,148.81637288151458,0.43512348742990525,0.8933290343216631,0.10350843418310215,17611785.4845933,384384.4071568874,17996169.891750187,1660,9,1052.1292962356792,123,488,91,33.80670899657302,0.6442242547425474,37.71001344086018,134292.4731182773,1091.80872453884,0
1662,512,0,0,611,0.0,0.0,1.0,611,17200,12700,4500,0.7383720930232558,217,127,90,150.281746932444,0.43502566785615265,0.894788308592261,0.1049086609122759,17627876.09964079,390429.6029925304,18018305.70263332,1661,10,1053.1292962356792,126,485,95,33.64668312860104,0.6449239417989419,37.590223097112826,134353.8057742759,1066.3000458275867,0
1663,512,1,0,612,0.0016339869281045752,0.0,1.0,612,18100,13500,4600,0.7458563535911602,227,135,92,150.27841940778814,0.43497174397127464,0.8967251510234764,0.10543148598035967,17649900.378646363,389979.82632158557,18039880.20496795,1662,0,1052.4068627450981,98,514,98,33.48043144326456,0.6525297619047619,37.42634680134683,134437.7104377119,1371.8133718133868,0
1664,512,1,0,613,0.0016313213703099511,0.0,1.0,613,16250,11500,4750,0.7076923076923077,210,115,95,146.76622711385176,0.43496705370565847,0.8947538367575922,0.10343714183298079,17669915.585299842,379819.36877494527,18049734.95407479,1663,0,1051.6884176182707,102,511,102,33.421629199065904,0.6529820261437909,37.27750809061491,134513.9158576063,1318.7638809569246,0
1665,512,0,0,613,0.0,0.0,1.0,613,16300,11700,4600,0.7177914110429447,209,117,92,147.68348129043676,0.43490452416239284,0.8949852117277508,0.10437756404945768,17682289.466397863,383376.4131165768,18065665.87951444,1664,1,1052.6884176182707,105,508,101,33.304199072689244,0.6531746031746032,37.185534591194994,134561.0062893095,1281.533393231519,0
1666,512,0,0,613,0.0,0.0,1.0,613,17050,11900,5150,0.6979472140762464,222,119,103,145.18620034262372,0.43475669676969936,0.8928738427803387,0.1031789930434917,17706378.116343573,374494.35210834397,18080872.468451917,1665,2,1053.6884176182707,113,500,77,33.18827739559449,0.6532079646017699,37.00657894736843,134652.631578948,1191.6162086632567,0
1667,512,0,0,613,0.0,0.0,1.0,613,16750,11700,5050,0.6985074626865672,218,117,101,147.34253339152144,0.43459109899170834,0.8945453217181007,0.10500350768113392,17718535.494285952,382788.7815431385,18101324.27582909,1666,3,1054.6884176182707,115,498,79,33.03996569614637,0.653713768115942,36.916307471264375,134698.85057471303,1171.2943528235915,0
1668,512,0,0,613,0.0,0.0,1.0,613,17250,13200,4050,0.7652173913043478,213,132,81,145.70324386826934,0.4343042183340619,0.8938394119118742,0.10432835588936698,17739163.361755583,377080.72906338895,18116244.09081897,1667,4,1055.6884176182707,122,491,84,32.9277659814046,0.6539446721311475,36.76321138211382,134777.23577235782,1104.7314407570314,0
1669,512,0,0,613,0.0,0.0,1.0,613,16300,12100,4200,0.7423312883435583,205,121,84,147.53376260441303,0.43417171789868747,0.8946111878011302,0.10592863813989678,17751054.24000003,384875.9644444457,18135930.204444475,1668,5,1056.6884176182707,124,489,88,32.7900671962193,0.6544858870967742,36.675000000000004,134822.40000000023,1087.2774193548405,0
1670,512,0,0,613,0.0,0.0,1.0,613,17700,12500,5200,0.7062146892655368,229,125,104,151.9850179339093,0.43411529692536793,0.8972815829204461,0.10950160283860669,17766005.46942826,399733.3319769995,18165738.80140526,1669,6,1057.6884176182707,127,486,90,32.56029702511506,0.6551017060367454,36.56412760416668,134879.16666666738,1062.0406824147037,0
1671,512,0,0,613,0.0,0.0,1.0,613,17900,13300,4600,0.7430167597765364,225,133,92,156.33521917159754,0.4337711067751371,0.9005233257241194,0.1132017671350959,17787676.20806392,415668.0517082134,18203344.259772133,1670,7,1058.6884176182707,94,519,94,32.28256724902938,0.6640070921985816,36.40350877192981,134961.40350877115,1435.7596117954379,0
1672,512,0,0,613,0.0,0.0,1.0,613,16000,11700,4300,0.73125,203,117,86,150.11722515941284,0.4335083272025504,0.8955438960235806,0.1093331648727407,17812728.46811311,396199.47403024475,18208927.942143355,1671,8,1059.6884176182707,103,510,103,32.25812575941679,0.6634304207119741,36.21794871794872,135056.41025641045,1311.22728404282,0
1673,512,1,1,613,0.0016286644951140066,0.0016286644951140066,0.998371335504886,614,16900,12100,4800,0.7159763313609467,217,121,96,152.5077090865728,0.43332754355946884,0.8956566682572851,0.11147093140475858,17828045.66670624,404082.88042403484,18232128.547130276,1672,0,1058.9609120521172,105,509,95,32.0799508453117,0.6640873015873017,36.104559748427675,135114.46540880518,1286.8044324648113,0
1674,512,1,3,611,0.0016286644951140066,0.004885993485342019,0.995114006514658,614,17750,12200,5550,0.6873239436619718,233,122,111,152.85419064933777,0.4333471933656055,0.8955676673282909,0.11229823778277219,17850001.849096365,405139.51714656246,18255141.366242927,1673,0,1059.6254071661238,112,502,78,31.90587362541454,0.6641555059523809,35.942109144542776,135197.64011799434,1207.1217867678065,0
1675,512,0,0,611,0.0,0.0,1.0,611,16350,11700,4650,0.7155963302752294,210,117,93,158.39279926462478,0.43288403405686277,0.8995820084335762,0.11693406033028672,17870749.71655317,427569.6145124673,18298319.331065636,1674,11,1065.6644844517184,111,500,81,31.603773584905646,0.6659159159159159,35.78869047619046,135276.1904761896,1218.7044187044107,0
1676,512,0,0,611,0.0,0.0,1.0,611,17700,12900,4800,0.7288135593220338,225,129,96,162.6300000434061,0.43272003255435415,0.9012635950805881,0.12036079659158634,17881332.639345523,441708.22558258637,18323040.864928108,1675,12,1066.6644844517184,116,495,82,31.41232945932287,0.6656788793103448,35.71047008547009,135316.2393162398,1166.5193044503433,0
1677,512,0,0,611,0.0,0.0,1.0,611,16050,11400,4650,0.7102803738317757,207,114,93,166.10355102898905,0.43249331473084524,0.9032828620626605,0.12327308004108958,17893133.058610268,456172.5880138769,18349305.646624144,1676,13,1067.6644844517184,120,491,83,31.231887007489448,0.6657986111111112,35.623278236914615,135360.8815427007,1128.0073461891725,0
1678,512,0,0,611,0.0,0.0,1.0,611,17300,12500,4800,0.7225433526011561,221,125,96,165.10154210431642,0.4323255122391851,0.9033800712231677,0.12287395035351784,17905053.2825112,451730.3816805121,18356783.66419171,1677,14,1068.6644844517184,122,489,87,31.168876222193784,0.6663251366120219,35.53523035230353,135405.96205962103,1109.8849349149264,0
1679,512,0,0,611,0.0,0.0,1.0,611,19450,14600,4850,0.7506426735218509,243,146,97,168.503360151813,0.4320500523194977,0.9057732555200668,0.12606668867280313,17927314.334017657,462512.5407559484,18389826.874773607,1678,15,1069.6644844517184,90,521,90,30.911789514663873,0.6756944444444444,35.370879120879124,135490.1098901101,1505.4456654456676,0
1680,512,0,0,611,0.0,0.0,1.0,611,16300,11500,4800,0.7055214723926381,211,115,96,163.7990676556467,0.4317338994571293,0.9019361626554057,0.12291099065874823,17939834.81998229,449205.64348187705,18389040.463464167,1679,16,1070.6644844517184,97,514,97,30.94237268286153,0.6745060137457044,35.2784863945578,135537.41496598546,1397.2929377936646,0
1681,512,0,0,611,0.0,0.0,1.0,611,16400,11500,4900,0.7012195121951219,213,115,98,163.65643120276007,0.4315579360181732,0.9014472427655227,0.12314600293347468,17951559.763338752,448977.6410782123,18400537.404416963,1680,17,1071.6644844517184,101,510,101,30.858240133693265,0.6742986798679869,35.19199346405227,135581.6993464042,1342.3930628356852,0
1682,512,0,0,611,0.0,0.0,1.0,611,16450,12000,4450,0.729483282674772,209,120,89,162.91572645364081,0.43145542110488044,0.9037421489731234,0.11470938072864129,17665723.656809803,436954.84057569236,18102678.497385494,1681,18,1072.6644844517184,97,514,97,33.02901863990722,0.6539948453608248,37.30867346938778,134497.95918367454,1386.5768988007685,8
1683,512,0,1,610,0.0,0.0016366612111292963,0.9983633387888707,611,18850,13600,5250,0.7214854111405835,241,136,105,164.11518347190562,0.4310666022734387,0.9034578962936533,0.11605957831976546,17684882.88245839,439421.559786768,18124304.442245156,1682,19,1073.6644844517184,102,509,94,32.85276142470532,0.6541053921568627,37.166262135922345,134570.87378640854,1319.322292023613,0
1684,512,0,1,609,0.0,0.001639344262295082,0.9983606557377049,610,17300,12200,5100,0.7052023121387283,224,122,102,166.39410720821,0.4310151349969043,0.9046629522051735,0.11804361395734553,17698715.444696534,449692.3910304916,18148407.835727025,1683,20,1075.9606557377049,104,506,69,32.68838351443807,0.6546474358974359,37.063492063492085,134623.49206349312,1294.4566544566646,0
1685,512,0,0,609,0.0,0.0,1.0,609,17300,12200,5100,0.7052023121387283,224,122,102,171.48410272992288,0.4308579233644456,0.9093240955746051,0.11944164174522678,17617969.845488235,465140.3501752684,18083110.195663504,1684,21,1078.5418719211823,107,502,82,33.165320109807936,0.6478777258566979,37.66396604938268,134316.04938271406,1255.2901811468603,8
1686,512,2,0,611,0.0032733224222585926,0.0,1.0,611,19000,13600,5400,0.7157894736842105,244,136,108,169.48408098329975,0.4311246232548988,0.9095194693324993,0.11854067619244517,17636348.015122592,456616.04704892955,18092964.062171523,1685,0,1076.0081833060556,114,497,85,33.078677341799775,0.6477521929824561,37.52717391304344,134386.08695651958,1178.8253241799962,0
1687,512,0,0,611,0.0,0.0,1.0,611,17650,13000,4650,0.7365439093484419,223,130,93,167.9962098617543,0.43117168844409864,0.9078970688767558,0.11797171171629091,17654002.777777866,453311.11111111566,18107313.88888898,1686,1,1077.0081833060556,89,522,89,32.9841828639429,0.6555477528089888,37.39583333333335,134453.333333334,1510.711610486899,0
1688,512,0,0,611,0.0,0.0,1.0,611,18450,13400,5050,0.7262872628726287,235,134,101,165.02224969523482,0.4310054510656185,0.9060562262945202,0.11641899918249707,17674271.94934868,442679.6237613822,18116951.573110063,1687,2,1078.0081833060556,93,518,93,32.909084039756536,0.6558019713261649,37.245124113475185,134530.49645390114,1446.564477998937,0
1689,512,0,0,611,0.0,0.0,1.0,611,17000,12500,4500,0.7352941176470589,215,125,90,164.61789123463552,0.43090181821434004,0.9058213429741584,0.11656584783143364,17690551.629055012,443236.26079049957,18133787.889845513,1688,3,1079.0081833060556,96,515,85,32.79673393520977,0.6561414930555556,37.1241408934708,134592.43986254363,1402.004581901496,0
1690,512,0,0,611,0.0,0.0,1.0,611,16800,12300,4500,0.7321428571428571,213,123,90,163.20280794733193,0.4309180283151333,0.9050050244464563,0.11594914672642541,17705110.476255402,438904.74894852587,18144015.225203928,1689,4,1080.0081833060556,98,513,75,32.72402043157021,0.6566751700680272,37.01599326599329,134647.81144781256,1373.9572596715568,0
1691,512,0,0,611,0.0,0.0,1.0,611,16650,11900,4750,0.7147147147147147,214,119,95,163.25176961419245,0.4309316671585594,0.9044342520508093,0.11629530048594555,17716814.210429214,439610.2543556953,18156424.46478491,1690,5,1081.0081833060556,103,508,76,32.63440732279967,0.65625,36.92908653846157,134692.30769230938,1307.692307692324,0
1692,512,0,0,611,0.0,0.0,1.0,611,15700,10900,4800,0.6942675159235668,205,109,96,162.23174623219973,0.4306556482698792,0.9032613620672933,0.1159417346173876,17730857.434080407,437401.5927450167,18168259.026825424,1691,6,1082.0081833060556,107,504,79,32.55530919397005,0.6563473520249221,36.82484567901238,134745.67901234748,1259.3054113303504,0
1693,512,0,0,611,0.0,0.0,1.0,611,17550,12400,5150,0.7065527065527065,227,124,103,160.49303408799148,0.43056453632404107,0.9020296564533874,0.11499539430761417,17742077.070722777,429745.9560206619,18171823.026743438,1692,7,1083.0081833060556,113,498,81,32.51647952749531,0.6558812684365782,36.741593567251485,134788.3040935685,1192.816850385562,0
1694,512,0,1,610,0.0,0.0016366612111292963,0.9983633387888707,611,16300,11300,5000,0.6932515337423313,213,113,100,162.40181738514667,0.430441339558012,0.9033121598577387,0.11667921681892907,17753858.349364273,438151.772307051,18192010.121671323,1693,8,1084.0081833060556,116,495,83,32.37741866414238,0.6561602011494253,36.65420227920231,134833.04843305016,1162.3538658021566,0
1695,512,0,0,610,0.0,0.0,1.0,610,16450,11800,4650,0.7173252279635258,211,118,93,165.04163696997452,0.43023443879153317,0.905488676243279,0.11910779478332564,17773250.6944447,448215.2777777869,18221465.97222249,1694,9,1086.5770491803278,119,491,88,32.161741450879674,0.6570378151260504,36.5104166666667,134906.66666666864,1133.6694677871315,0
1696,512,0,0,610,0.0,0.0,1.0,610,17650,12500,5150,0.7082152974504249,228,125,103,161.91979026449627,0.43007404865092824,0.9037246236158119,0.11780258431484907,17808106.945650052,437046.98832947435,18245153.933979526,1695,10,1087.5770491803278,95,515,95,31.981570809506202,0.6652412280701754,36.252170138888886,135038.8888888887,1421.4619883040916,0
1697,512,0,0,610,0.0,0.0,1.0,610,16550,12500,4050,0.7552870090634441,206,125,81,159.03884685161088,0.43000406022593696,0.9017462329429893,0.11604483115111035,17820658.214336373,428285.38650895184,18248943.600845326,1696,11,1088.5770491803278,100,510,95,31.963147916503832,0.6647916666666667,36.15924092409242,135086.46864686537,1350.8646864686536,0
1698,512,0,0,610,0.0,0.0,1.0,610,16850,12700,4150,0.7537091988130564,210,127,83,157.58645794161302,0.4298320614283022,0.9002704534175128,0.11559608203729031,17843386.637358025,423525.2195727948,18266911.85693082,1697,12,1089.5770491803278,106,504,71,31.830619983529385,0.66499606918239,35.99104361370718,135172.58566978254,1275.213072356439,0
1699,512,0,0,610,0.0,0.0,1.0,610,19750,14500,5250,0.7341772151898734,250,145,105,158.50671481698325,0.42951761824006035,0.9014759223495477,0.11679704211173994,17862680.337995745,424520.95564032806,18287201.293636072,1698,13,1090.5770491803278,110,500,75,31.661367296669976,0.665530303030303,35.84834834834836,135245.64564564635,1229.5058695058758,0
1700,512,0,0,610,0.0,0.0,1.0,610,16950,12100,4850,0.7138643067846607,218,121,97,154.48474900654367,0.4294892976033451,0.8991977437948737,0.11441281665002453,17884318.420499984,413620.8884688119,18297939.308968797,1699,14,1091.5770491803278,114,496,84,31.605194768106017,0.6663011695906433,35.68840579710146,135327.53623188473,1187.0836511568837,0
1701,512,0,0,610,0.0,0.0,1.0,610,15650,11300,4350,0.7220447284345048,200,113,87,157.95544417204883,0.4293084941721177,0.9013173429169292,0.1173053188295822,17896006.91452016,427704.3442178196,18323711.258737978,1700,15,1092.5770491803278,117,493,85,31.425738428321853,0.6665776353276354,35.60204802259888,135371.75141242988,1157.0235163455545,0
1702,512,0,0,610,0.0,0.0,1.0,610,17850,13000,4850,0.7282913165266106,227,130,97,161.88691583049228,0.4291253914416718,0.9054023339995934,0.12087296322707715,17918797.888859283,440313.7851234812,18359111.673982766,1701,16,1093.5770491803278,121,489,87,31.15076163428647,0.6675275482093663,35.43374316939894,135457.92349726972,1119.4869710518158,0
1703,512,1,1,610,0.0016366612111292963,0.0016366612111292963,0.9983633387888707,611,18600,13900,4700,0.7473118279569892,233,139,94,156.23597519191406,0.42886895978106304,0.9019947693801436,0.11750054702303087,17949344.4444444,420066.66666666523,18369411.111111064,1702,0,1092.785597381342,94,517,94,31.071334906897466,0.6760859929078014,35.20833333333333,135573.333333333,1442.2695035460956,0
1704,512,0,0,610,0.0,0.0,1.0,610,17550,12200,5350,0.6951566951566952,229,122,107,157.05456569214113,0.4285128805620609,0.9026179008979729,0.11848010066985647,17962292.14891979,424661.9984567918,18386954.147376582,1703,1,1095.355737704918,95,515,89,30.95267354852804,0.6767543859649123,35.11284722222223,135622.2222222225,1427.6023391812896,0
1705,512,0,1,609,0.0,0.001639344262295082,0.9983606557377049,610,16800,12100,4700,0.7202380952380952,215,121,94,154.39278705043773,0.42814033800820117,0.9005201300647439,0.11670075894882247,17970534.02777774,416104.16666666523,18386638.194444403,1704,2,1096.355737704918,99,511,88,30.961478605595975,0.6762415824915825,35.05208333333333,135653.33333333302,1370.2356902356871,0
1706,512,0,0,609,0.0,0.0,1.0,609,17500,13100,4400,0.7485714285714286,219,131,88,153.8761332445312,0.42786204015786594,0.9003968910418814,0.11709005103140166,17998534.29589903,414608.97230440314,18413143.268203434,1705,3,1098.8029556650247,103,506,78,30.765662184112106,0.6772855987055016,34.8457532051282,135758.97435897397,1318.0482947473201,0
1707,512,0,0,609,0.0,0.0,1.0,609,18700,14200,4500,0.7593582887700535,232,142,90,153.94127719305285,0.42761638741249675,0.9005266218172479,0.11759870653864514,18014867.892392237,414146.35436379263,18429014.24675603,1706,4,1099.8029556650247,106,503,82,30.64179725249851,0.6777712264150944,34.72546728971961,135820.5607476627,1281.3260447892708,0
1708,512,0,0,609,0.0,0.0,1.0,609,18300,13100,5200,0.7158469945355191,235,131,104,151.80310261956015,0.4273565559012474,0.8993820985951375,0.11637694062725658,18029628.064767394,407290.69586167164,18436918.760629065,1707,5,1100.8029556650247,111,498,85,30.58821639681314,0.6777402402402403,34.61681547619045,135876.19047618913,1224.109824109812,0
1709,512,0,0,609,0.0,0.0,1.0,609,17250,12900,4350,0.7478260869565218,216,129,87,152.96552235923474,0.4271956381614957,0.89996307637076,0.1176000878831122,18041380.446120005,412891.83680448105,18454272.282924484,1708,6,1101.8029556650247,113,496,88,30.469565678816874,0.6781895280235988,34.53033625730992,135920.46783625602,1202.8359985509383,0
1710,512,0,0,609,0.0,0.0,1.0,609,17000,11500,5500,0.6764705882352942,225,115,110,152.73370988428786,0.4269464969896004,0.8995642798607093,0.1176221177018983,18048453.145276714,412521.4413101631,18460974.586586878,1709,7,1102.8029556650247,120,489,90,30.42289444390407,0.67734375,34.478305785123936,135947.10743801465,1132.8925619834554,0
1711,512,0,0,609,0.0,0.0,1.0,609,16250,12200,4050,0.7507692307692307,203,122,81,155.1710880430601,0.42658685146774983,0.9015873015873013,0.11990493166963762,18062500.000000045,422505.5555555578,18485005.5555556,1710,8,1103.8029556650247,108,501,93,30.253267973856225,0.6808449074074074,34.37500000000001,136000.00000000035,1259.2592592592625,0
1712,512,0,0,609,0.0,0.0,1.0,609,16000,11300,4700,0.70625,207,113,94,142.51125655932213,0.42656749632702445,0.8889505903071266,0.10439036985110382,17837341.30869044,370604.38471579883,18207945.69340624,1711,9,1104.8029556650247,105,504,81,32.273983036124285,0.664781746031746,36.03577044025159,135149.6855345921,1287.1398622342106,8
1713,512,0,0,609,0.0,0.0,1.0,609,16850,12000,4850,0.712166172106825,217,120,97,141.1793082252797,0.42651685787745225,0.8883188724037527,0.10373610039161878,17850625.000000056,365377.77777777973,18216002.777777836,1712,10,1105.8029556650247,109,500,82,32.20948389217625,0.6648509174311927,35.93750000000001,135200.00000000044,1240.3669724770682,0
1714,512,0,0,609,0.0,0.0,1.0,609,18250,12800,5450,0.7013698630136986,237,128,109,141.60559085097134,0.42629371110967074,0.8888682343464396,0.1045408426427858,17870749.716553323,366069.614512473,18236819.331065796,1713,11,1106.8029556650247,111,498,88,32.0473106167277,0.6659159159159159,35.78869047619048,135276.19047619074,1218.704418704421,0
1715,512,0,0,609,0.0,0.0,1.0,609,16000,11400,4600,0.7125,206,114,92,144.08488150184067,0.42594925712269177,0.889141504206866,0.10679400226958319,17887642.759105165,377667.7774585907,18265310.536563754,1714,12,1107.8029556650247,117,492,91,31.85515740493366,0.665954415954416,35.66384180790963,135340.1129943517,1156.7531025158264,0
1716,512,0,0,609,0.0,0.0,1.0,609,16750,11400,5350,0.6805970149253732,221,114,107,144.6883095418614,0.4256247209258779,0.8903010441975558,0.10761974839410601,17902609.513571806,379509.6613813554,18282119.174953163,1715,13,1108.8029556650247,121,488,94,31.72704378148006,0.6663223140495868,35.553278688524614,135396.72131147684,1118.9811678634449,0
1717,512,0,0,609,0.0,0.0,1.0,609,18750,13800,4950,0.736,237,138,99,144.623025652197,0.4252385183504739,0.8909110650897774,0.10801354337723941,17920000.017222464,377778.924435633,18297778.9416581,1716,14,1109.8029556650247,126,483,98,31.59850316727122,0.6667493386243386,35.424868766404224,135462.46719160263,1075.0989459651003,0
1718,512,0,0,609,0.0,0.0,1.0,609,15750,10300,5450,0.653968253968254,212,103,109,144.80838484278547,0.4250730994152047,0.8912519852485941,0.10878462408140151,17944637.34567878,382156.79012344754,18326794.135802228,1717,15,1110.8029556650247,101,508,101,31.40915300546445,0.67378300330033,35.24305555555552,135555.5555555538,1342.1342134213246,0
1719,512,0,0,609,0.0,0.0,1.0,609,17800,13000,4800,0.7303370786516854,226,130,96,144.93620415603095,0.4250509310272808,0.8911188113945476,0.10933666645318907,17962234.999633227,381075.63180108316,18343310.63143431,1718,16,1111.8029556650247,102,507,98,31.2741008704948,0.6748366013071896,35.11326860841421,135622.00647249032,1329.6275144361796,0
1720,512,0,0,609,0.0,0.0,1.0,609,18600,13600,5000,0.7311827956989247,236,136,100,142.482585527532,0.4248178816293608,0.8889907990157095,0.10793208732021019,17979637.294952285,371957.0417263991,18351594.336678684,1719,17,1112.8029556650247,110,499,80,31.208982530689287,0.6742424242424243,34.98498498498494,135687.6876876852,1233.5244335244108,0
1721,512,0,0,609,0.0,0.0,1.0,609,17050,11900,5150,0.6979472140762464,222,119,103,132.97852032791158,0.42459102137527727,0.8868520456570468,0.09503977419954325,17731057.37778123,332719.95478933514,18063777.332570568,1720,18,1113.8029556650247,116,493,87,33.323677830401465,0.6544540229885057,36.82336182336185,134746.4387464403,1161.6072305727614,8
1722,512,0,0,609,0.0,0.0,1.0,609,13650,8800,4850,0.6446886446886447,185,88,97,134.36431451114976,0.4245559120502405,0.8880748035840531,0.0962157831714998,17739456.031201307,341259.9698866162,18080716.001087923,1721,19,1114.8029556650247,116,493,89,33.22404764320582,0.6550826149425287,36.76103988603992,134778.34757834958,1161.8823067099102,0
1723,512,0,0,609,0.0,0.0,1.0,609,16500,12400,4100,0.7515151515151515,206,124,82,134.49351416934036,0.4243242130109757,0.8877392276079674,0.09672934090887585,17758394.71542914,339377.7822568668,18097772.497686006,1722,20,1115.8029556650247,121,488,95,33.07827746620417,0.6555612947658402,36.62056010928964,134850.27322404517,1114.4650679673155,0
1724,512,0,1,608,0.0,0.0016420361247947454,0.9983579638752053,609,17200,12500,4700,0.7267441860465116,219,125,94,132.87838737434583,0.424168921765621,0.8860219189709748,0.09585718960855234,17771494.140625052,333289.49652777996,18104783.637152832,1723,21,1116.8029556650247,127,482,101,33.02240342640642,0.655511811023622,36.52343750000001,134900.0000000004,1062.204724409452,0
1725,512,0,0,608,0.0,0.0,1.0,608,16500,11600,4900,0.703030303030303,214,116,98,134.74852197064473,0.4240439346151623,0.8874556572140069,0.09735736343809419,17778210.84438695,341017.5269127308,18119228.37129968,1724,22,1119.1611842105262,135,473,102,32.922673370923654,0.6547839506172839,36.47365196078433,134925.49019607977,999.4480755265168,0
1726,512,0,0,608,0.0,0.0,1.0,608,17950,13000,4950,0.724233983286908,229,130,99,135.51179467267073,0.4238579307747334,0.8883015762796946,0.09837804314548512,17798846.564613886,342840.7282148697,18141687.292828757,1725,23,1120.1611842105262,105,503,105,32.747589942357365,0.6619047619047619,36.32075471698115,135003.77358490677,1285.7502246181598,0
1727,512,0,1,607,0.0,0.001644736842105263,0.9983552631578947,608,17450,11700,5750,0.670487106017192,232,117,115,134.43685473783438,0.42367649941111013,0.8868876132961621,0.09798170659930709,17815750.908566304,339968.703388076,18155719.61195438,1726,24,1121.1611842105262,110,498,110,32.64906679473045,0.6620265151515152,36.19557057057058,135067.86786786848,1227.8897078897135,0
1728,512,0,0,607,0.0,0.0,1.0,607,17600,13200,4400,0.75,220,132,88,134.92537861872052,0.42347846811040246,0.8864078044300798,0.09874817550700865,17833631.91967253,342241.9077817483,18175873.82745428,1727,25,1123.7133443163098,115,492,102,32.502041371801866,0.6623188405797101,36.06321839080462,135135.63218390945,1175.0924537731255,0
1729,512,0,0,607,0.0,0.0,1.0,607,17150,12900,4250,0.7521865889212828,214,129,85,134.43741735721744,0.4233043670923929,0.8866609387206237,0.09871281224469049,17847615.867566258,341327.47664386657,18188943.344210126,1728,26,1124.7133443163098,116,491,77,32.41006901125087,0.6631645114942528,35.959757834757866,135188.60398860587,1165.4189999017747,0
1730,512,0,0,607,0.0,0.0,1.0,607,16850,12000,4850,0.712166172106825,217,120,97,132.8667397163919,0.4230461040337971,0.8846941015401102,0.097757955299408,17856304.215082947,336251.7848884344,18192555.999971382,1729,27,1125.7133443163098,123,484,78,32.386426890168224,0.6625169376693767,35.89549731182799,135221.5053763462,1099.361832328018,0
1731,512,0,0,607,0.0,0.0,1.0,607,16800,11600,5200,0.6904761904761905,220,116,104,132.26310421731762,0.42285093418732317,0.8836320187737192,0.09765279340253247,17871145.986181032,334538.64881063654,18205684.63499167,1730,28,1126.7133443163098,126,481,86,32.291181614048206,0.6631117724867726,35.78576115485566,135277.6902887152,1073.6324626088508,0
1732,512,0,0,607,0.0,0.0,1.0,607,17650,12500,5150,0.7082152974504249,228,125,103,135.59756366884403,0.422723501757095,0.8867736095376109,0.10057632240473396,17890730.834977247,346137.90269560314,18236868.73767285,1731,29,1127.7133443163098,129,478,91,32.05638235531847,0.6640826873385013,35.64102564102567,135351.79487179685,1049.2387199364098,0
1733,512,0,0,607,0.0,0.0,1.0,607,16250,11700,4550,0.72,208,117,91,133.40910153488963,0.42250488434345906,0.8854478294961214,0.09931566447597413,17906260.38781177,340121.62203755416,18246382.009849325,1732,30,1128.7133443163098,132,475,98,31.99799613045883,0.6647727272727273,35.5263157894737,135410.52631579048,1025.8373205741702,0
1734,512,0,1,606,0.0,0.0016474464579901153,0.9983525535420099,607,19350,14600,4750,0.7545219638242894,241,146,95,141.9070730177928,0.4224207223028728,0.893486320442908,0.099011252697424,17625591.178873397,359489.21088042785,17985080.389753826,1733,31,1129.7133443163098,135,472,89,33.88369140054877,0.6433641975308642,37.60723039215685,134345.09803921482,995.1488743645542,8
1735,512,0,0,606,0.0,0.0,1.0,606,16700,11700,5000,0.7005988023952096,217,117,100,142.8564091564767,0.4223470642518797,0.8950138853163561,0.10006635892406132,17642947.491536118,366181.62511543144,18009129.11665155,1734,32,1131.1914191419141,94,512,94,33.72777615348204,0.6531471631205674,37.47807017543864,134411.22807017746,1429.9066815976325,0
1736,512,0,1,605,0.0,0.0016501650165016502,0.9983498349834984,606,17700,12400,5300,0.7005649717514124,230,124,106,140.66298231946803,0.42232388011528427,0.8932628210543658,0.09893970210315381,17661218.49811271,357955.93306806573,18019174.431180775,1735,33,1132.1914191419141,98,508,98,33.64754837158998,0.6533801020408163,37.34217171717176,134480.80808081018,1372.2531436817364,0
1737,512,1,0,606,0.0016501650165016502,0.0,1.0,606,16700,11500,5200,0.688622754491018,219,115,104,139.0660596022773,0.42237308958168546,0.8911719319503886,0.09830757819017348,17683203.99161519,353926.7000514436,18037130.691666633,1736,0,1132.7112211221122,106,500,101,33.52378659357213,0.6530070754716981,37.17873831775704,134564.48598131,1269.476282842547,0
1738,512,0,0,606,0.0,0.0,1.0,606,19150,14300,4850,0.7467362924281984,240,143,97,149.50648058723928,0.42227006791588245,0.8913860069581481,0.09506574824676094,17203459.371863987,374055.7329225885,17577515.104786575,1737,1,1133.7112211221122,137,469,93,36.89273772433003,0.6112378345498783,40.768417874396135,132726.5700483092,968.8070806445927,8
1739,512,1,0,607,0.0016474464579901153,0.0,1.0,607,16800,12600,4200,0.75,210,126,84,153.38462282866413,0.4224753200196461,0.8950861105046217,0.0979301822675316,17222499.999999996,390133.33333333314,17612633.33333333,1738,0,1132.841845140033,100,507,100,36.64658634538153,0.6196875,40.625,132799.99999999997,1327.9999999999998,0
1740,512,2,0,609,0.003284072249589491,0.0,1.0,609,17150,12700,4450,0.7405247813411079,216,127,89,152.6040239380579,0.4228883316408838,0.8948805627614411,0.09808367091723728,17253542.01240276,387641.98765539756,17641184.00005816,1739,0,1130.1182266009853,106,503,106,36.429622754715616,0.6205778301886793,40.39135514018691,132919.62616822377,1253.9587374360733,0
1741,512,2,0,611,0.0032733224222585926,0.0,1.0,611,16800,12100,4700,0.7202380952380952,215,121,94,149.07363468267098,0.4234547861161046,0.8936719463007441,0.09649223164339416,17286216.640126698,376383.82889115176,17662600.46901785,1740,0,1127.4157119476267,112,499,76,36.27190570790026,0.6217447916666667,40.14564896755162,133045.42772861358,1187.9056047197641,0
1742,512,1,1,611,0.0016339869281045752,0.0016339869281045752,0.9983660130718954,612,16600,12400,4200,0.7469879518072289,208,124,84,147.63186820676512,0.423668719624602,0.8934317853176876,0.09594116907382273,17304659.899773367,371943.853937247,17676603.753710613,1741,0,1126.5718954248366,117,495,79,36.16873783331073,0.6221509971509971,40.00706214689266,133116.38418079092,1137.7468733400933,0
1743,512,1,1,611,0.0016339869281045752,0.0016339869281045752,0.9983660130718954,612,17000,12600,4400,0.7411764705882353,214,126,88,146.6574846438403,0.42371017101148517,0.8924813427992027,0.09555793881788364,17316740.59019397,368525.92343755264,17685266.513631523,1742,0,1127.5669934640523,121,491,84,36.10200338137294,0.6223312672176309,39.916325136612045,133162.841530056,1100.5193514880661,0
1744,512,1,0,612,0.0016339869281045752,0.0,1.0,612,18700,13200,5500,0.7058823529411765,242,132,110,152.6375445318287,0.423841823736223,0.8929877891783691,0.09631822901325646,17167667.679803275,382986.1279967214,17550653.807799995,1743,0,1128.5588235294117,120,492,83,37.08549416575247,0.6111979166666667,41.038223140495866,132588.42975206597,1104.9035812672164,8
1745,512,1,0,613,0.0016313213703099511,0.0,1.0,613,16950,12100,4850,0.7138643067846607,218,121,97,151.48136449625923,0.42397384910099617,0.8929098053438342,0.09599128439227114,17187385.6414993,381163.72581954254,17568549.367318843,1744,0,1127.716150081566,125,488,90,36.96450981643375,0.6118333333333333,40.88955026455025,132664.5502645495,1061.316402116396,0
1746,512,4,0,617,0.006482982171799027,0.0,1.0,617,16800,12800,4000,0.7619047619047619,208,128,80,150.4967884398188,0.42495829737523416,0.8941671390585817,0.09589675905021852,17213279.012345582,377908.6419753066,17591187.65432089,1745,0,1121.3987034035656,134,483,98,36.791979110873086,0.6124067164179104,40.694444444444436,132764.4444444437,990.779436152565,0
1747,512,0,1,616,0.0,0.0016207455429497568,0.9983792544570502,617,16300,11700,4600,0.7177914110429447,209,117,92,152.51022353536672,0.4249125823528173,0.8971219902319463,0.09735143505235788,17221518.926501665,385591.54021986655,17607110.46672153,1746,1,1122.3987034035656,140,477,98,36.67676645398963,0.6122023809523809,40.6323877068558,132796.21749409055,948.5444106720754,0
1748,512,4,0,620,0.0064516129032258064,0.0,1.0,620,15500,10700,4800,0.6903225806451613,203,107,96,156.14485543670324,0.4256112985738357,0.899357387634881,0.0957206621864401,17030573.93404754,392347.3009871901,17422921.23503473,1747,0,1117.9548387096775,114,506,78,38.046897863623066,0.6018823099415205,42.07427536231885,132057.97101449332,1158.4032545130992,8
1749,512,0,1,619,0.0,0.0016129032258064516,0.9983870967741936,620,18300,13700,4600,0.7486338797814208,229,137,92,158.584398850802,0.4257818064168708,0.8994007495069463,0.09768890203299573,17053714.473814044,398590.61160060513,17452305.085414648,1748,1,1118.9548387096775,120,500,85,37.80602715052871,0.6025173611111111,41.899104683195596,132147.65840220402,1101.2304866850334,0
1750,512,1,0,620,0.0016129032258064516,0.0,1.0,620,18300,12800,5500,0.6994535519125683,238,128,110,163.79718423324294,0.4262013718797228,0.9018359110691136,0.10128272550784768,17071728.86259064,416960.223537154,17488689.086127795,1749,0,1119.441935483871,129,491,89,37.53296822638699,0.602390180878553,41.76282051282054,132217.43589743777,1024.9413635460292,0
1751,512,1,2,619,0.001610305958132045,0.00322061191626409,0.9967793880837359,621,18900,14900,4000,0.7883597883597884,229,149,80,161.39100282231186,0.42663584575693037,0.9001810938540864,0.10029764750293407,17095579.81611842,408714.5540704416,17504294.370188862,1750,0,1118.6376811594203,98,523,98,37.41186549945709,0.6105442176870748,41.58249158249156,132309.76430976338,1350.099635813912,0
1752,512,1,1,619,0.0016129032258064516,0.0016129032258064516,0.9983870967741936,620,18150,13600,4550,0.7493112947658402,227,136,91,161.7028340787153,0.4264536865739052,0.9007100962733356,0.10096653881706077,17117902.017155096,411452.6539311424,17529354.671086237,1751,0,1121.4241935483872,102,518,102,37.232423377266706,0.6112132352941176,41.41383495145629,132396.1165048532,1298.0011422044433,0
1753,512,1,0,620,0.0016129032258064516,0.0,1.0,620,18500,13300,5200,0.7189189189189189,237,133,104,159.8947745978054,0.42671132115621796,0.8982335206702112,0.10037777407383837,17143363.84297503,405726.85950412555,17549090.702479158,1752,0,1122.2387096774194,109,511,75,37.083859369853975,0.6115252293577982,41.221590909090885,132494.54545454407,1215.5462885737988,0
1754,512,1,0,621,0.001610305958132045,0.0,1.0,621,17800,12900,4900,0.7247191011235955,227,129,98,161.7439360408835,0.4270071468148841,0.8987834961369963,0.10193897178946698,17161880.92062499,413166.03399336047,17575046.95461835,1753,0,1121.4299516908213,113,508,78,36.89402762092982,0.612094395280236,41.08187134502922,132566.0818713438,1173.1511670030425,0
1755,512,1,1,621,0.001607717041800643,0.001607717041800643,0.9983922829581994,622,16700,11700,5000,0.7005988023952096,217,117,100,164.51351741451282,0.4272376974695932,0.9019178675248187,0.10424872113883264,17187348.463085126,424410.23013820424,17611758.69322333,1754,0,1120.6254019292605,117,505,83,36.62711797038252,0.6132478632478633,40.88983050847455,132664.4067796595,1133.8838186295684,0
1756,512,3,1,623,0.004807692307692308,0.0016025641025641025,0.9983974358974359,624,17200,12600,4600,0.7325581395348837,218,126,92,160.65730175929323,0.42792845224376125,0.900061164366798,0.10223377613076852,17207010.151110765,410886.364444433,17617896.5155552,1755,0,1118.0128205128206,124,500,91,36.576492237472216,0.6134912634408602,40.741666666666625,132740.26666666396,1070.4860215053545,0
1757,512,4,0,627,0.006379585326953748,0.0,1.0,627,16050,11300,4750,0.7040498442367601,208,113,95,159.47860163206076,0.4287584309549166,0.9046096961420351,0.09855612186220676,17069016.817777816,402978.58666666795,17471995.404444486,1756,0,1112.878787878788,124,503,86,37.66533004152416,0.6029905913978495,41.78333333333334,132206.93333333364,1066.1849462365617,8
1758,512,2,0,629,0.003179650238473768,0.0,1.0,629,18800,13500,5300,0.7180851063829787,241,135,106,159.49905445604756,0.42940066799658405,0.9058871716042733,0.09927951335765506,17103106.945649836,400985.8772183539,17504092.82286819,1757,0,1110.3370429252782,95,534,95,37.40296552061904,0.6119517543859649,41.52560763888885,132338.888888887,1393.040935672495,0
1759,512,3,0,632,0.004746835443037975,0.0,1.0,632,17600,12300,5300,0.6988636363636364,229,123,106,155.23039656178398,0.4298682019699493,0.9035040673293491,0.09731751784450207,17136971.52935229,388035.77727386577,17525007.306626156,1758,0,1106.0617088607594,104,528,91,37.25356275562376,0.6121794871794872,41.269841269841244,132469.8412698398,1273.7484737484594,0
1760,512,2,0,634,0.0031545741324921135,0.0,1.0,634,17600,12800,4800,0.7272727272727273,224,128,96,152.136811679454,0.4303011359955347,0.9018241573346573,0.09580000510844694,17157756.157057792,377665.2634616535,17535421.420519445,1759,0,1103.5694006309147,110,524,76,37.174363528715205,0.612405303030303,41.112987987987964,132550.15015014884,1205.0013650013532,0
1761,512,0,0,634,0.0,0.0,1.0,634,17200,12400,4800,0.7209302325581395,220,124,96,151.0941355878349,0.43046040129040186,0.9016441955891139,0.09548147640075391,17174417.664356124,374990.7582440628,17549408.422600187,1760,1,1104.5694006309147,114,520,78,37.07378912397272,0.6128472222222222,40.9873188405797,132614.49275362238,1163.2850241545823,0
1762,512,0,0,634,0.0,0.0,1.0,634,16900,12200,4700,0.7218934911242604,216,122,94,150.5042469187403,0.43052191673186785,0.901749025940012,0.09548714261031768,17193031.741765924,373824.85890889505,17566856.60067482,1761,2,1105.5694006309147,121,513,81,36.946631743103175,0.6129476584022038,40.84699453551912,132686.33879781398,1096.581312378628,0
1763,512,2,0,636,0.0031446540880503146,0.0,1.0,636,17250,12000,5250,0.6956521739130435,225,120,105,150.65108558971292,0.4307893927763746,0.9035268241986405,0.096053422656136,17216115.97633133,374275.31229454244,17590391.288625874,1762,0,1103.0896226415093,129,507,88,36.76628867465911,0.6133720930232558,40.67307692307692,132775.38461538436,1029.2665474060802,0
1764,512,0,0,636,0.0,0.0,1.0,636,17500,12000,5500,0.6857142857142857,230,120,110,150.75962816246846,0.43070510201554996,0.9028794879256716,0.09655552369322945,17237064.48137895,375030.6863650387,17612095.16774399,1763,1,1104.0896226415093,94,542,94,36.6033699556307,0.6224512411347518,40.51535087719299,132856.1403508777,1413.363195222103,0
1765,512,0,0,636,0.0,0.0,1.0,636,17100,11900,5200,0.695906432748538,223,119,104,157.7604656692968,0.43085299773849023,0.9008751440878497,0.10012960167990038,17194844.444444396,398233.33333333186,17593077.777777728,1764,2,1105.0896226415093,124,512,91,36.74470793140408,0.6125672043010753,40.83333333333333,132693.33333333294,1070.1075268817171,8
1766,512,1,0,637,0.0015698587127158557,0.0,1.0,637,17750,12500,5250,0.704225352112676,230,125,105,147.9662922095768,0.4311876540650126,0.9026623697902751,0.09229109977299828,17112864.04270125,361275.4082970134,17474139.450998265,1765,0,1104.353218210361,96,541,96,37.626249515423375,0.6124131944444444,41.45189003436423,132376.6323024041,1378.9232531500427,7
1767,512,2,0,639,0.003129890453834116,0.0,1.0,639,17950,13600,4350,0.7576601671309192,223,136,87,144.6328610474016,0.43155602896375117,0.9007750602026767,0.0906773950664654,17137164.792387273,349969.4348327468,17487134.22722002,1766,0,1101.8935837245697,101,538,95,37.52627294256957,0.6129331683168318,41.26838235294114,132470.58823529203,1311.5899825276438,0
1768,512,2,2,639,0.0031201248049922,0.0031201248049922,0.9968798751950078,641,19550,14200,5350,0.7263427109974424,249,142,107,144.2313776336144,0.43215079384425376,0.900628715435865,0.09081197295481609,17157237.86865552,347172.4108367564,17504410.279492278,1767,0,1099.452418096724,107,534,75,37.38299150553255,0.6130257009345794,41.116898148148124,132548.14814814684,1238.767739702307,0
1769,512,2,1,640,0.0031201248049922,0.0015600624024961,0.9984399375975039,641,18250,13700,4550,0.7506849315068493,228,137,91,142.84960271634742,0.4319038855304212,0.899855554756444,0.09034166972878414,17178064.413265064,344325.9353741411,17522390.348639205,1768,0,1100.4477379095165,111,530,81,37.25944276892143,0.6137387387387387,40.959821428571395,132628.57142856953,1194.8519948519777,0
1770,512,2,0,642,0.003115264797507788,0.0,1.0,642,18650,13300,5350,0.7131367292225201,240,133,107,142.1517953317141,0.4320625628763468,0.8999084272504374,0.09041154834613842,17204616.7137335,342083.43077024154,17546700.144503742,1769,0,1099.6947040498442,115,527,87,37.074550844619964,0.6149456521739131,40.75969827586205,132731.03448275744,1154.1829085457168,0
1771,512,1,0,643,0.0015552099533437014,0.0,1.0,643,17800,12700,5100,0.7134831460674157,229,127,102,143.94880910919426,0.432237136411131,0.9016118361242023,0.09179418809728153,17216831.067663867,349268.4657648747,17566099.533428743,1770,0,1098.9828926905132,121,522,89,36.93463355611893,0.6147555096418733,40.66769125683059,132778.14207650165,1097.3400171611706,0
1772,512,0,0,643,0.0,0.0,1.0,643,18400,13300,5100,0.7228260869565217,235,133,102,144.0812508665839,0.4322408710144717,0.901331513187269,0.09222302919054745,17234275.061616793,349627.1817313091,17583902.243348103,1771,1,1099.9828926905132,93,550,93,36.79796275732472,0.6225358422939068,40.536347517730526,132845.39007092334,1428.4450545260574,0
1773,512,0,1,642,0.0,0.0015552099533437014,0.9984447900466563,643,18100,13800,4300,0.7624309392265194,224,138,86,140.76301009670453,0.43236411292471527,0.8992461194372408,0.09050762053452026,17255316.304720245,339082.05264463794,17594398.35736488,1772,2,1100.9828926905132,96,547,96,36.723489548863846,0.6232638888888888,40.37800687285226,132926.46048110104,1384.650630011469,0
1774,512,1,0,643,0.0015552099533437014,0.0,1.0,643,18250,13800,4450,0.7561643835616438,227,138,89,140.25565147739283,0.432440823696038,0.8986942105108697,0.0906530430280722,17279507.881584246,337859.7270280755,17617367.60861232,1773,0,1101.6251944012442,101,542,76,36.55218160377357,0.6237623762376238,40.196078431372584,133019.60784313912,1317.0258202291002,0
1775,512,0,0,643,0.0,0.0,1.0,643,17350,12000,5350,0.69164265129683,227,120,107,138.37480940417748,0.4323595708395711,0.8971531933648236,0.0897117693412527,17293679.312118746,332651.9157422873,17626331.227861032,1774,1,1102.6251944012442,106,537,79,36.49305815666591,0.623624213836478,40.08956386292839,133074.14330218278,1255.4164462470073,0
1776,512,0,0,643,0.0,0.0,1.0,643,18000,13600,4400,0.7555555555555555,224,136,88,156.38229856209256,0.4323701690382407,0.9051874613224227,0.10384132316343915,17403464.953388788,397718.77047115273,17801183.72385994,1775,2,1103.6251944012442,104,539,95,35.188452806737224,0.632411858974359,39.26587301587302,133495.8730158732,1283.6141636141654,8
1777,512,1,1,643,0.0015527950310559005,0.0015527950310559005,0.9984472049689441,644,17550,12500,5050,0.7122507122507122,226,125,101,156.08423840426525,0.43253778749649835,0.9052735828022545,0.10416356207670145,17426237.13803895,397642.1903885865,17823879.328427535,1776,0,1102.9099378881988,110,534,70,35.02303491355533,0.6327651515151516,39.09534534534534,133583.18318318322,1214.3925743925747,0
1778,512,1,2,642,0.0015527950310559005,0.003105590062111801,0.9968944099378882,644,20200,13900,6300,0.6881188118811881,265,139,126,156.84870781853547,0.4323660261487785,0.9056572809486996,0.10529439582062303,17453040.393884297,398497.366657092,17851537.76054139,1777,0,1103.8757763975154,117,527,78,34.79937228120004,0.6333689458689459,38.89477401129944,133685.87570621498,1142.6143222753417,0
1779,512,1,1,642,0.0015552099533437014,0.0015552099533437014,0.9984447900466563,643,17550,12000,5550,0.6837606837606838,231,120,111,156.230303986582,0.4318462142830611,0.9058731690554387,0.10537667933824947,17474422.639177926,399856.87218175497,17874279.51135968,1778,0,1106.552099533437,123,520,84,34.65312610526996,0.6338922764227642,38.734879032258064,133767.74193548376,1087.5426173616565,0
1780,512,0,0,642,0.0,0.0,1.0,642,17650,12600,5050,0.7138810198300283,227,126,101,160.30601732887249,0.431859201938171,0.9090286815402104,0.10856106151042247,17492531.721536376,414781.6186556928,17907313.34019207,1779,1,1106.8255451713396,125,517,88,34.40913032248543,0.6349166666666667,38.59953703703704,133837.03703703723,1070.6962962962978,0
1781,512,2,0,644,0.003105590062111801,0.0,1.0,644,19300,13700,5600,0.7098445595854922,249,137,112,155.22449056919393,0.4318690049554205,0.9062594204813346,0.10596425627134902,17528459.70932653,396069.24576856475,17924528.955095097,1780,0,1104.3850931677018,98,546,98,34.26948878791534,0.6433886054421769,38.33122895622893,133974.41077440936,1367.085824228667,0
1782,512,0,0,644,0.0,0.0,1.0,644,19000,13600,5400,0.7157894736842105,244,136,108,155.43210404422962,0.4317116828305465,0.9066366005711743,0.10648672326463277,17544486.079795916,397595.2771514697,17942081.356947385,1781,1,1105.3850931677018,100,544,96,34.14260200396587,0.6440625,38.21163366336631,134035.643564355,1340.35643564355,0
1783,512,2,1,645,0.0030959752321981426,0.0015479876160990713,0.9984520123839009,646,16050,10500,5550,0.6542056074766355,216,105,111,150.0486461959991,0.4318271453828369,0.9030939158748053,0.10330128549212708,17566259.04499513,381908.67768594023,17948167.722681068,1782,0,1102.9597523219813,109,537,72,34.118706769816605,0.643539755351682,38.04924242424239,134118.78787878572,1230.4475952182177,0
1784,512,0,0,645,0.0,0.0,1.0,645,17050,12300,4750,0.7214076246334311,218,123,95,151.02388882059236,0.43160981109666646,0.9033344502638545,0.10435387786136804,17582546.857284315,385026.9203514638,17967573.77763578,1783,1,1105.6697674418604,111,534,78,33.96991151489336,0.6443318318318318,37.927827380952344,134180.95238095033,1208.8374088373903,0
1785,512,0,1,644,0.0,0.0015503875968992248,0.9984496124031008,645,19250,13900,5350,0.7220779220779221,246,139,107,159.21592906687948,0.43167701863354035,0.910033203971442,0.1060993544117939,17419639.88919658,406446.829793778,17826086.718990356,1784,2,1106.6697674418604,94,551,73,34.991505534538334,0.6363031914893618,39.144736842105246,133557.89473684135,1420.828667413206,8
1786,512,1,1,644,0.0015503875968992248,0.0015503875968992248,0.9984496124031008,645,18450,12900,5550,0.6991869918699187,240,129,111,153.79226340267869,0.4318140417609579,0.9063234953306005,0.10288485256697287,17437316.34718111,388894.8697403015,17826211.21692141,1785,0,1107.0713178294573,103,542,76,34.998632805004405,0.6352144012944984,39.01241987179487,133625.64102564089,1297.33632063729,0
1787,512,0,0,644,0.0,0.0,1.0,644,18000,13100,4900,0.7277777777777777,229,131,98,153.5400547235645,0.4316469830375858,0.9056336629239143,0.10318567871058502,17457972.027352605,389299.5960884355,17847271.62344104,1786,1,1109.748447204969,111,533,79,34.8483094712349,0.6349474474474475,38.857886904761905,133704.7619047619,1204.5474045474045,0
1788,512,0,0,644,0.0,0.0,1.0,644,18500,14000,4500,0.7567567567567568,230,140,90,153.9494758636458,0.4316401407577704,0.906359471105294,0.10383520254467854,17474289.31660775,390731.53627629805,17865020.85288405,1787,2,1110.748447204969,117,527,82,34.71372820651443,0.63497150997151,38.735875706214706,133767.23163841912,1143.3096721232403,0
1789,512,0,1,643,0.0,0.0015527950310559005,0.9984472049689441,644,19850,15200,4650,0.7657430730478589,245,152,93,157.6694421126321,0.43144020531669286,0.9088770290291648,0.10676635732713576,17492144.4637347,402945.3317901278,17895089.795524828,1788,3,1111.748447204969,119,525,86,34.48098966116516,0.6359418767507004,38.60243055555557,133835.55555555658,1124.6685340803074,0
1790,512,0,0,643,0.0,0.0,1.0,643,17300,12300,5000,0.7109826589595376,223,123,100,157.4831531725824,0.43125029271215376,0.9089604333709265,0.1072716095216996,17518670.886500526,405879.1061197638,17924549.99262029,1789,4,1114.4183514774495,90,553,90,34.284612523519854,0.6450231481481481,38.40430402930402,133936.9963369961,1488.1888481888454,0
1791,512,0,0,643,0.0,0.0,1.0,643,19400,14500,4900,0.7474226804123711,243,145,98,155.77748674736867,0.43103752125695843,0.907546950066269,0.10675497340930415,17545810.280086093,398648.44567558856,17944458.72576168,1790,5,1115.4183514774495,94,549,90,34.12352711230241,0.6458333333333333,38.2017543859649,134040.70175438529,1425.9649122806945,0
1792,512,1,2,642,0.0015527950310559005,0.003105590062111801,0.9968944099378882,644,19450,13600,5850,0.699228791773779,253,136,117,152.4623117117726,0.4310727346418992,0.9053684124532759,0.10480855288599661,17559695.563615583,387188.3557167522,17946883.919332337,1791,0,1114.6847826086957,100,544,74,34.10516920007344,0.6452083333333334,38.09818481848182,134093.72937293586,1340.9372937293585,0
1793,512,0,0,642,0.0,0.0,1.0,642,20400,15200,5200,0.7450980392156863,256,152,104,152.21152537500737,0.43081662908260876,0.9047947574492816,0.10516542280002705,17582162.870849572,386441.56599276024,17968604.436842334,1792,1,1119.0778816199377,103,539,80,33.941692145996534,0.6461367313915858,37.930689102564074,134179.48717948567,1302.7134677619968,0
1794,512,1,0,643,0.0015552099533437014,0.0,1.0,643,18600,13700,4900,0.7365591397849462,235,137,98,150.88498772039094,0.43079446923413584,0.9038849077839555,0.10466054014169936,17599662.725788534,383904.9788527152,17983567.70464125,1793,0,1118.3359253499223,110,533,84,33.84410045335239,0.6458333333333333,37.80030030030026,134246.2462462438,1220.4204204203982,0
1795,512,0,0,643,0.0,0.0,1.0,643,18850,14900,3950,0.7904509283819628,228,149,79,149.31363209953915,0.43065931696729215,0.9030270145407913,0.10394024612787318,17615447.1461301,378595.2788892191,17994042.42501932,1794,1,1119.3359253499223,113,530,88,33.765994380195956,0.6463864306784661,37.68274853801165,134306.43274853544,1188.5525021994288,0
1796,512,0,0,643,0.0,0.0,1.0,643,16600,11200,5400,0.6746987951807228,220,112,108,151.33869982858488,0.4305009495986008,0.9025524125811124,0.1034017447863333,17532364.694444142,385465.0555555428,17917829.749999683,1795,2,1120.3359253499223,99,544,99,34.341581087715035,0.6434132996632997,38.302083333333286,133989.333333331,1353.4276094275858,8
1797,512,0,0,643,0.0,0.0,1.0,643,15850,10900,4950,0.6876971608832808,208,109,99,162.78172086060493,0.4305782659812761,0.9088908763941277,0.10618501758062228,17321991.758494213,419490.7254361869,17741482.4839304,1796,3,1121.3359253499223,109,534,79,35.64256525537882,0.6250955657492354,39.876893939393966,133183.03030303173,1221.8626633305664,8
1798,512,1,0,644,0.0015527950310559005,0.0,1.0,644,17300,12000,5300,0.6936416184971098,226,120,106,168.38100810923012,0.4309375493046634,0.9119106332012674,0.11029088079894973,17340936.53866448,437876.8751877021,17778813.41385218,1797,0,1120.5931677018634,116,528,80,35.35231302523405,0.6250897988505747,39.73468660968661,133255.8404558406,1148.7572453089708,0
1799,512,0,0,644,0.0,0.0,1.0,644,18500,14200,4300,0.7675675675675676,228,142,86,167.03999999999934,0.43098192350170167,0.912049689440994,0.10989473684210531,17361111.11111118,432700.0000000025,17793811.111111183,1798,1,1121.5931677018634,122,522,86,35.23333333333337,0.6255122950819672,39.58333333333334,133333.33333333387,1092.8961748633924,0
1800,512,1,0,645,0.0015503875968992248,0.0,1.0,645,18800,13500,5300,0.7180851063829787,241,135,106,165.43255060390996,0.43110304620668627,0.9104309563571529,0.10957083199792515,17391826.438904237,427634.84148968745,17819461.280393925,1799,0,1120.8527131782946,94,551,94,35.04112153464305,0.634197695035461,39.35307017543859,133451.2280701751,1419.6939156401606,0
1801,512,0,0,645,0.0,0.0,1.0,645,18000,13400,4600,0.7444444444444445,226,134,92,162.25823188165776,0.43107154894313643,0.9085092854200998,0.10806355933479551,17416983.879063565,418209.801785637,17835193.680849202,1800,1,1121.8527131782946,101,544,70,34.93235549378126,0.6341790429042904,39.16462418300653,133547.71241830033,1322.254578399013,0
1802,512,0,3,642,0.0,0.004651162790697674,0.9953488372093023,645,18950,13900,5050,0.7335092348284961,240,139,101,158.41978522412074,0.43109502142616396,0.9065329428636,0.10602559474590192,17439241.143865004,404594.1672965506,17843835.311161555,1801,2,1122.8527131782946,104,541,78,34.86322804616927,0.6351161858974359,38.99801587301588,133633.01587301627,1284.9328449328486,0
1803,512,0,0,642,0.0,0.0,1.0,642,17450,13000,4450,0.7449856733524355,219,130,89,162.79283612494234,0.4307531958599216,0.9072545900444084,0.10930376139817637,17453827.16049396,422421.6049382767,17876248.765432235,1802,5,1128.4906542056074,110,532,80,34.6381870567376,0.6348484848484848,38.88888888888891,133688.88888888992,1215.3535353535447,0
1804,512,0,0,642,0.0,0.0,1.0,642,18700,13200,5500,0.7058823529411765,242,132,110,162.94281470283804,0.4307469689753322,0.9072494769967974,0.10986084144031803,17472640.230711006,422308.2358964261,17894948.466607433,1803,6,1129.4906542056074,115,527,85,34.49129372472185,0.6352355072463768,38.74820402298853,133760.91954023152,1163.138430784622,0
1805,512,1,1,642,0.0015552099533437014,0.0015552099533437014,0.9984447900466563,643,20200,14900,5300,0.7376237623762376,255,149,106,165.2354724528158,0.4307297697546386,0.9104484085431213,0.11209217185312796,17500277.777778037,429533.33333334234,17929811.11111138,1804,0,1128.732503888025,122,521,89,34.22144754316076,0.6360143442622951,38.5416666666667,133866.66666666867,1097.267759562858,0
1806,512,0,0,642,0.0,0.0,1.0,642,17250,12300,4950,0.7130434782608696,222,123,99,165.8765901935914,0.4304562797776708,0.9105340852229631,0.11290341039903505,17515275.01573697,435424.81918268255,17950699.834919654,1805,1,1131.4345794392523,92,550,92,34.09081988038651,0.644134963768116,38.42965949820785,133924.01433691574,1455.6958080099537,0
1807,512,0,1,641,0.0,0.001557632398753894,0.9984423676012462,642,16550,11400,5150,0.6888217522658611,217,114,103,163.4317429819453,0.43034925836285787,0.9086724461495925,0.11158143124799702,17529041.01864622,428010.34529586555,17957051.363942087,1806,2,1132.4345794392523,96,546,96,34.05032078904527,0.6439887152777778,38.326890034364226,133976.63230240374,1395.5899198167056,0
1808,512,1,0,642,0.001557632398753894,0.0,1.0,642,16800,11600,5200,0.6904761904761905,220,116,104,163.47396900824896,0.4303839365412623,0.9085750635397545,0.11221283153662667,17553116.95520564,428695.5394266879,17981812.49463233,1807,0,1133.3956386292834,102,540,87,33.866638343889996,0.6441993464052287,38.147249190938496,134068.60841423867,1314.3981217082223,0
1809,512,0,0,642,0.0,0.0,1.0,642,18200,13100,5100,0.7197802197802198,233,131,102,161.7032669036974,0.4303523464926136,0.908194210816138,0.11155224334937248,17575342.376685884,421798.0558522149,17997140.4325381,1808,1,1134.3956386292834,105,537,76,33.744600820112744,0.6451388888888889,37.98152515723268,134153.4591194956,1277.6519916142436,0
1810,512,1,0,643,0.0015552099533437014,0.0,1.0,643,18200,13200,5000,0.7252747252747253,232,132,100,161.6148029073839,0.43031704561787704,0.9087650243435799,0.11197597058582873,17594623.813001934,421910.33195356594,18016534.1449555,1809,0,1133.6298600311043,110,533,79,33.600909221076726,0.6454545454545455,37.8378378378378,134227.02702702506,1220.2457002456824,0
1811,512,0,1,642,0.0,0.0015552099533437014,0.9984447900466563,643,18600,13100,5500,0.7043010752688172,241,131,110,163.42297113424345,0.4302575947701019,0.9095758356253134,0.11360449359327084,17609311.604425143,428353.20440476877,18037664.80882991,1810,1,1134.6298600311043,113,530,82,33.442315843872294,0.6459255162241888,37.7284356725146,134283.04093567136,1188.3454950059413,0
1812,512,0,0,642,0.0,0.0,1.0,642,18300,13200,5100,0.7213114754098361,234,132,102,166.5202786144764,0.4299886053074522,0.9110656575191358,0.11623673615821958,17627582.831107374,440370.0008671428,18067952.831974518,1811,2,1137.3442367601247,123,519,85,33.22278734620258,0.6454098915989159,37.59240591397846,134352.68817204094,1092.2982778214712,0
1813,512,0,0,642,0.0,0.0,1.0,642,18800,12700,6100,0.675531914893617,249,127,122,167.54850088183377,0.4298934807859604,0.9120432181179845,0.11728395061728404,17640000.00000005,443911.11111111334,18083911.11111116,1812,3,1138.3442367601247,103,539,89,33.10185185185185,0.6504854368932038,37.50000000000001,134400.00000000038,1304.8543689320425,0
1814,512,1,0,643,0.0015552099533437014,0.0,1.0,643,18950,14500,4450,0.7651715039577837,234,145,89,164.57208521616457,0.4298138835191349,0.9103780803503276,0.1157028223417325,17659163.09633751,433691.05878732656,18092854.155124836,1813,0,1137.5723172628304,94,549,94,33.03509302940482,0.6543661347517731,37.357456140350905,134472.98245614168,1430.5636431504433,0
1815,512,0,1,642,0.0,0.0015552099533437014,0.9984447900466563,643,17650,13400,4250,0.7592067988668555,219,134,85,162.37703931077274,0.4297374755534884,0.9097587883743425,0.11487796145631457,17686697.530864436,428132.71604939253,18114830.246913828,1814,1,1138.5723172628304,98,545,89,32.88474240422723,0.6552933673469388,37.152777777777814,134577.77777777961,1373.2426303855063,0
1816,512,0,1,641,0.0,0.001557632398753894,0.9984423676012462,642,18200,12100,6100,0.6648351648351648,243,121,122,164.19662665299373,0.4295227027149622,0.9111389191265962,0.11689606955238868,17714116.149942666,435119.6231919871,18149235.773134653,1815,2,1139.6635514018692,103,539,70,32.62991185317749,0.6560477346278317,36.94911858974362,134682.0512820528,1307.5927308937164,0
1817,512,0,1,640,0.0,0.0015600624024961,0.9984399375975039,641,19700,14400,5300,0.7309644670050761,250,144,106,163.87798893000328,0.42922791130395216,0.9107509513088003,0.11729331748987042,17737356.181413066,433452.4519890328,18170808.633402098,1816,3,1142.1716068642745,107,534,78,32.46296856106413,0.6568341121495327,36.776620370370395,134770.37037037167,1259.5361716857167,0
1818,512,0,0,640,0.0,0.0,1.0,640,16850,11600,5250,0.6884272997032641,221,116,105,165.34288321511482,0.4290071665525561,0.9110920130600833,0.11878602139065352,17753630.68106758,442237.29686880944,18195867.977936387,1817,4,1144.8484375,115,525,80,32.30168337538932,0.6563405797101449,36.65589080459771,134832.18390804649,1172.4537731134476,0
1819,512,0,0,640,0.0,0.0,1.0,640,16600,11600,5000,0.6987951807228916,216,116,100,169.79390239157883,0.42880441648735007,0.9133485731675428,0.1223419639059273,17766341.115892317,458723.2778574667,18225064.393749785,1818,5,1145.8484375,120,520,82,32.08861638508547,0.6563368055555556,36.561639118457315,134880.44077135072,1124.0036730945894,0
1820,512,0,0,640,0.0,0.0,1.0,640,18900,14300,4600,0.7566137566137566,235,143,92,158.39657585044466,0.42874680082811684,0.9095566740777334,0.10545877286884854,17415563.821872655,404813.1351779019,17820376.95705056,1819,6,1146.8484375,96,544,83,35.043883124725475,0.6354166666666667,39.17525773195876,133542.26804123697,1391.0652920962184,8
1821,512,1,1,640,0.0015600624024961,0.0015600624024961,0.9984399375975039,641,18150,12800,5350,0.7052341597796143,235,128,107,156.64356534706735,0.42877238527041084,0.9085517904466067,0.10450971597449821,17425058.777777825,399554.6666666678,17824613.444444492,1820,0,1146.0577223088924,99,542,70,35.01740131491386,0.6353114478114479,39.10416666666667,133578.66666666704,1349.279461279465,0
1822,512,0,0,640,0.0,0.0,1.0,640,16900,11600,5300,0.6863905325443787,222,116,106,158.8916829948788,0.4287017169568336,0.908879784666262,0.10631033561112126,17437915.44469648,409247.9465860454,17847163.391282525,1821,8,1148.8484375,104,536,71,34.860989686280504,0.6350160256410257,39.00793650793652,133627.93650793712,1284.8840048840107,0
1823,512,1,0,641,0.0015600624024961,0.0,1.0,641,17300,12500,4800,0.7225433526011561,221,125,96,157.6094784043577,0.42895713484789394,0.9080734375060988,0.10581363886153827,17453405.165289354,404664.4168962386,17858069.582185593,1822,0,1148.0546021840873,109,532,75,34.776736602231665,0.6350344036697247,38.89204545454547,133687.2727272735,1226.488740617188,0
1824,512,2,0,643,0.003110419906687403,0.0,1.0,643,18550,13600,4950,0.7331536388140162,235,136,99,158.2508690082892,0.42927872495393316,0.909621133706602,0.1068762029092952,17480194.0893423,406101.1810144006,17886295.2703567,1823,0,1145.4805598755831,117,526,80,34.55651132281566,0.6354166666666667,38.69173728813561,133789.8305084758,1143.5028248587676,0
1825,512,1,0,644,0.0015527950310559005,0.0,1.0,644,17300,12000,5300,0.6936416184971098,226,120,106,159.58216207366462,0.42938631391091836,0.9101185386040924,0.108040873696349,17491282.518210378,412159.33633946715,17903441.854549844,1824,0,1144.7003105590063,123,521,84,34.437534815957534,0.6351626016260163,38.60887096774196,133832.25806451752,1088.0671387359148,0
1826,512,0,0,644,0.0,0.0,1.0,644,19600,13700,5900,0.6989795918367347,255,137,118,166.2489669271632,0.4294187141182797,0.913692448907691,0.11302135650762625,17509895.957193855,433800.42277711927,17943696.379970975,1825,1,1145.7003105590063,86,558,86,34.12191548779928,0.6457122093023255,38.469827586206904,133903.44827586238,1557.0168404170045,0
1827,512,0,2,642,0.0,0.003105590062111801,0.9968944099378882,644,18600,13700,4900,0.7365591397849462,235,137,98,167.60080458673,0.4294800933930946,0.9138254975966189,0.11067356151516233,17378090.56927299,435116.3923182442,17813206.961591236,1826,2,1146.7003105590063,89,555,89,35.089280425865844,0.6347144194756554,39.45601851851852,133398.51851851863,1498.8597586350409,8
1828,512,0,0,642,0.0,0.0,1.0,642,17600,12700,4900,0.7215909090909091,225,127,98,169.40167032554947,0.429323796783647,0.9141367709461559,0.11223291926049135,17393177.1860618,443286.6535174218,17836463.83957922,1827,3,1150.8255451713396,90,552,90,34.9273747310175,0.6355324074074074,39.342948717948715,133456.41025641025,1482.8490028490028,0
1829,512,0,1,641,0.0,0.001557632398753894,0.9984423676012462,642,16500,12000,4500,0.7272727272727273,210,120,90,170.80031044774609,0.4291556202746552,0.9141885079654948,0.11367252893984602,17413782.5792552,449955.89412126923,17863738.47337647,1828,4,1151.8255451713396,94,548,84,34.733929622466974,0.6358599290780143,39.188596491228076,133535.43859649156,1420.5897723031017,0
1830,512,1,0,642,0.001557632398753894,0.0,1.0,642,18200,13400,4800,0.7362637362637363,230,134,96,168.22970669194908,0.42922249600264384,0.9121139293287179,0.11241190670418853,17432016.6944445,439916.61111111357,17871933.30555561,1829,0,1152.8177570093458,99,543,73,34.6621641850625,0.6358375420875421,39.05208333333334,133605.33333333378,1349.548821548826,0
1831,512,0,0,642,0.0,0.0,1.0,642,18200,12500,5700,0.6868131868131868,239,125,114,168.54537150917815,0.42909319955352726,0.9118675525349511,0.11306674845799318,17449848.551272485,441618.2413706272,17891466.79264311,1830,1,1153.8177570093458,104,538,76,34.518245494040634,0.635917467948718,38.91865079365081,133673.65079365176,1285.3235653235747,0
1832,512,0,0,642,0.0,0.0,1.0,642,16400,11600,4800,0.7073170731707317,212,116,96,173.60260375116096,0.4291416983782155,0.9141170011265662,0.11677642115653362,17462148.67390545,461494.89537597913,17923643.56928143,1831,2,1154.8177570093458,105,537,78,34.29261360073246,0.6366071428571429,38.826650943396245,133720.75471698228,1273.530997304593,0
1833,512,1,0,643,0.0015552099533437014,0.0,1.0,643,19750,14600,5150,0.739240506329114,249,146,103,195.95599735342245,0.42945748123816024,0.9200448004348629,0.12665678450364398,17279591.909637522,528857.9333026372,17808449.84294016,1832,0,1154.0202177293934,96,547,62,35.10442070020256,0.6251085069444444,40.195446735395215,133019.93127147903,1385.6242840779066,8
1834,512,0,0,643,0.0,0.0,1.0,643,19650,14200,5450,0.72264631043257,251,142,109,191.38869828641478,0.42954034905823396,0.9181414976694509,0.12431209141064163,17302238.54708731,514040.5825936246,17816279.129680935,1833,1,1155.0202177293934,98,545,73,35.04962967459938,0.6262755102040816,40.02525252525257,133107.07070707285,1358.2354153782944,0
1835,512,0,0,643,0.0,0.0,1.0,643,18150,12800,5350,0.7052341597796143,235,128,107,194.15439743776747,0.4294830178501927,0.9196777559994505,0.12672503337456895,17324722.431688227,525984.2089002102,17850706.640588436,1834,2,1156.0202177293934,102,541,76,34.80558903186519,0.6269403594771241,39.856391585760555,133193.52750809252,1305.818897138162,0
1836,512,0,0,643,0.0,0.0,1.0,643,19450,14500,4950,0.7455012853470437,244,145,99,194.3509872905577,0.42968731074645233,0.9204549076354169,0.12750111384076507,17348133.267340433,526275.3656311664,17874408.6329716,1835,3,1157.0202177293934,106,537,80,34.62135377711301,0.627751572327044,39.68068535825549,133283.48909657513,1257.3914065714634,0
1837,512,0,0,643,0.0,0.0,1.0,643,19000,13600,5400,0.7157894736842105,244,136,108,193.203180407838,0.4297466606590021,0.9209534312397989,0.12720140028007337,17364498.81023196,523375.2792649851,17887874.089496948,1836,4,1158.0202177293934,81,562,81,34.52610314440865,0.6365740740740741,39.55792682926828,133346.3414634143,1646.2511291779545,0
1838,512,1,0,644,0.0015527950310559005,0.0,1.0,644,18950,13100,5850,0.6912928759894459,248,131,117,190.98390352466265,0.43004035536386437,0.9203879132718658,0.12641315519013344,17388899.999999933,516449.99999999616,17905349.99999993,1837,0,1157.22049689441,84,560,84,34.397482014388444,0.6372767857142857,39.374999999999986,133439.99999999948,1588.5714285714223,0
1839,512,0,0,644,0.0,0.0,1.0,644,18400,13100,5300,0.7119565217391305,237,131,106,193.83682911990945,0.43000111287668763,0.9206468716861076,0.12865672978125303,17401509.261763044,527410.675440174,17928919.937203217,1838,1,1158.22049689441,85,559,84,34.22681958962442,0.6378676470588236,39.28052325581394,133488.37209302268,1570.451436388502,0
1840,512,1,0,645,0.0015503875968992248,0.0,1.0,645,19350,13800,5550,0.7131782945736435,249,138,111,189.45925300615437,0.43005641420707147,0.918298747328625,0.12632967253840102,17422395.684793387,511816.8144037213,17934212.499197107,1839,0,1157.4232558139536,92,553,71,34.181568703218716,0.637115036231884,39.12410394265233,133568.4587813622,1451.8310737104587,0
1841,512,1,0,646,0.0015479876160990713,0.0,1.0,646,18350,13000,5350,0.7084468664850136,237,130,107,186.8911672794161,0.43024180806553547,0.9176357724753748,0.1250606533468866,17438516.78652824,504270.9515711896,17942787.73809943,1840,0,1156.6300309597523,96,550,73,34.12564118389293,0.6371527777777778,39.003436426116835,133630.24054982798,1391.9816723940414,0
1842,512,0,0,646,0.0,0.0,1.0,646,19150,13000,6150,0.6788511749347258,253,130,123,162.9317243306978,0.43021515827873374,0.9088339637763931,0.11023200247508316,17488154.27431216,421525.02625499025,17909679.30056715,1841,1,1157.6300309597523,114,532,87,34.373736498584925,0.6366045321637427,38.6322463768116,133820.2898550728,1173.862191711165,8
1843,512,0,0,646,0.0,0.0,1.0,646,15950,12000,3950,0.7523510971786834,199,120,79,162.28285043117737,0.43008835929312567,0.9090672976520324,0.11023942069878791,17506407.740610972,423047.9497913534,17929455.690402325,1842,2,1158.6300309597523,90,556,90,34.252115707302806,0.6440972222222222,38.49587912087911,133890.1098901094,1487.667887667882,0
1844,512,0,0,646,0.0,0.0,1.0,646,19650,14900,4750,0.7582697201017812,244,149,95,158.5678069886687,0.4299541103671171,0.9063831855444069,0.1081911122172745,17526163.631747175,406967.06640213565,17933130.698149312,1843,3,1159.6300309597523,96,550,96,34.19941514467471,0.6437717013888888,38.34836769759447,133965.63573883002,1395.4753722794794,0
1845,512,0,0,646,0.0,0.0,1.0,646,18700,14200,4500,0.7593582887700535,232,142,90,159.29992729418188,0.429952610379117,0.9061332071403203,0.10904516134501313,17540740.027777474,410947.7222222097,17951687.749999683,1844,4,1160.6300309597523,99,547,97,34.06974179898388,0.6440446127946128,38.239583333333286,134021.333333331,1353.750841750818,0
1846,512,0,0,646,0.0,0.0,1.0,646,18200,13200,5000,0.7252747252747253,232,132,100,159.75585515055297,0.42980311157510737,0.9066789817123619,0.10989420697328295,17562609.341125157,413745.93479329813,17976355.275918454,1845,5,1161.6300309597523,102,544,75,33.89207434006458,0.6449142156862745,38.07645631067957,134104.85436892972,1314.7534742051932,0
1847,512,1,0,647,0.0015455950540958269,0.0,1.0,647,17500,12100,5400,0.6914285714285714,229,121,108,156.82719610667579,0.4297187902249487,0.9052200433730955,0.10827061050605546,17578719.979843553,404464.2731166452,17983184.252960198,1846,0,1160.8330757341575,104,543,80,33.846792105196705,0.6456330128205128,37.956349206349174,134166.34920634737,1290.0610500610323,0
1848,512,0,0,647,0.0,0.0,1.0,647,17900,13300,4600,0.7430167597765364,225,133,92,159.68113735365617,0.42958969156685695,0.9066379828695534,0.11068155529899049,17596442.016731717,414663.9749218697,18011105.991653588,1847,1,1161.8330757341575,105,542,83,33.63784093606706,0.6467261904761905,37.82429245283016,134233.96226414928,1278.418688229993,0
1849,512,0,0,647,0.0,0.0,1.0,647,18350,13300,5050,0.7247956403269755,234,133,101,168.9173610883165,0.429856960680636,0.9100597091558467,0.1088466975780008,17265410.027777933,435535.50000000605,17700945.52777794,1848,2,1162.8330757341575,99,548,90,35.915334656986616,0.6232112794612794,40.30208333333336,132965.33333333454,1343.0841750841873,8
1850,512,1,1,647,0.0015432098765432098,0.0015432098765432098,0.9984567901234568,648,17450,12300,5150,0.7048710601719198,226,123,103,169.84603623996045,0.43014262169175876,0.9091612035636225,0.10985149702017039,17282583.7585539,440025.66947510093,17722609.428029,1849,0,1162.037037037037,105,543,69,35.75989662128085,0.623015873015873,40.17295597484277,133031.44654088083,1266.9661575321984,0
1851,512,2,0,649,0.0030816640986132513,0.0,1.0,649,17450,11500,5950,0.6590257879656161,234,115,119,176.19309311273503,0.4300431337860717,0.91176333027592,0.11481593869873798,17317279.16281927,462986.9959987665,17780266.158818036,1850,0,1161.2434514637905,113,536,74,35.329714727374885,0.6238938053097345,39.912280701754376,133164.91228070128,1178.4505511566485,0
1852,512,0,0,649,0.0,0.0,1.0,649,18750,13300,5450,0.7093333333333334,242,133,109,174.3017479802565,0.43001697768646924,0.9112972945443925,0.11396292810896992,17332632.770837825,455671.6378113793,17788304.408649202,1851,1,1162.2434514637905,116,533,81,35.26162492301374,0.6244612068965517,39.79700854700854,133223.93162393104,1148.4821691718194,0
1853,512,0,1,648,0.0,0.0015408320493066256,0.9984591679506933,649,16400,12100,4300,0.7378048780487805,207,121,86,177.84955041769163,0.43002242687388637,0.9145071520158163,0.11680471541318196,17353207.765072074,471052.0398645672,17824259.80493664,1852,2,1163.2434514637905,122,527,85,35.01217079226705,0.6249146174863388,39.64261517615174,133302.9810298091,1092.6473854902385,0
1854,512,0,0,648,0.0,0.0,1.0,648,16150,10800,5350,0.6687306501547987,215,108,107,178.19895232637134,0.42983090880035113,0.9151104192915045,0.11735606055397221,17365793.074667804,473163.2264444681,17838956.30111227,1853,3,1165.7067901234568,88,560,88,34.906997558381626,0.6341145833333333,39.548220973782755,133351.31086142248,1515.3558052434373,0
1855,512,0,0,648,0.0,0.0,1.0,648,19050,13500,5550,0.7086614173228346,246,135,111,174.43564445147453,0.42958737223398913,0.912202117506772,0.11540905723959581,17386893.87229717,457928.80752470886,17844822.67982188,1854,4,1166.7067901234568,96,552,96,34.844067633646496,0.6332465277777778,39.39003436426116,133432.302405498,1389.9198167239374,0
1856,512,0,0,648,0.0,0.0,1.0,648,18450,12300,6150,0.6666666666666666,246,123,123,171.9391436575495,0.42958374477646116,0.9107940212184336,0.11421349001445513,17405143.395527657,450475.0901327748,17855618.485660434,1855,5,1167.7067901234568,100,548,90,34.77004390475435,0.6335416666666667,39.253300330033,133502.31023102297,1335.0231023102297,0
1857,512,0,0,648,0.0,0.0,1.0,648,17400,12900,4500,0.7413793103448276,219,129,90,167.56378446158135,0.4294933564854568,0.9073719221377887,0.11180563319402483,17425471.060051788,436975.575369607,17862446.635421395,1856,6,1168.7067901234568,107,541,74,34.72935921133703,0.6333722741433021,39.101080246913575,133580.24691358,1248.4135225568223,0
1858,512,0,1,647,0.0,0.0015432098765432098,0.9984567901234568,648,20050,15100,4950,0.7531172069825436,250,151,99,166.06146090249632,0.4294133536550461,0.9074624332684316,0.11128888287567698,17445310.813717525,429748.75992481026,17875059.573642336,1857,7,1169.7067901234568,108,540,80,34.617608117342705,0.6346450617283951,38.952599388379205,133656.26911314993,1237.558047343981,0
1859,512,1,0,648,0.0015432098765432098,0.0,1.0,648,17250,11800,5450,0.6840579710144927,227,118,109,168.29869315284412,0.4292438072840142,0.9077074332557871,0.1132909994847671,17465434.02777781,441031.94444444514,17906465.972222254,1858,0,1170.6774691358025,115,533,84,34.40615653040874,0.6346920289855073,38.802083333333336,133733.33333333358,1162.8985507246398,0
1860,512,0,0,648,0.0,0.0,1.0,648,17800,13000,4800,0.7303370786516854,226,130,96,169.47111009981563,0.42924191901845177,0.9091297242333019,0.11467631815414592,17488942.667136658,445374.10565433477,17934316.772790994,1859,1,1171.6774691358025,122,526,90,34.196826836881286,0.635160519125683,38.62635501355013,133823.30623306203,1096.9123461726397,0
1861,512,0,1,647,0.0,0.0015432098765432098,0.9984567901234568,648,19950,14900,5050,0.7468671679197995,250,149,101,173.90068365504743,0.429227707335534,0.9125911908632356,0.11836077672992291,17515115.436849188,459628.1097530278,17974743.546602216,1860,2,1172.6774691358025,93,555,93,33.882145681522914,0.6438172043010753,38.43085106382978,133923.40425531866,1440.0366048958995,0
1862,512,0,0,647,0.0,0.0,1.0,647,17750,12800,4950,0.7211267605633803,227,128,99,175.50896287604309,0.42910679280253544,0.9113702011834128,0.11981148497843208,17528459.70932657,468130.3568796773,17996590.066206247,1861,3,1175.3493044822258,98,549,98,33.73870749393486,0.6433886054421769,38.331228956228934,133974.41077440965,1367.08582422867,0
1863,512,0,1,646,0.0,0.0015455950540958269,0.9984544049459042,647,17400,12600,4800,0.7241379310344828,222,126,96,176.07244123296644,0.42924267038630304,0.910876151509314,0.12068965517241378,17546790.12345658,471101.2345678934,18017891.35802447,1862,4,1176.3493044822258,101,546,89,33.584770114942536,0.643976897689769,38.194444444444414,134044.4444444428,1327.172717271711,0
1864,512,0,0,646,0.0,0.0,1.0,646,17650,12200,5450,0.6912181303116147,231,122,109,172.91248643707672,0.4290586175310598,0.9080951117258564,0.11900801909270863,17564989.003673013,460591.1845729994,18025580.18824601,1863,5,1176.8529411764705,109,537,71,33.529420182446984,0.6434441896024465,38.05871212121211,134113.93939393878,1230.4031137058603,0
1865,512,0,0,646,0.0,0.0,1.0,646,18950,14200,4750,0.7493403693931399,237,142,95,170.82213813091766,0.42908121735026117,0.9071567427460576,0.11802817980565614,17582327.917136654,452540.16962483356,18034868.08676149,1864,6,1177.8529411764705,113,533,77,33.45271404995173,0.6438974926253687,37.92945906432745,134180.11695906246,1187.4346633545351,0
1866,512,0,1,645,0.0,0.0015479876160990713,0.9984520123839009,646,18150,13300,4850,0.7327823691460055,230,133,97,168.20638071561055,0.4289176686586507,0.9060703869277171,0.11666300182583196,17599190.297067776,444709.2206790079,18043899.517746784,1865,7,1178.8529411764705,119,527,81,33.393512387573786,0.6439950980392157,37.80381944444443,134244.4444444435,1128.1045751633908,0
1867,512,0,1,644,0.0,0.0015503875968992248,0.9984496124031008,645,18950,13900,5050,0.7335092348284961,240,139,101,167.1935235938961,0.4288283218578972,0.9058542586006795,0.11634985010517887,17614041.814805087,441040.7431494939,18055082.55795458,1866,8,1181.5565891472868,123,522,86,33.30761275687214,0.6443936314363143,37.693212365591386,134301.07526881646,1091.878660722085,0
1868,512,0,2,642,0.0,0.003105590062111801,0.9968944099378882,644,19000,13900,5100,0.7315789473684211,241,139,102,166.62550265716325,0.428711695307645,0.9067094361888706,0.11652040657179709,17635555.83550282,439906.6711458218,18075462.50664864,1867,9,1184.302795031056,125,519,93,33.15970034857837,0.6456666666666666,37.53306878306877,134383.06878306795,1075.0645502645436,0
1869,512,0,0,642,0.0,0.0,1.0,642,18700,13600,5100,0.7272727272727273,238,136,102,164.7039950485312,0.4282722126642075,0.9055272060088304,0.11551958344625973,17648660.856626756,434260.990068616,18082921.84669537,1868,10,1188.4252336448599,96,546,96,33.111025903203824,0.6529947916666667,37.4355670103093,134432.98969072258,1400.3436426116934,0
1870,512,0,0,642,0.0,0.0,1.0,642,15950,10500,5450,0.658307210031348,214,105,109,164.69545725912295,0.4282785914240308,0.9042573432344745,0.11583810194668949,17661006.250000156,437387.5000000058,18098393.750000164,1869,11,1189.4252336448599,99,543,99,33.0179208804283,0.6530934343434344,37.34375000000002,134480.0000000012,1358.3838383838504,0
1871,512,0,1,641,0.0,0.001557632398753894,0.9984423676012462,642,17550,12700,4850,0.7236467236467237,224,127,97,163.70925129101494,0.4281679756286825,0.9043115400391186,0.11560281158672973,17678452.304669302,432875.2381562711,18111327.542825572,1870,12,1190.4252336448599,101,541,93,32.912003212601675,0.6538778877887789,37.21405228758172,134546.40522875937,1332.1426260273204,0
1872,512,0,0,641,0.0,0.0,1.0,641,18100,13500,4600,0.7458563535911602,227,135,92,163.00818027013534,0.4280432389170567,0.9036325467679398,0.1157165297575998,17701548.92227385,430799.45555653394,18132348.377830382,1871,13,1192.3369734789392,106,535,76,32.756022237853756,0.6543828616352201,37.04244548286607,134634.26791277406,1270.1346029506985,0
1873,512,0,0,641,0.0,0.0,1.0,641,17750,13000,4750,0.7323943661971831,225,130,95,160.3787207965835,0.4280474031461258,0.9019791956061805,0.11422094261610433,17715756.837919164,422296.083921766,18138052.921840932,1872,14,1193.3369734789392,110,531,80,32.71796518264841,0.6545454545454545,36.93693693693696,134688.28828828954,1224.4389844389957,0
1874,512,0,0,641,0.0,0.0,1.0,641,17150,11900,5250,0.6938775510204082,224,119,105,159.18051754616567,0.4280615208983359,0.9012335298040468,0.11383946103715381,17733853.31881011,419226.78987519804,18153080.108685307,1873,15,1194.3369734789392,117,524,84,32.613023366314465,0.6544693732193732,36.80261299435029,134757.06214689312,1151.7697619392575,0
1875,512,0,0,641,0.0,0.0,1.0,641,18650,14000,4650,0.7506702412868632,233,140,93,158.4920864200693,0.42793486739469583,0.9017118191699582,0.1137175188697561,17748033.757353246,415734.58001135004,18163768.337364595,1874,16,1195.3369734789392,121,520,87,32.52426659748799,0.6547865013774105,36.69740437158471,134810.92896174928,1114.1399087747875,0
1876,512,0,0,641,0.0,0.0,1.0,641,19400,14300,5100,0.7371134020618557,245,143,102,160.57965463308756,0.4277069520280811,0.903633975867508,0.1155390197969776,17760204.08163264,422785.48752834374,18182989.569160983,1875,17,1196.3369734789392,125,516,89,32.3775894538606,0.655,36.607142857142854,134857.14285714275,1078.857142857142,0
1877,512,0,0,641,0.0,0.0,1.0,641,16950,11700,5250,0.6902654867256637,222,117,105,162.83272752093,0.42752646824622986,0.9059781457558818,0.11752969052191382,17773840.701461338,433682.5919882946,18207523.293449633,1876,18,1197.3369734789392,130,511,90,32.21549929082297,0.6552083333333334,36.50604325699746,134908.90585241743,1037.7608142493648,0
1878,512,1,0,642,0.001557632398753894,0.0,1.0,642,18000,13100,4900,0.7277777777777777,229,131,98,161.0637779127193,0.42738743817665475,0.9049499097244451,0.11681763106455448,17794770.99349321,426818.608660738,18221589.60215395,1877,0,1196.4704049844236,96,546,96,32.10451373331702,0.6639539930555556,36.35094501718213,134988.31615120263,1406.128293241694,0
1879,512,0,0,642,0.0,0.0,1.0,642,19600,14200,5400,0.7244897959183674,250,142,108,156.19441487983133,0.4272944905335154,0.901185903304947,0.11388363014296489,17817425.04252213,408596.4558364018,18226021.49835853,1878,1,1197.4704049844236,105,537,105,32.06250465618716,0.6632936507936508,36.18317610062894,135074.21383647856,1286.4210841569386,0
1880,512,1,0,643,0.0015552099533437014,0.0,1.0,643,17700,13300,4400,0.751412429378531,221,133,88,153.82636006122658,0.4271179036480413,0.8991826763101987,0.11270326441310642,17838273.336240258,402499.33141821553,18240772.667658474,1879,0,1196.6065318818041,113,530,75,31.96830252575955,0.6630715339233038,36.028874269005854,135153.2163742694,1196.046162604154,0
1881,512,0,0,643,0.0,0.0,1.0,643,17700,12700,5000,0.7175141242937854,227,127,100,153.07022803870262,0.42679097445289066,0.8984220781695094,0.11259901677486711,17855399.33049243,400326.0094481128,18255725.33994054,1880,1,1197.6065318818041,117,526,81,31.85963805417209,0.6635505698005698,35.90218926553671,135218.07909604456,1155.7100777439705,0
1882,512,1,0,644,0.0015527950310559005,0.0,1.0,644,17550,13100,4450,0.7464387464387464,220,131,89,153.1319661330843,0.4266194670105516,0.8996269973468536,0.1132114362336503,17876822.621405665,401152.59924565046,18277975.220651314,1881,0,1196.745341614907,120,524,87,31.69719453131787,0.6645833333333333,35.743801652892564,135299.17355371919,1127.49311294766,0
1883,512,0,0,644,0.0,0.0,1.0,644,19250,13700,5550,0.7116883116883117,248,137,111,154.9770001987731,0.4264110793414668,0.9009544471689446,0.11497872671435666,17891772.017777834,406512.631111113,18298284.648888946,1882,1,1197.745341614907,124,520,90,31.536258038078437,0.664986559139785,35.63333333333334,135355.73333333374,1091.5784946236593,0
1884,512,0,0,644,0.0,0.0,1.0,644,17750,12500,5250,0.704225352112676,230,125,105,155.56913398058362,0.42642083965238003,0.9025381108705035,0.11582986690761717,17906893.43255289,410601.98071697366,18317495.413269863,1883,2,1198.745341614907,128,516,93,31.407173897556458,0.6654459635416667,35.521640826873394,135412.9198966415,1057.9134366925118,0
1885,512,0,0,644,0.0,0.0,1.0,644,19950,14800,5150,0.7418546365914787,251,148,103,164.06619959030712,0.4263866282533028,0.9128813126214028,0.12034653910858348,17843290.684075765,436746.17814428033,18280036.862220045,1884,3,1199.745341614907,95,549,66,31.660270505390923,0.6678728070175439,35.991753472222186,135172.22222222039,1422.865497076004,8
1886,512,0,0,644,0.0,0.0,1.0,644,18850,13100,5750,0.6949602122015915,246,131,115,158.77409660628226,0.4261932332267548,0.9096253932281833,0.11708655271472353,17866052.93524807,419683.28294280206,18285736.21819087,1885,4,1200.745341614907,104,540,72,31.62897279907869,0.667167467948718,35.82341269841268,135258.41269841188,1300.5616605616526,0
1887,512,0,1,643,0.0,0.0015527950310559005,0.9984472049689441,644,17950,12600,5350,0.7019498607242339,233,126,107,160.50425643070673,0.42608058716420505,0.9103253074989144,0.11878374992975724,17881196.254103664,427251.6217712829,18308447.875874948,1886,5,1201.745341614907,105,539,77,31.46953471654145,0.6680555555555556,35.711477987421354,135315.72327043867,1288.7211740041778,0
1888,512,0,0,643,0.0,0.0,1.0,643,18600,13400,5200,0.7204301075268817,238,134,104,158.52670288554552,0.4258090765799593,0.908874435108993,0.11784746721002581,17900257.27788273,420333.7534131453,18320591.031295873,1887,6,1204.51632970451,114,529,83,31.37874090820858,0.6674890350877193,35.57065217391303,135387.826086956,1187.6125095347018,0
1889,512,0,1,642,0.0,0.0015552099533437014,0.9984447900466563,643,18600,12600,6000,0.6774193548387096,246,126,120,160.43003801098027,0.42542966106758784,0.9101435598317134,0.11967861458003129,17915029.251717404,427621.76476416487,18342651.016481567,1888,7,1205.51632970451,115,528,86,31.217574991230705,0.6683876811594203,35.461566091954005,135443.67816091856,1177.77111444277,0
1890,512,0,1,641,0.0,0.001557632398753894,0.9984423676012462,642,19400,14300,5100,0.7371134020618557,245,143,102,162.13641244836913,0.4250121095186487,0.9106767815697299,0.12135021507796961,17928951.47462283,433587.1742112504,18362538.64883408,1889,8,1208.1978193146417,89,553,89,31.067998760842613,0.6761470037453183,35.358796296296305,135496.29629629676,1522.4302954640086,0
1891,512,0,0,641,0.0,0.0,1.0,641,15550,10600,4950,0.6816720257234726,205,106,99,159.62551788602005,0.42492748147425896,0.9090474510069513,0.11976474570533988,17939323.621227924,428964.764712685,18368288.385940608,1890,9,1210.8798751950078,92,549,92,31.05668739950919,0.6759510869565217,35.282258064516135,135535.48387096802,1473.211781206174,0
1892,512,0,0,641,0.0,0.0,1.0,641,16650,11800,4850,0.7087087087087087,215,118,97,156.34325792757815,0.424716223023921,0.9072696479056053,0.11784994234492015,17958954.665155116,416702.29626480525,18375656.96141992,1891,10,1211.8798751950078,96,545,91,30.99650975781164,0.6762152777777778,35.13745704467354,135609.62199312716,1412.6002290950746,0
1893,512,0,1,640,0.0,0.0015600624024961,0.9984399375975039,641,18350,14000,4350,0.7629427792915532,227,140,87,155.6005389937775,0.4244332585803432,0.906554325986269,0.11803228607261147,17985437.15757712,413158.7431515417,18398595.90072866,1892,11,1212.8798751950078,100,541,72,30.817931258106356,0.6770833333333333,34.94224422442244,135709.57095709554,1357.0957095709555,0
1894,512,0,0,640,0.0,0.0,1.0,640,19850,14500,5350,0.7304785894206549,252,145,107,167.49421280755246,0.42417870940923313,0.9113565213203192,0.11419526628017494,17522776.04347315,439142.7159209123,17961918.759394065,1893,14,1215.7578125,92,548,92,33.99156605873788,0.6447010869565217,38.37365591397848,133952.68817204237,1456.0074801308954,8
1895,512,1,1,640,0.0015600624024961,0.0015600624024961,0.9984399375975039,641,18200,13800,4400,0.7582417582417582,226,138,88,162.79839207167487,0.42434286433957363,0.9086850287242467,0.11155568144134718,17545379.751499165,424871.9223661932,17970251.67386536,1894,0,1214.8595943837754,98,543,88,33.942985276583165,0.6446641156462585,38.20496632996631,134039.05723905633,1367.745482031187,0
1896,512,1,0,641,0.0015600624024961,0.0,1.0,641,17000,12200,4800,0.7176470588235294,218,122,96,160.4504677748996,0.42406772052132086,0.9063589098057232,0.11035717339067763,17562009.47156449,418366.5269559387,17980375.99852043,1895,0,1215.6801872074882,103,538,73,33.87842574888462,0.6446197411003236,38.080929487179446,134102.56410256203,1301.9666417724468,0
1897,512,0,1,640,0.0,0.0015600624024961,0.9984399375975039,641,17700,12200,5500,0.6892655367231638,232,122,110,160.60627574056787,0.42401724193967755,0.9064709471847716,0.11098074110162637,17582773.760330245,418880.7621671132,18001654.52249736,1896,1,1216.6801872074882,109,532,77,33.717065642878616,0.6447821100917431,37.92613636363632,134181.81818181562,1231.0258548790423,0
1898,512,1,1,640,0.0015600624024961,0.0015600624024961,0.9984399375975039,641,18500,13800,4700,0.745945945945946,232,138,94,160.69863519626642,0.4240869166016641,0.9067049626991024,0.11143273654716285,17598270.322492104,418903.6045278788,18017173.927019984,1897,0,1214.7207488299532,113,528,80,33.59732580562716,0.6450958702064897,37.810672514619846,134240.93567251242,1187.972882057632,0
1899,512,1,0,641,0.0015600624024961,0.0,1.0,641,18900,13400,5500,0.708994708994709,244,134,110,161.3788732021772,0.4241604507930317,0.9080285216064268,0.11234984852197145,17615870.326330774,421465.86074777547,18037336.18707855,1898,0,1215.5179407176288,115,526,84,33.44630060705639,0.6460144927536232,37.67959770114938,134308.04597700908,1167.896051973992,0
1900,512,0,0,641,0.0,0.0,1.0,641,17350,11800,5550,0.6801152737752162,229,118,111,161.53041790736756,0.4241437938767551,0.9088884274978026,0.11292434651022344,17634262.7616529,424143.96667561936,18058406.728328522,1899,1,1216.5179407176288,121,520,88,33.3032073804179,0.6462637741046833,37.54269125683058,134378.1420765014,1110.5631576570363,0
1901,512,0,1,640,0.0,0.0015600624024961,0.9984399375975039,641,18250,13400,4850,0.7342465753424657,231,134,97,161.52398388737612,0.4238898774700988,0.9081139200483472,0.11363603624147227,17662112.188365832,424120.9449061322,18086233.133271962,1900,2,1217.5179407176288,94,547,94,33.09286509427395,0.6545877659574468,37.3355263157895,134484.21052631718,1430.6830907055019,0
1902,512,1,0,641,0.0015600624024961,0.0,1.0,641,18150,13700,4450,0.7548209366391184,226,137,89,160.8718347956675,0.4239466531786271,0.9078149762457091,0.11363986409966048,17680022.67573712,422493.5374149726,18102516.213152092,1901,0,1218.4836193447738,97,544,93,32.9747074367686,0.6550687285223368,37.20238095238098,134552.38095238217,1387.1379479627028,0
1903,512,0,0,641,0.0,0.0,1.0,641,16400,11600,4800,0.7073170731707317,212,116,96,157.87979582663039,0.4238587981019241,0.9054035728732575,0.1121095963425066,17702859.63839642,414384.77305150626,18117244.411447927,1902,1,1219.4836193447738,106,535,73,32.88098807937218,0.6544811320754718,37.03271028037384,134639.25233644902,1270.1816258155568,0
1904,512,0,0,641,0.0,0.0,1.0,641,17000,12000,5000,0.7058823529411765,220,120,100,137.50353890523985,0.42375956757020283,0.891459966548342,0.09502421873518412,17583135.332437288,338348.66665197635,17921483.999089263,1903,2,1220.4836193447738,122,519,86,34.31979631185503,0.6422472677595629,37.92344173441734,134183.19783197794,1099.8622773112945,8
1905,512,0,0,641,0.0,0.0,1.0,641,17700,12500,5200,0.7062146892655368,229,125,104,140.24621018472305,0.4237647474648986,0.8926229451335173,0.09711873943540847,17592254.573640037,347549.4065115716,17939803.98015161,1904,3,1221.4836193447738,125,516,88,34.17901200500383,0.6424166666666666,37.8554894179894,134217.98941798852,1073.7439153439082,0
1906,512,0,0,641,0.0,0.0,1.0,641,18650,13300,5350,0.7131367292225201,240,133,107,139.78057245703693,0.4235156046866875,0.8924579546320446,0.09716296356902823,17609021.246495374,345429.8140486434,17954451.060544018,1905,4,1222.4836193447738,130,511,94,34.06458124892618,0.6428685897435897,37.730597964376564,134281.9338422374,1032.9379526325954,0
1907,512,0,1,640,0.0,0.0015600624024961,0.9984399375975039,641,17700,12900,4800,0.7288135593220338,225,129,96,140.25525300662477,0.4232423906331253,0.8925404668120418,0.09763923382384182,17615660.575509198,348237.7861793694,17963898.36168857,1906,5,1223.4836193447738,137,504,95,34.001999884898694,0.6423357664233577,37.68115942028984,134307.24637681045,980.3448640643098,0
1908,512,0,0,640,0.0,0.0,1.0,640,17250,12100,5150,0.7014492753623188,224,121,103,140.82319722320315,0.4232197219776996,0.8942588387367252,0.09848815474288851,17636056.55844286,351463.17419382936,17987519.73263669,1907,6,1225.890625,141,499,103,33.8331470095025,0.6433215130023641,37.52934272300468,134384.97652582062,953.084939899437,0
1909,512,0,0,640,0.0,0.0,1.0,640,18800,14300,4500,0.7606382978723404,233,143,90,138.86943825423262,0.4229600694444444,0.893103377038343,0.09755255585103859,17655558.984910887,343563.5116598102,17999122.496570695,1908,7,1226.890625,107,533,107,33.737329219920696,0.6507009345794392,37.38425925925927,134459.25925925962,1256.6285912080339,0
1910,512,0,0,640,0.0,0.0,1.0,640,18100,12800,5300,0.7071823204419889,234,128,106,139.38969492604198,0.42275630053468966,0.8923702304261625,0.09835258893732626,17675017.361111145,346643.0555555564,18021660.4166667,1909,8,1227.890625,111,529,111,33.57697390155266,0.6512762762762763,37.239583333333336,134533.33333333358,1212.012012012014,0
1911,512,2,0,642,0.003115264797507788,0.0,1.0,642,18850,13600,5250,0.7214854111405835,241,136,105,139.4609003625242,0.42302461958291415,0.8920996101502676,0.09875612958907945,17690726.070154633,346182.9171621101,18036908.987316743,1910,0,1225.0623052959502,115,527,106,33.45673635307783,0.6516304347826087,37.12284482758621,134593.1034482763,1170.3748125937068,0
1912,512,0,1,641,0.0,0.001557632398753894,0.9984423676012462,642,18400,13300,5100,0.7228260869565217,235,133,102,138.49128754288566,0.4230141401917759,0.8913697113278922,0.09841438085484508,17706078.025278732,343627.50861112383,18049705.533889856,1911,1,1226.0623052959502,122,520,79,33.36660870311928,0.6514685792349727,37.00880758807586,134651.49051490388,1103.7007419254417,0
1913,512,1,1,641,0.001557632398753894,0.001557632398753894,0.9984423676012462,642,18950,13400,5550,0.7071240105540897,245,134,111,136.55410967532023,0.4227328166335376,0.8896687404892958,0.09752987567665262,17728140.129196033,336820.0783083367,18064960.20750437,1912,0,1227.0591900311526,131,511,85,33.251523125518574,0.6516380407124682,36.84501262626263,134735.3535353538,1028.514149124838,0
1914,512,0,0,641,0.0,0.0,1.0,641,18050,13200,4850,0.7313019390581718,229,132,97,144.32758503790754,0.4226949468603744,0.8928481427617083,0.09901891116553624,17550802.698506985,360362.99379045854,17911165.692297444,1913,1,1228.5429017160686,115,526,101,34.385503120927375,0.6411231884057971,38.164511494252864,134059.77011494187,1165.7371314342772,8
1915,512,0,0,641,0.0,0.0,1.0,641,17100,12200,4900,0.7134502923976608,220,122,98,144.5101484102752,0.4227922476274051,0.8936060219100217,0.09959904298789053,17571214.72722388,362543.7695959876,17933758.49681987,1914,2,1229.5429017160686,121,520,81,34.22630687003002,0.6415289256198347,38.01229508196722,134137.70491803292,1108.5760737027515,0
1916,512,0,0,641,0.0,0.0,1.0,641,19800,14300,5500,0.7222222222222222,253,143,110,152.6907264834372,0.42276736381955277,0.9021277306239244,0.10497060458246044,17559909.297520485,388247.0615243276,17948156.359044813,1915,3,1230.5429017160686,109,532,73,34.09756872883297,0.6430619266055047,38.096590909090885,134094.5454545441,1230.225187656368,8
1917,512,0,0,641,0.0,0.0,1.0,641,20750,15500,5250,0.7469879518072289,260,155,105,157.47441273211953,0.4226193813377535,0.904255235856644,0.10885350034002085,17584281.356730174,404864.87599348836,17989146.23272366,1916,4,1231.5429017160686,117,524,75,33.787731426903335,0.6432514245014245,37.9149011299435,134187.57062146883,1146.902313004007,0
1918,512,0,0,641,0.0,0.0,1.0,641,17900,13100,4800,0.7318435754189944,227,131,96,155.000492141274,0.4224718051222049,0.9025287154510808,0.10749221121667162,17598712.711636573,399461.8262713105,17998174.537907884,1917,5,1232.5429017160686,121,520,82,33.743378489861456,0.643595041322314,37.80737704918032,134242.62295081903,1109.443164882802,0
1919,512,1,0,642,0.001557632398753894,0.0,1.0,642,18800,14100,4700,0.75,235,141,94,155.1252795626851,0.422614455201261,0.9034286371088183,0.1078965605655084,17611785.484593425,399206.6293791137,18010992.113972537,1918,0,1231.6214953271028,123,519,85,33.641232691712325,0.6442242547425474,37.710013440860195,134292.47311827826,1091.8087245388476,0
1920,512,0,0,642,0.0,0.0,1.0,642,17400,13100,4300,0.7528735632183908,217,131,86,161.1330650887591,0.4225941039199201,0.9073842319674099,0.11257146636682325,17631318.89776905,422397.6911109718,18053716.58888002,1919,1,1232.6214953271028,128,514,87,33.335897435897365,0.6448567708333333,37.56459948320411,134366.9250645981,1049.7416020671726,0
1921,512,1,0,643,0.0015552099533437014,0.0,1.0,643,18850,13900,4950,0.7374005305039788,238,139,99,163.58829952109323,0.42249577687016826,0.9098951588938686,0.11499295172218149,17658466.368796237,430293.6970843649,18088760.0658806,1920,0,1231.7029548989115,90,553,90,33.06619740818224,0.6555555555555556,37.36263736263739,134470.32967033118,1494.1147741147909,0
1922,512,0,0,643,0.0,0.0,1.0,643,18750,13100,5650,0.6986666666666667,244,131,113,160.12704016198052,0.42226281836988805,0.9074331994077098,0.11308712264946208,17678990.594112195,418826.88737734145,18097817.481489535,1921,1,1232.7029548989115,96,547,89,33.00207388337217,0.6552734375,37.21005154639178,134548.4536082488,1401.5463917525915,0
1923,512,0,0,643,0.0,0.0,1.0,643,18700,13400,5300,0.7165775401069518,240,134,106,162.23791001032674,0.42199483534638543,0.908133901179472,0.11504676049772788,17696877.457548,426920.882484299,18123798.340032298,1922,2,1233.7029548989115,100,543,71,32.81153976908697,0.6555208333333333,37.077145214521494,134616.50165016705,1346.1650165016704,0
1924,512,0,0,643,0.0,0.0,1.0,643,18800,13700,5100,0.7287234042553191,239,137,102,162.75678347023597,0.42176823576530703,0.9073834271207675,0.11610262461413445,17722824.265381217,429501.97428834304,18152326.23966956,1923,3,1234.7029548989115,109,534,75,32.60208595765106,0.6552943425076452,36.88446969696972,134715.15151515257,1235.9188212399317,0
1925,512,0,0,643,0.0,0.0,1.0,643,17250,12500,4750,0.7246376811594203,220,125,95,163.73766648364614,0.42156414473949827,0.9082520813064694,0.11718480052261053,17737056.213017914,434994.83892176766,18172051.05193968,1924,4,1235.7029548989115,116,527,76,32.468924403855915,0.6549030172413793,36.778846153846175,134769.23076923203,1161.8037135278623,0
1926,512,0,0,643,0.0,0.0,1.0,643,19950,14500,5450,0.7268170426065163,254,145,109,164.1991998561836,0.4215918009912647,0.909591424935301,0.11800560475913505,17755146.64624978,434526.174528687,18189672.820778467,1925,5,1236.7029548989115,122,521,78,32.3203738838688,0.6551400273224044,36.64464769647698,134837.9403794047,1105.2290195033172,0
1927,512,0,0,643,0.0,0.0,1.0,643,16900,12500,4400,0.7396449704142012,213,125,88,166.73539542155117,0.4214572543357735,0.9120295367388265,0.12018982311248805,17768200.83618152,447017.59847004793,18215218.43465157,1926,6,1237.7029548989115,127,516,81,32.15517174806162,0.6552657480314961,36.547851562499986,134887.4999999991,1062.1062992125912,0
1928,512,0,0,643,0.0,0.0,1.0,643,18400,12500,5900,0.6793478260869565,243,125,118,166.69364322015625,0.42124579503850884,0.9130577600402525,0.1205868908401124,17783546.661859155,445880.8364881865,18229427.498347342,1927,7,1238.7029548989115,85,558,85,32.04063265931373,0.6666666666666667,36.43410852713176,134945.73643410768,1587.5968992247963,0
1929,512,0,0,643,0.0,0.0,1.0,643,19850,14800,5050,0.7455919395465995,249,148,101,166.88034924442323,0.42098941956593006,0.9126359614493551,0.12150808815592255,17811526.063099988,446028.7379972499,18257554.801097237,1928,8,1239.7029548989115,89,554,89,31.824996343425447,0.6673689138576779,36.226851851851826,135051.85185185072,1517.436537661244,0
1930,512,0,0,643,0.0,0.0,1.0,643,20850,15700,5150,0.7529976019184652,260,157,103,168.76197648440677,0.4208169212656793,0.9127277888966765,0.12351077944530629,17833580.824869044,452476.0695598584,18286056.8944289,1929,9,1240.7029548989115,94,549,83,31.60935357899547,0.6674423758865249,36.06359649122805,135135.4385964901,1437.6110488988309,0
1931,512,1,1,643,0.0015527950310559005,0.0015527950310559005,0.9984472049689441,644,16950,11600,5350,0.6843657817109144,223,116,107,167.76945442167494,0.42074411201697526,0.9124357030013466,0.12315239968798652,17846400.249999914,453066.1666666626,18299466.41666658,1930,0,1239.774844720497,99,545,70,31.539112123722703,0.6669823232323233,35.968749999999986,135183.99999999936,1365.494949494943,0
1932,512,0,0,643,0.0,0.0,1.0,643,18600,13000,5600,0.6989247311827957,242,130,112,166.2985591041258,0.42049241451593883,0.9110308940105412,0.12257393932761179,17863913.63573433,446948.61951663246,18310862.255250964,1931,11,1242.7029548989115,105,538,75,31.44627401014348,0.666765873015873,35.839229559748425,135250.3144654087,1288.0982330038923,0
1933,512,0,0,643,0.0,0.0,1.0,643,18850,13600,5250,0.7214854111405835,241,136,105,168.75575225211966,0.4204366982715044,0.9120315211016028,0.12468264802316827,17874104.93827164,455821.60493827244,18329926.543209914,1932,12,1243.7029548989115,110,533,75,31.30475251861586,0.6663825757575758,35.76388888888889,135288.88888888917,1229.8989898989923,0
1934,512,0,0,643,0.0,0.0,1.0,643,18550,13900,4650,0.7493261455525606,232,139,93,167.06972290503595,0.42030427125574726,0.9115024624201997,0.123840379058615,17887995.988237813,450558.5066162586,18338554.49485407,1933,13,1244.7029548989115,114,529,79,31.244931409839097,0.6665752923976609,35.661231884057976,135341.44927536268,1187.2056953979184,0
1935,512,0,1,642,0.0,0.0015552099533437014,0.9984447900466563,643,20550,14900,5650,0.7250608272506083,262,149,113,168.64494348606937,0.42016568719123915,0.913314636255921,0.12557222379493566,17907119.35280689,454839.02625048655,18361958.379057374,1934,14,1245.7029548989115,120,523,82,31.059650521884425,0.6668402777777778,35.51997245179064,135413.77410468383,1128.448117539032,0
1936,512,0,0,642,0.0,0.0,1.0,642,17800,13600,4200,0.7640449438202247,220,136,84,168.9601016587968,0.419718953867189,0.9142724287930419,0.1264169318504648,17927599.565479096,459609.80901631026,18387209.374495406,1935,15,1248.4454828660437,86,556,86,30.897562060748626,0.6770833333333333,35.36877394636016,135491.18773946376,1575.4789272030669,0
1937,512,0,1,641,0.0,0.001557632398753894,0.9984423676012462,642,18500,13300,5200,0.7189189189189189,237,133,104,171.2784445195011,0.41942694841750056,0.9153762133566012,0.12877475075987618,17948075.05365485,467923.67546185304,18415998.729116704,1936,16,1249.4454828660437,88,554,88,30.68254652344958,0.6779119318181819,35.217696629213485,135568.53932584275,1540.551583248213,0
1938,512,0,0,641,0.0,0.0,1.0,641,18550,13500,5050,0.7277628032345014,236,135,101,165.02308892282778,0.41909522474648986,0.9117431807014538,0.1249113417871068,17976434.38315555,446555.3459453692,18422989.72910092,1937,17,1252.3541341653665,96,545,85,30.635620981250323,0.6775173611111112,35.00859106529209,135675.60137457002,1413.2875143184376,0
1939,512,0,0,641,0.0,0.0,1.0,641,18200,13400,4800,0.7362637362637363,230,134,96,160.66309050094753,0.4189394216393656,0.9089439063943885,0.1222722973493538,17999142.95792382,431959.58679767844,18431102.544721495,1938,18,1253.3541341653665,104,537,71,30.581147735209015,0.6770833333333333,34.84126984126983,135761.26984126912,1305.3968253968185,0
1940,512,0,0,641,0.0,0.0,1.0,641,16700,11600,5100,0.6946107784431138,218,116,102,161.00206905811677,0.41857581334503385,0.9094716226742241,0.12288975579148569,18011378.815157574,435073.85116597445,18446452.666323546,1939,19,1254.3541341653665,107,534,72,30.48059616013963,0.6772780373831775,34.75115740740738,135807.40740740608,1269.2281066112716,0
1941,512,0,1,640,0.0,0.0015600624024961,0.9984399375975039,641,18250,13500,4750,0.7397260273972602,230,135,95,163.06889588365826,0.4183078807527301,0.9112240186497882,0.12512861918115012,18033451.859156787,441689.01672875317,18475140.87588554,1940,20,1255.3541341653665,116,525,75,30.26064204488273,0.6769935344827587,34.58867521367519,135890.59829059677,1171.4706749189377,0
1942,512,0,0,640,0.0,0.0,1.0,640,19200,14900,4300,0.7760416666666666,235,149,86,153.02647495261544,0.4181221879890454,0.9043353873239444,0.1107312049512609,17784763.876314,397107.9447713871,18181871.821085386,1941,21,1258.175,93,547,93,32.39169469553638,0.6640905017921147,36.42508865248226,134950.35460992856,1451.0790818271887,8
1943,512,0,0,640,0.0,0.0,1.0,640,18600,12600,6000,0.6774193548387096,246,126,120,149.17680511271263,0.41794704861111115,0.9015315791573562,0.10843873095548243,17804421.77102112,384601.3513360316,18189023.122357152,1942,22,1259.175,98,542,98,32.34536253856788,0.6641156462585034,36.27946127946128,135024.91582491598,1377.8052635195509,0
1944,512,0,0,640,0.0,0.0,1.0,640,18000,13400,4600,0.7444444444444445,226,134,92,148.93537549716638,0.41795041079812206,0.901777827718284,0.108813835450328,17826231.524142455,384991.29714951443,18211222.82129197,1943,23,1260.175,100,540,95,32.18785012637118,0.6652083333333334,36.11798679867986,135107.59075907545,1351.0759075907545,0
1945,512,0,0,640,0.0,0.0,1.0,640,18100,13400,4700,0.7403314917127072,228,134,94,148.07255603035412,0.4177464381194575,0.9013794706589531,0.10881820255151727,17851295.64121941,382557.3948097742,18233853.036029186,1944,24,1261.175,104,536,78,32.02242530117463,0.6660657051282051,35.93253968253968,135202.53968253938,1300.0244200244172,0
1946,512,0,0,640,0.0,0.0,1.0,640,16550,11200,5350,0.676737160120846,219,112,107,147.72645866228038,0.4175543349797861,0.9009930334466927,0.1088591587279148,17862901.574876733,383214.6382178809,18246116.213094614,1945,25,1262.175,108,532,80,31.944469568153597,0.665991512345679,35.84671253822629,135246.48318042772,1252.2822516706271,0
1947,512,0,0,640,0.0,0.0,1.0,640,17150,11700,5450,0.6822157434402333,226,117,109,146.9216596473351,0.41733849276212837,0.9005170934530105,0.10852949429487206,17873266.10331627,380043.9838435353,18253310.087159805,1946,26,1263.175,111,529,82,31.887979584653273,0.6661036036036037,35.77008928571428,135285.71428571385,1218.7902187902148,0
1948,512,0,0,640,0.0,0.0,1.0,640,19850,15500,4350,0.7808564231738035,242,155,87,147.50524279300612,0.41742361722417837,0.9015302309782613,0.1094393736851332,17891927.599418607,379980.6249174239,18271908.22433603,1947,27,1264.175,115,525,85,31.732620018115938,0.6666666666666667,35.63218390804597,135356.3218390799,1177.0114942528687,0
1949,512,0,0,640,0.0,0.0,1.0,640,16600,11800,4800,0.7108433734939759,214,118,96,146.59019879573424,0.41719814692553464,0.9011521855645552,0.10918837021726258,17908595.375910502,380444.9112614171,18289040.28717192,1948,28,1265.175,123,517,89,31.631894817638006,0.6664126016260163,35.50907258064516,135419.35483870964,1100.9703645423547,0
1950,512,0,0,640,0.0,0.0,1.0,640,17650,12500,5150,0.7082152974504249,228,125,103,146.5093161262967,0.41700273254107983,0.9010540115230059,0.10952716686253344,17924051.04648902,379558.09220678284,18303609.138695803,1949,29,1266.175,95,545,95,31.518255009705033,0.6739035087719298,35.39496527777775,135477.7777777764,1426.0818713450149,0
1951,512,0,0,640,0.0,0.0,1.0,640,17750,12000,5750,0.676056338028169,235,120,115,145.2859145691603,0.41674521958137717,0.8994695073248669,0.10896868157019347,17937880.708862722,375474.280843916,18313354.98970664,1950,30,1267.175,100,540,100,31.44708304111791,0.6735416666666667,35.29290429042901,135530.03300329848,1355.3003300329847,0
1952,512,0,1,639,0.0,0.0015625,0.9984375,640,18000,13300,4700,0.7388888888888889,227,133,94,142.69706049276493,0.41665367639866985,0.8979489306784665,0.10749845223788146,17956406.249999758,366465.2777777681,18322871.527777527,1951,31,1268.175,103,537,103,31.377007538511933,0.6741504854368932,35.156249999999964,135599.99999999814,1316.504854368914,0
1953,512,0,0,639,0.0,0.0,1.0,639,17400,12900,4500,0.7413793103448276,219,129,90,144.71691040115752,0.4163849928784363,0.8988600826376971,0.10952263510994004,17975733.381788455,375078.51944146823,18350811.90122992,1952,32,1271.0985915492959,105,534,93,31.178958835527506,0.6750992063492063,35.013757861635185,135672.95597484094,1292.1233902365805,0
1954,512,0,0,639,0.0,0.0,1.0,639,17950,12800,5150,0.713091922005571,231,128,103,145.40819583959714,0.41620644276666613,0.8991054575442974,0.11055092435038344,17994920.68645198,377571.79025871813,18372492.476710696,1953,33,1272.0985915492959,110,529,78,31.017199372315808,0.6753787878787878,34.87237237237234,135745.34534534352,1234.0485940485776,0
1955,512,0,0,639,0.0,0.0,1.0,639,17900,12900,5000,0.7206703910614525,229,129,100,143.90632296515298,0.4158303326285357,0.8978964113719292,0.10970906924245626,18006365.520543996,372545.9704055899,18378911.490949586,1954,34,1273.0985915492959,115,524,81,30.971507415182465,0.6751811594202899,34.788074712643635,135788.5057471239,1180.769615192382,0
1956,512,0,1,638,0.0,0.001564945226917058,0.9984350547730829,639,17500,12400,5100,0.7085714285714285,226,124,102,145.39896095517898,0.41559362853073395,0.8985544821310889,0.11125114142598162,18021545.27999725,378762.791703652,18400308.0717009,1955,35,1274.0985915492959,120,519,84,30.818529634436437,0.6753472222222222,34.67630853994486,135845.73002754574,1132.0477502295478,0
1957,512,0,0,638,0.0,0.0,1.0,638,18850,13800,5050,0.7320954907161804,239,138,101,144.24489656707368,0.4154573361777795,0.8975114978244974,0.11089825055183682,18041477.47463622,374028.21044920996,18415505.68508543,1956,36,1276.782131661442,127,511,91,30.70034767991988,0.6756069553805775,34.5296223958333,135920.8333333312,1070.242782152214,0
1958,512,0,0,638,0.0,0.0,1.0,638,19250,14700,4550,0.7636363636363637,238,147,91,150.8091202098639,0.4150821981794888,0.8988289795912312,0.11470350549501272,17996611.92033274,395960.64209274005,18392572.56242548,1957,37,1277.782131661442,115,523,79,30.861359479780525,0.6744565217391305,34.85991379310342,135751.72413792956,1180.4497751124309,8
1959,512,0,0,638,0.0,0.0,1.0,638,18450,13600,4850,0.7371273712737128,233,136,97,153.4380144385779,0.41495634906964957,0.9010298531509435,0.11734628163056585,18019561.068559665,406927.13428289385,18426488.20284256,1958,38,1278.782131661442,121,517,83,30.620065383666436,0.675017217630854,34.69091530054643,135838.251366119,1122.6301765794958,0
1960,512,0,0,638,0.0,0.0,1.0,638,18350,13400,4950,0.7302452316076294,233,134,99,153.73305284019793,0.414877763861754,0.9017392650496925,0.1179665130864572,18033509.017573357,408519.2789385505,18442028.296511907,1959,39,1279.782131661442,126,512,85,30.507998805072244,0.6751818783068784,34.588254593175826,135890.81364829218,1078.498521018192,0
1961,512,1,0,639,0.001564945226917058,0.0,1.0,639,16750,11800,4950,0.7044776119402985,217,118,99,154.67346182133952,0.41478325426844126,0.9040550099686486,0.11920886816347993,18051687.369293254,413873.3954250218,18465560.764718276,1960,0,1278.7777777777778,130,509,89,30.34723261965362,0.6758814102564102,34.454516539440185,135959.28753180534,1045.8406733215795,0
1962,512,0,1,638,0.0,0.001564945226917058,0.9984350547730829,639,18650,13600,5050,0.7292225201072386,237,136,101,156.30278909164826,0.41458518322287147,0.9059600726514536,0.12082437347213057,18064039.887891233,418241.9633480381,18482281.85123927,1961,1,1279.7777777777778,91,548,91,30.21170772771836,0.6855540293040293,34.36367753623189,136005.7971014495,1494.5691989170275,0
1963,512,0,0,638,0.0,0.0,1.0,638,17200,12700,4500,0.7383720930232558,217,127,90,156.97548404543988,0.41428317167233425,0.9059565008865278,0.12178162072104066,18078907.232994903,422789.04278240015,18501696.275777303,1962,2,1282.680250783699,94,544,94,30.082831325301218,0.68572695035461,34.2543859649123,136061.75438596596,1447.4654721911272,0
1964,512,0,0,638,0.0,0.0,1.0,638,18350,12100,6250,0.659400544959128,246,121,125,154.34013457041664,0.4139563740856844,0.9032387437897469,0.12063728885810221,18109753.08641991,413062.34567901853,18522815.43209893,1963,3,1283.680250783699,104,534,89,29.922758920800682,0.6852964743589743,34.0277777777778,136177.77777777897,1309.4017094017208,0
1965,512,0,0,638,0.0,0.0,1.0,638,16450,11500,4950,0.6990881458966566,214,115,99,154.5494681607069,0.4137397905870812,0.903418463549043,0.12128735601653741,18126241.15067017,416230.1859177625,18542471.336587932,1964,4,1284.680250783699,108,530,72,29.794270459225217,0.685570987654321,33.90672782874619,136239.75535168272,1261.4792162192844,0
1966,512,0,0,638,0.0,0.0,1.0,638,17000,11900,5100,0.7,221,119,102,154.1872044826841,0.41354084134256547,0.903628958517265,0.1214273277032853,18140565.819375638,414808.6262847374,18555374.445660375,1965,5,1285.680250783699,108,530,77,29.697166876084513,0.6866319444444444,33.80160550458718,136293.57798165263,1261.977573904191,0
1967,512,0,0,638,0.0,0.0,1.0,638,19400,14200,5200,0.7319587628865979,246,142,104,153.63883237061907,0.41317082958092816,0.9023748930454538,0.1213640366307503,18152986.606553175,410800.7332540674,18563787.339807242,1966,6,1286.680250783699,115,523,79,29.61924754389515,0.6860507246376812,33.71048850574714,136340.22988505845,1185.5672163918125,0
1968,512,0,0,638,0.0,0.0,1.0,638,18850,14000,4850,0.7427055702917772,237,140,97,154.4885965594048,0.4128021506408206,0.902970245270299,0.12238059791963977,18164503.10771132,414791.7184618575,18579294.826173175,1967,7,1287.680250783699,120,518,81,29.510859026565882,0.6859375,33.62603305785125,136383.4710743809,1136.528925619841,0
1969,512,0,0,638,0.0,0.0,1.0,638,17500,12500,5000,0.7142857142857143,225,125,100,154.59472320113858,0.41262662829781055,0.9035454554422202,0.12272784725286567,18173238.317139447,416797.3494613056,18590035.666600753,1968,8,1288.680250783699,122,516,83,29.443000858205426,0.686219262295082,33.56199186991872,136416.26016260296,1118.1660669065816,0
1970,512,0,0,638,0.0,0.0,1.0,638,19200,14000,5200,0.7291666666666666,244,140,104,157.79882429525432,0.412384823714873,0.9063640779677182,0.12577529499404094,18189537.10327804,427257.51387444325,18616794.617152482,1969,9,1289.680250783699,123,515,86,29.236294948157944,0.6872459349593496,33.44254032258067,136477.41935484027,1109.5725150800022,0
1971,512,0,0,638,0.0,0.0,1.0,638,17800,13700,4100,0.7696629213483146,219,137,82,160.21728515624886,0.41211651648843767,0.9086623236677105,0.128173828125,18204444.44444458,437933.33333333815,18642377.777777918,1970,10,1290.680250783699,126,512,88,29.060872395833346,0.6878306878306879,33.33333333333335,136533.33333333436,1083.5978835978917,0
1972,512,0,0,638,0.0,0.0,1.0,638,17450,12400,5050,0.7106017191977078,225,124,101,157.96970017182875,0.4117285116361471,0.9067576539965108,0.12703353218708682,18225409.54139717,430762.49615265423,18656172.037549824,1971,11,1291.680250783699,94,544,94,28.964874250020518,0.6965868794326241,33.17982456140348,136611.92982456004,1453.3184023889366,0
1973,512,0,0,638,0.0,0.0,1.0,638,16850,11400,5450,0.6765578635014837,223,114,109,154.94776610118802,0.4114860406424446,0.9044366785668942,0.12529537424012782,18247694.50318242,421037.8999530048,18668732.403135423,1972,12,1292.680250783699,101,537,93,28.87990252330133,0.696266501650165,33.016748366013054,136695.42483660043,1353.420047887133,0
1974,512,0,0,638,0.0,0.0,1.0,638,17700,13300,4400,0.751412429378531,221,133,88,149.946436044055,0.4111193609346319,0.900595885789705,0.121783447206872,18265262.832874216,402462.2130394867,18667725.045913704,1973,13,1293.680250783699,109,529,74,28.883012195554297,0.6956230886850152,32.88825757575758,136761.21212121227,1254.690019460663,0
1975,512,0,0,638,0.0,0.0,1.0,638,17050,11600,5450,0.6803519061583577,225,116,109,146.9094193592045,0.4106901411396486,0.8981863852657246,0.11975614204244037,18279962.213820726,392449.72694812366,18672411.94076885,1974,14,1294.680250783699,114,524,79,28.85509530750373,0.6956323099415205,32.78079710144929,136816.23188405874,1200.1423849478838,0
1976,512,0,0,638,0.0,0.0,1.0,638,20850,15500,5350,0.7434052757793765,262,155,107,147.42396693241494,0.4103994835214047,0.8981261466113033,0.12051038528669714,18291065.760030985,390858.2947530907,18681924.054784074,1975,15,1295.680250783699,119,519,80,28.759005022786596,0.6954656862745099,32.69965277777779,136857.77777777868,1150.0653594771318,0
1977,512,0,0,638,0.0,0.0,1.0,638,19200,13900,5300,0.7239583333333334,245,139,106,149.93939617381764,0.4102220132084664,0.8997114863742717,0.12314528457146964,18309817.807595517,402272.6052246998,18712090.412820216,1976,16,1296.680250783699,122,516,86,28.55273018989412,0.6962943989071038,32.562669376693776,136927.9132791335,1122.3599449109304,0
1978,512,0,0,638,0.0,0.0,1.0,638,19700,15000,4700,0.7614213197969543,244,150,94,148.55255001482968,0.40991428522216694,0.8994502094028523,0.12249201672102508,18325590.206736006,397162.63114748604,18722752.83788349,1977,17,1297.680250783699,126,512,90,28.47294604537096,0.6967592592592593,32.447506561679795,136986.87664042023,1087.1974336541289,0
1979,512,0,0,638,0.0,0.0,1.0,638,16500,11300,5200,0.6848484848484848,217,113,104,151.35751986838483,0.4096952923923367,0.9008669530400577,0.12537802506208606,18343724.03439682,411192.11499927903,18754916.1493961,1978,18,1298.680250783699,132,506,96,28.263551602395275,0.6971275252525253,32.315162907268174,137054.6365914791,1038.2927014505992,0
1980,512,0,2,636,0.0,0.003134796238244514,0.9968652037617555,638,18600,13600,5000,0.7311827956989247,236,136,100,147.93208045703352,0.4093623433217029,0.8989534741703578,0.1233761003509403,18370517.275688156,397317.7679328792,18767835.043621037,1979,19,1299.680250783699,102,536,102,28.156932699083825,0.7050653594771241,32.119741100323594,137154.6925566328,1344.6538485944393,0
1981,512,0,0,636,0.0,0.0,1.0,636,17100,12500,4600,0.7309941520467836,217,125,92,149.31821429024546,0.4089345627197544,0.9006050916792281,0.12510534293094439,18388553.76985986,404849.2024591237,18793402.972318985,1980,20,1303.433962264151,102,534,96,27.986365294391383,0.7063929738562091,31.988268608414224,137222.00647249108,1345.313788945991,0
1982,512,0,0,636,0.0,0.0,1.0,636,18650,13400,5250,0.7184986595174263,239,134,105,146.41769406005503,0.4086970113405635,0.8981364086894226,0.12315477994479362,18403835.186137587,393079.42196310806,18796914.608100694,1981,21,1304.433962264151,107,529,99,27.95113283451442,0.7062889408099688,31.876929012345652,137279.01234567753,1282.9814237913788,0
1983,512,0,0,636,0.0,0.0,1.0,636,17950,13300,4650,0.7409470752089137,226,133,93,148.63464486925452,0.40825626454712033,0.9002967509236846,0.12578007044312073,18427507.438016362,402643.20477501664,18830150.64279138,1982,22,1305.433962264151,109,527,82,27.716745493905574,0.7075688073394495,31.704545454545432,137367.27272727148,1260.2502085070778,0
1984,512,0,0,636,0.0,0.0,1.0,636,17300,12100,5200,0.6994219653179191,225,121,104,150.09765002258285,0.4078062839432807,0.9004267760264044,0.1274035855031321,18439297.343392197,409039.0398621581,18848336.383254357,1983,23,1306.433962264151,112,524,85,27.590391793180792,0.7077752976190477,31.6187315634218,137411.20943952637,1226.8857985671998,0
1985,512,0,0,636,0.0,0.0,1.0,636,18250,13500,4750,0.7397260273972602,230,135,95,149.65362740550947,0.4075541854438007,0.899630474948377,0.12742578435666008,18451476.66909866,406816.0829037377,18858292.7520024,1984,24,1307.433962264151,118,518,88,27.512362786653608,0.7074505649717514,31.530112044817884,137456.58263305057,1164.8862935004286,0
1986,512,0,0,636,0.0,0.0,1.0,636,17900,12800,5100,0.7150837988826816,230,128,102,150.15816457161833,0.4072022689380808,0.8996997788403274,0.12817372621791248,18461113.44158243,409317.3820672771,18870430.82364971,1985,25,1308.433962264151,123,513,90,27.4276662912795,0.7072323848238482,31.460013440860166,137492.47311827648,1117.824984701435,0
1987,512,0,0,636,0.0,0.0,1.0,636,17350,12300,5050,0.7089337175792507,224,123,101,153.15847732265945,0.40699432765479787,0.9024519316337996,0.1313697889934086,18479843.914687503,421518.95102678053,18901362.86571428,1986,26,1309.433962264151,126,510,95,27.208815418587335,0.7080853174603174,31.323818897637757,137562.204724407,1091.7635295587856,0
1988,512,0,0,636,0.0,0.0,1.0,636,17900,13500,4400,0.7541899441340782,223,135,88,153.31889593755668,0.40672004737615347,0.9030772033599845,0.13209997027274376,18497167.36111124,422093.0555555607,18919260.4166668,1987,27,1310.433962264151,99,537,99,27.076672802428494,0.7151725589225589,31.197916666666686,137626.66666666762,1390.1683501683597,0
1989,512,0,0,636,0.0,0.0,1.0,636,18400,13800,4600,0.75,230,138,92,151.50980157611468,0.4062419526568613,0.9019137932624983,0.13100793867015745,18510879.677632336,415315.94139148603,18926195.619023822,1988,28,1311.433962264151,102,534,102,27.02417666453545,0.7153799019607843,31.098300970873805,137677.66990291365,1349.7810774795455,0
1990,512,0,0,636,0.0,0.0,1.0,636,17400,12100,5300,0.6954022988505747,227,121,106,148.59498132671584,0.40589689702702253,0.8995572673035628,0.1288662691166725,18522163.507730078,405860.10811230977,18928023.615842387,1989,29,1312.433962264151,106,530,106,27.019393171673325,0.7152122641509434,31.016355140186935,137719.6261682254,1299.2417563040133,0
1991,512,0,0,636,0.0,0.0,1.0,636,17100,11800,5300,0.6900584795321637,224,118,106,145.89424035986968,0.40547750664421667,0.8975809239527164,0.12691382462373232,18533929.966002204,396498.7266545881,18930428.692656793,1990,30,1313.433962264151,110,526,105,27.00536818731398,0.7151515151515151,30.930930930930952,137763.36336336462,1252.3942123942238,0
1992,512,0,0,636,0.0,0.0,1.0,636,17350,13200,4150,0.760806916426513,215,132,83,145.36701919848417,0.4050352638703181,0.897094213234426,0.12696018436312448,18549140.78263416,394736.66085291863,18943877.44348708,1991,31,1314.433962264151,113,523,76,26.907559376308328,0.7156157817109144,30.82054093567254,137819.88304093707,1219.64498266316,0
1993,512,0,0,636,0.0,0.0,1.0,636,18200,13700,4500,0.7527472527472527,227,137,90,147.15189276756195,0.4047715070403935,0.8983485742948643,0.129197294141826,18569165.015193824,401097.55581980135,18970262.571013626,1992,32,1315.433962264151,115,521,82,26.712123232862126,0.7166666666666667,30.675287356321874,137894.25287356524,1199.0804597701326,0
1994,512,0,0,636,0.0,0.0,1.0,636,19150,13300,5850,0.6945169712793734,250,133,117,147.80203362072942,0.4042430132554185,0.8984662566741302,0.1301698046382811,18580889.197531164,402908.64197531843,18983797.83950648,1993,33,1316.433962264151,119,517,84,26.60834729561372,0.7167366946778712,30.590277777777814,137937.77777778002,1159.140989729244,0
1995,512,0,0,636,0.0,0.0,1.0,636,17450,12800,4650,0.7335243553008596,221,128,93,146.04600578284942,0.4039353055514287,0.8975149498261059,0.1289570553126368,18590701.25520319,398369.5326049342,18989070.787808124,1994,34,1317.433962264151,123,513,86,26.58349309517131,0.7167174796747968,30.519153225806484,137974.19354838916,1121.7414109625136,0
1996,512,0,0,636,0.0,0.0,1.0,636,17700,13000,4700,0.7344632768361582,224,130,94,147.83097581106452,0.40348723361230787,0.899054531513888,0.13101505514872444,18604621.533828992,405167.8711883036,19009789.405017298,1995,35,1318.433962264151,128,508,87,26.433028805351718,0.7168782552083333,30.418281653746796,138025.83979328338,1078.3268733850264,0
1997,512,0,0,636,0.0,0.0,1.0,636,18350,13200,5150,0.7193460490463215,235,132,103,152.37028972900836,0.403119789861173,0.902492738218571,0.13552258116066485,18618118.606180348,421819.62524655403,19039938.231426902,1996,36,1319.433962264151,129,507,90,26.211398660961883,0.7177002583979328,30.320512820512842,138075.89743589895,1070.355794076736,0
1998,512,0,0,636,0.0,0.0,1.0,636,18850,14300,4550,0.7586206896551724,234,143,91,151.1524918495804,0.4026892570032519,0.90242178350801,0.1349559029095569,18632529.25546972,417220.6452848982,19049749.90075462,1997,37,1320.433962264151,132,504,96,26.138315527685876,0.7182765151515151,30.216165413533858,138129.32330827232,1046.4342674869115,0
1999,512,0,0,636,0.0,0.0,1.0,636,16800,12700,4100,0.7559523809523809,209,127,82,152.6981463911443,0.4023273329041417,0.9027915916304734,0.13674588193575576,18643786.461698793,425374.3268827399,19069160.78858153,1998,38,1321.433962264151,98,538,98,26.013886722811378,0.7261904761904762,30.134680134680117,138171.04377104284,1409.9086099086003,0
2000,512,0,1,635,0.0,0.0015723270440251573,0.9984276729559748,636,16800,11800,5000,0.7023809523809523,218,118,100,150.45199563300227,0.40193677883424944,0.9006125151002429,0.13521615999654174,18657138.832388114,417400.7540269515,19074539.586415067,1999,39,1322.433962264151,103,533,103,25.976429649142318,0.72582928802589,30.03806089743588,138220.51282051194,1341.9467264127372,0
2001,511.8477890730431,0,0,635,0.0,0.0,1.0,635,18150,12300,5850,0.6776859504132231,240,123,117,149.17214160451607,0.40133582966955633,0.9001368970498655,0.1345879447004358,18666088.044113975,411742.0657837816,19077830.109897755,2000,40,1324.628346456693,105,530,105,25.90453145088904,0.7263888888888889,29.933176100628906,138233.10671487066,1316.5057782368635,0
2002,511.4214505085222,0,0,635,0.0,0.0,1.0,635,18100,13200,4900,0.7292817679558011,230,132,98,148.54734835055717,0.4006502686769832,0.8992450855083014,0.1347596833146162,18670868.533038184,409601.6023969327,19080470.135435116,2001,41,1325.628346456693,110,525,75,25.772079252622063,0.7267045454545454,29.786036036036023,138193.21739810717,1256.3019763464288,0
2003,511.45641652367664,0,0,635,0.0,0.0,1.0,635,17950,13000,4950,0.724233983286908,229,130,99,144.82649296126644,0.4001767720675294,0.8964984862606471,0.13204261229350334,18690647.626926098,396430.18939650356,19087077.816322602,2002,42,1326.628346456693,117,518,80,25.73683673469388,0.7265847578347578,29.65218926553672,138271.12249326945,1181.8044657544397,0
2004,511.9301446021363,0,0,635,0.0,0.0,1.0,635,16750,11300,5450,0.6746268656716418,222,113,109,144.53479135684262,0.3998512754911945,0.8962097104255959,0.13234769863182544,18723926.389044225,397501.758804278,19121428.1478485,2003,43,1327.628346456693,120,515,86,25.627712172815126,0.7271701388888889,29.53684573002755,138458.24167497706,1153.8186806248088,0
2005,511.5668307528808,0,0,635,0.0,0.0,1.0,635,16400,12400,4000,0.7560975609756098,204,124,80,145.38415163268618,0.39942217889167636,0.8972685886236631,0.1336447518462643,18724962.84094441,401062.567396855,19126025.408341266,2004,44,1328.628346456693,124,511,88,25.49972280399164,0.727486559139785,29.433333333333334,138412.93217403776,1116.2333239841755,0
2006,511.38339102390415,0,0,635,0.0,0.0,1.0,635,16100,11500,4600,0.7142857142857143,207,115,92,147.91808999081763,0.39898666550750556,0.899441469816274,0.13650159311233143,18732450.548208326,411073.6611876827,19143524.20939601,2005,45,1329.628346456693,126,509,91,25.32702020202022,0.7281746031746033,29.33070866141732,138415.78005076115,1098.5379369108027,0
2007,511.6845338102468,0,0,635,0.0,0.0,1.0,635,16350,11700,4650,0.7155963302752294,210,117,93,147.58230553430627,0.39869894516340026,0.8989775491295067,0.1364764039441784,18751129.06372557,410116.9717191922,19161246.03544476,2006,46,1330.628346456693,133,502,94,25.280082888263557,0.7276002506265664,29.275497512437813,138525.54084635945,1041.5454198974394,0
2008,511.4284767604469,0,0,635,0.0,0.0,1.0,635,19050,13600,5450,0.7139107611548556,245,136,109,133.46804447667844,0.39838855907995724,0.8889646034450154,0.11354455377943327,18427479.798109002,345845.9386574128,18773325.736766417,2007,47,1331.628346456693,122,513,95,27.971993501167276,0.7064549180327868,31.554878048780452,137290.47981328226,1125.3318017482152,8
2009,511.30330261691415,0,0,635,0.0,0.0,1.0,635,18750,13600,5150,0.7253333333333334,239,136,103,132.62941633761116,0.397927275060649,0.888645261212331,0.11310694215713092,18432424.440732505,343186.33905228425,18775610.77978479,2008,48,1332.628346456693,127,508,96,27.924717128857907,0.7062828083989501,31.486002604166625,137292.09366735627,1081.0401076169785,0
2010,511.3717267228143,0,0,635,0.0,0.0,1.0,635,17800,12300,5500,0.6910112359550562,233,123,110,134.27135271949516,0.3975859435157356,0.8895511996011396,0.11494239448090621,18449551.19925638,350649.23931834317,18800200.438574724,2009,49,1333.628346456693,136,499,99,27.772450866615667,0.7059589460784313,31.379257907542556,137365.05271738226,1010.0371523336931,0
2011,511.7323749539737,0,0,635,0.0,0.0,1.0,635,17400,12100,5300,0.6954022988505747,227,121,106,134.49252762772124,0.3972070427316459,0.8909145194993209,0.11551221054000002,18475291.21537041,352557.7228426741,18827848.938213084,2010,50,1334.628346456693,141,494,101,27.67268502088392,0.7061908983451537,31.286678403755847,137509.30624221527,975.2433066823778,0
2012,511.64208128830467,0,0,635,0.0,0.0,1.0,635,17450,11800,5650,0.6762177650429799,231,118,113,136.94067866968606,0.39693608882485903,0.891847089856995,0.11810370816649272,18487988.993011557,361901.5519881453,18849890.5449997,2011,51,1335.628346456693,104,531,104,27.489267350603946,0.7141426282051282,31.170634920634956,137544.4158606218,1322.5424601982866,0
2013,512.0974799831075,0,0,635,0.0,0.0,1.0,635,16750,11800,4950,0.7044776119402985,217,118,99,137.53517942996825,0.39673323563261215,0.8912862123315386,0.11925647443733602,18525099.433175016,365820.5748999517,18890920.00807497,2012,52,1336.628346456693,108,527,108,27.32122977806199,0.7146990740740741,31.020642201834892,137743.65129591658,1275.4041786658943,0
2014,512.5333810617074,0,0,635,0.0,0.0,1.0,635,16000,11000,5000,0.6875,210,110,100,135.6724915519383,0.3962787823840632,0.889653544940189,0.11797022867766935,18551562.419141475,360387.3391172503,18911949.758258726,2013,53,1337.628346456693,111,524,106,27.29271809141923,0.7148085585585586,30.94308035714288,137900.65272260303,1242.3482227261534,0
2015,512.1391565632545,0,0,635,0.0,0.0,1.0,635,18200,13500,4700,0.7417582417582418,229,135,94,133.26965235034544,0.3958748354405226,0.8874800496122615,0.11621253274926516,18548210.204866238,349182.70514473633,18897392.910010975,2014,54,1338.628346456693,115,520,102,27.277097027126235,0.7147644927536232,30.86386494252876,137835.15320902903,1198.5665496437307,0
2016,512.2667082481046,0,0,635,0.0,0.0,1.0,635,17000,12300,4700,0.7235294117647059,217,123,94,133.7627775704638,0.39559539481854994,0.8880689491805132,0.11723076266815899,18571998.937688358,352848.4325881871,18924847.370276544,2015,55,1339.628346456693,120,515,84,27.12296322346195,0.7151909722222223,30.724862258953202,137940.68842366314,1149.5057368638595,0
2017,512.2331021244432,0,0,635,0.0,0.0,1.0,635,17400,12600,4800,0.7241379310344828,222,126,96,132.19495301309982,0.3951688856321982,0.8869539799404427,0.11627760152785041,18584557.281980447,346956.93533213984,18931514.217312586,2016,56,1340.628346456693,124,511,88,27.06399845320964,0.7154737903225806,30.62500000000003,137982.79188477361,1112.7644506836582,0
2018,511.7917686379434,0,0,635,0.0,0.0,1.0,635,16700,11600,5100,0.6946107784431138,218,116,102,136.51110657207877,0.39494874851999967,0.888477517813171,0.12053045484708926,18582908.6655898,363654.68505351304,18946563.35064331,2017,57,1341.628346456693,129,506,91,26.842143409354467,0.7156815245478036,30.520833333333357,137917.21931941406,1069.1257311582485,0
2019,512.1665692603519,0,1,634,0.0,0.0015748031496062992,0.9984251968503937,635,17050,12200,4850,0.7155425219941349,219,122,97,136.51945300244532,0.39453072604883377,0.8886507539308752,0.12088734811830529,18607462.711672127,364006.12623218005,18971468.837904308,2018,58,1342.628346456693,133,502,94,26.761544968662285,0.7158521303258145,30.44154228855723,138058.83050118253,1038.0363195577634,0
2020,511.7487238216093,0,0,634,0.0,0.0,1.0,634,16400,12100,4300,0.7378048780487805,207,121,86,137.18566304478853,0.3940924722957293,0.8889041847365089,0.12202303712931258,18609169.549233474,367382.2526648999,18976551.801898375,2019,59,1345.0110410094637,140,494,99,26.61951429980282,0.7160714285714286,30.319148936170226,138008.83137104116,985.7773669360083,0
2021,511.9138325552562,0,0,634,0.0,0.0,1.0,634,16400,11600,4800,0.7073170731707317,212,116,96,138.05095000014524,0.3938703937652724,0.8900986926336951,0.12312982483748962,18625480.186495077,371053.0467909082,18996533.233285986,2020,60,1346.0110410094637,143,491,102,26.520502042494584,0.7164189976689976,30.244502314814824,138091.5706728744,965.67531939073,0
2022,511.4979503289633,0,0,634,0.0,0.0,1.0,634,17750,13000,4750,0.7323943661971831,225,130,95,138.15419550173021,0.39340863861604064,0.8910535349786579,0.12361164860681091,18622185.392425034,369996.6082749085,18992182.00069994,2021,61,1347.0110410094637,104,530,104,26.430759803921536,0.7243589743589743,30.158730158730148,138023.25643797376,1327.1466965189784,0
2023,511.06854033421473,0,0,634,0.0,0.0,1.0,634,17100,11900,5200,0.695906432748538,223,119,104,137.67432556012844,0.3930336799378056,0.8906316937336916,0.12390689300411512,18628448.29518205,369031.81105418026,18997480.10623623,2022,62,1348.0110410094637,109,525,109,26.282793209876537,0.7247706422018348,29.99999999999999,137988.5058902374,1265.9495953232788,0
2024,510.7680421447495,0,0,634,0.0,0.0,1.0,634,18300,13700,4600,0.7486338797814208,229,137,92,133.2475896644816,0.3927348758187523,0.88584925492685,0.12037131682799374,18631376.112711787,351417.1918302495,18982793.304542035,2023,63,1349.0110410094637,117,517,107,26.30033854081552,0.7240918803418803,29.899364406779664,137958.7728240018,1179.1348104615538,0
2025,511.12021211201267,0,0,634,0.0,0.0,1.0,634,17000,12700,4300,0.7470588235294118,213,127,86,132.63303274607068,0.3923610591993461,0.8856165852644637,0.1202432225814034,18657428.83642471,351118.27396380197,19008547.11038851,2024,64,1350.0110410094637,120,514,107,26.220023789800166,0.7244791666666667,29.803719008264473,138102.7804523733,1150.8565037697774,0
2026,511.3670625939339,0,0,634,0.0,0.0,1.0,634,19950,15100,4850,0.7568922305764411,248,151,97,131.38501861813702,0.3919412487561941,0.8850586240221721,0.1196295169523036,18682500.996550087,344170.1482530187,19026671.144803107,2025,65,1351.0110410094637,123,511,87,26.135998715478465,0.7251016260162602,29.687499999999996,138228.9091074226,1123.8122691660374,0
2027,511.2623590848256,0,0,634,0.0,0.0,1.0,634,17150,11900,5250,0.6938775510204082,224,119,105,159.0404282314792,0.39179828375552134,0.9024608170560617,0.13095708123893335,18293660.35161979,437936.3152485761,18731596.666868366,2026,66,1352.0110410094637,137,497,86,28.233399172310065,0.694647201946472,32.487922705314034,136768.85572136514,998.312815484417,8
2028,511.0096374842142,0,0,634,0.0,0.0,1.0,634,18250,13600,4650,0.7452054794520548,229,136,93,163.98687576946355,0.39150212713648064,0.9050864048923544,0.13546741911390736,18297409.158084232,455056.99250197376,18752466.150586206,2027,67,1353.0110410094637,141,493,90,28.005985014619938,0.6950354609929078,32.39436619718314,136749.05791831377,969.8514745979701,0
2029,510.96875640887663,1,0,635,0.0015748031496062992,0.0,1.0,635,18700,13900,4800,0.7433155080213903,235,139,96,169.04794852856702,0.39140896031529177,0.908922533509964,0.14019899274101866,18311475.292630523,473403.46655014163,18784878.759180665,2028,0,1351.8787401574803,95,540,95,27.755078088058465,0.7053728070175438,32.2808159722222,136796.1385294718,1439.9593529418082,0
2030,510.65453766389874,0,0,635,0.0,0.0,1.0,635,15700,11000,4700,0.7006369426751592,204,110,94,168.68166902911045,0.39111730710317366,0.9080598003179692,0.14059692901232418,18319886.32262739,475345.80026486685,18795232.122892257,2029,1,1352.8787401574803,100,535,100,27.618605292879504,0.7054166666666667,32.13696369636961,136785.47496087724,1367.8547496087724,0
2031,510.2262134459819,0,0,635,0.0,0.0,1.0,635,18000,13700,4300,0.7611111111111111,223,137,86,170.2279483726544,0.3909091755880673,0.9087615076921971,0.14263928087777467,18325254.72399056,478894.10301423527,18804148.827004794,2030,2,1353.8787401574803,101,534,97,27.422934766041745,0.7066831683168318,31.985294117647033,136748.12853019015,1353.9418666355461,0
2032,510.1195359826652,0,1,634,0.0,0.0015748031496062992,0.9984251968503937,635,18700,13700,5000,0.732620320855615,237,137,100,173.32632614830544,0.3906966972188413,0.9144775031167098,0.1357600362754449,18051760.875522573,480069.0786124118,18531829.954134986,2031,3,1354.8787401574803,93,542,83,29.35389504450092,0.6889560931899641,33.96498226950356,135709.65979982147,1459.2436537615213,8
2033,510.03736362668957,0,0,634,0.0,0.0,1.0,634,16900,12100,4800,0.7159763313609467,217,121,96,170.29375400064572,0.39046591639631023,0.9129721089688247,0.1338038104030327,18061659.905514915,471457.5737586183,18533117.47927353,2032,4,1357.3438485804415,94,540,73,29.33859681650256,0.6896054964539007,33.870614035087726,135735.9304011339,1443.9992595865308,0
2034,509.9923448223634,0,0,634,0.0,0.0,1.0,634,17150,11600,5550,0.6763848396501457,227,116,111,167.37587411549467,0.39032175742504355,0.9114100717141005,0.13190988493067032,18072398.595202945,461026.7024471498,18533425.297650095,2033,5,1358.3438485804415,97,537,76,29.323877398919304,0.689647766323024,33.77976190476192,135770.28346535919,1399.6936439727751,0
2035,510.24016948161955,0,0,634,0.0,0.0,1.0,634,18200,12900,5300,0.7087912087912088,235,129,106,169.571221953915,0.39024264389525953,0.9112165453430554,0.12208732248541927,17701946.121627852,455348.12696135807,18157294.24858921,2034,6,1359.3438485804415,121,513,80,32.11967062115762,0.6559056473829201,36.58640710382513,134404.19628310617,1110.7784816785634,8
2036,510.55304044047733,0,0,634,0.0,0.0,1.0,634,17050,11800,5250,0.6920821114369502,223,118,105,172.63704704083423,0.3900982772769331,0.9130955332703246,0.12460042993005566,17723408.025918312,468093.3650188687,18191501.39093718,2035,7,1360.3438485804415,126,508,83,31.958690012970166,0.6558366402116402,36.50754593175852,134526.8735576629,1067.6735996639914,0
2037,511.07008575696483,0,0,634,0.0,0.0,1.0,634,18650,13800,4850,0.739946380697051,235,138,97,170.5804639646724,0.39022395565987744,0.9117428782372734,0.1236144771902571,17758778.517557286,460410.1357941498,18219188.653351437,2036,8,1361.3438485804415,90,544,90,31.88133232016206,0.6655092592592593,36.378205128205096,134729.21331253185,1496.9912590281317,0
2038,510.6279784810563,0,0,634,0.0,0.0,1.0,634,17950,13000,4950,0.724233983286908,229,130,99,170.8739511849142,0.3902976184543417,0.9124055540546685,0.12435203664019162,17761593.249379087,462248.72357213375,18223841.972951222,2037,9,1362.3438485804415,91,543,91,31.73628997638975,0.6665521978021978,36.2432065217391,134681.59826444826,1480.0175633455854,0
2039,510.5261884154287,0,0,634,0.0,0.0,1.0,634,18150,12600,5550,0.6942148760330579,237,126,111,171.31595939784884,0.3903945377195037,0.9120824127727851,0.12533221189889704,17780617.971054543,464270.72527956474,18244888.69633411,2038,10,1363.3438485804415,97,537,88,31.554235467848017,0.6664518900343643,36.075680272108826,134740.27698081444,1389.0750204207675,0
2040,510.34556307551605,0,0,634,0.0,0.0,1.0,634,18500,13700,4800,0.7405405405405405,233,137,96,161.07528642365466,0.39035908198404273,0.9054697117446198,0.11079069958837764,17505412.528417096,418637.8673957984,17924050.395812895,2039,11,1364.3438485804415,105,529,68,33.86090840305654,0.6441468253968254,38.07979559748426,133669.81419665503,1273.0458494919526,8
2041,510.150832723245,0,0,634,0.0,0.0,1.0,634,18000,12900,5100,0.7166666666666667,231,129,102,160.614200592553,0.3901346674241632,0.9050593134505578,0.11073294512320248,17509143.738615125,417643.424927548,17926787.163542673,2040,12,1365.3438485804415,109,525,70,33.7938323032252,0.6440175840978593,38.00189393939391,133658.55197872967,1226.2252475112814,0
2042,510.661964890886,0,1,633,0.0,0.0015772870662460567,0.998422712933754,634,14450,10000,4450,0.6920415224913494,189,100,89,157.26355446436816,0.39006339257088657,0.9028453525932862,0.1088022254387391,17542177.65117289,410499.0420937648,17952676.693266656,2041,13,1366.3438485804415,115,519,76,33.76403924994573,0.6439311594202899,37.88613505747124,133851.58129669484,1163.926793884303,0
2043,510.6929733582644,0,0,633,0.0,0.0,1.0,633,17050,11800,5250,0.6920821114369502,223,118,105,168.55903463595655,0.3901250699902014,0.9064693932814578,0.10804328775628527,17196843.007228814,436086.65121692175,17632929.658445735,2042,14,1368.7551342812005,97,536,97,36.112490613693744,0.6218857388316151,40.486819727891174,132531.55765882344,1366.3047181322004,8
2044,510.45606545900836,2,0,635,0.0031496062992125984,0.0,1.0,635,18550,14300,4250,0.77088948787062,228,143,85,166.80561327268418,0.39103544135058826,0.9053007925039234,0.107416848725972,17210372.160752673,428607.3365850992,17638979.497337773,2043,0,1365.4409448818897,103,532,93,35.99298644861018,0.6219660194174756,40.32451923076925,132552.92420963873,1286.9215942683372,0
2045,510.43245672132497,2,1,636,0.0031397174254317113,0.0015698587127158557,0.9984301412872841,637,17850,12900,4950,0.7226890756302521,228,129,99,166.48316111760002,0.3916444722543105,0.9045024822409369,0.107729662261865,17231949.18335182,428515.8744524485,17660465.057804268,2044,0,1362.1507064364207,110,527,72,35.82981207940584,0.622064393939394,40.15578078078077,132632.9231809,1205.7538470990908,0
2046,510.17399144229483,1,0,637,0.0015698587127158557,0.0,1.0,637,18850,14300,4550,0.7586206896551724,234,143,91,167.9618986113813,0.3920046429311928,0.9064432066164119,0.10919250228436875,17244608.14011499,433037.42480459437,17677645.564919583,2045,0,1363.149136577708,113,524,77,35.627416095589446,0.6230641592920354,39.99451754385963,132648.03478152762,1173.8764139958196,0
2047,509.77260818292723,0,0,637,0.0,0.0,1.0,637,16850,11900,4950,0.7062314540059347,218,119,99,168.7993975146917,0.391944065966977,0.9078293662259243,0.11003574800531986,17243522.75276476,437889.2503395094,17681412.00310427,2046,1,1364.149136577708,114,523,79,35.50989610540367,0.6238121345029239,39.900362318840564,132591.67068815808,1163.084830597878,0
2048,509.70960197625635,4,0,641,0.0062402496099844,0.0,1.0,641,17250,12400,4850,0.7188405797101449,221,124,97,173.40551804801697,0.39301161108944355,0.911814961103462,0.11386335642969349,17274669.553533487,453654.6046077503,17728324.158141237,2047,0,1356.6302652106085,125,516,86,35.134849062195656,0.6243333333333334,39.64947089947088,132703.16456213707,1061.6253164970965,0
2049,510.1054503657934,0,0,641,0.0,0.0,1.0,641,17650,13300,4350,0.7535410764872521,220,133,87,174.8239509039459,0.39304106539261574,0.9134181312501812,0.11509328681218854,17299945.06190513,459038.9492286951,17758984.011133827,2048,1,1357.6302652106085,89,552,89,35.0070734453234,0.6336610486891385,39.5601851851852,132851.76902929548,1492.7165059471401,0
2050,509.78353761328,2,0,643,0.003110419906687403,0.0,1.0,643,17850,13100,4750,0.7338935574229691,226,131,95,169.94972579976854,0.3939296949818236,0.9110817646795752,0.11265318525569659,17320186.801976603,442262.19955934293,17762449.001535945,2049,0,1354.4043545878694,96,547,96,34.89544711762928,0.6338975694444444,39.32560137457047,132887.51709648687,1384.2449697550717,0
2051,509.48385833830207,0,0,643,0.0,0.0,1.0,643,16850,12000,4850,0.712166172106825,217,120,97,169.96184317267026,0.3941189485294949,0.9107294384107492,0.11309238017049751,17327319.723733813,443546.6394975985,17770866.36323141,2050,1,1355.4043545878694,101,542,90,34.762576030490514,0.6338696369636964,39.19526143790852,132875.80447552784,1315.6020245101765,0
2052,509.4410648106159,0,0,643,0.0,0.0,1.0,643,18850,13200,5650,0.7002652519893899,245,132,113,168.32602260548725,0.39432879286315287,0.9097760932256789,0.11244178310046574,17343508.12561439,436422.74816212547,17779930.873776514,2051,2,1356.4043545878694,105,538,73,34.670242847638065,0.6342261904761906,39.06250000000001,132932.27784902047,1266.021693800195,0
2053,509.5558228086363,0,0,643,0.0,0.0,1.0,643,17450,12100,5350,0.6934097421203438,228,121,107,139.39489191409808,0.3944353804612013,0.8929183393033295,0.09310337703152022,17346812.789887555,337561.41878009896,17684374.208667655,2052,3,1357.4043545878694,114,529,80,35.429756656368255,0.632218567251462,39.06702898550727,132959.9147431934,1166.3150416069595,8
2054,509.62892948960877,0,0,643,0.0,0.0,1.0,643,16100,11600,4500,0.7204968944099379,206,116,90,137.51394070789468,0.39456760560650767,0.8908862759406397,0.09219236051025664,17366237.520003546,332919.9513290015,17699157.471332546,2053,4,1358.4043545878694,122,521,83,35.3497588615671,0.6320013661202186,38.93970189701899,133043.88025446175,1090.5236086431291,0
2055,510.14653806705223,2,1,644,0.0031007751937984496,0.0015503875968992248,0.9984496124031008,645,17850,12300,5550,0.6890756302521008,234,123,111,146.06988390145253,0.3950754931227631,0.8987757512143562,0.10220049108612488,17574060.518026654,366558.195909044,17940618.7139357,2054,0,1355.1891472868217,133,512,98,33.6814399099686,0.6445802005012531,37.51554726368157,133905.53485985598,1006.808532780872,8
2056,510.2021286805249,1,0,645,0.0015503875968992248,0.0,1.0,645,17850,13100,4750,0.7338935574229691,226,131,95,146.57364679562497,0.39509565538382524,0.8998999465184159,0.10308729806529174,17598782.888531633,369053.55742730974,17967836.445958942,2055,0,1356.187596899225,100,545,100,33.49547126346515,0.6528125,37.345297029703,134006.9885633979,1340.069885633979,0
2057,510.6600668767782,0,0,645,0.0,0.0,1.0,645,19050,15400,3650,0.8083989501312336,227,154,73,144.03775462144228,0.3952431107259216,0.8967345112760956,0.1017440075606235,17633569.8376736,359929.9610757835,17993499.798749384,2056,1,1357.187596899225,108,537,100,33.41848794501619,0.652295524691358,37.20374617737005,134199.5525520321,1242.5884495558528,0
2058,511.0098854136513,0,0,645,0.0,0.0,1.0,645,17850,12400,5450,0.6946778711484594,233,124,109,145.45687933565478,0.39520188341598855,0.898181548528195,0.10311538288126881,17661319.198569696,366942.07511497266,18028261.27368467,2057,2,1358.187596899225,110,535,99,33.26283790215116,0.6530303030303031,37.08708708708711,134351.09750139827,1221.3736136490752,0
2059,510.754031326184,0,0,645,0.0,0.0,1.0,645,16550,10800,5750,0.6525679758308157,223,108,115,146.68431820579983,0.3952792222382718,0.8994141944790295,0.10427302373221933,17664516.47430451,372671.5110936987,18037187.985398207,2058,3,1359.187596899225,113,532,75,33.139606422772715,0.6533001474926254,36.99744152046785,134329.61699252238,1188.7576725001982,0
2060,511.1119772638903,0,0,645,0.0,0.0,1.0,645,16800,10900,5900,0.6488095238095238,227,109,118,144.9468227091419,0.3953505424751633,0.8977548323728073,0.10327418874256684,17686876.069754347,366931.29799225274,18053807.3677466,2059,4,1360.187596899225,120,525,75,33.1099948733052,0.6526909722222223,36.9232093663912,134461.69863298308,1120.514155274859,0
2061,511.6331519561244,0,0,645,0.0,0.0,1.0,645,16050,10700,5350,0.6666666666666666,214,107,107,145.95529656679884,0.3952475243552089,0.8988167938364595,0.10424522617992593,17715472.189182896,372083.3994386146,18087555.588621512,2060,5,1361.187596899225,123,522,76,33.00386792653603,0.6529471544715447,36.844758064516135,134638.94588522837,1094.6255763026697,0
2062,511.84970376349065,0,1,644,0.0,0.0015503875968992248,0.9984496124031008,645,17550,12200,5350,0.6951566951566952,229,122,107,143.6367978040534,0.39515192915723757,0.8983281331651947,0.10305673289617773,17742732.543099303,363151.85735691444,18105884.400456216,2061,6,1362.187596899225,125,520,85,32.91609757501542,0.6540833333333333,36.69808201058203,134771.00872324355,1078.1680697859483,0
2063,512.0829870077894,2,0,646,0.0030959752321981426,0.0,1.0,646,19100,13900,5200,0.7277486910994765,243,139,104,148.29843953292146,0.39552418580651355,0.9019733450701035,0.10691304858988013,17771621.535708345,378800.7483430443,18150422.28405139,2062,0,1361.0510835913312,133,513,89,32.636829590943535,0.6543703007518797,36.5438432835821,134911.41567693616,1014.371546443129,0
2064,512.0679205889832,0,0,646,0.0,0.0,1.0,646,16950,11900,5050,0.7020648967551623,220,119,101,150.76004936805705,0.39553728570171437,0.9043490497925819,0.10897797854319599,17782636.46320549,390032.23021741654,18172668.693422906,2063,1,1362.0510835913312,135,511,92,32.485177865612684,0.6549382716049383,36.45833333333334,134951.23323855552,999.6387647300409,0
2065,512.1329945353921,0,1,645,0.0,0.0015479876160990713,0.9984520123839009,646,16250,11600,4650,0.7138461538461538,209,116,93,151.4833374567362,0.3956440348477212,0.9042305480373232,0.10976378538682485,17795257.216882303,393686.99082287936,18188944.20770518,2064,2,1363.0510835913312,94,552,94,32.38819912375568,0.6642287234042553,36.38157894736842,135007.69138837585,1436.2520360465517,0
2066,512.1938919594844,0,0,645,0.0,0.0,1.0,645,20250,15300,4950,0.7555555555555555,252,153,99,153.9242834555546,0.39550030494165983,0.9042605998327533,0.11194744565142713,17813385.00040726,399132.50442112,18212517.50482838,2065,3,1363.4,95,550,95,32.203468279437146,0.6651315789473684,36.26302083333332,135084.46981301185,1421.941787505388,0
2067,512.2597797568718,0,0,645,0.0,0.0,1.0,645,18700,13800,4900,0.7379679144385026,236,138,98,154.81078604160035,0.39546138475612697,0.9035680454688972,0.11322996752742438,17839960.868492585,404663.6730005449,18244624.54149313,2066,4,1364.4,99,546,92,31.997618671718726,0.6658249158249159,36.08333333333333,135193.89354083422,1365.5948842508508,0
2068,512.5399668622558,0,0,645,0.0,0.0,1.0,645,18600,13100,5500,0.7043010752688172,241,131,110,154.692970332774,0.3954858603367198,0.903269245882899,0.11368319751494169,17870109.475531098,405276.06298835133,18275385.53851945,2067,5,1365.4,106,539,78,31.84769585253458,0.6655856918238994,35.932632398753896,135345.07983974591,1276.8403758466595,0
2069,512.3819766684035,0,1,644,0.0,0.0015503875968992248,0.9984496124031008,645,18350,13100,5250,0.7138964577656676,236,131,105,157.74752444414267,0.395197971335484,0.9035241324816754,0.11639317089456977,17881717.339823566,416809.3286334178,18298526.668456983,2068,6,1366.4,114,531,80,31.638566987805888,0.6651133040935673,35.80615942028987,135368.16225984995,1187.4400198232452,0
2070,511.90991660660495,0,0,644,0.0,0.0,1.0,644,17000,12900,4100,0.7588235294117647,211,129,82,158.68389064812158,0.3949780483564039,0.9047161578199099,0.11746774662201319,17879180.27215145,421627.5774368322,18300807.849588282,2069,7,1368.697204968944,119,525,81,31.509159358885928,0.6651785714285714,35.70312500000002,135296.19124063765,1136.9427835347701,0
2071,511.6157403867287,2,0,646,0.0030959752321981426,0.0,1.0,646,17600,12900,4700,0.7329545454545454,223,129,94,157.26669149494109,0.39518083855329156,0.9044013776901374,0.11685341841635176,17884740.85367589,415734.8044604094,18300475.6581363,2070,0,1365.4566563467492,122,524,88,31.427692545854427,0.6658128415300546,35.58604336043363,135278.34219473763,1108.8388704486692,0
2072,512.0289585654621,0,0,646,0.0,0.0,1.0,646,18250,12900,5350,0.7068493150684931,236,129,107,155.16605155073907,0.3950646394828841,0.9033632937700471,0.11558154801543272,17909806.92021079,408348.8047690474,18318155.724979836,2071,1,1366.4566563467492,125,521,92,31.403581773096217,0.6660833333333334,35.50760582010584,135427.76514041805,1083.4221211233444,0
2073,512.4961276132291,0,0,646,0.0,0.0,1.0,646,16550,11900,4650,0.7190332326283988,212,119,93,156.39865951800115,0.3948485412116703,0.9043144232409279,0.11674773874330095,17935166.310546122,415257.19384037243,18350423.504386496,2072,2,1367.4566563467492,127,519,94,31.303414695417743,0.6664206036745407,35.44108072916669,135585.42165184458,1067.6017452901149,0
2074,512.0035413772467,0,0,646,0.0,0.0,1.0,646,17750,13100,4650,0.7380281690140845,224,131,93,154.6942049527497,0.3948504911960704,0.9028699159903015,0.11583874180340795,17931214.078079764,407820.9811292138,18339035.059208978,2073,3,1368.4566563467492,98,548,98,31.248923256337896,0.6735756802721089,35.34301346801344,135505.31435460586,1382.707289332713,0
2075,512.2362980343723,0,0,646,0.0,0.0,1.0,646,17750,12500,5250,0.704225352112676,230,125,105,142.5328632986969,0.39484334125327,0.8957509350827075,0.10057039095691214,17683174.728024945,357136.70523930737,18040311.43326425,2074,4,1369.4566563467492,111,535,111,33.494383878427456,0.6512762762762763,37.23958333333332,134595.42310330184,1212.5713793090256,8
2076,512.6638234806544,0,1,645,0.0,0.0015479876160990713,0.9984520123839009,646,18300,13000,5300,0.7103825136612022,236,130,106,139.877007120212,0.3947463920288638,0.8932159431224562,0.09914474408260814,17717817.88689508,348163.06774396636,18065980.954639047,2075,5,1370.4566563467492,119,527,99,33.414535664366426,0.6511729691876751,37.09201388888888,134783.41338332044,1132.6337259102559,0
2077,512.4567441970847,0,0,645,0.0,0.0,1.0,645,16300,12100,4200,0.7423312883435583,205,121,84,141.1695254904664,0.3943671056221612,0.8943345879968021,0.10043575986742038,17727019.07906313,355202.97435035673,18082222.053413484,2076,6,1373.5317829457365,121,524,78,33.257455257633815,0.6520316804407713,36.970628415300546,134791.17539050014,1113.9766561198358,0
2078,512.6740334997256,0,0,645,0.0,0.0,1.0,645,16550,11700,4850,0.7069486404833837,214,117,97,141.91770473085904,0.394286155648643,0.8952049154367523,0.10124061475761639,17746309.14886391,358153.09237019747,18104462.24123411,2077,7,1374.5317829457365,124,521,80,33.14924199235657,0.652385752688172,36.88333333333331,134893.0827810014,1087.8474417822695,0
2079,512.2480123949587,0,1,644,0.0,0.0015503875968992248,0.9984496124031008,645,17950,13100,4850,0.7298050139275766,228,131,97,141.27539825355387,0.3943213643731844,0.8952396037343442,0.10105050704574388,17743135.54876532,354383.7081837177,18097519.256949037,2078,8,1375.5317829457365,128,517,82,33.079076545482444,0.652587890625,36.79748062015502,134824.96740967,1053.320057888047,0
2080,512.3018643232302,0,0,644,0.0,0.0,1.0,644,19300,15200,4100,0.7875647668393783,234,152,82,139.52860738681397,0.39411556892349203,0.8947522524296838,0.1001376312311866,17759640.57582675,347495.58344709134,18107136.15927384,2079,9,1378.388198757764,130,514,87,33.014988625153535,0.6533653846153846,36.68893129770992,134894.75139312507,1037.6519337932698,0
2081,512.7180780656438,0,0,644,0.0,0.0,1.0,644,17850,12600,5250,0.7058823529411765,231,126,105,140.74029672392254,0.39414359208420674,0.8959667380650649,0.10123379042646512,17783802.104955435,353929.5170261885,18137731.621981625,2080,10,1379.388198757764,137,507,88,32.909985527183096,0.6530565693430657,36.61684782608695,135041.3035774795,985.7029458210183,0
2082,512.2945351312908,0,1,643,0.0,0.0015527950310559005,0.9984472049689441,644,17200,12600,4600,0.7325581395348837,218,126,92,143.34691493341094,0.39413071249867176,0.898099185264899,0.10352313089889247,17786488.173903592,363927.641445736,18150415.81534933,2081,11,1380.388198757764,139,505,96,32.710733378510675,0.6540767386091126,36.48809523809524,134995.70875156103,971.192149291806,0
2083,512.3012367040906,0,0,643,0.0,0.0,1.0,643,18700,13900,4800,0.7433155080213903,235,139,96,137.56955928528694,0.39399944122259206,0.8927917890558592,0.09974340407172601,17803763.299693704,342551.1741516913,18146314.473845396,2082,12,1383.5178849144634,107,536,107,32.73502475549379,0.6610202492211839,36.36188271604941,135062.1335269074,1262.262930158013,0
2084,512.0910244390436,0,0,643,0.0,0.0,1.0,643,18800,14200,4600,0.7553191489361702,234,142,92,138.23768761799317,0.3940432471104263,0.8933853695395635,0.10063316979743521,17813847.574559003,345109.01925729215,18158956.593816295,2083,13,1384.5178849144634,110,533,110,32.58685558757605,0.6616477272727272,36.233108108108134,135072.65788202282,1227.9332534729347,0
2085,512.2497216902212,0,0,643,0.0,0.0,1.0,643,18200,13200,5000,0.7252747252747253,232,132,100,137.82418077568624,0.3938983041267165,0.8931333469231624,0.10075564737900283,17837474.00705907,344887.0484261094,18182361.05548518,2084,14,1385.5178849144634,115,528,98,32.461945918969185,0.6619565217391304,36.09913793103451,135183.1431486388,1175.505592596859,0
2086,512.1922922193932,1,0,644,0.0015527950310559005,0.0,1.0,644,17300,12600,4700,0.7283236994219653,220,126,94,134.76492606071025,0.3941024880944331,0.8930479358796686,0.09227403445954123,17548479.40126121,326883.9057977696,17875363.30705898,2085,0,1384.3649068322982,113,531,106,34.70326608023827,0.6408554572271387,38.23099415204677,134076.06713725402,1186.5138684712745,8
2087,512.1948136775288,0,0,644,0.0,0.0,1.0,644,17450,12100,5350,0.6934097421203438,228,121,107,134.40263413979977,0.39416210648841316,0.8924871355993877,0.09224088231963837,17558991.209000703,325744.93426545965,17884736.143266164,2086,1,1385.3649068322982,117,527,97,34.6339592744926,0.6408475783475783,38.15324858757064,134116.54805175646,1146.295282493645,0
2088,511.92873776665766,1,0,645,0.0015503875968992248,0.0,1.0,645,16400,11600,4800,0.7073170731707317,212,116,96,133.3806373762701,0.3946765612210506,0.8921471159036103,0.09194049688045405,17569355.866295815,323282.37674741115,17892638.243043225,2087,0,1384.215503875969,120,525,79,34.51345304986914,0.6417534722222222,38.00792011019285,134121.27476285098,1117.677289690425,0
2089,511.49111568601165,0,0,645,0.0,0.0,1.0,645,17150,11800,5350,0.6880466472303207,225,118,107,131.84932805245177,0.3947179891504968,0.8899791720585164,0.09113541466482646,17566567.40461189,317078.02169723547,17883645.426309124,2088,1,1385.215503875969,129,516,82,34.46111552729205,0.6411498708010336,37.916666666666664,134053.29656937532,1039.1728416230644,0
2090,511.56004172979897,0,0,645,0.0,0.0,1.0,645,17650,11900,5750,0.6742209631728046,234,119,115,131.53875665904755,0.39466191599659745,0.8890784986004081,0.09123054072064661,17584024.934079174,315946.1553780881,17899971.089457262,2089,2,1386.215503875969,136,509,89,34.35524446119938,0.6412377450980392,37.80413625304134,134128.9269997734,986.2421102924515,0
2091,511.8964054338856,0,0,645,0.0,0.0,1.0,645,18400,12800,5600,0.6956521739130435,240,128,112,131.95571762091706,0.39462259457203847,0.8901479979400881,0.09182721810121931,17610445.682686172,317359.7995366026,17927805.482222773,2090,3,1387.215503875969,139,506,94,34.23216750817872,0.6419364508393286,37.693452380952365,134273.77884796172,965.9984089781418,0
2092,512.0063135343431,0,0,645,0.0,0.0,1.0,645,18300,13400,4900,0.73224043715847,232,134,98,135.2531022216094,0.39439248399056287,0.8927567159659286,0.09444963813903916,17629598.29901329,329591.5721724676,17959189.871185757,2091,4,1388.215503875969,144,501,99,34.02969786562272,0.6424334490740741,37.579022988505734,134361.19703373485,933.0638682898253,0
2093,511.8961192063418,0,0,645,0.0,0.0,1.0,645,17850,13000,4850,0.7282913165266106,227,130,97,137.03545964617098,0.3946125635963857,0.8946555511223053,0.09598285688610331,17639087.2084125,336586.08466874115,17975673.29308124,2092,5,1389.215503875969,104,541,104,33.88270601869348,0.6504407051282051,37.480158730158735,134382.88796069683,1292.1431534682388,0
2094,512.299478109696,1,1,645,0.0015479876160990713,0.0015479876160990713,0.9984520123839009,646,18450,13100,5350,0.7100271002710027,238,131,107,134.26360021688924,0.3948504411964704,0.8926831661430112,0.09439668776568849,17669600.544436797,326826.8366980773,17996427.381134875,2093,0,1388.06346749226,108,538,108,33.830307220221,0.6507523148148149,37.356651376146786,134552.05042898274,1245.8523187868773,0
2095,511.82399514580686,0,0,645,0.0,0.0,1.0,645,16350,11600,4750,0.709480122324159,211,116,95,131.90594951008657,0.39507509188373696,0.8906558106647693,0.09308513840641827,17669555.844620466,320793.9082212304,17990349.752841696,2094,1,1388.5426356589148,113,532,113,33.768988130426195,0.6509033923303835,37.23501461988303,134489.42460168054,1190.1718991299163,0
2096,512.3144589108791,0,0,645,0.0,0.0,1.0,645,19400,14800,4600,0.7628865979381443,240,148,92,130.3640797631362,0.3949061702537435,0.8879971363550505,0.09249781445392852,17710280.518192146,313356.88442021876,18023637.402612366,2095,2,1389.5426356589148,124,521,75,33.63051849269482,0.6506216397849462,37.058333333333316,134708.81768345687,1086.3614329311038,0
2097,512.604319673029,0,0,645,0.0,0.0,1.0,645,18750,14200,4550,0.7573333333333333,233,142,91,130.14084439929312,0.39490055290737797,0.8864082442976153,0.09263159219148655,17734117.24295805,313836.5985349236,18047953.841492973,2096,3,1390.5426356589148,133,512,78,33.53256693658023,0.6502192982456141,36.955845771144276,134837.56972244952,1013.816313702628,0
2098,512.3559125440738,0,0,645,0.0,0.0,1.0,645,18300,13900,4400,0.7595628415300546,227,139,88,130.39001740563796,0.3947194937968446,0.8863195922506744,0.09311332036866016,17739807.19907137,315318.7538919095,18055125.952963278,2097,4,1391.5426356589148,140,505,83,33.418666947407814,0.6502976190476191,36.84988179669028,134826.5189481359,963.0465639152565,0
2099,512.6139508601692,0,2,643,0.0,0.0031007751937984496,0.9968992248062015,645,18450,13100,5350,0.7100271002710027,238,131,107,133.12865676085127,0.39470715569679166,0.8892028491461317,0.09531501834011044,17760000.22285011,325422.99474808533,18085423.217598196,2098,5,1392.5426356589148,141,504,86,33.26203879166204,0.6510047281323876,36.76643192488261,134937.19933000373,957.0014136879697,0
2100,512.9738389842129,0,0,643,0.0,0.0,1.0,643,18050,13600,4450,0.7534626038781164,225,136,89,136.6215833613246,0.3941394383802561,0.8930671323622319,0.09826589595375723,17792437.91262167,339516.20789608295,18131954.120517753,2099,12,1397.7900466562985,142,501,93,33.02023121387283,0.652362089201878,36.61858974358973,135107.7731363057,951.4631911007444,0
2101,513.2390516404233,0,0,643,0.0,0.0,1.0,643,18400,14100,4300,0.7663043478260869,227,141,86,136.23549618087222,0.39414246643701883,0.8920746021925747,0.09828822329301332,17814909.68628061,338404.61210556264,18153314.29838617,2100,13,1398.7900466562985,150,493,101,32.93089228674657,0.6523611111111112,36.52041942604853,135228.01006038836,901.5200670692558,0
2102,513.6344294472714,0,0,643,0.0,0.0,1.0,643,18400,13300,5100,0.7228260869565217,235,133,102,149.8930509401766,0.39396542605162393,0.9008947396725437,0.10795266647897135,17821039.887608595,387250.00793604646,18208289.89554464,2101,14,1399.7900466562985,140,503,90,32.62800198184552,0.6530505952380952,36.576536643026,135303.3603043834,966.4525736027384,8
2103,513.1425239789725,0,0,643,0.0,0.0,1.0,643,17200,13000,4200,0.7558139534883721,214,130,84,167.41786180287258,0.3939689587845138,0.910345452775638,0.11413862695550836,17561697.53535898,442228.37019971246,18003925.905558694,2102,15,1400.7900466562985,99,544,99,33.99493019058234,0.6426767676767677,38.374999999999986,134250.91283599794,1356.0698266262418,8
2104,513.1991617812068,0,0,643,0.0,0.0,1.0,643,19850,15600,4250,0.7858942065491183,241,156,85,166.410628368468,0.39405152379891123,0.9101030968715267,0.11398621633547892,17584716.289859183,436806.7374953332,18021523.027354516,2103,16,1401.7900466562985,102,541,97,33.861712059751454,0.643484477124183,38.21804207119738,134346.28137850304,1317.1204056715985,0
2105,513.4137230421037,0,0,643,0.0,0.0,1.0,643,17300,12500,4800,0.7225433526011561,221,125,96,164.27825777969286,0.3941461001051341,0.9085668536281715,0.11298304168050195,17610229.455542892,432695.56281143776,18042925.01835433,2104,17,1402.7900466562985,108,535,68,33.780223422240084,0.6434220679012346,38.08295107033637,134471.80721917818,1245.1093261035016,0
2106,513.2908440611949,0,0,643,0.0,0.0,1.0,643,17900,12600,5300,0.7039106145251397,232,126,106,162.49410425447542,0.3944085316912383,0.9070631498535524,0.11221209766227017,17624197.90869289,426265.65047532733,18050463.559168216,2105,18,1403.7900466562985,113,530,75,33.68953909364571,0.6437131268436578,37.94773391812864,134509.02884531187,1190.3453880116094,0
2107,512.7384191691976,0,0,643,0.0,0.0,1.0,643,17650,13000,4650,0.7365439093484419,223,130,93,161.33764219801077,0.3944262962909131,0.9070572098237335,0.11176242318082286,17619143.633298524,422276.2182688888,18041419.851567414,2106,19,1404.7900466562985,114,529,80,33.614643079261924,0.6445540935672515,37.8442028985507,134417.34898183655,1179.0995524722505,0
2108,512.4643652594591,0,0,643,0.0,0.0,1.0,643,17600,13400,4200,0.7613636363636364,218,134,84,168.33520840037167,0.39451481648361053,0.9098998961666513,0.11780542735851515,17654904.109308083,448188.39250578784,18103092.50181387,2107,20,1405.7900466562985,127,516,94,33.08947579186685,0.6455872703412073,37.50813802083332,134517.72543492648,1059.194688463988,8
2109,512.1821302217649,0,0,643,0.0,0.0,1.0,643,19350,13900,5450,0.7183462532299741,248,139,109,168.5885832487143,0.3943467593332784,0.9093257201630773,0.11836051180536446,17659271.65892956,447480.3180366266,18106751.976966187,2108,21,1406.7900466562985,96,547,96,32.97627080521817,0.6533203125,37.40335051546394,134497.31132208896,1401.0136596050934,0
2110,512.115636483106,1,0,644,0.0015527950310559005,0.0,1.0,644,19450,14600,4850,0.7506426735218509,243,146,97,165.06405220051482,0.394698672034234,0.9064040047849307,0.11629695915413031,17672545.723598972,435170.4019672266,18107716.1255662,2109,0,1405.6040372670807,102,542,102,32.95118438105504,0.6528799019607843,37.28762135922331,134539.11699961245,1319.0109509765928,0
2111,511.6187245228165,0,0,644,0.0,0.0,1.0,644,19050,13800,5250,0.7244094488188977,243,138,105,165.1845678119176,0.3947362039514568,0.907076933392162,0.11682861557952419,17672192.54692747,435984.6976306455,18108177.244558115,2110,1,1406.6040372670807,104,540,95,32.8210318059435,0.6536458333333333,37.16269841269843,134472.48499511505,1293.0046634145679,0
2112,511.69325390882364,0,0,644,0.0,0.0,1.0,644,18950,13700,5250,0.7229551451187335,242,137,105,162.63407491078266,0.39461098016865814,0.9056707354377682,0.11535321740191776,17687242.492191393,427559.66408804996,18114802.156279445,2111,2,1407.6040372670807,108,536,74,32.79381565078323,0.6536458333333333,37.06995412844038,134539.5307224154,1245.7363955779203,0
2113,511.51520231227994,0,0,644,0.0,0.0,1.0,644,18300,14100,4200,0.7704918032786885,225,141,84,159.42013982146818,0.39445340648937915,0.9031259618247063,0.1134371052718079,17695097.07820012,417090.97007222456,18112188.048272345,2112,3,1408.6040372670807,116,528,77,32.77251726238832,0.6530172413793103,36.96581196581197,134545.98590735428,1159.8791888565024,0
2114,511.79112089885837,0,0,644,0.0,0.0,1.0,644,18950,14800,4150,0.7810026385224275,231,148,83,157.17221656775607,0.39445597234430996,0.9031381086807762,0.11229148096228678,17722292.003874782,409340.38338200515,18131632.387256786,2113,4,1409.6040372670807,118,526,82,32.69850707379812,0.653954802259887,36.83473389355743,134685.64652226286,1141.4037840869735,0
2115,512.1832012409791,0,0,644,0.0,0.0,1.0,644,16800,12000,4800,0.7142857142857143,216,120,96,158.52330594910015,0.3944573307380968,0.9039739879954056,0.11366458320180158,17751505.731731176,417205.474833685,18168711.206564862,2114,5,1410.6040372670807,123,521,86,32.54512858555887,0.6542174796747968,36.71875,134848.23345172644,1096.3271012335483,0
2116,511.859244665396,0,1,643,0.0,0.0015527950310559005,0.9984472049689441,644,18100,13300,4800,0.7348066298342542,229,133,96,161.99502254051706,0.39440631550476707,0.90602176750329,0.11654066266489989,17754699.48696671,428334.5887182527,18183034.075684965,2115,6,1411.6040372670807,128,516,89,32.34499867149016,0.6544596354166667,36.61175710594314,134817.70706149717,1053.2633364179467,0
2117,512.1760139937104,0,0,643,0.0,0.0,1.0,643,19200,14900,4300,0.7760416666666666,235,149,86,162.07387269032483,0.3941069372376693,0.9063818941410238,0.11698836274218515,17780187.66291956,428540.77433802036,18208728.43725758,2116,7,1414.755832037325,135,508,94,32.23371218727595,0.6544753086419752,36.50428921568627,134956.18285394905,999.6754285477707,0
2118,511.98882209738576,0,0,643,0.0,0.0,1.0,643,15800,10600,5200,0.6708860759493671,210,106,104,162.89711019859863,0.39402719840958383,0.9076686134145506,0.11779083319074865,17781338.62581258,434905.7355215186,18216244.361334097,2117,8,1415.755832037325,96,547,96,32.15440197756228,0.6629774305555556,36.447594501718214,134935.885651998,1405.5821422083125,0
2119,511.8380099440488,0,0,643,0.0,0.0,1.0,643,16000,12000,4000,0.75,200,120,80,159.65753900905833,0.3940063048179209,0.9086187814110411,0.11386976423624287,17716374.82267925,421110.56087020616,18137485.38354946,2118,9,1416.755832037325,105,538,74,32.68998530913077,0.6561507936507937,36.89072327044027,134669.32859907678,1282.5650342769218,8
2120,511.8241448829426,0,0,643,0.0,0.0,1.0,643,16550,12400,4150,0.7492447129909365,207,124,83,162.30466530905179,0.3939896505057259,0.9101708337786949,0.11601650771985555,17725617.412872236,430240.0803185104,18155857.493190747,2119,10,1417.755832037325,106,537,75,32.54697787970703,0.6566430817610063,36.81853582554519,134702.62785013215,1270.7795080201147,0
2121,511.9505372813661,0,0,643,0.0,0.0,1.0,643,18750,12500,6250,0.6666666666666666,250,125,125,164.27484377918094,0.39384400097543804,0.9111967438339561,0.11772961765344075,17741267.62825651,435538.79361529415,18176806.421871804,2120,11,1418.755832037325,112,531,75,32.410098392800855,0.6561569940476191,36.7348820058997,134778.7186045216,1203.3814161118,0
2122,511.9672386819187,0,0,643,0.0,0.0,1.0,643,20450,15500,4950,0.7579462102689487,254,155,99,165.11214877024685,0.39366504282076004,0.912081883227704,0.118785980759875,17758548.69665007,437380.4268689908,18195929.12351906,2121,12,1419.755832037325,115,528,81,32.26211886172759,0.6567934782608695,36.61099137931034,134846.5434427024,1172.5786386321947,0
2123,512.454235266153,0,0,643,0.0,0.0,1.0,643,16750,11600,5150,0.6925373134328359,219,116,103,163.3117882354388,0.3936054910377595,0.9111725417179497,0.11782933971555497,17787914.457002427,435645.2237904163,18223559.680792842,2122,13,1420.755832037325,120,523,87,32.21563310026357,0.6567708333333333,36.518595041322314,135022.1618849508,1125.18468237459,0
2124,512.020873973224,1,0,644,0.0015527950310559005,0.0,1.0,644,20500,15800,4700,0.7707317073170732,252,158,94,159.7929770995473,0.39359807120156876,0.9101450831380535,0.11587603462357289,17794755.889444545,419395.4040668037,18214151.29351135,2123,0,1419.5481366459628,91,553,91,32.14359208360172,0.6654075091575091,36.35643115942026,134991.01053517216,1483.4176981887051,0
2125,512.1952535992034,0,0,644,0.0,0.0,1.0,644,18750,14100,4650,0.752,234,141,93,160.6815359089494,0.3934354161233091,0.9100692512371382,0.11694990457760195,17816672.614006385,425012.06408108736,18241684.678087473,2124,1,1420.5481366459628,94,550,94,32.00088339222616,0.6656693262411347,36.23903508771927,135097.11431281499,1437.203343753351,0
2126,512.3042696182101,0,0,644,0.0,0.0,1.0,644,18400,13200,5200,0.717391304347826,236,132,104,161.07673773044874,0.39336261627850816,0.9096156608614263,0.11789030562143539,17844327.167800877,427661.2014368339,18271988.36923771,2125,2,1421.5481366459628,99,545,86,31.811080853526956,0.6660353535353536,36.062499999999986,135216.30816235568,1365.8212945692492,0
2127,511.9752655988653,1,0,645,0.0015503875968992248,0.0,1.0,645,19200,14800,4400,0.7708333333333334,236,148,88,161.0267755959015,0.39376334119761824,0.9095460003235531,0.11849011678464234,17855915.79298584,426856.1090912871,18282771.902077127,2126,0,1420.3426356589148,102,543,77,31.639144170017197,0.6669730392156863,35.891990291262125,135216.76841741832,1325.6545923276306,0
2128,512.1818033127767,0,0,645,0.0,0.0,1.0,645,16600,11200,5400,0.6746987951807228,220,112,108,161.29036834242498,0.3937152928242413,0.9100139409783368,0.11911787448113623,17878695.090873886,431132.2633377911,18309827.354211677,2127,1,1421.3426356589148,106,539,79,31.515204549083233,0.6671580188679245,35.776869158878505,135330.2796311533,1276.7007512372952,0
2129,512.2146619529891,0,1,644,0.0,0.0015503875968992248,0.9984496124031008,645,17600,11600,6000,0.6590909090909091,236,116,120,158.8197508944654,0.39343111528399693,0.909185956749808,0.11778554763208887,17897679.71639405,421901.0068293269,18319580.723223373,2128,2,1422.3426356589148,113,532,81,31.446624439758974,0.6669432153392331,35.64510233918129,135406.45454095362,1198.287208327023,0
2130,511.9824080497457,0,0,644,0.0,0.0,1.0,644,18050,13200,4850,0.7313019390581718,229,132,97,157.13078073292118,0.39329685995704655,0.9062091104039309,0.10693236317134056,17513907.909129385,403544.80468918895,17917452.713818572,2129,3,1425.4378881987577,97,547,97,34.32538876246208,0.6426116838487972,38.43537414965983,133916.48700348605,1380.5823402421242,8
2131,511.59161448765536,0,0,644,0.0,0.0,1.0,644,18100,12600,5500,0.6961325966850829,236,126,110,156.6800454625275,0.39330722399853174,0.9058945502053468,0.10701057317686831,17516682.046268597,402002.90787239315,17918684.95414099,2130,4,1426.4378881987577,100,544,100,34.21468358754056,0.6430208333333334,38.31476897689765,133875.96982668215,1338.7596982668215,0
2132,511.5933130450536,0,0,644,0.0,0.0,1.0,644,17750,12600,5150,0.7098591549295775,229,126,103,159.5243103880675,0.3932303489723701,0.9049901978374255,0.10689563231351912,17430934.27649735,409581.5539755967,17840515.830472946,2131,5,1427.4378881987577,112,532,79,34.79221107893685,0.6337425595238095,38.95648967551624,133548.11429581416,1192.3938776411978,8
2133,512.013921425399,1,0,645,0.0015503875968992248,0.0,1.0,645,16850,11700,5150,0.6943620178041543,220,117,103,161.21720232845018,0.39343111528399693,0.9063850759008161,0.10844546274490022,17462634.706444737,417205.4225313448,17879840.12897608,2132,0,1426.2232558139535,116,529,82,34.61600193170846,0.6342492816091954,38.82656695156696,133724.4336272625,1152.796841614332,0
2134,512.2845230593301,0,0,645,0.0,0.0,1.0,645,18450,13400,5050,0.7262872628726287,235,134,101,159.46662269037682,0.39355740526746597,0.9072245090425113,0.10042980874757369,17167958.43910729,400093.2701546337,17568051.709261924,2133,1,1427.2232558139535,109,536,72,36.97949053245059,0.6126720183486238,41.107954545454525,132626.38802953507,1216.7558534819732,8
2135,512.5455075608415,0,0,645,0.0,0.0,1.0,645,18300,12900,5400,0.7049180327868853,237,129,108,161.32619476835325,0.39380226138315116,0.907503251363232,0.10193059004827235,17191938.584014554,407402.0064900626,17599340.590504616,2134,2,1428.2232558139535,115,530,76,36.81471674236379,0.612590579710145,40.99317528735633,132752.78443406447,1154.3720385570823,0
2136,512.2521411280884,1,0,646,0.0015479876160990713,0.0,1.0,646,17300,12500,4800,0.7225433526011561,221,125,96,161.54738382249107,0.3943764949880401,0.9077691416069988,0.10250384185363703,17201974.00442815,409286.7793995713,17611260.78382772,2135,0,1427.0108359133128,123,523,81,36.65680713128041,0.6126355013550135,40.84341397849462,132753.5160769612,1079.2968786744814,0
2137,512.7263492147465,1,0,647,0.0015455950540958269,0.0,1.0,647,16650,12800,3850,0.7687687687687688,205,128,77,160.03622795719312,0.39495665873931124,0.9076332165047976,0.10190004462019445,17234245.31522746,405570.72238758183,17639816.037615042,2136,0,1425.8037094281299,130,517,87,36.57100724793244,0.6127403846153846,40.72041984732823,132939.47255761066,1022.6113273662359,0
2138,513.1716842935142,0,0,647,0.0,0.0,1.0,647,16850,11400,5450,0.6765578635014837,223,114,109,160.80385800228976,0.39518255646845085,0.9094802703860247,0.10266707857069303,17261912.75926773,408906.43363784236,17670819.19290557,2137,1,1426.8037094281299,99,548,90,36.45414993306555,0.619949494949495,40.62500000000001,133103.9056136307,1344.4838950871788,0
2139,512.8872682593989,1,0,648,0.0015432098765432098,0.0,1.0,648,19300,14000,5300,0.7253886010362695,246,140,106,154.58107263695194,0.3956817254851451,0.9054000085457379,0.09950324943967455,17290406.290608983,385653.9101462083,17676060.20075519,2138,0,1425.6003086419753,101,547,90,36.325185505650396,0.6223184818481848,40.3390522875817,133176.79414586892,1318.5821202561278,0
2140,512.4431453647522,1,0,649,0.0015408320493066256,0.0,1.0,649,16750,11500,5250,0.6865671641791045,220,115,105,155.60446116481694,0.3961017305826628,0.9056354545067704,0.10057196064677855,17294387.370988626,391666.7656076622,17686054.13659629,2139,0,1424.402157164869,106,543,70,36.15399507875245,0.6225432389937107,40.19665109034269,133134.44529156157,1255.9853329392602,0
2141,512.776631074292,0,0,649,0.0,0.0,1.0,649,19950,15000,4950,0.7518796992481203,249,150,99,157.6595231330513,0.39629403736042157,0.9062477594079288,0.10235121749024269,17326095.344849184,396574.7859653409,17722670.130814526,2140,1,1425.402157164869,110,539,76,35.94470115398966,0.6232007575757577,40.04316816816817,133299.78845147317,1211.816258649756,0
2142,512.5698187407728,1,0,650,0.0015384615384615385,0.0,1.0,650,16650,11600,5050,0.6966966966966966,217,116,101,159.01304234500927,0.39687892615858716,0.9072407173834633,0.10361918371681268,17336489.565713163,404695.58988530596,17741185.15559847,2141,0,1424.2076923076922,116,534,79,35.77702278665888,0.6232938218390804,39.912749287749264,133312.87495436292,1149.24892202037,0
2143,512.4879677964029,1,0,651,0.0015360983102918587,0.0,1.0,651,19150,13700,5450,0.7154046997389034,246,137,109,158.71156097937035,0.39736815156169997,0.9074153410411685,0.10379090528261319,17350093.802275367,401382.0940995163,17751475.896374885,2142,0,1423.0184331797236,120,531,85,35.66011050089323,0.6237847222222221,39.78994490358124,133354.52233655172,1111.287686137931,0
2144,512.6453260731707,2,0,653,0.0030627871362940277,0.0,1.0,653,17150,11500,5650,0.6705539358600583,228,115,113,158.78273133133115,0.39787587648011224,0.9083103889159538,0.10428938459214258,17375388.871049415,404032.3405778469,17779421.211627264,2143,0,1419.656967840735,127,526,91,35.50623704143616,0.6240977690288714,39.640299479166664,133472.18356981542,1050.9620753528773,0
2145,512.9305420787512,1,0,654,0.0015290519877675841,0.0,1.0,654,16700,11000,5700,0.6586826347305389,224,110,114,155.98290457355463,0.39823525819045785,0.9068779978661097,0.10274876066070082,17398402.58226221,395270.67394426034,17793673.25620647,2144,0,1418.4847094801223,96,558,96,35.47765317061103,0.6317274305555556,39.54037800687286,133597.69509856164,1391.6426572766838,0
2146,513.1647470648414,0,0,654,0.0,0.0,1.0,654,16650,11500,5150,0.6906906906906907,218,115,103,152.47785835728016,0.39830077365815736,0.9038738932531738,0.10095509815429661,17429784.795985643,384081.25146403845,17813866.047449682,2145,1,1419.4847094801223,104,550,104,35.390973913926125,0.6314102564102564,39.36507936507938,133748.653123885,1286.0447415758172,0
2147,513.1088567251529,1,0,655,0.0015267175572519084,0.0,1.0,655,16500,11600,4900,0.703030303030303,214,116,98,149.72797917452303,0.3985529448840955,0.9009630592279521,0.09963625989587042,17450945.969992977,375078.9749541677,17826024.944947146,2146,0,1418.316030534351,111,544,99,35.2876934598103,0.6315690690690691,39.192708333333336,133822.53125266705,1205.6083896636671,0
2148,513.4777779164447,2,3,654,0.0030441400304414,0.0045662100456621,0.995433789954338,657,16950,12000,4950,0.7079646017699115,219,120,99,151.8439064222012,0.3990395026667162,0.9018509698762673,0.1014450205910266,17481531.202348016,382542.7976012294,17864073.999949247,2147,0,1414.9954337899544,116,541,77,35.095803905512604,0.6319145114942528,39.058048433048455,133987.89345578008,1155.068047032587,0
2149,513.4852417532635,1,0,655,0.0015267175572519084,0.0,1.0,655,18500,13100,5400,0.7081081081081081,239,131,108,149.7599395290467,0.39899356864392926,0.90058281501262,0.1003828560185423,17496764.220211312,374562.8703145717,17871327.090525884,2148,0,1418.5832061068702,120,535,82,35.03674207448445,0.6322916666666667,38.946280991735556,134047.23201554848,1117.0602667962373,0
2150,513.396426730177,0,1,654,0.0,0.0015267175572519084,0.9984732824427481,655,18600,13900,4700,0.7473118279569892,233,139,94,154.11756508025965,0.399203570122402,0.9037529819891148,0.09765537839548696,17233953.426901888,381610.98777214007,17615564.41467403,2149,1,1419.5832061068702,120,535,87,36.89856191995034,0.6126736111111111,40.8918732782369,133025.18639570227,1108.5432199641857,8
2151,513.1558976719766,0,1,653,0.0,0.0015290519877675841,0.9984709480122325,654,17400,11800,5600,0.6781609195402298,230,118,112,159.59850710108628,0.39945258729021393,0.9082051130919391,0.10202488731436474,17267219.938280508,402964.5047871419,17670184.44306765,2150,2,1420.3593272171254,94,560,94,36.44085407949054,0.6217863475177305,40.58114035087722,133122.31779628745,1416.1948701732706,8
2152,512.9144581761203,0,0,653,0.0,0.0,1.0,653,17400,12000,5400,0.6896551724137931,228,120,108,162.39332847834808,0.39953625629077066,0.9093890095123309,0.1041912491636109,17276126.46007587,413105.5358129206,17689231.995888792,2151,3,1423.1163859111791,96,557,96,36.238311473375006,0.6225043402777778,40.4531786941581,133125.31722142125,1386.7220543898047,0
2153,512.6716790467501,0,1,652,0.0,0.0015313935681470138,0.998468606431853,653,18150,12400,5750,0.6831955922865014,239,124,115,159.80923685508458,0.399720634197365,0.9069988637075945,0.10318508468557182,17297403.081701,404106.9572122862,17701510.038913287,2152,4,1424.1163859111791,105,548,89,36.080584348440105,0.6224206349206349,40.231918238993714,133175.7386391688,1268.3403679920837,0
2154,512.8083798035672,0,0,652,0.0,0.0,1.0,652,17550,12400,5150,0.7065527065527065,227,124,103,158.5009559796786,0.39979260513163645,0.9065725562312013,0.10273098185946994,17319674.299769085,401086.98675401654,17720761.2865231,2153,5,1426.3895705521472,108,544,75,35.979938839044955,0.623070987654321,40.0993883792049,133279.21155521675,1234.0667736594144,0
2155,513.2292252558515,2,0,654,0.0030581039755351682,0.0,1.0,654,16250,11800,4450,0.7261538461538461,207,118,89,158.46548613383746,0.4002946781341663,0.90716908269981,0.10324528031224971,17358027.747199506,403079.6610569181,17761107.408256423,2154,0,1423.0244648318044,114,540,81,35.797083783187624,0.6236293859649122,39.91847826086955,133481.43790553586,1170.889806188911,0
2156,513.2314378713644,2,0,656,0.003048780487804878,0.0,1.0,656,17600,12000,5600,0.6818181818181818,232,120,112,153.3785904929922,0.40100641756656114,0.9086211650682887,0.09921876455542587,17324989.699292228,382656.5000766142,17707646.199368842,2155,0,1419.6829268292684,99,557,70,36.1813796236904,0.6245791245791246,40.166666666666686,133354.63527357712,1347.0165179149203,8
2157,513.3279009682872,1,0,657,0.0015220700152207,0.0,1.0,657,19650,14300,5350,0.727735368956743,250,143,107,151.75400490073548,0.40142402101817826,0.9075958851105581,0.09860687238148569,17348923.914225366,375503.7369403709,17724427.65116574,2156,0,1418.5205479452054,106,551,74,36.06625539828753,0.6244103773584906,40.011682242990666,133459.25743048228,1259.0495984007762,0
2158,512.918529415739,1,0,658,0.001519756838905775,0.0,1.0,658,19300,14000,5300,0.7253886010362695,246,140,106,180.2849082124924,0.4018270623123436,0.9194833052063787,0.11207573326205089,17127788.28755603,466676.34786100325,17594464.635417033,2157,0,1417.3632218844984,86,572,86,36.91179423029403,0.6143410852713178,41.570881226053615,132553.0835597368,1541.3149251132188,8
2159,512.4904352996582,0,1,657,0.0,0.001519756838905775,0.9984802431610942,658,19400,14200,5200,0.7319587628865979,246,142,104,179.53846680095245,0.40217230387734615,0.9192912590410947,0.1120723354791855,17133003.396975704,464206.6323177002,17597210.029293403,2158,1,1418.3632218844984,89,569,89,36.78117026990733,0.6148174157303371,41.423611111111086,132517.9260998792,1488.9654617963956,0
2160,512.2047585880689,1,0,658,0.001519756838905775,0.0,1.0,658,18500,12700,5800,0.6864864864864865,243,127,116,161.54275198665715,0.40258925390811134,0.9085787326108212,0.10094693943047363,17128511.97547603,403297.39239095896,17531809.36786699,2159,0,1418.483282674772,99,559,91,37.207685517111706,0.6122685185185186,41.38541666666665,132463.62022360324,1338.0163658949823,8
2161,512.6008085825106,3,3,658,0.0045385779122541605,0.0045385779122541605,0.9954614220877458,661,17600,12400,5200,0.7045454545454546,228,124,104,159.49737642732896,0.403589602530601,0.9077652239547143,0.10006493730540829,17160494.594289824,397610.77319691563,17558105.36748674,2160,0,1413.0408472012102,105,556,72,37.11701511526338,0.6122023809523809,41.2441037735849,132638.48163115207,1263.2236345824006,0
2162,513.0649499400427,2,1,659,0.0030303030303030303,0.0015151515151515152,0.9984848484848485,660,18900,14300,4600,0.7566137566137566,235,143,92,161.05523552167875,0.40372005334069067,0.9095413775071592,0.10178333646000183,17210468.403598383,403467.20843597926,17613935.61203436,2161,0,1416.178787878788,109,551,78,36.81327386175293,0.613914373088685,40.98484848484844,132891.59574583132,1219.1889517966176,0
2163,513.4687481163762,0,1,658,0.0,0.0015174506828528073,0.9984825493171472,659,18550,12600,5950,0.6792452830188679,245,126,119,161.09793161652627,0.4038270467519329,0.9093679860082362,0.10201204644736495,17233323.69560557,404900.56044802227,17638224.25605359,2162,1,1419.320182094082,114,545,79,36.741046976424336,0.613578216374269,40.91485507246375,133032.12502149108,1166.948465100799,0
2164,513.1966656395293,0,0,658,0.0,0.0,1.0,658,19100,14000,5100,0.7329842931937173,242,140,102,164.13726688782344,0.40397585853538925,0.9118501548291429,0.1043415653655751,17242438.68276747,415325.35197406274,17657764.034741532,2163,2,1422.30547112462,115,543,82,36.522853373517556,0.6147644927536232,40.77765804597699,133032.04155007345,1156.8003613049866,0
2165,513.2733518887453,0,0,658,0.0,0.0,1.0,658,18300,13200,5100,0.7213114754098361,234,132,102,170.3574147695563,0.4042927154993608,0.9142628412968281,0.10880332351633067,17266908.538028408,438409.17992018315,17705317.71794859,2164,3,1423.30547112462,87,571,87,36.1943157790657,0.6236829501915708,40.6131628787879,133136.35132502532,1530.3028887933945,0
2166,512.7192143008533,1,2,657,0.0015174506828528073,0.0030349013657056147,0.9969650986342944,659,17600,13000,4600,0.7386363636363636,222,130,92,166.9211517053314,0.40445451337801125,0.9129506146869923,0.10706091294526213,17268011.241882,427079.264831117,17695090.50671312,2165,0,1422.144157814871,90,569,90,36.13255119892972,0.6241898148148148,40.46474358974362,133068.71275003854,1478.541252778206,0
2167,512.7633580485721,0,0,657,0.0,0.0,1.0,657,17150,12500,4650,0.7288629737609329,218,125,93,174.5628444863815,0.4042023981883654,0.9134652333323281,0.11821754895412194,17518673.00317638,463071.87821224984,17981744.88138863,2166,1,1427.3744292237443,126,531,90,34.03599257399848,0.6347552910052909,38.599081364829395,134036.8128363517,1063.784228859934,8
2168,512.8390148089536,1,0,658,0.001519756838905775,0.0,1.0,658,18900,14100,4800,0.746031746031746,237,141,96,172.5716446296723,0.4043896761398947,0.9122096220376603,0.1175472939392569,17547301.187268652,455133.32493982516,18002434.512208477,2167,0,1426.2036474164133,98,560,98,33.89049218351969,0.6426445578231292,38.40488215488213,134156.18251452115,1368.940637903277,0
2169,512.417901923905,0,0,658,0.0,0.0,1.0,658,16850,11400,5450,0.6765578635014837,223,114,109,169.26743142668025,0.40462253588893055,0.910370524199531,0.11566235339393106,17547095.28527199,445580.3495874349,17992675.634859428,2168,1,1427.2036474164133,102,556,102,33.86920173641973,0.6426674836601307,38.2989482200647,134100.30388435244,1314.7088616112985,0
2170,512.7080794592498,1,1,658,0.0015174506828528073,0.0015174506828528073,0.9984825493171472,659,19050,13500,5550,0.7086614173228346,246,135,111,170.76837046457186,0.40480658653543106,0.910561637867376,0.11712173281028929,17573646.17258825,449354.5840027687,18023000.756591022,2169,0,1426.0364188163885,107,552,90,33.704014096613335,0.6427180685358256,38.175154320987644,134239.7137828004,1254.5767643252373,0
2171,512.3600506571531,0,0,658,0.0,0.0,1.0,658,18500,13000,5500,0.7027027027027027,240,130,110,168.06400408719173,0.4049430553820674,0.9088749777088407,0.11559434878066754,17574383.286785007,440624.2449080213,18015007.531693026,2170,1,1428.29179331307,112,546,69,33.67883245932025,0.642578125,38.08075221238938,134196.9590645435,1198.1871345048528,0
2172,511.87881217077575,0,1,657,0.0,0.001519756838905775,0.9984802431610942,658,18600,13200,5400,0.7096774193548387,240,132,108,167.1019839723989,0.4050053665690507,0.9084968315557163,0.11549015235765472,17579412.66249167,437310.9465943716,18016723.609086044,2171,2,1429.29179331307,118,540,76,33.54076207971498,0.6430084745762712,37.92016806722688,134153.11306366388,1136.8907886751176,0
2173,511.61265857071,0,0,657,0.0,0.0,1.0,657,18100,12700,5400,0.7016574585635359,235,127,108,165.6594009034697,0.4048825152207001,0.9074762869555568,0.114745731818458,17580054.356057573,432960.25449498434,18013014.610552557,2172,5,1432.4642313546424,122,535,80,33.50441501103754,0.6430157103825136,37.847222222222214,134120.67959058494,1099.3498327097127,0
2174,511.24077337170837,1,0,658,0.001519756838905775,0.0,1.0,658,17600,12200,5400,0.6931818181818182,230,122,108,165.38289448416214,0.40522078111337806,0.9095296072203172,0.11507713154054613,17587434.714159466,432532.1719157846,18019966.88607525,2173,0,1431.2857142857142,126,532,84,33.35880498228059,0.6438492063492063,37.696850393700785,134100.06506255924,1064.286230655232,0
2175,511.260589853668,0,0,658,0.0,0.0,1.0,658,20000,14200,5800,0.71,258,142,116,164.21580869467093,0.4051856015569219,0.9090289553671429,0.11456516238140481,17599701.08871654,426429.82941360737,18026130.91813015,2174,1,1432.2857142857142,131,527,89,33.301629072681656,0.6439249363867685,37.61047979797978,134149.42086990437,1024.0413806862928,0
2176,511.6197044978211,0,0,658,0.0,0.0,1.0,658,18650,13600,5050,0.7292225201072386,237,136,101,163.10200175177596,0.4051859870863077,0.9082695645078531,0.11420839629327027,17628325.170764506,424793.024576587,18053118.19534109,2175,2,1433.2857142857142,97,561,97,33.20776983709223,0.6521692439862543,37.48937074829934,134305.61056529335,1384.5939233535396,0
2177,511.37633911872524,0,0,658,0.0,0.0,1.0,658,18200,12900,5300,0.7087912087912088,235,129,106,161.31518525936573,0.40514116929520605,0.9069389112344299,0.11355635454957394,17643197.362104446,419423.1302070898,18062620.492311537,2176,3,1434.2857142857142,101,557,101,33.07868750485966,0.6528465346534653,37.31617647058825,134330.2920221808,1330.0028913087208,0
2178,511.65066486813225,0,0,658,0.0,0.0,1.0,658,16850,12000,4850,0.712166172106825,217,120,97,160.04798602353915,0.40531952482732136,0.9119827532408002,0.1059025760525464,17375573.50852291,407735.10920860857,17783308.61773152,2177,4,1435.2857142857142,94,564,94,35.21488976775494,0.6338652482269503,39.38596491228069,133343.3443265979,1418.5462162404033,8
2179,511.91159970037916,1,0,659,0.0015174506828528073,0.0,1.0,659,17950,13000,4950,0.724233983286908,229,130,99,157.08445333865762,0.4057362556942836,0.9096355263162486,0.10462387043082674,17414238.95135582,397351.24119649816,17811590.192552317,2178,0,1434.1062215477998,103,556,70,35.06531116401709,0.6336974110032363,39.162660256410255,133525.65984973236,1296.3656296090521,0
2180,511.5693798347927,0,0,659,0.0,0.0,1.0,659,18700,13900,4800,0.7433155080213903,235,139,96,158.68469918631016,0.4058678026791384,0.9106171186697125,0.10612186333621335,17421115.25215256,402392.886655575,17823508.138808135,2179,1,1435.1062215477998,107,552,71,34.882628674206025,0.6341510903426791,39.023919753086425,133507.37152362903,1247.7324441460657,0
2181,511.4501811563601,0,0,659,0.0,0.0,1.0,659,20050,14200,5850,0.7082294264339152,259,142,117,160.4817981783797,0.4060012714607039,0.9112567875995528,0.10780232849619513,17437191.89426382,407820.38207458385,17845012.276338402,2180,2,1436.1062215477998,109,550,78,34.68249471139317,0.6352255351681957,38.873106060606055,133553.3972101004,1225.2605248633065,0
2182,511.81772944813196,0,0,659,0.0,0.0,1.0,659,16500,11000,5500,0.6666666666666666,220,110,110,158.37770505300065,0.40591488669855313,0.9094647922624672,0.10676605474575199,17465707.729968596,404935.74147977686,17870643.471448373,2181,3,1437.1062215477998,117,542,84,34.61596945326754,0.6347934472934473,38.75353107344633,133710.57455233103,1142.8254235241968,0
2183,511.7960282520128,0,2,657,0.0,0.0030349013657056147,0.9969650986342944,659,18400,13200,5200,0.717391304347826,236,132,104,155.87913600441658,0.40587251108107986,0.9080374378682665,0.1055093867051049,17483271.41569593,394855.44856188225,17878126.864257812,2182,4,1438.1062215477998,124,535,92,34.54224585007123,0.6349126344086021,38.61666666666668,133774.95185127284,1078.8302568651036,0
2184,511.62688230348994,0,0,657,0.0,0.0,1.0,657,17450,12200,5250,0.6991404011461319,227,122,105,149.15976554180128,0.40537682060610564,0.8991030392415706,0.10286065892727646,17560876.393460725,375025.241111422,17935901.63457215,2183,5,1443.2176560121766,115,542,83,34.085816739212376,0.6428442028985507,37.99389367816088,134049.36732191697,1165.6466723644953,8
2185,511.2229000046071,1,0,658,0.001519756838905775,0.0,1.0,658,17500,13000,4500,0.7428571428571429,220,130,90,164.04180775704634,0.40564780309934784,0.9139177361760131,0.11371210539713356,17570045.925473366,427344.41919778584,17997390.344671153,2184,0,1442.0227963525836,109,549,73,33.52115389246072,0.6458333333333333,37.82196969696966,134031.41296900867,1229.645990541364,8
2186,511.2891633068158,0,0,658,0.0,0.0,1.0,658,18750,13800,4950,0.736,237,138,99,161.0948521430511,0.4056576340986862,0.9120026754131958,0.1119592406647625,17583803.129279036,416182.0330447401,17999985.162323777,2185,1,1443.0227963525836,118,540,77,33.511412057897466,0.6448622881355932,37.73634453781511,134092.5649670463,1136.3776692122567,0
2187,510.9607181593614,0,0,658,0.0,0.0,1.0,658,19000,13500,5500,0.7105263157894737,245,135,110,162.11815077105695,0.405468290979075,0.9131614571490267,0.11322175076988605,17594054.288728844,419863.1091708559,18013917.3978997,2186,2,1444.0227963525836,123,535,84,33.32122907263355,0.6455792682926829,37.57560483870966,134088.55741414777,1090.1508732857542,0
2188,510.7300828385657,0,0,658,0.0,0.0,1.0,658,18750,12900,5850,0.688,246,129,117,160.13184105366494,0.40536959545630485,0.9124424215599487,0.11206513048595647,17595181.34986364,413159.75664535863,18008341.106509,2187,3,1445.0227963525836,130,528,88,33.30461815758383,0.6451121794871795,37.50795165394403,134062.5855962468,1031.2506584326677,0
2189,510.7208538255571,0,0,658,0.0,0.0,1.0,658,18100,13600,4500,0.7513812154696132,226,136,90,156.4662909112256,0.4053297895472188,0.9089175868847277,0.11016179974308231,17621329.528293394,401728.814443311,18023058.342736706,2188,4,1446.0227963525836,98,560,98,33.200402547464584,0.6536989795918368,37.31060606060609,134160.95156364693,1368.9893016698666,0
2190,510.96438991028424,1,0,659,0.0015174506828528073,0.0,1.0,659,16100,10600,5500,0.6583850931677019,216,106,110,155.26902427163898,0.4053397890328443,0.9077282310073314,0.10979289856944573,17648681.130817074,400158.69977265847,18048839.830589734,2189,0,1444.8270106221548,103,556,92,33.088527177572004,0.6538228155339806,37.16947115384619,134297.04082167425,1303.8547652589732,0
2191,510.68450835360983,0,0,659,0.0,0.0,1.0,659,18400,13400,5000,0.7282608695652174,234,134,100,152.91312968626798,0.4053925423525559,0.9050956636153662,0.10857850874021986,17657203.311463222,389803.64397251594,18047006.955435738,2190,1,1445.8270106221548,113,546,68,33.01289568782794,0.6529314159292036,37.03399122807018,134292.66690340423,1188.4306805610993,0
2192,510.8668824349294,0,0,659,0.0,0.0,1.0,659,18050,12900,5150,0.7146814404432132,232,129,103,150.72006400608225,0.40546163094430937,0.9042816724964917,0.10732118509951862,17675701.72031684,382966.5789277174,18058668.299244557,2191,2,1446.8270106221548,115,544,73,32.9784540634032,0.6534420289855072,36.943247126436795,134386.98324397372,1168.5824629910758,0
2193,511.35283584075046,0,0,659,0.0,0.0,1.0,659,17300,12700,4600,0.7341040462427746,219,127,92,152.1582356263688,0.4054865182117144,0.9047858657210683,0.10877896223972104,17709902.07207848,389841.4904806481,18099743.562559128,2192,3,1447.8270106221548,122,537,77,32.8094330212054,0.6534323770491803,36.81402439024391,134580.89498156367,1103.122090012817,0
2194,511.50416969141963,0,0,659,0.0,0.0,1.0,659,17900,12600,5300,0.7039106145251397,232,126,106,156.04364374214143,0.4056494865727907,0.9076058229590847,0.11211306197814551,17736740.137937773,403841.1118462579,18140581.24978403,2193,4,1448.8270106221548,127,532,83,32.54429336629579,0.6541994750656168,36.65364583333332,134702.75822928266,1060.651639600651,0
2195,511.5954284992684,0,0,659,0.0,0.0,1.0,659,17950,12700,5250,0.7075208913649025,232,127,105,156.55762657654205,0.4057934291464302,0.9107004743896718,0.10320242856790533,17356444.724827457,393706.75838518137,17750151.48321264,2194,5,1449.8270106221548,91,568,91,35.43731345446114,0.6334706959706959,39.51539855072461,133262.73129590202,1464.425618636286,8
2196,511.7461495462835,0,1,658,0.0,0.0015174506828528073,0.9984825493171472,659,18050,13300,4750,0.7368421052631579,228,133,95,155.89428454641956,0.4058849066698645,0.9099085801084741,0.10315410231345457,17378816.152690254,392001.62207747984,17770817.774767734,2195,6,1450.8270106221548,94,565,94,35.323141058005135,0.6338652482269503,39.38596491228069,133368.22897385992,1418.8109465304246,0
2197,512.0249965468757,0,1,657,0.0,0.001519756838905775,0.9984802431610942,658,19150,13400,5750,0.6997389033942559,249,134,115,151.6611268291547,0.4060115500748698,0.907411954177713,0.10082535856581973,17409693.012328207,377324.73199986975,17787017.744328078,2196,7,1452.661094224924,98,560,86,35.27065512696365,0.6343537414965986,39.22558922558922,133523.01677628089,1362.4797630232742,0
2198,511.54811240487743,0,0,657,0.0,0.0,1.0,657,19000,14100,4900,0.7421052631578947,239,141,98,154.56853201261356,0.40603421873259826,0.9089411753696055,0.10315688839115145,17411069.787704997,387840.699570943,17798910.48727594,2197,8,1455.7610350076104,99,558,74,35.06096039445844,0.6354166666666667,39.093749999999986,133466.09970213435,1348.1424212336804,0
2199,511.2860378371193,0,0,657,0.0,0.0,1.0,657,20200,14400,5800,0.7128712871287128,260,144,116,155.44171517207928,0.40628170979198375,0.9084653024577702,0.1040884931866582,17417360.367174625,389876.87384876463,17807237.24102339,2198,9,1456.7610350076104,106,551,76,34.92240725545778,0.6348270440251572,38.979750778816204,133456.00901955672,1259.018953014686,0
2200,511.09486391484353,0,0,657,0.0,0.0,1.0,657,19300,13800,5500,0.7150259067357513,248,138,110,154.11447155488474,0.40632840439420376,0.9076939408558096,0.10345790708827977,17422144.069402512,386300.9053218109,17808444.974724323,2199,10,1457.7610350076104,111,546,77,34.871084752202535,0.634572072072072,38.8950892857143,133449.37880901602,1202.2466559370812,0
2201,510.80563233827326,0,0,657,0.0,0.0,1.0,657,20050,14700,5350,0.7331670822942643,254,147,107,161.42344006469114,0.4065900101780698,0.9104001417164664,0.1083459820711208,17411514.846177492,410675.32464148215,17822190.170818973,2200,11,1458.7610350076104,115,542,75,34.68610996469026,0.633695652173913,38.900862068965516,133370.91025383997,1159.747045685565,8
2202,510.52166404427993,0,0,657,0.0,0.0,1.0,657,17650,12800,4850,0.7252124645892352,225,128,97,153.26330824210146,0.40671829948893096,0.9085765864014512,0.10071632106164555,17305777.15517094,381418.1317004152,17687195.286871355,2201,12,1459.7610350076104,132,525,90,35.63186193412543,0.6235006313131313,39.62249373433583,132928.3577784464,1007.0330134730788,8
2203,510.9671752335451,0,0,657,0.0,0.0,1.0,657,17550,12600,4950,0.717948717948718,225,126,99,151.27557937050403,0.40681565241736894,0.9072578858950702,0.09977278424061148,17337523.187415455,375598.77300516487,17713121.96042062,2202,13,1460.7610350076104,96,561,96,35.55665484925936,0.6321614583333333,39.49742268041237,133108.2660740479,1386.5444382713322,0
2204,510.5550874278628,1,0,658,0.001519756838905775,0.0,1.0,658,17800,12700,5100,0.7134831460674157,229,127,102,147.26230529116464,0.40713527185219117,0.9045674299684403,0.09768728012855471,17349786.52948298,361593.91212825116,17711380.44161123,2203,0,1459.5395136778116,102,556,96,35.461035896242265,0.6325571895424836,39.30016181229773,133101.62867835184,1304.9179282191358,0
2205,511.08625579596355,0,0,658,0.0,0.0,1.0,658,18250,12500,5750,0.684931506849315,240,125,115,148.02937255458278,0.4070261188448306,0.9044753091312983,0.0987063690967829,17391383.41451581,365037.114941395,17756420.529457204,2204,1,1460.5395136778116,110,548,71,35.261760015348244,0.6324810606060607,39.12349849849851,133330.3943775535,1212.0944943413954,0
2206,511.4988873710701,0,0,658,0.0,0.0,1.0,658,17900,12600,5300,0.7039106145251397,232,126,106,149.22443842458713,0.40690029169153336,0.9050168824429292,0.09985196102298224,17421289.79762869,370436.43733663624,17791726.234965324,2205,2,1461.5395136778116,116,542,72,35.10994087213598,0.6324533045977012,39.00462962962967,133498.84155344736,1150.8520823573049,0
2207,511.8625958399547,1,0,659,0.0015174506828528073,0.0,1.0,659,19100,12900,6200,0.675392670157068,253,129,124,151.24699992668903,0.4074432916226575,0.9074158656135503,0.10182544502106788,17461317.648764905,377294.38182853383,17838612.03059344,2206,0,1460.320182094082,121,538,79,34.84720951011161,0.6336088154269972,38.7978142076503,133699.62885874382,1104.9556104028416,0
2208,511.382188993667,0,1,658,0.0,0.0015174506828528073,0.9984825493171472,659,18500,13100,5400,0.7081081081081081,239,131,108,153.08234320315955,0.40740639312581006,0.9096049690544483,0.10352157195134738,17465018.480021413,384417.1906016343,17849435.67062305,2207,1,1461.320182094082,127,532,82,34.64661502932172,0.6341043307086613,38.64746093750001,133651.03352483458,1052.370342715233,0
2209,511.2316883482003,1,0,659,0.0015174506828528073,0.0,1.0,659,18300,13400,4900,0.73224043715847,232,134,98,153.67768944199557,0.4078058385721512,0.910506133182011,0.10467947054598872,17492382.216644805,387537.776378045,17879919.99302285,2208,0,1461.4522003034901,90,569,90,34.38416181682928,0.6450231481481481,38.40430402930403,133736.00931572137,1485.9556590635707,0
2210,511.048953769194,0,0,659,0.0,0.0,1.0,659,18200,13400,4800,0.7362637362637363,230,134,96,153.92611776546434,0.4079880249003356,0.9107979133559496,0.10535754354500233,17507772.466073923,388980.68928476906,17896753.15535869,2209,1,1462.4522003034901,93,566,87,34.21333241607042,0.6457213261648745,38.24246453900709,133770.9146385429,1438.3969315972354,0
2211,510.97318335237856,0,0,659,0.0,0.0,1.0,659,19200,14400,4800,0.75,240,144,96,153.29104585739464,0.40804673578985073,0.9101328055865998,0.10540664954370825,17525678.5595604,386305.9191511018,17911984.4787115,2210,2,1463.4522003034901,98,561,69,34.07436793615085,0.6458333333333333,38.08922558922557,133829.38215495905,1365.6059403567251,0
2212,511.1002569028503,0,0,659,0.0,0.0,1.0,659,17800,11900,5900,0.6685393258426966,237,119,118,152.3683694049487,0.4081267786228559,0.9096161116813744,0.10522838987262753,17549350.9124159,385193.19652800524,17934544.108943906,2211,3,1464.4522003034901,102,557,73,33.95209426777812,0.6462418300653594,37.9449838187702,133936.3860929055,1313.10182444025,0
2213,511.63464405740586,0,0,659,0.0,0.0,1.0,659,19500,14000,5500,0.717948717948718,250,140,110,155.67911855338352,0.40822805730951534,0.9114626729297164,0.10786513861803074,17582140.466871638,396134.4260328677,17978274.892904505,2212,4,1465.4522003034901,104,555,74,33.75597580665506,0.6468349358974359,37.837301587301575,134131.51888750933,1289.7261431491281,0
2214,511.5911167053421,1,0,660,0.0015151515151515152,0.0,1.0,660,17800,13600,4200,0.7640449438202247,220,136,84,152.83480590162256,0.4085681837341549,0.909975434077468,0.10637546052196478,17600716.623208042,388200.4217674857,17988917.044975527,2213,0,1464.230303030303,110,550,81,33.67864255390188,0.646969696969697,37.68768768768766,134196.6487814145,1219.9695343764954,0
2215,511.55919212628015,1,0,661,0.0015128593040847202,0.0,1.0,661,18100,12700,5400,0.7016574585635359,235,127,108,154.4572803000484,0.40859808371154815,0.9115275410037726,0.10806043139871437,17622380.188793547,394080.98327489366,18016461.17206844,2214,0,1463.0136157337367,114,547,86,33.46389214806636,0.647843567251462,37.518115942028956,134275.02055647783,1177.8510575129635,0
2216,511.2598174492296,0,0,661,0.0,0.0,1.0,661,18200,12400,5800,0.6813186813186813,240,124,116,155.03778468923247,0.4086396300371338,0.9121344298358651,0.10899804710661282,17633566.865832098,396373.8286096137,18029940.694441713,2215,1,1464.0136157337367,87,574,87,33.28601045610239,0.6566091954022988,37.357954545454554,134278.32421358355,1543.4290139492362,0
2217,510.9006341109727,0,0,661,0.0,0.0,1.0,661,18700,13300,5400,0.7112299465240641,241,133,108,152.92854105314083,0.4087218631091551,0.9104013670858169,0.10792385611464601,17637809.4083729,388564.8920391704,18026374.30041207,2216,2,1465.0136157337367,93,568,93,33.215601102114256,0.6559139784946236,37.234042553191514,134247.29428235246,1443.5192933586286,0
2218,511.4535392981417,0,0,661,0.0,0.0,1.0,661,18700,13500,5200,0.7219251336898396,239,135,104,152.96934486652665,0.40894430309142865,0.9102625348176063,0.10846071446183607,17677446.15958701,389921.4715890688,18067367.63117608,2217,3,1466.0136157337367,96,565,69,33.05933368732046,0.6565755208333333,37.08118556701033,134470.758189825,1400.7370644773437,0
2219,511.9325648299121,0,0,661,0.0,0.0,1.0,661,17500,12700,4800,0.7257142857142858,223,127,96,153.3822681812613,0.4088769693913416,0.9104555293319065,0.10911354410914084,17708445.25069863,393532.29970317386,18101977.550401803,2218,4,1467.0136157337367,98,563,71,32.93955183081312,0.6571003401360545,36.97390572390575,134651.62305995665,1373.996153673027,0
2220,511.8392927039228,1,1,661,0.0015105740181268882,0.0015105740181268882,0.9984894259818731,662,16650,12500,4150,0.7507507507507507,208,125,83,149.52195692097746,0.409057664239693,0.9082432602859698,0.10690061532988888,17727008.04278262,381065.3865821562,18108073.429364774,2219,0,1465.796072507553,105,557,76,32.876870037089596,0.6569444444444444,36.81210691823901,134709.9050432051,1282.9514766019533,0
2221,512.0215448771286,0,1,660,0.0,0.0015128593040847202,0.9984871406959153,661,17900,13000,4900,0.7262569832402235,228,130,98,148.33163966299395,0.4085969376060148,0.9076372875619731,0.10649114120047308,17751378.577781133,376518.2181441675,18127896.7959253,2220,1,1468.9606656580938,108,553,80,32.77223815054076,0.6576003086419753,36.67813455657494,134826.46834427075,1248.3932254099143,0
2222,512.0149979159228,0,0,660,0.0,0.0,1.0,660,18900,13300,5600,0.7037037037037037,245,133,112,147.10311001016112,0.40846874473107403,0.906587846833893,0.10595148050099022,17765184.300010517,371762.77208705083,18136947.07209757,2221,2,1468.948484848485,116,544,84,32.69899677797308,0.6569683908045977,36.57407407407409,134878.02491396386,1162.7415940858953,0
2223,511.8410526543028,0,0,660,0.0,0.0,1.0,660,18900,13700,5200,0.7248677248677249,241,137,104,145.88504252654892,0.4083851604052666,0.9058951487553608,0.1055286519556546,17777812.7348193,367803.39336962055,18145616.12818892,2222,3,1469.948484848485,91,569,91,32.59067932525706,0.6646062271062272,36.435688405797066,134903.03468848186,1482.4509306426578,0
2224,511.86515130242526,0,0,660,0.0,0.0,1.0,660,18250,12500,5750,0.684931506849315,240,125,115,148.28938634277307,0.4081418797228737,0.9074553093964841,0.10786330669186932,17802512.86068507,377734.7414940572,18180247.602179125,2223,4,1470.948484848485,93,567,93,32.34786414565822,0.6657706093189963,36.25886524822692,134999.8958443883,1451.6117832729924,0
2225,511.5990844998146,1,0,661,0.0015128593040847202,0.0,1.0,661,19150,13900,5250,0.7258485639686684,244,139,105,149.51523545706456,0.40832970399914426,0.9083048013376864,0.10926113360323836,17813201.14818972,381318.992783122,18194520.14097284,2224,0,1469.7216338880485,95,566,87,32.165570175438596,0.6666666666666667,36.11111111111108,135005.31396522734,1421.1085680550245,0
2226,511.5841818380707,0,1,660,0.0,0.0015128593040847202,0.9984871406959153,661,19500,13500,6000,0.6923076923076923,255,135,120,145.95155919760828,0.4083760257644524,0.905464508165323,0.1071760711691865,17833472.731042884,368864.63020074705,18202337.36124363,2225,1,1470.7216338880485,105,556,72,32.103407582467995,0.6655753968253968,35.95715408805031,135080.1432960604,1286.4775552005754,0
2227,511.8061170712069,0,0,660,0.0,0.0,1.0,660,17900,12900,5000,0.7206703910614525,229,129,100,148.02093759743542,0.4081383351726675,0.906430528955996,0.10912908371079794,17858206.952769797,378777.70739160303,18236984.660161402,2226,7,1473.948484848485,107,553,76,31.921155999367173,0.6663746105919003,35.831404320987644,135203.10320662838,1263.5804038002652,0
2228,512.0385503949228,0,0,660,0.0,0.0,1.0,660,19250,13900,5350,0.7220779220779221,246,139,107,147.2215208322155,0.40799291281556077,0.9055924094973258,0.10892112982551676,17881271.60822313,375251.60011530406,18256523.208338432,2227,8,1474.948484848485,112,548,81,31.830112665248198,0.6663876488095238,35.72087020648967,135321.10251910042,1208.2241296348252,0
2229,512.4959126306117,0,0,660,0.0,0.0,1.0,660,17600,13300,4300,0.7556818181818182,219,133,86,150.70068705867152,0.40790789150994006,0.9077014642368049,0.11192314365889301,17913551.70797011,390316.9100104278,18303868.617980536,2228,9,1475.948484848485,118,542,82,31.61597141753569,0.666401836158192,35.60049019607843,135503.66807604738,1148.3361701359947,0
2230,512.291763796413,0,0,660,0.0,0.0,1.0,660,18650,13000,5650,0.6970509383378016,243,130,113,151.26914043416753,0.40777818013212547,0.9085092117964964,0.11285267946236073,17925537.406144638,391666.12704960717,18317203.533194244,2229,10,1476.948484848485,121,539,87,31.457674369815685,0.6672692837465565,35.45935792349728,135521.99212520802,1120.0164638446945,0
2231,512.3470178503424,0,0,660,0.0,0.0,1.0,660,17300,12900,4400,0.7456647398843931,217,129,88,148.00516105749261,0.40771078577888137,0.9063072735482127,0.11064790901336123,17936294.32184569,381632.8259758741,18317927.147821564,2230,11,1477.948484848485,92,568,92,31.47796379388194,0.6748188405797102,35.39426523297492,135569.95911398437,1473.5865121085258,0
2232,511.9037574488198,0,0,660,0.0,0.0,1.0,660,17300,12400,4900,0.7167630057803468,222,124,98,144.47223521317338,0.4076891352830276,0.9038214259382162,0.1087510781549712,17949755.265074532,369348.2529349499,18319103.518009484,2231,12,1478.948484848485,96,564,96,31.354504595836765,0.67578125,35.180412371134025,135562.14195326364,1412.1056453464962,0
2233,512.0131627044232,0,0,660,0.0,0.0,1.0,660,20100,15600,4500,0.7761194029850746,246,156,90,143.7134093872302,0.4077629481461045,0.9033473881812835,0.10854281865355542,17967679.734455794,364339.30268329737,18332019.03713909,2232,13,1479.948484848485,97,563,93,31.269225111004125,0.6765463917525774,35.0765306122449,135644.30343585307,1398.3948807819904,0
2234,512.282164571103,0,0,660,0.0,0.0,1.0,660,19750,14600,5150,0.739240506329114,249,146,103,142.88557103185124,0.40775049432105576,0.9027853456166872,0.10845785450453294,17998079.188137807,362583.1644547122,18360662.35259252,2233,14,1480.948484848485,98,562,80,31.13455787983434,0.6778273809523809,34.92213804713806,135794.66090109292,1385.6598051131932,0
2235,512.310558267042,1,0,661,0.0015128593040847202,0.0,1.0,661,17900,12900,5000,0.7206703910614525,229,129,100,142.27829135187164,0.4079050718990205,0.9027646953683579,0.1084334316485491,18015958.643185973,362555.9625636997,18378514.605749674,2234,0,1479.7065052950077,100,561,83,31.02460397708123,0.6785416666666666,34.79785478547856,135865.85906846946,1358.6585906846947,0
2236,512.4234389733674,0,0,661,0.0,0.0,1.0,661,19300,13700,5600,0.7098445595854922,249,137,112,145.66575609874369,0.4077787137639634,0.9044517943671404,0.11136271371198297,18032984.376958475,373857.6607973003,18406842.037755776,2235,1,1480.7065052950077,101,560,85,30.837311058074796,0.6792491749174918,34.70179738562093,135945.017337114,1345.990270664495,0
2237,512.1537505669122,0,1,660,0.0,0.0015128593040847202,0.9984871406959153,661,19300,14300,5000,0.7409326424870466,243,143,100,148.61038863330927,0.40767862054737997,0.9061642421092457,0.11406132385896749,18039860.50167746,384682.1360089974,18424542.637686457,2236,2,1481.7065052950077,105,556,85,30.6369713182026,0.6794642857142856,34.581367924528315,135935.14788779285,1294.6204560742176,0
2238,512.6307278422132,0,0,660,0.0,0.0,1.0,660,18450,13100,5350,0.7100271002710027,238,131,107,151.44677725929017,0.4074902093775387,0.9070811502619687,0.11669102532554868,18072822.419588488,396964.1422852278,18469786.561873715,2237,3,1484.2272727272727,106,554,89,30.441138730019087,0.6804245283018868,34.46261682242992,136122.62200763525,1284.1756793173136,0
2239,512.7025245463403,0,0,660,0.0,0.0,1.0,660,18850,13900,4950,0.7374005305039788,238,139,99,153.3561339157812,0.4072261882865069,0.9078846905687274,0.11863342414267883,18091860.33832675,404049.5513660155,18495909.889692765,2238,4,1485.2272727272727,92,568,92,30.267360232734646,0.6854619565217391,34.341397849462396,136203.83599003393,1480.4764781525428,0
2240,512.3920640074668,0,0,660,0.0,0.0,1.0,660,17400,12600,4800,0.7241379310344828,222,126,96,148.9124514839471,0.407210573105869,0.9051122144637544,0.11577728187536458,18101710.551122103,389714.0188440886,18491424.569966193,2239,5,1486.2272727272727,94,566,94,30.23033371834012,0.6863918439716312,34.18859649122809,136199.65368058212,1448.9324859636397,0
2241,512.4019930389977,0,0,660,0.0,0.0,1.0,660,18200,13200,5000,0.7252747252747253,232,132,100,150.21456594591885,0.4070366506491317,0.9058886840579286,0.11728604003722647,18119535.746701036,394163.6394664536,18513699.38616749,2240,6,1487.2272727272727,95,565,92,30.06552864933972,0.687390350877193,34.06032986111112,136268.0170073008,1434.400179024219,0
2242,512.7565141046102,0,0,660,0.0,0.0,1.0,660,16200,11500,4700,0.7098765432098766,209,115,94,148.162987351051,0.4069838655906562,0.9051336115934512,0.11617356468669932,18149428.42901959,389614.7069515312,18539043.13597112,2241,7,1488.2272727272727,98,562,78,29.99095384980425,0.6878188775510203,33.93308080808083,136427.54600340268,1392.1178163612517,0
2243,512.6144750639561,0,0,660,0.0,0.0,1.0,660,19950,14700,5250,0.7368421052631579,252,147,105,147.91068046792822,0.40669599063472356,0.9053500907153287,0.11626058816554714,18154461.987845447,385097.7652302753,18539559.753075723,2242,8,1489.2272727272727,100,560,78,29.92281857521154,0.6880208333333333,33.85932343234325,136427.56321189651,1364.2756321189652,0
2244,512.4473592185814,0,1,659,0.0,0.0015151515151515152,0.9984848484848485,660,21200,15900,5300,0.75,265,159,106,147.4902235738343,0.40659750961818486,0.905105769465453,0.11642484405814728,18165964.596247684,382660.4359469894,18548625.032194674,2243,9,1490.2272727272727,101,559,82,29.804419322670984,0.6890470297029703,33.73161764705884,136448.52938016903,1350.975538417515,0
2245,512.7327318174208,0,0,659,0.0,0.0,1.0,659,18400,13100,5300,0.7119565217391305,237,131,106,150.80458025016046,0.4062913666742001,0.9075856786797623,0.119511281773936,18192171.898270898,398492.5693915058,18590664.4676624,2244,10,1492.6418816388468,103,556,82,29.596555873063647,0.6897249190938511,33.61378205128207,136584.933247358,1326.0673130811458,0
2246,512.5684395304592,0,0,659,0.0,0.0,1.0,659,16600,11500,5100,0.6927710843373494,217,115,102,149.38846716599917,0.40599271946534077,0.9066528100810562,0.11870614505527512,18197234.91708038,395291.40618445474,18592526.323264834,2245,11,1493.6418816388468,108,551,85,29.553326997334107,0.6893325617283951,33.53402140672786,136582.05083551203,1264.6486188473336,0
2247,512.4375163973539,0,0,659,0.0,0.0,1.0,659,19100,13100,6000,0.6858638743455497,251,131,120,147.23754326999227,0.4058468550949906,0.9053180343356504,0.11738456822423626,18206023.074584592,385222.0220437312,18591245.096628323,2246,12,1494.6418816388468,111,548,88,29.51081173022576,0.6896584084084084,33.43563988095241,136597.5786594561,1230.608816751857,0
2248,511.9649284882416,0,0,659,0.0,0.0,1.0,659,18250,13500,4750,0.7397260273972602,230,135,95,145.87402343749775,0.4055888538865648,0.9045902883156276,0.11669921875000028,18203197.457360048,381024.7305064782,18584222.187866528,2247,13,1495.6418816388468,116,543,90,29.443359375000046,0.6896551724137931,33.33333333333338,136523.98093020037,1176.9308700879342,0
2249,511.7941765329039,0,0,659,0.0,0.0,1.0,659,16650,11700,4950,0.7027027027027027,216,117,99,146.87224019850254,0.40524638971269905,0.9053067074174035,0.11807774666785394,18217004.23601067,386664.4443696969,18603668.680380367,2248,14,1496.6418816388468,92,567,92,29.268992345689355,0.6971240942028986,33.1877240143369,136552.96907695165,1484.2714030103439,0
2250,511.6080129585872,0,0,659,0.0,0.0,1.0,659,17150,12100,5050,0.7055393586005831,222,121,101,145.66168384596153,0.40512973665235313,0.9045930278095096,0.11759377964790654,18227152.713584527,382049.55119563796,18609202.264780164,2249,15,1497.6418816388468,96,563,96,29.176640382990673,0.6971571180555556,33.064862542955304,136566.15526322494,1422.5641173252598,0
2251,511.5572014940872,0,0,659,0.0,0.0,1.0,659,19700,14400,5300,0.7309644670050761,250,144,106,144.96212422923426,0.4049407279458453,0.9041927726928483,0.11770483817245059,18248431.128697813,377566.2680533779,18625997.39675119,2250,16,1498.6418816388468,99,560,78,29.023834594285418,0.6980218855218856,32.89583333333331,136639.06000740893,1380.192525327363,0
2252,511.8306945936183,0,0,659,0.0,0.0,1.0,659,18200,12400,5800,0.6813186813186813,240,124,116,142.30923584840104,0.40469935027896803,0.9019604569423942,0.11597695681611898,18272910.204493932,370080.7775855927,18642990.982079525,2251,17,1499.6418816388468,106,553,81,28.9854907461382,0.6973270440251572,32.78816199376946,136767.22065036555,1290.2567985883543,0
2253,511.49648194771237,0,1,658,0.0,0.0015174506828528073,0.9984825493171472,659,16400,12100,4300,0.7378048780487805,207,121,86,143.2639380105689,0.4045952849870778,0.9027749977533135,0.11692784855183576,18266880.32835572,375197.0422016029,18642077.370557323,2252,18,1500.6418816388468,107,552,81,28.916183971513465,0.6975272585669782,32.74498456790121,136700.00017639904,1277.570095106533,0
2254,511.4840240556729,0,0,658,0.0,0.0,1.0,658,16600,11400,5200,0.6867469879518072,218,114,104,151.89486116433096,0.4043953626983356,0.9038508965564549,0.11291205413824165,17882016.880094893,395037.29426805367,18277054.174362946,2253,19,1502.9878419452887,133,525,87,31.555615984634688,0.6641604010025063,35.57213930348261,135250.62626148915,1016.9220019660838,8
2255,511.56814515130884,0,0,658,0.0,0.0,1.0,658,18700,13600,5100,0.7272727272727273,238,136,102,144.0244548747359,0.4041462625239221,0.9031332089490616,0.09858394718953187,17525730.405192357,354526.75357787963,17880257.158770237,2254,20,1503.9878419452887,103,555,96,34.47121884645798,0.6430016181229774,38.241185897435884,133907.47100745427,1300.072534052954,8
2256,511.59940836111565,0,0,658,0.0,0.0,1.0,658,18750,13200,5550,0.704,243,132,111,145.67729754306896,0.4044545896502323,0.9044545772972765,0.10008131740719813,17543153.966404095,360777.85204153927,17903931.818445634,2255,21,1504.9878419452887,105,553,68,34.30409364954279,0.64375,38.11910377358488,133978.1115705115,1275.9820149572524,0
2257,511.7233964904991,0,0,658,0.0,0.0,1.0,658,18950,14200,4750,0.7493403693931399,237,142,95,143.74182623841367,0.40451892486649116,0.9030243580269937,0.0990580242680263,17561206.413521174,354305.97616584867,17915512.389687024,2256,22,1505.9878419452887,110,548,72,34.25033730940528,0.643655303030303,38.01614114114111,134063.2700809411,1218.7570007358281,0
2258,511.86328457309713,0,0,658,0.0,0.0,1.0,658,17900,12600,5300,0.7039106145251397,232,126,106,142.94761365530567,0.40472677339662183,0.9026594169259112,0.09896899376039506,17586640.674370907,353293.6633229269,17939934.337693833,2257,23,1506.9878419452887,114,544,80,34.115123243492256,0.6443713450292398,37.86231884057969,134178.65448863496,1177.005741128377,0
2259,511.73442406090425,0,1,657,0.0,0.001519756838905775,0.9984802431610942,658,18250,12600,5650,0.6904109589041096,239,126,113,143.78567046586085,0.4047438330719444,0.9029765848472517,0.09981662400533656,17594108.65726696,356106.14190686145,17950214.79917382,2258,24,1507.9878419452887,117,541,84,34.00321915502443,0.6446759259259259,37.77365819209037,134190.24599866694,1146.9251794757859,0
2260,512.1406448616622,0,0,657,0.0,0.0,1.0,657,18050,13000,5050,0.7202216066481995,231,130,101,141.22900240375984,0.4047151687270298,0.9008011154431628,0.09821125986866934,17615729.676902108,348120.3857766423,17963850.06267875,2259,25,1510.6560121765601,124,533,87,34.0124653152867,0.6439852150537635,37.71666666666668,134325.95546980068,1083.2738344338766,0
2261,512.0271575422315,0,0,657,0.0,0.0,1.0,657,19200,13600,5600,0.7083333333333334,248,136,112,142.88445173670073,0.40489024931630596,0.9011953667436148,0.09965943225914738,17625029.314633597,353068.5300929389,17978097.844726536,2260,26,1511.6560121765601,131,526,92,33.86934569460739,0.6438454198473282,37.61837121212121,134346.51957955843,1025.5459509889956,0
2262,512.5084576403037,0,0,657,0.0,0.0,1.0,657,18850,13600,5250,0.7214854111405835,241,136,105,147.2867253828381,0.4049421644330598,0.9042852359034694,0.10305363250617851,17655501.623262867,369834.2038163547,18025335.82707922,2261,27,1512.6560121765601,138,519,96,33.64893222177812,0.6438707729468599,37.51498800959233,134525.78864890066,974.8245554268163,0
2263,512.8706942183087,0,0,657,0.0,0.0,1.0,657,16350,11200,5150,0.6850152905198776,215,112,103,149.20485760449077,0.40483224359926245,0.9050637278900313,0.10480924115538712,17685427.69241676,380000.3441043164,18065428.036521077,2262,28,1513.6560121765601,99,558,99,33.467079515555376,0.6526725589225589,37.385416666666686,134687.32366601954,1360.4780168284801,0
2264,512.6299596536262,0,0,657,0.0,0.0,1.0,657,17250,11900,5350,0.6898550724637681,226,119,107,151.3652324317802,0.40475751290047146,0.9062297322881283,0.10687701629096188,17699829.71051111,387177.7676268911,18087007.478138003,2263,29,1514.6560121765601,102,555,99,33.23920489532023,0.6535947712418301,37.216828478964416,134710.52661448112,1320.6914373968737,0
2265,512.5823356595805,1,0,658,0.001519756838905775,0.0,1.0,658,18550,14300,4250,0.77088948787062,228,143,85,147.7938066969969,0.4048439743299114,0.903704383595682,0.10462265994077855,17709412.99667372,373318.31222953886,18082731.308903262,2264,0,1513.3525835866262,107,551,97,33.24848340304786,0.6532320872274143,37.133487654321,134740.73086483683,1259.259166961092,0
2266,512.8881468491255,0,1,657,0.0,0.001519756838905775,0.9984802431610942,658,18050,13300,4750,0.7368421052631579,228,133,95,146.80868217322464,0.4048091321116678,0.90200065738678,0.10449199023868758,17743793.14055993,371338.5775439815,18115131.71810391,2265,1,1514.3525835866262,116,542,76,33.095207874992965,0.6531070402298851,36.956908831908834,134911.6835706679,1163.0317549195508,0
2267,512.896560169532,0,0,657,0.0,0.0,1.0,657,19000,13500,5500,0.7105263157894737,245,135,110,146.87594791448194,0.40463483080892454,0.9029940869959083,0.10514320690648647,17769197.256265398,371573.53813868086,18140770.79440408,2266,32,1517.6560121765601,119,538,82,32.90462999604276,0.6544117647058824,36.77083333333334,135009.33411962632,1134.5322194926582,0
2268,512.3961713731154,0,0,657,0.0,0.0,1.0,657,18600,13200,5400,0.7096774193548387,240,132,108,146.52955603707647,0.40464884885721003,0.9023900987721649,0.10519359349924975,17764210.28636928,370596.36932218657,18134806.655691467,2267,33,1518.6560121765601,131,526,83,32.820866299048966,0.6533078880407125,36.67929292929291,134924.52214629075,1029.9581843228302,0
2269,512.1441237741246,0,0,657,0.0,0.0,1.0,657,16550,12100,4450,0.7311178247734139,210,121,89,144.04709751262925,0.40449058992587644,0.9014731019488642,0.10385614221200756,17774077.687181417,364110.8603604924,18138188.54754191,2268,34,1519.6560121765601,137,520,93,32.74631956183325,0.6538169099756691,36.54136473429951,134928.79190887857,984.881692765537,0
2270,512.1152849658989,0,0,657,0.0,0.0,1.0,657,16150,11400,4750,0.7058823529411765,209,114,95,143.1755979995683,0.4044477623714593,0.9010767707773892,0.10369384218756611,17792552.087805074,361941.8570219913,18154493.944827065,2269,35,1520.6560121765601,101,556,101,32.622907949790786,0.6621287128712872,36.39705882352941,134995.09533843736,1336.5851023607659,0
2271,511.72151278086346,0,0,657,0.0,0.0,1.0,657,18900,13400,5500,0.708994708994709,244,134,110,149.02368954438188,0.4046819121159248,0.9038117871623821,0.10317692844533388,17581821.1527122,373721.5714173196,17955542.72412952,2270,36,1521.6560121765601,117,540,82,33.955456867037086,0.6437856125356125,37.86193502824856,134141.68716479125,1146.5101467076174,8
2272,512.2277989516743,0,0,657,0.0,0.0,1.0,657,18400,13300,5100,0.7228260869565217,235,133,102,151.8898931224139,0.40467205114402743,0.9066754498524963,0.10550589631473076,17613732.06321475,385269.5761136974,17999001.639328446,2271,37,1522.6560121765601,118,539,83,33.77059759449027,0.6446857344632768,37.75385154061622,134329.76740890235,1138.3878593974775,0
2273,512.3130887184179,0,0,657,0.0,0.0,1.0,657,17300,12000,5300,0.6936416184971098,226,120,106,153.16344134110795,0.40455797323384196,0.9076377163921339,0.10667223746500094,17628380.302579742,391304.6784825788,18019684.98106232,2272,38,1523.6560121765601,124,533,85,33.64867905548494,0.644489247311828,37.66666666666665,134396.80027379724,1083.8451634983649,0
2274,512.1631927572764,0,0,657,0.0,0.0,1.0,657,19350,14100,5250,0.7286821705426356,246,141,105,150.31507997905481,0.4048185155795622,0.9067359187587276,0.09934460285888462,17387565.685487796,371972.6653310344,17759538.35081883,2273,39,1524.6560121765601,92,565,92,35.509710998395235,0.6340579710144927,39.426523297491045,133456.14377582105,1450.6102584328376,8
2275,512.3816727457607,1,0,658,0.001519756838905775,0.0,1.0,658,19350,14300,5050,0.7390180878552972,244,143,101,146.56332160665156,0.4053278137091165,0.9039932732651614,0.09733686662605764,17417167.39679067,359593.5813305461,17776760.978121214,2274,0,1523.337386018237,99,559,90,35.43893072589989,0.633733164983165,39.26041666666668,133598.18385936672,1349.476604640068,0
2276,512.4710133569255,1,1,658,0.0015174506828528073,0.0015174506828528073,0.9984825493171472,659,17350,12500,4850,0.7204610951008645,222,125,97,145.27250948677525,0.40538793004045,0.903172243981696,0.09691467413706827,17440691.006084874,357580.5899274784,17798271.596012354,2275,0,1522.0242792109257,104,555,77,35.31708685071107,0.6340144230769231,39.10714285714287,133700.02687758426,1285.5771815152332,0
2277,512.070568244908,0,1,657,0.0,0.001519756838905775,0.9984802431610942,658,18250,13600,4650,0.7452054794520548,229,136,93,147.27258512505574,0.4054431833778234,0.9038111201958758,0.09869720155240513,17447715.27654178,364064.02666044864,17811779.30320223,2276,2,1525.337386018237,108,550,80,35.10808683555426,0.6346450617283951,38.95259938837921,133674.6907700492,1237.7286182411963,0
2278,512.0239307163356,1,0,658,0.001519756838905775,0.0,1.0,658,16750,11100,5650,0.6626865671641791,224,111,113,147.97060640626827,0.4054713752141616,0.9038804082506147,0.09961385441961561,17466558.57047785,368557.4527008431,17835116.023178693,2277,0,1526.3328267477204,112,546,85,34.93478324804426,0.6353236607142857,38.79977876106195,133740.76398273776,1194.1139641315872,0
2279,511.75597524912956,1,1,658,0.0015174506828528073,0.0015174506828528073,0.9984825493171472,659,18350,14000,4350,0.7629427792915532,227,140,87,150.14073084471383,0.40593910133710925,0.9048804170738987,0.10142551151221452,17473043.350658488,374533.09974984906,17847576.450408336,2278,0,1525.0151745068285,117,542,89,34.75947571110059,0.635505698005698,38.682909604519786,133730.58244460466,1142.9964311504673,0
2280,511.5051189382871,0,0,658,0.0,0.0,1.0,658,17100,12300,4800,0.7192982456140351,219,123,96,151.7814677146136,0.40569931946352816,0.9062078577670272,0.10293866305103554,17482201.73466704,381994.8476341503,17864196.582301192,2279,1,1528.127659574468,119,539,92,34.58202601901353,0.636467086834734,38.55034722222224,133732.83574047234,1123.8053423569104,0
2281,511.9705947801107,0,0,658,0.0,0.0,1.0,658,18750,13300,5450,0.7093333333333334,242,133,109,152.54647590136807,0.40585444685014777,0.9068485310090268,0.10386096232050053,17515593.53399062,384038.4133862049,17899631.947376825,2280,2,1529.127659574468,93,565,93,34.429455270775904,0.6439292114695341,38.419769503546064,133921.3861899863,1440.01490526867,0
2282,511.6596806460478,0,0,658,0.0,0.0,1.0,658,18050,12800,5250,0.7091412742382271,233,128,105,150.30698840512827,0.4058582539528328,0.9054902361396886,0.10276899476605592,17523853.123600375,377141.51765242784,17900994.641252805,2281,3,1530.127659574468,98,560,98,34.34476427863094,0.6439200680272108,38.278619528619494,133912.27795022752,1366.4518158186481,0
2283,511.6780283197942,0,0,658,0.0,0.0,1.0,658,18200,13000,5200,0.7142857142857143,234,130,104,153.59327349379967,0.40577348567912547,0.9065182420602127,0.10553981525924308,17546701.972437967,389211.0789933652,17935913.05143133,2282,4,1531.127659574468,101,557,76,34.090333021369474,0.6448019801980198,38.112745098039184,134001.95423031706,1326.7520220823471,0
2284,511.2386538980556,0,0,658,0.0,0.0,1.0,658,16800,11700,5100,0.6964285714285714,219,117,102,154.07754005946316,0.40596451548979967,0.9067822618993491,0.10622863448475021,17546575.125992246,392306.626376282,17938881.75236853,2283,5,1532.127659574468,105,553,77,33.96436586524635,0.6449404761904762,38.001179245282984,133943.92444551748,1275.6564232906426,0
2285,511.07373981175266,1,0,659,0.0015174506828528073,0.0,1.0,659,18550,13500,5050,0.7277628032345014,236,135,101,153.03837049159242,0.40628271858900145,0.9047680721248677,0.10591347285855035,17557764.268358357,387052.3266210047,17944816.59497936,2284,0,1530.8012139605462,110,549,84,33.86386283354806,0.6450757575757575,37.875375375375334,133965.01220365646,1217.8637473059678,0
2286,511.27552653608507,0,0,659,0.0,0.0,1.0,659,19150,13700,5450,0.7154046997389034,246,137,109,151.5519148065103,0.4061716387391168,0.9046475333733288,0.10540470867733051,17586595.86246418,382106.4555769331,17968702.318041112,2285,1,1531.8012139605462,112,547,89,33.73699609882959,0.6462983630952381,37.712020648967524,134101.42474678336,1197.3341495248515,0
2287,511.51437162193713,0,0,659,0.0,0.0,1.0,659,20550,15400,5150,0.7493917274939172,257,154,103,151.7481992557257,0.40633969986147694,0.904539359914035,0.1059101954185575,17610232.527573694,382114.21490677254,17992346.742480464,2286,2,1532.8012139605462,117,542,94,33.615187832912774,0.6464565527065527,37.59710451977397,134222.85219334214,1147.2038649003603,0
2288,511.5790224290169,0,0,659,0.0,0.0,1.0,659,17900,12100,5800,0.6759776536312849,237,121,116,151.97234981715255,0.4063253824759814,0.9053369278625878,0.10635363356788219,17624376.9457759,385983.5957025497,18010360.54147845,2287,3,1533.8012139605462,124,535,94,33.519185794258,0.6460853494623655,37.50833333333328,134285.23022909346,1082.9454050733343,0
2289,511.441109248544,1,0,660,0.0015151515151515152,0.0,1.0,660,18000,12900,5100,0.7166666666666667,231,129,102,152.11080892054142,0.406410750141782,0.9052397700421242,0.10719883680319112,17650421.50513515,386963.9785869351,18037385.483722083,2288,0,1532.4757575757576,98,562,98,33.28277063558814,0.6540178571428572,37.27904040404045,134366.29899860185,1371.0846836592025,0
2290,511.65817194616693,0,0,660,0.0,0.0,1.0,660,18150,13400,4750,0.7382920110192838,229,134,95,149.51571495710883,0.406516751352677,0.9037059297015348,0.10582357753712514,17676738.751732003,378440.04651505494,18055178.798247058,2289,1,1533.4757575757576,100,560,92,33.20884176246718,0.6548958333333333,37.1390264026403,134494.96522681642,1344.9496522681643,0
2291,511.5458620885282,0,0,660,0.0,0.0,1.0,660,17700,12100,5600,0.6836158192090396,233,121,112,150.07118756190442,0.40652676231204304,0.9046644339099352,0.10662434867103289,17689598.65132982,381239.81541971193,18070838.46674953,2290,2,1534.4757575757576,102,558,81,33.06790942419118,0.6556372549019608,37.014563106796146,134529.11203226369,1318.9128630614086,0
2292,511.4687109363544,0,0,660,0.0,0.0,1.0,660,17800,12000,5800,0.6741573033707865,236,120,116,151.74452639685958,0.40649572354807556,0.906102590466398,0.10834518338295361,17708378.50593036,387629.90192775003,18096008.40785811,2291,3,1535.4757575757576,104,556,84,32.86207979893182,0.6567508012820513,36.85515873015875,134590.3527538383,1294.138007248445,0
2293,511.8939371897697,0,0,660,0.0,0.0,1.0,660,17050,12400,4650,0.7272727272727273,217,124,93,150.76850864737685,0.4066745796355053,0.9051100217901209,0.10816897549447431,17744080.136429235,385999.6998977974,18130079.83632703,2292,4,1536.4757575757576,107,553,90,32.72971690049698,0.6576129283489096,36.699459876543216,134781.95014798953,1259.644393906444,0
2294,512.1602567767166,0,0,660,0.0,0.0,1.0,660,19350,13700,5650,0.7080103359173127,250,137,113,152.25202893986037,0.4065358152848669,0.9058385778211386,0.10976948902467383,17774546.647845544,389892.158124137,18164438.80596968,2293,5,1537.4757575757576,111,549,92,32.53083777550276,0.6583145645645645,36.5420386904762,134932.69711415633,1215.6098839113183,0
2295,512.6062334696701,0,0,660,0.0,0.0,1.0,660,19050,13500,5550,0.7086614173228346,246,135,111,152.26583496961666,0.40657035069971337,0.9061962828914953,0.11010374711452832,17802796.39529274,391101.5315846643,18193897.926877405,2294,6,1538.4757575757576,95,565,95,32.434478227455514,0.6632675438596491,36.44748263888888,135098.6632459285,1422.0911920624053,0
2296,512.6613355530619,0,0,660,0.0,0.0,1.0,660,21900,15500,6400,0.7077625570776256,283,155,128,151.79152536275896,0.4065727456660689,0.9064878742221247,0.11031501889118862,17826465.982709873,387281.292668572,18213747.275378447,2295,7,1539.4757575757576,96,564,96,32.28356476768339,0.6646050347222222,36.286512027491405,135195.70894734238,1408.2886348681498,0
2297,512.7435988991954,0,0,660,0.0,0.0,1.0,660,16750,11700,5050,0.6985074626865672,218,117,101,151.56595589639397,0.4065279597952208,0.9065516391332871,0.11064976640506186,17848780.811087534,392303.50504354,18241084.316131074,2296,8,1540.4757575757576,98,562,91,32.14349802607967,0.6654974489795918,36.14267676767677,135291.1535100498,1380.5219745923448,0
2298,513.0658063504103,0,0,660,0.0,0.0,1.0,660,17050,12000,5050,0.7038123167155426,221,120,101,151.9898869965686,0.40648528149476554,0.9069654059846362,0.11131999459337745,17873950.551736154,394281.944908124,18268232.496644277,2297,9,1541.4757575757576,101,559,74,32.0276934138069,0.6657384488448845,36.039624183006524,135429.04306310244,1340.8816144861628,0
2299,513.2380830070141,0,0,660,0.0,0.0,1.0,660,19150,14400,4750,0.7519582245430809,239,144,95,150.8167121181159,0.4064334544228323,0.9059032250924155,0.11088511218566097,17896404.574142765,388665.3793215639,18285069.95346433,2298,10,1542.4757575757576,107,553,77,31.935415144874632,0.6654984423676013,35.91820987654321,135536.8317200235,1266.6993618693784,0
2300,512.7188726221525,0,0,660,0.0,0.0,1.0,660,19300,14200,5100,0.7357512953367875,244,142,102,151.02812279728437,0.40625890927484254,0.9056352066001374,0.11145551665545433,17894249.67161433,389206.9873539696,18283456.6589683,2299,11,1543.4757575757576,113,547,80,31.81028221622744,0.6653761061946903,35.80043859649124,135460.10127007487,1198.7619581422555,0
2301,512.7782023375983,0,0,660,0.0,0.0,1.0,660,18350,12600,5750,0.6866485013623979,241,126,115,154.40876544164396,0.4060083478947288,0.9075219169261663,0.1143661517619227,17911859.337067228,402799.6174001895,18314658.954467416,2300,12,1544.4757575757576,119,541,82,31.604520400232126,0.6653536414565826,35.6857638888889,135534.57884529178,1138.9460407167376,0
2302,512.3894935404124,0,0,660,0.0,0.0,1.0,660,19650,14000,5650,0.712468193384224,253,140,113,158.08495628132673,0.4061158339847642,0.9107147933610771,0.10990686308280573,17623236.81474259,405543.7242788045,18028780.539021395,2301,13,1545.4757575757576,115,545,80,33.578315985893745,0.6455615942028985,37.72449712643676,134387.21208544078,1168.5844529168764,8
2303,512.7074904844854,0,0,660,0.0,0.0,1.0,660,18350,12700,5650,0.6920980926430518,240,127,113,157.48557605621951,0.4062097645652274,0.9107658823471421,0.10998225812514989,17654034.631796505,405701.16274097667,18059735.79453748,2302,14,1546.4757575757576,121,539,87,33.444058077110725,0.6459194214876033,37.576844262295054,134546.31762329632,1111.9530382090604,0
2304,512.611162724081,0,0,660,0.0,0.0,1.0,660,18500,13000,5500,0.7027027027027027,240,130,110,154.77922597475225,0.40625435883876704,0.9097901042422143,0.10853267224458922,17668675.065154713,396448.77011681604,18065123.83527153,2303,15,1547.4757575757576,91,569,91,33.379556758233086,0.6544184981684982,37.44338768115945,134589.45032165805,1479.0049485896488,0
2305,512.8023891023444,0,1,659,0.0,0.0015151515151515152,0.9984848484848485,660,19400,14000,5400,0.7216494845360825,248,140,108,155.13359072343107,0.4063193103263285,0.909659873140789,0.10931590508136627,17696869.26294459,397675.77466474765,18094545.03760934,2304,16,1548.4757575757576,95,565,95,33.207362740239,0.6548245614035088,37.282986111111136,134721.9123800573,1418.1253934742874,0
2306,513.0737274845319,0,0,659,0.0,0.0,1.0,659,16200,11400,4800,0.7037037037037037,210,114,96,156.17211571043657,0.4064568333710006,0.9100979614566287,0.11025769392482461,17714617.735740077,405305.8661584366,18119923.601898514,2305,17,1550.6646433990895,96,563,94,33.11691186486856,0.6551649305555556,37.2207903780069,134825.10858619664,1404.4282144395484,0
2307,513.4714791793511,0,0,659,0.0,0.0,1.0,659,17350,11700,5650,0.6743515850144092,230,117,113,154.01364720379536,0.4063130829770322,0.9087051911194832,0.10915895652279206,17745496.3469864,397459.7227682059,18142956.069754608,2306,18,1551.6646433990895,99,560,92,33.0446349564827,0.6556186868686869,37.09375000000003,134994.8610729977,1363.584455282805,0
2308,513.2695830954215,0,0,659,0.0,0.0,1.0,659,18100,12200,5900,0.6740331491712708,240,122,118,160.05711564593503,0.4063954319660903,0.9122835155734721,0.1091489807495752,17567223.934658,412451.8385775157,17979675.773235515,2307,19,1552.6646433990895,94,565,94,34.17859338111005,0.6441710992907801,38.366228070175424,134288.65704210298,1428.6027344904571,8
2309,512.7655511193747,0,1,658,0.0,0.0015174506828528073,0.9984825493171472,659,18250,14100,4150,0.7726027397260274,224,141,83,160.63320267476442,0.40642877513902276,0.9122190340454748,0.10996788156694488,17567376.80040282,414330.79960861045,17981707.60001143,2308,20,1553.6646433990895,98,561,90,34.031741565506344,0.6443452380952381,38.23653198653198,134223.28893884429,1369.6253973351459,0
2310,512.8053479449546,1,1,658,0.0015174506828528073,0.0015174506828528073,0.9984825493171472,659,19000,14100,4900,0.7421052631578947,239,141,98,159.92023888690477,0.40678584496789066,0.9111224375227334,0.10996373082594799,17588465.961544573,411750.3356448743,18000216.297189448,2309,0,1553.566009104704,105,554,65,33.90114563009655,0.644047619047619,38.08962264150941,134309.04219171364,1279.1337351591776,0
2311,512.5820015295103,0,0,658,0.0,0.0,1.0,658,17100,12200,4900,0.7134502923976608,220,122,98,163.73580296086845,0.40656295347894006,0.9130666193460573,0.11295192542495988,17595222.885318108,427493.5894805968,18022716.474798705,2310,22,1556.9270516717324,107,551,67,33.69208446833047,0.6446651090342679,37.98225308641973,134305.58114921456,1255.192347188921,0
2312,512.4756041875711,1,0,659,0.0015174506828528073,0.0,1.0,659,18550,13500,5050,0.7277628032345014,236,135,101,160.63308544380172,0.4065391823600586,0.911454078502643,0.11121343284075619,17607678.801859684,415325.1546892271,18023003.95654891,2311,0,1555.5629742033384,114,545,72,33.65152038700761,0.6443713450292398,37.862318840579704,134339.16653250234,1178.4137415131784,0
2313,512.5471905539341,0,0,659,0.0,0.0,1.0,659,20300,15100,5200,0.7438423645320197,255,151,104,162.31185773498996,0.4064493383638284,0.9123366005787164,0.11275954668599783,17625278.81863297,420058.3496298982,18045337.16826287,2312,1,1556.5629742033384,120,539,75,33.4930215890315,0.6443576388888889,37.74965564738292,134415.67721973584,1120.1306434977987,0
2314,512.4761964639766,0,0,659,0.0,0.0,1.0,659,19350,13700,5650,0.7080103359173127,250,137,113,161.88772580838335,0.4067671074499603,0.9127806296070708,0.11293215462468158,17641201.801281914,420028.80802726396,18061230.609309178,2313,2,1557.5629742033384,128,531,82,33.36532641923639,0.6443684895833333,37.61304909560726,134467.066601265,1050.5239578223827,0
2315,512.6713892371422,2,0,661,0.0030257186081694403,0.0,1.0,661,17800,12900,4900,0.7247191011235955,227,129,98,163.3199213251158,0.40700623863445345,0.9114165138234647,0.11272700281833971,17600741.23472173,424910.3347436895,18025651.56946542,2314,0,1553.8472012102875,109,552,70,33.68444550853478,0.6443998470948012,37.96401515151513,134338.35238239417,1232.4619484623317,8
2316,513.002141062841,0,1,660,0.0,0.0015128593040847202,0.9984871406959153,661,18850,13700,5150,0.726790450928382,240,137,103,146.40820399540448,0.40685008175552806,0.9031510439103569,0.10868606122559492,17929323.005661827,373949.9960224865,18303273.00168431,2315,1,1554.8472012102875,120,541,90,31.743851280214447,0.6658854166666667,35.6146694214876,135630.24065238368,1130.2520054365307,8
2317,513.3095554905726,0,0,660,0.0,0.0,1.0,660,17150,12100,5050,0.7055393586005831,222,121,101,145.32861158566345,0.40677636570561454,0.9023537085209845,0.1080498477702964,17946582.19694733,372480.3746780653,18319062.571625393,2316,2,1557.3560606060605,124,536,92,31.723693747636435,0.6656586021505376,35.566666666666656,135736.1567902231,1094.6464257276054,0
2318,513.0997568264382,0,0,660,0.0,0.0,1.0,660,18850,14000,4850,0.7427055702917772,237,140,97,142.8711643265581,0.4066677300317285,0.9010529125451381,0.1065461155912901,17952162.904492803,362119.2832689898,18314282.18776179,2317,3,1558.3560606060605,132,528,96,31.692141623488748,0.6653251262626263,35.471491228070185,135729.51352453834,1028.2538903374116,0
2319,512.564097685123,0,0,660,0.0,0.0,1.0,660,18700,13200,5500,0.7058823529411765,242,132,110,140.92020586008167,0.4065442455664383,0.8997948421120339,0.10551710877965792,17950551.829304364,355219.09181751823,18305770.92112188,2318,4,1559.3560606060605,101,559,101,31.615658563251632,0.6727516501650165,35.345179738562045,135652.55914531992,1343.0946450031674,0
2320,512.915226524546,0,0,660,0.0,0.0,1.0,660,19600,14600,5000,0.7448979591836735,246,146,100,141.66452331961767,0.40656881792124583,0.9006193883277234,0.10624839248971134,17969780.86007243,357536.08794002,18327316.94801245,2319,5,1560.3560606060605,101,559,101,31.544174382716037,0.6732673267326732,35.294117647058776,135771.67760943613,1344.2740357369914,0
2321,512.7718402004114,0,0,660,0.0,0.0,1.0,660,17000,12000,5000,0.7058823529411765,220,120,100,140.69340911510236,0.4062050704311706,0.8990617525689084,0.1061896671791724,17991441.67676155,357255.4528798146,18348697.129641365,2320,6,1561.3560606060605,110,550,99,31.370595389920112,0.6731060606060606,35.097597597597556,135834.49235338744,1234.8590213944312,0
2322,512.720667767014,1,0,661,0.0015128593040847202,0.0,1.0,661,18900,13300,5600,0.7037037037037037,245,133,112,139.92379729437923,0.4062123695349868,0.8972982699809668,0.106224927386955,18014086.04244974,353019.8647694419,18367105.90721918,2321,0,1559.9924357034795,118,543,79,31.208585124767435,0.6732874293785311,34.917717086834706,135913.1651084409,1151.8064839698382,0
2323,513.12647730252,0,0,661,0.0,0.0,1.0,661,17600,11500,6100,0.6534090909090909,237,115,122,125.55369143211513,0.4060166720151592,0.8874770375244612,0.09713747676237647,18107311.237716794,304887.9535611135,18412199.191277906,2322,1,1560.9924357034795,111,550,111,31.002310600756154,0.6805555555555556,34.33779761904762,136318.3100601673,1228.0928834249307,8
2324,512.9100482653331,0,0,661,0.0,0.0,1.0,661,18450,13400,5050,0.7262872628726287,235,134,101,124.91853662852637,0.4057772314674735,0.8873386213982051,0.09707177121732109,18117857.706423834,302001.25430606765,18419858.9607299,2323,2,1561.9924357034795,115,546,115,30.884102221921896,0.6810688405797101,34.20438218390805,136329.2431627662,1185.4716796762277,0
2325,512.9592035676908,0,0,661,0.0,0.0,1.0,661,17000,11600,5400,0.6823529411764706,224,116,108,124.67024385408092,0.40547083925487853,0.8871293886053386,0.09713090248407132,18130321.679014187,302862.3249751298,18433184.003989317,2324,3,1562.9924357034795,116,545,116,30.8110510218888,0.6816630747126438,34.12571225071227,136382.66289300294,1175.712611146577,0
2326,512.8683019570909,0,1,660,0.0,0.0015128593040847202,0.9984871406959153,661,17600,12600,5000,0.7159090909090909,226,126,100,124.3619765596202,0.40518736915295156,0.8864180278126788,0.09724207564722184,18142018.41344989,301435.4537355348,18443453.867185425,2325,4,1563.9924357034795,121,540,108,30.708568738229758,0.6818181818181819,34.01639344262297,136414.56064350612,1127.393063169472,0
2327,513.0340022861083,0,1,659,0.0,0.0015151515151515152,0.9984848484848485,660,17100,12600,4500,0.7368421052631579,216,126,90,123.73053470902877,0.40516508024095277,0.8850020481282317,0.09711332270561289,18163357.360798493,300372.3836725554,18463729.744471047,2326,5,1566.489393939394,127,533,83,30.610562317776832,0.6819225721784776,33.90299479166667,136516.81157837904,1074.935524239205,0
2328,513.1728143996664,0,0,659,0.0,0.0,1.0,659,18500,13300,5200,0.7189189189189189,237,133,104,121.84110462399785,0.4047058843877847,0.8829676150833901,0.09592341030474401,18180823.918529093,292734.33384159516,18473558.25237069,2327,13,1569.8588770864947,132,527,88,30.567815145006428,0.6820549242424243,33.8110902255639,136600.91199092564,1034.8553938706489,0
2329,512.7281440387592,0,0,659,0.0,0.0,1.0,659,19300,14000,5300,0.7253886010362695,246,140,106,125.38799300416584,0.40458000670322697,0.8868006559464297,0.09642843662354111,18068331.611386366,302010.36753708974,18370341.978923455,2328,14,1570.8588770864947,149,510,100,31.19204334405813,0.6726090604026846,34.52083333333332,136118.64040595552,913.547922187621,8
2330,512.4402481224835,0,0,659,0.0,0.0,1.0,659,18700,14200,4500,0.7593582887700535,232,142,90,143.2904248316262,0.404431163547975,0.9007108680784548,0.1072287859042067,17943727.211582012,363732.85904207366,18307460.070624087,2329,15,1571.8588770864947,97,562,97,31.571533049497248,0.6736469072164948,35.36352040816323,135610.38326429977,1398.0451882917503,6
2331,512.339486966094,0,0,659,0.0,0.0,1.0,659,16500,11100,5400,0.6727272727272727,219,111,108,141.40832327650654,0.40440704499925434,0.8994161877091014,0.10646688767448387,17965911.043692477,359805.87136467756,18325716.915057156,2330,16,1572.8588770864947,102,557,102,31.42908742585094,0.6742238562091503,35.17394822006469,135680.84350418634,1330.2043480802583,0
2332,512.2556453884429,0,0,659,0.0,0.0,1.0,659,17200,11800,5400,0.686046511627907,226,118,108,140.87714384715176,0.40406986576634335,0.8985263885158816,0.1065366275100825,17981554.87839963,357638.01863994315,18339192.897039574,2331,17,1573.8588770864947,106,553,98,31.304270615179234,0.674626572327044,35.036993769470364,135728.7957606797,1280.460337364903,0
2333,512.2306819582483,0,0,659,0.0,0.0,1.0,659,19450,14400,5050,0.7403598971722365,245,144,101,139.14449978400012,0.4038850850125993,0.8976757287254413,0.10561097716794168,17995984.709152438,349558.45809510007,18345543.167247538,2332,18,1574.8588770864947,109,550,81,31.235859054968063,0.6750764525993884,34.924242424242394,135779.93607362796,1245.687486914018,0
2334,511.84825753217376,0,0,659,0.0,0.0,1.0,659,17500,13000,4500,0.7428571428571429,220,130,90,137.99724538666888,0.4037270172331355,0.8970178043045651,0.10513518949374032,17998288.980506364,347442.8601966155,18345731.84070298,2333,19,1575.8588770864947,112,547,85,31.148686619391924,0.6755952380952381,34.808259587020615,135737.93024230606,1211.9458057348754,0
2335,511.4641184035982,0,0,659,0.0,0.0,1.0,659,19000,13000,6000,0.6842105263157895,250,130,120,138.0804382055936,0.4036348670808523,0.8974268528637628,0.10554360253964337,17998432.545732766,346246.29058571096,18344678.836318478,2334,20,1576.8588770864947,118,541,85,31.044464425160275,0.6754060734463276,34.70763305322125,135687.52657963577,1149.8942930477608,0
2336,511.02053692081853,0,0,659,0.0,0.0,1.0,659,19800,14000,5800,0.7070707070707071,256,140,116,139.19334052290782,0.4034115543030566,0.8982346563171222,0.10679760786109468,17998547.88601984,349455.60096331825,18348003.486983158,2335,21,1577.8588770864947,124,535,89,30.897359414738265,0.6754872311827957,34.59166666666664,135629.1090032579,1093.7831371230477,0
2337,511.0397342064818,0,1,658,0.0,0.0015174506828528073,0.9984825493171472,659,19400,13700,5700,0.7061855670103093,251,137,114,141.5394467163081,0.40332910922416293,0.899859530051216,0.10897565730473328,18013629.48219491,358727.830052482,18372357.312247396,2336,22,1578.8588770864947,131,528,90,30.727401969525808,0.6754134860050891,34.48547979797977,135688.46983200018,1035.789846045803,0
2338,511.1513441386207,0,0,658,0.0,0.0,1.0,658,19550,14600,4950,0.7468030690537084,245,146,99,142.71208974793856,0.4029162792096339,0.9010731882280487,0.11016742556873366,18028431.686017808,363425.0321579065,18391856.718175713,2337,23,1582.224924012158,136,522,93,30.615057780576937,0.6754748774509804,34.40541362530412,135759.02982136566,998.2281604512182,0
2339,511.50230440535233,1,1,658,0.0015174506828528073,0.0015174506828528073,0.9984825493171472,659,16500,11700,4800,0.7090909090909091,213,117,96,142.7389621364548,0.4031204021013694,0.9013464476922326,0.11057130247902919,18055157.0105467,367134.8745792392,18422291.88512594,2338,0,1580.8224582701062,96,563,96,30.50725150216907,0.6846788194444444,34.299828178694185,135906.25016749726,1415.6901059114298,0
2340,511.9659076671576,0,0,658,0.0,0.0,1.0,658,19450,14000,5450,0.7197943444730077,249,140,109,138.71688352976525,0.4029368086494289,0.898034847842264,0.10796387824418172,18090990.036681037,350855.15157129394,18441845.18825233,2339,1,1584.1838905775076,104,554,104,30.469051261957155,0.683994391025641,34.156746031746074,136102.68281505012,1308.679642452405,0
2341,512.1361304093534,0,0,658,0.0,0.0,1.0,658,17400,12700,4700,0.7298850574712644,221,127,94,136.52430023584446,0.40281522231937567,0.8963068385070894,0.10656554565674345,18108927.671732184,345461.73568095977,18454389.407413144,2340,2,1585.1838905775076,108,550,95,30.43858782237879,0.6839313271604939,34.06918960244653,136192.7761936289,1261.0442240150824,0
2342,512.1081337082644,0,0,658,0.0,0.0,1.0,658,19100,13600,5500,0.7120418848167539,246,136,110,136.00973742293436,0.40239976621498047,0.8955553641350866,0.1066789418743377,18127810.67070355,342411.7538750184,18470222.424578566,2341,3,1586.1838905775076,112,546,80,30.304401676829322,0.6845238095238095,33.923303834808294,136260.04029641915,1216.6075026465994,0
2343,511.68864671658133,0,0,658,0.0,0.0,1.0,658,17000,12000,5000,0.7058823529411765,220,120,100,133.70370366682286,0.40213948568837815,0.8928503809223276,0.10534734881157756,18131528.932776738,336250.5142908853,18467779.447067622,2342,4,1587.1838905775076,123,535,83,30.227595455979852,0.6837737127371274,33.786962365591414,136218.18896546186,1107.4649509387143,0
2344,511.581851057447,0,0,658,0.0,0.0,1.0,658,18450,13900,4550,0.7533875338753387,230,139,91,132.3962666371664,0.4018859037348545,0.8921261384965933,0.10463072965938261,18139986.430641066,330283.2960531513,18470269.72669422,2343,5,1588.1838905775076,125,533,88,30.171338838528097,0.6843333333333333,33.697089947089964,136235.73566685358,1089.8858853348286,0
2345,511.1490967299605,1,1,658,0.0015174506828528073,0.0015174506828528073,0.9984825493171472,659,19050,14100,4950,0.7401574803149606,240,141,99,139.45929774107933,0.40190169471721143,0.896403482888982,0.10218209163501471,17808840.114644237,345871.66719429253,18154711.78183853,2344,0,1586.772382397572,115,544,78,32.345954098063245,0.6626811594202899,36.027298850574724,134929.40775389728,1173.2991978599764,8
2346,511.6177062877379,0,0,658,0.0,0.0,1.0,658,17400,13000,4400,0.7471264367816092,218,130,88,140.8111825136268,0.4018736631768547,0.8972325529740459,0.10349448928040894,17838489.151732102,353371.7503423813,18191860.902074482,2345,1,1589.7325227963527,117,541,81,32.21025272447686,0.6632834757834758,35.92867231638419,135103.5669658496,1154.7313415884582,0
2347,512.0817837405385,0,0,658,0.0,0.0,1.0,658,17400,11800,5600,0.6781609195402298,230,118,112,144.41389282105752,0.40170118696787305,0.8986872302419424,0.10638330933133706,17864357.11545055,366972.27075755765,18231329.386208106,2346,2,1590.7325227963527,122,536,81,32.04245484663888,0.6630806010928962,35.85704607046072,135262.7950107343,1108.7114345142154,0
2348,512.3621769344659,0,0,658,0.0,0.0,1.0,658,18750,14600,4150,0.7786666666666666,229,146,83,147.45132387749334,0.4013620656818704,0.9016692939526596,0.109200052714555,17896823.342229508,377432.0590026733,18274255.401232183,2347,3,1591.7325227963527,125,533,85,31.792190578962188,0.66425,35.68948412698413,135422.71129937013,1083.381690394961,0
2349,512.026981988199,0,0,658,0.0,0.0,1.0,658,16300,11700,4600,0.7177914110429447,209,117,92,147.28191000918198,0.40118587875255024,0.9021009486966929,0.10946628446628441,17900351.568443857,379379.5937672563,18279731.162211113,2348,4,1592.7325227963527,129,529,89,31.682449494949505,0.6647286821705427,35.57692307692309,135391.75004495718,1049.5484499609083,0
2350,512.0854805874135,1,0,659,0.0015174506828528073,0.0,1.0,659,19900,14800,5100,0.7437185929648241,250,148,102,138.62390221470497,0.40159555250118,0.8962312371126122,0.09577823039537048,17585131.614590935,335843.9130747508,17920975.527665686,2349,0,1591.3141122913505,120,539,84,34.2975302761536,0.6425347222222222,37.93044077134985,134202.01618493415,1118.3501348744512,7
2351,512.3272563304265,0,0,659,0.0,0.0,1.0,659,18250,14200,4050,0.7780821917808219,223,142,81,137.6482169400232,0.4017771622903512,0.8963108423467667,0.09554567693535225,17614012.810503896,334857.4913049135,17948870.301808808,2350,1,1592.3141122913505,123,536,90,34.16776790004801,0.6435467479674797,37.777217741935466,134343.87858160396,1092.2266551349915,0
2352,512.1370915966706,0,0,659,0.0,0.0,1.0,659,20050,14200,5850,0.7082294264339152,259,142,117,135.6257303314545,0.40164792146154943,0.8947452319569169,0.09440738962068386,17619956.068277188,326093.8820336398,17946049.950310826,2351,2,1593.3141122913505,129,530,95,34.12661896325254,0.6434916020671835,37.68429487179484,134341.60230448685,1041.4077698022236,0
2353,512.4272454739267,0,0,659,0.0,0.0,1.0,659,16900,11600,5300,0.6863905325443787,222,116,106,138.50022722210065,0.4016796311072777,0.8962934341947333,0.09658113263822435,17637867.80575785,339869.73976215883,17977737.545520008,2352,3,1594.3141122913505,132,527,97,33.991417910447716,0.6436237373737373,37.62531328320799,134447.9379963679,1018.5449848209689,0
2354,512.3289965530201,1,0,660,0.0015151515151515152,0.0,1.0,660,17200,11700,5500,0.6802325581395349,227,117,110,140.89674497045064,0.40201445410094877,0.8979707642206554,0.09860470383667952,17650304.901158,348174.1016618182,17998479.00281982,2353,0,1592.8969696969698,135,525,101,33.80922767548843,0.6443672839506173,37.50765931372544,134482.43750664924,996.1662037529574,0
2355,512.5491447956623,0,1,659,0.0,0.0015151515151515152,0.9984848484848485,660,15100,11100,4000,0.7350993377483444,191,111,80,137.2961220085377,0.4020500433009917,0.894900303163856,0.09644733772054931,17674495.426963855,338227.93611595826,18012723.363079812,2354,1,1593.8969696969698,107,553,107,33.77864698104893,0.6507009345794392,37.38425925925928,134603.47332654713,1257.9763862294124,0
2356,512.6089666572926,0,0,659,0.0,0.0,1.0,659,17800,12600,5200,0.7078651685393258,230,126,104,137.34234922671362,0.4019501239943238,0.8947568442185476,0.09685922150250753,17693827.859104265,336422.37699649343,18030250.23610076,2355,2,1596.300455235205,110,549,110,33.64741826797154,0.6513257575757576,37.25600600600602,134684.92725667194,1224.4084296061085,0
2357,512.6293536307073,0,0,659,0.0,0.0,1.0,659,18250,13000,5250,0.7123287671232876,235,130,105,140.15626380709907,0.4020562071727603,0.8963840166183892,0.09923090831778099,17711692.94732323,346430.9418390767,18058123.889162306,2356,3,1597.300455235205,114,545,105,33.444316184831706,0.6517726608187134,37.12862318840581,134755.58398294233,1182.0665261661609,0
2358,512.8240687721125,0,0,659,0.0,0.0,1.0,659,19450,14600,4850,0.7506426735218509,243,146,97,143.25585896077084,0.40205024960295677,0.898128194686175,0.10190700876073028,17739164.322270732,356997.84444663156,18096162.166717365,2357,4,1598.300455235205,118,541,78,33.20679967607384,0.652542372881356,36.97478991596639,134885.658424934,1143.098800211305,0
2359,512.567103036569,0,0,659,0.0,0.0,1.0,659,18950,14500,4450,0.7651715039577837,234,145,89,143.56884601017995,0.40211703203865734,0.8970641472332823,0.10236575443164794,17740360.052613463,358642.6041117584,18099002.65672522,2358,5,1599.300455235205,124,535,81,33.12270366147216,0.6522177419354839,36.899999999999984,134856.40480892028,1087.551651684841,0
2360,512.2720161981844,0,0,659,0.0,0.0,1.0,659,17850,12900,4950,0.7226890756302521,228,129,99,143.34245549526875,0.4020821514283562,0.8972479163087141,0.1025206036184868,17743609.741713878,359032.5179454064,18102642.259659283,2359,6,1600.300455235205,127,532,86,33.027358646136086,0.6527230971128609,36.80013020833333,134829.92796127644,1061.6529760730427,0
2361,512.6313825226331,0,0,659,0.0,0.0,1.0,659,18300,12600,5700,0.6885245901639344,240,126,114,142.60015474351357,0.4020637021799325,0.8973615568427304,0.10232251103595896,17770234.393334944,356707.6348636162,18126942.02819856,2360,7,1601.300455235205,131,528,90,32.94034346340586,0.6531488549618321,36.695075757575765,134978.3673394116,1030.3692163313863,0
2362,512.1358233013947,0,0,659,0.0,0.0,1.0,659,17800,12200,5600,0.6853932584269663,234,122,112,141.69954796911983,0.4020461177400286,0.8975922822450273,0.10198603139409416,17766253.75513097,353894.0252413518,18120147.78037232,2361,8,1602.300455235205,134,525,94,32.86481676773006,0.6536847014925373,36.59722222222224,134897.9984570978,1006.7014810231179,0
2363,512.1351266917578,0,0,659,0.0,0.0,1.0,659,18550,13700,4850,0.738544474393531,234,137,97,144.0064714397182,0.4020362204869679,0.8997322249491668,0.10397784626467761,17780054.849329323,361738.5921713114,18141793.441500634,2362,9,1603.300455235205,142,517,97,32.70010919444906,0.6536091549295775,36.49475524475524,134950.29190666942,950.3541683568269,0
2364,512.0748592566298,0,0,659,0.0,0.0,1.0,659,21200,16200,5000,0.7641509433962265,262,162,100,143.05681100038194,0.4021469159775104,0.8993540371853002,0.1037402986737604,17796662.064536646,356186.7442808188,18152848.808817465,2363,10,1604.300455235205,101,558,101,32.584605154426214,0.6625412541254125,36.356209150326805,135005.3570932312,1336.6867038933783,0
2365,512.129026411836,0,0,659,0.0,0.0,1.0,659,19100,14500,4600,0.7591623036649214,237,145,92,157.25749459968856,0.40211693594882175,0.9084790069609769,0.10879912610084246,17592618.557882257,402414.22357210366,17995032.781454362,2364,11,1605.300455235205,107,552,77,33.76386026886467,0.645638629283489,37.885802469135776,134236.28879019961,1254.5447550485944,8
2366,512.2690774472561,1,0,660,0.0015151515151515152,0.0,1.0,660,18050,13000,5050,0.7202216066481995,231,130,101,156.63100804241793,0.40226822473597895,0.9088451403668811,0.10891318931321449,17619793.70300916,401911.20984034555,18021704.912849505,2365,0,1603.8666666666666,113,547,81,33.61116917502787,0.6460176991150443,37.719298245614,134358.29311993605,1189.011443539257,0
2367,512.2308906042508,0,0,660,0.0,0.0,1.0,660,19350,13600,5750,0.7028423772609819,251,136,115,155.74650555525338,0.40243898583712695,0.9086744233941615,0.10861327165915491,17631341.154744014,397853.9546207737,18029195.10936479,2366,1,1604.8666666666666,117,543,84,33.53716663302153,0.6461894586894588,37.62358757062144,134397.30341224695,1148.6949009593757,0
2368,511.78552586831444,0,1,659,0.0,0.0015151515151515152,0.9984848484848485,660,18400,13700,4700,0.7445652173913043,231,137,94,157.69286261751023,0.40257904346959733,0.9105732086130889,0.1102995913135735,17629197.65733403,405599.7288469755,18034797.386181004,2367,2,1605.8666666666666,122,538,86,33.38636950279093,0.6462602459016393,37.52540650406502,134330.69785938773,1101.0712939294076,0
2369,511.8655824077373,0,0,659,0.0,0.0,1.0,659,17000,12400,4600,0.7294117647058823,216,124,92,159.04284878235933,0.40250388971654266,0.9112930030743578,0.11172390832420301,17650923.7940344,412650.6407687164,18063574.434803117,2368,3,1608.185128983308,89,570,89,33.207543705009556,0.6556647940074907,37.38425925925928,134423.95908369962,1510.381562738198,0
2370,512.3436067704303,0,0,659,0.0,0.0,1.0,659,16800,11600,5200,0.6904761904761905,220,116,104,155.59409097384082,0.40244883024077804,0.9088663963795476,0.1099220148473406,17692300.980391975,401963.49765594373,18094264.47804792,2369,4,1609.185128983308,96,563,92,33.11028931023208,0.6553819444444444,37.19931271477667,134644.25198546101,1402.544291515219,0
2371,512.66994156198,0,0,659,0.0,0.0,1.0,659,18950,14500,4450,0.7651715039577837,234,145,89,161.4803017832656,0.40240107359251454,0.9098100376552583,0.11425493050702697,17710277.502112012,421222.191141282,18131499.693253294,2370,5,1610.185128983308,106,553,96,32.90501543209878,0.6533018867924528,37.14953271028036,134755.53370495894,1271.2786198581032,8
2372,512.1563677166057,0,0,659,0.0,0.0,1.0,659,18400,13700,4700,0.7445652173913043,231,137,94,162.47298971369185,0.4024527699240352,0.9097675293735388,0.11562582154260032,17717897.60416118,425535.95903782104,18143433.563199002,2371,6,1611.185128983308,115,544,67,32.68753698393187,0.6532608695652173,36.96120689655171,134716.99284442092,1171.4521116906167,0
2373,512.4653899922786,0,0,659,0.0,0.0,1.0,659,19500,13700,5800,0.7025641025641025,253,137,116,162.88630478725048,0.40270116214890694,0.9102963784903657,0.11641800385392229,17747291.432436485,426858.14428239485,18174149.576718878,2372,7,1612.185128983308,122,537,71,32.53569206676101,0.6533469945355191,36.822493224932224,134869.3636466791,1105.4865872678615,0
2374,512.7941593450361,0,0,659,0.0,0.0,1.0,659,18000,13200,4800,0.7333333333333333,228,132,96,163.57729648576276,0.4026927062433794,0.9114820124761562,0.11738398952041515,17776223.921227414,431757.33015197463,18207981.25137939,2373,8,1613.185128983308,128,531,76,32.38539366617596,0.6536458333333333,36.692506459948284,135022.54479911693,1054.863631243101,0
2375,513.2375567285005,0,0,659,0.0,0.0,1.0,659,18050,12800,5250,0.7091412742382271,233,128,105,163.93117830003885,0.40264158645087195,0.9123967224076039,0.1179217453487039,17802073.574748322,433812.97945848433,18235886.554206807,2374,9,1614.185128983308,132,527,79,32.29727318683272,0.6538036616161615,36.61497493734332,135179.08674203014,1024.0839904699253,0
2376,513.409458042775,0,0,659,0.0,0.0,1.0,659,18300,13400,4900,0.73224043715847,232,134,98,162.77625633146806,0.4027334483336485,0.9130076096731874,0.1174687294233781,17822023.46169057,430100.45186910755,18252123.91355968,2375,10,1615.185128983308,136,523,84,32.222590946692044,0.6542585784313726,36.51155717761554,135277.4586299731,994.6871958086257,0
2377,513.3743385123779,0,0,659,0.0,0.0,1.0,659,18550,13700,4850,0.738544474393531,234,137,97,164.7005522376961,0.40274103943065614,0.9137915131339336,0.11943901508622722,17841945.71300068,437365.6623852348,18279311.375385918,2376,11,1616.185128983308,90,569,90,32.0130687738798,0.6657407407407407,36.35531135531132,135348.4176352674,1503.8713070585266,0
2378,513.6877336800894,0,0,659,0.0,0.0,1.0,659,16550,12100,4450,0.7311178247734139,210,121,89,163.79159693294642,0.4026096846254726,0.9120218839524481,0.11916439229718966,17866808.7852414,436936.62860605365,18303745.413847454,2377,12,1617.185128983308,95,564,95,31.93220231483385,0.6652412280701754,36.25217013888887,135484.02498439522,1426.1476314146864,0
2379,513.695160714836,0,0,659,0.0,0.0,1.0,659,17800,13800,4000,0.7752808988764045,218,138,80,162.3485009885833,0.4025932532635952,0.9115174615745156,0.11856073697704389,17883331.193026263,431066.4023740365,18314397.5954003,2378,13,1618.185128983308,98,561,92,31.84829997075787,0.6656037414965986,36.13215488215488,135547.63510528876,1383.1391337274363,0
2380,513.3336444192507,0,0,659,0.0,0.0,1.0,659,17550,12500,5050,0.7122507122507122,226,125,101,161.87696783791847,0.40240635853346923,0.9117277174386478,0.11874882054564506,17890062.53609431,429847.8155547371,18319910.35164905,2379,14,1619.185128983308,99,560,73,31.71586276057078,0.6667718855218856,35.98958333333333,135525.4293521447,1368.9437308297445,0
2381,513.174506478115,0,1,658,0.0,0.0015174506828528073,0.9984825493171472,659,19600,13800,5800,0.7040816326530612,254,138,116,164.4546880219127,0.40225578576117754,0.912151756475587,0.121304889069058,17908067.616600625,437613.13459267514,18345680.7511933,2380,15,1620.185128983308,106,553,76,31.471177113657873,0.6667649371069182,35.815809968847354,135572.59133855742,1278.9867107411078,0
2382,513.321573286663,0,0,658,0.0,0.0,1.0,658,18550,14000,4550,0.7547169811320755,231,140,91,160.76778685172286,0.40216387042203133,0.9099892899847086,0.11900333938435553,17928232.024800107,426306.4369582593,18354538.461758368,2381,16,1622.481762917933,111,547,81,31.455972657212243,0.6667605105105106,35.70498511904762,135668.33285051252,1222.2372328875,0
2383,513.6099196921116,0,0,658,0.0,0.0,1.0,658,19950,15300,4650,0.7669172932330827,246,153,93,159.19718610522787,0.402147292658441,0.9093064264336921,0.11822749618243727,17952278.66050034,420040.44938571885,18372319.109886058,2382,17,1623.481762917933,117,541,84,31.392907025920152,0.6665776353276354,35.60204802259888,135797.4108818723,1160.6616314689938,0
2384,513.57609191597,0,0,658,0.0,0.0,1.0,658,18950,13600,5350,0.7176781002638523,243,136,107,157.86449817415195,0.4021501359376614,0.9092279459076853,0.11774555051786458,17969484.20676271,416798.7213497935,18386282.928112503,2383,18,1624.481762917933,124,534,88,31.290624474966386,0.6666666666666667,35.46666666666668,135857.99551483904,1095.6289960874117,0
2385,513.1530861785504,0,0,658,0.0,0.0,1.0,658,18500,13600,4900,0.7351351351351352,234,136,98,157.48768224760525,0.4017687028015649,0.9091468197228454,0.11794538460707218,17972005.1137435,415973.88614111056,18387978.99988461,2384,19,1625.481762917933,93,565,93,31.171012505408303,0.6750672043010753,35.33909574468083,135811.55980942203,1460.3393527894843,0
2386,512.948250773094,0,0,658,0.0,0.0,1.0,658,18200,12800,5400,0.7032967032967034,236,128,108,158.88472159163712,0.40165800767666116,0.9101243469118541,0.11948424841296428,17982292.812295265,421622.31741216104,18403915.129707426,2385,20,1626.481762917933,95,563,95,31.003402928601695,0.6757675438596491,35.2105034722222,135823.30906701073,1429.7190428106394,0
2387,512.476891255361,0,0,658,0.0,0.0,1.0,658,19250,13800,5450,0.7168831168831169,247,138,109,158.5788837461958,0.4014607130134673,0.9101060441598088,0.11978386595280592,17984429.078317184,419540.13761043083,18403969.215927616,2386,21,1627.481762917933,96,562,88,30.871841643021185,0.6768663194444444,35.07302405498281,135768.9530419859,1414.2599275206865,0
2388,512.121924022729,1,0,659,0.0015174506828528073,0.0,1.0,659,17200,13200,4000,0.7674418604651163,212,132,80,155.8224075853127,0.40147274969135943,0.9087505607101332,0.11821875323243461,17990364.07685278,411660.3687583028,18402024.445611082,2387,0,1626.0106221547799,99,560,75,30.807232308941803,0.6773989898989898,34.93749999999999,135744.31748627423,1371.154722083578,0
2389,511.6529482066006,0,0,659,0.0,0.0,1.0,659,18550,12900,5650,0.6954177897574124,242,129,113,157.26789454068998,0.40137396934042396,0.9095109468771947,0.11994979056177306,17996050.65893939,415690.19943579537,18411740.858375188,2388,1,1627.0106221547799,106,553,76,30.602992096119014,0.6772798742138364,34.77414330218067,135703.59152005977,1280.2225615099978,0
2390,511.27558323198696,0,0,659,0.0,0.0,1.0,659,19100,13600,5500,0.7120418848167539,246,136,110,156.3168255575027,0.4013994331468422,0.9093402953145433,0.11978305722170812,18002236.976918545,411910.50743315555,18414147.484351702,2389,2,1628.0106221547799,109,550,82,30.48251287632776,0.6780389908256881,34.6306818181818,135676.85292528267,1244.7417699567218,0
2391,511.5049368128569,0,1,658,0.0,0.0015174506828528073,0.9984825493171472,659,17900,12400,5500,0.6927374301675978,234,124,110,154.62135591988888,0.40126980795869827,0.9071663772389555,0.10891875612966145,17650635.9380287,396133.0523172691,18046768.99034597,2390,3,1629.0106221547799,95,564,95,33.23183848939194,0.6547149122807018,37.293836805555586,134375.49940512373,1414.4789411065656,8
2392,511.67895337858545,0,0,658,0.0,0.0,1.0,658,19900,14400,5500,0.7236180904522613,254,144,110,152.8909144930886,0.40100337877953735,0.9057665484136621,0.10814390662937537,17674682.467625234,388959.67317004123,18063642.140795276,2391,4,1632.1382978723404,100,558,94,33.14106337061019,0.6546875,37.15965346534656,134489.87342051737,1344.8987342051737,0
2393,512.0133002336424,0,0,658,0.0,0.0,1.0,658,17300,12300,5000,0.7109826589595376,223,123,100,151.32710036808518,0.4011316636826692,0.9041157519837582,0.10735475021830207,17699175.204560995,386772.9725225903,18085948.177083585,2392,5,1633.1382978723404,104,554,79,33.084550130797936,0.6546474358974359,37.06349206349209,134626.98918048208,1294.4902805815584,0
2394,512.0214367231722,0,0,658,0.0,0.0,1.0,658,18150,12800,5350,0.7052341597796143,235,128,107,149.605428886613,0.401041835335773,0.9030227292909341,0.10657913565383637,17717762.61399085,380384.6949554651,18098147.308946315,2393,6,1634.1382978723404,110,548,82,32.99184591968991,0.6546401515151515,36.92755255255258,134698.73250432458,1224.533931857496,0
2395,512.4434954943257,0,0,658,0.0,0.0,1.0,658,19500,14200,5300,0.7282051282051282,248,142,106,149.95030252315263,0.4010655935841742,0.902980380636,0.10708840189042923,17743116.883120734,381017.14886552625,18124134.03198626,2394,7,1635.1382978723404,114,544,84,32.90185127816788,0.6546052631578947,36.84782608695654,134850.61984693166,1182.9001740958918,0
2396,512.9126249653065,0,0,658,0.0,0.0,1.0,658,19000,14400,4600,0.7578947368421053,236,144,92,148.68716833228166,0.40115696404861373,0.9025098657694224,0.10675562725111995,17782648.07618398,378210.3175794651,18160858.393763445,2395,8,1636.1382978723404,119,539,91,32.760047524861264,0.655374649859944,36.67534722222225,135062.53887432962,1134.9793182716776,0
2397,513.3197014131905,0,0,658,0.0,0.0,1.0,658,18750,13500,5250,0.72,240,135,105,150.20930039802536,0.4010453051002454,0.904162185633308,0.10833205837349291,17816200.278336395,384881.7959120058,18201082.0742484,2396,9,1637.1382978723404,127,531,94,32.57403474903472,0.6554297900262467,36.53157552083334,135243.5329854503,1064.9097085468527,0
2398,513.2095309047842,1,0,659,0.0015174506828528073,0.0,1.0,659,19300,13800,5500,0.7150259067357513,248,138,110,149.3263433992022,0.4011665113854925,0.9040998272195377,0.1081526172312602,17830735.54285867,381419.7077466581,18212155.25060533,2397,0,1635.6525037936267,99,560,99,32.459528702020606,0.6626683501683501,36.39583333333335,135284.17071954734,1366.5067749449227,0
2399,513.4829572931775,1,0,660,0.0015151515151515152,0.0,1.0,660,17100,12600,4500,0.7368421052631579,216,126,90,148.5341329414799,0.4015892517741911,0.9034887749880027,0.10810503675103043,17861323.854979504,381503.2503972727,18242827.105376776,2398,0,1634.1727272727273,104,556,104,32.32234425345721,0.6629607371794872,36.240079365079374,135436.22406303338,1302.271385221475,0
2400,513.0916435988999,1,0,661,0.0015128593040847202,0.0,1.0,661,18400,13400,5000,0.7282608695652174,234,134,100,148.26748826604685,0.4018175323583795,0.9033143904958612,0.1084774932360644,17870252.98858656,379315.5050593113,18249568.493645873,2399,0,1632.6989409984872,110,551,99,32.1604027402456,0.6632575757575758,36.07357357357358,135418.44392431973,1231.0767629483612,0
2401,512.9180533933726,0,0,661,0.0,0.0,1.0,661,19800,13800,6000,0.696969696969697,258,138,120,148.0382432078509,0.4016523976527759,0.9038577727391968,0.1086967290490257,17879511.24199808,377370.2867360859,18256881.528734166,2400,1,1633.6989409984872,112,549,74,32.051752027836926,0.6639694940476191,35.960545722713874,135430.60290695468,1209.2018116692382,0
2402,512.8116498091487,0,0,661,0.0,0.0,1.0,661,18900,13100,5800,0.6931216931216931,247,131,116,146.69809960153194,0.4015257529913354,0.9030337113441418,0.10803650229543005,17888652.13031015,373746.2543898812,18262398.384700034,2401,2,1634.6989409984872,115,546,79,31.990860361279243,0.6643115942028985,35.86566091954024,135451.1661951002,1177.8362277834801,0
2403,512.6607803298566,0,0,661,0.0,0.0,1.0,661,18100,13700,4400,0.7569060773480663,225,137,88,148.14366391651768,0.4014673971179266,0.9044167231858105,0.10948388621710967,17898348.935939524,380005.39788528177,18278354.333824806,2402,3,1635.6989409984872,119,542,81,31.840589172497673,0.6646533613445378,35.75520833333335,135467.94109393473,1138.3860596128968,0
2404,512.2415777695813,0,0,661,0.0,0.0,1.0,661,18550,13300,5250,0.7169811320754716,238,133,105,150.279341739064,0.40148793150873335,0.9059261345611687,0.11153474608048156,17901786.742082585,387303.745510662,18289090.48759325,2403,4,1636.6989409984872,126,535,83,31.648659758632515,0.6647652116402116,35.621719160105016,135425.5477054391,1074.8059341701514,0
2405,512.4001525488846,0,0,661,0.0,0.0,1.0,661,18050,13200,4850,0.7313019390581718,229,132,97,149.80445698734823,0.40124581671480314,0.9058939913159065,0.11156916778516435,17922083.86623412,386711.6083325947,18308795.474566713,2404,5,1637.6989409984872,129,532,90,31.55068468250127,0.6653746770025839,35.512820512820554,135523.27111645773,1050.567993150835,0
2406,512.2320552242538,0,0,661,0.0,0.0,1.0,661,19050,13500,5550,0.7086614173228346,246,135,111,156.60010508230542,0.40122423172725746,0.9107881697322102,0.11724167563006072,17938342.77313742,410579.2726551469,18348922.04579257,2405,6,1638.6989409984872,92,569,92,31.205032165227696,0.6752717391304348,35.3494623655914,135562.48880867692,1473.5053131377927,0
2407,512.637020997232,0,0,661,0.0,0.0,1.0,661,16350,11200,5150,0.6850152905198776,215,112,103,155.28863747619604,0.4009784875991382,0.9097726544822049,0.11673916610271473,17969909.258519176,409554.5448652622,18379463.80338444,2406,7,1639.6989409984872,95,566,95,31.10964265224161,0.6756578947368421,35.22135416666666,135735.3362236806,1428.7930128808487,0
2408,512.3279148616901,0,0,661,0.0,0.0,1.0,661,17100,12400,4700,0.7251461988304093,218,124,94,136.66362680273693,0.40107982243004936,0.8979610200506345,0.09625170794259512,17678248.291187916,333894.70539861365,18012142.99658653,2407,8,1640.6989409984872,103,558,103,33.70952163082711,0.6525080906148868,37.29967948717953,134588.7074418333,1306.686480017799,8
2409,512.7952428929764,1,0,662,0.0015105740181268882,0.0,1.0,662,19050,14300,4750,0.7506561679790026,238,143,95,136.41150499011093,0.4012122775464561,0.8976391553323715,0.09654539917173735,17715870.559152305,331879.7130367983,18047750.272189103,2408,0,1639.2190332326284,109,553,94,33.55444076182242,0.6527140672782874,37.140151515151544,134793.27985060046,1236.6355949596373,0
2410,513.2018493522465,0,0,662,0.0,0.0,1.0,662,18900,13800,5100,0.7301587301587301,240,138,102,136.65309203574782,0.4011467660156649,0.8974979628404465,0.09700549291082343,17743008.671677224,333627.39940035966,18076636.071077585,2409,1,1640.2190332326284,113,549,76,33.44974170083634,0.6528392330383481,37.04312865497078,134949.95267415076,1194.2473687977943,0
2411,512.7512696171018,1,0,663,0.0015082956259426848,0.0,1.0,663,19200,13800,5400,0.71875,246,138,108,150.39620299159202,0.4012466982299931,0.9055676606171437,0.10406144799707157,17614392.67143305,378027.55515728256,17992420.22659033,2410,0,1638.7435897435898,116,547,79,33.94069211870067,0.6437679597701149,37.88283475783472,134400.9092663537,1158.6285281582216,8
2412,512.4970463852288,0,0,663,0.0,0.0,1.0,663,18650,13600,5050,0.7292225201072386,237,136,101,153.58995034820896,0.4011916370855415,0.9079244183608548,0.10676828669660228,17626376.657659218,390196.86313373526,18016573.520792954,2411,1,1639.7435897435898,122,541,82,33.70043430527302,0.6442110655737705,37.72865853658534,134413.2878514902,1101.7482610777886,0
2413,512.8602356671119,1,0,664,0.0015060240963855422,0.0,1.0,664,18550,13200,5350,0.7115902964959568,239,132,107,156.08499242178868,0.4015163216970446,0.910662217187302,0.1089891005983749,17658683.628621437,399901.1000704225,18058584.72869186,2412,0,1638.2725903614457,127,537,86,33.48541938018155,0.6448490813648293,37.581380208333314,134584.0751897911,1059.7171274786701,0
2414,512.5153964387614,0,0,664,0.0,0.0,1.0,664,19400,14000,5400,0.7216494845360825,248,140,108,154.9188666290429,0.40158281126012346,0.9096099369287542,0.10862466358513796,17665133.626524802,395132.4960543675,18060266.12257917,2413,1,1639.2725903614457,94,570,94,33.37770585369252,0.653479609929078,37.445175438596515,134563.38999699827,1431.5254254999816,0
2415,512.8217787672722,0,0,664,0.0,0.0,1.0,664,18150,13400,4750,0.7382920110192838,229,134,95,155.89499945176516,0.4014548957519368,0.9103681746151815,0.10970657403280126,17691691.35921388,400659.2429490944,18092350.602162976,2414,2,1640.2725903614457,95,569,95,33.23143864287288,0.6543859649122807,37.326388888888914,134704.748485224,1417.9447208970948,0
2416,512.9862765618161,0,0,664,0.0,0.0,1.0,664,19450,13900,5550,0.7146529562982005,250,139,111,153.95074616965562,0.4014632246936464,0.9089073810252191,0.1087557239575553,17714278.70869634,393175.2850122128,18107453.99370855,2415,3,1641.2725903614457,100,564,91,33.155095953847976,0.6542708333333334,37.200907590759094,134812.32789884205,1348.1232789884205,0
2417,512.6762734647197,1,0,665,0.0015037593984962407,0.0,1.0,665,17700,12000,5700,0.6779661016949152,234,120,114,150.20225881077306,0.40161218180994657,0.9067629833984008,0.10660774645248527,17724187.07996657,381742.58699914394,18105929.666965716,2416,0,1639.803007518797,105,560,74,33.09835687769391,0.6545634920634921,37.047955974842786,134809.27403074957,1283.8978479119007,0
2418,512.1778227159036,0,0,665,0.0,0.0,1.0,665,18400,13000,5400,0.7065217391304348,238,130,108,146.61299337123788,0.40169465455808195,0.9044268790457415,0.10467569600461712,17732697.26842238,368568.765413881,18101266.03383626,2417,1,1640.803007518797,114,551,80,32.99886406664142,0.6545138888888888,36.85688405797104,134776.06818586838,1182.2462121567403,0
2419,512.0514331136851,1,2,664,0.0015015015015015015,0.003003003003003003,0.996996996996997,666,19300,13200,6100,0.6839378238341969,254,132,122,146.78098848720174,0.40195599735073423,0.9049515475844674,0.10522400820242932,17746068.416999824,368457.09280175343,18114525.509801578,2418,0,1639.337837837838,120,546,84,32.860833169838465,0.6546875,36.725206611570265,134810.2352572559,1123.418627143799,0
2420,511.6533659225269,0,0,664,0.0,0.0,1.0,664,18000,12700,5300,0.7055555555555556,233,127,106,147.4680003456887,0.40169482606141,0.9050356623456342,0.10604610127247983,17745773.622589022,372586.750142094,18118360.372731116,2419,1,1644.1551204819277,124,540,88,32.74106154089544,0.6549899193548387,36.625,134756.70524984546,1086.7476229826248,0
2421,511.19756925422735,0,0,664,0.0,0.0,1.0,664,19550,14400,5150,0.7365728900255755,247,144,103,148.32400393920236,0.4018067462156318,0.9063800012652439,0.10708411421649824,17747055.776993167,374112.87419519335,18121168.65118836,2420,2,1645.1551204819277,130,534,92,32.589725793147835,0.6552884615384615,36.498091603053425,134701.53506636855,1036.1656543566812,0
2422,511.5567105999335,0,0,664,0.0,0.0,1.0,664,18350,13100,5250,0.7138964577656676,236,131,105,151.46634597401453,0.40164343270517966,0.9081751768350967,0.10978598871672586,17776588.369447276,387360.9768408676,18163949.346288145,2421,3,1646.1551204819277,95,569,95,32.378443639556565,0.6640350877192982,36.37152777777777,134860.91407048574,1419.5885691630078,0
2423,511.65314991344644,0,0,664,0.0,0.0,1.0,664,18650,13700,4950,0.7345844504021448,236,137,99,148.77629191355376,0.4016096437030172,0.9063096373764847,0.10831066512067043,17798841.170011375,378159.1179265203,18177000.287937894,2422,4,1647.1551204819277,100,564,100,32.307184750733164,0.6640625,36.23143564356437,134958.01680111853,1349.5801680111854,0
2424,511.39204453272066,0,0,664,0.0,0.0,1.0,664,20150,14300,5850,0.7096774193548387,260,143,117,147.96188098773996,0.40163269026331566,0.9059153716922714,0.1080912367215779,17804614.145200424,373930.83983695495,18178544.98503738,2423,5,1648.1551204819277,101,563,98,32.216924997097394,0.6649133663366337,36.12132352941176,134945.45586888236,1336.0936224641819,0
2425,511.1760368018014,1,1,664,0.0015037593984962407,0.0015037593984962407,0.9984962406015038,665,17350,12600,4750,0.7262247838616714,221,126,95,149.4870209141298,0.40170107120210163,0.9066885511404434,0.10985705749732033,17822542.924118392,382497.76936813426,18205040.693486527,2424,0,1646.6751879699248,108,557,75,31.985258637328677,0.6651234567901234,35.93272171253823,134984.86476402348,1249.8598589261435,0
2426,511.18697634157854,0,0,664,0.0,0.0,1.0,664,17450,12800,4650,0.7335243553008596,221,128,93,152.8935340634124,0.4015018406961178,0.9079612702730413,0.11283215017635342,17840785.412779044,395298.1464453556,18236083.5592244,2425,7,1650.1551204819277,113,551,78,31.760998132392622,0.6653761061946903,35.80043859649124,135055.37494463156,1195.180309244527,0
2427,511.6327968666409,0,0,664,0.0,0.0,1.0,664,19750,14500,5250,0.7341772151898734,250,145,105,155.75719291625188,0.4014816335477657,0.9085196308122021,0.11525585446657347,17867827.38827048,404058.52750182967,18271885.915772308,2426,8,1651.1551204819277,121,543,80,31.59908436446655,0.6646866391184574,35.715505464480884,135216.6151076948,1117.4926868404527,0
2428,511.39903246091063,0,0,664,0.0,0.0,1.0,664,19700,14300,5400,0.7258883248730964,251,143,108,158.45311093015135,0.40127809503473927,0.9111522333057995,0.11780318908501011,17879621.96174493,414116.3444187107,18293738.306163643,2427,9,1652.1551204819277,123,541,84,31.377867081771395,0.665819783197832,35.56787634408603,135230.33218921893,1099.4335950343002,0
2429,511.757982759577,0,0,664,0.0,0.0,1.0,664,18650,13000,5650,0.6970509383378016,243,130,113,160.91608006031632,0.40119996388268003,0.9132871110622396,0.11989634525965924,17901447.73059036,424676.1592422504,18326123.88983261,2428,10,1653.1551204819277,125,539,85,31.243097664145367,0.6661666666666667,35.49933862433863,135360.32490418263,1082.8825992334612,0
2430,511.87854340108464,0,0,664,0.0,0.0,1.0,664,18300,12900,5400,0.7049180327868853,237,129,108,164.17241785581587,0.40094626242526665,0.9146629083177635,0.12295835525087072,17927595.642321024,437543.3445882423,18365138.986909267,2429,11,1654.1551204819277,91,573,91,30.992379679144378,0.6757097069597069,35.33740942028984,135475.10135869883,1488.737377568119,0
2431,511.96278214667853,0,0,664,0.0,0.0,1.0,664,18600,13100,5500,0.7043010752688172,241,131,110,161.37103261637128,0.40081399315209554,0.9130257829828321,0.1211914022557466,17942094.412326377,427666.8605235015,18369761.27284988,2430,12,1655.1551204819277,94,570,94,30.979930282322037,0.6756427304964538,35.252192982456116,135541.02384793252,1441.9257856163033,0
2432,512.2921704415287,0,0,664,0.0,0.0,1.0,664,19550,13900,5650,0.710997442455243,252,139,113,159.603835539928,0.40064850275915126,0.9116291517104098,0.12042493866061904,17973300.341560546,421371.53436482575,18394671.875925373,2431,13,1656.1551204819277,100,564,88,30.879471006592965,0.6754166666666667,35.10726072607258,135702.47633684086,1357.0247633684087,0
2433,512.1810429209039,0,0,664,0.0,0.0,1.0,664,18450,13300,5150,0.7208672086720868,236,133,103,157.9025529885494,0.40062309002223073,0.9104311595275449,0.11945416183334379,17980422.46051446,416580.92206557136,18397003.38258003,2432,14,1657.1551204819277,103,561,90,30.842035217035175,0.6754652103559871,35.026041666666636,135714.63832604524,1317.617847825682,0
2434,512.0241515359509,0,0,664,0.0,0.0,1.0,664,17150,12000,5150,0.6997084548104956,223,120,103,155.00396223806072,0.40049763533773103,0.9090014739216372,0.11768173040730734,17989917.05690074,407751.6848307289,18397668.74173147,2433,15,1658.1551204819277,105,559,75,30.806572443620613,0.6760912698412698,34.91548742138361,135729.6726383851,1292.6635489370008,0
2435,512.3245553367813,0,2,662,0.0,0.0030120481927710845,0.9969879518072289,664,18250,12800,5450,0.7013698630136986,237,128,109,154.40281570657183,0.40000812071816677,0.9085767070546575,0.11781968636961346,18021627.191941462,405467.9964099669,18427095.18835143,2434,16,1659.1551204819277,110,554,79,30.664375766581724,0.6765151515151515,34.759759759759724,135889.0881385,1235.3553467136364,0
2436,512.160878064421,0,0,662,0.0,0.0,1.0,662,18000,12500,5500,0.6944444444444444,235,125,110,153.96831778182286,0.39979682855632387,0.9081353721945458,0.1180162052309299,18034564.771460265,404950.3199578015,18439515.091418065,2435,17,1663.214501510574,117,545,82,30.53619741423276,0.676460113960114,34.62217514124289,135916.13979848436,1161.6764085340544,0
2437,512.0584501020091,0,0,662,0.0,0.0,1.0,662,16850,10500,6350,0.6231454005934718,232,105,127,152.9625730246496,0.3997389346453922,0.9077868243224863,0.11764605001941883,18045142.9827579,402796.3002480594,18447939.28300596,2436,18,1664.214501510574,123,539,87,30.45692523916505,0.6764058265582655,34.51780913978491,135942.39918156504,1105.2227575736995,0
2438,511.72769403367954,0,0,662,0.0,0.0,1.0,662,18950,13800,5150,0.7282321899736148,241,138,103,151.82429475493717,0.3997076071837202,0.9069857301448165,0.11688777488381792,18037648.426576853,396360.65028049756,18434009.07685735,2437,19,1665.214501510574,129,533,88,30.45604981490419,0.6757105943152455,34.48717948717945,135870.26337740166,1053.2578556387725,0
2439,511.3203551598,0,0,662,0.0,0.0,1.0,662,15850,10700,5150,0.6750788643533123,210,107,103,152.09534794309855,0.39954911308051977,0.9073810793199455,0.11752822341057645,18038523.271628734,400465.09467561194,18438988.366304345,2438,20,1666.214501510574,104,558,94,30.334967320261438,0.6817908653846154,34.37500000000001,135819.46933932224,1305.9564359550216,0
2440,510.8637766491279,0,1,661,0.0,0.0015105740181268882,0.9984894259818731,662,17200,12900,4300,0.75,215,129,86,150.7305061543393,0.3995070733409205,0.9065736372510147,0.11696350449630125,18039728.547057897,394227.4829569896,18433956.030014887,2439,21,1667.214501510574,97,565,97,30.241747326880553,0.6849226804123711,34.247448979591866,135763.3518684271,1399.6221842105886,0
2441,510.832507693221,0,0,661,0.0,0.0,1.0,661,18000,12800,5200,0.7111111111111111,232,128,104,151.9738324385091,0.39930526902917224,0.9068189819446895,0.11839629575196073,18054915.086573258,398574.92801168736,18453490.014584944,2440,22,1669.6217851739789,100,561,100,30.086908594851106,0.6853125,34.12747524752479,135816.32854603697,1358.1632854603697,0
2442,510.8070436454899,0,0,661,0.0,0.0,1.0,661,17550,13200,4350,0.7521367521367521,219,132,87,152.82106380397076,0.39909763291003836,0.9062733170310993,0.11964115131357798,18074109.998457212,402670.9434548484,18476780.94191206,2441,23,1670.6217851739789,107,554,89,29.91419969060827,0.685066199376947,33.979552469135825,135885.1183524922,1269.9543771260953,0
2443,511.2885608954597,0,1,660,0.0,0.0015128593040847202,0.9984871406959153,661,17700,12000,5700,0.6779661016949152,234,120,114,150.98878859144818,0.3989069973563166,0.9046478002690832,0.11862947345429957,18105762.044735458,396853.4155319287,18502615.460267387,2442,24,1671.6217851739789,115,546,74,29.853893912808758,0.6844202898550724,33.87212643678162,136068.13748830752,1183.2011955505002,0
2444,511.3143860629963,0,0,660,0.0,0.0,1.0,660,18200,13800,4400,0.7582417582417582,226,138,88,149.58919511783571,0.3986338632914885,0.904176765518359,0.11809898069788455,18126397.234263536,392102.6345319352,18518499.86879547,2443,25,1674.1136363636363,118,542,81,29.74408812474662,0.6852930790960452,33.727240896358566,136149.09234638,1153.8058673422033,0
2445,511.54411452429343,0,0,660,0.0,0.0,1.0,660,18700,14400,4300,0.7700534759358288,230,144,86,147.2579276886077,0.398469855995463,0.9029813246414755,0.11690339800684728,18157056.84175803,384054.1126883178,18541110.95444635,2444,26,1675.1136363636363,122,538,90,29.638480976447106,0.686219262295082,33.561991869918735,136294.79494452107,1117.1704503649269,0
2446,511.63031133725417,0,0,660,0.0,0.0,1.0,660,18400,12500,5900,0.6793478260869565,243,125,118,150.19870583931683,0.3983192126117012,0.9059895569013534,0.11975784053123123,18177767.282943666,395655.4241892904,18573422.707132958,2445,27,1676.1136363636363,125,535,92,29.42873092668407,0.687,33.43253968253971,136383.99271460527,1091.071941716842,0
2447,511.67020356679404,0,0,660,0.0,0.0,1.0,660,17900,13100,4800,0.7318435754189944,227,131,96,151.66708077436164,0.3981873936634938,0.9072741660246924,0.12126807097571494,18190531.789944075,401880.97086281417,18592412.76080689,2446,28,1677.1136363636363,129,531,95,29.30514654326185,0.6871770025839794,33.349358974359,136437.18777480742,1057.6526184093598,0
2448,511.5579702049337,0,0,660,0.0,0.0,1.0,660,18300,13700,4600,0.7486338797814208,229,137,92,152.35338695833727,0.39807693781517756,0.908043844239498,0.12223701976889818,18200449.258448638,404280.0177375997,18604729.27618624,2447,29,1678.1136363636363,96,564,96,29.183356816961915,0.6953125,33.24742268041236,136459.40700054244,1421.4521562556504,0
2449,511.45662840722485,0,0,660,0.0,0.0,1.0,660,15900,10800,5100,0.6792452830188679,210,108,102,150.79589617836268,0.39796576347695467,0.9072277476121364,0.1215423548320357,18215273.384373892,401457.69482610637,18616731.0792,2448,30,1679.1136363636363,98,562,98,29.08781785925491,0.6961096938775511,33.11237373737373,136501.44549189,1392.8718927743876,0
2450,511.5898866387995,0,0,660,0.0,0.0,1.0,660,19350,14400,4950,0.7441860465116279,243,144,99,150.80952253063603,0.39769762304379147,0.9070102987661899,0.12233159532323712,18245634.06626206,398973.0723603332,18644607.138622392,2449,31,1680.1136363636363,101,559,92,28.897088814112372,0.6971947194719472,32.92483660130717,136632.95256717503,1352.8015105660895,0
2451,511.9251835237372,0,0,660,0.0,0.0,1.0,660,18250,12900,5350,0.7068493150684931,236,129,107,149.57150574751708,0.3977008322987079,0.9060475777228683,0.12181422987377852,18273620.253908433,396392.57936707896,18670012.83327551,2450,32,1681.1136363636363,106,554,77,28.811195924117666,0.6971305031446541,32.80763239875388,136782.5018204091,1290.400960569897,0
2452,512.3112641881995,0,0,660,0.0,0.0,1.0,660,16350,10400,5950,0.636085626911315,223,104,119,149.28310332136533,0.39750516354746246,0.9063141690391241,0.12207310082721542,18303590.47387306,398133.35757262644,18701723.831445687,2451,33,1682.1136363636363,109,551,80,28.698898257049738,0.6976299694189603,32.68939393939392,136946.23452182196,1256.3874726772656,0
2453,512.3403626964813,0,0,660,0.0,0.0,1.0,660,18300,13100,5200,0.7158469945355191,235,131,104,147.31922109784767,0.39738445724314464,0.9050523874791034,0.12096260610738878,18320979.315216012,389506.4804934794,18710485.79570949,2452,34,1683.1136363636363,115,545,84,28.63028580862521,0.6975543478260869,32.57004310344827,137015.16111228333,1191.4361835850725,0
2454,512.7365721094482,0,0,660,0.0,0.0,1.0,660,17450,12100,5350,0.6934097421203438,228,121,107,147.4834700005863,0.3972923947364388,0.9051064323620501,0.12124494871019369,18339991.081108782,391519.10488434526,18731510.185993128,2453,35,1684.1136363636363,119,541,84,28.590051495088545,0.6971288515406162,32.53472222222222,137139.2296860789,1152.4305015636883,0
2455,512.3365518367929,0,0,660,0.0,0.0,1.0,660,18500,14000,4500,0.7567567567567568,230,140,90,127.48908642471065,0.3971428051378734,0.8890545930820999,0.09685364923906935,18003562.57953903,308551.5491310979,18312114.12867013,2454,36,1685.1136363636363,119,541,87,31.516044531761548,0.6733193277310925,34.895833333333286,135822.55462756357,1141.3660052736434,8
2456,512.0343969373438,0,0,660,0.0,0.0,1.0,660,20050,14100,5950,0.7032418952618454,260,141,119,128.88093543062647,0.397091792354501,0.889903803001034,0.09821005531097136,18005696.11656295,312068.1917164382,18317764.30827939,2455,37,1686.1136363636363,121,539,91,31.384014810045,0.6738980716253444,34.80191256830597,135790.54276702207,1122.235890636546,0
2457,511.74394745769996,0,0,660,0.0,0.0,1.0,660,17450,12300,5150,0.7048710601719198,226,123,103,131.1485387048323,0.39693453886359803,0.8913644929191433,0.10037907385485108,18013841.834019624,323047.8065983226,18336889.640617948,2456,38,1687.1136363636363,124,536,96,31.186858773031815,0.674731182795699,34.666666666666636,135782.72739210768,1095.0219950976427,0
2458,511.6689716903105,0,0,660,0.0,0.0,1.0,660,19050,14000,5050,0.7349081364829396,241,140,101,132.88667376127665,0.39695326750049814,0.8919588889299959,0.10208948974398,18026709.737125143,328051.89916531375,18354761.636290457,2457,39,1688.1136363636363,134,526,99,31.025025192333803,0.6742848258706468,34.55246913580246,135821.26515501534,1013.5915310075771,0
2459,511.6292471041012,0,0,660,0.0,0.0,1.0,660,17600,12100,5500,0.6875,231,121,110,132.90979905695326,0.3968010913382689,0.891818247410932,0.10231646039045761,18033802.976123694,329773.82595785044,18363576.802081544,2458,40,1689.1136363636363,144,516,101,30.961053690125063,0.6735387731481481,34.489942528735604,135842.71080258762,943.3521583513029,0
2460,511.17672052303845,0,0,660,0.0,0.0,1.0,660,17950,13500,4450,0.7520891364902507,224,135,89,132.37008381807732,0.3965958427216014,0.8930981800608462,0.09605709133458132,17768428.16122332,320451.66500332736,18088879.826226644,2459,41,1690.1136363636363,108,552,108,32.84395010269419,0.6610725308641976,36.33409785932724,134779.8711700187,1247.9617700927658,8
2461,511.15658645458245,0,0,660,0.0,0.0,1.0,660,16950,11400,5550,0.672566371681416,225,114,111,133.98893556270065,0.3964960684232308,0.8937382818133728,0.09767659103664962,17787340.95756195,327711.37627891504,18115052.333840866,2460,42,1691.1136363636363,111,549,111,32.653835419237325,0.6618806306306306,36.18861607142859,134848.92647678909,1214.8551934845864,0
2462,511.0870227548366,0,0,660,0.0,0.0,1.0,660,20150,14300,5850,0.7096774193548387,260,143,117,131.3522776503429,0.396433607700679,0.8912719935628111,0.09621988746449274,17805691.791827053,315613.63439930446,18121305.42622636,2461,43,1692.1136363636363,117,543,80,32.56735892805393,0.6622150997150997,36.034604519774035,134909.28808629312,1153.0708383443857,0
2463,511.25250839276055,0,0,660,0.0,0.0,1.0,660,16200,11500,4700,0.7098765432098766,209,115,94,132.82119159944918,0.39628205422970214,0.8917228562683108,0.09771240528494618,17829709.3654085,325432.64875708893,18155142.014165588,2462,44,1693.1136363636363,122,538,84,32.391574474907856,0.6626536885245902,35.89939024390247,135022.0992058641,1106.7385180808533,0
2464,510.94031770465705,0,0,660,0.0,0.0,1.0,660,17400,12400,5000,0.7126436781609196,224,124,100,151.49996000869646,0.3963094526448092,0.9032420392674461,0.10716131570015269,17649219.905319963,385371.2219681376,18034591.1272881,2463,45,1694.1136363636363,106,554,98,33.17723187278539,0.6532036163522013,37.159267912772606,134295.9271583738,1266.942709041262,8
2465,510.88188793075534,0,0,660,0.0,0.0,1.0,660,17250,11200,6050,0.6492753623188405,233,112,121,152.36568112079064,0.3965207844760197,0.9041848912635426,0.10815159083236581,17662487.82016074,388981.3974012972,18051469.217562035,2464,46,1695.1136363636363,109,551,74,33.03892970325553,0.6536697247706422,37.04545454545457,134338.714621793,1232.4652717595689,0
2466,510.6774576027913,0,0,660,0.0,0.0,1.0,660,16350,11900,4450,0.72782874617737,208,119,89,149.17950668249168,0.3967061548719364,0.9018363654824215,0.10623781354417003,17669704.50264222,378841.56018591847,18048546.06282814,2465,47,1696.1136363636363,116,544,77,33.01477307340849,0.6532866379310345,36.93910256410258,134339.27029727382,1158.097157735119,0
2467,510.34050693485636,2,0,662,0.0030211480362537764,0.0,1.0,662,18550,13400,5150,0.7223719676549866,237,134,103,146.04041906480234,0.39700359018423975,0.8996181475391511,0.10437922542678246,17673758.346567377,365266.615076546,18039024.961643923,2466,0,1691.9864048338368,125,537,83,32.9786287198174,0.6528333333333334,36.822089947089935,134310.34803045736,1074.482784243659,0
2468,509.9980531497982,0,0,662,0.0,0.0,1.0,662,19600,14800,4800,0.7551020408163265,244,148,96,145.28407427615682,0.3967916299116508,0.8990208717765271,0.10414060114080805,17674476.711546965,361563.997470518,18036040.70901748,2467,1,1692.9864048338368,134,528,85,32.90347792106287,0.652363184079602,36.72839506172839,134268.00596814108,1002.0000445383663,0
2469,510.58999166330614,1,0,663,0.0015082956259426848,0.0,1.0,663,19400,13700,5700,0.7061855670103093,251,137,114,146.97748659264948,0.39705388701301264,0.9010590260143045,0.10607481334854957,17724451.53999723,369019.0677164003,18093470.607713632,2468,0,1691.4313725490197,142,521,98,32.63660427955321,0.653462441314554,36.509324009324004,134535.7020574378,947.4345215312521,0
2470,510.32040222876486,0,0,663,0.0,0.0,1.0,663,19350,14000,5350,0.7235142118863049,247,140,107,148.43762319177156,0.39722448162780494,0.9034026910911528,0.10750686345022656,17730273.630287383,374417.9352439215,18104691.565531306,2469,1,1692.4313725490197,100,563,100,32.48358373436621,0.6623958333333333,36.396452145214525,134522.26857018386,1345.2226857018386,0
2471,510.1338100122755,0,0,663,0.0,0.0,1.0,663,19500,13900,5600,0.7128205128205128,251,139,112,146.24326220856125,0.397124801969746,0.9019374059844134,0.10639801882395206,17743225.681098025,366865.44114130177,18110091.12223933,2470,2,1693.4313725490197,105,558,105,32.39482811083376,0.6625992063492063,36.25196540880504,134546.7897692563,1281.397997802441,0
2472,510.2601080851502,0,0,663,0.0,0.0,1.0,663,17250,12200,5050,0.7072463768115942,223,122,101,142.78036193054953,0.39704857076458283,0.8991565400093517,0.10428904976427697,17764511.058669444,357434.6636952189,18121945.722364664,2471,3,1694.4313725490197,112,551,100,32.35887918486171,0.6622953869047619,36.12647492625371,134644.13342494055,1202.1797627226836,0
2473,510.27412801499105,0,0,663,0.0,0.0,1.0,663,18950,13600,5350,0.7176781002638523,243,136,107,142.53683695777158,0.3969904717638857,0.8986658672997425,0.10444202488478982,17778560.52390645,355269.95654798974,18133830.48045444,2472,4,1695.4313725490197,117,546,74,32.26317175534227,0.6623041310541311,36.02577683615821,134699.2165433651,1151.2753550714965,0
2474,510.07420780022824,0,0,663,0.0,0.0,1.0,663,18700,12600,6100,0.6737967914438503,248,126,122,144.2998053930804,0.39723340533052637,0.9023942741182114,0.09716186896467426,17400937.479165882,350890.37838015985,17751827.857546043,2473,5,1696.4313725490197,115,548,88,35.02389301430143,0.6347826086956522,38.793103448275865,133234.90083057704,1158.564355048496,8
2475,510.27900509269256,1,0,664,0.0015060240963855422,0.0,1.0,664,17200,11900,5300,0.6918604651162791,225,119,106,142.09859719055572,0.3975671255913549,0.9007361770475275,0.09592037707018082,17419224.74679817,345049.4801334094,17764274.22693158,2474,0,1694.875,124,540,91,34.99541540424172,0.6339885752688172,38.70833333333334,133331.65170567887,1075.2552556909586,0
2476,510.56281784899545,0,0,664,0.0,0.0,1.0,664,17450,12700,4750,0.7277936962750716,222,127,95,140.71587199651233,0.3976224468007778,0.8998633036511849,0.09518810447938626,17438419.20395473,340522.4729050447,17778941.676859774,2475,1,1695.875,130,534,95,34.959295486121654,0.6337339743589744,38.637086513994916,133442.1855906384,1026.4783506972185,0
2477,510.3934599379835,0,0,664,0.0,0.0,1.0,664,18400,12400,6000,0.6739130434782609,244,124,120,138.88671226656547,0.3975949991519623,0.898818391952376,0.09424639528653131,17446728.708251905,333423.75801915466,17780152.466271058,2476,2,1696.875,101,563,101,34.90000358030961,0.6405734323432344,38.531454248365975,133451.83573112733,1321.3053042685874,0
2478,510.1998202438877,0,0,664,0.0,0.0,1.0,664,17600,13200,4400,0.75,220,132,88,138.91569071333097,0.39765050965551496,0.8978233857087339,0.09469937448100192,17460626.49218576,334710.99788988964,17795337.49007565,2477,3,1697.875,107,557,107,34.74335637480797,0.6406736760124611,38.37770061728393,133479.65011685307,1247.473365578066,0
2479,510.1161103282887,0,0,664,0.0,0.0,1.0,664,19050,14000,5050,0.7349081364829396,241,140,101,142.05400562960781,0.3977103739240522,0.9001241574909593,0.09713940205188612,17471593.048284363,344531.95544783695,17816125.0037322,2478,4,1698.875,108,556,108,34.55616107398887,0.6414930555555556,38.27408256880732,133510.60697210178,1236.2093238157572,0
2480,510.4072000568137,0,0,664,0.0,0.0,1.0,664,18550,14300,4250,0.77088948787062,228,143,85,143.56625670695954,0.3977240977484599,0.9010269165362621,0.09866273229425984,17503701.999981824,351238.1949303001,17854940.194912124,2479,5,1699.875,112,552,75,34.34852751378625,0.6422991071428572,38.10840707964601,133671.35466089603,1193.4942380437146,0
2481,510.0260929155229,0,0,664,0.0,0.0,1.0,664,18300,12900,5400,0.7049180327868853,237,129,108,140.70267156632164,0.3977608208096337,0.8991396841714194,0.09722944283036819,17515092.59676237,341784.0642191893,17856876.66098156,2480,6,1700.875,119,545,83,34.23788684265731,0.6427696078431373,37.92534722222221,133664.91120844128,1123.2345479700948,0
2482,510.3212925901614,0,0,664,0.0,0.0,1.0,664,16350,11400,4950,0.6972477064220184,213,114,99,139.54642814192738,0.3977175671009831,0.898670250756052,0.09672329094014495,17538653.449839592,340341.288668842,17878994.738508433,2481,7,1701.875,124,540,86,34.16644152018904,0.6428931451612903,37.825,133793.4848848257,1078.9797168131106,0
2483,510.8166454819943,0,0,664,0.0,0.0,1.0,664,18950,13900,5050,0.7335092348284961,240,139,101,148.9358713431327,0.3977120302476876,0.9060757162927342,0.10280207704903875,17537206.06996173,370633.8133907561,17907839.88335249,2482,8,1702.875,107,557,78,34.06029151943462,0.6448598130841121,37.96296296296292,133852.880251298,1250.961497675682,8
2484,511.3373490762278,1,0,665,0.0015037593984962407,0.0,1.0,665,17850,12000,5850,0.6722689075630253,237,120,117,146.08013502341166,0.3978792991514932,0.9040340614467219,0.10116594425501783,17569805.277333103,362469.9054495657,17932275.18278267,2483,0,1701.3127819548872,117,548,80,34.023661997126425,0.6438746438746439,37.85310734463273,134045.49715896376,1145.6880099056732,0
2485,511.8655764794613,0,0,665,0.0,0.0,1.0,665,17600,12300,5300,0.6988636363636364,229,123,106,145.15664888444743,0.39801933297098163,0.9040388255518217,0.10095770430272108,17606932.348283224,360552.65936238744,17967485.00764561,2484,1,1702.3127819548872,122,543,85,33.90443210315022,0.6443818306010929,37.71172086720865,134256.34120211055,1100.4618131320537,0
2486,512.029935330185,0,0,665,0.0,0.0,1.0,665,17350,12400,4950,0.7146974063400576,223,124,99,148.0805913500421,0.3978979829090799,0.9065435811922957,0.10347811867270931,17633434.840250764,371883.8917353523,18005318.731986117,2485,2,1703.3127819548872,128,537,90,33.67024604371145,0.6449381510416667,37.55652454780361,134378.9157636168,1049.8352794032562,0
2487,512.4400475372114,0,0,665,0.0,0.0,1.0,665,19200,14400,4800,0.75,240,144,96,146.57134353490062,0.3977325656007489,0.9054691289869614,0.10293324654273094,17669461.90000265,365767.3540444284,18035229.25404708,2486,3,1704.3127819548872,97,568,97,33.54465177149945,0.6531357388316151,37.393707482993214,134569.98102098674,1387.3193919689354,0
2488,512.2252689271728,0,0,665,0.0,0.0,1.0,665,19500,14400,5100,0.7384615384615385,246,144,102,144.7587650152494,0.3976879321798472,0.9045749998155352,0.10206835147421832,17679670.84490244,359357.46347684204,18039028.30837928,2487,4,1705.3127819548872,100,565,100,33.45943735688586,0.6536458333333333,37.26278877887791,134580.63867491586,1345.8063867491585,0
2489,512.3733291474972,0,0,665,0.0,0.0,1.0,665,16750,11500,5250,0.6865671641791045,220,115,105,146.29728291462993,0.3978531607633542,0.9046146198010674,0.1035966168538725,17703602.374970365,368247.78505183716,18071850.160022203,2488,5,1706.3127819548872,104,561,88,33.277197021158834,0.6540464743589743,37.1230158730159,134691.15551339823,1295.1072645519062,0
2490,512.0970817148911,0,0,665,0.0,0.0,1.0,665,19250,13900,5350,0.7220779220779221,246,139,107,143.6574314075846,0.39818154195730293,0.9029374005831554,0.10225286445796411,17716587.64836823,356773.89497438824,18073361.543342616,2489,6,1707.3127819548872,110,555,79,33.1768789392318,0.6543560606060606,36.955705705705725,134704.2154698622,1224.5837769987472,0
2491,512.3994870368583,0,0,665,0.0,0.0,1.0,665,18250,13400,4850,0.7342465753424657,231,134,97,142.90285262510173,0.3981610653138871,0.9022807069768617,0.10190056311260998,17734972.627775468,355625.6359474439,18090598.26372291,2490,7,1708.3127819548872,113,552,81,33.13711189831216,0.6543141592920354,36.89692982456141,134813.87819571767,1193.0431698736077,0
2492,511.9137260025909,0,0,665,0.0,0.0,1.0,665,17500,12200,5300,0.6971428571428572,228,122,106,139.77607442181863,0.39818843041338287,0.9001052577028439,0.10003374804561735,17733977.47499001,345257.15106781275,18079234.626057822,2491,8,1709.3127819548872,119,546,86,33.1003212632875,0.6543242296918768,36.77951388888889,134746.17980535232,1132.3208387004397,0
2493,512.0839338617321,0,0,665,0.0,0.0,1.0,665,19150,14300,4850,0.7467362924281984,240,143,97,141.56402014214504,0.3980734969955008,0.9008603633778389,0.10170005181794856,17756425.761892147,350584.2028417949,18107009.964733943,2492,9,1710.3127819548872,125,540,90,32.928753060840066,0.6545000000000001,36.65674603174601,134853.84944801117,1078.8307955840894,0
2494,511.8227390634392,0,0,665,0.0,0.0,1.0,665,19450,13300,6150,0.6838046272493573,256,133,123,143.10213030898865,0.39828930383186884,0.9026826302132445,0.10312783086292376,17760951.93791726,355876.01172629866,18116827.949643556,2493,10,1711.3127819548872,127,538,92,32.786049672556544,0.6551837270341208,36.555989583333314,134836.63500131425,1061.7057874119232,0
2495,511.70501910878596,0,0,665,0.0,0.0,1.0,665,19100,12600,6500,0.6596858638743456,256,126,130,141.79167847633857,0.398582016034061,0.9017771272129658,0.10241941421934554,17766841.48476822,351738.0550696625,18118579.539837882,2494,11,1712.3127819548872,131,534,97,32.745541730302776,0.6552958015267176,36.482007575757564,134843.4793489551,1029.3395370149244,0
2496,511.25432409357035,0,0,665,0.0,0.0,1.0,665,18950,13800,5150,0.7282321899736148,241,138,103,134.42169552300535,0.39856455898783105,0.894434239326118,0.09290403316186813,17557984.836317383,320084.8183330004,17878069.654650383,2495,12,1713.3127819548872,123,542,85,34.397103446802134,0.6421070460704608,37.92002688172043,133989.5195150472,1089.3456871142048,8
2497,511.31517965311696,0,0,665,0.0,0.0,1.0,665,18350,13400,4950,0.7302452316076294,233,134,99,134.25349859796378,0.3987517740133466,0.8943334739449169,0.09308093149872154,17574063.77415601,320525.9092528342,17894589.683408845,2496,13,1714.3127819548872,131,534,87,34.29574002728948,0.6418575063613232,37.81565656565656,134058.8346653654,1023.3498829417206,0
2498,510.8977614899013,0,0,665,0.0,0.0,1.0,665,19850,15500,4350,0.7808564231738035,242,155,87,135.9506946273217,0.3988221683727391,0.8961242607607454,0.0945867358403837,17575129.803120296,325020.22097990644,17900150.024100203,2497,14,1715.3127819548872,134,531,92,34.13463895589419,0.642568407960199,37.700617283950606,134008.16746981174,1000.0609512672518,0
2499,510.7713123559063,0,0,665,0.0,0.0,1.0,665,18000,13300,4700,0.7388888888888889,227,133,94,137.98751042004147,0.3987801770993749,0.8980044883822031,0.09635085141564836,17586695.979335345,334348.8789405226,17921044.858275868,2498,15,1716.3127819548872,139,526,97,33.960802451633626,0.6430605515587531,37.58184523809522,134035.66529375204,964.2853618255542,0
2500,510.5179407738311,0,0,665,0.0,0.0,1.0,665,18350,13300,5050,0.7247956403269755,234,133,101,137.94406651549522,0.39888671226258415,0.8991168397183453,0.09656084656084679,17588938.428223427,333907.9384959611,17922846.366719387,2499,16,1717.3127819548872,108,557,99,33.87896825396828,0.6493055555555556,37.50000000000001,134010.95945313087,1240.8422171586192,0
2501,510.67638380982044,0,0,665,0.0,0.0,1.0,665,16750,12300,4450,0.7343283582089553,212,123,89,139.26269382005114,0.39910969064226837,0.90007055295626,0.0979364045816566,17614738.803743057,340865.1953491736,17955603.99909223,2500,17,1718.3127819548872,102,563,102,33.6905426565528,0.6522671568627452,37.34830097087381,134130.01986170065,1315.0001947225555,0
2502,510.74509910084896,0,0,665,0.0,0.0,1.0,665,18450,12900,5550,0.6991869918699187,240,129,111,138.80227082222623,0.3990097608479029,0.8988608293812284,0.09812323546612556,17639957.882279474,338243.24225376756,17978201.124533243,2501,18,1719.3127819548872,109,556,101,33.53000168143934,0.6523318042813455,37.17803030303032,134235.03295876,1231.514063841835,0
2503,510.5023476977546,0,0,665,0.0,0.0,1.0,665,20350,15800,4550,0.7764127764127764,249,158,91,136.95898083532285,0.3989411593743395,0.8965196662934358,0.09722912586088187,17649969.435188908,330114.36512361513,17980083.800312523,2502,19,1720.3127819548872,117,548,78,33.43950024618411,0.6520655270655271,37.040960451977405,134241.20703761245,1147.3607439112175,0
2504,510.82606612683946,0,0,665,0.0,0.0,1.0,665,17250,11800,5450,0.6840579710144927,227,118,109,139.33320886134194,0.3990080623244859,0.8986764605433915,0.09919692630874669,17673579.692872193,342253.3141349076,18015833.0070071,2503,20,1721.3127819548872,118,547,80,33.2833488624893,0.6528072033898304,36.94852941176471,134373.54790946853,1138.7588805887162,0
2505,510.92752929717534,1,0,666,0.0015015015015015015,0.0,1.0,666,17350,12200,5150,0.7031700288184438,225,122,103,137.64798883127463,0.3992058317716212,0.8973377702862169,0.09832812884926542,17691756.02686376,336496.9271982783,18028252.95406204,2504,0,1719.7267267267268,122,544,87,33.21707858659976,0.6531762295081966,36.839430894308954,134455.9793816099,1102.0981916525402,0
2506,511.0966939635686,0,0,666,0.0,0.0,1.0,666,18600,13300,5300,0.7150537634408602,239,133,106,137.27923085186336,0.39920592585066267,0.8978227399280039,0.09841363330462068,17713034.08394939,334526.33901948226,18047560.422968872,2505,1,1720.7267267267268,128,538,89,33.11058459084772,0.6533203125,36.724806201550386,134559.0811530053,1051.242821507854,0
2507,510.81714078841975,0,0,666,0.0,0.0,1.0,666,18100,12800,5300,0.7071823204419889,234,128,106,146.47565331691243,0.39909679416258365,0.9037376388313381,0.10540603493506003,17719789.23782034,367803.541049545,18087592.778869882,2506,2,1721.7267267267268,129,537,91,32.74443295205649,0.6543927648578811,36.6025641025641,134547.92509612913,1043.0071712878228,0
2508,510.9674380819408,0,0,666,0.0,0.0,1.0,666,18650,13400,5250,0.7184986595174263,239,134,105,147.63548875939253,0.39914129354918826,0.9055953186387959,0.10671936758893279,17744419.891594566,372091.2206894926,18116511.11228406,2507,3,1722.7267267267268,136,530,95,32.567523056653485,0.6547947303921569,36.45833333333334,134661.21024451216,990.1559576802365,0
2509,510.9620276810446,0,0,666,0.0,0.0,1.0,666,18700,14100,4600,0.7540106951871658,233,141,92,144.24729337554186,0.39901381644802697,0.9035057444610894,0.10468267954525669,17761238.575004302,360502.11828832893,18121740.693292633,2508,4,1723.7267267267268,98,568,98,32.528732192026794,0.6635841836734694,36.33207070707071,134724.2997859778,1374.737752918141,0
2510,510.57046816872565,0,0,666,0.0,0.0,1.0,666,18550,13900,4650,0.7493261455525606,232,139,93,143.574758647317,0.3989183732604786,0.9024674493988571,0.1046584424876497,17766694.53610805,358419.77599646477,18125114.312104516,2509,5,1724.7267267267268,104,562,104,32.402837319494594,0.6634615384615384,36.1904761904762,134693.3520787975,1295.1283853730529,0
2511,510.67851291164277,0,0,666,0.0,0.0,1.0,666,17600,13500,4100,0.7670454545454546,217,135,82,143.1745627597033,0.399050930629878,0.9018976766482507,0.1047229500345836,17785047.65559372,358473.2843500251,18143520.939943746,2510,6,1725.7267267267268,107,559,102,32.30354401929611,0.6638434579439252,36.08217592592593,134777.16192902508,1259.599644196496,0
2512,510.9029228834032,0,0,666,0.0,0.0,1.0,666,18500,13200,5300,0.7135135135135136,238,132,106,144.74925648788414,0.39880881821671293,0.9006394579688282,0.10684926032350006,17831963.60208286,364532.6946241054,18196496.296706963,2511,7,1726.7267267267268,121,545,85,31.967963633229964,0.6639118457300275,35.792349726775974,134984.4607727472,1115.5740559731173,8
2513,510.9339305770151,0,0,666,0.0,0.0,1.0,666,17000,12100,4900,0.711764705882353,219,121,98,144.68014074487584,0.3986717920928447,0.9008017161099284,0.10708356274734632,17844389.257835273,366145.7498659977,18210535.00770127,2512,8,1727.7267267267268,124,542,88,31.884557780230168,0.6642305107526882,35.70833333333336,135035.58006875188,1088.9966134576764,0
2514,510.5971113455958,1,0,667,0.0014992503748125937,0.0,1.0,667,17750,12600,5150,0.7098591549295775,229,126,103,145.10420391339252,0.3989032135583859,0.9015469540023173,0.10793044944227584,17853609.27094843,366976.75204835704,18220586.022996787,2513,0,1726.134932533733,129,538,95,31.71564579987686,0.6649709302325582,35.552884615384656,135025.93321906275,1046.7126606128895,0
2515,510.4922858164745,0,0,667,0.0,0.0,1.0,667,18650,13500,5150,0.7238605898123325,238,135,103,145.71032129009458,0.3988880184532358,0.9026082898111059,0.10863943528636509,17860001.299856752,368427.30552873143,18228428.605385482,2514,1,1727.134932533733,134,533,97,31.624042257355715,0.6649564676616915,35.47839506172841,135036.23875278194,1007.7331250207608,0
2516,510.6388616442345,0,0,667,0.0,0.0,1.0,667,17700,12800,4900,0.7231638418079096,226,128,98,142.32316260159297,0.39876992809901357,0.9003757230696396,0.10652673079573632,17881511.274902653,357890.64734802954,18239401.92225068,2515,2,1728.134932533733,104,563,104,31.590662018293585,0.671875,35.35714285714282,135136.92731370425,1299.3935318625408,0
2517,510.56707923488636,0,0,667,0.0,0.0,1.0,667,18350,12900,5450,0.7029972752043597,238,129,109,145.00270500198252,0.3988439338889114,0.901730814973631,0.10905903773601726,17899368.49122453,367341.369810955,18266709.861035485,2516,3,1729.134932533733,108,559,108,31.366843510899336,0.6724537037037037,35.20642201834859,135194.88371024502,1251.804478798565,0
2518,510.71499328240236,0,0,667,0.0,0.0,1.0,667,18700,13900,4800,0.7433155080213903,235,139,96,142.9178639361898,0.39867069093081087,0.8995811590810561,0.10799770937057142,17924287.508500624,360240.17665860313,18284527.68515923,2517,4,1730.134932533733,116,551,101,31.274083159710536,0.6722341954022988,35.06054131054129,135308.55386482895,1166.4530505588702,0
2519,510.8398051800907,0,0,667,0.0,0.0,1.0,667,18050,12900,5150,0.7146814404432132,232,129,103,144.48982675661694,0.398514800407604,0.9005533278173392,0.10978446126252056,17951549.67041317,367313.2603781534,18318862.930791322,2518,5,1731.134932533733,120,547,75,31.060981219894995,0.6731770833333333,34.8915289256198,135427.95971522608,1128.5663309602173,0
2520,511.1623772985212,0,0,667,0.0,0.0,1.0,667,18600,13600,5000,0.7311827956989247,236,136,100,143.418701143463,0.3984778444111278,0.8995589178196832,0.1093069259677145,17975748.051963333,363611.6875389377,18339359.73950227,2519,6,1732.134932533733,125,542,80,30.99311465444681,0.67325,34.79662698412696,135561.98661837867,1084.4958929470292,0
2521,510.78487407865595,0,0,667,0.0,0.0,1.0,667,18800,13700,5100,0.7287234042553191,239,137,102,143.71266241283175,0.3985186460823642,0.9002600910223444,0.11008656376235848,17983520.919827238,364691.93418904144,18348212.854016278,2520,7,1733.134932533733,132,535,86,30.82775006640887,0.6736900252525253,34.641290726817026,135541.21490177631,1026.8273856195176,0
2522,511.00397048851374,0,0,667,0.0,0.0,1.0,667,18950,14200,4750,0.7493403693931399,237,142,95,145.6992344054774,0.39848863105984544,0.9026336707043907,0.11191432282353433,18002601.0209752,372243.03721267235,18374844.058187872,2521,8,1734.134932533733,136,531,88,30.6900045830827,0.6739430147058824,34.557481751824824,135642.18076128775,997.3689761859393,0
2523,511.01758214310047,0,0,667,0.0,0.0,1.0,667,19050,14000,5050,0.7349081364829396,241,140,101,149.09850399106364,0.3984500805152979,0.9064846439486618,0.11492942112080437,18017671.09254204,384831.5610602149,18402502.653602257,2522,9,1735.134932533733,138,529,90,30.490628380603024,0.6747433574879227,34.44994004796165,135700.7495746471,983.3387650336747,0
2524,511.33258124971184,0,0,667,0.0,0.0,1.0,667,17950,13300,4650,0.7409470752089137,226,133,93,153.3561339157814,0.39824897986442215,0.9099683651723345,0.11863342414267891,18043518.811598428,402066.8574366877,18445585.669035114,2523,10,1736.134932533733,92,575,92,30.267360232734653,0.6854619565217391,34.341397849462396,135839.898768826,1476.520638791587,0
2525,511.5204966819462,0,0,667,0.0,0.0,1.0,667,19000,13600,5400,0.7157894736842105,244,136,108,155.19386752856477,0.3979591473032253,0.9084315935527507,0.11871600123621665,18003627.922451798,406410.5293661029,18410038.4518179,2524,11,1737.134932533733,117,550,81,30.566426828592014,0.6758368945868947,34.68396892655364,135714.58799236995,1159.9537435245295,8
2526,512.0444321452596,0,0,667,0.0,0.0,1.0,667,18450,13200,5250,0.7154471544715447,237,132,105,158.18887072994374,0.39781882707294997,0.9109921719744831,0.12155442389999725,18040848.898104064,418922.30284011876,18459771.20094418,2525,12,1738.134932533733,121,546,83,30.34657446124151,0.6764807162534435,34.545765027322375,135924.3630071372,1123.3418430341917,0
2527,512.4738817507924,0,0,667,0.0,0.0,1.0,667,18600,13100,5500,0.7043010752688172,241,131,110,156.69054564770266,0.39769651585618604,0.909920594717545,0.12066272885217152,18064930.87642282,414120.7752229399,18479051.651645757,2526,13,1739.134932533733,128,539,87,30.319526387283805,0.6759440104166667,34.4799741602067,136072.0783246884,1063.063111911628,0
2528,511.96733328943907,0,0,667,0.0,0.0,1.0,667,16750,12200,4550,0.7283582089552239,213,122,91,183.22730918162736,0.39788401594998296,0.921169638100185,0.13095838183061548,17730118.485304873,499578.3803067688,18229696.865611643,2527,14,1740.134932533733,105,562,72,31.999793074692278,0.6568452380952381,36.821933962264154,134738.5726496116,1283.2245014248724,8
2529,512.1489520650356,0,0,667,0.0,0.0,1.0,667,19350,13800,5550,0.7131782945736435,249,138,111,192.19750012272846,0.39795652098875484,0.9248469342254717,0.1379515665568553,17754788.09049804,529735.1772405014,18284523.267738543,2528,15,1741.134932533733,109,558,73,31.62476923445776,0.6573012232415902,36.685606060606055,134856.19091970028,1237.2127607311952,0
2530,512.2503914800322,0,0,667,0.0,0.0,1.0,667,18500,13400,5100,0.7243243243243244,236,134,102,168.5510902177856,0.39799141345243294,0.9141769283985048,0.12111221568603484,17763078.104442474,446897.2360254988,18209975.34046797,2529,16,1742.134932533733,113,554,83,32.21143003365604,0.6568030973451328,36.650219298245645,134901.02826065608,1193.814409386337,8
2531,512.3169543016476,1,0,668,0.0014970059880239522,0.0,1.0,668,17750,13200,4550,0.7436619718309859,223,132,91,170.61823488217343,0.3979987457618496,0.9160529579096903,0.12309505575364502,17782942.45812924,455468.850643462,18238411.3087727,2530,0,1740.5254491017963,117,551,85,32.0246800348444,0.6573183760683761,36.5201271186441,134985.20599436326,1153.7197093535322,0
2532,511.98715413197436,0,0,668,0.0,0.0,1.0,668,20450,15200,5250,0.7432762836185819,257,152,105,167.58240856364915,0.3980184776623665,0.9145749709491522,0.1213984047440165,17789100.052275144,442178.04658800224,18231278.098863147,2531,1,1741.5254491017963,90,578,90,31.972006310883398,0.6653935185185185,36.38965201465202,134965.11186475804,1499.6123540528672,0
2533,511.84262194484785,0,0,668,0.0,0.0,1.0,668,17350,12500,4850,0.7204610951008645,222,125,97,165.7879721751943,0.3979438985597022,0.9130798704511924,0.12078128233596497,17808492.85071941,439536.7834434437,18248029.634162854,2532,2,1742.5254491017963,95,573,95,31.835426007431504,0.6656798245614035,36.208767361111114,135019.59615995234,1421.2589069468668,0
2534,511.4136613330943,0,0,668,0.0,0.0,1.0,668,18700,13700,5000,0.732620320855615,237,137,100,169.30764314765406,0.3978905476154138,0.9149054372853047,0.12368256454514266,17805280.619243678,450614.01944535016,18255894.638689026,2533,3,1743.5254491017963,95,573,88,31.654304933042763,0.6665570175438597,36.12196180555556,134950.833658415,1420.5350911412106,0
2535,511.17409607448195,1,0,669,0.0014947683109118087,0.0,1.0,669,16350,10900,5450,0.6666666666666666,218,109,109,168.5778436192736,0.3979901743598006,0.9138163209071293,0.12362375198746728,17813394.90000354,450438.73995623295,18263833.639959775,2534,0,1741.9177877429,99,570,75,31.549544928451187,0.6666666666666667,36.0,134949.9613636632,1363.130922865285,0
2536,510.85070802261936,0,0,669,0.0,0.0,1.0,669,18250,13400,4850,0.7342465753424657,231,134,97,168.52738683029938,0.39795959277260123,0.9139448871235518,0.1238507908113128,17811237.63648671,448286.2670181163,18259523.903504826,2535,1,1742.9177877429,102,567,75,31.482181839071632,0.6665645424836601,35.93244336569579,134899.09827243735,1322.5401791415427,0
2537,511.10781557874,0,0,669,0.0,0.0,1.0,669,18250,12800,5450,0.7013698630136986,237,128,109,166.60955229793814,0.39802001005462917,0.9133215102003305,0.12280316356788751,17832784.914155103,442172.4621545592,18274957.376309663,2536,2,1743.9177877429,105,564,77,31.43805878997556,0.666765873015873,35.83922955974842,135014.63434131345,1285.8536603934615,0
2538,510.7549753774709,0,0,669,0.0,0.0,1.0,669,20250,14300,5950,0.7061728395061728,262,143,119,165.69745831354737,0.3979428101942602,0.9133138294618599,0.12252128435871341,17834048.920334015,436961.31550776097,18271010.235841777,2537,3,1744.9177877429,109,560,79,31.359892735134622,0.6668577981651376,35.73863636363636,134972.80627730754,1238.2826263973168,0
2539,511.01824033195726,0,0,669,0.0,0.0,1.0,669,18750,12800,5950,0.6826666666666666,247,128,119,172.1030286872206,0.3978723233652277,0.9181736537198883,0.11958997542932956,17573752.5709911,452349.20857347205,18026101.77956457,2538,4,1745.9177877429,111,558,72,33.2282726907345,0.6462087087087087,37.741815476190446,134018.71596800926,1207.375819531615,8
2540,511.218104307094,0,0,669,0.0,0.0,1.0,669,18500,13900,4600,0.7513513513513513,231,139,92,173.51851222997416,0.3980277486879753,0.9191073065906372,0.12093764234609358,17593950.37519242,458275.218670271,18052225.59386269,2539,5,1746.9177877429,116,553,76,33.09006097009184,0.6461925287356323,37.64245014245012,134121.9292888294,1156.2235283519774,0
2541,511.21283591576696,0,0,669,0.0,0.0,1.0,669,18750,13900,4850,0.7413333333333333,236,139,97,173.14604625626535,0.3980167467755073,0.9197169522440924,0.12100850253741995,17605832.471406035,457126.0566948215,18062958.528100856,2540,6,1747.9177877429,118,551,80,33.008346674671444,0.6467161016949152,37.552521008403346,134166.52001423688,1137.0044069003127,0
2542,511.47193869347257,0,0,669,0.0,0.0,1.0,669,19450,13900,5550,0.7146529562982005,250,139,111,172.14820106320659,0.3980436921373993,0.9197354504139115,0.12095000957396146,17638072.66973639,454022.4960634469,18092095.165799838,2541,7,1748.9177877429,85,584,85,32.85790056267874,0.6571078431372549,37.378875968992254,134323.33544999873,1580.2745347058674,0
2543,511.2269879420453,0,0,669,0.0,0.0,1.0,669,17350,12500,4850,0.7204610951008645,222,125,97,189.22502576952894,0.3979699420292449,0.9232157290230123,0.1344995945631046,17680413.052263066,517965.3230860826,18198378.37534915,2542,8,1749.9177877429,95,574,62,32.02426630360043,0.6576754385964912,37.00086805555557,134452.25405533164,1415.2868847929647,8
2544,511.04753145860815,0,0,669,0.0,0.0,1.0,669,16950,12000,4950,0.7079646017699115,219,120,99,190.18611059624635,0.39819464210592265,0.9233384466174634,0.13574336082057933,17692226.65500131,522213.1550603918,18214439.8100617,2543,9,1750.9177877429,101,568,65,31.86240264948641,0.6573844884488449,36.866830065359494,134473.55693997737,1331.42135584136,0
2545,511.1980373166473,0,0,669,0.0,0.0,1.0,669,19600,14400,5200,0.7346938775510204,248,144,104,191.03510780430128,0.3981604242934162,0.9245327107454133,0.13693367353793576,17716013.39986881,523476.10594128305,18239489.505810093,2544,10,1751.9177877429,103,566,69,31.699361169234706,0.6582726537216829,36.72876602564105,134583.7380896254,1306.6382338798583,0
2546,511.6845987606218,1,0,670,0.0014925373134328358,0.0,1.0,670,17950,13100,4850,0.7298050139275766,228,131,97,191.56285352753383,0.3982662360841532,0.9250217176135143,0.13789728915974755,17751320.52629712,528148.7227798735,18279469.249076992,2545,0,1750.3014925373134,116,554,73,31.545959237477195,0.6567887931034483,36.59188034188035,134781.8780175551,1161.9127415306475,0
2547,511.7883095480852,0,0,670,0.0,0.0,1.0,670,18500,14000,4500,0.7567567567567568,230,140,90,193.70564261091545,0.3982186879503826,0.9269439236356132,0.14013688346542105,17776483.456439253,536181.0302583735,18312664.486697625,2546,1,1751.3014925373134,78,592,78,31.326500408558058,0.6694711538461539,36.43196202531645,134891.0406059686,1729.3723154611357,0
2548,511.4708881036062,0,0,670,0.0,0.0,1.0,670,18800,14100,4700,0.75,235,141,94,189.37868937096454,0.3979618443656159,0.9249235971498995,0.13748604919433155,17780516.721581835,520650.1906143356,18301166.91219617,2547,2,1752.3014925373134,82,588,82,31.326749167063277,0.6689532520325203,36.32028112449798,134864.49998816187,1644.6890242458765,0
2549,511.2130758598596,0,0,670,0.0,0.0,1.0,670,20000,14800,5200,0.74,252,148,104,186.37525703342396,0.3980030248607486,0.9223334088775219,0.1360338719005822,17794613.796846714,509295.14403955755,18303908.94088627,2548,3,1753.3014925373134,90,580,84,31.231742588575536,0.6678240740740741,36.14926739926737,134883.94458069664,1498.7104953410737,0
2550,511.07641367990055,0,0,670,0.0,0.0,1.0,670,17450,12300,5150,0.7048710601719198,226,123,103,184.82767481582783,0.39803862786218386,0.9212985657310273,0.1355966104270403,17811766.226226952,506971.4671913173,18318737.693418268,2549,4,1754.3014925373134,94,576,67,31.10714829581635,0.668218085106383,35.98684210526313,134930.8979011461,1435.4350840547456,0
2551,511.5061895533961,0,0,670,0.0,0.0,1.0,670,20300,15000,5300,0.7389162561576355,256,150,106,188.5983629233479,0.3979709077928742,0.9228728400489119,0.13899900698016004,17846332.084517717,518857.80306528526,18365189.887583002,2550,5,1755.3014925373134,97,573,69,30.859857020226414,0.6688144329896908,35.84183673469385,135118.5355312592,1392.974593105765,0
2552,511.1030391911029,0,0,670,0.0,0.0,1.0,670,18850,13700,5150,0.726790450928382,240,137,103,178.34990502928355,0.3979622626776432,0.9164392097893239,0.12447008776834405,17595846.786210522,474793.5206460771,18070640.3068566,2551,6,1756.3014925373134,115,555,85,32.91885544642548,0.6468297101449275,37.59877873563212,134114.0616756718,1166.2092319623634,6
2553,511.5067926657659,0,1,669,0.0,0.0014925373134328358,0.9985074626865672,670,17800,12700,5100,0.7134831460674157,229,127,102,181.81385333476786,0.39801985030006914,0.9186274988029257,0.12720182468726549,17620656.869850732,488935.90475944284,18109592.774610177,2552,7,1757.3014925373134,118,552,86,32.74521165432751,0.647069209039548,37.517507002801054,134261.57812390762,1137.809984100912,0
2554,511.21054216257505,0,0,669,0.0,0.0,1.0,669,18350,12900,5450,0.7029972752043597,238,129,109,177.14003650345538,0.3980680268759939,0.9163805266071483,0.1246062316863366,17634312.52610222,472598.5529174197,18106911.07901964,2553,8,1760.6083707025412,90,579,90,32.68697884889157,0.6557870370370371,37.3397435897436,134274.6920840486,1491.9410231560958,0
2555,511.3651701587073,1,0,670,0.0014925373134328358,0.0,1.0,670,19200,13900,5300,0.7239583333333334,245,139,106,170.09317877293503,0.3985440417493995,0.9119579382651233,0.11738363167814805,17555199.549865995,444003.9390859777,17999203.488951974,2554,0,1758.9791044776118,110,560,75,33.51225437528351,0.6441287878787878,37.969219219219205,133993.4148007822,1218.1219527343835,8
2556,511.2124166105979,0,0,670,0.0,0.0,1.0,670,20100,14900,5200,0.7412935323383084,253,149,104,169.60831858153034,0.3988082755133153,0.9125049503725164,0.11755611046512868,17569133.798805416,441874.2485098589,18011008.047315273,2555,1,1759.9791044776118,114,556,78,33.3793992997973,0.6447368421052632,37.82608695652172,134026.55965921213,1175.671575958001,0
2557,510.9793566263637,0,0,670,0.0,0.0,1.0,670,20250,15000,5250,0.7407407407407407,255,150,105,162.83702799715078,0.3990178498389963,0.9134473698921117,0.10815295143094343,17369846.036213327,411440.82106101385,17781286.857274342,2556,2,1760.9791044776118,95,575,87,35.011964211402386,0.6348684210526316,39.2578125,133233.87521410073,1402.461844358955,8
2558,511.50313711289675,0,0,670,0.0,0.0,1.0,670,17350,12600,4750,0.7262247838616714,221,126,95,162.79462913854283,0.3989962370509188,0.9135999188184283,0.10866434110677752,17410268.499169923,415509.64070496615,17825778.13987489,2557,3,1761.9791044776118,100,570,68,34.84078122117687,0.6352083333333334,39.08828382838284,133457.16133129224,1334.5716133129224,0
2559,511.3081113976853,1,0,671,0.0014903129657228018,0.0,1.0,671,18100,13100,5000,0.7237569060773481,231,131,100,161.09172199963007,0.3995014680694886,0.9127239624822319,0.10809101648215681,17427291.15209713,409178.4682960517,17836469.62039318,2558,0,1760.3517138599107,109,562,72,34.705056943890334,0.6348432721712538,38.910984848484865,133496.93124380376,1224.7424884752638,0
2560,510.8517108639785,1,0,672,0.001488095238095238,0.0,1.0,672,20200,14300,5900,0.7079207920792079,261,143,118,160.98577652478056,0.39970128132909893,0.9133749705422103,0.10845784373354617,17429986.615918,406595.9860360225,17836582.60195402,2559,0,1758.7306547619048,111,561,77,34.5688174244313,0.635792042042042,38.774181547619065,133447.65627824282,1202.2311376418272,0
2561,510.67127828368865,0,0,672,0.0,0.0,1.0,672,16500,11900,4600,0.7212121212121212,211,119,92,162.923345146608,0.3996866812888842,0.9143701187764384,0.11003592079901865,17434998.48039126,417213.65501028503,17852212.135401547,2560,1,1759.7306547619048,118,554,79,34.43313401670468,0.6352401129943503,38.69047619047623,133443.26855151402,1130.8751572162205,0
2562,511.02170499999914,0,0,672,0.0,0.0,1.0,672,17600,12000,5600,0.6818181818181818,232,120,112,166.5052935667675,0.39953375048790013,0.9163405900208688,0.11295359104124046,17466839.429636076,429664.24538303335,17896503.675019108,2561,2,1760.7306547619048,122,550,86,34.18824701195222,0.6360143442622951,38.541666666666686,133610.88328645923,1095.171174479174,0
2563,511.34335304035426,0,0,672,0.0,0.0,1.0,672,18250,13300,4950,0.7287671232876712,232,133,99,163.71649588472167,0.3995775044058856,0.9147698784875857,0.11159974888354157,17499503.6851245,420341.48461007,17919845.16973457,2562,3,1761.7306547619048,89,583,89,34.09647260071967,0.6455992509363295,38.379629629629626,133777.83740884418,1503.1217686386985,0
2564,511.8462025567832,0,0,672,0.0,0.0,1.0,672,17300,11300,6000,0.653179190751445,233,113,120,166.48102017994478,0.399647778650084,0.9162086410266026,0.11390649334035381,17533339.31034761,432093.64310956077,17965432.95345717,2563,4,1762.7306547619048,90,582,87,33.897945275372464,0.6465277777777778,38.25549450549451,133972.93117746589,1488.5881241940654,0
2565,512.1984316135116,1,1,672,0.0014858841010401188,0.0014858841010401188,0.9985141158989599,673,17100,11700,5400,0.6842105263157895,225,117,108,168.74324856781504,0.40000906566192596,0.9171210561559295,0.11604343401509684,17568143.99338479,441201.1377501765,18009345.131134965,2564,0,1761.109955423477,95,578,71,33.66631452481564,0.6467105263157895,38.085937499999986,134151.97203002256,1412.1260213686585,0
2566,512.3924565245891,0,0,672,0.0,0.0,1.0,672,17500,12900,4600,0.7371428571428571,221,129,92,165.68651168828796,0.39996782446833673,0.9152198116779502,0.11428663857348567,17588288.998001166,430928.45012885507,18019217.44813002,2565,6,1764.7306547619048,102,570,72,33.64420899593427,0.6458333333333333,37.985436893203854,134254.28563550682,1316.218486622616,0
2567,512.5865221336853,0,0,672,0.0,0.0,1.0,672,19850,14100,5750,0.7103274559193955,256,141,115,167.77653022139512,0.39989657996830125,0.9162765989633128,0.11627816732312261,17616040.45621775,436861.6287967814,18052902.085014533,2566,7,1765.7306547619048,110,562,73,33.42983021321779,0.6455492424242424,37.82845345345343,134385.60124670248,1221.6872840609317,0
2568,512.285519721483,0,0,672,0.0,0.0,1.0,672,18700,13300,5400,0.7112299465240641,241,133,108,168.04945267150916,0.3998986128852932,0.9163285986639322,0.11690448465537882,17622311.07216202,439183.9460967757,18061495.018258795,2567,8,1766.7306547619048,116,556,78,33.2969151307378,0.6455639367816092,37.70477207977206,134370.04715557775,1158.3624754791185,0
2569,512.479593194045,0,0,672,0.0,0.0,1.0,672,16850,12700,4150,0.7537091988130564,210,127,83,171.83728013095615,0.399831757637854,0.9182521863359445,0.11991151891427154,17642742.783532348,455086.1867944474,18097828.970326796,2568,9,1767.7306547619048,121,551,82,33.09349104082607,0.6456611570247934,37.60245901639343,134473.3850583957,1111.3502897388075,0
2570,512.1876000441141,2,0,674,0.002967359050445104,0.0,1.0,674,16500,11900,4600,0.7212121212121212,211,119,92,166.45366556799036,0.4002512573430746,0.9163166550417636,0.11668216779185173,17652688.45875178,436370.94021780393,18089059.398969583,2569,0,1763.4821958456973,89,585,89,33.08352436372189,0.6549625468164795,37.45370370370373,134472.95740047205,1510.9321056232814,0
2571,512.4024628106469,0,0,674,0.0,0.0,1.0,674,17500,12100,5400,0.6914285714285714,229,121,108,166.85271476333295,0.40032129855394527,0.9164280856773117,0.11728229005000891,17672146.05484353,437429.1089889572,18109575.163832486,2570,1,1764.4821958456973,91,583,91,32.98197965166412,0.6552197802197802,37.36413043478263,134575.26638763412,1478.8490811827926,0
2572,512.1403346389324,0,0,674,0.0,0.0,1.0,674,19500,14800,4700,0.7589743589743589,242,148,94,165.45153159188044,0.4003728305136809,0.9155296487757103,0.11670284991253788,17678401.775858767,430683.729982497,18109085.505841263,2571,2,1765.4821958456973,95,579,95,32.903202216257135,0.6551535087719298,37.25043402777781,134564.6506432496,1416.4700067710485,0
2573,511.77648657805315,0,2,672,0.0,0.002967359050445104,0.9970326409495549,674,18900,12800,6100,0.6772486772486772,250,128,122,164.7373312681584,0.40055530509124737,0.9138649016141669,0.11644941505427236,17675276.95953074,428655.59114773845,18103932.55067848,2572,3,1766.4821958456973,100,574,89,32.85065860900733,0.6544791666666667,37.18028052805283,134504.95263478404,1345.0495263478404,0
2574,511.3676273949811,0,0,672,0.0,0.0,1.0,672,16800,11500,5300,0.6845238095238095,221,115,106,164.99567330157606,0.40058915782532584,0.9126845656811393,0.11709230519904368,17678376.641834512,432171.13137967256,18110547.773214184,2573,4,1770.0223214285713,106,566,69,32.71365543625817,0.6542845911949686,37.05218068535827,134463.00249161356,1268.5188914303167,0
2575,511.7442730034205,0,1,671,0.0,0.001488095238095238,0.9985119047619048,672,17200,12500,4700,0.7267441860465116,219,125,94,164.15802823160695,0.40063249591938116,0.9122004869651594,0.11692797352130511,17707483.67916778,429765.1211431121,18137248.800310895,2574,5,1771.0223214285713,111,561,72,32.614202168404894,0.6543731231231231,36.932663690476204,134623.2027706643,1212.8216465825612,0
2576,511.70280810189035,0,0,671,0.0,0.0,1.0,671,17300,12500,4800,0.7225433526011561,221,125,96,167.4328872371103,0.40046655693217964,0.9136385280742594,0.11970849160880596,17722370.769492906,441961.54132455355,18164332.310817458,2575,6,1774.500745156483,117,554,74,32.404798640459745,0.6543803418803419,36.811440677966104,134674.32486537576,1151.0626056869723,0
2577,511.77196842408057,0,0,671,0.0,0.0,1.0,671,17000,12700,4300,0.7470588235294118,213,127,86,168.33459124480993,0.4004002899066515,0.9145889433641601,0.12076244205507168,17739516.864233192,446034.86404422193,18185551.728277415,2576,7,1775.500745156483,123,548,77,32.269731944400114,0.6543868563685638,36.701948924731184,134748.56188101452,1095.5167632602806,0
2578,511.7078390423792,0,2,669,0.0,0.0029806259314456036,0.9970193740685543,671,17300,11500,5800,0.6647398843930635,231,115,116,170.9984221967861,0.4003129842590327,0.916361301125814,0.12320345684072269,17755978.262217995,455748.8534799389,18211727.115697935,2577,8,1776.500745156483,128,543,82,32.058581616805625,0.6549479166666667,36.563307493540044,134802.62064695172,1053.1454738043103,0
2579,511.33151056562826,0,0,669,0.0,0.0,1.0,669,20400,14000,6400,0.6862745098039216,268,140,128,173.5294258410223,0.4000223581238122,0.9183042390873444,0.12598302675303144,17775784.278815307,462724.32795533084,18238508.60677064,2578,9,1782.6337817638266,89,580,89,31.74381090334469,0.6664325842696629,36.31944444444441,134828.1767790047,1514.9233345955583,0
2580,511.554405384148,0,0,669,0.0,0.0,1.0,669,17500,12100,5400,0.6914285714285714,229,121,108,173.15914287267412,0.39991476314933655,0.9177280953216027,0.12626032815833746,17802172.46104519,465221.7849252161,18267394.245970406,2579,10,1783.6337817638266,93,576,90,31.613032231416536,0.6665546594982079,36.18129432624111,134957.621110154,1451.157216238215,0
2581,511.8540437677567,0,0,669,0.0,0.0,1.0,669,16650,11500,5150,0.6906906906906907,218,115,103,170.86461280879246,0.39985742267333796,0.9161767730976971,0.12502823651387798,17827763.818388943,458776.792415123,18286540.610804066,2580,11,1784.6337817638266,98,571,84,31.559377159411028,0.6662414965986394,36.06902356902356,135094.13756176727,1378.5116077731354,0
2582,512.1702243542646,0,0,669,0.0,0.0,1.0,669,15150,10400,4750,0.6864686468646864,199,104,95,169.30630081816605,0.39964903899226956,0.9151916205956288,0.12438344159713874,17855875.90962672,455672.45962542004,18311548.369252138,2581,12,1785.6337817638266,102,567,72,31.47189774032936,0.6664624183006536,35.942556634304204,135242.3600110218,1325.9054903041354,0
2583,512.3260543275852,0,0,669,0.0,0.0,1.0,669,17100,12800,4300,0.7485380116959064,214,128,86,168.16451826699674,0.3994749663602541,0.9146536284123095,0.12394928476926614,17875289.820008818,450297.90029294614,18325587.720301766,2582,13,1786.6337817638266,105,564,76,31.39698268913608,0.666765873015873,35.839229559748425,135336.44522778896,1288.9185259789426,0
2584,512.6301778707964,0,0,669,0.0,0.0,1.0,669,19200,14100,5100,0.734375,243,141,102,167.73467675019126,0.3994724489735029,0.914532916523564,0.12409135235018168,17901714.570398256,447547.6613479879,18349262.231746245,2583,14,1787.6337817638266,108,561,80,31.2896265760228,0.6672453703703703,35.722477064220186,135476.63358982233,1254.4132739798365,0
2585,512.1129718867468,0,0,669,0.0,0.0,1.0,669,19700,14100,5600,0.7157360406091371,253,141,112,171.0647810810639,0.3992689135928442,0.9159518720854345,0.12720492152013724,17905433.568325102,459097.8147054145,18364531.383030515,2584,15,1788.6337817638266,114,555,84,31.03798440318785,0.6675804093567251,35.561594202898554,135422.33787374743,1187.9152445065563,0
2586,511.6264165214183,0,0,669,0.0,0.0,1.0,669,16950,11900,5050,0.7020648967551623,220,119,101,174.60707220577584,0.3992781440109318,0.9177300752931432,0.13014742068591767,17898476.279988725,474290.1080386743,18372766.3880274,2585,16,1789.6337817638266,117,552,85,30.868709117607835,0.6677350427350428,35.48728813559323,135331.69089554952,1156.6811187653805,0
2587,511.3714914982545,0,0,669,0.0,0.0,1.0,669,17600,12400,5200,0.7045454545454546,228,124,104,171.18332554063932,0.39921623494416253,0.9150822103992458,0.12819894286609937,17909498.353015393,461761.49736675085,18371259.850382145,2586,17,1790.6337817638266,94,575,94,30.80937288533511,0.6747562056737588,35.33991228070173,135339.62379707536,1439.7832318837804,0
2588,511.14126836412163,0,0,669,0.0,0.0,1.0,669,18850,13400,5450,0.7108753315649867,243,134,109,171.67683592656877,0.39904607824709326,0.9149504017426162,0.12891030908721773,17912622.551075436,462386.4725431008,18375009.023618538,2587,18,1791.6337817638266,97,572,97,30.712207746149012,0.6747207903780068,35.25722789115644,135320.95632594667,1395.0614054221305,0
2589,511.4129263682955,0,0,669,0.0,0.0,1.0,669,18300,13300,5000,0.726775956284153,233,133,100,172.17699830892124,0.3989166659207743,0.9152395938528846,0.12975021810914614,17937227.83659135,465575.6093774987,18402803.44596885,2588,19,1792.6337817638266,99,570,99,30.585653792705624,0.6752946127946128,35.14583333333331,135449.84443583494,1368.1802468266155,0
2590,511.6594848870175,0,0,669,0.0,0.0,1.0,669,18700,13000,5700,0.6951871657754011,244,130,114,170.26604446751983,0.39856376559288,0.9141092172482299,0.12880721207858734,17962112.85316655,459167.58115756756,18421280.43432412,2589,20,1793.6337817638266,103,566,88,30.51443488943482,0.6754652103559871,35.02604166666664,135576.43902930623,1316.276107080643,0
2591,511.20554072203333,0,0,669,0.0,0.0,1.0,669,17600,12500,5100,0.7102272727272727,227,125,102,151.79746881384912,0.39834307468769486,0.9087955738490547,0.108250085249049,17693929.131458182,385778.73110540165,18079707.862563584,2590,21,1794.6337817638266,104,565,77,32.900971557130816,0.6563501602564102,36.894841269841294,134500.81493540856,1293.2770666866209,8
2592,511.4266677117708,0,0,669,0.0,0.0,1.0,669,19800,13800,6000,0.696969696969697,258,138,120,155.7344728971125,0.3982446168947606,0.9111737587236581,0.11146471282022329,17717494.07397815,398244.92013374285,18115738.99411189,2591,22,1795.6337817638266,107,562,78,32.677324942288664,0.6568341121495327,36.77662037037038,134619.45590781243,1258.1257561477796,0
2593,511.6551351890916,1,0,670,0.0014925373134328358,0.0,1.0,670,17650,12900,4750,0.7308781869688386,224,129,95,155.72759798167004,0.3984140396671352,0.9115519365431193,0.1120344904684915,17747722.79870795,401112.048217467,18148834.84692542,2592,0,1793.9522388059702,115,555,83,32.509297614583,0.6567934782608695,36.61099137931036,134764.33881314087,1171.8638157664423,0
2594,511.5252341540315,0,0,670,0.0,0.0,1.0,670,18500,13200,5300,0.7135135135135136,238,132,106,158.21668872611482,0.3983544999219151,0.9133093100653824,0.11412055456784889,17754430.086360164,409309.4276966484,18163739.514056813,2593,1,1794.9522388059702,119,551,85,32.359207520646684,0.6568627450980392,36.5277777777778,134772.6901653065,1132.5436148345084,0
2595,511.38055562638584,1,0,671,0.0014903129657228018,0.0,1.0,671,19050,13900,5150,0.7296587926509186,242,139,103,156.09823103644885,0.3985059797880938,0.9124857471441121,0.11304092883482009,17766566.318925425,401415.91479519685,18167982.233720623,2594,0,1793.2757078986588,89,582,89,32.28572081961214,0.6656132958801498,36.40046296296293,134799.6777128568,1514.6031203691775,0
2596,511.7939363752097,0,0,671,0.0,0.0,1.0,671,17250,11900,5350,0.6898550724637681,226,119,107,153.4029822518702,0.3983747432732018,0.9107237957524177,0.11131646739238579,17789743.828884937,394349.9513695459,18184093.780254483,2595,1,1794.2757078986588,92,579,92,32.290427640894926,0.6653079710144927,36.33512544802865,134942.08403082812,1466.7617829437838,0
2597,512.2836260735063,0,0,671,0.0,0.0,1.0,671,18150,12800,5350,0.7052341597796143,235,128,107,152.28409634906942,0.39833618791289455,0.9099075961829275,0.11105685418809928,17828235.89389189,390641.3585198669,18218877.252411757,2596,2,1795.2757078986588,95,576,87,32.15859861259631,0.6660087719298246,36.17621527777774,135152.60508193437,1422.659000862467,0
2598,512.0782280281506,0,0,671,0.0,0.0,1.0,671,16550,11400,5150,0.6888217522658611,217,114,103,151.50297695087465,0.39830189588569814,0.9094895292340346,0.1110139906973266,17841500.227805406,389858.07955644256,18231358.30736185,2597,3,1796.2757078986588,100,571,73,32.025867682490016,0.6661458333333333,36.02516501650163,135175.76574237252,1351.7576574237253,0
2599,512.4556917212825,0,0,671,0.0,0.0,1.0,671,19200,14600,4600,0.7604166666666666,238,146,92,149.48731528111628,0.39809846075138466,0.9082808470511443,0.11008461299297105,17876001.327792324,381047.0892906655,18257048.41708299,2598,4,1797.2757078986588,103,568,79,31.918940313222866,0.666970064724919,35.8673878205128,135356.26048058743,1314.1384512678392,0
2600,512.4186526680595,0,0,671,0.0,0.0,1.0,671,17650,12600,5050,0.7138810198300283,227,126,101,147.8037936137659,0.3980182915526689,0.9070681595271766,0.10922391709045118,17889552.365039825,376978.7411210013,18266531.106160827,2599,5,1798.2757078986588,112,559,80,31.85214256642829,0.666015625,35.75774336283186,135402.6611239854,1208.9523314641553,0
2601,512.8882292500929,1,0,672,0.001488095238095238,0.0,1.0,672,16800,11800,5000,0.7023809523809523,218,118,100,145.52222433495183,0.3981114478360892,0.9060825414581635,0.1079503109278874,17922265.26571707,370417.5813176406,18292682.84703471,2600,0,1796.5982142857142,117,555,84,31.790294798588636,0.66622150997151,35.63735875706215,135588.4869469683,1158.875956811695,0
2602,512.4471322845641,0,1,671,0.0,0.001488095238095238,0.9985119047619048,672,18750,13100,5650,0.6986666666666667,244,131,113,146.31048985051956,0.39798582280651956,0.9067534740828072,0.10895635920153224,17923313.343214367,371323.75099800987,18294637.094212376,2601,1,1797.5982142857142,125,547,88,31.64619279819956,0.6659999999999999,35.51587301587302,135534.13240780256,1084.2730592624205,0
2603,512.2903463340824,0,0,671,0.0,0.0,1.0,671,18200,12900,5300,0.7087912087912088,235,129,106,145.8533710119178,0.3978791771396371,0.9067175976327788,0.10893288582643143,17930179.374692682,370635.42092946457,18300814.795622148,2602,2,1800.5946348733235,128,543,93,31.56582226969831,0.6664225260416667,35.42474160206721,135539.35075610818,1058.9011777820951,0
2604,512.0337200558985,0,1,670,0.0,0.0014903129657228018,0.9985096870342772,671,19450,14500,4950,0.7455012853470437,244,145,99,145.8401491206026,0.3978562848944547,0.9066597027891539,0.10921667415414803,17932582.892745286,369408.1126391052,18301991.005384393,2603,3,1801.5946348733235,95,576,95,31.48091679991252,0.6744517543859649,35.34071180555554,135514.47988154693,1426.4682092794412,0
2605,511.7820560892576,0,0,670,0.0,0.0,1.0,670,18050,13300,4750,0.7368421052631579,228,133,95,145.14823981308766,0.3978229647725498,0.9053244857394158,0.10911832388642366,17940026.78210444,368742.66192441713,18308769.444028858,2604,4,1802.4641791044776,100,570,100,31.377484776483676,0.6742708333333334,35.22070957095707,135509.28966562898,1355.09289665629,0
2606,511.7147660179463,0,0,670,0.0,0.0,1.0,670,18150,12900,5250,0.7107438016528925,234,129,105,145.72150188094884,0.39786070581323574,0.9056367351659784,0.10990341943257186,17951247.21925197,371026.5410851169,18322273.76033709,2605,5,1803.4641791044776,101,569,95,31.260642775443014,0.6750206270627063,35.12050653594769,135542.7480209086,1342.0074061476098,0
2607,511.34387315338404,0,0,670,0.0,0.0,1.0,670,20250,15200,5050,0.7506172839506173,253,152,101,143.48279949874086,0.3978192929225323,0.9037788572841738,0.10857543284837862,17952187.301363956,360916.0182250826,18313103.319589037,2606,6,1804.4641791044776,106,564,95,31.215480607908688,0.6748231132075472,35.017523364485946,135497.16592057794,1278.2751501941316,0
2608,511.8070541215914,0,0,670,0.0,0.0,1.0,670,19700,14200,5500,0.7208121827411168,252,142,110,141.25800679863852,0.39763486379760393,0.9023271475057524,0.10724921975958279,17982432.210219633,354332.5062814446,18336764.716501076,2607,7,1805.4641791044776,111,559,76,31.169888662783887,0.6747372372372372,34.91443452380949,135672.6623565234,1222.2762374461568,0
2609,511.7282950441903,0,0,670,0.0,0.0,1.0,670,18150,12500,5650,0.6887052341597796,238,125,113,142.61299347568544,0.39756463385613044,0.9028553774371761,0.10861441199256286,17992634.82321486,361046.70253069914,18353681.52574556,2608,8,1806.4641791044776,114,556,79,31.03701268388212,0.6750730994152047,34.81884057971011,135700.7025879847,1190.3570402454798,0
2610,511.4361058849909,0,0,670,0.0,0.0,1.0,670,18650,13000,5650,0.6970509383378016,243,130,113,141.4966596698743,0.3973231748581458,0.9020027381829294,0.10823493557621756,18000528.984638464,356752.944723413,18357281.929361876,2609,9,1807.4641791044776,120,550,85,30.930797559946793,0.6752604166666667,34.68491735537187,135691.71270032146,1130.7642725026788,0
2611,510.98064673523135,0,0,670,0.0,0.0,1.0,670,18150,13100,5050,0.721763085399449,232,131,101,140.28045292422547,0.3971309372420409,0.9017752952675779,0.10791783849623267,18008152.124812543,353088.347279404,18361240.472091947,2610,10,1808.4641791044776,122,548,93,30.786202643359122,0.6766564207650273,34.51050135501352,135659.99571902546,1111.9671780247988,0
2612,511.4545844831718,0,0,670,0.0,0.0,1.0,670,17400,12200,5200,0.7011494252873564,226,122,104,137.87988761575312,0.39705382839167397,0.8995889134617006,0.10631783971909062,18034483.55306626,345918.51310097775,18380402.06616724,2611,11,1809.4641791044776,128,542,99,30.778055665359126,0.6763509114583333,34.439599483204105,135822.08430150064,1061.1100336054737,0
2613,511.69491839245575,0,0,670,0.0,0.0,1.0,670,17900,12500,5400,0.6983240223463687,233,125,108,140.97488241197755,0.3967640311149782,0.9016096059156338,0.10887951587369796,18049624.12721779,357008.7277829784,18406632.855000768,2612,12,1810.4641791044776,133,537,100,30.646121126980383,0.6760651629072681,34.39054726368157,135911.00724217374,1021.887272497547,0
2614,511.4352956510674,0,0,670,0.0,0.0,1.0,670,20100,14500,5600,0.7213930348258707,257,145,112,140.61853247799368,0.39672689430277613,0.9015250331775937,0.10891303317399431,18052196.673471425,353594.68084553943,18405791.354316965,2613,13,1811.4641791044776,102,568,102,30.568031871701198,0.6830065359477124,34.30420711974113,135886.20638496152,1332.2177096564856,0
2615,511.908092073312,0,0,670,0.0,0.0,1.0,670,18200,12800,5400,0.7032967032967034,236,128,108,138.55596249290735,0.39642189835575486,0.8995989725037019,0.10768555206216629,18083092.99997517,348904.0710920707,18431997.07106724,2614,14,1812.4641791044776,106,564,106,30.51694563478979,0.6830778301886793,34.19976635514022,136065.29047778266,1283.6348158281382,0
2616,511.52507697879855,0,0,670,0.0,0.0,1.0,670,18050,12500,5550,0.6925207756232687,236,125,111,157.38626853648756,0.3961818802103087,0.9069653278486316,0.1209642978196006,18023463.378892485,415279.12946158,18438742.508354064,2615,15,1813.4641791044776,126,544,90,30.361051032493947,0.67567791005291,34.53904199475064,135789.9369784997,1077.6979125277753,8
2617,511.78975069009556,0,0,670,0.0,0.0,1.0,670,17050,12100,4950,0.7096774193548387,220,121,99,158.974764972253,0.3960073511366932,0.9086895436830045,0.12268262130396473,18049636.68777487,422837.3500547084,18472474.037829578,2616,16,1814.4641791044776,129,541,96,30.192933826117557,0.6764373385012921,34.41506410256409,135923.64812999268,1053.6716909301758,0
2618,511.98174873959016,0,0,670,0.0,0.0,1.0,670,17150,12400,4750,0.7230320699708455,219,124,95,156.66697597777207,0.39595208746997446,0.9067454800306591,0.12122193790751433,18067357.967112657,414961.66732309206,18482319.63443575,2617,17,1815.4641791044776,102,568,102,30.17244661007274,0.6827001633986929,34.33454692556636,136015.86324474475,1333.4888553406347,0
2619,511.906738270616,0,0,670,0.0,0.0,1.0,670,18650,13000,5650,0.6970509383378016,243,130,113,159.98103698856534,0.3959393986718129,0.9123290358244642,0.12252665303477034,18022278.992944404,423994.5764376892,18446273.569382094,2618,18,1816.4641791044776,114,556,79,30.401590146213817,0.6768092105263157,34.64673913043475,135836.1222612092,1191.5449321158703,8
2620,512.240568682035,0,0,670,0.0,0.0,1.0,670,17950,13300,4650,0.7409470752089137,226,133,93,162.14756000945718,0.39584258267704825,0.913798884927564,0.12460872162137315,18048172.611868374,433343.430328787,18481516.04219716,2619,19,1817.4641791044776,117,553,82,30.238401061931192,0.677261396011396,34.54272598870054,135977.98500032918,1162.2050000028134,0
2621,511.944497434233,1,0,671,0.0014903129657228018,0.0,1.0,671,18250,13600,4650,0.7452054794520548,229,136,93,160.71217677156068,0.39593556064684027,0.9139218133091358,0.12401270797517605,18054737.047689702,427873.2183944645,18482610.266084168,2620,0,1815.7540983606557,121,550,87,30.1494601618175,0.6777720385674931,34.41769125683058,135963.40157694378,1123.6644758425107,0
2622,512.278760880456,0,0,671,0.0,0.0,1.0,671,17900,12900,5000,0.7206703910614525,229,129,100,159.3336541199786,0.3959154488362954,0.9131465291293996,0.12361631703174504,18088925.061750162,424334.9058382279,18513259.96758839,2621,1,1816.7540983606557,93,578,93,30.018860417274798,0.6860439068100359,34.25310283687946,136136.4911865506,1463.8332385650601,0
2623,511.8683734226311,0,0,671,0.0,0.0,1.0,671,17650,12300,5350,0.6968838526912181,230,123,107,160.47569879053026,0.3956496392849464,0.9141293111593447,0.12495853585471078,18089511.095378928,428735.38676200144,18518246.48214093,2622,2,1817.7540983606557,93,578,93,29.875917010545603,0.6871639784946236,34.14228723404258,136084.1549953728,1463.270483821213,0
2624,511.41474585405155,0,0,671,0.0,0.0,1.0,671,18600,13300,5300,0.7150537634408602,239,133,106,160.10750152875238,0.395418029079639,0.9132761748872149,0.12502776804773436,18085196.992670663,426315.14103036537,18511512.133701026,2623,3,1818.7540983606557,97,574,90,29.798161470823377,0.6868556701030928,34.056122448979615,136007.62054919713,1402.14041803296,0
2625,511.32303470721985,0,0,671,0.0,0.0,1.0,671,17800,12200,5600,0.6853932584269663,234,122,112,158.2018887240298,0.3953880930667082,0.9121160591772457,0.12405763011745283,18099106.20810056,420662.55726767064,18519768.76536823,2624,4,1819.7540983606557,102,569,71,29.7207387839396,0.6867851307189543,33.9300161812298,136047.711570716,1333.801093830549,0
2626,511.0396208728819,0,0,671,0.0,0.0,1.0,671,18250,13200,5050,0.7232876712328767,233,132,101,156.97285878678014,0.39524295437862844,0.9103658734879954,0.12365590350471115,18107686.641632657,416033.0676304614,18523719.70926312,2625,5,1820.7540983606557,110,561,76,29.61444342604674,0.6862689393939394,33.7931681681682,136042.23841311215,1236.7476219373832,0
2627,511.5870794979548,0,1,670,0.0,0.0014903129657228018,0.9985096870342772,671,18000,13100,4900,0.7277777777777777,229,131,98,156.46936135867995,0.39487556628185455,0.9105236958227518,0.12368591095196019,18141179.579139527,415507.75660822314,18556687.33574775,2626,6,1821.7540983606557,113,558,78,29.522752616229226,0.6866703539823009,33.689692982456165,136240.91220731035,1205.6717894452242,0
2628,511.5654894730022,0,0,670,0.0,0.0,1.0,670,19200,14000,5200,0.7291666666666666,244,140,104,157.58222624229523,0.3947152782425689,0.9111825833239799,0.125050334667217,18156217.30202634,419019.428518447,18575236.730544787,2627,7,1823.8477611940298,116,554,82,29.37531328320807,0.6872306034482758,33.573717948717984,136294.49138603837,1174.9525119486066,0
2629,511.14507946649366,0,0,670,0.0,0.0,1.0,670,19050,13700,5350,0.7191601049868767,244,137,107,156.00037169015033,0.3947717968453696,0.9105094660796231,0.12412580775518094,18152121.28425785,413297.5334617905,18565418.817719642,2628,8,1824.8477611940298,122,548,85,29.336741449256987,0.6869023224043715,33.494241192411955,136223.1072639847,1116.5828464261042,0
2630,511.03952521088416,0,0,670,0.0,0.0,1.0,670,19150,14300,4850,0.7467362924281984,240,143,97,155.51831718672884,0.3944598755103406,0.9102475959739194,0.1241053735212446,18160235.788932916,411699.86192181637,18571935.650854733,2629,9,1825.8477611940298,126,544,89,29.261145125065426,0.6870866402116402,33.40715223097115,136239.4823485033,1081.2657329246294,0
2631,510.61339690161634,0,0,670,0.0,0.0,1.0,670,19800,15100,4700,0.7626262626262627,245,151,94,154.04004944009216,0.39435743554276453,0.9097052666849557,0.1232776585203179,18156636.053269967,405569.82306228986,18562205.876332257,2630,10,1826.8477611940298,94,576,94,29.214464865753882,0.6951462765957447,33.322368421052616,136169.17133820328,1448.6082057255667,0
2632,510.94005463827216,0,0,670,0.0,0.0,1.0,670,17800,12500,5300,0.702247191011236,231,125,106,151.90966285462943,0.39419150510526585,0.9076453956109443,0.12216521254933488,18187841.997508407,400781.7891789523,18588623.78668736,2631,11,1827.8477611940298,100,570,100,29.125355932640165,0.6948958333333333,33.17863036303629,136329.72518096826,1363.2972518096826,0
2633,510.83001543544714,0,0,670,0.0,0.0,1.0,670,19450,14300,5150,0.7352185089974294,246,143,103,148.44751463914605,0.39395906305542544,0.9056610832253389,0.12007057234983501,18207047.40578088,387108.1872610572,18594155.593041938,2632,12,1828.8477611940298,105,565,97,29.045626449262013,0.6953373015873017,33.00904088050314,136386.99576813742,1298.9237692203565,0
2634,510.52129346320345,0,0,670,0.0,0.0,1.0,670,19600,14400,5200,0.7346938775510204,248,144,104,151.70626396934048,0.39374688589935225,0.9067347759057656,0.11558224387276016,17951723.694262393,391077.78669328353,18342801.480955675,2633,13,1829.8477611940298,117,553,73,30.784421013503753,0.6745904558404558,34.80755649717513,135386.38927372883,1157.1486262711865,8
2635,510.635940187811,0,0,670,0.0,0.0,1.0,670,16950,11800,5150,0.696165191740413,221,118,103,151.58641557797762,0.39378388327421193,0.9068123279408369,0.11587594081004662,17969607.085400186,393839.6654840862,18363446.750884272,2634,14,1830.8477611940298,122,548,76,30.68377705420418,0.6746926229508197,34.70528455284552,135469.01644921495,1110.401774173893,0
2636,511.1785693259443,0,0,670,0.0,0.0,1.0,670,19050,13400,5650,0.7034120734908137,247,134,113,151.73402108670177,0.39346480415560464,0.9073975898758477,0.11635620923544784,18001852.799237918,393248.70244784834,18395101.501685765,2635,15,1831.8477611940298,124,546,80,30.58143885870984,0.6753192204301075,34.60833333333331,135662.53247769334,1094.0526812717205,0
2637,511.65960903210595,0,0,670,0.0,0.0,1.0,670,18100,13000,5100,0.7182320441988951,232,130,102,150.43660792407462,0.39323291985513387,0.9066803149873874,0.11558170960481784,18026723.876005035,390275.83837801917,18416999.714383055,2636,16,1832.8477611940298,130,540,82,30.556595672448047,0.6749198717948718,34.54993638676843,135820.0757658924,1044.7698135837877,0
2638,511.86724769449654,0,0,670,0.0,0.0,1.0,670,19650,13900,5750,0.7073791348600509,254,139,115,150.67120589452904,0.39300963419078006,0.9078736449366525,0.11625089073489753,18051522.606417783,390318.93586826243,18441841.542286046,2637,17,1833.8477611940298,134,536,89,30.419789941601987,0.6756063432835822,34.42129629629629,135941.0401110866,1014.4853739633328,0
2639,511.7639636121602,0,0,670,0.0,0.0,1.0,670,19150,14300,4850,0.7467362924281984,240,143,97,150.09994829599296,0.39287740111103675,0.9077643631576691,0.1164011315316304,18068926.186763354,389278.9772794622,18458205.164042816,2638,18,1834.8477611940298,95,575,95,30.27783449026815,0.6853070175438596,34.26649305555557,135992.8327784492,1431.5035029310443,0
2640,512.0298579451584,0,0,670,0.0,0.0,1.0,670,18650,12600,6050,0.675603217158177,247,126,121,148.6031343740308,0.39276994139913285,0.9068414051193581,0.11581969480602057,18098989.432312515,385263.3117288259,18484252.744041342,2639,19,1835.8477611940298,99,571,99,30.16344270323217,0.6857112794612794,34.114583333333364,136141.27212552412,1375.164364904284,0
2641,511.6279150656247,0,0,670,0.0,0.0,1.0,670,18550,12400,6150,0.6684636118598383,247,124,123,147.6447727187076,0.39264663230930547,0.9057368320808941,0.11569981280320621,18107093.646263182,382133.5451997805,18489227.191462964,2640,20,1836.8477611940298,107,563,71,30.02253721964425,0.6853582554517135,33.950617283950635,136118.29098350977,1272.1335605935492,0
2642,512.0060571268426,0,0,670,0.0,0.0,1.0,670,18950,14200,4750,0.7493403693931399,237,142,95,148.15631650029334,0.3925912292052443,0.9060083982359974,0.11663472724270746,18139270.464107074,384539.49919293955,18523809.963300012,2641,21,1837.8477611940298,112,558,73,29.868951147435045,0.6856398809523809,33.812684365781735,136289.51793505577,1216.8706958487123,0
2643,511.8957938177658,0,0,670,0.0,0.0,1.0,670,17850,12000,5850,0.6722689075630253,237,120,117,147.8541057090131,0.39241116911704554,0.9057447597940032,0.11695748215104813,18154977.08205287,385007.58012691763,18539984.66217979,2642,22,1838.8477611940298,117,553,80,29.730968953706803,0.6860754985754987,33.66878531073449,136333.82856181305,1165.246397964214,0
2644,511.4120418831128,0,1,669,0.0,0.0014925373134328358,0.9985074626865672,670,17750,12400,5350,0.6985915492957746,231,124,107,149.67080101879932,0.3922972488082755,0.9073806546446419,0.11880383741294923,18151853.98858979,391610.505289713,18543464.493879505,2643,23,1839.8477611940298,120,550,81,29.578028907773042,0.6865451388888889,33.565771349862295,136257.67290152123,1135.480607512677,0
2645,511.2542035419061,0,1,668,0.0,0.0014947683109118087,0.9985052316890882,669,18300,12700,5600,0.6939890710382514,239,127,112,155.485748018215,0.39222340073216794,0.9080655091225234,0.11480386052303852,17845309.792771835,402838.26834918273,18248148.061121017,2644,24,1843.52466367713,118,551,78,31.676136363636353,0.66454802259887,35.7843137254902,135081.38024955304,1144.757459741975,8
2646,511.54615415898525,0,0,668,0.0,0.0,1.0,668,19050,13400,5650,0.7034120734908137,247,134,113,157.2289222006662,0.39203036019415444,0.9086749575366917,0.1166865561163873,17877263.02931745,409514.55959948286,18286777.58891693,2645,25,1846.4131736526947,125,543,86,31.466580933320888,0.6649166666666666,35.62334656084657,135240.86031622245,1081.9268825297795,0
2647,511.36264943557114,0,0,668,0.0,0.0,1.0,668,19200,13700,5500,0.7135416666666666,247,137,110,157.92625678587603,0.3920625764961831,0.910594272162764,0.11761520270042314,17885694.584282096,412124.15914222016,18297818.743424315,2646,26,1847.4131736526947,128,540,88,31.336630640532483,0.66552734375,35.51356589147288,135248.48368550374,1056.628778792998,0
2648,511.8049367941263,0,0,668,0.0,0.0,1.0,668,17300,11800,5500,0.6820809248554913,228,118,110,159.39585357027303,0.39214543177513045,0.9120699775165515,0.11892782548934641,17908940.79254894,420022.18083357194,18328962.97338251,2647,27,1848.4131736526947,131,537,89,31.2394040410067,0.6656329516539441,35.456123737373765,135394.86186986856,1033.5485638921264,0
2649,511.9143227069738,0,0,668,0.0,0.0,1.0,668,17700,12900,4800,0.7288135593220338,225,129,96,158.93517431376358,0.39203396056462786,0.9122341488510237,0.11890630262680106,17924246.98396993,418458.6637680394,18342705.64773797,2648,28,1849.4131736526947,91,577,91,31.165497176108186,0.6753663003663004,35.37137681159419,135467.18240837107,1488.6503561359457,0
2650,512.1178699068669,0,0,668,0.0,0.0,1.0,668,17400,12900,4500,0.7413793103448276,219,129,90,159.7395678675938,0.3919880441515769,0.9118546033476693,0.11988164087744144,17944556.403395504,422291.13709080825,18366847.540486313,2649,29,1850.4131736526947,94,574,94,31.045403084399897,0.6754210992907801,35.27412280701753,135570.8523372961,1442.243109971235,0
2651,511.74470627126965,0,0,668,0.0,0.0,1.0,668,18650,13000,5650,0.6970509383378016,243,130,113,156.99056486922498,0.3918602543787986,0.910489532197672,0.11835649863590841,17950661.586585548,411366.90045086964,18362028.48703642,2650,30,1851.4131736526947,98,570,94,30.974407102848275,0.6757015306122449,35.132575757575744,135544.50221976644,1383.1071655078208,0
2652,511.72969370713685,0,0,668,0.0,0.0,1.0,668,17350,12800,4550,0.7377521613832853,219,128,91,155.32346047743627,0.39159242422202073,0.9091276451215871,0.11752661839524918,17965418.32878083,407140.18875019567,18372558.517531026,2651,31,1852.4131736526947,104,564,93,30.90407774865838,0.6752804487179487,35.01984126984125,135598.2154654517,1303.8289948601125,0
2653,511.75918650394925,0,0,668,0.0,0.0,1.0,668,17300,11300,6000,0.653179190751445,233,113,120,152.51246543943438,0.39149970299281495,0.9072102576339605,0.11596886775891946,17987059.518785585,397750.15864315786,18384809.67742874,2652,32,1853.4131736526947,111,557,75,30.82433700494616,0.6752064564564564,34.86793154761901,135683.77166729758,1222.3763213270051,0
2654,512.2242332697942,0,0,668,0.0,0.0,1.0,668,18700,13500,5200,0.7219251336898396,239,135,104,150.63599602352267,0.39148511447868883,0.9062201598374349,0.11482612151972553,18013763.55287442,390404.2429838849,18404167.795858305,2653,33,1854.4131736526947,114,554,78,30.796674522126164,0.6753472222222222,34.79166666666663,135846.1351984245,1191.6327648984607,0
2655,512.6747408830818,0,0,668,0.0,0.0,1.0,668,17500,12700,4800,0.7257142857142858,223,127,96,149.51227742512606,0.39150479962114754,0.9056237277222083,0.11436631615698409,18044124.03967648,388463.61586269015,18432587.65553917,2654,34,1855.4131736526947,120,548,81,30.71813113122856,0.6752604166666667,34.684917355371866,136020.3412472059,1133.502843726716,0
2656,512.6226160935367,0,0,668,0.0,0.0,1.0,668,16800,12000,4800,0.7142857142857143,216,120,96,149.11202577041766,0.39122434478868345,0.9056116420701694,0.11442058434680775,18055438.613153975,388056.6055561542,18443495.21871013,2655,35,1856.4131736526947,126,542,85,30.63064629108851,0.6751818783068784,34.588254593175826,136056.06327239607,1079.8100259713974,0
2657,512.5094562238397,0,0,668,0.0,0.0,1.0,668,17750,13000,4750,0.7323943661971831,225,130,95,148.1122072593879,0.3909156948471872,0.9051102399666646,0.1139339841993992,18061708.973764464,383681.916596192,18445390.890360657,2656,36,1857.4131736526947,135,533,88,30.58067912988283,0.674537037037037,34.51286764705883,136064.66583663312,1007.8864136046898,0
2658,512.8156803198909,0,0,668,0.0,0.0,1.0,668,18800,13800,5000,0.7340425531914894,238,138,100,156.03368142083036,0.3907977710246673,0.910264376906565,0.11813978736148552,18006240.575232115,409516.0011005176,18415756.576332632,2657,37,1858.4131736526947,104,564,91,30.865107442348023,0.6754807692307692,34.99999999999999,135896.15528477068,1306.6938008151026,8
2659,512.9197301629565,0,0,668,0.0,0.0,1.0,668,18350,13000,5350,0.7084468664850136,237,130,107,172.6999234173922,0.39073315138837766,0.9132322374421686,0.12101124572381237,17676116.850157272,458582.80526781536,18134699.655425087,2658,38,1859.4131736526947,94,574,94,32.933164181597995,0.6532579787234043,37.46710526315793,134658.30152732268,1432.5351226310922,8
2660,512.8790726481625,1,0,669,0.0014947683109118087,0.0,1.0,669,19200,14100,5100,0.734375,243,141,102,169.03182863385373,0.39094316971438287,0.9107221309633018,0.1189950435407487,17695288.97116547,445213.410600118,18140502.38176559,2659,0,1857.6322869955156,100,569,100,32.87413296688919,0.653125,37.31435643564359,134725.969269274,1347.2596926927401,0
2661,513.1423862565354,1,0,670,0.0014925373134328358,0.0,1.0,670,17800,12200,5600,0.6853932584269663,234,122,112,168.11678619778888,0.39130803382192175,0.9103218764856744,0.11896264013805526,17727044.14601244,444242.7381227923,18171286.88413523,2660,0,1855.858208955224,105,565,98,32.72721324958878,0.6535714285714286,37.14622641509436,134881.4126138946,1284.5848820370913,0
2662,513.5781180197105,0,1,669,0.0,0.0014925373134328358,0.9985074626865672,670,17450,11900,5550,0.6819484240687679,230,119,111,167.65867625027622,0.3912573251083893,0.9110850741342227,0.11914383959646375,17760748.113912065,444098.7035986219,18204846.817510687,2661,1,1856.858208955224,107,563,70,32.59881450104519,0.6544976635514019,37.00810185185187,135066.88410535833,1262.307328087461,0
2663,513.112067184152,0,1,668,0.0,0.0014947683109118087,0.9985052316890882,669,18050,12900,5150,0.7146814404432132,232,129,103,167.6855989821753,0.39108647428610643,0.911656095495003,0.11966751106798841,17763103.663143896,443873.3355073579,18206976.998651255,2662,3,1860.6322869955156,110,559,72,32.458955977983045,0.6552083333333334,36.87124624624627,135014.53877417982,1227.4048979470892,0
2664,513.0365763353619,0,0,668,0.0,0.0,1.0,668,17250,12500,4750,0.7246376811594203,220,125,95,166.00070194310868,0.39110361548267786,0.9105326855244589,0.11882731565466195,17773805.548894208,439242.8394633597,18213048.38835757,2663,43,1864.4131736526947,115,553,77,32.403036479832664,0.6551630434782609,36.77262931034486,135045.26905638177,1174.306687446798,0
2665,513.4179586243824,0,0,668,0.0,0.0,1.0,668,16750,11800,4950,0.7044776119402985,217,118,99,165.83112659361353,0.3912203235956872,0.9109024215290198,0.11898592766196209,17797283.874081634,439918.7270290689,18237202.601110704,2664,44,1865.4131736526947,117,551,80,32.33029218493314,0.6555377492877492,36.69668079096048,135184.6526473308,1155.424381601118,0
2666,512.9073179854664,0,0,668,0.0,0.0,1.0,668,17250,12100,5150,0.7014492753623188,224,121,103,166.0259707924455,0.3912188740958862,0.9109206949713731,0.11938638156616431,17789083.118862655,439839.95886333694,18228923.07772599,2665,45,1866.4131736526947,123,545,83,32.2536573955941,0.6551490514905149,36.62634408602151,135086.2754828662,1098.2624022997252,0
2667,513.3216018510645,0,0,668,0.0,0.0,1.0,668,20000,14600,5400,0.73,254,146,108,167.0861999531867,0.39132216264622177,0.9124900080622274,0.12048024076276236,17815417.679802984,441742.088139419,18257159.767942403,2666,46,1867.4131736526947,130,538,84,32.135760923148126,0.6548878205128206,36.537849872773535,135240.8129304333,1040.3139456187178,0
2668,513.1688411532507,0,0,668,0.0,0.0,1.0,668,19600,14900,4700,0.7602040816326531,243,149,94,168.58512315450528,0.39123383667447714,0.914552350538058,0.12213684292506401,17830585.1872515,447994.27994192974,18278579.467193432,2667,47,1868.4131736526947,86,582,86,31.94236271971655,0.6667877906976745,36.38649425287352,135278.2372565967,1573.0027587976363,0
2669,513.5609449994619,0,0,668,0.0,0.0,1.0,668,17900,12700,5200,0.7094972067039106,231,127,104,163.6661350131957,0.39142657338995174,0.9114894142027108,0.11903798973972719,17861125.144148204,433152.2638659422,18294277.40801415,2668,48,1869.4131736526947,89,579,89,31.945069191498096,0.6670177902621723,36.26157407407404,135445.75525118748,1521.8624185526683,0
2670,513.3685116178639,0,0,668,0.0,0.0,1.0,668,18750,14100,4650,0.752,234,141,93,163.1232686980616,0.3913399774663566,0.9113339111251191,0.1192054655870443,17874810.25212651,430809.4951368964,18305619.74726341,2669,49,1870.4131736526947,92,576,85,31.8064692982456,0.667572463768116,36.11111111111109,135472.24612137987,1472.5244143628247,0
2671,512.9206303313714,0,0,668,0.0,0.0,1.0,668,16550,12000,4550,0.7250755287009063,211,120,91,163.9714596106689,0.3913560154802838,0.9118317521129029,0.12010455620928974,17869216.580673266,435858.3049664273,18305074.885639694,2670,50,1871.4131736526947,93,575,75,31.708998040862003,0.668010752688172,36.037234042553166,135391.94829890472,1455.8274010634916,0
2672,513.2787831234917,0,0,668,0.0,0.0,1.0,668,17600,12700,4900,0.7215909090909091,225,127,98,157.72668404083734,0.3913930011042383,0.9093795828935476,0.10682906614113509,17536844.912171695,402005.67930705764,17938850.591478754,2671,51,1872.4131736526947,136,532,89,34.47183439984486,0.6332720588235294,38.594890510948915,134173.69650080404,986.5712978000297,8
2673,513.5918108638402,1,0,669,0.0014947683109118087,0.0,1.0,669,21050,16100,4950,0.7648456057007126,260,161,99,156.25568346154714,0.39169689395498986,0.9090909760335733,0.10640850414984022,17571994.99586534,394294.8175723585,17966289.8134377,2672,0,1870.6128550074739,96,573,96,34.32535202594525,0.6431206597222222,38.41280068728519,134349.04339381587,1399.4692020189152,0
2674,513.8578405752394,1,0,670,0.0014925373134328358,0.0,1.0,670,18150,12300,5850,0.6776859504132231,240,123,117,153.75809193863455,0.39183668726621007,0.9074565703271511,0.10497584838112398,17592604.337251347,388851.05502541485,17981455.39227676,2673,0,1868.8194029850747,101,569,101,34.303774928774935,0.6426361386138614,38.32720588235291,134462.61692258142,1331.3130388374398,0
2675,513.974763465637,0,0,670,0.0,0.0,1.0,670,17800,12300,5500,0.6910112359550562,233,123,110,151.31823638870657,0.3919823992890555,0.90542104115203,0.10373187181242469,17614904.05291706,381291.2430887278,17996195.296005785,2674,1,1869.8194029850747,106,564,97,34.22955477881483,0.6427869496855345,38.191199376947,134563.11637345332,1269.4633620137106,0
2676,514.2808161361393,0,0,670,0.0,0.0,1.0,670,18550,12700,5850,0.6846361185983828,244,127,117,149.16237253699472,0.3920470517368315,0.9041657153276363,0.10267741811652473,17643914.162702672,373811.61946955486,18017725.782172225,2675,2,1870.8194029850747,110,560,77,34.14642520211606,0.6432765151515152,38.053678678678644,134713.96791298653,1224.6724355726049,0
2677,514.4228832840794,0,0,670,0.0,0.0,1.0,670,16750,12100,4650,0.7223880597014926,214,121,93,147.01935529583022,0.3919554878819653,0.9035152318735464,0.10160985900228743,17666762.786747754,368721.2150143938,18035484.001762148,2676,3,1871.8194029850747,113,557,81,34.06724310252653,0.6439896755162242,37.92032163742686,134819.78379343657,1193.0954318003237,0
2678,514.1102886353762,0,0,670,0.0,0.0,1.0,670,18800,13400,5400,0.7127659574468085,242,134,108,143.95517341625708,0.39191165807732636,0.9015940967865321,0.0998275182263872,17671033.999783877,355967.35277668183,18027001.352560557,2677,4,1872.8194029850747,117,553,86,34.03459339191723,0.6443198005698005,37.808968926553625,134795.10666277347,1152.0949287416536,0
2679,514.3708192370793,0,0,670,0.0,0.0,1.0,670,17400,11800,5600,0.6781609195402298,230,118,112,144.12524476178302,0.3918928805152117,0.9017136057579034,0.10018888226773535,17690821.567713954,358538.7976967548,18049360.365410708,2678,5,1873.8194029850747,122,548,87,33.94866640834384,0.6442110655737705,37.72865853658534,134904.72477094276,1105.7764325487112,0
2680,513.7571568780039,1,0,671,0.0014903129657228018,0.0,1.0,671,19550,13500,6050,0.690537084398977,256,135,121,158.24953750769566,0.39244036894514017,0.9087011713433901,0.09825875834580147,17150060.418483533,389047.82589080674,17539108.24437434,2679,0,1872.0253353204173,98,573,98,37.52511164501635,0.6102253401360545,41.61405723905722,132747.62733010342,1354.567625817382,8
2681,513.843236167964,2,0,673,0.0029717682020802376,0.0,1.0,673,17100,11500,5600,0.672514619883041,227,115,112,155.23362298684714,0.3934957008125191,0.9072126566426577,0.09683907065689798,17175212.350474034,381534.0877465006,17556746.438220534,2680,0,1867.4591381872215,103,570,103,37.43269156271791,0.6106391585760518,41.44631410256408,132856.0626846926,1289.8646862591513,0
2682,514.1065800696817,0,0,673,0.0,0.0,1.0,673,18250,12800,5450,0.7013698630136986,237,128,109,152.0165245740052,0.39394207410552134,0.9051239979341583,0.09509277209006428,17197034.94363655,369996.69702186505,17567031.640658416,2681,1,1868.4591381872215,107,566,98,37.416447589215764,0.6106892523364487,41.348379629629605,132974.49997809133,1242.7523362438442,0
2683,513.6363718716558,1,1,673,0.001483679525222552,0.001483679525222552,0.9985163204747775,674,17250,12300,4950,0.7130434782608696,222,123,99,150.18816762018403,0.3945172474989087,0.904189375459231,0.09441256182887976,17204581.259516604,364734.90680786944,17569316.166324474,2682,0,1866.685459940653,113,561,77,37.28597401680439,0.6111725663716814,41.17324561403508,132942.8350661228,1176.4852660718832,0
2684,513.657073195442,0,1,672,0.0,0.0014858841010401188,0.9985141158989599,673,19650,14500,5150,0.7379134860050891,248,145,103,150.4783815492374,0.39470169181466547,0.9037584612041392,0.09505017376653452,17227912.735673275,364235.68518712267,17592148.4208604,2683,3,1870.4591381872215,123,550,81,37.10567961899821,0.6110264227642277,41.00302419354839,133035.62855921293,1081.590476091162,0
2685,513.6031155260786,1,0,673,0.0014858841010401188,0.0,1.0,673,18750,12800,5950,0.6826666666666666,247,128,119,157.7002925319942,0.3950598960175948,0.9079803394527539,0.10005418559921422,17246936.173649557,390619.37597303116,17637555.549622588,2684,0,1871.4531946508173,126,547,86,36.7595977338904,0.6121031746031746,40.84645669291338,133102.06724214164,1056.3656130328702,0
2686,513.4150375556208,1,0,674,0.001483679525222552,0.0,1.0,674,18650,14100,4550,0.7560321715817694,232,141,91,159.83613167529515,0.3955416863241344,0.9112473633406009,0.1020492225311502,17270098.60215177,398627.15084377356,17668725.752995543,2685,0,1869.6750741839762,99,575,95,36.47925033467199,0.619949494949495,40.62500000000001,133167.02536598954,1345.1214683433286,0
2687,513.7552646861952,1,0,675,0.0014814814814814814,0.0,1.0,675,16750,11700,5050,0.6985074626865672,218,117,101,156.68653654490066,0.3960413232223321,0.9098958338025842,0.10045940795113072,17301177.986747447,390422.3313780706,17691600.318125516,2686,0,1867.9037037037037,98,577,98,36.411328468139764,0.6217049319727892,40.47769360269362,133330.95121512085,1360.519910358376,0
2688,513.207629425012,2,0,677,0.0029542097488921715,0.0,1.0,677,18800,14100,4700,0.75,235,141,94,157.77413489806918,0.3968573100667465,0.9104704221034925,0.10184540474634148,17314315.74227821,392150.2375179959,17706465.97979621,2687,0,1863.3825701624814,102,575,94,36.14236584258001,0.6230596405228759,40.240695792880274,133310.45673322715,1306.9652620904624,0
2689,513.0492767081059,4,1,680,0.005873715124816446,0.0014684287812041115,0.9985315712187959,681,17650,12500,5150,0.7082152974504249,228,125,103,153.81019888231359,0.39834540828078663,0.9080796528483748,0.09997662927350433,17341065.55273409,379596.5482994562,17720662.101033546,2688,0,1853.431718061674,109,572,81,36.000934829059844,0.6238532110091743,40.000000000000014,133392.81194410837,1223.7872655422786,0
2690,513.2191228253126,1,0,681,0.0014684287812041115,0.0,1.0,681,19950,14800,5150,0.7418546365914787,251,148,103,157.73331459910975,0.39871809406582015,0.9100853391219208,0.10296997157764315,17366739.055657372,391712.66300533497,17758451.718662705,2689,0,1854.4302496328928,112,569,84,35.74724200654363,0.6247209821428572,39.85066371681418,133513.61417084525,1192.0858408111183,0
2691,512.8135590277321,1,0,682,0.001466275659824047,0.0,1.0,682,18050,13600,4450,0.7534626038781164,225,136,89,157.45202186394945,0.3992376425186927,0.9103026134149339,0.10311373378984423,17367662.192667156,392464.7054571013,17760126.89812426,2690,0,1852.7096774193549,118,564,87,35.643064150858784,0.6246468926553672,39.74089635854341,133464.39720774224,1131.0542136249342,0
2692,512.7212033536664,0,0,682,0.0,0.0,1.0,682,16700,12200,4500,0.7305389221556886,212,122,90,159.28109745011955,0.39924437102300536,0.9121556221987162,0.10460967269619781,17377651.498738296,400486.28036494943,17778137.779103246,2691,1,1853.7096774193549,122,560,89,35.49561417775319,0.6249146174863388,39.64261517615176,133490.75164889687,1094.186488925384,0
2693,513.0507792690026,1,0,683,0.0014641288433382138,0.0,1.0,683,17650,12600,5050,0.7138810198300283,227,126,101,155.84130091080524,0.39972900019893837,0.910227114088334,0.10269098760433243,17404067.090821702,388204.4913145181,17792271.58213622,2692,0,1851.9941434846266,94,589,94,35.469287167613835,0.6324246453900709,39.52850877192983,133635.1015519208,1421.6500165097957,0
2694,512.9159547979431,0,0,683,0.0,0.0,1.0,683,18800,13600,5200,0.723404255319149,240,136,104,150.7436621911437,0.40009869988793617,0.9061288628413573,0.09989381397408105,17425313.40870767,369951.1116114093,17795264.52031908,2693,1,1852.9941434846266,104,579,104,35.40596257532509,0.6317107371794872,39.33531746031747,133699.0745269445,1285.5680242975432,0
2695,512.5022226823796,1,0,684,0.0014619883040935672,0.0,1.0,684,19200,13500,5700,0.703125,249,135,114,148.59194658661457,0.40057453857109016,0.9049458328074371,0.09910883193637035,17440821.037194163,362313.1095970961,17803134.146791257,2694,0,1851.2836257309941,110,574,79,35.237559952038374,0.6325757575757576,39.11411411411413,133704.59638297916,1215.496330754356,0
2696,512.0346305683485,0,0,684,0.0,0.0,1.0,684,19250,14600,4650,0.7584415584415585,239,146,93,153.3638813539978,0.40076736548137876,0.9071343356212507,0.1026280211008216,17439810.59249531,378877.4085087314,17818688.001004044,2695,1,1852.2836257309941,112,572,81,34.99982340267725,0.6332775297619048,39.002581120943965,133639.71695503063,1193.2117585270591,0
2697,511.9765528794031,0,0,684,0.0,0.0,1.0,684,17200,11900,5300,0.6918604651162791,225,119,106,152.1993822107336,0.40095145185641834,0.9068391910388747,0.10220820172965939,17453788.812735472,377291.17490699457,17831079.987642467,2696,2,1853.2836257309941,121,563,81,34.90901510692567,0.6327479338842975,38.88319672131149,133685.6808415132,1104.840337533167,0
2698,511.6819316230554,0,0,684,0.0,0.0,1.0,684,18550,12900,5650,0.6954177897574124,242,129,113,153.38828976679022,0.40111573824344493,0.9076032137505612,0.10325399640006157,17454584.023375865,380115.75838727725,17834699.781763144,2697,3,1854.2836257309941,127,557,82,34.79561316051847,0.6325459317585302,38.80208333333335,133650.2545359189,1052.3642089442433,0
2699,511.63023907028685,0,0,684,0.0,0.0,1.0,684,18700,13500,5200,0.7219251336898396,239,135,104,153.95599927502434,0.4014145218463436,0.9093420261145244,0.10405494136766814,17471005.16317367,382453.2116471074,17853458.37482078,2698,4,1855.2836257309941,133,551,87,34.642651754020676,0.6329887218045113,38.66604477611942,133706.35398837892,1005.3109322434506,0
2700,511.8666830140261,1,0,685,0.00145985401459854,0.0,1.0,685,19200,13800,5400,0.71875,246,138,108,153.7383086709802,0.40178222065707664,0.9104118619712502,0.10432716114730337,17497204.06922682,381798.1120147786,17879002.181241598,2699,0,1853.5737226277372,93,592,93,34.510798544889425,0.6428091397849462,38.530585106382944,133837.4821112124,1439.1127108732514,0
2701,511.8173539985196,0,0,685,0.0,0.0,1.0,685,19600,14500,5100,0.7397959183673469,247,145,102,188.9530520898386,0.40203780182410603,0.9233493341108103,0.12151934817887966,17250175.553650923,495294.6639895834,17745470.217640508,2700,1,1854.5737226277372,89,596,89,35.46458927722305,0.6254681647940075,40.370370370370416,132882.95005665478,1493.0668545691549,8
2702,512.0594939669772,0,0,685,0.0,0.0,1.0,685,20750,15800,4950,0.7614457831325301,257,158,99,188.35562747988925,0.4021181933950855,0.9229849984780334,0.12166089220974888,17278426.834339075,493147.7856494671,17771574.619988542,2701,2,1855.5737226277372,94,591,82,35.32618253700264,0.6254432624113475,40.21929824561407,133023.1746827388,1415.1401561993491,0
2703,511.97628721403163,2,0,687,0.002911208151382824,0.0,1.0,687,17800,13000,4800,0.7303370786516854,226,130,96,189.71950733995,0.40264772471683624,0.923517577985699,0.12314911621178146,17298483.864949606,501171.96731726767,17799655.832266875,2702,0,1851.1688500727803,100,587,71,35.115635125305865,0.6255208333333333,40.04744224422444,133089.54537159405,1330.8954537159404,0
2704,512.3294736854706,0,0,687,0.0,0.0,1.0,687,18800,13300,5500,0.7074468085106383,243,133,110,186.51371304989928,0.4028778593991142,0.9218442863194054,0.12140952996744062,17323417.694527436,490010.9913841285,17813428.685911566,2703,1,1852.1688500727803,107,580,74,35.099553692851686,0.6248052959501558,39.94984567901235,133231.35869509715,1245.1528850009079,0
2705,512.2933597056743,0,0,687,0.0,0.0,1.0,687,18250,12800,5450,0.7013698630136986,237,128,109,183.38406918073326,0.4032274377831815,0.9206564004365099,0.11977895358685087,17337869.487931237,480247.81152426015,17818117.299455497,2704,2,1853.1688500727803,112,575,79,35.061164652942594,0.6249069940476191,39.83222713864306,133282.2224462871,1190.0198432704206,0
2706,512.2733476218732,1,0,688,0.0014534883720930232,0.0,1.0,688,19800,14200,5600,0.7171717171717171,254,142,112,182.02285638492953,0.4035045660409826,0.9203654290696484,0.11935307907988446,17355073.78302743,474404.02055156976,17829477.803579,2705,0,1851.4738372093022,117,571,85,34.96000356089121,0.625267094017094,39.698093220338976,133345.72917837332,1139.7070869946438,0
2707,512.5226262902839,1,0,689,0.001451378809869376,0.0,1.0,689,19200,13400,5800,0.6979166666666666,250,134,116,183.3482594268497,0.40393941407612427,0.9220483229231742,0.12074585548382835,17383467.207239565,480445.6910502216,17863912.898289785,2706,0,1849.7851959361394,89,600,89,34.77328022930274,0.6337780898876404,39.54861111111112,133487.22985428598,1499.8565152166964,0
2708,512.2251572338146,0,0,689,0.0,0.0,1.0,689,20100,15000,5100,0.746268656716418,252,150,102,179.71965735323775,0.4042115476029748,0.9204899701139737,0.11877835535982254,17389669.33413193,467153.0828432644,17856822.416975193,2707,1,1850.7851959361394,92,597,92,34.74350570265935,0.6340579710144927,39.42652329749106,133472.29007490532,1450.7857616837534,0
2709,512.5851649479782,1,0,690,0.0014492753623188406,0.0,1.0,690,19950,14000,5950,0.7017543859649122,259,140,119,176.42039292016557,0.4045620709843433,0.9186974067445697,0.11714087182641339,17423114.31072336,456808.5345181619,17879922.845241524,2708,0,1849.1014492753623,98,592,91,34.667826876513345,0.6339285714285714,39.2676767676768,133647.5209113114,1363.7502133807286,0
2710,512.3283219790983,1,1,690,0.001447178002894356,0.001447178002894356,0.9985528219971056,691,17650,12500,5150,0.7082152974504249,228,125,103,180.0922378522146,0.4048936638771787,0.9204090616453788,0.12021385420084524,17438486.996376555,472257.229586848,17910744.225963403,2709,0,1847.424023154848,104,587,68,34.38846641318125,0.6342147435897436,39.08730158730162,133672.96496081803,1285.3169707770965,0
2711,511.9322155016958,1,0,691,0.001447178002894356,0.0,1.0,691,20000,14300,5700,0.715,257,143,114,177.15581099398125,0.4048949747268189,0.9195947481663556,0.11883663525800718,17447297.256599087,459978.0190291791,17907275.275628265,2710,0,1848.422575976845,109,582,75,34.29527868456049,0.6347477064220184,38.92045454545456,133655.03012672206,1226.1929369424042,0
2712,512.129359513057,0,0,691,0.0,0.0,1.0,691,20700,15100,5600,0.7294685990338164,263,151,112,174.780005512929,0.40509885554087405,0.9182511960614639,0.11782943900007717,17476580.262395505,452011.35892173287,17928591.621317238,2711,1,1849.422575976845,118,573,82,34.18565365499528,0.6346221751412429,38.751750700280134,133792.89858777434,1133.8381236252062,0
2713,512.3644678606078,1,0,692,0.001445086705202312,0.0,1.0,692,19000,12800,6200,0.6736842105263158,252,128,124,175.81041915278706,0.40545556828923485,0.9201129271566166,0.11908580662692794,17505929.024392676,458144.9438874865,17964073.968280163,2712,0,1847.7485549132948,122,570,88,33.99666310299025,0.6355020491803278,38.592479674796756,133935.92504618442,1097.835451198233,0
2714,512.8206066838778,0,0,692,0.0,0.0,1.0,692,17450,12200,5250,0.6991404011461319,227,122,105,175.3711886893787,0.40562065010080056,0.9201656907312667,0.11912688805152506,17534334.040860906,459153.40072448156,17993487.441585388,2713,1,1848.7485549132948,92,600,92,33.9108522151311,0.643455615942029,38.49686379928315,134104.19695618807,1457.6543147411746,0
2715,512.5881323987857,1,0,693,0.001443001443001443,0.0,1.0,693,18250,12700,5550,0.6958904109589041,238,127,111,175.563516944408,0.40597665687983603,0.9209333124789105,0.11969041500261376,17542664.693494912,459120.38203328976,18001785.0755282,2714,0,1847.079365079365,93,600,93,33.7822705324241,0.6443772401433692,38.37544326241134,134105.64292778017,1441.9961605137653,0
2716,512.7978593216587,0,0,693,0.0,0.0,1.0,693,17200,12400,4800,0.7209302325581395,220,124,96,172.04508234089454,0.4060671051277988,0.9184670406580522,0.11778471021799672,17568649.842936184,448719.9617692578,18017369.80470544,2715,1,1848.079365079365,101,592,89,33.73176107990013,0.6435643564356436,38.23529411764705,134232.38082243377,1329.0334734894432,0
2717,512.7355046758818,1,2,692,0.001440922190201729,0.002881844380403458,0.9971181556195965,694,20000,15100,4900,0.755,249,151,98,169.3330445752527,0.40644090139767375,0.9165012695190491,0.11646341237297454,17587116.689813804,436816.0028772829,18023932.692691088,2716,0,1846.414985590778,110,584,65,33.646691747282965,0.6429924242424243,38.081831831831835,134294.7441394883,1220.8613103589844,0
2718,512.470741449512,0,1,691,0.0,0.001445086705202312,0.9985549132947977,692,17200,11400,5800,0.6627906976744186,230,114,116,170.24387187502188,0.4063443698083535,0.9172958449626594,0.11748439082416834,17593031.213536005,443421.1503620966,18036452.363898102,2717,3,1850.9407514450868,112,580,69,33.50923482849608,0.6436941964285714,37.97013274336283,134282.64035492603,1198.9521460261253,0
2719,512.6080986706461,1,0,692,0.001445086705202312,0.0,1.0,692,18600,13500,5100,0.7258064516129032,237,135,102,170.51060368956064,0.40628023667913077,0.91735530902491,0.11813697504079868,17615426.2346185,443723.39230274374,18059149.626921244,2718,0,1851.6907514450868,119,573,74,33.36841081421144,0.6436449579831933,37.838541666666664,134386.08670097357,1129.2948462266686,0
2720,512.6110098432666,0,0,692,0.0,0.0,1.0,692,19900,14400,5500,0.7236180904522613,254,144,110,173.98997071443637,0.4062507842366345,0.9191250405049249,0.12103028373806972,17633260.4062747,455302.092337554,18088562.49861225,2719,1,1852.6907514450868,120,572,81,33.14296967309965,0.6447916666666667,37.70661157024794,134454.47871818754,1120.4539893182296,0
2721,512.4907407625025,0,0,692,0.0,0.0,1.0,692,18950,13100,5850,0.6912928759894459,248,131,117,176.9593254871218,0.4063469403617666,0.9212964896803337,0.12347326404850226,17642678.04248116,467057.28123678727,18109735.323717948,2720,2,1853.6907514450868,127,565,82,32.96248410507709,0.6446030183727034,37.60579427083334,134474.60086592968,1058.8551249285802,0
2722,512.0199398290647,0,0,692,0.0,0.0,1.0,692,18450,13900,4550,0.7533875338753387,230,139,91,181.68061299909925,0.40640314398724026,0.9243462223030108,0.1271152829107296,17638565.758463096,484067.0878845046,18122632.8463476,2721,3,1854.6907514450868,131,561,84,32.74695348044819,0.6448791348600509,37.515782828282845,134397.15308234285,1025.9324662774263,0
2723,512.4230041038116,0,0,692,0.0,0.0,1.0,692,19850,13800,6050,0.6952141057934509,259,138,121,177.74581437990187,0.4064341213343037,0.9217776279617225,0.12494485187293218,17673055.438602895,470012.326303132,18143067.764906026,2722,4,1855.6907514450868,90,602,90,32.694368171780575,0.6555555555555556,37.36263736263739,134581.42635254088,1495.3491816948986,0
2724,512.1717799489033,0,0,692,0.0,0.0,1.0,692,18250,13700,4550,0.7506849315068493,228,137,91,175.60196539755225,0.4063327369649415,0.920503771673252,0.1236306679462133,17671255.08811387,463971.4249028624,18135226.513016734,2723,5,1856.6907514450868,93,599,93,32.6987537790902,0.6551299283154122,37.311613475177325,134541.57849832487,1446.6836397669342,0
2725,512.2337851534385,0,0,692,0.0,0.0,1.0,692,16200,11400,4800,0.7037037037037037,210,114,96,170.7567881032896,0.4064177395023827,0.917353808567364,0.12076854782672126,17693398.517214287,449653.5802862072,18143052.097500496,2724,6,1857.6907514450868,101,591,93,32.674869837199374,0.6543935643564356,37.16299019607845,134633.99641027494,1333.0098654482667,0
2726,512.6870900015851,0,0,692,0.0,0.0,1.0,692,19550,14200,5350,0.7263427109974424,249,142,107,169.45781779202167,0.40651860104732185,0.9166088783206436,0.12023820818512702,17723236.24820947,442718.1877668096,18165954.435976278,2725,7,1858.6907514450868,105,587,68,32.602021589366046,0.6544642857142857,37.05778301886794,134807.08006262255,1283.8769529773576,0
2727,512.5926317570271,0,0,692,0.0,0.0,1.0,692,20750,15700,5050,0.7566265060240964,258,157,101,167.70091842478482,0.4066063919816858,0.9156090707171232,0.11940117968923468,17734997.134123888,435685.0615307038,18170682.195654593,2726,8,1859.6907514450868,110,582,72,32.53488697037806,0.6544507575757577,36.946321321321335,134839.37744727204,1225.8125222479277,0
2728,512.7452425333431,0,0,692,0.0,0.0,1.0,692,18250,13100,5150,0.7178082191780822,234,131,103,171.51730111092672,0.40644693053266745,0.9168846355409204,0.12258344827947226,17756865.85066976,452471.9413791284,18209337.79204889,2727,9,1860.6907514450868,116,576,75,32.30942715381146,0.6544540229885057,36.823361823361815,134942.56917098968,1163.2980100947386,0
2729,513.0301860331259,0,0,692,0.0,0.0,1.0,692,18400,12800,5600,0.6956521739130435,240,128,112,172.52179802564513,0.4063860650560886,0.9177929483510359,0.12390864709571427,17788129.224270497,456968.00745673495,18245097.23172723,2728,10,1861.6907514450868,120,572,81,32.12184118473962,0.6552951388888889,36.66494490358127,135098.83230515942,1125.823602542995,0
2730,512.8467491918427,0,0,692,0.0,0.0,1.0,692,18750,13900,4850,0.7413333333333333,236,139,97,157.34318281935802,0.4062196326147634,0.9063900491449735,0.10602283627360731,17498868.86595799,393515.5446216938,17892384.410579685,2729,11,1862.6907514450868,137,555,87,34.6578103328711,0.6313868613138687,38.768115942029034,133971.9225243941,977.8972447036065,8
2731,512.9007085229119,0,1,691,0.0,0.001445086705202312,0.9985549132947977,692,17150,13000,4150,0.7580174927113703,213,130,83,157.69334062158993,0.40645111312805154,0.9066508220474403,0.10667279348788299,17518278.035852324,396953.1570822931,17915231.192934617,2730,12,1863.6907514450868,141,551,96,34.515510539167614,0.6321660756501182,38.637030516431984,134053.25222977853,950.7322853175782,0
2732,512.881203198269,0,0,691,0.0,0.0,1.0,691,18050,12900,5150,0.7146814404432132,232,129,103,161.40017570210077,0.4063240630046771,0.9095810172176331,0.10952469596387701,17531808.48815477,409677.3940727479,17941485.882227518,2731,13,1867.327062228654,98,593,98,34.31103286384977,0.6413690476190477,38.53114478114476,134102.46106351944,1368.392459831831,0
2733,512.7112514001068,0,0,691,0.0,0.0,1.0,691,20900,15200,5700,0.7272727272727273,266,152,114,138.75605566165322,0.40670464635024506,0.9012297914938441,0.09000184503536898,17319909.64453218,321548.46933830116,17641458.113870483,2732,14,1868.327062228654,116,575,82,36.46636124907232,0.6216774425287357,40.073005698005694,133267.4945212437,1148.857711390032,8
2734,512.9769632043993,2,1,692,0.002886002886002886,0.001443001443001443,0.9985569985569985,693,18450,13300,5150,0.7208672086720868,236,133,103,138.47462753842927,0.4074971605679698,0.9011581201081835,0.09018171221280848,17347504.984371826,323387.85828639107,17670892.842658218,2733,0,1863.9321789321789,121,572,87,36.332139105026414,0.6221590909090908,39.93340163934428,133408.17385794863,1102.5468913880052,0
2735,512.6357021912532,2,0,694,0.002881844380403458,0.0,1.0,694,20200,14900,5300,0.7376237623762376,255,149,106,137.79883581741498,0.407889924010241,0.9010350209326512,0.09016940267792616,17357881.72804283,319379.1788761403,17677260.90691897,2734,0,1861.7608069164264,128,566,94,36.183104746537595,0.6226399739583333,39.76905684754524,133403.6722748518,1042.2161896472796,0
2736,512.5906706007495,0,0,694,0.0,0.0,1.0,694,18450,13200,5250,0.7154471544715447,237,132,105,142.0733281737915,0.40805721722508465,0.9047755648490441,0.09328210349537067,17371939.25598397,336367.8453861155,17708307.101370085,2735,1,1862.7608069164264,135,559,95,35.9534202681102,0.6227623456790123,39.65226715686274,133451.8189674483,988.5319923514688,0
2737,512.7570148342417,1,0,695,0.0014388489208633094,0.0,1.0,695,18550,13500,5050,0.7277628032345014,236,135,101,144.95269606104225,0.40847604337279453,0.9006165018488159,0.09127676809072038,17183154.32524613,340598.9092554758,17523753.234501604,2736,0,1861.0791366906474,125,570,81,37.360124274841674,0.6095833333333334,41.112764550264544,132746.24602789537,1061.9699682231628,8
2738,512.3148035039272,3,0,698,0.004297994269340974,0.0,1.0,698,21100,15200,5900,0.7203791469194313,270,152,118,142.81016491283893,0.40937243494085035,0.899595424794869,0.09029173359132685,17187327.13555717,330205.00452796463,17517532.140085135,2737,0,1854.0759312320918,132,566,89,37.27039427932151,0.609927398989899,40.96961152882205,132705.1025711571,1005.3416861451295,0
2739,512.5525045606943,2,0,700,0.002857142857142857,0.0,1.0,700,19200,13000,6200,0.6770833333333334,254,130,124,144.69609344369445,0.40992634035016007,0.9032163713707511,0.09197055994519301,17220169.493956793,339138.25084276724,17559307.74479956,2738,0,1849.7757142857142,138,562,95,37.031596318781894,0.6109601449275363,40.78237410071943,132862.64338095373,962.7727781228531,0
2740,512.1497781619476,1,0,701,0.0014265335235378032,0.0,1.0,701,18550,13300,5250,0.7169811320754716,238,133,105,147.07495549312637,0.41038907003600295,0.9040344523875237,0.09375137820395997,17220059.3391315,347777.8921783659,17567837.231309865,2739,0,1848.135520684736,147,554,101,36.867377772952665,0.610827664399093,40.681306306306354,132810.01144847486,903.4694656358835,0
2741,512.526507761222,1,0,702,0.0014245014245014246,0.0,1.0,702,20250,14100,6150,0.6962962962962963,264,141,123,147.4342363799896,0.4108171849196576,0.9042669836139849,0.09458568024962505,17262673.32026338,348371.81177004555,17611045.132033423,2740,0,1846.5014245014245,110,592,110,36.62951513179299,0.6190340909090909,40.45608108108106,133023.138374174,1209.3012579470364,0
2742,512.1993155674166,0,0,702,0.0,0.0,1.0,702,18800,13500,5300,0.7180851063829787,241,135,106,149.3621351909966,0.4108747610590216,0.9053189273120308,0.09616160303257112,17268071.937501896,356639.21904339566,17624711.156545293,2741,1,1847.5014245014245,113,589,108,36.45415464377034,0.6196533923303835,40.33260233918126,133001.46335704182,1177.004100504795,0
2743,512.163420329412,1,0,703,0.001422475106685633,0.0,1.0,703,19700,13400,6300,0.6802030456852792,260,134,126,148.9415043974892,0.41128577970683233,0.9053589896127838,0.09629128277111366,17286187.93922199,354626.16739308543,17640814.106615074,2742,0,1845.8719772403983,118,585,74,36.31763586132542,0.6201447740112994,40.187324929971965,133066.5483087982,1127.6826127864254,0
2744,511.6759526447469,0,0,703,0.0,0.0,1.0,703,20450,15600,4850,0.7628361858190709,253,156,97,146.35319780727733,0.4113887841958017,0.9047075305677956,0.09498450452446325,17287605.38188069,344969.2660137093,17632574.647894397,2743,1,1846.8719772403983,121,582,80,36.2485287677232,0.6209538567493114,40.05293715846995,133008.6610166442,1099.2451323689604,0
2745,512.1284006692282,0,0,703,0.0,0.0,1.0,703,19250,12000,7250,0.6233766233766234,265,120,145,147.88604921551976,0.41139021950425464,0.9061709889052809,0.09635657995675458,17320994.47812561,352456.68837076717,17673451.166496377,2744,2,1847.8719772403983,127,576,83,36.070727338151976,0.6213090551181102,39.91699218750001,133195.89483225852,1048.7865734823506,0
2746,511.68231681053146,1,0,704,0.0014204545454545455,0.0,1.0,704,20950,16300,4650,0.7780429594272077,256,163,93,147.24664949629243,0.41181765647226176,0.9063045437697974,0.09633158592167639,17324644.290237222,348449.16509049677,17673093.45532772,2745,0,1846.2457386363637,134,570,91,35.94452680998269,0.6216573383084577,39.77623456790122,133151.89918545552,993.6708894436979,0
2747,511.76881426387433,0,0,704,0.0,0.0,1.0,704,18550,13100,5450,0.706199460916442,240,131,109,145.9666577732982,0.41213787333236346,0.9059623030804764,0.09583028401638062,17343699.069605112,346970.3573232122,17690669.426928323,2746,1,1847.2457386363637,144,560,98,35.85500597866073,0.6215277777777778,39.65517241379306,133236.3637135227,925.2525257883522,0
2748,511.5498460685798,1,0,705,0.0014184397163120568,0.0,1.0,705,19850,12900,6950,0.6498740554156172,268,129,139,142.51942707575074,0.41237650776380824,0.9048010764973224,0.09397978694513016,17356421.420361888,333875.44738305564,17690296.867744945,2747,0,1845.6241134751774,104,601,104,35.79139373397313,0.6300080128205128,39.50396825396827,133256.70494115914,1281.3144705880686,0
2749,511.52886634607717,1,0,706,0.00141643059490085,0.0,1.0,706,19000,13200,5800,0.6947368421052632,248,132,116,139.37244049328274,0.41271133445844127,0.9025224307705575,0.09222092077529115,17371397.74375409,324018.81966530427,17695416.563419394,2748,0,1844.0084985835695,110,596,110,35.75402398185155,0.6298295454545455,39.38626126126127,133311.4503312402,1211.9222757385471,0
2750,511.1032157748229,0,0,706,0.0,0.0,1.0,706,21400,16200,5200,0.7570093457943925,266,162,104,137.82628550193462,0.4129481177880913,0.9015947807530098,0.09155941093845141,17374953.958251473,316345.07296659244,17691299.031218067,2749,1,1845.0084985835695,115,591,106,35.657272043714315,0.6301630434782608,39.25107758620692,133269.61275551084,1158.8661978740074,0
2751,510.84414489268823,3,3,706,0.004231311706629055,0.004231311706629055,0.995768688293371,709,18350,13100,5250,0.7138964577656676,236,131,105,133.79824114915274,0.4135324447047511,0.8996124323742807,0.08991980901924906,17418635.336008105,305966.55423527997,17724601.890243385,2750,0,1838.1974612129761,131,578,87,35.3632801482735,0.6313613231552162,38.85732323232326,133403.20740837348,1018.3450947204083,8
2752,511.0015308397554,0,0,706,0.0,0.0,1.0,706,19450,13300,6150,0.6838046272493573,256,133,123,135.21932395535012,0.4131217812200725,0.9006271486254174,0.09123388236948339,17441777.79476102,311043.0803974139,17752820.875158433,2751,1,1847.0056657223795,136,570,93,35.19119401682041,0.6319699754901961,38.724148418491524,133512.3601296144,981.7085303648117,0
2753,511.23716383413137,0,0,706,0.0,0.0,1.0,706,18950,13600,5350,0.7176781002638523,243,136,107,152.3369797663131,0.4129931974497552,0.913214971785582,0.10142674855614005,17389723.184727546,369669.58178672777,17759392.766514275,2752,2,1848.0056657223795,106,600,95,35.201117248930046,0.6328616352201257,39.174454828660444,133343.71196888725,1257.9595468762948,8
2754,511.2878323772482,1,1,706,0.0014144271570014145,0.0014144271570014145,0.9985855728429985,707,19100,14300,4800,0.7486910994764397,239,143,96,149.9332378766557,0.41309971243988014,0.9109419455673764,0.10029993005742426,17412913.366659127,361654.8963857851,17774568.263044912,2753,0,1846.3903818953324,116,591,75,35.1004781560574,0.6323635057471264,39.01353276353279,133439.20511313048,1150.3379751131938,0
2755,511.5719780199506,0,1,705,0.0,0.00141643059490085,0.9985835694050992,706,20900,15300,5600,0.7320574162679426,265,153,112,158.00288872432446,0.41291513471159064,0.9124423203628327,0.10568319914583654,17421945.799912043,388443.5527169488,17810389.35262899,2754,4,1850.0056657223795,117,589,75,34.89477630451453,0.6321225071225072,39.01836158192093,133510.89299242568,1141.1187435250058,8
2756,511.6485209675484,1,0,706,0.00141643059490085,0.0,1.0,706,19000,13200,5800,0.6947368421052632,248,132,116,159.92813490267005,0.4130170557665133,0.9114919233319272,0.10738031914893616,17441845.413847532,397688.3612594676,17839533.775107,2755,0,1850.9447592067988,128,578,80,34.71298758865252,0.6315104166666667,38.8888888888889,133597.11380819388,1043.7274516265147,0
2757,511.3307082677603,1,1,706,0.0014144271570014145,0.0014144271570014145,0.9985855728429985,707,18900,12700,6200,0.671957671957672,251,127,124,155.49690176981431,0.4131785978071704,0.9087223284513397,0.10741990560479217,17558541.20068144,385759.7512607211,17944300.95194216,2756,0,1849.3253182461103,121,586,81,33.86042827354766,0.6423037190082644,37.935450819672134,134001.65154424857,1107.4516656549467,8
2758,511.8037233675261,0,1,705,0.0,0.00141643059490085,0.9985835694050992,706,22500,17500,5000,0.7777777777777778,275,175,100,155.10063717277188,0.41285707947414596,0.9078363041281414,0.10758568007063651,17592956.144599065,382035.74155598675,17974991.88615505,2757,2,1852.9447592067988,124,582,88,33.73326129332997,0.6431451612903225,37.79999999999999,134194.93626696465,1082.2172279593924,0
2759,512.2799926943218,0,0,705,0.0,0.0,1.0,705,19500,14300,5200,0.7333333333333333,247,143,104,156.12565665068743,0.41266865798946917,0.9083383431721157,0.10867713420738954,17624872.54690005,389838.95995388564,18014711.506853934,2758,3,1856.5475177304966,129,576,93,33.58887370050197,0.6434916020671835,37.68429487179486,134379.08750668212,1041.6983527649777,0
2760,512.295167590751,0,0,705,0.0,0.0,1.0,705,18750,13100,5650,0.6986666666666667,244,131,113,159.42925629853224,0.41260854892005155,0.9089283122369229,0.11128633309114183,17637720.023295872,402643.71722315263,18040363.740519024,2759,4,1857.5475177304966,134,571,98,33.40905081157372,0.6436567164179104,37.592592592592574,134430.0467548309,1003.2093041405291,0
2761,512.2141934616897,0,0,705,0.0,0.0,1.0,705,21450,16100,5350,0.7505827505827506,268,161,107,162.50192900776597,0.41270039154846333,0.9106747970145013,0.11389174074086403,17652819.220926244,411273.4351651761,18064092.656091418,2760,5,1858.5475177304966,102,603,102,33.19321391884953,0.6511437908496732,37.45954692556634,134476.94642258759,1318.4014355155646,0
2762,512.1796199290486,1,0,706,0.00141643059490085,0.0,1.0,706,18150,12700,5450,0.699724517906336,236,127,109,164.41299746216026,0.41279529899075135,0.910446176962201,0.11567767857768033,17668656.3221626,421641.3494110992,18090297.6715737,2761,0,1856.913597733711,105,601,105,33.014352388791195,0.651686507936508,37.332940251572325,134532.71482983022,1281.2639507602878,0
2763,512.6552035290606,0,0,706,0.0,0.0,1.0,706,20500,15000,5500,0.7317073170731707,260,150,110,161.35680493866084,0.4127284957038287,0.909388934281308,0.11424320477921586,17712673.2699864,409912.07315348426,18122585.343139883,2762,1,1857.913597733711,111,595,96,32.886357203509746,0.6524024024024024,37.12797619047618,134762.7108681671,1214.0784762897938,0
2764,512.9723307526381,0,1,705,0.0,0.00141643059490085,0.9985835694050992,706,20850,15400,5450,0.7386091127098321,263,154,109,160.10195078913807,0.41265001439870347,0.9085771183350633,0.1138753311950914,17743702.345132343,406110.2719355002,18149812.617067844,2763,2,1858.913597733711,115,591,79,32.76815181518152,0.6530797101449275,36.97916666666667,134922.4099115014,1173.238347056534,0
2765,512.786705524456,0,0,705,0.0,0.0,1.0,705,19700,13900,5800,0.7055837563451777,255,139,116,166.89508787680307,0.4122141461154094,0.9109085674996005,0.11919364086266201,17755145.388126876,431949.30996337143,18187094.698090248,2764,3,1862.5148936170212,117,588,82,32.454852957620496,0.6540242165242165,36.846751412429384,134941.48739127893,1153.3460460793071,0
2766,512.814057429742,0,0,705,0.0,0.0,1.0,705,18400,12300,6100,0.6684782608695652,245,123,122,166.3886607493698,0.4120592561250806,0.9113223070529572,0.11917578001618762,17768682.577886153,431901.45948302624,18200584.03736918,2765,4,1863.5148936170212,119,586,85,32.37334850183562,0.6545868347338936,36.75347222222222,134996.52001401337,1134.4245379328854,0
2767,512.8605581048314,1,0,706,0.00141643059490085,0.0,1.0,706,20350,14700,5650,0.7223587223587223,260,147,113,166.6838544230763,0.41231218900474825,0.9121682167907803,0.11984869097298387,17787071.304457664,431413.52078501775,18218484.825242683,2766,0,1861.8739376770538,127,579,88,32.23926629175292,0.6544455380577427,36.62923177083333,135072.47918250828,1063.5628282087266,0
2768,512.7853246621231,0,0,706,0.0,0.0,1.0,706,19650,14200,5450,0.72264631043257,251,142,109,166.01317647725094,0.4122946510490962,0.9119118431720548,0.1196262074768781,17793895.546114203,429954.2243029674,18223849.77041717,2767,1,1862.8739376770538,133,573,91,32.185929308428484,0.6542136591478697,36.55939054726369,135088.47844740952,1015.7028454692445,0
2769,512.4122943331655,0,0,706,0.0,0.0,1.0,706,19000,13600,5400,0.7157894736842105,244,136,108,165.7990721284411,0.41229272564107716,0.9119026764427838,0.11967854289962845,17788435.42488401,429661.21761249646,18218096.642496508,2768,2,1863.8739376770538,136,570,95,32.13521377386624,0.6543351715686274,36.50395377128955,135018.61359577233,992.783923498326,0
2770,512.3898002210708,0,0,706,0.0,0.0,1.0,706,18100,12400,5700,0.6850828729281768,238,124,114,159.9296505540162,0.4121530917029983,0.9139791479500889,0.11217326620597497,17662187.58326224,405641.4976421307,18067829.08090437,2769,3,1864.8739376770538,95,611,95,33.23570129762789,0.6532894736842105,37.43489583333337,134535.6812689849,1416.1650659893146,8
2771,512.5654243362368,1,0,707,0.0014144271570014145,0.0,1.0,707,18750,13200,5550,0.704,243,132,111,159.74952906076572,0.41207144793799494,0.91410425429415,0.11254588717802598,17687806.046831973,404973.7372199204,18092779.784051895,2770,0,1863.2347949080622,98,609,98,33.09277541920323,0.6539115646258503,37.28956228956232,134656.2869826106,1374.0437447205163,0
2772,513.0359568505478,0,0,707,0.0,0.0,1.0,707,21300,14700,6600,0.6901408450704225,279,147,132,158.82428580986198,0.4119304559958222,0.913111388656114,0.11217855576975529,17715211.2467136,400021.15484602866,18115232.40155963,2771,1,1864.2347949080622,102,605,97,33.032919633121686,0.6536968954248366,37.20671521035601,134822.40431595469,1321.7882776073989,0
2773,512.6745628107486,0,0,707,0.0,0.0,1.0,707,20400,15300,5100,0.75,255,153,102,157.06841238910576,0.41197069170696915,0.9118758326417555,0.11125407089598462,17715199.11794022,394699.6401223547,18109898.758062575,2772,2,1865.2347949080622,107,600,93,32.98509196751785,0.6534267912772586,37.11419753086421,134774.86385001778,1259.5781668225961,0
2774,512.3286341815153,0,0,707,0.0,0.0,1.0,707,19100,13300,5800,0.6963350785340314,249,133,116,158.50064129152048,0.4117968934691931,0.9132766649159263,0.11267054800587212,17718884.843767308,401190.92214154813,18120075.765908856,2773,3,1866.2347949080622,109,598,73,32.829509175578195,0.6541475535168195,36.99810606060608,134743.40110912235,1236.1779918268105,0
2775,512.5345488011212,0,2,705,0.0,0.002828854314002829,0.9971711456859972,707,17800,13200,4600,0.7415730337078652,224,132,92,157.2706968232556,0.4116559850035995,0.9128276973741358,0.11219055013069634,17741383.137619134,398839.93773234717,18140223.07535148,2774,4,1867.2347949080622,114,593,77,32.7460152161939,0.6542397660818713,36.88405797101451,134856.0106302088,1182.9474616684981,0
2776,512.658870156497,0,0,705,0.0,0.0,1.0,705,19700,14000,5700,0.7106598984771574,254,140,114,160.63888676244235,0.4111566966204599,0.9136208238007117,0.11508848379032809,17764476.946555987,410033.1601223643,18174510.10667835,2775,5,1873.42695035461,119,586,81,32.51588930655848,0.6546743697478992,36.744791666666664,134960.1176669799,1134.118635856974,0
2777,512.5067856258427,0,0,705,0.0,0.0,1.0,705,20200,15200,5000,0.7524752475247525,252,152,100,158.57882116239796,0.41105864160219213,0.9123647896051428,0.11391792060815939,17770873.84707983,402416.84513912024,18173290.69221895,2776,6,1874.42695035461,124,581,87,32.48229222703926,0.6546538978494624,36.65833333333333,134964.39110468523,1088.4225089087518,0
2778,512.0898667306622,1,0,706,0.00141643059490085,0.0,1.0,706,18850,13800,5050,0.7320954907161804,239,138,101,158.25230726384493,0.4110717658168083,0.9132544923564596,0.11413674303887875,17773667.443582516,402494.7762974438,18176162.21987996,2777,0,1872.770538243626,129,577,91,32.36098227953326,0.6551195090439277,36.530448717948715,134920.0874036129,1045.892150415604,0
2779,512.1840159118727,0,0,706,0.0,0.0,1.0,706,19500,13400,6100,0.6871794871794872,256,134,122,157.14107059535613,0.4109610967124077,0.9132671107859698,0.11370609907154562,17791062.328794643,398441.3162750987,18189503.64506974,2778,1,1873.770538243626,95,611,95,32.28394775842902,0.6634868421052631,36.42578124999999,134998.50185020908,1421.0368615811483,0
2780,512.2397571517172,0,0,706,0.0,0.0,1.0,706,19200,13800,5400,0.71875,246,138,108,151.29307897706042,0.41098256919748993,0.911962974617039,0.10315589600945486,17531257.24104484,370071.5772673044,17901328.818312146,2779,2,1874.770538243626,97,609,97,34.4133420004875,0.6432560137457044,38.37159863945575,134016.46877691546,1381.6130801743861,7
2781,511.9047220596678,1,0,707,0.0014144271570014145,0.0,1.0,707,18600,13300,5300,0.7150537634408602,239,133,106,154.115566199899,0.4113166527093826,0.912861377199816,0.10557451694196045,17540787.626453716,380661.6833286121,17921449.30978233,2780,0,1873.117397454031,101,606,94,34.180352916699164,0.6437706270627063,38.214869281045715,134009.04458003805,1326.8222235647331,0
2782,511.50419122615267,0,1,706,0.0,0.0014144271570014145,0.9985855728429985,707,20000,13900,6100,0.695,261,139,122,152.9864847796444,0.4111426875184483,0.9117273402106654,0.10529383317963839,17547979.480898246,375520.7391535795,17923500.220051825,2781,1,1874.117397454031,109,598,73,34.05136443608931,0.6434441896024465,38.058712121212075,133984.06660517366,1229.211620230951,0
2783,511.4094755183334,0,0,706,0.0,0.0,1.0,706,21700,16000,5700,0.7373271889400922,274,160,114,148.31218950316548,0.41091333822219545,0.9083863912359837,0.1025201535310699,17564000.207054935,358091.06542846985,17922091.272483405,2782,2,1877.6827195467422,117,589,81,34.02785964498633,0.6432514245014245,37.91490112994349,134032.80295430517,1145.5795124299586,0
2784,511.6467776675643,0,1,705,0.0,0.00141643059490085,0.9985835694050992,706,20850,14100,6750,0.6762589928057554,276,141,135,148.0983290054578,0.4108827409773706,0.9080969310322511,0.10269488883779923,17586109.727611054,358844.69287316443,17944954.42048422,2783,3,1878.6827195467422,123,583,85,33.92784194674956,0.6432079945799458,37.81081989247312,134148.24914131683,1090.6361718806247,0
2785,511.4301292661035,0,0,705,0.0,0.0,1.0,705,18200,12700,5500,0.6978021978021978,237,127,110,150.51802039143757,0.41093548517085754,0.9103244307441105,0.10485633547118445,17599116.26825813,370596.8282673887,17969713.096525516,2784,4,1882.3390070921985,124,581,90,33.70961850004764,0.644573252688172,37.658333333333324,134169.43249521777,1082.0115523807885,0
2786,511.6690926895326,0,0,705,0.0,0.0,1.0,705,19850,14000,5850,0.7052896725440806,257,140,117,155.58075081884573,0.41096360882763805,0.9139930203759985,0.10890652557319234,17628599.2090691,387684.14016629785,18016283.349235397,2785,5,1883.3390070921985,103,602,94,33.416005291005284,0.6504854368932038,37.50000000000001,134313.13683100266,1304.0110371942005,0
2787,511.6319821747667,0,0,705,0.0,0.0,1.0,705,20000,14800,5200,0.74,252,148,104,157.20139988043155,0.41103437970126805,0.9142513664402117,0.11043431864787714,17643027.12357309,393701.71239082504,18036728.835963916,2786,6,1884.3390070921985,97,608,97,33.25470345785942,0.6532431271477663,37.38307823129253,134363.21623716003,1385.1877962593817,0
2788,511.6954564538003,0,0,705,0.0,0.0,1.0,705,20100,14600,5500,0.7263681592039801,256,146,110,154.69214593604022,0.410941529658285,0.9128733314642823,0.10906453380368673,17661071.48863992,385305.8096215089,18046377.29826143,2787,7,1885.3390070921985,101,604,101,33.20081205218902,0.6533622112211221,37.265114379084984,134440.24722413195,1331.0915566745737,0
2789,511.8633858904149,0,0,705,0.0,0.0,1.0,705,18200,12800,5400,0.7032967032967034,236,128,108,156.49532273358486,0.4108220670803782,0.9135148435569391,0.11073907122957538,17682859.731393315,394256.96810342505,18077116.69949674,2788,8,1886.3390070921985,105,600,95,33.03268780220328,0.6535714285714286,37.146226415094354,134545.222541243,1281.3830718213621,0
2790,512.3583516121992,1,1,705,0.00141643059490085,0.00141643059490085,0.9985835694050992,706,17550,12200,5350,0.6951566951566952,229,122,107,157.30198298570005,0.41098085307295124,0.9139715175491205,0.11168802775581455,17714808.775858257,398564.9097309978,18113373.685589254,2789,0,1884.6657223796035,109,597,68,32.8995087447633,0.6537652905198776,37.03598484848485,134731.8093363558,1236.071645287668,0
2791,512.279476393261,0,0,705,0.0,0.0,1.0,705,17400,12500,4900,0.7183908045977011,223,125,98,152.88053529987974,0.410690935283688,0.9108631338999065,0.10895955628261472,17728583.493425187,383671.06691668776,18112254.560341876,2790,10,1888.3390070921985,118,587,72,32.89143514667553,0.6531603107344632,36.91351540616245,134773.8065738741,1142.1509031684247,0
2792,512.5290807218621,0,0,705,0.0,0.0,1.0,705,20150,14700,5450,0.7295285359801489,256,147,109,150.97773587155825,0.41066658943154954,0.9102773898518575,0.10801998229484412,17754066.726105098,374943.75936398265,18129010.48546908,2791,11,1889.3390070921985,122,583,79,32.814712033462,0.6536885245901639,36.78861788617886,134903.48771032755,1105.7662927076028,0
2793,512.9465251072093,1,0,706,0.00141643059490085,0.0,1.0,706,19650,13800,5850,0.7022900763358778,255,138,117,151.4479713326832,0.41079337693126794,0.9111598745203306,0.1087836826715711,17785655.463130787,377870.2877426402,18163525.750873428,2792,0,1887.6614730878186,127,579,85,32.67357999320126,0.6541174540682415,36.66178385416666,135078.42289993577,1063.6096291333527,0
2794,512.9224600015693,0,0,706,0.0,0.0,1.0,706,19750,14000,5750,0.7088607594936709,255,140,115,149.18866009025973,0.41083071310415953,0.910086027914436,0.10755695967318074,17800840.68174754,370186.71395802207,18171027.395705562,2793,1,1888.6614730878186,134,572,93,32.612733325523315,0.6542288557213931,36.543209876543216,135132.90489424093,1008.4545141361264,0
2795,513.2407150797592,0,0,706,0.0,0.0,1.0,706,18350,13400,4950,0.7302452316076294,233,134,99,151.76432497863695,0.4107174907412989,0.9129516752971072,0.10985277063113905,17829235.37741929,381618.3743878504,18210853.75180714,2794,2,1889.6614730878186,95,611,95,32.41464954168725,0.6635964912280702,36.414930555555536,135282.58952601365,1424.0272581685647,0
2796,513.3532041889737,0,0,706,0.0,0.0,1.0,706,18700,13000,5700,0.6951871657754011,244,130,114,147.28903774661723,0.4106537429931891,0.909874920814262,0.10711741480727653,17853531.421057213,366025.8926773023,18219557.313734517,2795,3,1890.6614730878186,101,605,101,32.37975959987094,0.6634694719471947,36.264297385620914,135389.56799612177,1340.4907722388293,0
2797,513.5238122133858,0,0,706,0.0,0.0,1.0,706,17350,12200,5150,0.7031700288184438,225,122,103,145.51064250831803,0.41048187939913877,0.9087727557016778,0.10624785707288406,17876699.789219487,361700.0144515286,18238399.803671017,2796,4,1891.6614730878186,106,600,100,32.29758522727275,0.6635220125786163,36.137071651090345,135499.89686751962,1278.3009138445248,0
2798,513.0386031319574,0,0,706,0.0,0.0,1.0,706,21450,15400,6050,0.717948717948718,275,154,121,144.7664438157987,0.41046555528767265,0.9080235024316345,0.10623253183008728,17881216.038480997,355070.0113985859,18236286.049879584,2797,5,1892.6614730878186,112,594,74,32.15684391839206,0.6637834821428572,35.978982300884965,135452.9741178324,1209.4015546235037,0
2799,513.2988488044359,1,0,707,0.0014144271570014145,0.0,1.0,707,18800,13200,5600,0.7021276595744681,244,132,112,143.5521534319888,0.4104845581684838,0.9072643099016438,0.10574070386787743,17906499.5782416,353903.31497711915,18260402.893218722,2798,0,1890.983026874116,119,588,76,32.06757944723784,0.6636029411764706,35.859375000000014,135583.0787349852,1139.3536028150018,0
2800,513.0709957142952,0,0,707,0.0,0.0,1.0,707,18800,14200,4600,0.7553191489361702,234,142,92,142.06443766458392,0.4102191861233877,0.906375341896061,0.10503808757092456,17914580.710045125,348804.96691387566,18263385.676959,2799,1,1891.983026874116,121,586,84,31.986941303177176,0.6644283746556474,35.74112021857925,135583.5665757987,1120.5253436016421,0
2801,513.347565117524,0,1,706,0.0,0.0014144271570014145,0.9985855728429985,707,19850,14100,5750,0.7103274559193955,256,141,115,141.97474983049418,0.4101222698150025,0.9066757583532359,0.10538189263659577,17940870.183666322,348180.1112134834,18289050.294879805,2800,2,1892.983026874116,128,579,88,31.864990888081234,0.6644694010416667,35.6185400516796,135719.57872668747,1060.3092088022458,0
2802,513.7607174776621,0,0,706,0.0,0.0,1.0,706,18700,12500,6200,0.6684491978609626,249,125,124,146.05424037828425,0.4097805704565394,0.9095775691620256,0.10883606111603698,17972014.64518234,365077.7894139023,18337092.434596244,2801,3,1896.5934844192634,131,575,91,31.63238160590331,0.665235368956743,35.49558080808081,135891.9801800529,1037.3433601530755,0
2803,513.448040599015,0,0,706,0.0,0.0,1.0,706,17950,12200,5750,0.6796657381615598,237,122,115,150.86101234955132,0.4096598557450826,0.9118676106158807,0.11304464598310826,17984662.54053541,383486.8795260419,18368149.42006145,2802,4,1897.5934844192634,98,608,98,31.32901013714965,0.6737882653061225,35.32196969696968,135898.4160486969,1386.718531109152,0
2804,513.023114982452,0,0,706,0.0,0.0,1.0,706,19000,13500,5500,0.7105263157894737,245,135,110,155.68440885946873,0.4095636272008251,0.914087767977821,0.1083194976400307,17648372.779629014,389315.29670561175,18037688.076334625,2803,5,1898.5934844192634,119,587,84,33.61604532768527,0.645045518207283,37.69965277777776,134566.14119292202,1130.8079091842187,8
2805,513.1382427101936,1,0,707,0.0014144271570014145,0.0,1.0,707,18000,13300,4700,0.7388888888888889,227,133,94,155.1394724258695,0.40962984147463716,0.9135938213100288,0.10834990299762766,17669115.052422497,388835.4374929597,18057950.489915457,2804,0,1896.906647807638,124,583,91,33.50375239486411,0.6454133064516129,37.57499999999999,134660.30334322184,1085.970188251789,0
2806,512.5933401232971,0,0,707,0.0,0.0,1.0,707,19750,14600,5150,0.739240506329114,249,146,103,159.4484819153931,0.40955896985894463,0.9164641386803696,0.11172712171125798,17664915.967721757,402178.806843253,18067094.77456501,2805,1,1897.906647807638,93,614,93,33.28070258748049,0.6535618279569892,37.46675531914898,134572.79278436635,1447.019277251251,0
2807,512.9638133728881,0,0,707,0.0,0.0,1.0,707,21750,16200,5550,0.7448275862068966,273,162,111,157.09364974605808,0.4097786802152494,0.9149022780538711,0.11046117422425787,17693047.196524065,392743.0718462528,18085790.26837032,2806,2,1898.906647807638,98,609,98,33.22667120690121,0.6532738095238095,37.35269360269364,134728.56386168156,1374.7812638947098,0
2808,513.0848914267232,0,0,707,0.0,0.0,1.0,707,18400,12900,5500,0.7010869565217391,239,129,110,155.7009208726087,0.4097224170009069,0.914815244237055,0.10996704456254855,17716682.78585981,391900.7649132631,18108583.550773073,2807,3,1899.906647807638,99,608,93,33.11664288356853,0.6544612794612794,37.20833333333338,134834.43375951657,1361.9639773688543,0
2809,512.8204253559036,0,0,707,0.0,0.0,1.0,707,20350,14700,5650,0.7223587223587223,260,147,113,156.3683268818567,0.40966239734050297,0.914914255779552,0.11076591828818995,17720545.27121728,392436.4030988989,18112981.67431618,2808,4,1900.906647807638,101,606,87,33.00119130862668,0.6549092409240924,37.11192810457521,134814.3728504076,1334.795770796115,0
2810,513.1330428285257,2,2,707,0.0028208744710860366,0.0028208744710860366,0.997179125528914,709,20750,15600,5150,0.7518072289156627,259,156,103,153.18430521573984,0.4099230136342266,0.9133113799885377,0.10897109414455598,17749906.27842297,381251.4121809525,18131157.690603923,2809,0,1896.5416078984485,108,601,74,32.945248822197215,0.6546103395061729,36.97438837920493,134967.13243281472,1249.6956706742103,0
2811,513.1952952275501,0,0,707,0.0,0.0,1.0,707,18700,13500,5200,0.7219251336898396,239,135,104,152.88151202271018,0.4094946928930044,0.9128867746886484,0.10914652080894721,17767738.68679284,383171.7511322635,18150910.437925104,2810,6,1902.906647807638,111,596,79,32.83530820344257,0.6551238738738738,36.85825892857145,135043.10349584464,1216.6045359986003,0
2812,513.2228396658578,1,0,708,0.0014124293785310734,0.0,1.0,708,19700,14900,4800,0.7563451776649747,245,149,96,155.95070809191955,0.4096236651510187,0.9149763760106668,0.11185114386631896,17788751.448989064,393533.67690820614,18182285.12589727,2811,0,1901.2175141242938,115,593,82,32.60374033651664,0.6557971014492754,36.70977011494255,135126.55943788693,1175.0135603294516,0
2813,513.4166559396343,0,0,708,0.0,0.0,1.0,708,19050,14100,4950,0.7401574803149606,240,141,99,155.89756305295703,0.4093907158573,0.9151428503964611,0.1122758439166997,17813435.28721539,394764.2301756901,18208199.51739108,2812,1,1902.2175141242938,122,586,87,32.47019503831113,0.6558230874316939,36.57689701897021,135245.80862976328,1108.5722018833055,0
2814,513.1191888906673,0,0,708,0.0,0.0,1.0,708,19100,13800,5300,0.7225130890052356,244,138,106,159.1126336309327,0.40936166482871045,0.9175741511805999,0.11492452897075585,17815708.455540642,406240.858472397,18221949.314013038,2813,2,1903.2175141242938,122,586,88,32.29086322149379,0.6567622950819672,36.4837398373984,135215.249674138,1108.3217186404754,0
2815,513.5626209769775,0,1,707,0.0,0.0014124293785310734,0.998587570621469,708,19400,14000,5400,0.7216494845360825,248,140,108,159.8360118048377,0.40937077969298136,0.9179796844685146,0.1158697887276425,17846939.47836238,409516.7258287485,18256456.20419113,2814,3,1904.2175141242938,90,618,90,32.152949647576456,0.665625,36.36675824175823,135392.17861401915,1504.3575401557684,0
2816,513.3152586984723,0,0,707,0.0,0.0,1.0,707,20950,14500,6450,0.6921241050119332,274,145,129,161.80020275695614,0.40917906794726416,0.9176241068475528,0.11775566852143979,17855322.621994227,415448.96410590655,18270771.586100135,2815,4,1907.8161244695898,95,612,95,31.973698645164824,0.6653508771929825,36.24131944444444,135391.35534334276,1425.172161508871,0
2817,513.1610994169193,0,0,707,0.0,0.0,1.0,707,20150,14800,5350,0.7344913151364765,255,148,107,159.79542107501237,0.409145176456132,0.916402635188938,0.11688972140054077,17871863.23290122,409618.3821392978,18281481.61504052,2816,5,1908.8161244695898,98,609,93,31.862217438105493,0.6661352040816326,36.07954545454546,135433.71061315885,1381.9766389097842,0
2818,512.7396665560315,0,0,707,0.0,0.0,1.0,707,18450,13300,5150,0.7208672086720868,236,133,103,159.1167947761105,0.40910736156578026,0.9157746482349549,0.1168052861902828,17872344.96862412,408908.04930808395,18281253.017932203,2817,6,1909.8161244695898,103,604,74,31.766348330235314,0.6659587378640777,35.96754807692308,135379.91135901006,1314.3680714466996,0
2819,512.4382020246758,0,0,707,0.0,0.0,1.0,707,19150,14600,4550,0.762402088772846,237,146,91,164.57236989550665,0.40909709394654564,0.9176405919225543,0.12103770849950335,17869892.178433396,427628.10111639363,18297520.27954979,2818,7,1910.8161244695898,105,602,73,31.561794547394005,0.6660714285714286,35.90801886792453,135330.81998045562,1288.8649521948155,8
2820,512.6169454688732,0,0,707,0.0,0.0,1.0,707,18550,13000,5550,0.7008086253369272,241,130,111,163.10103502489306,0.408866364681794,0.9174509907599573,0.1203573155011279,17890417.340872206,423639.1170647105,18314056.457936917,2819,8,1911.8161244695898,107,600,76,31.49338006230529,0.6666666666666667,35.80246913580247,135432.13127202325,1265.7208530095631,0
2821,512.5239896789186,0,0,707,0.0,0.0,1.0,707,20350,14600,5750,0.7174447174447175,261,146,115,166.2165146413411,0.40888823554552944,0.9181309809127505,0.1229275389645777,17896596.369958494,433191.9745114766,18329788.344469972,2820,9,1912.8161244695898,111,596,77,31.340331057459956,0.6664789789789789,35.73288690476191,135443.2351445018,1220.2093256261426,0
2822,512.552483263574,0,0,707,0.0,0.0,1.0,707,17700,12800,4900,0.7231638418079096,226,128,98,166.1056123440636,0.40896403227939143,0.91832101143245,0.12326784916059516,17912207.67145871,435963.64474033954,18348171.31619905,2821,10,1913.8161244695898,114,593,81,31.233582873653834,0.6669407894736843,35.625000000000014,135506.0627628082,1188.6496733579668,0
2823,512.0445378381705,0,0,707,0.0,0.0,1.0,707,20200,15300,4900,0.7574257425742574,251,153,98,169.21129678559254,0.4088418225675259,0.9201562485853971,0.12588576694928227,17905033.94949589,444346.8027168557,18349380.752212744,2822,11,1914.8161244695898,119,588,82,31.072029377974705,0.6667542016806722,35.546875000000014,135411.7781704859,1137.9141022729907,0
2824,512.1836738809468,0,0,707,0.0,0.0,1.0,707,19350,13600,5750,0.7028423772609819,251,136,115,157.6316378382892,0.4088560970625594,0.9148675888146551,0.10991248614516577,17629095.397883877,395030.63623518136,18024126.03411906,2823,12,1915.8161244695898,129,578,86,33.49239555338386,0.6440568475452196,37.628205128205146,134382.54982017516,1041.7251924044585,7
2825,512.3338629030488,1,0,708,0.0014124293785310734,0.0,1.0,708,20400,15600,4800,0.7647058823529411,252,156,96,152.46132392139174,0.4089713072396828,0.9132244153932729,0.10082802695757301,17396305.229750663,368452.7453336832,17764757.975084346,2824,0,1914.1087570621469,98,610,98,35.431387195327105,0.632546768707483,39.40446127946128,133511.91900799473,1362.3665204897422,8
2826,512.1267522532436,0,0,708,0.0,0.0,1.0,708,19450,14200,5250,0.7300771208226221,247,142,105,149.429478345236,0.4090221257295221,0.9108752816421053,0.09919565850950138,17406448.74080781,359157.31103640236,17765606.05184421,2825,1,1915.1087570621469,104,604,95,35.379805436119895,0.6323116987179487,39.27579365079366,133523.841031424,1283.8830868406153,0
2827,511.99680661903847,0,0,708,0.0,0.0,1.0,708,20400,14400,6000,0.7058823529411765,264,144,120,147.32574735456458,0.4092276471896585,0.9093497701923812,0.09815123929809277,17418389.26472322,351235.4432276173,17769624.707950838,2826,2,1916.1087570621469,108,600,76,35.31034377480608,0.6326195987654322,39.15328746177371,133552.68383664681,1236.5989244133964,0
2828,512.2536047423122,0,0,708,0.0,0.0,1.0,708,20300,14800,5500,0.729064039408867,258,148,110,148.48884505987928,0.40930377087345543,0.9104079240894394,0.09947382601278959,17452198.98860917,356391.3743147558,17808590.362923924,2827,3,1917.1087570621469,112,596,81,35.08963991006581,0.6336495535714286,38.965707964601776,133715.75705649063,1193.8906880043808,0
2829,512.5625093473842,0,1,707,0.0,0.0014124293785310734,0.998587570621469,708,19750,14600,5150,0.739240506329114,249,146,103,149.4375557263865,0.4093333629670473,0.9103925904127113,0.10045786474855933,17478470.4013368,361037.978922359,17839508.38025916,2828,4,1918.1087570621469,118,590,85,34.94544814641015,0.6336511299435028,38.8480392156863,133856.70434059907,1134.3788503440599,0
2830,512.7775411794564,0,0,707,0.0,0.0,1.0,707,20350,14500,5850,0.7125307125307125,262,145,117,149.63297230247002,0.4092766520682825,0.911151391364214,0.10097709562863333,17503210.838349186,362061.4925157976,17865272.330864985,2829,5,1921.779349363508,123,584,89,34.80843889656949,0.6340616531165312,38.71807795698924,133979.50153985707,1089.2642401614396,0
2831,513.0342644492896,0,0,707,0.0,0.0,1.0,707,19100,14200,4900,0.743455497382199,240,142,98,152.89820399819286,0.4092390876076681,0.9133064336424295,0.10354854936881765,17528047.956148393,375501.4104178547,17903549.36656625,2830,6,1922.779349363508,128,579,93,34.60140450595165,0.6344401041666667,38.598191214470276,134108.0846959976,1047.7194116874812,0
2832,513.4793439543297,0,0,707,0.0,0.0,1.0,707,17650,12600,5050,0.7138810198300283,227,126,101,140.4573775223678,0.4090657067527878,0.9011182593241442,0.09679324958018357,17621405.035409383,335961.2679066086,17957366.303315993,2831,7,1923.779349363508,122,585,81,34.33684876892413,0.6413080601092895,38.01659891598916,134523.06491554162,1102.64807307821,8
2833,513.5704513399209,0,0,707,0.0,0.0,1.0,707,19600,15200,4400,0.7755102040816326,240,152,88,139.6826259409831,0.40928616839830484,0.9005867992063585,0.096535402767714,17637312.125213314,331725.2144381,17969037.339651413,2832,8,1924.779349363508,125,582,85,34.26084744960721,0.64175,37.92162698412695,134595.70831619203,1076.7656665295362,0
2834,513.765645953248,1,0,708,0.0014124293785310734,0.0,1.0,708,20000,14100,5900,0.705,259,141,118,141.9614910527897,0.40928433415375437,0.9035574449157642,0.09851914003137131,17662539.263918076,339880.08193684614,18002419.345854923,2833,0,1923.0593220338983,131,577,87,34.06163476586012,0.642175572519084,37.78409090909089,134717.52591330794,1028.378060406931,0
2835,513.5556695789049,0,3,705,0.0,0.00423728813559322,0.9957627118644068,708,20400,15000,5400,0.7352941176470589,258,150,108,140.75488988944116,0.4091295063223029,0.902585287933795,0.09780253146790022,17660812.79113558,335169.15195486066,17995981.94309044,2834,1,1924.0593220338983,136,572,89,34.05191783601988,0.6418504901960784,37.74330900243307,134683.41054680225,990.3191951970754,0
2836,513.7220085118918,0,0,705,0.0,0.0,1.0,705,19450,13500,5950,0.6940874035989717,254,135,119,146.2296731642302,0.4086504170696325,0.9064892100280928,0.1020640319757591,17686470.90200721,356807.37188583356,18043278.273893043,2835,2,1932.7078014184397,141,564,93,33.75822943166252,0.6426566193853428,37.59536384976525,134803.0367259301,956.0499058576604,0
2837,513.5593024315339,0,0,705,0.0,0.0,1.0,705,18000,12300,5700,0.6833333333333333,237,123,114,146.09916073636043,0.4087200965774769,0.9070393409011408,0.1023968708890503,17699230.186613165,358168.5351887695,18057398.721801933,2836,3,1933.7078014184397,101,604,101,33.62345054717077,0.6514026402640264,37.45915032679739,134830.29561795248,1334.9534219599254,0
2838,513.586594164484,0,0,705,0.0,0.0,1.0,705,20550,15400,5150,0.7493917274939172,257,154,103,143.42643898593656,0.40870951872447886,0.9041437437756306,0.10096727375834985,17719608.761953007,346742.0769901869,18066350.838943195,2837,4,1934.7078014184397,106,599,106,33.54743418695721,0.6516312893081762,37.31503115264799,134911.47848851595,1272.749797061471,0
2839,513.3434359279815,0,0,705,0.0,0.0,1.0,705,21100,15300,5800,0.7251184834123223,269,153,116,142.6353009965493,0.40872933121104665,0.903634886660587,0.10090153295277852,17732687.316309012,343761.43856788863,18076448.7548769,2838,5,1935.7078014184397,111,594,98,33.406792930186455,0.6521208708708709,37.15587797619049,134929.30471317683,1215.5793217403318,0
2840,513.1509284182871,0,0,705,0.0,0.0,1.0,705,20550,15700,4850,0.7639902676399026,254,157,97,143.44749460397367,0.4087156471631206,0.9028995457590001,0.1000077409376803,17661745.101986505,345156.6170427846,18006901.71902929,2839,6,1936.7078014184397,140,565,95,33.86938953652079,0.6424107142857143,37.63297872340422,134633.8805544232,961.6705753887371,8
2841,513.0030940418368,1,0,706,0.00141643059490085,0.0,1.0,706,20300,14400,5900,0.7093596059113301,262,144,118,145.19069897136296,0.4087037232368285,0.9048067954620511,0.10172753993515901,17678645.619264472,351854.9828656113,18030500.602130085,2840,0,1934.9631728045326,102,604,102,33.657963840415,0.6510416666666667,37.46966019417478,134678.87660024432,1320.3811431396502,0
2842,513.2282803218719,0,0,706,0.0,0.0,1.0,706,21000,16100,4900,0.7666666666666667,259,161,98,145.0666250945007,0.40857145607725737,0.9058161920516841,0.10210191651388156,17706383.853953604,351521.06966416625,18057904.92361777,2841,1,1935.9631728045326,104,602,104,33.510839187249836,0.6520432692307692,37.3214285714286,134814.071491693,1296.2891489585866,0
2843,513.152688217176,0,0,706,0.0,0.0,1.0,706,19350,14200,5150,0.7338501291989664,245,142,103,144.20588436864628,0.4085077920425398,0.9050400089894546,0.10201257817627836,17726098.219662752,350691.53403439163,18076789.753697142,2842,2,1936.9631728045326,111,595,98,33.365511069436096,0.6521208708708709,37.15587797619048,134879.16779860156,1215.1276378252392,0
2844,512.789741173979,0,0,706,0.0,0.0,1.0,706,19600,14400,5200,0.7346938775510204,248,144,104,145.2423962182013,0.40859841178952444,0.905191338040026,0.1032785581557212,17736215.81009826,354410.0968203633,18090625.906918623,2843,3,1937.9631728045326,119,587,78,33.16779569182696,0.6522233893557423,36.98784722222222,134869.93374852766,1133.3607878027535,0
2845,512.812409071333,1,0,707,0.0014144271570014145,0.0,1.0,707,19500,14200,5300,0.7282051282051282,248,142,106,142.3225747012273,0.40863446674493425,0.9026827051202475,0.10163435042266801,17755605.435505792,344504.69619205705,18100110.13169785,2844,0,1936.220650636492,132,575,82,33.10471789835012,0.6514362373737373,36.84993734335839,134946.61757822434,1022.3228604410934,0
2846,512.5070423462191,0,0,707,0.0,0.0,1.0,707,19500,14100,5400,0.7230769230769231,249,141,108,146.56640603042314,0.4084610024134749,0.905348818912886,0.10507263716789617,17761960.124057624,359761.33188775816,18121721.455945384,2845,1,1937.220650636492,136,571,86,32.86571747627028,0.6521139705882353,36.72445255474451,134930.57214324834,992.136559876826,0
2847,512.4393466578366,2,0,709,0.0028208744710860366,0.0,1.0,709,20600,14700,5900,0.7135922330097088,265,147,118,144.7136235503401,0.40883422448529666,0.9084437765796056,0.09792844718932336,17504171.83927775,344218.4268219465,17848390.2660997,2846,0,1932.75317348378,137,572,94,34.84224136271312,0.6328315085158152,38.62469806763287,133938.9889547184,977.6568536840759,8
2848,512.8042560755651,2,0,711,0.0028129395218002813,0.0,1.0,711,19550,13800,5750,0.7058823529411765,253,138,115,140.88635317111152,0.4091980150947881,0.9061652649717433,0.09580053981557891,17538410.077946935,332434.5272602806,17870844.605207216,2847,0,1928.3136427566808,104,607,104,34.77759233268845,0.6405248397435898,38.462301587301575,134117.64487023867,1289.5927391369103,0
2849,512.903768585623,1,1,711,0.0014044943820224719,0.0014044943820224719,0.9985955056179775,712,19750,13500,6250,0.6835443037974683,260,135,125,140.5239078192077,0.4095180174307432,0.9059783712480987,0.09603811369176407,17564505.319429953,331496.5852795097,17896001.904709462,2848,0,1926.6039325842696,108,604,108,34.61558943460528,0.6413001543209876,38.293195718654424,134230.40618040168,1242.8741313000155,0
2850,512.6308801875074,0,0,711,0.0,0.0,1.0,711,18300,13400,4900,0.73224043715847,232,134,98,142.10683315990354,0.4094327568788257,0.9068290912390538,0.0974626510609951,17570930.104810722,338889.846573729,17909819.95138445,2849,1,1930.2925457102672,110,601,101,34.454973118279526,0.6420454545454546,38.175675675675656,134219.23383287675,1220.1748530261523,0
2851,512.419375317785,1,1,711,0.0014044943820224719,0.0014044943820224719,0.9985955056179775,712,18300,13500,4800,0.7377049180327869,231,135,96,156.79672153478828,0.40963485286061196,0.9111173303966178,0.10598899147282126,17498551.499679234,388043.10135148966,17886594.601030722,2850,0,1928.5800561797753,138,574,92,34.563869851556696,0.6323218599033816,38.66157074340534,133914.87466620005,970.397642508696,8
2852,512.4467075726926,1,1,711,0.0014044943820224719,0.0014044943820224719,0.9985955056179775,712,20350,15100,5250,0.742014742014742,256,151,105,157.61654576911135,0.4096241528916913,0.9129157527194576,0.10692365672445316,17515546.345370993,389397.9824432422,17904944.327814236,2851,0,1929.5758426966293,148,564,98,34.420650730411744,0.6322494369369369,38.5416666666667,133983.46208411278,905.2936627304917,0
2853,512.6669273669188,0,0,711,0.0,0.0,1.0,711,19900,14300,5600,0.7185929648241206,255,143,112,158.13323457450306,0.40973435550008913,0.9106765572777147,0.10780498594508375,17545264.112898007,392797.8731273026,17938061.98602531,2852,1,1932.7510548523207,106,605,106,34.23902594825234,0.6409198113207547,38.37616822429907,134125.88596240853,1265.3385468151748,0
2854,512.8021667543965,0,0,711,0.0,0.0,1.0,711,18150,11800,6350,0.650137741046832,245,118,127,152.00804127284277,0.4097752124561716,0.9127935932060474,0.09895918142095397,17339906.1854076,366811.0350197342,17706717.220427334,2853,2,1933.7510548523207,111,600,81,35.993027490671544,0.6239677177177176,39.94605654761906,133356.22567540684,1201.4074385171787,8
2855,512.2967376982333,1,0,712,0.0014044943820224719,0.0,1.0,712,16600,12000,4600,0.7228915662650602,212,120,92,153.2226054707429,0.41014470637968364,0.9129894678325263,0.10003879181007547,17336146.23885566,372257.89910785883,17708404.13796352,2854,0,1932.0337078651685,114,598,85,35.85986734445182,0.624360380116959,39.84601449275363,133276.03807455624,1169.088053285581,0
2856,511.88287411950864,1,0,713,0.001402524544179523,0.0,1.0,713,17000,12000,5000,0.7058823529411765,220,120,100,166.05839981850917,0.41046241615056916,0.9193489490906781,0.10834686669314547,17319066.91320597,415595.30759133794,17734662.220797308,2855,0,1930.3225806451612,112,601,78,35.549408200148825,0.6245349702380952,39.869100294985266,133156.55258829752,1188.8977909669422,7
2857,512.0411080079659,0,0,713,0.0,0.0,1.0,713,19700,14100,5600,0.7157360406091371,253,141,112,167.04999893784702,0.41055352115080557,0.916922844444902,0.10802118103982478,17283032.069153666,415126.0977589803,17698158.166912645,2856,1,1931.3225806451612,102,611,74,35.83972337913411,0.623672385620915,40.18001618122978,133038.51239717525,1304.299141148777,8
2858,512.1241928135877,1,1,713,0.0014005602240896359,0.0014005602240896359,0.9985994397759104,714,21000,15200,5800,0.7238095238095238,268,152,116,168.28130155685304,0.41096031680554407,0.9182645200674893,0.10949149247637484,17314378.947590437,418937.24498982186,17733316.19258026,2857,0,1929.6162464985994,108,606,78,35.589703540365065,0.6244212962962963,39.96559633027524,133169.90908312114,1233.0547137326032,0
2859,512.5462524477085,0,0,713,0.0,0.0,1.0,713,18900,13200,5700,0.6984126984126984,246,132,114,168.6304824485457,0.4109958318231243,0.9186399826472302,0.11023695174942155,17350375.031257354,423660.42243682814,17774035.453694183,2858,1,1933.3183730715286,113,600,83,35.414910802078914,0.625,39.80263157894738,133363.18608096679,1180.2051865572282,0
2860,512.352099208181,0,0,713,0.0,0.0,1.0,713,20300,14700,5600,0.7241379310344828,259,147,112,168.20754436375051,0.4111026134495275,0.9194426011343726,0.11052772604525007,17367446.481190562,421367.1048939842,17788813.586084545,2859,2,1934.3183730715286,123,590,89,35.24563773726944,0.6249153116531165,39.625336021505376,133403.50567000645,1084.5813469106215,0
2861,512.8112533949321,1,0,714,0.0014005602240896359,0.0,1.0,714,19400,13400,6000,0.6907216494845361,254,134,120,168.08098122097007,0.41162720347606085,0.9190417475180994,0.11086251948494713,17400335.8433778,422733.10442587,17823068.94780367,2860,0,1932.6078431372548,94,620,94,35.11703075455283,0.6327570921985816,39.49561403508771,133589.5806815435,1421.165751931314,0
2862,513.0112391826866,0,0,714,0.0,0.0,1.0,714,18100,12200,5900,0.6740331491712708,240,122,118,166.00509379465004,0.4116362066098061,0.9182281533795349,0.1099273806356636,17425234.101274382,417635.5242751594,17842869.62554954,2861,1,1933.6078431372548,97,617,97,35.03336425920636,0.6332689003436427,39.36011904761905,133711.18830780912,1378.4658588433929,0
2863,513.2555710827378,2,0,716,0.002793296089385475,0.0,1.0,716,19350,14000,5350,0.7235142118863049,247,140,107,162.59518956461025,0.41224553495852384,0.9161122860824826,0.10815542366585276,17454109.8274595,405040.8592154641,17859150.686674964,2862,0,1929.203910614525,104,612,93,34.96596989754515,0.6330128205128205,39.20634920634922,133853.79417284825,1287.055713200464,0
2864,513.5611919904162,0,1,715,0.0,0.0013966480446927375,0.9986033519553073,716,18950,13700,5250,0.7229551451187335,242,137,105,169.18194895625956,0.4122203448320767,0.9186970746367207,0.11296498744209452,17481817.68727562,429371.5975262608,17911189.284801878,2863,1,1930.203910614525,106,610,73,34.662758376240575,0.6338443396226415,39.07710280373832,133999.8741017052,1264.1497556764643,0
2865,513.8029146113951,0,0,715,0.0,0.0,1.0,715,22150,16100,6050,0.7268623024830699,282,161,121,158.73557025106783,0.41220715558950854,0.9146796356821563,0.10634985391492759,17505482.01007368,390598.5338777722,17896080.54395145,2864,2,1933.902097902098,113,602,79,34.81838653971812,0.6334808259587021,38.96198830409357,134122.09123372048,1186.9211613603582,8
2866,513.3157560201946,0,1,714,0.0,0.0013986013986013986,0.9986013986013986,715,20450,14900,5550,0.7286063569682152,260,149,111,148.37502549094702,0.4121384334619629,0.9115599269877692,0.10027190119676356,17528065.96305926,356695.4468151847,17884761.409874447,2865,3,1934.902097902098,121,594,90,34.79225204473922,0.6349001377410468,38.669740437158474,134144.93975845398,1108.635865772347,7
2867,513.1302166212045,1,0,715,0.0013986013986013986,0.0,1.0,715,20150,15000,5150,0.7444168734491315,253,150,103,147.54346172436908,0.4124016506369448,0.9107798113626595,0.0999514812825772,17532651.836069874,354215.6290203786,17886867.465090252,2866,0,1935.716083916084,133,582,95,34.731349867174224,0.6337719298245614,38.58830845771146,134138.2379084114,1008.5581797624917,0
2868,512.953033601165,0,0,715,0.0,0.0,1.0,715,19350,13600,5750,0.7028423772609819,251,136,115,141.72942439832516,0.41242099403864113,0.9061225713600369,0.09490362517131753,17474018.618639827,332966.52014909213,17806985.13878892,2867,1,1936.716083916084,120,595,81,35.28130496921727,0.6319444444444444,38.980716253443546,133890.63342620071,1115.7552785516725,8
2869,512.9225202088828,0,1,714,0.0,0.0013986013986013986,0.9986013986013986,715,19200,13400,5800,0.6979166666666666,250,134,116,141.52433261588692,0.4126598075127487,0.906316639265897,0.09518618675044746,17493026.84307804,332937.78987968655,17825964.632957727,2868,2,1937.716083916084,125,590,87,35.13484193810476,0.6325833333333333,38.83101851851853,133959.4521818695,1071.675617454956,0
2870,512.702349185919,0,0,714,0.0,0.0,1.0,714,20750,14900,5850,0.7180722891566265,266,149,117,142.0550997644299,0.412345039698909,0.9064663484244464,0.09594810547710843,17504637.308067042,333774.59982752864,17838411.90789457,2869,7,1941.4271708683473,134,580,93,34.97620524026065,0.6326181592039801,38.688271604938286,133975.13701798196,999.8144553580744,0
2871,512.7928418131803,1,0,715,0.0013986013986013986,0.0,1.0,715,17400,11800,5600,0.6781609195402298,230,118,112,143.4500301668328,0.4125846375846376,0.9084002929566128,0.09722535752466474,17523299.855261117,342343.5785719355,17865643.43383305,2870,0,1939.7104895104894,136,579,98,34.821895995113856,0.6335018382352942,38.57208029197081,134058.36587638903,985.7232785028605,0
2872,512.3876483916425,0,0,715,0.0,0.0,1.0,715,19300,14300,5000,0.7409326424870466,243,143,100,143.9404224564277,0.4125959824489236,0.9061046532307966,0.09370426177130432,17325751.95181811,336475.2110639993,17662227.16288211,2871,1,1940.7104895104894,125,590,82,36.20387737368601,0.6213333333333333,39.947089947089964,133247.89903941497,1065.9831923153197,8
2873,512.24678031805,0,0,715,0.0,0.0,1.0,715,19600,13900,5700,0.7091836734693877,253,139,114,145.14468038275118,0.4127229796347443,0.9072429632973189,0.09479258761605647,17335809.11216666,340640.09455236275,17676449.206719026,2872,2,1941.7104895104894,131,584,86,36.059714470597726,0.621501272264631,39.83585858585858,133268.24379360347,1017.3148381191105,0
2874,512.5826435682774,0,0,715,0.0,0.0,1.0,715,20200,14100,6100,0.698019801980198,263,141,122,146.1415600210001,0.41281651355180765,0.9086032257914076,0.0957878618932543,17363742.88319497,344312.89455072646,17708055.777745698,2873,3,1942.7104895104894,137,578,92,35.90776010401263,0.6218826034063261,39.71165458937197,133419.28818059157,973.8634173765807,0
2875,512.3935734849683,2,0,717,0.002789400278940028,0.0,1.0,717,19550,14700,4850,0.7519181585677749,244,147,97,148.44666094941448,0.4130482703900226,0.9108408433747497,0.09758122006501553,17370648.674788106,352772.95885951596,17723421.63364762,2874,0,1938.2887029288702,145,572,97,35.74649733304098,0.6218390804597701,39.611872146118664,133421.20332410678,920.1462298214261,0
2876,512.8460330028857,0,0,717,0.0,0.0,1.0,717,20950,15800,5150,0.7541766109785203,261,158,103,146.42057278257366,0.41305938968233563,0.9090696959759894,0.09671636937611347,17408177.734152436,345433.0709870941,17753610.80513953,2875,1,1939.2887029288702,105,612,105,35.630704533454086,0.6303571428571428,39.445754716981156,133624.21107545838,1272.6115340519846,0
2877,512.8876250494651,0,0,717,0.0,0.0,1.0,717,16850,11600,5250,0.6884272997032641,221,116,105,144.8476439884835,0.41305784759070097,0.907101529041128,0.09606687082538332,17428165.768043388,344635.7501083689,17772801.518151756,2876,2,1940.2887029288702,112,605,112,35.53070485619991,0.6302083333333333,39.30678466076698,133706.32408184913,1193.8064650165102,0
2878,512.5482752454747,0,0,717,0.0,0.0,1.0,717,21050,15500,5550,0.7363420427553444,266,155,111,143.36017659068878,0.41305663014993677,0.9054169760703268,0.0954915802051785,17436305.946656737,335484.3799204038,17771790.326577142,2877,3,1941.2887029288702,117,600,77,35.42019200397095,0.6306980056980057,39.159604519774035,133693.29481773893,1142.6777334849482,0
2879,512.8493924839229,0,1,716,0.0,0.001394700139470014,0.99860529986053,717,19200,13100,6100,0.6822916666666666,253,131,122,143.36725394378232,0.4130970491833083,0.9063641960743749,0.09575699020412787,17458956.17960549,338008.5208389755,17796964.700444467,2878,4,1942.2887029288702,118,599,80,35.325950216377564,0.631444209039548,39.06687675070029,133819.39373733648,1134.0626587909871,0
2880,512.7831260679669,0,0,716,0.0,0.0,1.0,716,18700,13100,5600,0.7005347593582888,243,131,112,144.25839297659735,0.4131227129481319,0.906945452568336,0.09668982308118397,17472586.99664651,342213.46425600816,17814800.460902516,2879,5,1945.953910614525,122,594,83,35.18227899432283,0.6319159836065573,38.948170731707336,133862.97307795752,1097.2374842455533,0
2881,512.8611173905662,0,1,715,0.0,0.0013966480446927375,0.9986033519553073,716,20950,15500,5450,0.7398568019093079,264,155,109,144.08701377322433,0.41319441731452905,0.9073966692792073,0.09701617119948039,17495898.787675947,340036.36191896594,17835935.149594914,2880,6,1946.953910614525,127,589,89,35.030305272559254,0.6326279527559056,38.79394531250002,133962.429076214,1054.8222761906613,0
2882,512.6436917252571,0,0,715,0.0,0.0,1.0,715,19250,13800,5450,0.7168831168831169,247,138,109,146.0264263307011,0.41289992687051513,0.9081860385982261,0.09867563860670844,17504701.972390153,348979.8146024259,17853681.78699258,2881,7,1950.662937062937,134,581,95,34.856772371166514,0.632773631840796,38.672839506172856,133967.72030363552,999.7591067435486,0
2883,512.3773561353509,0,0,715,0.0,0.0,1.0,715,19000,13400,5600,0.7052631578947368,246,134,112,148.6129136547441,0.4128713606654783,0.9094398224418709,0.10070262255145365,17508120.203576364,358386.55121420027,17866506.754790563,2882,8,1951.662937062937,137,578,100,34.6943606290725,0.6332877128953771,38.5794082125604,133945.99165938827,977.7079683167027,0
2884,512.0691386513081,0,0,715,0.0,0.0,1.0,715,19150,12900,6250,0.6736292428198434,254,129,125,144.20746148191643,0.4127194700724113,0.9071452235011466,0.09822556901091378,17520893.24006059,343178.7074089581,17864071.947469547,2883,9,1952.662937062937,106,609,106,34.63298413407268,0.640625,38.405373831775684,133954.5348977726,1263.7220273374774,0
2885,512.1758149602183,1,0,716,0.0013966480446927375,0.0,1.0,716,19150,13700,5450,0.7154046997389034,246,137,109,144.27165105000208,0.413016295854983,0.9074444140503815,0.09865587284160758,17542138.401391502,343816.654023276,17885955.055414777,2884,0,1950.9343575418995,108,608,108,34.498119545769896,0.6414930555555556,38.27408256880732,134049.68505653096,1241.2007875604718,0
2886,511.77678297628694,0,1,715,0.0,0.0013966480446927375,0.9986033519553073,716,19750,13900,5850,0.7037974683544304,256,139,117,165.2647788391643,0.4130282601476736,0.9183403839182416,0.11184720084871781,17482009.81317204,414882.0970876018,17896891.91025964,2885,1,1951.9343575418995,130,586,87,34.30151197103833,0.6338942307692308,38.62118320610689,133767.60999692834,1028.9816153609872,8
2887,512.2294268802656,0,0,715,0.0,0.0,1.0,715,18650,12700,5950,0.6809651474530831,246,127,119,161.6106994996178,0.41287005478181954,0.9190969773102362,0.10580926929503236,17346665.548469707,399031.3506548202,17745696.89912453,2886,12,1955.662937062937,124,591,79,35.54408154552248,0.6234879032258065,39.74999999999999,133307.70834558853,1075.0621640773268,8
2888,512.2084906041856,0,0,715,0.0,0.0,1.0,715,18850,13500,5350,0.7161803713527851,242,135,107,160.88497464688007,0.4129798306268895,0.9194699530637511,0.10569515151647403,17361668.24095118,396796.3109545948,17758464.551905774,2887,13,1956.662937062937,127,588,85,35.443234148069415,0.6241797900262467,39.632161458333336,133362.61758130154,1050.0993510338703,0
2889,512.6565109224972,0,0,715,0.0,0.0,1.0,715,19550,13700,5850,0.7007672634271099,254,137,117,160.7084743026496,0.41331160669395967,0.9195440720984924,0.10608644447368457,17398827.679591093,396677.81020835956,17795505.48979945,2888,14,1957.662937062937,89,626,89,35.28061602250851,0.6345973782771536,39.467592592592595,133563.63496372016,1500.7149995923614,0
2890,512.2135846494318,1,0,716,0.0013966480446927375,0.0,1.0,716,17750,12700,5050,0.7154929577464789,228,127,101,158.1247848924485,0.41360787722519565,0.9179544726677,0.10487205176506759,17405236.433346935,389489.85340503935,17794726.286751974,2889,0,1955.927374301676,97,619,97,35.18476990404737,0.6338058419243986,39.30697278911565,133530.50996079913,1376.603195472156,0
2891,512.6687870903521,0,0,716,0.0,0.0,1.0,716,18800,12900,5900,0.6861702127659575,247,129,118,157.17779976986208,0.41362378892057666,0.9171397432173407,0.10466750926580246,17439190.780403055,386210.7273261258,17825401.50772918,2890,1,1956.927374301676,102,614,88,35.069000168017276,0.6338848039215687,39.16868932038836,133720.07168130387,1310.9810949147438,0
2892,512.9670724962403,1,2,715,0.001394700139470014,0.002789400278940028,0.99721059972106,717,20450,14900,5550,0.7286063569682152,260,149,111,157.4052881147974,0.4139461735349805,0.9166661494542812,0.10536107157641657,17472803.597370643,386212.3368834853,17859015.93425413,2891,0,1955.1966527196653,112,605,70,34.88498033952584,0.6333705357142857,38.993362831858434,133887.81057023152,1195.4268800913528,0
2893,513.2093575938076,0,0,715,0.0,0.0,1.0,715,21100,15500,5600,0.7345971563981043,267,155,112,160.88375380409042,0.4137503836033248,0.9180581479442147,0.10803134060774705,17495447.88280551,398846.66597392317,17894294.548779435,2892,1,1961.639160839161,117,598,72,34.68504541510309,0.6334579772079771,38.88594632768365,134006.17574388644,1145.351929434927,0
2894,512.8598306527127,0,0,715,0.0,0.0,1.0,715,21050,15800,5250,0.7505938242280285,263,158,105,162.9901597893709,0.4138366535425359,0.9202722276625579,0.10805749370839347,17425447.121583764,403985.2821496301,17829432.403733395,2893,2,1962.639160839161,90,625,90,35.071228355215965,0.6357638888888889,39.32005494505492,133692.2724754365,1485.4696941715167,8
2895,512.5734511932827,1,1,715,0.0013966480446927375,0.0013966480446927375,0.9986033519553073,716,19900,14500,5400,0.7286432160804021,253,145,108,162.60643609781425,0.4142436125327187,0.9196982273532259,0.10837874494670147,17439990.22467625,404070.93120305944,17844061.15587931,2894,0,1960.8966480446927,95,621,72,34.896678244110745,0.6360745614035088,39.138454861111086,133710.70247545137,1407.4810786889618,0
2896,512.113098461068,0,0,715,0.0,0.0,1.0,715,20750,15300,5450,0.7373493975903614,262,153,109,162.23834781531778,0.41424229365405835,0.919464733911687,0.10866114828840129,17446428.686182793,402345.95306480926,17848774.639247604,2895,4,1964.639160839161,98,617,77,34.738206089433504,0.6369047619047619,38.97306397306396,133675.31299055245,1364.0338060260456,0
2897,512.5385802188861,0,0,715,0.0,0.0,1.0,715,18500,12800,5700,0.6918918918918919,242,128,114,161.99615431246468,0.41423543776484956,0.9193742617145806,0.1087147053778237,17469931.41055606,404512.34092251875,17874443.75147858,2896,5,1965.639160839161,102,613,77,34.67611780351447,0.6365400326797386,38.90574433656956,133820.87910104063,1311.9694029513787,0
2898,512.3642509676711,0,0,715,0.0,0.0,1.0,715,21000,14200,6800,0.6761904761904762,278,142,136,166.3011222872578,0.4144194041252865,0.9210786602998899,0.11193063823638652,17477225.76902668,417296.45197138085,17894522.220998064,2897,6,1966.639160839161,109,606,77,34.46314625480382,0.635894495412844,38.806818181818166,133826.0489601347,1227.761917065456,0
2899,512.0505683256334,0,0,715,0.0,0.0,1.0,715,19850,15000,4850,0.7556675062972292,247,150,97,164.456509904176,0.41450493950493955,0.9209266359598505,0.11120987901951382,17487705.730266757,412343.41012618796,17900049.140392944,2898,7,1967.639160839161,116,599,82,34.35040878896276,0.6360452586206897,38.64850427350428,133825.18191950687,1153.665361375059,0
2900,512.3204709555034,1,0,716,0.0013966480446927375,0.0,1.0,716,19950,14200,5750,0.7117794486215538,257,142,115,167.94426037608088,0.41506544549491475,0.9188935698479164,0.1110562963855859,17395392.113457188,421141.25248929847,17816533.365946487,2899,0,1965.8896648044692,94,622,94,35.03139989901538,0.6336436170212766,39.40789473684212,133506.67009570778,1420.2837244224233,8
2901,512.6249473853502,1,0,717,0.001394700139470014,0.0,1.0,717,20100,15600,4500,0.7761194029850746,246,156,90,164.02453187139642,0.41568167592570954,0.9167432730325158,0.10901099419063673,17428685.797061082,408246.40579932404,17836932.202860408,2900,0,1964.1464435146443,101,616,91,34.958943630714614,0.633457095709571,39.23611111111113,133674.0748216669,1323.5056913036326,0
2902,512.5018102789805,0,1,716,0.0,0.001394700139470014,0.99860529986053,717,19000,13200,5800,0.6947368421052632,248,132,116,163.15775041270896,0.4156095222697511,0.9166762926242773,0.10892636236378844,17445080.463500857,406860.0168387038,17851940.48033956,2901,1,1965.1464435146443,105,612,74,34.825077209897906,0.6340277777777779,39.08215408805033,133720.86836396725,1273.532079656831,0
2903,512.9188689421277,0,0,716,0.0,0.0,1.0,716,20250,14700,5550,0.725925925925926,258,147,111,163.06910317064506,0.41521915003060256,0.9162374853061588,0.10937113652093147,17480256.232511625,406647.94140575116,17886904.173917376,2902,3,1968.8896648044692,113,603,78,34.66811913761723,0.6338495575221239,38.92543859649123,133910.06874465017,1185.0448561473465,0
2904,512.8413765401939,1,0,717,0.001394700139470014,0.0,1.0,717,20100,14600,5500,0.7263681592039801,256,146,110,161.74444323628285,0.41530256487173695,0.9155726742000667,0.10867477996902776,17485635.194858633,402140.865845038,17887776.060703672,2903,0,1967.142259414226,118,599,80,34.64184153481721,0.6334745762711864,38.86554621848742,133920.5527393839,1134.919938469355,0
2905,512.9753361997792,0,0,717,0.0,0.0,1.0,717,18350,13000,5350,0.7084468664850136,237,130,107,159.61211908249933,0.41528584535190854,0.9146328087411784,0.10751151852069663,17501565.044550937,396942.3768042012,17898507.42135514,2904,1,1968.142259414226,121,596,85,34.611361704909484,0.6337809917355373,38.78073770491806,133999.03889767968,1107.4300735345428,0
2906,512.7286292808656,1,0,718,0.001392757660167131,0.0,1.0,718,18350,13200,5150,0.7193460490463215,235,132,103,160.71948192059133,0.41556058657695005,0.9164556245241007,0.10874097388807963,17513276.98374,400994.960711705,17914271.944451705,2905,0,1966.399721448468,128,590,89,34.42977374773438,0.6341145833333333,38.630490956072364,134011.63010790668,1046.965860218021,0
2907,513.1859671736293,0,0,718,0.0,0.0,1.0,718,18850,13900,4950,0.7374005305039788,238,139,99,162.6298489228221,0.4155804565214858,0.9184882284811646,0.11027352981799193,17538728.389333278,408014.14965114114,17946742.538984418,2906,1,1967.399721448468,133,585,90,34.30537385030135,0.6340852130325815,38.557213930348276,134168.76902972365,1008.7877370655914,0
2908,513.1755679465308,0,0,718,0.0,0.0,1.0,718,19450,13900,5550,0.7146529562982005,250,139,111,162.16478866213876,0.41546321980189305,0.9183396988093713,0.1103730585807692,17555330.68741024,406321.2981635606,17961651.9855738,2907,2,1968.399721448468,93,625,93,34.18912048805284,0.6438172043010753,38.43085106382975,134230.89656260802,1443.3429737914842,0
2909,512.662316693411,0,1,717,0.0,0.001392757660167131,0.9986072423398329,718,22400,17100,5300,0.7633928571428571,277,171,106,160.47636698689743,0.415555689910374,0.917814824559195,0.10964218184107521,17554927.878159095,397430.2097207891,17952358.087879885,2908,3,1969.399721448468,95,623,95,34.10333222765845,0.6445175438596491,38.30295138888886,134162.2152127989,1412.2338443452518,0
2910,512.9154445154686,0,0,717,0.0,0.0,1.0,717,20000,14500,5500,0.725,255,145,110,155.6795817705157,0.4152577630516143,0.9143961244639707,0.10688981745526624,17585642.00925754,384145.07863343833,17969787.08789098,2909,4,1973.0794979079499,105,612,87,34.06211299583446,0.6435515873015873,38.13875786163519,134312.67541277045,1279.1683372644804,0
2911,512.597126357571,0,0,717,0.0,0.0,1.0,717,19000,13000,6000,0.6842105263157895,250,130,120,152.68043784768795,0.41543486010144687,0.912690004583568,0.10521770231889527,17591179.722499844,374765.80445772276,17965945.526957568,2910,5,1974.0794979079499,112,605,75,34.01624442880596,0.6432291666666667,38.01622418879053,134292.1306331304,1199.03688065295,0
2912,512.0913060672883,0,0,717,0.0,0.0,1.0,717,22950,16700,6250,0.7276688453159041,292,167,125,155.37892111365113,0.4154472779972418,0.9128471675986687,0.10435260830586615,17458100.459312394,376174.16281234054,17834274.622124735,2911,6,1975.0794979079499,119,598,76,34.8229571822745,0.6331407563025211,38.880208333333336,133717.17515460175,1123.6737407949727,8
2913,512.4360564784585,1,0,718,0.001392757660167131,0.0,1.0,718,20850,15800,5050,0.7577937649880095,259,158,101,154.72480371735364,0.41566175737397515,0.9131603257995136,0.10429402298353999,17486395.36968168,376665.8182596056,17863061.187941283,2912,0,1973.3272980501392,125,593,81,34.71453059071733,0.6333333333333333,38.756613756613746,133870.53062763897,1070.9642450211118,0
2914,512.0505096223727,0,0,718,0.0,0.0,1.0,718,21250,16000,5250,0.7529411764705882,265,160,105,156.95058075435344,0.41579356268833956,0.915293094478157,0.1061145925655866,17486872.48177398,384064.95831834787,17870937.44009233,2913,1,1974.3272980501392,128,590,84,34.552886348421666,0.6338704427083333,38.654715762273895,133821.98598133103,1045.4842654791487,0
2915,512.5274281000056,1,0,719,0.0013908205841446453,0.0,1.0,719,20150,14300,5850,0.7096774193548387,260,143,117,155.30981678750982,0.415957616130936,0.9151659747605214,0.10531079233660863,17516252.685657002,380139.1990826252,17896391.884739626,2914,0,1972.5799721835883,135,584,90,34.49651862268315,0.6337962962962963,38.55698529411765,133996.71592191822,992.5682660882832,0
2916,512.7463539571116,0,0,719,0.0,0.0,1.0,719,19400,14300,5100,0.7371134020618557,245,143,102,150.15243966883318,0.415830979785966,0.9117719669169195,0.1021833859339214,17540040.99116268,363535.98934287555,17903576.980505556,2915,1,1973.5799721835883,97,622,97,34.50791747941049,0.6426116838487972,38.43537414965983,134116.30822891617,1382.6423528754244,0
2917,512.5280854106934,1,0,720,0.001388888888888889,0.0,1.0,720,18400,12600,5800,0.6847826086956522,242,126,116,149.37254028365777,0.4161499381857518,0.9111290768380327,0.1021220428469892,17553242.305058066,361994.47866421094,17915236.783722278,2916,0,1971.8375,103,617,103,34.37189054726368,0.6425970873786409,38.281249999999964,134138.20985357804,1302.3127170250295,0
2918,512.9317620403777,0,1,719,0.0,0.001388888888888889,0.9986111111111111,720,21100,15700,5400,0.7440758293838863,265,157,108,150.1355220659608,0.41628262150363154,0.9107389768792227,0.10310810966544873,17587279.23080254,362995.0698072664,17950274.300609805,2917,1,1972.8375,108,612,93,34.199146047733734,0.6429398148148149,38.130733944954095,134321.06406183325,1243.7135561280857,0
2919,513.3040449347419,0,1,718,0.0,0.0013908205841446453,0.9986091794158554,719,16600,11700,4900,0.7048192771084337,215,117,98,148.49949918309562,0.41618611039008835,0.9101776982517122,0.1024235676183786,17619236.910642486,362889.5714437362,17982126.482086223,2918,2,1976.4881780250348,110,609,78,34.09712273161413,0.6439393939393939,37.98798798798795,134491.82558725378,1222.6529598841253,8
2920,513.0766906290892,0,0,718,0.0,0.0,1.0,718,18550,12800,5750,0.6900269541778976,243,128,115,150.06520236096688,0.4158558029626694,0.9110375157747668,0.1040002356771785,17632756.58752578,367062.63709773635,17999819.224623516,2919,5,1980.2381615598886,116,602,81,33.89514777962668,0.6443067528735632,37.829415954415914,134513.6156424013,1159.600134848287,0
2921,512.9756083346159,0,0,718,0.0,0.0,1.0,718,19000,13500,5500,0.7105263157894737,245,135,110,154.05443077229813,0.4159340686912481,0.9124532173569051,0.10723184376666157,17648658.84054537,381170.8183149336,18029829.658860303,2920,6,1981.2381615598886,117,601,88,33.64430843008577,0.6455662393162394,37.68538135593217,134561.00107400166,1150.0940262735185,0
2922,513.3447760228913,0,0,718,0.0,0.0,1.0,718,19450,14000,5450,0.7197943444730077,249,140,109,158.11582658361004,0.41591359172193015,0.9154090157891197,0.1104224024096155,17675978.256912444,395920.3825531168,18071898.63946556,2921,7,1982.2381615598886,121,597,89,33.42751884388044,0.6459194214876033,37.57684426229505,134713.55610539028,1113.335174424713,0
2923,513.3294147442473,0,0,718,0.0,0.0,1.0,718,19350,14200,5150,0.7338501291989664,245,142,103,157.36327584899982,0.4158576645053347,0.9158967717363931,0.1103081936085789,17691972.855154447,393863.36094374396,18085836.21609819,2922,8,1983.2381615598886,90,628,90,33.32270593535638,0.6546296296296297,37.45421245421249,134772.47546444827,1497.4719496049809,0
2924,513.709879882763,0,0,718,0.0,0.0,1.0,718,19650,14600,5050,0.7430025445292621,247,146,101,155.23305390538295,0.41593690147356477,0.9147423587285566,0.10921021457572673,17721096.739768207,386929.99309339654,18108026.732861605,2923,9,1984.2381615598886,94,624,94,33.25810547554439,0.6545877659574468,37.33552631578951,134933.33522578672,1435.4610130402843,0
2925,513.539995654359,0,0,718,0.0,0.0,1.0,718,21350,15500,5850,0.7259953161592506,272,155,117,154.9150281847662,0.41573375051313827,0.9145372709235233,0.10937018868093634,17730716.323425125,384400.88379590365,18115117.207221027,2924,10,1985.2381615598886,96,622,91,33.14994551151071,0.6551649305555556,37.220790378006896,134947.63416733532,1405.7045225764095,0
2926,513.7340777145084,1,1,718,0.0013908205841446453,0.0013908205841446453,0.9986091794158554,719,19950,14000,5950,0.7017543859649122,259,140,119,154.54812309331655,0.4158999074077661,0.9143920287240921,0.10962017777148615,17757872.70640499,385139.17938099185,18143011.885785982,2925,0,1983.4756606397775,103,616,74,33.005766446992524,0.6548341423948221,37.06931089743593,135076.4550689478,1311.4218938732797,0
2927,513.7744645813215,0,1,717,0.0,0.001392757660167131,0.9986072423398329,718,19650,12900,6750,0.6564885496183206,264,129,135,153.1374855167853,0.4157194651965983,0.9133866214525044,0.1091952373416907,17782426.837724686,381381.2264630797,18163808.064187765,2926,12,1987.2381615598886,108,610,79,32.86885692492101,0.6553819444444444,36.89793577981655,135175.12217496723,1251.621501620067,0
2928,513.5100072127649,0,0,717,0.0,0.0,1.0,717,20100,14400,5700,0.7164179104477612,258,144,114,133.86951570018334,0.415827931142849,0.9014850849900122,0.08986237886994937,17504219.86451181,305156.28719434846,17809376.15170616,2927,13,1990.771269177127,128,589,88,35.401590124220434,0.6314290364583333,38.89696382428942,134079.021989865,1047.4923592958203,8
2929,513.1331787559144,0,0,717,0.0,0.0,1.0,717,17550,12900,4650,0.7350427350427351,222,129,93,137.58994770467223,0.4159826272826203,0.9043735110075533,0.0926512509573638,17505652.09748957,320770.35132596106,17826422.448815532,2928,14,1991.771269177127,133,584,89,35.19644168005871,0.6317355889724311,38.79042288557216,134035.30062621622,1007.7842152347084,0
2930,512.8325941928596,0,0,717,0.0,0.0,1.0,717,19800,14400,5400,0.7272727272727273,252,144,108,140.78644683694765,0.41600283679930605,0.9068925864908051,0.09510312671841284,17509649.490107607,329824.26741453534,17839473.757522143,2929,15,1992.771269177127,138,579,92,35.00507838638757,0.6320954106280193,38.68405275779381,134011.33512818808,971.0966313636817,0
2931,512.6772235911245,0,0,717,0.0,0.0,1.0,717,21250,14700,6550,0.691764705882353,278,147,131,146.0132024886114,0.41603570769993947,0.9109978275966959,0.09855891167981251,17500911.883357756,346422.8381120106,17847334.721469767,2930,16,1993.771269177127,123,594,84,34.89449374142658,0.6341463414634146,38.70967741935483,133957.59713187418,1089.0861555436925,7
2932,512.4929031628894,1,1,717,0.001392757660167131,0.001392757660167131,0.9986072423398329,718,19750,14100,5650,0.7139240506329114,254,141,113,146.72944374811195,0.4160991794319932,0.9119511539715479,0.09939469099095208,17510633.89078243,350515.1140942652,17861149.004876696,2931,0,1991.993036211699,128,590,90,34.75446359620671,0.634521484375,38.590116279069754,133970.71022361203,1046.646173621969,0
2933,512.5496299764465,0,0,717,0.0,0.0,1.0,717,19500,13900,5600,0.7128205128205128,251,139,112,148.1779945606128,0.416097959504349,0.9130547088725247,0.10075335204912174,17529461.1069878,356596.0785123413,17886057.18550014,2932,1,1995.1464435146443,93,624,93,34.58870916486591,0.643481182795699,38.46409574468085,134050.13095161892,1441.3992575442894,0
2934,512.8744530685518,0,0,717,0.0,0.0,1.0,717,18200,13200,5000,0.7252747252747253,232,132,100,145.5988828708983,0.416276436320381,0.9089953496318159,0.09369952204032607,17288886.26472621,341848.5052452366,17630734.769971445,2933,2,1996.1464435146443,104,613,99,36.56670678434521,0.621494391025641,40.34722222222225,133169.27639050945,1280.4738114472061,8
2935,513.0280358747287,1,0,718,0.001392757660167131,0.0,1.0,718,19000,13600,5400,0.7157894736842105,244,136,108,144.85936825350052,0.416671077713417,0.9078371378849843,0.09364028520313433,17314781.30920434,339041.65637977095,17653822.96558411,2934,0,1994.3649025069637,112,606,76,36.42817437789762,0.6212797619047619,40.19174041297935,133288.92111996075,1190.0796528567923,0
2936,513.1143853849771,0,1,717,0.0,0.001392757660167131,0.9986072423398329,718,18700,13300,5400,0.7112299465240641,241,133,108,145.8316054046757,0.416720489530684,0.9079519128175668,0.09467199408310852,17337476.35600754,343370.4021324337,17680846.75813997,2935,1,1995.3649025069637,119,599,79,36.252413986932496,0.6214110644257703,40.043402777777764,133387.46961044968,1120.9031059701654,0
2937,513.044922017141,0,0,717,0.0,0.0,1.0,717,20450,15600,4850,0.7628361858190709,253,156,97,149.35039650987164,0.4166398018071366,0.9078167642541082,0.09729525830885656,17351260.345976487,354433.52252351184,17705693.868499998,2936,2,1999.142259414226,128,589,84,36.0382125558867,0.62109375,39.92248062015501,133431.45064864182,1042.4332081925143,0
2938,513.0285636478065,1,0,718,0.001392757660167131,0.0,1.0,718,20650,15200,5450,0.7360774818401937,261,152,109,148.9031502214784,0.4168998451196502,0.9091347956029368,0.0975025112370445,17374346.473738506,353168.98459581105,17727515.45833432,2937,0,1997.356545961003,134,584,92,35.87009694921281,0.6219682835820896,39.74537037037034,133518.05882157845,996.4034240416303,0
2939,512.5678855262163,0,0,718,0.0,0.0,1.0,718,20450,14900,5550,0.7286063569682152,260,149,111,151.8593322100711,0.41680106195343486,0.9121955319072501,0.09986481242669441,17378408.916054025,363764.7145730878,17742173.630627114,2938,1,1998.356545961003,141,577,98,35.64355738351451,0.6224881796690307,39.59800469483563,133473.70012037212,946.6219866693058,0
2940,512.0985540571554,0,0,718,0.0,0.0,1.0,718,20050,14400,5650,0.7182044887780549,257,144,113,148.95454384401083,0.4168245335783447,0.9098491434824021,0.09844662723249772,17385427.649552483,354277.68901443103,17739705.338566914,2939,2,1999.356545961003,105,613,105,35.54473399708354,0.6305555555555555,39.426100628930826,133439.51709295978,1270.8525437424742,0
2941,512.4168616054839,0,0,718,0.0,0.0,1.0,718,18850,12700,6150,0.6737400530503979,250,127,123,147.14946050054854,0.41692558297041343,0.9073999999225921,0.09778713455424327,17421207.669711497,350254.26197321666,17771461.931684714,2940,3,2000.356545961003,114,604,97,35.40204830716503,0.6304824561403508,39.23913043478262,133618.26641212654,1172.090056246724,0
2942,512.3823661430024,2,1,719,0.002777777777777778,0.001388888888888889,0.9986111111111111,720,19850,14200,5650,0.7153652392947103,255,142,113,146.80314940215987,0.4175388673182919,0.9076427833124407,0.09815153663381364,17447671.066360265,348424.6124549303,17796095.678815193,2941,0,1995.7972222222222,120,600,79,35.20128213586683,0.6314236111111111,39.03236914600553,133715.21218370445,1114.2934348642038,0
2943,512.3455870139359,0,0,719,0.0,0.0,1.0,719,19500,14200,5300,0.7282051282051282,248,142,106,147.5974584010543,0.41742123848892576,0.9082636795481127,0.09890823715127549,17456779.621929854,352015.26081283885,17808794.88274269,2942,1,1999.5730180806677,120,599,83,35.101930327913955,0.6322048611111111,38.95488980716256,133745.3102188683,1114.5442518239026,0
2944,511.9396418685307,0,0,719,0.0,0.0,1.0,719,19950,14300,5650,0.7167919799498746,256,143,113,150.19033936412757,0.41745320024329674,0.9099913222305436,0.10099005577932782,17458400.822949134,360666.6288707423,17819067.451819874,2943,2,2000.5730180806677,125,594,84,34.916904083570756,0.6325000000000001,38.83928571428573,133698.52254155918,1069.5881803324735,0
2945,511.6156504670595,0,0,719,0.0,0.0,1.0,719,21500,16700,4800,0.7767441860465116,263,167,96,155.477171589189,0.41733374722191013,0.9135123093036448,0.10509321598397167,17470942.07693061,377966.5318239505,17848908.60875456,2944,3,2001.5730180806677,128,591,90,34.59959368434061,0.6337890625,38.66279069767444,133704.20632845673,1044.5641119410682,0
2946,511.2323863164019,0,0,719,0.0,0.0,1.0,719,18750,13100,5650,0.6986666666666667,244,131,113,156.62523148910043,0.417172808489042,0.9157021462677923,0.10645745429639723,17482743.86037399,385097.7608391363,17867841.621213123,2945,4,2002.5730180806677,95,624,95,34.38044560617373,0.6427631578947368,38.47656249999996,133699.25103079135,1407.3605371662247,0
2947,511.0041162725436,0,0,719,0.0,0.0,1.0,719,19050,12900,6150,0.6771653543307087,252,129,123,158.24774117523606,0.4172448031478777,0.91628548719242,0.10796012564621527,17491551.628322452,390749.7069664025,17882301.335288856,2946,5,2003.5730180806677,98,621,98,34.2117565448184,0.6431760204081632,38.35227272727269,133703.06564971776,1364.3169964256913,0
2948,510.5659419076553,0,0,719,0.0,0.0,1.0,719,17500,12000,5500,0.6857142857142857,230,120,110,156.76592779686007,0.41736845316731297,0.915739217921103,0.10740212463503218,17495412.09604658,387236.90188502235,17882648.9979316,2947,6,2004.5730180806677,103,616,96,34.107180433867654,0.6433050161812297,38.21113782051278,133660.47699960132,1297.674533976712,0
2949,510.6758421308226,1,0,720,0.001388888888888889,0.0,1.0,720,20200,14500,5700,0.7178217821782178,259,145,114,153.9064763195294,0.41736622205480867,0.914212065664348,0.10594306963025803,17520234.93938172,375095.52476210083,17895330.46414382,2948,0,2002.7875,110,610,72,34.02215514873591,0.6432765151515152,38.053678678678644,133769.6582338348,1216.087802125771,0
2950,510.98886373035964,1,0,721,0.0013869625520110957,0.0,1.0,721,19000,13400,5600,0.7052631578947368,246,134,112,158.4224014702409,0.41767076976421635,0.9174148628325676,0.10968287795571097,17556597.251404442,393071.65964265703,17949668.911047097,2949,0,2001.008321775312,114,607,75,33.70947074406816,0.6443713450292398,37.86231884057968,133949.43583656187,1174.9950511979112,0
2951,510.8473941563076,0,0,721,0.0,0.0,1.0,721,20850,14900,5950,0.7146282973621103,268,149,119,158.67367922680052,0.41768160540915394,0.9174213598956087,0.1102108718445293,17565976.54291456,392401.6254551794,17958378.168369737,2950,1,2002.008321775312,117,604,80,33.59488083616655,0.6448539886039886,37.75600282485873,133966.6625900536,1145.0142101713984,0
2952,510.92350703292897,0,0,721,0.0,0.0,1.0,721,18550,14100,4450,0.7601078167115903,230,141,89,160.4807212927452,0.4175711620948272,0.9183550081480101,0.1119065498579206,17586015.63288648,401693.2946862173,17987708.927572697,2951,2,2003.008321775312,123,598,86,33.41541131708977,0.6450711382113821,37.62600806451611,134053.04011390556,1089.8621147471997,0
2953,510.8178824462175,0,0,721,0.0,0.0,1.0,721,18850,12900,5950,0.6843501326259946,248,129,119,161.49492896417846,0.4174424185801613,0.9195953941003241,0.11299330509056844,17597203.131577015,405321.8139404514,18002524.945517465,2952,3,2004.008321775312,134,587,90,33.276439434025136,0.6444340796019901,37.51543209876544,134081.8111501194,1000.6105309710404,0
2954,510.81537781605874,1,0,722,0.0013850415512465374,0.0,1.0,722,18850,13600,5250,0.7214854111405835,241,136,105,156.5377401694204,0.417394085622846,0.9172754514551389,0.11008050744864031,17619351.271061163,388368.68624462816,18007719.957305793,2953,0,2002.231301939058,96,626,96,33.23818723253473,0.6538628472222222,37.34965635738834,134165.83452131946,1397.5607762637444,0
2955,510.4765698326292,0,0,722,0.0,0.0,1.0,722,19500,13900,5600,0.7128205128205128,251,139,112,152.08210726732682,0.4174016495633565,0.9142098717044662,0.10748636037942405,17629676.706238993,372331.6767853083,18002008.3830243,2954,1,2003.231301939058,105,617,95,33.188596819224244,0.6531746031746032,37.18553459119498,134160.6268042836,1277.7202552788913,0
2956,510.2163640512268,0,0,722,0.0,0.0,1.0,722,19500,14500,5000,0.7435897435897436,245,145,100,150.90250987226568,0.4173269306377851,0.9128159269250835,0.10719242165147083,17642706.843136013,368565.748713968,18011272.59184998,2955,2,2004.231301939058,110,612,74,33.052983263747684,0.6536931818181818,37.02139639639641,134175.98695390028,1219.7816995809117,0
2957,509.97298975195184,0,1,721,0.0,0.0013850415512465374,0.9986149584487535,722,22500,16100,6400,0.7155555555555555,289,161,128,151.5579170999983,0.41729407352054126,0.9127390082360218,0.10819917386008591,17656080.702734422,368283.7630911822,18024364.465825602,2956,3,2005.231301939058,116,606,81,32.8708637840033,0.6540948275862069,36.858974358974365,134194.8155725491,1156.851858384044,0
2958,510.1282464487231,0,1,720,0.0,0.0013869625520110957,0.9986130374479889,721,19850,14300,5550,0.7204030226700252,254,143,111,151.2225658848557,0.4172910406071814,0.9130039695824768,0.10830474455478183,17675287.869311478,370530.47687015287,18045818.34618163,2957,4,2007.1636615811374,118,603,84,32.77510834746563,0.6547492937853108,36.755952380952394,134288.22439996965,1138.0357999997427,0
2959,509.8144421661422,0,0,720,0.0,0.0,1.0,720,21150,15000,6150,0.7092198581560284,273,150,123,152.18015798320016,0.41706286541235255,0.9141319377451924,0.10939663784007421,17680492.890273143,372974.0402525292,18053466.93052567,2958,9,2010.9458333333334,122,598,86,32.628304071001416,0.6552254098360656,36.63617886178864,134266.6795603224,1100.5465537731345,0
2960,509.9384378139194,0,0,720,0.0,0.0,1.0,720,19000,13500,5500,0.7105263157894737,245,135,110,151.6350169911738,0.4169983145958893,0.9146085577794252,0.10938804166903415,17699937.42126867,373786.06232335843,18073723.48359203,2959,10,2011.9458333333334,127,593,89,32.52821019685366,0.655511811023622,36.52343750000001,134356.82668183188,1057.9277691482826,0
2961,510.4057004628887,1,0,721,0.0013869625520110957,0.0,1.0,721,18100,12800,5300,0.7071823204419889,234,128,106,149.864271253306,0.41705819463707816,0.9134835068081864,0.10851234224730559,17732135.677419823,369182.71821225533,18101318.395632077,2960,0,2010.1539528432731,96,625,96,32.454286509682525,0.6634114583333333,36.40463917525774,134540.57478052098,1401.464320630427,0
2962,510.43599574459853,0,0,721,0.0,0.0,1.0,721,19850,14200,5650,0.7153652392947103,255,142,113,146.0098243155101,0.41697496083115015,0.9107737231296147,0.10601725713797808,17745202.66276313,354144.7846466373,18099347.447409768,2961,1,2011.1539528432731,101,620,101,32.46530467337981,0.6629537953795379,36.315359477124204,134594.13204785174,1332.6151687906113,0
2963,510.6253133135407,0,0,721,0.0,0.0,1.0,721,18250,11500,6750,0.6301369863013698,250,115,135,146.09327609206053,0.41685697269738536,0.9104644588779651,0.10658457273151295,17772234.146838732,356830.7819973766,18129064.928836107,2962,2,2012.1539528432731,105,616,102,32.30904847040128,0.6634920634920635,36.16352201257864,134721.58423586932,1283.0627070082792,0
2964,510.588427966864,0,0,721,0.0,0.0,1.0,721,18700,14100,4600,0.7540106951871658,233,141,92,145.52167905275422,0.4168511936867519,0.9087788102417493,0.10659462990614371,17788128.379404195,354811.66179537575,18142940.04119957,2963,3,2013.1539528432731,110,611,78,32.19478811149037,0.6636363636363636,36.036036036036066,134776.94540026388,1225.244958184217,0
2965,510.67211266093665,0,0,721,0.0,0.0,1.0,721,19600,13900,5700,0.7091836734693877,253,139,114,143.98262428669813,0.4169293708583757,0.9080882204278578,0.1058717127636501,17807382.654074974,348990.7372422338,18156373.391317207,2964,4,2014.1539528432731,114,607,82,32.11248785228381,0.6640168128654971,35.914855072463794,134860.91888251604,1182.9905165132986,0
2966,510.8981512269152,0,0,721,0.0,0.0,1.0,721,18900,14200,4700,0.7513227513227513,236,142,94,143.52288059124163,0.41693266168387527,0.9073511661290063,0.10590789757378224,17830347.14205317,348712.55675386277,18179059.69880703,2965,5,2015.1539528432731,123,598,84,32.01126126126131,0.6634485094850948,35.803091397849485,134977.71216470646,1097.3797736968006,0
2967,510.5121841598638,0,0,721,0.0,0.0,1.0,721,19450,13500,5950,0.6940874035989717,254,135,119,146.28076521057426,0.41669941439358915,0.9093301959901239,0.10836882619944911,17833599.677272234,358092.5214500947,18191692.19872233,2966,6,2016.1539528432731,126,595,88,31.81262800223424,0.6641865079365079,35.67913385826775,134939.0226930448,1070.9446245479746,0
2968,510.7000333006964,0,0,721,0.0,0.0,1.0,721,19700,13600,6100,0.6903553299492385,258,136,122,143.96706817033262,0.4165215492885396,0.9081585698786023,0.10695247879356459,17851979.39002988,350119.4267639662,18202098.816793848,2967,7,2017.1539528432731,130,591,93,31.78499288263362,0.664423076923077,35.591603053435136,135033.37712559596,1038.7182855815074,0
2969,510.864421771897,0,0,721,0.0,0.0,1.0,721,20300,14400,5900,0.7093596059113301,262,144,118,149.9118165784833,0.41632859454461396,0.915263192655704,0.10493827160493843,17600875.781359926,363215.85235118057,17964091.633711107,2968,8,2018.1539528432731,106,615,92,33.56481481481481,0.6497641509433962,37.50000000000001,134101.91071512323,1265.1123652370115,8
2970,510.92164369230096,0,0,721,0.0,0.0,1.0,721,20650,15400,5250,0.7457627118644068,259,154,105,149.5025472598822,0.41624768839574666,0.9146208889504341,0.10509412347779398,17621384.447135948,362038.3722185031,17983422.819354452,2969,9,2019.1539528432731,97,624,97,33.435312032053105,0.6534579037800687,37.36181972789118,134187.53076098184,1383.376605783318,0
2971,510.6294034320259,0,0,721,0.0,0.0,1.0,721,19350,13800,5550,0.7131782945736435,249,138,111,150.47497383426537,0.41604245325422506,0.9142506491560276,0.10608383569173395,17623970.927823577,366843.3128440238,17990814.2406676,2970,10,2020.1539528432731,102,619,102,33.31392663304982,0.6530841503267975,37.26739482200649,134158.99344418148,1315.2842494527597,0
2972,510.7789912951044,0,0,721,0.0,0.0,1.0,721,19450,13700,5750,0.7043701799485861,252,137,115,149.4796580009822,0.4159584168079314,0.9140475009052833,0.10554563677982454,17635920.404922504,363592.27013207483,17999512.67505458,2971,11,2021.1539528432731,102,619,99,33.28875461822664,0.6535947712418301,37.216828478964416,134224.1232788437,1315.9227772435656,0
2973,511.3199621605817,1,0,722,0.0013850415512465374,0.0,1.0,722,19750,13800,5950,0.6987341772151898,257,138,119,159.8196005037687,0.41614891693976896,0.9184258286369282,0.10954907161803693,17523484.496026408,395969.25831778,17919453.754344188,2972,0,2019.3531855955678,98,624,90,34.010278514588805,0.6447704081632653,38.19444444444442,133866.40676009562,1365.9837424499553,8
2974,511.4454587954809,0,0,722,0.0,0.0,1.0,722,20150,14100,6050,0.6997518610421837,262,141,121,157.79756011706692,0.41622963899272963,0.91733838078388,0.10864783767643056,17547716.548827305,389247.3714061595,17936963.920233466,2973,1,2020.3531855955678,104,618,71,33.91205895348101,0.6447315705128205,38.045634920634896,133975.37043149344,1288.2247156874369,0
2975,511.7918957249786,0,0,722,0.0,0.0,1.0,722,20250,15300,4950,0.7555555555555555,252,153,99,159.69480089388503,0.4161315478911894,0.9185386617415363,0.11052911162549392,17582794.320778426,396926.167642962,17979720.488421388,2974,2,2021.3531855955678,108,614,76,33.68666982633951,0.6455439814814814,37.87270642201832,134154.62450153154,1242.172449088255,0
2976,511.3496398061994,0,0,722,0.0,0.0,1.0,722,19750,14500,5250,0.7341772151898734,250,145,105,163.58734416897317,0.41608340280952766,0.9201546853318026,0.11368726276847013,17585718.223295968,411210.1878905739,17996928.411186542,2975,3,2022.3531855955678,113,609,79,33.44729171021763,0.6458333333333333,37.73757309941518,134107.7975303122,1186.7946684098426,0
2977,511.14134461950056,0,1,721,0.0,0.0013850415512465374,0.9986149584487535,722,19550,14500,5050,0.7416879795396419,246,145,101,156.5091206022359,0.41606003063355884,0.9143497361685253,0.10902995409778676,17589178.733722735,386623.3791460985,17975802.112868834,2976,4,2023.3531855955678,124,598,89,33.552446978600855,0.644573252688172,37.65833333333333,134093.67224972066,1081.4005826590376,8
2978,511.35014038534774,1,0,722,0.0013850415512465374,0.0,1.0,722,17450,12700,4750,0.7277936962750716,222,127,95,147.6543316614691,0.4160941283971298,0.9073541503651035,0.09932677417046892,17440205.204306424,353174.3686961535,17793379.573002577,2977,0,2024.0540166204987,124,598,88,34.968637992831496,0.6328125,38.82500000000002,133551.87291514446,1077.031233186649,8
2979,511.79660061800143,1,0,723,0.0013831258644536654,0.0,1.0,723,20900,14900,6000,0.7129186602870813,269,149,120,142.62787872659896,0.41624561467364996,0.9041342190119597,0.09641316047364144,17477368.60261444,333052.00190275715,17810420.604517195,2978,0,2022.253112033195,130,593,99,34.93351792125606,0.6334935897435898,38.660941475826995,133752.4417613821,1028.864936626016,0
2980,512.035200343911,0,0,723,0.0,0.0,1.0,723,20400,15100,5300,0.7401960784313726,257,151,106,141.29055584949032,0.41613705908872056,0.9032111504566975,0.09565770895256505,17492517.17965367,329305.49510402145,17821822.674757693,2979,1,2023.253112033195,139,584,101,34.91541776968122,0.6327188249400479,38.60863095238101,133841.5820184711,962.8890792695762,0
2981,512.0706854008014,0,0,723,0.0,0.0,1.0,723,19450,13500,5950,0.6940874035989717,254,135,119,143.6897079928391,0.41600783005048475,0.9055598608270667,0.0975923750332203,17508058.220307034,339095.55463950074,17847153.774946533,2980,2,2024.253112033195,103,620,103,34.74413972728666,0.6403721682847896,38.50160256410253,133905.66360620913,1300.0549864680497,0
2982,511.96182001396517,0,0,723,0.0,0.0,1.0,723,19850,14400,5450,0.72544080604534,253,144,109,145.24031459733658,0.41595043926698155,0.9061244172880594,0.09906799130203423,17523511.43728809,344574.0628003424,17868085.500088435,2981,3,2025.253112033195,107,616,107,34.558319816664834,0.6408683800623053,38.35841049382713,133950.50435492527,1251.873872475937,0
2983,512.3928444382357,0,0,723,0.0,0.0,1.0,723,20850,15200,5650,0.7290167865707434,265,152,113,141.21559246035036,0.41586215803394344,0.9032926783330517,0.09677948713185255,17559450.248782646,330483.63403197157,17889933.882814616,2982,4,2026.253112033195,115,608,103,34.50341291074985,0.6407608695652174,38.20043103448273,134144.22581494375,1166.471528825598,0
2984,512.1765535980933,0,0,723,0.0,0.0,1.0,723,20500,14100,6400,0.6878048780487804,269,141,128,143.31338654592776,0.4157691674042061,0.9045508609093744,0.09868483908590221,17573240.45376779,338596.12040306896,17911836.57417086,2983,5,2027.253112033195,120,603,82,34.28815165357608,0.64140625,38.04235537190082,134168.56361429338,1118.0713634524448,0
2985,512.5215041935595,2,0,725,0.002758620689655172,0.0,1.0,725,20250,15100,5150,0.745679012345679,254,151,103,140.19325663379718,0.41600455642344575,0.9037509962034447,0.09714526421219528,17613064.816482954,328596.5831849754,17941661.39966793,2984,0,2022.6579310344828,130,595,87,34.15857850571218,0.6418269230769231,37.833969465648835,134365.72831791907,1033.5825255224545,0
2986,512.4291635774863,0,0,725,0.0,0.0,1.0,725,17450,12600,4850,0.7220630372492837,223,126,97,142.1466940344147,0.41595676954340505,0.9049564937157601,0.09876426143949513,17621832.629873693,338527.05023286014,17960359.680106554,2985,1,2023.6579310344828,135,590,90,34.01723130841119,0.6419753086419753,37.74509803921567,134387.06005585918,995.4597041174754,0
2987,512.1617010955928,0,0,725,0.0,0.0,1.0,725,20550,15500,5050,0.754257907542579,256,155,101,139.8714446206564,0.41594756144027434,0.9038113352133101,0.09748674904886521,17626433.565346487,327536.9452590018,17953970.510605488,2986,2,2024.6579310344828,138,587,97,33.972752244660875,0.6425875603864735,37.64238609112707,134369.5218349473,973.6921872097631,0
2988,512.6345094022525,0,0,725,0.0,0.0,1.0,725,18400,13700,4700,0.7445652173913043,231,137,94,142.5376147918903,0.41594470375309583,0.9059424334319197,0.09962466578224628,17655140.823883973,339904.3323702629,17995045.156254236,2987,3,2025.6579310344828,145,580,100,33.80904240859043,0.6426005747126438,37.549942922374406,134540.95625257998,927.8686638108965,0
2989,512.6942026304006,0,1,724,0.0,0.001379310344827586,0.9986206896551724,725,19400,13700,5700,0.7061855670103093,251,137,114,141.29427876095602,0.4158780243855973,0.9060046372395378,0.09931831819731837,17682264.805242885,335280.57050340716,18017545.37574629,2988,4,2026.6579310344828,106,619,106,33.652806607853314,0.6511399371069182,37.36370716510904,134652.10473678916,1270.3028748753695,0
2990,512.9364324520993,0,0,724,0.0,0.0,1.0,724,20600,15900,4700,0.7718446601941747,253,159,94,168.67728098069037,0.4160099286403847,0.9214105521471267,0.11198566324665526,17434488.357446257,422760.4182847083,17857248.775730964,2989,5,2030.121546961326,96,628,92,34.87401663989455,0.6344401041666667,39.271907216494846,133736.93775241118,1393.0931015876165,8
2991,513.3786653777303,2,0,726,0.0027548209366391185,0.0,1.0,726,21250,15500,5750,0.7294117647058823,270,155,115,170.58817438706296,0.4163192267502613,0.9220037170206974,0.1137629283185018,17469962.58205717,429583.804696689,17899546.38675386,2990,0,2025.526170798898,100,626,71,34.66890689859655,0.6348958333333333,39.11922442244225,133930.62438871423,1339.3062438871423,0
2992,513.5397058190389,1,0,727,0.001375515818431912,0.0,1.0,727,19600,14500,5100,0.7397959183673469,247,145,102,167.91013836418426,0.41682344894486945,0.9237795313593482,0.10694220361730061,17262837.687611163,414721.092937044,17677558.780548207,2991,0,2023.738651994498,108,619,80,36.35728414172687,0.6168981481481481,40.711009174311904,133155.19207073803,1232.9184450994262,8
2993,513.1661678891481,0,0,727,0.0,0.0,1.0,727,20850,16100,4750,0.7721822541966427,256,161,95,166.7229869765259,0.4169394962504878,0.9228620046808547,0.10673718909212174,17274478.833445042,409760.5419149509,17684239.375359993,2992,1,2024.738651994498,86,641,86,36.2032401212066,0.6248788759689923,40.529214559387,133151.62864374788,1548.2747516714871,0
2994,512.6967758836986,1,0,728,0.0013736263736263737,0.0,1.0,728,21700,16000,5700,0.7373271889400922,274,160,114,163.37579061276622,0.41732143801865257,0.9213645288775674,0.10503532127357403,17278274.783210933,397270.3606263482,17675545.14383728,2993,0,2022.956043956044,89,639,89,36.14041393607063,0.6253511235955056,40.38194444444448,133105.34004452988,1495.5656184778638,0
2995,512.8240064677019,0,0,728,0.0,0.0,1.0,728,18650,12800,5850,0.6863270777479893,245,128,117,157.3031987759876,0.41743287589874595,0.9148527439673038,0.10144262480199764,17296854.34531561,379920.10345609,17676774.4487717,2994,1,2023.956043956044,109,619,94,36.18905792345741,0.6210818042813455,40.27462121212118,133193.4093313398,1221.9578837737595,8
2996,512.3061107198085,3,1,730,0.004103967168262654,0.0013679890560875513,0.9986320109439124,731,19050,14200,4850,0.7454068241469817,239,142,97,153.81078451256107,0.41811148798480846,0.9147467285156232,0.09872369328813153,17257473.89203963,365627.1196079327,17623101.011647563,2995,0,2016.6456908344733,100,631,100,36.44703381412168,0.6215625,40.439356435643575,132974.50380038642,1329.7450380038642,8
2997,512.2963745199363,1,0,731,0.0013679890560875513,0.0,1.0,731,19600,14000,5600,0.7142857142857143,252,140,112,153.7139091626373,0.41850064651537583,0.9138876579368953,0.09910052365009243,17277774.508172084,365366.85225633765,17643141.360428423,2996,0,2017.6374829001368,106,625,99,36.29207586775621,0.6216588050314465,40.28426791277258,133051.42795407725,1255.2021505101627,0
2998,511.89911582416744,0,0,731,0.0,0.0,1.0,731,18350,12200,6150,0.6648501362397821,245,122,123,153.4487323491803,0.4186776574280557,0.9131019377893301,0.099241650374953,17278966.455390222,365737.09977672505,17644703.55516695,2997,1,2018.6374829001368,110,621,75,36.1875609491819,0.621875,40.17454954954954,133004.418354201,1209.131075947282,0
2999,511.6636488905006,0,0,731,0.0,0.0,1.0,731,20250,15300,4950,0.7555555555555555,252,153,99,151.4441744665542,0.4189056556040702,0.9125010082369001,0.09837245445324592,17291125.467766102,357278.04441268515,17648403.512178786,2998,2,2019.6374829001368,115,616,79,36.08615275235168,0.622373188405797,40.023347701149405,133020.60254156563,1156.700891665788,0
3000,511.18656321355377,0,0,731,0.0,0.0,1.0,731,18650,13300,5350,0.7131367292225201,240,133,107,154.66352166140445,0.4189186171442136,0.9141877933663558,0.10078356755152161,17289644.959304806,369965.4755362818,17659610.43484109,2999,3,2020.6374829001368,119,612,81,35.89060031595576,0.6227240896358543,39.91319444444443,132952.88026913514,1117.2510946986147,0
3001,511.10320755798614,0,1,730,0.0,0.0013679890560875513,0.9986320109439124,731,20750,14700,6050,0.708433734939759,268,147,121,153.39645608016252,0.41900950408835086,0.9135883363449371,0.10031484427847734,17303204.161236286,363900.0394330332,17667104.20066932,3000,4,2021.6374829001368,125,606,87,35.7984842467567,0.6229166666666667,39.79001322751323,132994.15887803913,1063.9532710243132,0
3002,511.2320709126193,1,0,731,0.0013679890560875513,0.0,1.0,731,19400,13700,5700,0.7061855670103093,251,137,114,154.70366445773763,0.4192510884570458,0.9158879307198697,0.10175499678631925,17334005.091739055,370726.821484225,17704731.91322328,3001,0,2022.5813953488373,129,602,95,35.56272885319544,0.6242732558139534,39.59134615384616,133129.25538933717,1032.009731700288,0
3003,510.7738933050113,3,0,734,0.004087193460490463,0.0,1.0,734,20800,15000,5800,0.7211538461538461,266,150,116,155.35303699070184,0.4196942302855026,0.9140568216138352,0.10285874465271505,17348578.776377145,371430.880076527,17720009.656453673,3002,0,2015.3106267029973,104,630,104,35.316036718432805,0.6314102564102564,39.365079365079374,133125.51314394156,1280.0530109994381,0
3004,510.9014738292626,1,0,735,0.0013605442176870747,0.0,1.0,735,20450,14400,6050,0.7041564792176039,265,144,121,154.6131272639376,0.4198839799316638,0.9140947312442274,0.10287992602020064,17375556.937998712,369847.8392273175,17745404.77722603,3003,0,2013.5673469387755,109,626,93,35.16268926328016,0.6319762996941896,39.19507575757576,133245.62017738383,1222.4368823613195,0
3005,511.3644282576328,0,1,734,0.0,0.0013605442176870747,0.998639455782313,735,20350,14200,6150,0.6977886977886978,265,142,123,160.3648927294384,0.420079766693235,0.9178457310765147,0.10376483277191381,17263155.703460228,386330.8225113987,17649486.525971625,3004,1,2014.5673469387755,106,629,73,35.990752188627845,0.6229363207547169,40.157710280373834,132874.10391963096,1253.5292822606693,8
3006,511.620267074016,1,0,735,0.0013605442176870747,0.0,1.0,735,20600,14900,5700,0.7233009708737864,263,149,114,163.57622613175377,0.42016773557742804,0.9182986699491451,0.10626182312481817,17290043.34483334,398048.0080004587,17688091.3528338,3005,0,2015.5646258503402,111,624,76,35.76781412847758,0.6232169669669669,40.02046130952382,133010.80101860128,1198.2955046720836,0
3007,511.43723997640757,0,0,735,0.0,0.0,1.0,735,21500,15600,5900,0.7255813953488373,274,156,118,167.77662275837764,0.4203123938040248,0.9185113154744018,0.10942244281094136,17302076.99808023,412076.8090886589,17714153.80716889,3006,1,2016.5646258503402,117,618,81,35.51932736034749,0.6233974358974359,39.883474576271176,133033.27783496428,1137.0365626920025,0
3008,511.03401130738143,0,0,735,0.0,0.0,1.0,735,19550,13700,5850,0.7007672634271099,254,137,117,168.27510554692344,0.4204320283971899,0.9191200033732505,0.1100610149793389,17301535.34408916,415733.5372300847,17717268.881319247,3007,2,2017.5646258503402,123,612,84,35.40617467286505,0.6233062330623307,39.784946236559136,132978.74272729683,1081.1279896528197,0
3009,511.5143530502518,0,0,735,0.0,0.0,1.0,735,23100,17000,6100,0.7359307359307359,292,170,122,170.43958295365312,0.42056355693957875,0.9211611349013449,0.11186419278223654,17333719.551150084,420770.3862667224,17754489.937416807,3008,3,2018.5646258503402,126,609,88,35.22822148708254,0.6240079365079365,39.66535433070867,133164.90785609442,1056.8643480642413,0
3010,511.76212181541507,0,0,735,0.0,0.0,1.0,735,19600,14000,5600,0.7142857142857143,252,140,112,172.6238145908539,0.4205574554980939,0.9225646749439707,0.11364318784255462,17356063.08977657,432613.96336735674,17788677.05314393,3009,4,2019.5646258503402,91,644,91,35.064885662116374,0.6330128205128205,39.56068840579713,133282.97470559663,1464.648073687875,0
3011,512.1810741152117,0,0,735,0.0,0.0,1.0,735,20300,14200,6100,0.6995073891625616,264,142,122,172.0703655586129,0.4205617033371023,0.921598204929378,0.1137727381647236,17390176.218365498,431166.79580457753,17821343.014170077,3010,5,2020.5646258503402,96,639,96,34.927556388911825,0.6330295138888888,39.41151202749145,133468.49167182026,1390.2967882481278,0
3012,512.4752117588179,0,0,735,0.0,0.0,1.0,735,18650,12100,6550,0.6487935656836461,252,121,131,172.00324112900392,0.4206580134324393,0.9215105482938846,0.11431365848485205,17423594.950037804,433732.9607050943,17857327.910742898,3011,6,2021.5646258503402,101,634,91,34.75088770528184,0.633457095709571,39.23611111111113,133635.02917738716,1323.1191007662094,0
3013,512.4427123416516,0,0,735,0.0,0.0,1.0,735,19300,13300,6000,0.689119170984456,253,133,120,172.0802974149182,0.4206632653061224,0.9217623527569094,0.11486415505840833,17442316.194185525,433995.7916600987,17876311.985845625,3012,7,2022.5646258503402,102,633,75,34.59799798441801,0.6347017973856209,39.08778317152104,133702.56407465908,1310.8094517123438,0
3014,512.759981407855,0,0,735,0.0,0.0,1.0,735,20000,14700,5300,0.735,253,147,106,173.30345092838044,0.4208456906831761,0.922263183316286,0.11618263350238661,17472783.66784964,438618.7413926795,17911402.40924232,3013,8,2023.5646258503402,106,629,77,34.416564115950706,0.6352201257861636,38.94080996884736,133860.705426724,1262.8368436483395,0
3015,513.1910358006346,1,0,736,0.001358695652173913,0.0,1.0,736,20200,13800,6400,0.6831683168316832,266,138,128,174.07146258114346,0.42118421417480034,0.922034053945679,0.11714471324385986,17504816.179649465,442017.79092113243,17946833.970570598,3014,0,2021.8138586956522,111,625,83,34.264835487661585,0.6354166666666667,38.81138392857144,134039.65642103128,1207.564472261543,0
3016,513.5413280696974,0,0,736,0.0,0.0,1.0,736,22400,16200,6200,0.7232142857142857,286,162,124,181.52634472009723,0.4214070818544809,0.9252315553680936,0.12284270382584339,17541920.549465798,467264.1433429796,18009184.692808777,3015,1,2022.8138586956522,113,623,88,33.879238769445905,0.636891592920354,38.62390350877194,134227.4277177792,1187.8533426352142,0
3017,513.8764200444622,0,0,736,0.0,0.0,1.0,736,20950,14300,6650,0.6825775656324582,276,143,133,174.97840604664228,0.42135778677413,0.9258425445974225,0.11562338876806649,17444878.619466666,442345.4109022802,17887224.030368946,3016,2,2023.8138586956522,89,647,89,34.873508269296266,0.6349485018726592,39.432870370370345,133899.30375533423,1504.4865590486993,8
3018,513.5939609724189,0,1,735,0.0,0.001358695652173913,0.998641304347826,736,19100,13100,6000,0.6858638743455497,251,131,120,173.85032982330694,0.42128958240905057,0.9258310771008444,0.11543902523561385,17457587.74767156,440701.4775704007,17898289.22524196,3017,3,2024.8138586956522,91,645,84,34.73344044930807,0.635989010989011,39.266304347826065,133911.25150897622,1471.552214384354,0
3019,513.5346724542835,0,0,735,0.0,0.0,1.0,735,20650,15500,5150,0.7506053268765133,258,155,103,178.59119589949378,0.42139528381743246,0.927958646297218,0.11926001981422145,17481386.777208712,456754.35410465504,17938141.13131337,3018,4,2028.548299319728,93,642,67,34.41366544919164,0.6373207885304659,39.073581560283664,133994.7628281079,1440.8039013775042,0
3020,513.7430083255894,0,0,735,0.0,0.0,1.0,735,19350,13300,6050,0.6873385012919897,254,133,121,193.37131969562083,0.421442550680581,0.9345071228477124,0.127114741430343,17416481.066747107,507219.58566613786,17923700.652413245,3019,5,2029.548299319728,111,624,73,34.576063209153396,0.6273460960960962,39.61123511904763,133772.90740412538,1205.1613279650935,8
3021,513.610042724526,0,0,735,0.0,0.0,1.0,735,19550,14200,5350,0.7263427109974424,249,142,107,192.14421750666185,0.4216744054570057,0.9341445825818553,0.1268047833261147,17429997.856824957,503264.6598684831,17933262.51669344,3020,6,2030.548299319728,77,658,77,34.47068723942317,0.6390692640692641,39.47649572649572,133807.48816065746,1737.759586502045,0
3022,513.9687631358421,0,0,735,0.0,0.0,1.0,735,20100,14100,6000,0.7014925373134329,261,141,120,191.5286124938129,0.4215965541529963,0.9334627511157478,0.1269905866554289,17463592.924508203,501855.5443975626,17965448.468905766,3021,7,2031.548299319728,81,654,81,34.323731380861865,0.6390174897119342,39.316565040650396,133983.14263605923,1654.112872050114,0
3023,514.1426429590681,1,0,736,0.001358695652173913,0.0,1.0,736,18400,13700,4700,0.7445652173913043,231,137,94,192.64745022455477,0.42208477367396235,0.93375320309413,0.1283491544523584,17491524.283203423,508339.5107399995,17999863.793943424,3022,0,2029.7866847826087,86,650,58,34.12713439823737,0.6388081395348837,39.15229885057469,134112.92647876157,1559.4526334739717,0
3024,513.7163120061787,0,0,736,0.0,0.0,1.0,736,20500,14700,5800,0.7170731707317073,263,147,116,196.3747016778336,0.42212386313220945,0.934222066698787,0.13143544611020208,17497969.34262153,519531.70192503545,18017501.044546567,3023,1,2030.7866847826087,93,643,60,33.870552583535,0.6381048387096775,38.99601063829787,134082.00683379333,1441.7420089655197,0
3025,513.2361813671154,0,0,736,0.0,0.0,1.0,736,20900,14300,6600,0.6842105263157895,275,143,132,191.78655917614145,0.4220557357906931,0.9323814127772991,0.12879713806953794,17496889.407341205,503033.64314389345,17999923.050485097,3024,2,2031.7866847826087,100,636,65,33.87412117860812,0.6372916666666666,38.88201320132015,134015.19843082418,1340.1519843082417,0
3026,512.6889800695574,1,0,737,0.0013568521031207597,0.0,1.0,737,18700,13600,5100,0.7272727272727273,238,136,102,178.66622924421927,0.4223202939108804,0.928278745382866,0.11658175415068135,17346686.882069625,453753.4270199154,17800440.30908954,3025,0,2030.0284938941656,102,635,74,35.218797786589974,0.6268382352941176,39.86650485436896,133367.57630814434,1307.5252579229837,8
3027,512.7786413770891,0,0,737,0.0,0.0,1.0,737,20500,14700,5800,0.7170731707317073,263,147,116,181.0792731135857,0.42251763047411167,0.9298609465089127,0.11864478241921333,17368721.378406696,461123.0884228561,17829844.466829553,3026,1,2031.0284938941656,110,627,75,35.0110420046872,0.6264204545454546,39.7240990990991,133463.92284716188,1213.3083895196535,0
3028,512.3680668439757,1,0,738,0.0013550135501355014,0.0,1.0,738,19950,13900,6050,0.6967418546365914,260,139,121,181.56470116760917,0.4227971683832623,0.9308381281949505,0.11949463687438627,17375286.70219059,463397.7475569493,17838684.44974754,3027,0,2029.2750677506774,81,657,81,34.84215200884506,0.6364454732510287,39.57063008130079,133435.69281463764,1647.3542322794772,0
3029,512.3691416763993,0,0,738,0.0,0.0,1.0,738,18750,13100,5650,0.6986666666666667,244,131,113,180.71212981834896,0.4228040246537698,0.9307548913639441,0.11932518495638976,17390377.822925165,462180.44294531253,17852558.265870478,3028,1,2030.2750677506774,82,656,82,34.74951830443158,0.6371951219512195,39.45783132530118,133493.76733436194,1627.9727723702676,0
3030,512.2088778795219,0,0,738,0.0,0.0,1.0,738,20000,14000,6000,0.7,260,140,120,176.56014568421693,0.42298313035708374,0.9286671827603308,0.1172896925791997,17412501.403314583,447270.75689916825,17859772.16021375,3029,2,2031.2750677506774,90,648,82,34.64759208042497,0.6364583333333333,39.25137362637361,133557.76132346125,1483.9751258162362,0
3031,512.3379995875155,0,0,738,0.0,0.0,1.0,738,21250,15000,6250,0.7058823529411765,275,150,125,176.62555042534038,0.42298018101166995,0.9283242574586588,0.11791054929282997,17439230.823087405,447192.7486244751,17886423.57171188,3030,3,2032.2750677506774,95,643,65,34.47576173445338,0.6366228070175439,39.084201388888886,133677.07832119567,1407.1271402231123,0
3032,511.84662660936567,0,0,738,0.0,0.0,1.0,738,21650,16100,5550,0.74364896073903,272,161,111,178.73721100269208,0.42302158675702545,0.9281409188893341,0.11973491183987806,17438237.805030663,454122.39801457967,17892360.20304524,3031,4,2033.2750677506774,102,636,67,34.300782612064644,0.6359272875816994,38.966423948220076,133609.1553338834,1309.8936797439549,0
3033,512.329741004392,0,0,738,0.0,0.0,1.0,738,18600,13300,5300,0.7150537634408602,239,133,106,179.03791407370935,0.42308823430274106,0.9280032129961189,0.12031401150522969,17468938.887020193,459320.4758826434,17928259.362902835,3032,5,2034.2750677506774,107,631,71,34.18455678670358,0.6358060747663552,38.85995370370372,133789.81228485715,1250.3720774285714,0
3034,511.89149951144185,0,0,738,0.0,0.0,1.0,738,20200,14200,6000,0.7029702970297029,262,142,120,177.6899370078888,0.4230799608143074,0.9273232155196671,0.11975849361281489,17467231.010976397,452950.2356085367,17920181.246584933,3033,6,2035.2750677506774,113,625,75,34.11901014340685,0.6355088495575221,38.760964912280734,133726.0414019767,1183.416295592714,0
3035,512.1514388127823,0,0,738,0.0,0.0,1.0,738,18500,13400,5100,0.7243243243243244,236,134,102,178.48698965906155,0.4232160903415909,0.9280425180639442,0.12064862046493434,17489318.87089417,458223.1752906722,17947542.046184845,3034,7,2036.2750677506774,120,618,78,33.997650185020525,0.63515625,38.662190082644656,133844.53536535674,1115.3711280446396,0
3036,511.70920047797057,0,0,738,0.0,0.0,1.0,738,21850,16200,5650,0.7414187643020596,275,162,113,178.41230152082034,0.42333008062667693,0.9287326465936256,0.12100150049527009,17489240.836303562,454609.14189136995,17943849.978194933,3035,8,2037.2750677506774,126,612,84,33.88527680177354,0.6352513227513228,38.54986876640421,133786.43761840445,1061.797123955591,0
3037,511.2995483685323,0,1,737,0.0,0.0013550135501355014,0.9986449864498645,738,18450,13700,4750,0.7425474254742548,232,137,95,178.43277382726734,0.4232966419442575,0.9280096369994795,0.12129845850837485,17485725.328810435,457955.2945602689,17943680.623370703,3036,9,2038.2750677506774,88,650,88,33.80491534273138,0.6450047348484849,38.47144194756554,133719.433617683,1519.5390183827615,0
3038,511.0154172925274,0,0,737,0.0,0.0,1.0,737,22050,16300,5750,0.7392290249433107,278,163,115,172.54954227406057,0.42299718367156314,0.9249249884525876,0.11803395997321472,17503949.418424614,434609.69202748954,17938559.110452104,3037,10,2042.0217096336498,96,641,91,33.74618772138565,0.6446397569444444,38.26245704467351,133751.91973443562,1393.249163900371,0
3039,511.15593250002644,0,0,737,0.0,0.0,1.0,737,19600,14000,5600,0.7142857142857143,252,140,112,169.9377677527735,0.42298666007905134,0.924252678892368,0.11672774539083841,17527157.551882077,428705.2058835951,17955862.757765673,3038,11,2043.0217096336498,99,638,67,33.67475470697422,0.6452020202020202,38.12499999999997,133858.95982344306,1352.1107052873037,0
3040,511.3588272212054,0,0,737,0.0,0.0,1.0,737,20300,14700,5600,0.7241379310344828,259,147,112,168.1325750724851,0.4228516969254518,0.9222033327876478,0.11581660845913662,17546774.531550255,422336.8772411669,17969111.408791423,3039,12,2044.0217096336498,107,630,70,33.6259173692672,0.6441783489096573,38.03047839506172,133960.42733560107,1251.9666106130942,0
3041,511.1438568391674,0,0,737,0.0,0.0,1.0,737,18650,13400,5250,0.7184986595174263,239,134,105,167.8136418316151,0.4228775066121959,0.9221030541785264,0.11612126177243533,17559495.24495613,423294.569156199,17982789.814112328,3040,13,2045.0217096336498,114,623,74,33.481710899163716,0.6441885964912281,37.88043478260868,133980.80551822216,1175.270223844054,0
3042,510.9608008214153,1,0,738,0.0013550135501355014,0.0,1.0,738,20500,15700,4800,0.7658536585365854,253,157,96,168.8837879537025,0.42301040222636505,0.9220807793360111,0.11738318406534687,17572913.90123842,425456.0530050815,17998369.9542435,3041,0,2043.249322493225,124,614,79,33.30407452126761,0.6438172043010753,37.73333333333333,134007.98602876274,1080.7095647480867,0
3043,510.87216525071096,0,0,738,0.0,0.0,1.0,738,21950,15500,6450,0.7061503416856492,284,155,129,167.9148396640948,0.4229896035957194,0.921639776604612,0.11696435057905531,17579491.617049985,420821.5032506531,18000313.12030064,3042,1,2044.249322493225,128,610,84,33.25644596979401,0.6438802083333333,37.66149870801035,134021.43818366597,1047.0424858098904,0
3044,510.65626943412184,1,0,739,0.0013531799729364006,0.0,1.0,739,22600,16800,5800,0.7433628318584071,284,168,116,169.02950026314085,0.42315921073058277,0.9234486357355811,0.1181247145184005,17586410.799960718,424124.4457879359,18010535.245748654,3043,0,2042.4817320703653,133,606,87,33.1183108221518,0.6441885964912281,37.55441542288558,134019.48314960735,1007.6652868391529,0
3045,510.7860059733316,0,0,739,0.0,0.0,1.0,739,19600,13400,6200,0.6836734693877551,258,134,124,153.5046241746484,0.42302398441214906,0.915088612562905,0.1061363071706202,17543711.71031227,371208.17454396497,17914919.884856235,3044,1,2043.4817320703653,122,617,75,33.883247705829106,0.6424180327868853,37.90650406504062,133873.68998020372,1097.3253277065878,8
3046,510.50710571489054,0,0,739,0.0,0.0,1.0,739,19400,13900,5500,0.7164948453608248,249,139,110,152.15639626360147,0.42294070944768986,0.914215523778324,0.10559894541286494,17550711.774534658,366890.61109487317,17917602.38562953,3045,2,2044.4817320703653,128,611,83,33.792817622845654,0.6426595052083333,37.782622739018095,133863.83433365394,1045.8112057316714,0
3047,510.749728855753,0,1,738,0.0,0.0013531799729364006,0.9986468200270636,739,21000,15600,5400,0.7428571428571429,264,156,108,155.1411912681898,0.42294422380398816,0.9173119941363457,0.10599978646262431,17489551.784936696,373869.9797323493,17863421.764669046,3046,3,2045.4817320703653,99,640,99,34.24207067892632,0.6434132996632997,38.30208333333331,133662.13997961412,1350.1226260567082,7
3048,510.77080072825356,1,1,738,0.0013531799729364006,0.0013531799729364006,0.9986468200270636,739,18600,13600,5000,0.7311827956989247,236,136,100,170.2003316512377,0.42267499355192023,0.9242605429312791,0.12015635353885984,17634913.653724153,433893.63050096366,18068807.284225117,3047,0,2046.4763193504737,89,650,84,32.749735729386906,0.6573033707865168,37.22222222222225,134219.2159691479,1508.0810783050324,8
3049,511.2165039396369,0,0,738,0.0,0.0,1.0,738,20750,15000,5750,0.7228915662650602,265,150,115,171.9221782324785,0.4225341020936216,0.9240651480198105,0.12189938628202779,17669269.15960277,439197.84833897697,18108467.007941745,3048,7,2050.249322493225,91,647,70,32.56090930623145,0.6580815018315018,37.08106884057973,134408.4968068659,1477.0164484270979,0
3050,511.28327860290096,0,0,738,0.0,0.0,1.0,738,19550,13800,5750,0.7058823529411765,253,138,115,171.12023519011245,0.4224671098192212,0.9233201194050242,0.12175219494003886,17686707.497124914,438160.7093293533,18124868.206454266,3049,8,2051.249322493225,97,641,71,32.46753684097095,0.6574312714776632,36.96853741496601,134483.5885661935,1386.4287481050876,0
3051,511.78104911201876,0,0,738,0.0,0.0,1.0,738,18650,13500,5150,0.7238605898123325,238,135,103,170.08229222107406,0.42250744307533533,0.9231976603218135,0.1213638051272418,17716520.49329375,436403.2831362111,18152923.776429962,3050,9,2052.249322493225,99,639,72,32.39970968593298,0.6578282828282829,36.87500000000002,134662.38854760095,1360.226146945464,0
3052,511.98447268370734,1,0,739,0.0013531799729364006,0.0,1.0,739,21900,15900,6000,0.726027397260274,279,159,120,167.11586172292482,0.42250019252560594,0.92248891978651,0.11992912281747799,17748367.169362474,423506.7347365805,18171873.904099055,3051,0,2050.470906630582,102,637,78,32.29062644031343,0.6589052287581699,36.690938511326884,134810.15099912134,1321.6681470502092,0
3053,512.1687603979233,1,0,740,0.0013513513513513514,0.0,1.0,740,19650,15000,4650,0.7633587786259542,243,150,93,166.82887835544355,0.42245695881944195,0.9229007293635607,0.12008689161537218,17767916.836954225,425190.3273243825,18193107.164278608,3052,0,2048.6986486486485,107,633,80,32.198980837300105,0.658683800623053,36.593364197530896,134908.65013953968,1260.8285059770062,0
3054,512.5832605780174,2,0,742,0.0026954177897574125,0.0,1.0,742,19850,14500,5350,0.7304785894206549,252,145,107,165.31166724804856,0.4225833921402442,0.9223265093401403,0.11954089870989881,17802131.80679118,420330.01791002986,18222461.82470121,3053,0,2044.1738544474395,87,655,87,32.08964930009729,0.6658285440613028,36.4464962121212,135093.1143083511,1552.794417337369,0
3055,512.4564869097145,0,0,742,0.0,0.0,1.0,742,18900,13800,5100,0.7301587301587301,240,138,102,162.5731534216372,0.4223272486368315,0.9210477509335044,0.11813649148638942,17818827.942497637,412072.6097778832,18230900.55227552,3054,1,2045.1738544474395,92,650,92,32.003111196058455,0.6657608695652174,36.29032258064515,135139.7348544163,1468.9101614610468,0
3056,512.419536871408,0,0,742,0.0,0.0,1.0,742,21700,16000,5700,0.7373271889400922,274,160,114,160.89282372988342,0.4220466275146017,0.9203914080468398,0.11753537339402252,17840300.99038698,403975.28050687554,18244276.270893857,3055,2,2046.1738544474395,95,647,91,31.876353537014968,0.6665570175438597,36.121961805555536,135216.262122132,1423.3290749698106,0
3057,512.1267651014374,0,0,742,0.0,0.0,1.0,742,20350,14000,6350,0.687960687960688,267,140,127,159.50013128573954,0.42192264799638185,0.9196502780035742,0.11675111740013902,17838684.873246066,400304.5158495351,18238989.3890956,3056,3,2047.1738544474395,98,644,89,31.84863132017805,0.6663477891156462,36.058501683501675,135171.50570885438,1379.3010786617795,0
3058,511.98384678563383,0,0,742,0.0,0.0,1.0,742,22150,16000,6150,0.7223476297968398,283,160,123,148.07574796349584,0.42186092347462756,0.9170354664927518,0.10722710694675291,17787356.291735828,356225.2174383888,18143581.509174217,3057,4,2048.173854447439,91,651,91,32.498469782225804,0.6649496336996337,36.401721014492715,134958.06088107108,1483.0556140777041,7
3059,512.087614123934,0,2,740,0.0,0.0026954177897574125,0.9973045822102425,742,21000,15400,5600,0.7333333333333333,266,154,112,145.95771661053732,0.4217443327113139,0.9153703340750978,0.10625410300497874,17813768.144749742,350611.3845274341,18164379.529277176,3058,5,2049.173854447439,96,646,96,32.38293230735824,0.6651475694444444,36.232817869415776,135071.90698144253,1406.999031056693,0
3060,511.9193149486582,0,0,740,0.0,0.0,1.0,740,21850,15500,6350,0.7093821510297483,282,155,127,143.4903047091418,0.4213169275500128,0.9134103840682792,0.10485829959514142,17824351.147421334,341674.31547724194,18166025.462898575,3059,6,2055.6135135135137,101,639,88,32.324561403508746,0.665016501650165,36.11111111111109,135089.81922256167,1337.5229625996205,0
3061,512.21474932802,0,0,740,0.0,0.0,1.0,740,20950,14600,6350,0.6968973747016707,273,146,127,142.1239414719396,0.4211105218886004,0.9116585723034072,0.10435416702334713,17854995.175815865,338574.4578698836,18193569.63368575,3060,7,2056.6135135135137,112,628,77,32.20791292811507,0.6639694940476191,35.96054572271387,135244.90288534755,1207.5437757620316,0
3062,511.8454560928652,0,0,740,0.0,0.0,1.0,740,20650,15100,5550,0.7312348668280871,262,151,111,141.99172091379106,0.42103520553706614,0.9116738009370031,0.10461267364766076,17856670.46800018,338449.87390836695,18195120.341908548,3061,8,2057.6135135135137,116,624,78,32.10225038480116,0.6642420977011494,35.852920227920244,135202.4825215397,1165.5386424270664,0
3063,512.1508764462119,0,0,740,0.0,0.0,1.0,740,18050,11800,6250,0.6537396121883656,243,118,125,141.71043788855567,0.42093444086847337,0.911518921605057,0.10466184408284956,17877792.65711687,340643.96518416784,18218436.62230104,3062,9,2058.6135135135137,118,622,82,32.03122411793936,0.6646362994350282,35.77556022408964,135322.77840974202,1146.8032068622206,0
3064,512.3279030503387,0,0,740,0.0,0.0,1.0,740,21550,15500,6050,0.7192575406032483,276,155,121,138.34665914878195,0.4207719221251021,0.9092048338180261,0.10265670688489502,17903900.423646927,325838.961868803,18229739.38551573,3063,10,2059.6135135135137,122,618,92,31.97089459802885,0.6653859289617486,35.62838753387534,135444.95384080656,1110.2045396787423,0
3065,512.0802456087503,0,0,740,0.0,0.0,1.0,740,20750,14800,5950,0.7132530120481928,267,148,119,141.5712422420103,0.4206472710870546,0.9110668263020265,0.10545246790704378,17911502.308997206,338400.7264610707,18249903.035458278,3064,11,2060.6135135135137,124,616,95,31.763891952067368,0.6662466397849462,35.50833333333332,135440.9576281335,1092.2657873236574,0
3066,511.66603778073056,0,0,740,0.0,0.0,1.0,740,22350,16400,5950,0.7337807606263982,283,164,119,144.3568885457082,0.420383111460581,0.9134993638118651,0.10791728561183936,17912329.436366655,346803.6288079142,18259133.06517457,3065,12,2061.6135135135137,96,644,96,31.57543628246755,0.6736111111111112,35.39518900343641,135389.29522032978,1410.305158545102,0
3067,511.2986433621096,0,0,740,0.0,0.0,1.0,740,20750,14700,6050,0.708433734939759,268,147,121,142.71117663264246,0.42016268636701654,0.9125658871526958,0.10704180698313732,17913476.238687877,342540.6543208024,18256016.89300868,3066,13,2062.6135135135137,99,641,99,31.51398289522011,0.6738215488215489,35.29166666666665,135345.01171997763,1367.1213305048245,0
3068,511.2419833544676,0,0,740,0.0,0.0,1.0,740,21300,15500,5800,0.7276995305164319,271,155,116,142.62842400120365,0.41992553700520546,0.912426628347899,0.10757061451931339,17934661.732499003,342298.5075802008,18276960.240079205,3067,14,2063.6135135135137,101,639,92,31.342572065646213,0.6750206270627063,35.12050653594769,135417.51758848768,1340.7675008761157,0
3069,511.04886517380953,0,0,740,0.0,0.0,1.0,740,20450,14100,6350,0.6894865525672371,268,141,127,138.40879475023155,0.41979890496044087,0.9093580718982646,0.1049881345544427,17951898.873171102,328490.137302724,18280389.010473825,3068,15,2064.6135135135137,109,631,81,31.274562343694146,0.6748853211009174,34.943181818181785,135456.98613839713,1242.7246434715332,0
3070,510.92467315460453,0,0,740,0.0,0.0,1.0,740,20950,15200,5750,0.7255369928400954,267,152,115,138.31140285995886,0.4194880392909825,0.9091240273844559,0.10517052977670804,17957728.455113962,327801.7229609943,18285530.178074956,3069,16,2065.6135135135137,111,629,84,31.200852714537973,0.6752064564564564,34.86793154761901,135462.51541683468,1220.3830217732855,0
3071,511.44795581010516,0,1,739,0.0,0.0013513513513513514,0.9986486486486487,740,18600,12600,6000,0.6774193548387096,246,126,120,138.0078376058137,0.4191259722171427,0.90913886900696,0.10534633630002403,17992260.696070004,330014.5984609296,18322275.294530936,3070,17,2066.6135135135137,116,624,86,31.088258987010324,0.6753771551724138,34.74893162393158,135662.11669738413,1169.501006011932,0
3072,511.1681534826345,0,1,738,0.0,0.0013531799729364006,0.9986468200270636,739,20500,14200,6300,0.6926829268292682,268,142,126,137.6986356552203,0.4188573330252923,0.9084365225767288,0.10557765533792002,18000871.788690105,327439.09718142526,18328310.88587153,3071,18,2070.3085250338295,126,613,89,30.958516194832487,0.6749338624338624,34.61286089238841,135657.45385567422,1076.6464591720176,0
3073,511.1121544166496,0,0,738,0.0,0.0,1.0,738,20250,14900,5350,0.7358024691358025,256,149,107,138.04946504107414,0.41862587469158274,0.9082528828023075,0.10615136122163853,18010827.990362376,329427.0338032563,18340255.024165634,3072,20,2074.089430894309,131,607,94,30.86006782398461,0.675015903307888,34.52493686868683,135687.53146093874,1035.7826829079293,0
3074,510.79111719369484,0,0,738,0.0,0.0,1.0,738,20550,15700,4850,0.7639902676399026,254,157,97,143.87407069935745,0.4184183097201845,0.9125032760602052,0.10740395387222028,17875714.99385405,346220.3765654694,18221935.370419517,3073,21,2075.089430894309,136,602,97,31.63313694496338,0.6650582107843137,35.43947688564479,135135.16516693117,993.6409203450821,8
3075,510.88690337358554,0,1,737,0.0,0.0013550135501355014,0.9986449864498645,738,19750,14000,5750,0.7088607594936709,255,140,115,143.60634890926033,0.4183502832597299,0.9124065663837462,0.10763416284066407,17895957.324110936,346644.61831029446,18242601.94242123,3074,22,2076.089430894309,101,637,101,31.513491267330338,0.6730610561056105,35.3145424836601,135224.33375854176,1338.8547896885323,0
3076,511.42538558948445,0,0,737,0.0,0.0,1.0,737,19300,14400,4900,0.7461139896373057,242,144,98,141.4222070110261,0.4180806687904352,0.9104115314705592,0.10656267115561592,17937224.713169023,340644.38131781324,18277869.094486836,3075,23,2079.796472184532,108,629,108,31.403502441605927,0.6730324074074074,35.14908256880732,135451.48257097544,1254.1803941756984,0
3077,511.30191848831294,0,0,737,0.0,0.0,1.0,737,20250,14900,5350,0.7358024691358025,256,149,107,151.6773212347536,0.41778362694924587,0.9171559782901482,0.11397075096942626,17921130.17378719,375995.80365187174,18297125.977439065,3076,24,2080.796472184532,97,640,97,31.220099495496953,0.6749355670103092,35.235969387755105,135374.35679873935,1395.6119257601995,8
3078,511.75375326385074,0,0,737,0.0,0.0,1.0,737,18400,13400,5000,0.7282608695652174,234,134,100,151.76062240061881,0.41761117829823213,0.9166414932971356,0.11431683844603958,17947420.645767294,378942.3455374717,18326362.991304766,3077,25,2081.796472184532,100,637,100,31.13958227864531,0.6748958333333333,35.15882838283828,135533.46359387803,1355.3346359387804,0
3079,511.53561549078745,0,0,737,0.0,0.0,1.0,737,17500,11700,5800,0.6685714285714286,233,117,116,149.71883132338544,0.41746845687570056,0.9151517251695651,0.1130682033840405,17950537.422803327,372606.6969137601,18323144.119717088,3078,26,2082.796472184532,104,633,98,31.11300429398843,0.6746794871794872,35.07936507936507,135516.34004033668,1303.0417311570834,0
3080,511.9367003546629,0,0,737,0.0,0.0,1.0,737,21050,15200,5850,0.7220902612826603,269,152,117,148.06761945234643,0.41736491087054844,0.9143458777339808,0.1121713256049655,17977732.73268717,363934.0177759001,18341666.750463072,3079,27,2083.796472184532,107,630,73,31.058589911562354,0.6749415887850467,34.98263888888887,135672.1133839215,1267.9636764852478,0
3081,512.1812967800795,0,0,737,0.0,0.0,1.0,737,19900,13900,6000,0.6984924623115578,259,139,120,148.09488066238418,0.4172349406623011,0.9137840909916355,0.11276064947416918,18007495.665128052,366063.58431110333,18373559.249439154,3080,28,2084.796472184532,112,625,79,30.899615286565155,0.6754092261904762,34.82669616519172,135816.806629569,1212.6500591925803,0
3082,512.0270931246031,0,0,737,0.0,0.0,1.0,737,19650,14300,5350,0.727735368956743,250,143,107,146.73612220804014,0.4171433777259945,0.913315747907387,0.11208435250351148,18015441.728146315,361653.21181061555,18377094.93995693,3081,29,2085.796472184532,114,623,83,30.835766236426938,0.6759868421052632,34.7282608695652,135826.31747506338,1191.458925219854,0
3083,512.2826589003671,0,1,736,0.0,0.0013568521031207597,0.9986431478968792,737,18900,13200,5700,0.6984126984126984,246,132,114,177.2322494691545,0.41707862306550253,0.9254882482538409,0.1350997925594218,18015818.249677863,472296.7988835729,18488115.048561435,3082,30,2086.796472184532,99,638,72,30.091319717203483,0.6788720538720538,34.79166666666668,135861.63016253535,1372.3396986114683,8
3084,512.4094828390757,0,0,736,0.0,0.0,1.0,736,19600,13500,6100,0.6887755102040817,257,135,122,177.07032088937777,0.4169375970496894,0.9245096449490771,0.13526742848092624,18029275.664365236,471689.92545843776,18500965.589823674,3083,31,2090.163043478261,106,630,73,30.028242626640708,0.6777712264150944,34.72546728971962,135929.18611645178,1282.3508124193563,0
3085,512.2150268589459,0,0,736,0.0,0.0,1.0,736,18650,13400,5250,0.7184986595174263,239,134,105,176.46603062551824,0.41671642388839597,0.9248278261490159,0.13526488080551155,18036602.400485933,470719.5263168864,18507321.926802818,3084,32,2091.163043478261,109,627,76,29.938177990294044,0.6781345565749235,34.62121212121211,135931.0029611272,1247.0734216617175,0
3086,512.6153389040262,0,1,735,0.0,0.001358695652173913,0.998641304347826,736,21500,16200,5300,0.7534883720930232,268,162,106,176.7619815883899,0.41657978408754803,0.9251290406209531,0.13586056633650392,18062014.37402705,469835.4904461941,18531849.864473246,3085,33,2092.163043478261,114,622,79,29.845685331149536,0.6779057017543859,34.538043478260846,136079.8708085158,1193.6830772676826,0
3087,512.8056930491117,0,0,735,0.0,0.0,1.0,735,20000,14800,5200,0.74,252,148,104,185.0931519890287,0.416540389997961,0.9269397058175013,0.13404077071051057,17816166.84843292,492530.0956677731,18308696.944100693,3086,34,2092.31156462585,88,647,88,31.52075378148771,0.6659564393939394,36.399812734082374,135175.67671877352,1536.0872354406083,7
3088,512.4157700829659,0,0,735,0.0,0.0,1.0,735,19300,14700,4600,0.7616580310880829,239,147,92,183.50896590569883,0.41646284762769775,0.9261209420661882,0.13349962060610013,17822249.242425147,487808.50571820897,18310057.748143356,3087,35,2093.31156462585,91,644,91,31.414563120689145,0.666437728937729,36.25452898550723,135147.3386357851,1485.135589404232,0
3089,512.6304119412239,0,0,735,0.0,0.0,1.0,735,19550,13900,5650,0.710997442455243,252,139,113,181.61957078821635,0.41639959344319016,0.9257152256412058,0.13263137304588074,17846175.012693968,481692.92920337076,18327867.94189734,3088,36,2094.31156462585,95,640,86,31.34046796611561,0.6664473684210526,36.132812499999986,135266.34502589653,1423.85626343049,0
3090,513.0821002119143,1,1,735,0.001358695652173913,0.001358695652173913,0.998641304347826,736,20800,15400,5400,0.7403846153846154,262,154,108,178.3782422415282,0.41632691573006014,0.9240454863470329,0.1308579545524397,17881434.368480895,469931.7662813731,18351366.13476227,3089,0,2092.4646739130435,101,635,72,31.279172468925694,0.6662541254125413,35.98856209150326,135459.54304205856,1341.1835944758272,0
3091,513.1800405914662,0,0,735,0.0,0.0,1.0,735,21050,15700,5350,0.7458432304038005,264,157,107,152.83325994333612,0.41626513003021376,0.9174786194299795,0.10817305433310558,17729372.972592324,373877.57363051287,18103250.546222836,3090,38,2096.31156462585,97,638,87,33.1212090578245,0.655713058419244,37.138605442176875,134895.22112911328,1390.6723827743638,8
3092,512.9255006354406,0,0,735,0.0,0.0,1.0,735,20650,15300,5350,0.7409200968523002,260,153,107,153.8617773536953,0.41617824241413187,0.9179970340480916,0.10936661471357294,17739271.976726454,378229.18305994786,18117501.159786403,3091,39,2097.31156462585,99,636,76,32.95343525559782,0.6565656565656566,37.00000000000001,134899.4066671213,1362.6202693648618,0
3093,512.8676522462287,0,0,735,0.0,0.0,1.0,735,20500,15000,5500,0.7317073170731707,260,150,110,157.02697035636638,0.41596978936897194,0.9194601623964695,0.11218568388481953,17759491.345072668,390243.8241973761,18149735.169270042,3092,40,2098.31156462585,104,631,77,32.702922179917316,0.6569511217948718,36.83531746031747,134968.65288825158,1297.7755085408805,0
3094,513.0617687728985,0,0,735,0.0,0.0,1.0,735,20650,15200,5450,0.7360774818401937,261,152,109,158.01258680058478,0.4159069213516469,0.9194375743924801,0.11324169300973398,17779776.53459137,394235.6965934242,18174012.23118479,3093,41,2099.31156462585,112,623,78,32.574961775038794,0.6561569940476191,36.734882005899706,135071.267094259,1205.9934561987411,0
3095,513.3213486149106,0,0,735,0.0,0.0,1.0,735,20200,14700,5500,0.7277227722772277,257,147,110,155.25209448642124,0.4158696948352456,0.9177898517050671,0.11149316682824055,17797755.22112532,385427.7550472673,18183182.97617259,3094,42,2100.31156462585,118,617,82,32.58013939212622,0.6556320621468927,36.66841736694677,135173.72313009715,1145.540026526247,0
3096,513.4068293409116,0,0,735,0.0,0.0,1.0,735,19350,13800,5550,0.7131782945736435,249,138,111,156.79617996248214,0.41585602451698206,0.9189324907363794,0.11310384977790537,17820041.03054492,392472.8720728322,18212513.902617753,3095,43,2101.31156462585,123,612,86,32.39435871274926,0.6561653116531165,36.52553763440862,135269.58833542073,1099.7527506944775,0
3097,513.8101124251178,0,0,735,0.0,0.0,1.0,735,20450,15000,5450,0.7334963325183375,259,150,109,149.53018413289962,0.4158742516080001,0.9139172949484313,0.09774308947374513,17392797.908454906,352699.654767517,17745497.563222423,3096,44,2102.31156462585,121,614,83,35.91463214543545,0.6234504132231404,39.805327868852466,133690.65374012198,1104.8814358687766,8
3098,513.9144744381323,2,0,737,0.0027137042062415195,0.0,1.0,737,19700,13900,5800,0.7055837563451777,255,139,116,149.71656081254233,0.41670192454230826,0.9141061832829527,0.0982227711566622,17413161.839035545,354307.74068252556,17767469.57971807,3097,0,2097.603799185889,129,608,88,35.78205799064275,0.6233850129198966,39.6794871794872,133782.47953162005,1037.0734847412407,0
3099,514.1951732001655,0,0,737,0.0,0.0,1.0,737,19050,13200,5850,0.6929133858267716,249,132,117,149.9956333664828,0.4167397172978979,0.9151787807939682,0.09871386446530697,17437062.133651294,356646.63575754967,17793708.769408844,3098,1,2098.603799185889,91,646,91,35.6657047519673,0.6328983516483517,39.572010869565226,133910.8149770951,1471.5474173307155,0
3100,513.6069847331055,2,0,739,0.0027063599458728013,0.0,1.0,739,20800,16400,4400,0.7884615384615384,252,164,88,145.11451905869362,0.416977916396214,0.9104699938600751,0.0951834548315721,17401770.50249268,336449.91144778917,17738220.41394047,3099,0,2093.92151556157,140,599,94,35.909238184432546,0.6217261904761905,39.68676122931439,133698.6976511187,954.9906975079908,8
3101,513.9701457626412,0,0,739,0.0,0.0,1.0,739,21600,16300,5300,0.7546296296296297,269,163,106,145.14438698379115,0.4169347509329852,0.910477119552966,0.09543147364492759,17425108.57336313,336431.34040134674,17761539.913764477,3100,1,2094.92151556157,148,591,100,35.82480915688956,0.6215512387387387,39.60430648769571,133835.61255047985,904.2946793951342,0
3102,513.8206953973906,1,0,740,0.0013513513513513514,0.0,1.0,740,20450,14600,5850,0.7139364303178484,263,146,117,149.6714832003516,0.41693151202623463,0.9136085004221643,0.10156508142653353,17563895.140286777,357312.84728443105,17921207.98757121,3101,0,2093.0891891891893,100,640,100,34.61791311665086,0.6408333333333334,38.531353135313516,134348.00195662715,1343.4800195662715,8
3103,513.7748539333427,2,0,742,0.0026954177897574125,0.0,1.0,742,20500,14900,5600,0.7268292682926829,261,149,112,147.8152006876951,0.41748772784646665,0.912650190450881,0.10083473528849221,17586033.05265264,350996.60099565383,17937029.65364829,3102,0,2088.44474393531,105,637,105,34.48744131455395,0.6413690476190477,38.35495283018866,134426.64589205125,1280.253770400488,0
3104,513.8058645612402,1,0,743,0.0013458950201884253,0.0,1.0,743,19050,13900,5150,0.7296587926509186,242,139,103,145.78862216681375,0.4175656683100371,0.9118217541892462,0.09984713025640188,17604892.161747843,345668.59433130844,17950560.756079152,3103,0,2086.6325706594885,110,633,105,34.40618091653221,0.6415719696969697,38.222597597597584,134502.7645639613,1222.7524051269208,0
3105,513.5287733285775,0,0,743,0.0,0.0,1.0,743,21750,15600,6150,0.7172413793103448,279,156,123,147.43715170512104,0.41729623234041835,0.9128689523419398,0.10143533241039479,17615711.373366993,349092.0620297465,17964803.43539674,3104,1,2087.6325706594885,112,631,76,34.20973522441989,0.6426711309523809,38.07153392330383,134507.80388420154,1200.962534680371,0
3106,513.2619915267733,1,0,744,0.0013440860215053765,0.0,1.0,744,20850,14100,6750,0.6762589928057554,276,141,135,150.05450320053555,0.4174703897065563,0.9138823752911651,0.10366925847135904,17625248.681383118,359299.5869341674,17984548.268317286,3105,0,2085.8252688172042,117,627,80,34.000116493190085,0.6430733618233618,37.93255649717514,134509.25796659006,1149.6517774922227,0
3107,513.1096484186733,0,1,743,0.0,0.0013440860215053765,0.9986559139784946,744,17300,12400,4900,0.7167630057803468,222,124,98,149.55484408578536,0.41752756160243515,0.9135316527807449,0.10359074062822779,17631493.980267107,361275.0666436642,17992769.04691077,3106,1,2086.8252688172042,122,622,83,33.92660044150116,0.6430157103825136,37.84722222222223,134513.1196375345,1102.5665544060205,0
3108,513.013344901025,0,0,743,0.0,0.0,1.0,743,22200,16100,6100,0.7252252252252253,283,161,122,151.57782835500285,0.4174835149021898,0.915250788697175,0.10536636172781767,17643999.19584752,364087.816320801,18008087.012168318,3107,2,2088.5827725437416,126,617,86,33.754221916437345,0.6435185185185186,37.72965879265094,134548.18501111644,1067.8427381834638,0
3109,512.5251727231637,0,0,743,0.0,0.0,1.0,743,20550,15600,4950,0.7591240875912408,255,156,99,155.56134963009518,0.4174525278762309,0.9179372764871843,0.10849836934568335,17642050.509873748,379734.2375116565,18021784.747385405,3108,3,2089.5827725437416,130,613,88,33.53764483639925,0.6439903846153846,37.619274809160316,134476.7264976648,1034.4363576743444,0
3110,512.3044400869375,0,0,743,0.0,0.0,1.0,743,21650,15400,6250,0.7113163972286374,279,154,125,160.6198034769457,0.41733439928702637,0.9220449058941651,0.11243386243386241,17650488.912370335,396753.6120753886,18047242.524445724,3109,4,2090.5827725437416,134,609,89,33.28373015873018,0.644589552238806,37.50000000000001,134479.9155228216,1003.5814591255343,0
3111,511.8827792458021,1,0,744,0.0013440860215053765,0.0,1.0,744,20650,14200,6450,0.6876513317191283,271,142,129,174.742133473318,0.4173499782317158,0.926833979523384,0.11799209739376021,17475365.516140506,441286.5307032898,17916652.046843797,3110,0,2088.771505376344,119,625,78,34.131868314397714,0.6349789915966386,38.69791666666667,133756.0366393852,1124.000307893993,8
3112,511.86899538660947,1,0,745,0.0013422818791946308,0.0,1.0,745,21050,16200,4850,0.7695961995249406,259,162,97,175.03108421162398,0.4173119482331433,0.9274809152393035,0.11862322276222192,17491477.524562456,442260.45511748554,17933737.979679942,3111,0,2086.9664429530203,128,617,84,33.99819819819817,0.6346842447916667,38.57396640826874,133815.88118250592,1045.4365717383275,0
3113,512.1413601175457,0,0,745,0.0,0.0,1.0,745,20500,14600,5900,0.7121951219512195,264,146,118,176.14835569046824,0.4173133013398764,0.927233707481703,0.11990366624613903,17520440.650505994,447739.3623118132,17968180.012817807,3112,1,2087.9664429530203,90,655,90,33.81963590214864,0.6447916666666667,38.427197802197796,133962.25068734,1488.4694520815558,0
3114,511.96469885904924,1,0,746,0.0013404825737265416,0.0,1.0,746,19100,13700,5400,0.7172774869109948,245,137,108,176.09721484805266,0.4175095288218748,0.9272287814053779,0.1205329560106006,17539144.522609442,449418.90024979616,17988563.42285924,3113,0,2086.1662198391423,93,653,92,33.632987242990005,0.6457213261648745,38.242464539007074,134010.6178163732,1440.9743851222927,0
3115,512.2373136879605,0,0,746,0.0,0.0,1.0,746,22950,16800,6150,0.7320261437908496,291,168,123,165.32092544788296,0.4176883722882967,0.921725345261468,0.11101164035420294,17462343.136209685,405228.1455533366,17867571.28176302,3114,1,2087.1662198391423,108,638,80,34.5689376471593,0.6353202160493827,38.88570336391438,133752.4858743902,1238.4489432813907,7
3116,511.80246237241323,0,0,746,0.0,0.0,1.0,746,21050,15200,5850,0.7220902612826603,269,152,117,166.63939861473165,0.41766809261625015,0.9217523538280459,0.10747508445576218,17262902.575328726,405085.94069950335,17667988.51602823,3115,2,2088.1662198391423,99,647,88,35.942722119729424,0.623526936026936,40.270833333333364,132930.02704993647,1342.7275459589544,8
3117,511.9385020138538,1,0,747,0.0013386880856760374,0.0,1.0,747,19450,14000,5450,0.7197943444730077,249,140,109,164.5418760908111,0.4180087194174374,0.920528274776973,0.10646444709907504,17282400.196563043,399885.71033894224,17682285.906901985,3116,0,2086.3694779116468,104,643,73,35.88325315617999,0.6233974358974359,40.15873015873018,133022.75044391837,1279.0649081145998,0
3118,512.1607974161213,1,0,748,0.001336898395721925,0.0,1.0,748,21850,16200,5650,0.7414187643020596,275,162,113,166.93155702700426,0.4181919672152663,0.9223428648502829,0.10860219057548448,17315145.128931865,406638.82730423484,17721783.9562361,3117,0,2084.5788770053477,107,641,77,35.628400098912,0.6246105919003115,39.96913580246916,133177.61476021187,1244.6506052356249,0
3119,512.5259786235987,1,0,749,0.0013351134846461949,0.0,1.0,749,20150,14200,5950,0.7047146401985112,261,142,119,164.46713268703633,0.41846474146158036,0.9216164292429814,0.1073658790553063,17343283.860899936,400530.0335959183,17743813.894495856,3118,0,2082.7943925233644,112,637,80,35.572062175921026,0.6247209821428572,39.85066371681418,133333.29316682083,1190.4758318466145,0
3120,512.9915739791845,0,0,749,0.0,0.0,1.0,749,19800,13500,6300,0.6818181818181818,261,135,126,168.625209742884,0.4185266927501672,0.9237669182923209,0.11049664365139339,17376428.39055757,416420.77638799674,17792849.166945565,3119,1,2083.7943925233644,113,636,83,35.33142443391264,0.6258296460176991,39.72039473684212,133521.2443786288,1181.6039325542372,0
3121,513.3792925620301,0,0,749,0.0,0.0,1.0,749,20700,13900,6800,0.6714975845410628,275,139,136,167.60471415578348,0.41866279221969166,0.9235276640660786,0.1101834337985219,17404428.111220308,412912.83972519304,17817340.9509455,3120,2,2084.7943925233644,120,629,87,35.24488654522212,0.6256076388888889,39.60915977961433,133679.26534197447,1113.9938778497874,0
3122,512.8957118430225,0,0,749,0.0,0.0,1.0,749,18500,12700,5800,0.6864864864864865,243,127,116,164.26038982885805,0.4187082330808279,0.9215457964031168,0.1083104904265634,17401845.71137704,403386.79205848987,17805232.50343553,3121,3,2085.7943925233644,93,656,93,35.226873909899204,0.6329525089605734,39.50576241134753,133606.37741903806,1436.627714183205,0
3123,513.0735851583587,2,0,751,0.002663115845539281,0.0,1.0,751,20600,14700,5900,0.7135922330097088,265,147,118,159.34661265360702,0.4193484982985649,0.9189695615983675,0.10568890915888914,17434741.146400087,384833.38883426966,17819574.535234354,3122,0,2081.237017310253,100,651,94,35.15077936463979,0.6330208333333334,39.304867986798705,133755.78601534615,1337.5578601534614,0
3124,513.4799140475692,0,0,751,0.0,0.0,1.0,751,20450,15000,5450,0.7334963325183375,259,150,109,160.0677707377586,0.4193309661192484,0.919183810965454,0.10649710195524592,17462719.245852627,388393.7081405983,17851112.953993224,3123,1,2082.237017310253,102,649,93,35.02444612481259,0.633578431372549,39.1990291262136,133916.0601077949,1312.9025500764208,0
3125,513.5446483651767,0,0,751,0.0,0.0,1.0,751,18150,12300,5850,0.6776859504132231,240,123,117,159.2748121873407,0.41943682497410856,0.9186443359223391,0.1063653787732454,17481918.857716035,388535.8685474154,17870454.726263452,3124,2,2083.237017310253,107,644,77,34.91622155275447,0.6336643302180686,39.07214506172842,133998.10351295595,1252.318724420149,0
3126,513.1543902077287,0,0,751,0.0,0.0,1.0,751,19300,14000,5300,0.7253886010362695,246,140,106,155.74039477009103,0.41941285693149877,0.9174471228396126,0.10450213695980415,17490297.8279524,375289.1776743602,17865587.00562676,3125,3,2084.237017310253,112,639,81,34.84417846508726,0.6342075892857143,38.91039823008852,133979.27538581906,1196.2435302305273,0
3127,512.7488460795172,0,0,751,0.0,0.0,1.0,751,21150,14600,6550,0.6903073286052009,277,146,131,161.19224004281986,0.4191963308181684,0.9203421516167178,0.1086516368703828,17496992.645759124,392725.88771653286,17889718.533475656,3126,4,2085.237017310253,115,636,84,34.54615243595032,0.6351449275362319,38.75718390804598,133951.9524977132,1164.7995869366366,0
3128,512.8538207617645,0,0,751,0.0,0.0,1.0,751,20850,14300,6550,0.6858513189448441,274,143,131,170.32663405498545,0.41925632490013315,0.9265586394344718,0.11171817808488249,17376153.556374744,420874.3496159667,17797027.90599071,3127,5,2086.237017310253,129,622,81,35.253684807256235,0.6233042635658914,39.68749999999997,133502.26021704485,1034.9012419925957,8
3129,512.90601314167,1,0,752,0.0013297872340425532,0.0,1.0,752,21150,15200,5950,0.7186761229314421,271,152,119,168.38384617355757,0.41965319143033875,0.926974844646618,0.11085521793867675,17394994.880483344,414257.2284290191,17809252.108912364,3128,0,2084.461436170213,87,665,87,35.174264460806576,0.6343390804597702,39.55965909090906,133581.4169169378,1535.4185852521587,0
3130,513.2107506053635,0,0,752,0.0,0.0,1.0,752,21250,14800,6450,0.6964705882352941,277,148,129,163.39309461763875,0.4198354248118348,0.9245588033068386,0.10812264488513279,17428834.597907495,397900.244106213,17826734.84201371,3129,1,2085.461436170213,93,659,93,35.125577571789,0.6341845878136201,39.38386524822694,133751.00213582552,1438.1828186647906,0
3131,512.6838074777719,0,0,752,0.0,0.0,1.0,752,21900,15500,6400,0.7077625570776256,283,155,128,159.06311631710437,0.41978429617484014,0.9220504211475031,0.10569231983824834,17429767.781038348,382186.6359870845,17811954.417025432,3130,2,2086.461436170213,100,652,95,35.09530448654563,0.6336458333333334,39.242986798679866,133685.89835458435,1336.8589835458436,0
3132,512.8580917456486,0,0,752,0.0,0.0,1.0,752,22400,17300,5100,0.7723214285714286,275,173,102,158.95377825194055,0.419838892410592,0.9219383744725722,0.10621184266990548,17461153.156159256,382303.25336146355,17843456.40952072,3131,3,2087.461436170213,105,647,71,34.90481660013558,0.6343253968253968,39.05267295597485,133828.9481939268,1274.5614113707315,0
3133,513.0672501730264,1,0,753,0.0013280212483399733,0.0,1.0,753,20100,14000,6100,0.6965174129353234,262,140,122,159.46167203086262,0.42000312873800305,0.9225714214122849,0.10709681448850498,17491466.417523175,387143.6962419861,17878610.11376516,3132,0,2085.68791500664,110,643,75,34.71563342318061,0.6349431818181819,38.87950450450451,133972.37458769232,1217.93067806993,0
3134,513.0476449734722,0,0,753,0.0,0.0,1.0,753,21800,15100,6700,0.6926605504587156,285,151,134,159.49624066391752,0.42005000094185907,0.9225937264279973,0.10757835442400669,17510128.65718632,386159.93887255155,17896288.596058868,3133,1,2086.68791500664,112,641,83,34.568176204925564,0.6359747023809523,38.73525073746313,134041.26432372959,1196.7970028904426,0
3135,513.046376482196,1,0,754,0.001326259946949602,0.0,1.0,754,20800,15300,5500,0.7355769230769231,263,153,110,157.23035662435177,0.42041655071432515,0.9220070233080742,0.10657972031179441,17532578.971770667,379730.72885523184,17912309.7006259,3134,0,2084.919098143236,120,634,89,34.45698048384269,0.6361111111111111,38.567493112947695,134127.0003530612,1117.7250029421766,0
3136,513.4680758833179,0,0,754,0.0,0.0,1.0,754,22450,15500,6950,0.6904231625835189,294,155,139,162.6405512921442,0.4204971302529346,0.9237587105774749,0.10669700481404906,17397835.52493101,392668.7122129564,17790504.237143967,3135,1,2085.919098143236,127,627,85,35.447146846734135,0.6236876640419948,39.6809895833333,133665.50139449307,1052.4842629487644,6
3137,513.1227846807357,1,1,754,0.0013245033112582781,0.0013245033112582781,0.9986754966887417,755,22550,16900,5650,0.7494456762749445,282,169,113,163.59395496984018,0.42094253751881067,0.925000043179061,0.10784076011564962,17408261.984447375,396027.2854373774,17804289.269884754,3136,0,2084.1549668874172,91,664,91,35.254027934741664,0.6334706959706959,39.51539855072466,133660.58406210487,1468.7976270560976,0
3138,513.3451747531963,2,0,756,0.0026455026455026454,0.0,1.0,756,21350,15100,6250,0.7072599531615925,276,151,125,159.2541120757574,0.42117179561302076,0.922172426741616,0.10565946050002725,17445350.27789873,383098.7536714723,17828449.0315702,3137,0,2082.3928571428573,100,656,92,35.14271303109422,0.6331249999999999,39.29455445544557,133831.8825021806,1338.318825021806,0
3139,513.0382780295242,1,0,757,0.001321003963011889,0.0,1.0,757,18850,13700,5150,0.726790450928382,240,137,103,159.23533552022212,0.4212679017005305,0.9223150831305575,0.10616374979953841,17457173.27033032,385709.76858714176,17842883.038917463,3138,0,2080.640686922061,102,655,72,34.97423596304194,0.6342933006535948,39.1282362459547,133837.20046290074,1312.1294163029484,0
3140,513.4499944179407,0,1,756,0.0,0.001321003963011889,0.9986789960369881,757,20700,14700,6000,0.7101449275362319,267,147,120,157.4721854858128,0.42123608519194167,0.9210449697867935,0.10537085408620475,17487743.121631652,378666.6257155698,17866409.74734722,3139,1,2081.640686922061,107,650,76,34.89467849223945,0.6343457943925234,39.00462962962965,134008.07145977605,1252.4118828016453,0
3141,513.0127998326598,1,0,757,0.001321003963011889,0.0,1.0,757,21000,14700,6300,0.7,273,147,126,154.7530882970605,0.42118206265333086,0.9201737545375808,0.10395411473304447,17490467.233133927,368940.7640172082,17859407.997151136,3140,0,2082.636723910172,109,648,81,34.83208673315203,0.6352255351681957,38.87310606060608,133961.4389714555,1229.0040272610597,0
3142,513.0563978438919,0,1,756,0.0,0.001321003963011889,0.9986789960369881,757,20950,15400,5550,0.7350835322195705,265,154,111,155.3446534913835,0.4211982257309206,0.9205055422969974,0.10477106082980289,17510121.118026346,371670.73953440157,17881791.857560746,3141,1,2083.636723910172,116,641,85,34.678962912478035,0.6351472701149425,38.73753561253565,134042.37887045287,1155.5377488832144,0
3143,513.1053092007588,0,0,756,0.0,0.0,1.0,756,18450,12800,5650,0.6937669376693767,241,128,113,155.56149852179527,0.42108448818575756,0.921133640814185,0.10529438849017465,17527997.26920553,375686.3042567173,17903683.573462248,3142,2,2087.34126984127,124,632,87,34.550548364471105,0.6349126344086021,38.616666666666696,134117.1760699269,1081.5901295961846,0
3144,513.3667488284857,0,0,756,0.0,0.0,1.0,756,22050,15900,6150,0.7210884353741497,282,159,123,152.84446077191532,0.42116825513624634,0.9198035634142752,0.10396066176192219,17558894.876545846,363505.9638312718,17922400.84037712,3143,3,2088.34126984127,93,663,93,34.45541338304662,0.6435931899641577,38.45301418439713,134269.52577404433,1443.7583416563907,0
3145,513.2266997040207,0,0,756,0.0,0.0,1.0,756,19900,13700,6200,0.6884422110552764,261,137,124,149.76395924499994,0.4210906566452924,0.915320511362776,0.10329569521048251,17616582.024211265,356565.81446202635,17973147.83867329,3144,4,2089.34126984127,110,646,81,34.06399235912129,0.6439393939393939,37.98798798798795,134471.56020773295,1222.4687291612086,8
3146,513.2045425118754,1,0,757,0.001321003963011889,0.0,1.0,757,22950,17300,5650,0.7538126361655774,286,173,113,149.9906417028811,0.4212019388703669,0.9143990808731155,0.1039104842699736,17635520.555976033,354682.60899103485,17990203.164967068,3145,0,2087.579920739762,121,636,85,33.90939834114987,0.6432506887052342,37.84153005464479,134540.91763391826,1111.9084101976716,0
3147,513.326027328814,0,0,757,0.0,0.0,1.0,757,22050,15700,6350,0.7120181405895691,284,157,127,153.40119437042915,0.4210165731246753,0.9158958851244989,0.1065412091291771,17650892.99277614,368083.6133592968,18018976.60613544,3146,1,2088.579920739762,124,633,87,33.73551484529745,0.643565188172043,37.758333333333326,134615.47295008655,1085.6086528232786,0
3148,512.982277228814,0,0,757,0.0,0.0,1.0,757,21050,15300,5750,0.7268408551068883,268,153,115,151.50050547240048,0.42078927074523725,0.9151011878462778,0.10545305164497315,17648842.23865056,362311.70403163903,18011153.9426822,3147,2,2089.579920739762,128,629,90,33.711648966189486,0.6436360677083333,37.68572351421187,134562.57490130738,1051.270116416464,0
3149,512.580384026528,0,1,756,0.0,0.001321003963011889,0.9986789960369881,757,22100,16400,5700,0.7420814479638009,278,164,114,153.5590680265714,0.4207701225947593,0.9174534616859629,0.10733525199671708,17653577.14440519,368673.3707260052,18022250.515131194,3148,3,2090.579920739762,130,627,95,33.51751701710796,0.6447115384615385,37.54770992366411,134527.895635969,1034.8299664305307,0
3150,512.4304248831753,0,0,756,0.0,0.0,1.0,756,21100,14700,6400,0.6966824644549763,275,147,128,151.8224222909295,0.4206186052419496,0.9170379542369689,0.10658010146288169,17667442.32668222,364162.7779444443,18031605.104626667,3149,4,2094.318783068783,99,657,99,33.419488079654094,0.6524621212121212,37.40625000000003,134561.0268841678,1359.2022917592708,0
3151,511.9837972541886,0,0,756,0.0,0.0,1.0,756,20550,14800,5750,0.7201946472019465,263,148,115,151.5055489010482,0.4204902720838151,0.9170596404880911,0.1066842933036325,17665529.00895012,363535.13382568024,18029064.142775804,3150,5,2095.318783068783,101,655,101,33.32600364135859,0.6529496699669968,37.30596405228761,134495.0900405393,1331.6345548568247,0
3152,512.2229168142974,0,1,755,0.0,0.0013227513227513227,0.9986772486772487,756,21300,14900,6400,0.6995305164319249,277,149,128,156.43569775045043,0.42040453414625595,0.9193869716505174,0.11065190243577785,17693499.040299404,381078.973603238,18074578.01390264,3151,6,2096.318783068783,103,653,92,33.047690724792304,0.6539239482200647,37.15945512820515,134632.95055129126,1307.116024769818,0
3153,512.6638964619432,0,0,755,0.0,0.0,1.0,755,21350,15500,5850,0.7259953161592506,272,155,117,155.42086143622166,0.42003647946785655,0.9181536237291283,0.1103488116197184,17725231.152706996,378624.13898198,18103855.291688975,3152,7,2100.056953642384,107,648,74,32.95004401408451,0.6542056074766356,37.03703703703706,134811.61721777153,1259.9216562408556,0
3154,512.4437927322549,0,1,754,0.0,0.0013245033112582781,0.9986754966887417,755,20650,14700,5950,0.711864406779661,266,147,119,157.82706671980142,0.4198707701676416,0.919157107954546,0.11253772761799655,17736314.95389328,388204.1127183074,18124519.066611588,3153,8,2101.056953642384,115,640,74,32.74589149800336,0.6538949275362319,36.89834770114943,134824.80857814642,1172.389639809969,0
3155,512.9081958195175,0,0,754,0.0,0.0,1.0,754,19550,13600,5950,0.6956521739130435,255,136,119,158.77748648588118,0.41940505000334644,0.9196618168344222,0.11366309018408557,17769600.370998126,393932.49655313336,18163532.86755126,3154,9,2104.8262599469494,119,635,79,32.5913467880227,0.6544117647058824,36.770833333333336,135012.39696207517,1134.5579576644973,0
3156,513.3108185654464,0,0,754,0.0,0.0,1.0,754,19250,14200,5050,0.7376623376623377,243,142,101,160.448888778431,0.4193982249604588,0.920634930792088,0.11506794701805435,17791445.667707413,400873.5374290982,18192319.20513651,3155,10,2105.8262599469494,122,632,80,32.48797806298048,0.6544569672131147,36.712398373983746,135148.3743087839,1107.7735599080647,0
3157,513.2156684096709,0,0,754,0.0,0.0,1.0,754,21350,15200,6150,0.711943793911007,275,152,123,161.35167935141303,0.41936061383701856,0.9214388303437184,0.11603950225427112,17800314.038772773,402272.1126277021,18202586.151400477,3156,11,2106.8262599469494,126,628,83,32.37273312364401,0.6546792328042328,36.62237532808398,135169.52369014831,1072.7739975408597,0
3158,513.4780336018612,0,0,754,0.0,0.0,1.0,754,21350,14900,6450,0.6978922716627635,278,149,129,160.98642909801325,0.4191855111237925,0.9220871531356825,0.11625559776039862,17827334.306904387,401841.7780810054,18229176.08498539,3157,12,2107.8262599469494,131,623,90,32.24774397061174,0.6552162849872774,36.48989898989898,135306.64850089385,1032.8751793961362,0
3159,513.2141847886309,0,1,753,0.0,0.001326259946949602,0.9986737400530504,754,19850,13900,5950,0.7002518891687658,258,139,119,168.25384284360294,0.419140634632117,0.9254887985091627,0.12046378238181689,17780813.135986168,427688.0278027379,18208501.163788907,3158,13,2108.8262599469494,114,640,72,32.3372962618859,0.6554276315789473,36.766304347826086,135095.266523029,1185.0461975704297,8
3160,512.8679358235948,0,1,752,0.0,0.0013280212483399733,0.99867197875166,753,22100,17000,5100,0.7692307692307693,272,170,102,172.59233638759085,0.41907731073342563,0.9274249605919376,0.12409206456182258,17787154.57182209,441285.3130475972,18228439.884869687,3159,14,2112.5644090305445,120,633,76,32.08495407446148,0.6556423611111111,36.630509641873275,135073.76687888431,1125.6147239907027,0
3161,513.3166460732332,1,0,753,0.0013280212483399733,0.0,1.0,753,21600,15800,5800,0.7314814814814815,274,158,116,172.44747544710444,0.41917274754410255,0.92779732650905,0.12434370598027943,17815162.962552547,442235.97551418294,18257398.938066732,3160,0,2112.565737051793,129,624,81,31.995133819951338,0.6550387596899225,36.53846153846152,135239.19329236972,1048.3658394757342,0
3162,513.0041170467265,0,0,753,0.0,0.0,1.0,753,20850,15100,5750,0.7242206235011991,266,151,115,175.08369931023543,0.419067671394799,0.9299680297660708,0.12665857539617875,17818501.137714032,452495.8190709202,18270996.956784952,3161,1,2113.565737051793,83,670,83,31.818912518427883,0.6674196787148594,36.43353174603173,135210.68332975058,1629.0443774668745,0
3163,512.640278690398,0,0,753,0.0,0.0,1.0,753,21600,15400,6200,0.7129629629629629,278,154,124,171.91789136447255,0.41901344091718234,0.9284632821174927,0.12468665562881402,17816908.688793797,440409.0744821524,18257317.76327595,3162,2,2114.565737051793,87,666,87,31.819214968796288,0.6667863984674329,36.35179924242422,135156.68711258474,1553.5251392251118,0
3164,512.4001952875045,0,1,752,0.0,0.0013280212483399733,0.99867197875166,753,21550,15500,6050,0.7192575406032483,276,155,121,172.0991337148783,0.41903507424203895,0.9280554387919746,0.1252079614753545,17822010.207182348,441280.50354275433,18263290.710725103,3163,3,2115.565737051793,90,663,90,31.713214125544344,0.6667824074074074,36.25228937728935,135144.3784297079,1501.6042047745323,0
3165,512.0517025587277,0,0,752,0.0,0.0,1.0,752,19500,14500,5000,0.7435897435897436,245,145,100,171.47167364187172,0.4188498520884683,0.927033647472667,0.12509252159022186,17821630.47476758,441280.9609070735,18262911.435674652,3164,4,2117.280585106383,95,657,86,31.641347933374448,0.6661184210526316,36.16536458333332,135096.9742590648,1422.0734132533137,0
3166,512.4597788140242,0,0,752,0.0,0.0,1.0,752,20650,14900,5750,0.7215496368038741,264,149,115,167.47211483285793,0.41875382911437237,0.9248086885095197,0.12295918169038729,17863298.93119906,427270.88997989084,18290569.82117895,3165,5,2118.280585106383,104,648,68,31.54040641242411,0.6657652243589743,35.9623015873016,135308.70052713624,1301.04519737631,0
3167,512.5734522450102,0,0,752,0.0,0.0,1.0,752,20750,14800,5950,0.7132530120481928,267,148,119,166.440993998248,0.4185758748973001,0.9237795914549134,0.122744879207458,17886217.887102213,424249.9767997105,18310467.863901924,3166,6,2119.280585106383,112,640,73,31.425271012166508,0.6653645833333333,35.82227138643069,135410.4903617034,1209.0222353723518,0
3168,512.7969159884886,0,0,752,0.0,0.0,1.0,752,21850,16000,5850,0.7322654462242563,277,160,117,166.04759269959484,0.41839069036792553,0.923487442615547,0.1228901218969712,17909164.51410301,422504.7309655687,18331669.24506858,3167,7,2120.280585106383,116,636,78,31.322006063668535,0.6656788793103448,35.71047008547011,135526.85586821966,1168.334964381204,0
3169,513.1548002842228,0,0,752,0.0,0.0,1.0,752,21600,15600,6000,0.7222222222222222,276,156,120,168.59193454264437,0.41826973019425634,0.9241765308765924,0.1250925489873936,17932561.886802044,432657.05996033427,18365218.94676238,3168,8,2121.280585106383,121,631,81,31.173060050167443,0.665547520661157,35.63012295081969,135662.67145833772,1121.1791029614687,0
3170,513.5761285828813,0,0,752,0.0,0.0,1.0,752,19050,13100,5950,0.6876640419947506,250,131,119,168.7868530816775,0.41812224657902936,0.9240922230786985,0.12566116399664898,17961678.096750993,436889.02440334647,18398567.121154338,3169,9,2122.280585106383,125,627,87,31.06013540266536,0.6659166666666667,35.52414021164024,135828.4881737364,1086.6279053898913,0
3171,513.1794704498526,0,1,751,0.0,0.0013297872340425532,0.9986702127659575,752,20550,14700,5850,0.7153284671532847,264,147,117,169.7832353644861,0.4178991029100679,0.925027348014237,0.12688405587568446,17963932.51917114,439044.9165948322,18402977.435765974,3170,10,2123.280585106383,91,661,91,30.912970530760106,0.6750228937728937,35.40534420289853,135784.54534581667,1492.1378609430403,0
3172,512.6895688955026,0,0,751,0.0,0.0,1.0,751,22500,16800,5700,0.7466666666666667,282,168,114,167.65168047169607,0.4177434531735464,0.9231365446438113,0.12588786269244742,17966881.764194693,429735.5841206941,18396617.348315388,3171,11,2127.010652463382,97,654,97,30.818770827478172,0.6747207903780068,35.257227891156425,135730.85770068146,1399.2871927905305,0
3173,512.9746140046856,0,1,750,0.0,0.0013315579227696406,0.9986684420772304,751,19850,14000,5850,0.7052896725440806,257,140,117,169.9183456100019,0.4176913004882379,0.9238442201675032,0.12803706324133776,17991637.93911002,441371.8706855349,18433009.809795555,3172,12,2128.010652463382,100,651,100,30.648202232606415,0.675,35.14851485148511,135862.08836262516,1358.6208836262515,0
3174,512.8666608983265,1,0,751,0.0013315579227696406,0.0,1.0,751,21500,15800,5700,0.7348837209302326,272,158,114,168.10995568329798,0.41774582038763136,0.9215903367319962,0.1273612674540534,18010604.76946332,433852.39392476884,18444457.16338809,3173,0,2128.4300932090546,109,642,70,30.52582839038566,0.6745030581039755,34.98106060606058,135919.3785217842,1246.966775429213,0
3175,512.8190014599795,0,0,751,0.0,0.0,1.0,751,19850,14400,5450,0.72544080604534,253,144,109,168.86286853634581,0.4175604379346057,0.9218816470701392,0.1283419189610562,18022363.112413317,438611.5865931431,18460974.69900646,3174,1,2129.4300932090546,114,637,71,30.40539193913924,0.6744334795321638,34.88224637681158,135957.4216823554,1192.6089621259246,0
3176,512.3194793528958,0,1,750,0.0,0.0013315579227696406,0.9986684420772304,751,22700,16900,5800,0.7444933920704846,285,169,116,145.50382547405812,0.417250480840361,0.9130510920430028,0.10757024295975326,17887911.662936516,347651.91533986386,18235563.57827638,3175,2,2130.4300932090546,123,628,85,31.899265929151973,0.6640413279132791,35.74428763440863,135383.3489751701,1100.6776339444725,8
3177,511.80564129328036,1,0,751,0.0013315579227696406,0.0,1.0,751,20750,15000,5750,0.7228915662650602,265,150,115,147.67503930135982,0.41704386743601124,0.9147763689422868,0.10971653012118,17890991.25088267,357460.56722288334,18248451.818105552,3176,0,2131.40878828229,126,625,90,31.684218961648625,0.6650958994708995,35.588910761154885,135327.08709294384,1074.0245007376495,0
3178,512.2948567991599,0,0,751,0.0,0.0,1.0,751,22950,17000,5950,0.7407407407407407,289,170,119,150.92753550031532,0.41690353602603936,0.9172811621213166,0.11269522876217312,17929308.60818946,368055.27229173185,18297363.88048119,3177,1,2132.40878828229,132,619,95,31.43927619893431,0.665719696969697,35.432330827067695,135536.6561926365,1026.792849944216,0
3179,512.7241868958059,0,0,751,0.0,0.0,1.0,751,21100,15100,6000,0.7156398104265402,271,151,120,151.9389668123135,0.41668493860038464,0.9177221069581629,0.11400132753472969,17964834.316466436,374611.67299965676,18339445.989466093,3178,2,2133.40878828229,99,652,99,31.259140662915268,0.6739267676767677,35.28124999999998,135727.70584982313,1370.9869277759913,0
3180,513.129772026046,0,0,751,0.0,0.0,1.0,751,20500,14400,6100,0.7024390243902439,266,144,122,148.34726123676577,0.416599053114366,0.9151678303904955,0.11191436962320124,18002038.80013398,363410.6305355686,18365449.43066955,3179,3,2134.40878828229,105,646,94,31.182487788289123,0.6741071428571428,35.11202830188677,135921.90452989307,1294.4943288561244,0
3181,513.3187591333194,0,0,751,0.0,0.0,1.0,751,21600,15000,6600,0.6944444444444444,282,150,132,146.94668632872919,0.41623775706465455,0.9141637220190948,0.11138582068645562,18028670.289166205,358050.6715812334,18386720.96074744,3180,4,2135.40878828229,112,639,76,31.070368566890416,0.6740141369047619,34.96497050147491,136047.45246904454,1214.7093970450405,0
3182,513.7271660584414,0,0,751,0.0,0.0,1.0,751,20250,14100,6150,0.6962962962962963,264,141,123,142.45981154397782,0.4159754401538689,0.9112529007334893,0.10851463983186618,18063568.861327216,344216.5231592659,18407785.38448648,3181,5,2136.40878828229,120,631,83,31.036215534778993,0.6739583333333333,34.81404958677685,136233.22678429875,1135.2768898691563,0
3183,513.7323238430723,0,0,751,0.0,0.0,1.0,751,21250,14400,6850,0.6776470588235294,281,144,137,145.34068451605256,0.41573132120136114,0.912524776380929,0.11100011203250852,18074748.237862844,353949.25626925594,18428697.4941321,3182,6,2137.40878828229,124,627,85,30.877929442070847,0.6740591397849462,34.73333333333332,136276.0611047714,1099.0004927804143,0
3184,513.3007712210831,0,1,750,0.0,0.0013315579227696406,0.9986684420772304,751,20700,15000,5700,0.7246376811594203,264,150,114,145.16429199188104,0.4155725699067909,0.9127131396289614,0.11126350813420655,18074536.982542116,353855.4728303545,18428392.45537247,3183,7,2138.40878828229,129,622,89,30.77107677365458,0.6743378552971576,34.62339743589742,136218.01476018332,1055.9536027921188,0
3185,512.9758664269655,0,0,750,0.0,0.0,1.0,750,21050,15000,6050,0.7125890736342043,271,150,121,142.57012354438075,0.41516106660732827,0.9115507856826892,0.10967078611396605,18078146.06628808,344430.7036248089,18422576.769912887,3184,8,2141.6653333333334,135,615,95,30.727814321158604,0.674537037037037,34.51286764705882,136188.49174396007,1008.8036425478524,0
3186,513.1085998860076,0,0,750,0.0,0.0,1.0,750,20700,16000,4700,0.7729468599033816,254,160,94,142.35871153923955,0.41504342827473667,0.9121961959718761,0.1099775728898357,18100595.46030733,344655.4895644711,18445250.9498718,3185,9,2142.6653333333334,139,611,102,30.60114312258979,0.6752847721822541,34.382440476190474,136290.65407240007,980.5083026791372,0
3187,513.3143704368284,0,0,750,0.0,0.0,1.0,750,20800,15300,5500,0.7355769230769231,263,153,110,139.86752355045383,0.41479591306927754,0.9108490420894524,0.1085653547171984,18127456.958290745,336288.5026047182,18463745.460895464,3186,10,2143.6653333333334,106,644,106,30.521569776670685,0.682684748427673,34.238707165109055,136419.09071802086,1286.972553943593,0
3188,513.5246711179407,0,0,750,0.0,0.0,1.0,750,19700,13800,5900,0.700507614213198,256,138,118,134.7469283476364,0.41465669040201747,0.9071093549522535,0.10512265680312484,18155847.086687766,319588.9252961153,18475436.011983883,3187,11,2144.6653333333334,114,636,106,30.502023935234085,0.6824744152046784,34.08514492753625,136553.83849646282,1197.8406885654633,0
3189,513.2598426440544,0,0,750,0.0,0.0,1.0,750,20900,15000,5900,0.7177033492822966,268,150,118,135.4101719475117,0.4144590194333185,0.9080487925640861,0.10594612027018548,18158400.953732245,320866.4390873531,18479267.3928196,3188,12,2145.6653333333334,115,635,104,30.395905070555703,0.6831521739130435,33.99784482758623,136528.22430677354,1187.201950493683,0
3190,512.8855503866745,0,0,750,0.0,0.0,1.0,750,18850,13900,4950,0.7374005305039788,238,139,99,133.7489283147331,0.41427907580477674,0.9069095851682689,0.10499547752850648,18158842.04257777,316895.1325262638,18475737.175104033,3189,13,2146.6653333333334,119,631,78,30.338477953569292,0.6833858543417367,33.897569444444464,136480.09155471923,1146.8915256699095,0
3191,513.0717548861978,0,0,750,0.0,0.0,1.0,750,20200,13700,6500,0.6782178217821783,267,137,130,133.97094723733744,0.4141738614448895,0.9065418047533367,0.10535124153190832,18172508.036257293,316717.62305910676,18489225.6593164,3190,14,2147.6653333333334,123,627,79,30.280072646740138,0.683180894308943,33.84576612903227,136556.21984256973,1110.2131694517864,0
3192,513.23985392338,0,0,750,0.0,0.0,1.0,750,23000,17800,5200,0.7739130434782608,282,178,104,133.43473154066697,0.41385002225189144,0.9064303070734019,0.10542430706152701,18197725.834463336,312641.7322744574,18510367.566737793,3191,15,2148.6653333333334,128,622,86,30.151477247457894,0.6837565104166667,33.704780361757116,136673.3196276269,1067.760309590835,0
3193,512.7772170633461,0,0,750,0.0,0.0,1.0,750,20050,13500,6550,0.6733167082294265,266,135,131,133.14452510226093,0.41360321168966024,0.9066365479293395,0.10568920578807058,18200439.652529623,314607.7788376825,18515047.431367304,3192,16,2149.6653333333334,134,616,90,30.017376194613423,0.6842350746268657,33.56481481481482,136621.89278701646,1019.5663640822124,0
3194,512.9236230766055,0,1,749,0.0,0.0013333333333333333,0.9986666666666667,750,21050,15100,5950,0.7173396674584323,270,151,119,135.32193367361052,0.41349150719477823,0.908765663949022,0.10787541866361089,18222936.81788872,322142.609481745,18545079.427370466,3193,17,2150.6653333333334,138,612,95,29.831084247024677,0.6849335748792271,33.43824940047961,136725.8188911482,990.7668035590449,0
3195,513.1127885365346,0,0,749,0.0,0.0,1.0,749,21050,15000,6050,0.7125890736342043,271,150,121,136.82555959217774,0.41319761761969015,0.9102788762575666,0.10943296653032938,18242992.192350294,328371.52307081176,18571363.715421107,3194,18,2154.4165554072097,139,610,99,29.6921940251309,0.6857763788968825,33.34077380952381,136826.2591395898,984.3615765438115,0
3196,512.5862895974453,0,0,749,0.0,0.0,1.0,749,20600,14800,5800,0.7184466019417476,264,148,116,135.7414138909945,0.4129111393920355,0.9092521394227262,0.10885063514998745,18234875.167846568,324645.5474818574,18559520.715328425,3195,19,2155.4165554072097,103,646,103,29.642498404115525,0.6932645631067962,33.26322115384616,136725.61576792473,1327.4331627953857,0
3197,512.1891420499333,0,0,749,0.0,0.0,1.0,749,19850,14000,5850,0.7052896725440806,257,140,117,136.52647688018834,0.41273056588820745,0.9097469266675615,0.11015258662339174,18245436.93148953,328547.0446791883,18573983.97616872,3196,20,2156.4165554072097,107,642,107,29.43843198188429,0.694119937694704,33.08256172839506,136712.21370649955,1277.6842402476593,0
3198,512.1160961795882,0,1,748,0.0,0.0013351134846461949,0.9986648865153538,749,22900,16800,6100,0.7336244541484717,290,168,122,139.9853232839543,0.41239418452172716,0.9111463728975484,0.1136326294060894,18267268.3078942,338729.8919190625,18605998.19981326,3197,21,2157.4165554072097,113,636,74,29.164920518171385,0.6945980825958702,32.903874269005854,136784.22521404957,1210.479869150881,0
3199,512.5315391702129,0,0,748,0.0,0.0,1.0,748,21000,15100,5900,0.719047619047619,269,151,118,140.26469918374562,0.41221306050106543,0.9108164921001645,0.11425005153104469,18295806.968277905,342651.17214587715,18638458.140423782,3198,22,2161.1697860962568,117,631,78,29.05585106382979,0.6948005698005698,32.80367231638419,136946.54508831247,1170.4832913530981,0
3200,513.002721857644,0,0,748,0.0,0.0,1.0,748,20800,13700,7100,0.6586538461538461,279,137,142,139.3059549028025,0.41185661391853806,0.9101610530132818,0.11384047142694009,18325697.42664777,340175.7558558005,18665873.18250357,3199,23,2162.1697860962568,119,629,84,28.984801247077133,0.6953781512605042,32.708333333333336,137121.3525298664,1152.2802733602218,0
3201,512.9796309161223,0,0,748,0.0,0.0,1.0,748,22100,15500,6600,0.7013574660633484,287,155,132,140.46917970513826,0.4116109044019214,0.9106791269136225,0.11524265279314337,18340540.950997956,343556.1485470357,18684097.09954499,3200,24,2163.1697860962568,123,625,88,28.837857083019205,0.6957994579945799,32.594086021505376,137173.78705747655,1115.2340411176956,0
3202,512.8757230988589,0,0,748,0.0,0.0,1.0,748,20800,15000,5800,0.7211538461538461,266,150,116,142.51068682256354,0.4112464042146005,0.9119818063233553,0.11730369501829885,18349949.915394228,352612.7931204958,18702562.708514724,3201,25,2164.1697860962568,130,618,89,28.686226132794314,0.6955929487179487,32.4984096692112,137195.07157099838,1055.3467043922951,0
3203,513.206681844521,0,0,748,0.0,0.0,1.0,748,20800,15400,5400,0.7403846153846154,262,154,108,142.2078148980612,0.4109808589676591,0.9117573213944887,0.11755105891538119,18378610.93394197,352316.4203555016,18730927.354297474,3202,26,2165.1697860962568,135,613,97,28.570095542008893,0.6960648148148147,32.37591911764706,137346.46653132216,1017.3812335653494,0
3204,513.0430679198874,0,0,748,0.0,0.0,1.0,748,20750,14500,6250,0.6987951807228916,270,145,125,144.0818356897076,0.41053828355609007,0.9128507843675779,0.119826853299731,18396824.8802021,359779.65992031735,18756604.540122416,3203,27,2166.1697860962568,102,646,102,28.342145015105746,0.7042483660130718,32.20064724919092,137392.6015222344,1346.9862894336707,0
3205,512.783792266892,0,0,748,0.0,0.0,1.0,748,21400,16200,5200,0.7570093457943925,266,162,104,142.96856745925197,0.4102263555111712,0.912350193938668,0.11953422997413209,18408456.30808003,355366.12550048233,18763822.43358051,3204,28,2167.1697860962568,106,642,106,28.2174193431187,0.7047955974842768,32.04828660436135,137401.295739426,1296.2386390511886,0
3206,513.0164789793613,0,0,748,0.0,0.0,1.0,748,20550,14700,5850,0.7153284671532847,264,147,117,155.18208030943845,0.4099850083638177,0.9176060161307369,0.11972833755697938,18091949.687509242,391359.2778722858,18483308.96538153,3205,29,2168.1697860962568,154,594,94,30.300749025760457,0.6730248917748918,34.422043010752716,136245.86838915813,884.7134310984294,8
3207,512.7638954912521,0,1,747,0.0,0.001336898395721925,0.9986631016042781,748,21100,15500,5600,0.7345971563981043,267,155,112,154.65079617419119,0.40964996349032495,0.9179371058894923,0.11978694561153089,18099283.416968204,389113.7181232946,18488397.1350915,3206,30,2169.1697860962568,100,648,100,30.193777010066484,0.6835416666666667,34.302805280528055,136239.92858545433,1362.3992858545432,0
3208,512.9524832845203,0,0,747,0.0,0.0,1.0,747,19650,13400,6250,0.6819338422391857,259,134,125,151.32631751514052,0.40948288237848623,0.9159749056641582,0.11230005668228879,17926186.500315674,373490.75803648104,18299677.258352153,3207,31,2172.9745649263723,119,628,87,31.624310480693435,0.6659663865546219,35.62500000000001,135611.81276834552,1139.5950652802144,8
3209,512.8135947561708,0,0,747,0.0,0.0,1.0,747,21700,14500,7200,0.6682027649769585,289,145,144,150.82534784114546,0.4092215600561316,0.9162759962701501,0.11222608238543431,17932632.45826211,369839.1056449626,18302471.563907072,3208,32,2173.9745649263723,124,623,88,31.55296465521773,0.6659106182795699,35.54166666666668,135617.82857989307,1093.6921659668797,0
3210,512.7521947987725,0,0,747,0.0,0.0,1.0,747,19700,14600,5100,0.7411167512690355,248,146,102,151.89477789619872,0.40926552501336894,0.9164901987799003,0.11341569058776413,17945248.645020198,376057.91144548525,18321306.55646568,3209,33,2174.9745649263723,128,619,95,31.414179180401263,0.6663411458333333,35.432816537467716,135657.4039921439,1059.8234686886242,0
3211,512.7159536575278,0,0,747,0.0,0.0,1.0,747,22900,17200,5700,0.7510917030567685,286,172,114,149.8203720182252,0.4091476121943837,0.9159560223326442,0.11249270009998606,17967587.79735895,366082.1376140835,18333669.93497303,3210,34,2175.9745649263723,98,649,98,31.292476451651336,0.6744260204081632,35.25883838383836,135737.01715043077,1385.0716035758242,0
3212,512.2558248354183,0,0,747,0.0,0.0,1.0,747,20250,14900,5350,0.7358024691358025,256,149,107,146.59367874778914,0.40897347208314944,0.9139226168047161,0.11040692163843258,17964349.291319236,357042.0097849371,18321391.301104173,3211,35,2176.9745649263723,102,645,102,31.281504181464054,0.6743259803921569,35.16383495145627,135663.86817318868,1330.0379232665557,0
3213,511.8628586853888,0,0,747,0.0,0.0,1.0,747,19250,12300,6950,0.638961038961039,262,123,139,144.16775884665967,0.4087952943738014,0.912258908942895,0.1089108910891086,17963366.161386564,349297.64816579665,18312663.80955236,3212,36,2177.9745649263723,107,640,94,31.250000000000004,0.6740654205607477,35.06944444444441,135608.11151977273,1267.365528222175,0
3214,512.0903633152541,0,0,747,0.0,0.0,1.0,747,20500,14100,6400,0.6878048780487804,269,141,128,143.39479445181846,0.4086954012056567,0.9124574253989708,0.10875183549688648,17987776.634409927,345970.70662727987,18333747.341037206,3213,37,2178.9745649263723,108,639,77,31.147692446367397,0.6750578703703703,34.94839449541281,135730.3729601337,1256.7627125938307,0
3215,512.1256509712018,0,0,747,0.0,0.0,1.0,747,20500,14900,5600,0.7268292682926829,261,149,112,144.2234048323172,0.40851520469725194,0.9136562288402608,0.11005211431373048,18014630.49368462,349726.2693190512,18364356.76300367,3214,38,2179.9745649263723,110,637,83,30.93437470516086,0.6765151515151515,34.75975975975974,135836.33069678975,1234.8757336071797,0
3216,512.2665360352279,0,0,747,0.0,0.0,1.0,747,20200,14900,5300,0.7376237623762376,255,149,106,142.42516283750376,0.40834106458601754,0.9127610894223808,0.10922438073123522,18040418.798133276,344281.916996174,18384700.71512945,3215,39,2180.9745649263723,116,631,88,30.826609972379707,0.6768139367816092,34.60648148148146,135952.2184176812,1172.0018829110447,0
3217,512.6936520891876,0,0,747,0.0,0.0,1.0,747,21750,16000,5750,0.735632183908046,275,160,115,143.46490931259794,0.408283042805718,0.9134186031041758,0.1103152695141533,18066549.0106907,347233.1630820616,18413782.173772763,3216,40,2181.9745649263723,124,623,88,30.716365320023826,0.6761592741935484,34.52499999999997,136107.34728837517,1097.6398974868964,0
3218,512.4606073627529,0,0,747,0.0,0.0,1.0,747,21300,15500,5800,0.7276995305164319,271,155,116,142.40810742681504,0.40807660190957457,0.913313024325483,0.10989568658959699,18073211.04576452,344054.35603054054,18417265.40179506,3217,41,2182.9745649263723,127,620,93,30.633554210714443,0.676755249343832,34.41569010416664,136101.4967552348,1071.6653287813765,0
3219,512.2418430623385,0,0,747,0.0,0.0,1.0,747,19300,14500,4800,0.7512953367875648,241,145,96,144.60363140163173,0.4078777875876458,0.9144555023163803,0.11197863752373118,18079891.25153056,354183.58606358635,18434074.837594148,3218,42,2183.9745649263723,95,652,95,30.467920444335544,0.6848684210526316,34.30989583333336,136097.58864175912,1432.6061962290435,0
3220,512.3756482969067,0,1,746,0.0,0.0013386880856760374,0.998661311914324,747,20550,14600,5950,0.7104622871046229,265,146,119,142.88019271608823,0.4077050681127848,0.913081881858673,0.11112233213833733,18102431.79627147,347345.78873622883,18449777.585007697,3219,43,2184.9745649263723,100,647,100,30.380987946509393,0.6847916666666667,34.17904290429046,136200.18522282003,1362.0018522282003,0
3221,512.3168666114233,0,0,746,0.0,0.0,1.0,746,21150,14800,6350,0.6997635933806147,275,148,127,144.10248225818373,0.4074536603870906,0.9131051231173928,0.11246093192107053,18114592.325413115,351721.54383742035,18466313.869250536,3220,44,2188.572386058981,103,643,95,30.242467043314555,0.6850728155339806,34.07451923076926,136238.1090598302,1322.7000879595164,0
3222,512.7078658296322,0,0,746,0.0,0.0,1.0,746,19900,13700,6200,0.6884422110552764,261,137,124,142.0798210428445,0.407317887795311,0.9114977152660162,0.11121861356998486,18140872.807970494,346390.3924234961,18487263.20039399,3221,45,2189.572386058981,108,638,100,30.203618216218874,0.6847993827160495,33.98318042813459,136388.915837479,1262.8603318285093,0
3223,513.0061541491667,0,0,746,0.0,0.0,1.0,746,19050,13000,6050,0.6824146981627297,251,130,121,139.4372723756405,0.4070908004510259,0.9096577703393964,0.10961914797531272,18169037.54036274,338438.2072637664,18507475.74762651,3222,46,2190.572386058981,113,633,79,30.143101761252442,0.6850110619469026,33.8541666666667,136534.45040116034,1208.2694725766403,0
3224,512.864915547773,0,0,746,0.0,0.0,1.0,746,21750,16700,5050,0.767816091954023,268,167,101,141.07864447539512,0.4068462823350187,0.9104521067466591,0.1113880701945667,18181660.716810778,342058.8096478503,18523719.52645863,3223,47,2191.572386058981,116,630,83,29.968500624136293,0.6857040229885057,33.72507122507127,136563.06885864562,1177.2678349883242,0
3225,512.6036995544894,0,0,746,0.0,0.0,1.0,746,16800,10900,5900,0.6488095238095238,227,109,118,142.63956007796912,0.4064080015114166,0.911582039751474,0.11305938901262158,18188271.93090621,352873.42136059573,18541145.352266807,3224,48,2192.572386058981,120,626,86,29.80902328938297,0.6861111111111111,33.60881542699728,136553.1067408264,1137.9425561735532,0
3226,512.2600539176236,0,0,746,0.0,0.0,1.0,746,19800,14600,5200,0.7373737373737373,250,146,104,144.6544599085165,0.4062463264180027,0.9131394471913381,0.11509096824791452,18191464.081804145,357295.2823397187,18548759.364143863,3225,49,2193.572386058981,127,619,89,29.64099588778964,0.6860236220472441,33.49609375000003,136519.30538488418,1074.955160510899,0
3227,512.3457986132079,0,0,746,0.0,0.0,1.0,746,21300,15400,5900,0.7230046948356808,272,154,118,148.12748808687,0.40618361312533363,0.9150266363811057,0.11825186900743637,18208180.014056835,368926.3936231614,18577106.407679997,3226,50,2194.572386058981,132,614,93,29.446851743047453,0.6862373737373737,33.39598997493736,136593.44442977538,1034.7988214376924,0
3228,512.3929016400339,0,0,746,0.0,0.0,1.0,746,19850,12700,7150,0.6397984886649875,270,127,143,146.21549334105976,0.4058802427263077,0.9142212417527973,0.11718254150134771,18225676.808329247,363925.26520091237,18589602.07353016,3227,51,2195.572386058981,97,649,97,29.380330171761024,0.6946950171821306,33.28018707482992,136665.3388696143,1408.9210192743742,0
3229,512.7849128408097,0,0,746,0.0,0.0,1.0,746,21350,15500,5850,0.7259953161592506,272,155,117,140.9345244823692,0.4055801710539732,0.9106172853643453,0.11357566219264621,18261927.511908337,344197.2140044588,18606124.725912794,3228,52,2196.572386058981,105,641,105,29.35583744507448,0.6942460317460317,33.11713836477987,136853.50494232215,1303.3667137364014,0
3230,512.8236872954323,0,0,746,0.0,0.0,1.0,746,21100,15400,5700,0.7298578199052133,268,154,114,141.22044467727852,0.4053050272594778,0.910646373335469,0.11413758486251112,18275025.31480168,345861.4402889624,18620886.755090643,3229,53,2197.572386058981,106,640,102,29.26140162150991,0.694870283018868,33.03154205607476,136907.7489943791,1291.5825376828218,0
3231,512.5622175068868,0,0,746,0.0,0.0,1.0,746,19900,14400,5500,0.7236180904522613,254,144,110,141.01832358453194,0.4050862991885132,0.910913461729318,0.11433840005072006,18278525.534051448,346421.40568179736,18624946.939733244,3230,54,2198.572386058981,107,639,98,29.171820638761453,0.6955802180685358,32.937885802469125,136885.94946516334,1279.3079389267602,0
3232,512.2977747546806,0,0,746,0.0,0.0,1.0,746,18700,13300,5400,0.7112299465240641,241,133,108,139.7961006045548,0.4049096298828652,0.9103549012537315,0.11383396763513717,18286253.944826137,343369.3992302686,18629623.344056405,3231,55,2199.572386058981,111,635,81,29.077322936972084,0.6959459459459459,32.81249999999999,136879.56169226582,1233.1492044348272,0
3233,511.83585360400434,0,0,746,0.0,0.0,1.0,746,20450,14800,5650,0.7237163814180929,261,148,113,139.5090136212463,0.4046092583262861,0.9099425107790646,0.11408243158155404,18286671.1315592,340581.09039598727,18627252.221955188,3232,56,2200.572386058981,117,629,84,28.959681813678575,0.6959579772079771,32.688912429378526,136819.3986845234,1169.3965699531914,0
3234,511.9040199973355,0,0,746,0.0,0.0,1.0,746,21950,15900,6050,0.724373576309795,280,159,121,139.02589167759828,0.40439712770870445,0.9095018037250939,0.11408216100862414,18302907.389668062,337765.60402822256,18640672.993696284,3233,57,2201.572386058981,122,624,88,28.870357761168854,0.6960382513661203,32.588075880758815,136889.2389518625,1122.0429422283812,0
3235,511.5448191564884,0,0,746,0.0,0.0,1.0,746,19000,13700,5300,0.7210526315789474,243,137,106,136.56636238777435,0.40412213385633144,0.9082348647794569,0.11254999156425408,18307237.366543077,331830.5625036664,18639067.929046743,3234,58,2202.572386058981,127,619,93,28.808903675538666,0.6964402887139107,32.46256510416667,136857.3887513803,1077.617234262837,0
3236,511.3463419341201,0,0,746,0.0,0.0,1.0,746,21350,14800,6550,0.6932084309133489,279,148,131,138.00552436676182,0.4037904243961831,0.9094912286721399,0.1143191893823237,18320352.690632306,335111.9759309476,18655464.666563254,3235,59,2203.572386058981,134,612,96,28.620611380145284,0.6968283582089552,32.314814814814824,136879.84023440257,1021.491345032855,0
3237,511.08806202975506,0,0,746,0.0,0.0,1.0,746,19850,14600,5250,0.7355163727959698,251,146,105,137.3303638293643,0.40365836287193146,0.9094165305852226,0.11410122197497498,18322904.977097478,334208.2413831322,18657113.21848061,3236,60,2204.572386058981,98,648,98,28.551220087233332,0.7050382653061225,32.22853535353535,136854.7989330303,1396.4775401329623,0
3238,511.37479507857864,0,0,746,0.0,0.0,1.0,746,21000,15000,6000,0.7142857142857143,270,150,120,137.6964083294752,0.4033053616304107,0.9092853442788642,0.11518481527988329,18359869.265957084,335417.6110641983,18695286.877021283,3237,61,2205.572386058981,104,642,104,28.34393086767119,0.7054286858974359,32.033730158730144,137031.19632804958,1317.6076570004768,0
3239,511.5895605867582,0,0,746,0.0,0.0,1.0,746,18100,12600,5500,0.6961325966850829,236,126,110,149.20396093862902,0.40321779543096364,0.9172335458909109,0.11550419643214929,18055550.592477072,371491.9330650832,18427042.525542155,3238,62,2206.572386058981,93,653,93,30.355535279805334,0.6853718637992832,34.31959219858159,135919.32308363973,1461.4980976735455,8
3240,511.7124910100226,0,0,746,0.0,0.0,1.0,746,21700,16000,5700,0.7373271889400922,274,160,114,148.34242165987263,0.40301653561725176,0.9167354918276001,0.11535283833551406,18078372.32822952,365457.9061676852,18443830.234397206,3239,63,2207.572386058981,97,649,97,30.240489709959476,0.6855670103092784,34.183673469387784,136021.53460011462,1402.283861856852,0
3241,512.2188760380802,0,0,746,0.0,0.0,1.0,746,19200,14100,5100,0.734375,243,141,102,146.8943854716194,0.4028757399643737,0.9155473326569306,0.11458466174086476,18109148.03363674,363626.4343631373,18472774.46799988,3240,64,2208.572386058981,101,645,95,30.182969762142502,0.6854372937293729,34.08905228758173,136204.60676347723,1348.560463004725,0
3242,512.5918401893485,0,0,746,0.0,0.0,1.0,746,20250,14900,5350,0.7358024691358025,256,149,107,145.1920242946572,0.40279177237586294,0.9142483811573574,0.11377774994726894,18141208.052395727,357341.744055581,18498549.796451308,3241,65,2209.572386058981,107,639,73,30.0877924400619,0.6853582554517135,33.95061728395065,136374.74266766163,1274.530305305249,0
3243,512.901323990409,0,0,746,0.0,0.0,1.0,746,18750,13700,5050,0.7306666666666667,238,137,101,144.4790222394751,0.4026738803821725,0.9136519082344419,0.11360048654654287,18165965.311970517,356970.18126195075,18522935.493232466,3242,66,2210.572386058981,110,636,78,30.004157704829424,0.6857007575757577,33.849474474474505,136508.95692278683,1240.9905174798803,0
3244,513.0494516114976,0,0,746,0.0,0.0,1.0,746,19400,13300,6100,0.6855670103092784,255,133,122,146.78842136190795,0.4025783297647108,0.9139684836676596,0.11593068113317569,18189419.03306227,365399.22107069835,18554818.25413297,3243,67,2211.572386058981,116,630,82,29.807429759158353,0.6857938218390804,33.71616809116812,136616.7739338363,1177.7308097744508,0
3245,513.0495191604562,0,0,746,0.0,0.0,1.0,746,21050,15100,5950,0.7173396674584323,270,151,119,148.11023376298968,0.4023829551793008,0.9145730675333612,0.11730854798042231,18201065.18767314,368902.8039363427,18569967.991609484,3244,68,2212.572386058981,118,628,85,29.685754189944127,0.6862641242937852,33.63095238095241,136660.5118001827,1158.1399305100229,0
3246,513.4306871579186,0,0,746,0.0,0.0,1.0,746,19750,14400,5350,0.7291139240506329,251,144,107,147.0443856998508,0.40220433662606236,0.9137430203005463,0.11700484415168859,18233466.852464058,367275.78649984114,18600742.6389639,3245,69,2213.572386058981,123,623,92,29.57410690832681,0.6867378048780488,33.492943548387125,136832.9011263875,1112.4626107836382,0
3247,513.2400636712064,0,0,746,0.0,0.0,1.0,746,19600,13600,6000,0.6938775510204082,256,136,120,150.00963714686918,0.4019540082528144,0.9151856222432313,0.11984310514125669,18242967.01097297,378524.1723596796,18621491.183332648,3246,70,2214.572386058981,127,619,97,29.37437683769299,0.6872539370078741,33.37402343750003,136843.13318733685,1077.5049857270617,0
3248,513.2217880231055,0,0,746,0.0,0.0,1.0,746,19100,13400,5700,0.7015706806282722,248,134,114,152.1836494240507,0.40175233609826605,0.9161742659402046,0.12183432559187694,18250795.33291267,387194.5277308148,18637989.860643484,3247,71,2215.572386058981,97,649,97,29.253520658961083,0.694372852233677,33.312074829931966,136870.05379995407,1411.0314824737534,0
3249,513.4550652962547,0,0,746,0.0,0.0,1.0,746,20150,15500,4650,0.7692307692307693,248,155,93,151.78194527279547,0.40165532354511163,0.9158363090479873,0.12201400314452446,18275761.520837717,385436.126994889,18661197.647832606,3248,72,2216.572386058981,101,645,101,29.140670851514475,0.6945132013201321,33.190359477124176,136994.76139634303,1356.3837762014161,0
3250,513.4971308993789,0,0,746,0.0,0.0,1.0,746,19350,13100,6250,0.6770025839793282,256,131,125,155.02118346582614,0.4014702199950819,0.9174558205132626,0.12507294938482572,18291979.86643431,398578.873365541,18690558.73979985,3249,73,2217.572386058981,103,643,103,28.945152726181117,0.6950849514563107,33.082932692307686,137061.1482505761,1330.690759714331,0
3251,513.1917963109054,0,0,746,0.0,0.0,1.0,746,20650,14800,5850,0.7167070217917676,265,148,117,172.84186709873478,0.40138197905608436,0.9253577693368007,0.129312565811927,17969044.230673313,451310.63096186426,18420354.86163518,3250,74,2218.572386058981,90,656,90,30.796979986734712,0.6756944444444444,35.37087912087912,135805.49390013155,1508.9499322236838,8
3252,513.3887875439787,0,0,746,0.0,0.0,1.0,746,21300,15300,6000,0.7183098591549296,273,153,120,171.44999895327453,0.4014011341622134,0.9239630322836858,0.12876805800039834,17992307.590827383,446456.22352286807,18438763.81435025,3251,75,2219.572386058981,93,653,93,30.711312139857373,0.6759632616487455,35.25044326241134,135919.45393631601,1461.49950469157,0
3253,513.0934763373879,0,0,746,0.0,0.0,1.0,746,20850,15500,5350,0.7434052757793765,262,155,107,167.62601113362757,0.40133448488883294,0.9218857344566651,0.12640552227478838,17999002.475035552,433370.1978548971,18432372.67289045,3252,76,2220.572386058981,99,647,94,30.68500603009802,0.6755050505050505,35.124999999999986,135905.63454486494,1372.784187321868,0
3254,512.6213883527262,0,0,746,0.0,0.0,1.0,746,21400,15800,5600,0.7383177570093458,270,158,112,164.5970129306037,0.40124511938391777,0.9206201862728394,0.12467286881345974,18001083.300115515,421984.90814279165,18423068.208258305,3253,77,2221.572386058981,101,645,73,30.625722543352573,0.6763613861386139,34.98774509803919,135850.9500383284,1345.0589112705782,0
3255,513.0651516368255,0,0,746,0.0,0.0,1.0,746,19500,13500,6000,0.6923076923076923,255,135,120,170.25254257575884,0.40124125837426755,0.9191589283405197,0.12172444374948835,17769554.323812407,436362.3608134245,18205916.68462583,3254,78,2222.572386058981,117,629,83,32.33058853782342,0.6543803418803419,36.8114406779661,135032.87809763665,1154.1271632276637,8
3256,513.3728214212298,0,0,746,0.0,0.0,1.0,746,20650,15100,5550,0.7312348668280871,262,151,111,168.36579899699785,0.4013066706251387,0.9182026161149011,0.12079933165702497,17795529.817443866,429381.7192577612,18224911.536701627,3255,79,2223.572386058981,125,621,88,32.264978230608996,0.6540833333333333,36.69808201058199,135172.0485238475,1081.37638819078,0
3257,513.737899338248,0,0,746,0.0,0.0,1.0,746,21600,16400,5200,0.7592592592592593,268,164,104,168.05721324025885,0.40132248951904564,0.9188098575576285,0.12092750908873204,17820786.47215429,428182.342451988,18248968.81460628,3256,80,2224.572386058981,134,612,90,32.17839426607299,0.6536069651741294,36.60493827160493,135316.02570841316,1009.8210873762176,0
3258,513.3713685128591,0,1,745,0.0,0.0013404825737265416,0.9986595174262735,746,20350,15100,5250,0.742014742014742,256,151,105,168.23719315996834,0.4011969879626464,0.9204546257443313,0.12146511937447964,17822682.11351538,430137.6026720365,18252819.716187418,3257,81,2225.572386058981,134,612,94,32.06381161542215,0.6546952736318408,36.496913580246904,135274.94008267016,1009.5144782288818,0
3259,513.6691823319734,0,0,745,0.0,0.0,1.0,745,19850,14500,5350,0.7304785894206549,252,145,107,166.08115658252945,0.4012149395010945,0.9193307126202481,0.12044064129699866,17852208.140634496,424133.0751097252,18276341.21574422,3258,82,2227.6,100,645,100,31.976554655817644,0.6628125,36.35519801980198,135426.2098592435,1354.262098592435,0
3260,513.0860688451924,0,0,745,0.0,0.0,1.0,745,20200,13900,6300,0.6881188118811881,265,139,126,166.98736426505292,0.4011758497510283,0.919130167414145,0.12149770296526302,17846175.68051319,426817.16781999904,18272992.848333187,3259,83,2228.6,104,641,104,31.84570826750923,0.6628605769230769,36.25000000000001,135326.45065791992,1301.2158717107684,0
3261,512.9660616882543,0,0,745,0.0,0.0,1.0,745,19500,14200,5300,0.7282051282051282,248,142,106,164.6204203992391,0.4011117275264006,0.9178517012591061,0.12008071945602108,17852964.655544627,419292.5093937028,18272257.16493833,3260,84,2229.6,107,638,96,31.825784163193685,0.6629672897196262,36.16898148148148,135336.3585206454,1264.8257805667793,0
3262,513.2759360912029,0,0,745,0.0,0.0,1.0,745,20450,15000,5450,0.7334963325183375,259,150,109,162.39841251383461,0.40105602463255635,0.9162403672450072,0.11907174170354046,17885903.389100056,411478.4633531355,18297381.85245319,3261,85,2230.6,114,631,73,31.718204952250254,0.6631030701754386,36.00543478260871,135502.0575849474,1188.614540218837,0
3263,513.0997640676823,0,0,745,0.0,0.0,1.0,745,20550,14800,5750,0.7201946472019465,263,148,115,163.57964033431907,0.4010970688701258,0.9169739903902705,0.12047408844785464,17898883.60136092,416028.58837929793,18314912.18974022,3262,86,2231.6,120,625,75,31.543603198400792,0.6633680555555556,35.86432506887054,135527.95248902187,1129.3996040751822,0
3264,513.3058675480622,0,0,745,0.0,0.0,1.0,745,22600,16800,5800,0.7433628318584071,284,168,116,162.05995242154745,0.4012213291717784,0.9168982845426796,0.11996457263679193,17927852.38440368,409477.3808874001,18337329.76529108,3263,87,2232.6,126,619,83,31.420556227953128,0.6639384920634921,35.703740157480325,135664.82094817344,1076.7049281601066,0
3265,513.7065224124588,0,0,745,0.0,0.0,1.0,745,18900,12700,6200,0.671957671957672,251,127,124,160.42700042819573,0.4009935562050468,0.9162079304854962,0.11903576835758639,17951894.919222575,408093.7307786142,18359988.65000119,3264,88,2233.6,131,614,87,31.3885219844184,0.6638835877862596,35.629734848484865,135808.72954024567,1036.7078590858448,0
3266,513.1788124030821,0,0,745,0.0,0.0,1.0,745,20150,14000,6150,0.6947890818858561,263,140,123,162.15805871112624,0.40089733528180704,0.9176341193752018,0.1207478607412582,17948550.191885613,412950.41115908156,18361500.603044696,3265,89,2234.6,132,613,92,31.229702784605244,0.6648516414141414,35.5184837092732,135726.31043264267,1028.2296244897173,0
3267,513.4723413655672,0,0,745,0.0,0.0,1.0,745,21000,16100,4900,0.7666666666666667,259,161,98,163.16533800088558,0.40083712203218586,0.9191316277223267,0.12171367380379455,17966357.164382115,416297.3478742124,18382654.512256328,3266,90,2235.6,134,611,93,31.146635456772874,0.6651119402985075,35.462962962962976,135832.45178531806,1013.6750133232691,0
3268,513.5282293997329,0,0,745,0.0,0.0,1.0,745,20100,14200,5900,0.7064676616915423,260,142,118,164.25799765732484,0.4006621202280436,0.9202464117594518,0.12313355006866468,17989196.376692,421873.87525995896,18411070.25195196,3267,91,2236.6,96,649,96,30.96152155685378,0.6744791666666667,35.30927835051543,135926.15762719564,1415.897475283288,0
3269,513.4651512849504,0,0,745,0.0,0.0,1.0,745,21300,15400,5900,0.7230046948356808,272,154,118,165.4827431484311,0.40051621021866207,0.9209423225172331,0.12458974460971661,18005286.82454203,425612.8509798981,18430899.67552193,3268,92,2237.6,98,647,98,30.792260982425443,0.6752763605442177,35.17466329966327,135978.58157292497,1387.5365466624996,0
3270,513.4395592137963,0,0,745,0.0,0.0,1.0,745,20200,14700,5500,0.7277227722772277,257,147,110,161.68844442077955,0.40054891029804435,0.9185782015533872,0.12214681494361734,18018699.046822753,413483.0838733844,18432182.130696137,3269,93,2238.6,104,641,90,30.785823503713388,0.6747796474358974,35.069444444444414,136025.82766670908,1307.9406506414334,0
3271,513.0467102667376,0,0,745,0.0,0.0,1.0,745,19200,13700,5500,0.7135416666666666,247,137,110,161.3816947331807,0.40040901409636526,0.9189400231322091,0.12248905637123453,18024653.887862384,413569.83828044054,18438223.726142824,3270,94,2239.6,109,636,72,30.64640492521669,0.6750764525993884,34.92424242424239,135996.2453957036,1247.6719761073723,0
3272,513.4446085390025,0,0,745,0.0,0.0,1.0,745,21800,16500,5300,0.7568807339449541,271,165,106,162.1737692829991,0.4003565436241611,0.9198351523583672,0.1237571960675989,18061288.55861031,415013.4487315408,18476302.00734185,3271,95,2240.6,116,629,75,30.456302586824187,0.6752873563218391,34.757834757834736,136187.15970079953,1174.027238799996,0
3273,513.105194045234,0,1,744,0.0,0.0013422818791946308,0.9986577181208054,745,19450,13500,5950,0.6940874035989717,254,135,119,163.34416004782418,0.40019589978590847,0.9205576929579622,0.12500695032603226,18061286.205075998,421591.12491029024,18482877.32998629,3272,96,2241.6,119,626,78,30.33613055900889,0.6755952380952381,34.67013888888886,136142.1298714097,1144.0515115244514,0
3274,512.7264200244504,0,0,744,0.0,0.0,1.0,744,19400,13700,5700,0.7061855670103093,251,137,114,163.86425258372745,0.3999352001596743,0.9206879539781998,0.1258980198215625,18064300.962246183,423818.6351251871,18488119.59737137,3273,97,2245.266129032258,124,620,83,30.200223415165006,0.6759072580645161,34.54999999999997,136103.22819548828,1097.6066789958732,0
3275,512.510516071049,0,0,744,0.0,0.0,1.0,744,22150,16300,5850,0.7358916478555305,280,163,117,147.26363432199972,0.39991390673767585,0.9162909759557922,0.10995684696042765,17936755.912442744,357336.3727225932,18294092.285165336,3274,98,2246.266129032258,126,618,92,31.536962115575385,0.6666666666666667,35.433070866141755,135593.3333857279,1076.137566553396,8
3276,512.6831801798821,0,0,744,0.0,0.0,1.0,744,20950,14700,6250,0.7016706443914081,272,147,125,146.14747443618478,0.39987897045060955,0.9154150826905683,0.10966564781058022,17963772.592598233,355321.99915083346,18319094.59174907,3275,99,2247.266129032258,97,647,97,31.409648330321893,0.6745060137457044,35.2784863945578,135718.26745726896,1399.1573964666902,0
3277,513.078769361148,0,0,744,0.0,0.0,1.0,744,20900,15400,5500,0.7368421052631579,264,154,110,144.88780636350438,0.3998829276352287,0.9141742901168792,0.10919328808212311,17995957.736362774,351778.9679663822,18347736.704329155,3276,100,2248.266129032258,102,642,102,31.306162256418048,0.6745302287581699,35.14360841423945,135892.19145225483,1332.276386786812,0
3278,512.6137366624682,0,0,744,0.0,0.0,1.0,744,21450,15300,6150,0.7132867132867133,276,153,123,147.49843808284098,0.3998648376483982,0.9149091614179283,0.11162771212191282,17997280.97282585,360664.16664596176,18357945.139471814,3277,101,2249.266129032258,105,639,97,31.105252178750224,0.6750992063492063,35.013757861635185,135835.58774669078,1293.672264254198,0
3279,512.6705191449589,0,0,744,0.0,0.0,1.0,744,20900,15500,5400,0.7416267942583732,263,155,108,144.79998951792575,0.3995790158564765,0.913584503291853,0.11005592627962325,18017246.546804752,352079.4222238357,18369325.96902859,3278,102,2250.266129032258,108,636,80,31.042582846706587,0.675733024691358,34.88149847094798,135918.43981383095,1258.5040723502866,0
3280,512.1718247733172,0,0,744,0.0,0.0,1.0,744,21450,15800,5650,0.7365967365967366,271,158,113,143.53589616990948,0.39938631980925915,0.9125311043749711,0.10957290574854825,18017984.914502542,346995.5223757986,18364980.436878342,3279,103,2251.266129032258,111,633,86,30.939691444600246,0.6764264264264264,34.747023809523775,135855.10084202758,1223.919827405654,0
3281,512.0388915643207,0,0,744,0.0,0.0,1.0,744,18950,13600,5350,0.7176781002638523,243,136,107,143.0679356024259,0.39910686720020067,0.9122781335858547,0.10955601293737105,18026278.13284268,348046.4798121846,18374324.612654865,3280,104,2252.266129032258,112,632,90,30.855263157894704,0.6771763392857143,34.65154867256634,135868.7268960065,1213.113633000058,0
3282,512.0253315178069,0,0,744,0.0,0.0,1.0,744,21850,16200,5650,0.7414187643020596,275,162,113,144.28367592479657,0.3988781796166852,0.9136903210916982,0.11104461239469561,18046730.00700397,350119.7087665666,18396849.715770535,3281,105,2253.266129032258,118,626,92,30.666782060158475,0.6775247175141244,34.49754901960782,135943.9804820239,1152.0676312035923,0
3283,512.1937127254506,0,0,744,0.0,0.0,1.0,744,20300,14700,5600,0.7241379310344828,259,147,112,141.20334319018468,0.3988471628267654,0.9117916454205361,0.1022377501040611,17794107.01996934,333417.4800607222,18127524.500030063,3282,106,2254.266129032258,98,646,98,32.6836846026931,0.6628401360544218,36.40572390572391,135011.330925905,1377.6666421010714,8
3284,512.2886392893558,0,0,744,0.0,0.0,1.0,744,20900,14500,6400,0.69377990430622,273,145,128,142.93659727686088,0.39900771145988606,0.9085445108853691,0.09847642272429491,17579396.86140942,332847.8339098723,17912244.69531929,3283,107,2255.266129032258,120,624,79,34.2805582027099,0.6415798611111111,38.025137741046805,134206.745714654,1118.3895476221167,8
3285,512.2894727813888,0,0,744,0.0,0.0,1.0,744,19600,14100,5500,0.7193877551020408,251,141,110,149.2938503789038,0.39924009241571273,0.916197138953047,0.09843946720653936,17381167.888955962,350580.29564487864,17731748.18460084,3284,108,2256.266129032258,94,650,94,35.61757236463636,0.6326462765957447,39.50657894736842,133448.0373340728,1419.6599716390724,8
3286,511.9417151527736,1,0,745,0.0013422818791946308,0.0,1.0,745,20250,15500,4750,0.7654320987654321,250,155,95,147.3538801402177,0.3995980521276852,0.9146622959226509,0.09762340859805861,17391090.26476114,343278.92607626546,17734369.190837406,3285,0,2254.236241610738,99,646,99,35.502879017970145,0.6328914141414141,39.34375000000001,133440.80769029047,1347.8869463665703,0
3287,512.220950737645,3,1,747,0.004010695187165776,0.001336898395721925,0.9986631016042781,748,21000,15500,5500,0.7380952380952381,265,155,110,143.01849634710587,0.4001615866317319,0.9119296081389505,0.0953351866858846,17428568.584056795,327921.53447484586,17756490.11853164,3286,0,2246.1911764705883,108,640,78,35.40331049810114,0.6328125,39.13417431192662,133620.94124890672,1237.230937489877,0
3288,512.107091679237,1,0,748,0.001336898395721925,0.0,1.0,748,20350,14200,6150,0.6977886977886978,265,142,123,140.9393587148114,0.40030118244815266,0.9097763805708177,0.09431378074432713,17442278.60534793,321710.712232566,17763989.3175805,3287,0,2247.1898395721923,112,636,86,35.32410023664039,0.6332775297619048,39.002581120943965,133658.62911794183,1193.3806171244808,0
3289,512.0743154544872,0,0,748,0.0,0.0,1.0,748,20800,15200,5600,0.7307692307692307,264,152,112,140.39897698209626,0.4004086011306068,0.9095615246796236,0.09419354838709697,17452789.45177092,319670.75690251583,17772460.208673436,3288,1,2248.1898395721923,116,632,89,35.25000000000002,0.6333512931034483,38.91559829059831,133694.6162811874,1152.5397955274775,0
3290,511.7535729157236,0,0,748,0.0,0.0,1.0,748,20850,14300,6550,0.6858513189448441,274,143,131,140.5025780888466,0.4005530440239866,0.909453922801319,0.09450941481571275,17453659.352695286,320006.82722763973,17773666.179922927,3289,2,2249.1898395721923,123,625,91,35.15774096708483,0.632960704607046,38.82728494623656,133656.07007686375,1086.634716072063,0
3291,511.8641299628762,1,0,749,0.0013351134846461949,0.0,1.0,749,21600,15500,6100,0.7175925925925926,277,155,122,140.57579085440065,0.4010461661300034,0.9100131236117781,0.09491393185260906,17474356.60295299,319894.29982639017,17794250.90277938,3290,0,2247.185580774366,130,619,94,35.027464167249946,0.6330929487179487,38.700699745547084,133749.73898465463,1028.844146035805,0
3292,511.46607518782025,0,0,749,0.0,0.0,1.0,749,19150,13200,5950,0.6892950391644909,251,132,119,153.90762931940122,0.4012363335308635,0.9165884322154714,0.0981109281240919,17197267.65923392,360408.1392407761,17557675.798474696,3291,1,2248.185580774366,132,617,93,36.68868921775901,0.6128472222222222,40.67982456140349,132633.4723485948,1004.7990329439,8
3293,511.7301227148131,2,0,751,0.002663115845539281,0.0,1.0,751,20350,14700,5650,0.7223587223587223,260,147,113,155.25118152280473,0.4019677467080929,0.9180527658037847,0.09944947113546587,17228787.64624243,364407.92765693134,17593195.57389936,3292,0,2243.195739014647,98,653,98,36.48063484983639,0.6213860544217686,40.509259259259274,132789.22860261783,1354.992128598141,0
3294,512.1897322419401,1,0,752,0.0013297872340425532,0.0,1.0,752,21050,16000,5050,0.7600950118764845,261,160,101,155.01760784782527,0.4025819814124902,0.9178535228380291,0.09968968007688794,17262487.02000566,363747.8886690814,17626234.90867474,3293,0,2241.211436170213,102,650,102,36.34747974446868,0.6217320261437909,40.372168284789645,132978.70960876904,1303.7128393016574,0
3295,512.6619311030549,1,0,753,0.0013280212483399733,0.0,1.0,753,21750,15100,6650,0.6942528735632184,284,151,133,159.14110010920336,0.40291986604409785,0.9202339789615592,0.10285779943362336,17301771.146815524,378334.57882837916,17680105.725643903,3294,0,2239.2337317397078,106,647,67,36.06211201458888,0.6225432389937107,40.19665109034268,133191.2865590655,1256.5215713119387,0
3296,512.8795004481135,1,0,754,0.001326259946949602,0.0,1.0,754,20850,16400,4450,0.7865707434052758,253,164,89,157.65952313305027,0.40351726750528094,0.9198667717039382,0.10235121749024267,17329571.17520288,374784.38551655185,17704355.56071943,3295,0,2237.262599469496,110,644,72,35.944701153989605,0.6232007575757577,40.04316816816819,133326.5300479852,1212.0593640725926,0
3297,513.1867684604308,0,0,754,0.0,0.0,1.0,754,20800,14800,6000,0.7115384615384616,268,148,120,158.0506090109381,0.4037070110363145,0.9201944539607163,0.10299202411413177,17357356.46420471,377068.15199749847,17734424.61620221,3296,1,2238.262599469496,116,638,76,35.80205445064413,0.6232938218390804,39.912749287749286,133473.3357107776,1150.6322044032552,0
3298,513.3383761686089,0,2,752,0.0,0.002652519893899204,0.9973474801061007,754,20000,14000,6000,0.7,260,140,120,157.94141047378417,0.40371086388310595,0.9201504811646672,0.10331302779465712,17380034.01698834,378205.417345101,17758239.434333444,3297,2,2239.262599469496,120,634,83,35.67140580717016,0.6238715277777778,39.78133608815428,133580.22638127275,1113.168553177273,0
3299,512.9992871264552,0,0,752,0.0,0.0,1.0,752,19200,13900,5300,0.7239583333333334,245,139,106,159.40030421360123,0.4033975680180563,0.9209899054251478,0.10466386076669325,17386018.455173258,384667.3261635803,17770685.781336837,3298,3,2246.2047872340427,123,629,89,35.50055928411634,0.6246612466124661,39.6505376344086,133559.0885973041,1085.84624875857,0
3300,512.6426008474823,1,0,753,0.0013280212483399733,0.0,1.0,753,21300,15500,5800,0.7276995305164319,271,155,116,158.0033614649255,0.40400175303514074,0.9199289720766599,0.1042396873793774,17395674.1470549,377814.99803663715,17773489.145091537,3299,0,2244.220451527224,97,656,97,35.371487684796094,0.6319802405498282,39.48767006802722,133549.7183691644,1376.8012203006638,0
3301,513.0685556267762,0,0,753,0.0,0.0,1.0,753,19550,14400,5150,0.7365728900255755,247,144,103,157.68868226787134,0.4042382479538112,0.9195995948153235,0.10449459243938662,17430432.04068419,379566.3719710384,17809998.412655227,3300,1,2245.220451527224,100,653,100,35.22542929492757,0.6327083333333333,39.3358085808581,133738.60019504148,1337.3860019504148,0
3302,513.3813572361568,0,0,753,0.0,0.0,1.0,753,20500,15500,5000,0.7560975609756098,255,155,100,161.75135938894047,0.40444427961911217,0.9212136105626769,0.10757395004878369,17457531.712300465,393655.897208033,17851187.609508496,3301,2,2246.220451527224,103,650,94,34.99447100920485,0.6331917475728155,39.21274038461541,133883.31729124542,1299.838031953839,0
3303,513.6159901395089,2,1,754,0.0026490066225165563,0.0013245033112582781,0.9986754966887417,755,19700,14500,5200,0.7360406091370558,249,145,104,158.04717909490302,0.4048819833588046,0.9195384066304491,0.10557551563539605,17485640.074463967,382011.2176875683,17867651.292151537,3302,0,2241.2675496688744,111,644,72,34.9384564204924,0.6328828828828829,39.06250000000002,134021.6724270292,1207.4024542975603,0
3304,513.7656510580354,0,1,753,0.0,0.001326259946949602,0.9986737400530504,754,20950,14800,6150,0.7064439140811456,271,148,123,159.49095221402098,0.4047285291489509,0.9206272220040463,0.10696053179382738,17508659.001150016,386744.53921680665,17895403.54036682,3303,1,2245.240053050398,112,642,77,34.764985935054085,0.6340215773809523,38.92883480825961,134129.39715721575,1197.5839031894263,0
3305,513.8187082854791,0,1,752,0.0,0.0013280212483399733,0.99867197875166,753,21550,14400,7150,0.6682134570765661,287,144,143,163.8906751933975,0.40442043881212736,0.9232145701337517,0.11044113115708021,17532295.159239747,402525.938267551,17934821.097507298,3304,2,2249.2164674634796,115,638,80,34.48478481317247,0.6350543478260869,38.76616379310346,134226.83228028865,1167.1898459155534,0
3306,514.0421412864563,0,0,752,0.0,0.0,1.0,752,20900,14600,6300,0.6985645933014354,272,146,126,167.45503276094024,0.40429685655532577,0.924778297844538,0.11333851244551595,17559752.23935608,416793.7773030757,17976546.016659155,3305,3,2253.184840425532,121,631,84,34.24154634741228,0.6354166666666667,38.618510928961754,134361.1003347195,1110.4223168158635,0
3307,513.7726360837324,0,0,752,0.0,0.0,1.0,752,19950,13500,6450,0.6766917293233082,264,135,129,171.16631241337734,0.40432865517371636,0.9271859602912222,0.11632279389337266,17568909.60215785,431091.093945069,18000000.696102917,3306,4,2254.184840425532,86,666,86,34.0054901871013,0.6455910852713178,38.481800766283534,134360.8946041776,1562.3359837695068,0
3308,514.1536788804102,0,0,752,0.0,0.0,1.0,752,21100,15200,5900,0.7203791469194313,270,152,118,171.73640921842824,0.40466652471645376,0.9266474016731305,0.11764090314604694,17617677.94696131,433619.34987556114,18051297.29683687,3307,5,2255.184840425532,95,657,89,33.72036392273891,0.6453947368421052,38.216145833333314,134597.1316912836,1416.8119125398275,0
3309,514.0829272398621,0,1,751,0.0,0.0013297872340425532,0.9986702127659575,752,21500,16000,5500,0.7441860465116279,270,160,110,168.2265133057465,0.4046369763483204,0.9252233323320491,0.11573339745753686,17634534.46945237,421419.24951319187,18055953.71896556,3308,6,2256.184840425532,99,653,67,33.66660866971563,0.6457281144781144,38.07291666666665,134652.24172339847,1360.1236537717018,0
3310,513.94228262757,0,0,751,0.0,0.0,1.0,751,20250,14200,6050,0.7012345679012346,263,142,121,167.07906580363885,0.4044084184050895,0.9245387301127741,0.11535266917234344,17645573.84888413,419191.19884813123,18064765.047732264,3309,7,2260.1597869507323,102,649,72,33.57687532965403,0.6461397058823529,37.95509708737862,134675.9555538314,1320.3525054297195,0
3311,514.008480481521,0,0,751,0.0,0.0,1.0,751,19700,13900,5800,0.7055837563451777,255,139,116,164.0805227840894,0.4044454061251665,0.9231523531538508,0.11365210523118033,17662379.68306789,409710.4984017677,18072090.18146966,3310,8,2261.1597869507323,104,647,78,33.545805739514314,0.6467347756410257,37.8472222222222,134748.7509595643,1295.6610669188874,0
3312,513.4467715032574,1,0,752,0.0013297872340425532,0.0,1.0,752,19700,14500,5200,0.7360406091370558,249,145,104,160.1116914529945,0.4046935646088903,0.920570826221419,0.11137050803277171,17661777.82163934,395471.4242179217,18057249.24585726,3311,0,2259.151595744681,114,638,85,33.50873709293084,0.6459247076023391,37.70833333333329,134672.80944220623,1181.3404337035633,0
3313,513.0872091393629,0,0,752,0.0,0.0,1.0,752,22350,15500,6850,0.6935123042505593,292,155,137,161.16950486151208,0.40479582188287955,0.9212207727755646,0.11252333594110185,17665864.836828798,396689.7377404061,18062554.574569203,3312,1,2260.151595744681,120,632,88,33.35677613017514,0.6460069444444445,37.58608815426992,134641.22166826538,1122.0101805688782,0
3314,513.2916905349099,0,0,752,0.0,0.0,1.0,752,20600,14900,5700,0.7233009708737864,263,149,114,159.36004031242078,0.40476096144856505,0.9208037825059079,0.11155202821869488,17684502.77546063,392640.6150405062,18077143.390501138,3313,2,2261.151595744681,105,647,91,33.31679894179893,0.65,37.50000000000001,134739.06876541433,1283.2292263372792,0
3315,513.4390503389067,0,0,752,0.0,0.0,1.0,752,20200,14100,6100,0.698019801980198,263,141,122,161.93497146186846,0.4047974819035612,0.9210958308608932,0.11385407174778384,17709001.230004646,402941.32175980747,18111942.551764455,3314,3,2262.151595744681,93,659,93,33.1028138756452,0.6546818996415771,37.35593971631209,134851.71688921307,1450.018461174334,0
3316,513.0148210995405,0,0,752,0.0,0.0,1.0,752,22250,16700,5550,0.750561797752809,278,167,111,162.67968754115208,0.40489479600485406,0.9215030088825302,0.11463331183778863,17704200.315532397,403372.75509936246,18107573.07063176,3315,4,2263.151595744681,95,657,95,33.0091139379922,0.6548245614035088,37.28298611111114,134777.72188001536,1418.7128618948987,0
3317,512.5500547075085,1,0,753,0.0013280212483399733,0.0,1.0,753,20050,14400,5650,0.7182044887780549,257,144,113,133.28358387505105,0.4051976196867377,0.9039570495137732,0.09117147663004183,17556403.994609423,297346.0888719579,17853750.083481383,3316,0,2261.144754316069,115,638,108,34.77476955890256,0.6401268115942029,38.26329022988504,134153.1649116345,1166.5492601011695,8
3318,512.7908114300396,2,0,755,0.0026490066225165563,0.0,1.0,755,21850,15500,6350,0.7093821510297483,282,155,127,134.1934087954615,0.40551825144483283,0.9055213458472775,0.09233086620801448,17590740.22818932,299262.2788912295,17890002.507080548,3317,0,2256.1523178807947,118,637,82,34.55403591440249,0.641507768361582,38.068977591036386,134315.82151979065,1138.269673896531,0
3319,512.555540432512,0,0,755,0.0,0.0,1.0,755,20850,15200,5650,0.7290167865707434,265,152,113,155.838340762799,0.4056488280312213,0.9196514067014339,0.10569290007814597,17518224.533733774,374152.2088894505,17892376.742623225,3318,1,2257.1523178807947,133,622,93,34.47503815696883,0.6341635338345865,38.54944029850748,134007.93292418236,1007.5784430389651,7
3320,512.6358585249172,0,0,755,0.0,0.0,1.0,755,19600,13400,6200,0.6836734693877551,258,134,124,155.18026716183994,0.40556758363049755,0.9186066804195172,0.10577269220864902,17543388.12840859,373877.5313380514,17917265.65974664,3319,2,2258.1523178807947,97,658,97,34.32243631414292,0.6431486254295533,38.382227891156425,134114.65121039125,1382.625270210219,0
3321,512.8591986184884,0,0,755,0.0,0.0,1.0,755,20650,14800,5850,0.7167070217917676,265,148,117,157.2769727990638,0.40556509506326816,0.9199942278620676,0.10753456353501548,17564935.46321648,380861.9754131144,17945797.438629594,3320,3,2259.1523178807947,98,657,98,34.162344884886465,0.6439200680272108,38.278619528619494,134226.2174498749,1369.6552801007645,0
3322,512.5169641328255,0,0,755,0.0,0.0,1.0,755,20550,15700,4850,0.7639902676399026,254,157,97,155.53473250659636,0.40558822409987055,0.9181012334824776,0.10702858089059879,17581928.256200634,375370.10165565665,17957298.357856292,3321,4,2260.1523178807947,106,649,75,33.99063715652025,0.644064465408805,38.06464174454825,134246.31461212583,1266.4746661521306,0
3323,512.1798570363634,0,0,755,0.0,0.0,1.0,755,20500,14400,6100,0.7024390243902439,266,144,122,152.3815312769947,0.40570921238311053,0.916311425232345,0.10522874874772115,17586051.396970972,364457.8881972642,17950509.285168238,3322,5,2261.1523178807947,113,642,77,33.9545413601125,0.6437131268436578,37.94773391812861,134217.89217786555,1187.7689573262437,0
3324,511.8517984164871,0,0,755,0.0,0.0,1.0,755,18750,13200,5550,0.704,243,132,111,155.34646615519657,0.4061034307095051,0.9180493694236946,0.09339394162980535,16932083.71436949,356317.87393425324,17288401.588303745,3323,6,2262.1523178807947,123,632,91,38.78817754771006,0.5930724932249323,42.78393817204302,131656.5038282468,1070.3780799044455,8
3325,512.0375192415996,2,0,757,0.002642007926023778,0.0,1.0,757,22950,16300,6650,0.710239651416122,296,163,133,155.14447645237098,0.4067198941565961,0.9186551154931701,0.09368704127928343,16959624.264921017,351888.4054820216,17311512.670403037,3324,0,2257.1730515191543,95,662,95,38.628442945475,0.6008771929824561,42.621527777777786,131787.4344228601,1387.23615181958,0
3326,511.94620563863896,3,0,760,0.003947368421052632,0.0,1.0,760,21300,15300,6000,0.7183098591549296,273,153,120,150.87694584248567,0.4078246711970968,0.9166386326641351,0.09155718417101799,16980156.463099167,339082.8294159921,17319239.29251516,3325,0,2249.2592105263157,101,659,101,38.55686624372193,0.6010726072607261,42.44281045751635,131855.42592122685,1305.4992665468005,0
3327,511.65477246653467,1,2,759,0.001314060446780552,0.002628120893561104,0.9973718791064389,761,21900,16600,5300,0.7579908675799086,272,166,106,147.42198208961563,0.408481813518685,0.9136741190787623,0.08990664541521645,16994338.441570703,326967.8114716215,17321306.253042325,3326,0,2247.3022339027593,111,650,76,38.46227867590459,0.6006006006006006,42.261904761904766,131872.92647500592,1188.044382657711,0
3328,511.7611285126375,4,1,762,0.005242463958060288,0.001310615989515072,0.9986893840104849,763,20600,15500,5100,0.7524271844660194,257,155,102,184.66094970878788,0.4096171608136139,0.9325275848577061,0.10894250430060676,16837477.780884977,448644.92754377273,17286122.70842875,3327,0,2242.116644823067,88,675,88,38.74389743121781,0.5943418560606061,43.48080524344572,131276.55259376855,1491.7790067473697,8
3329,512.2114620063751,7,2,767,0.009102730819245773,0.002600780234070221,0.9973992197659298,769,20400,15000,5400,0.7352941176470589,258,150,108,188.40425050347383,0.41146214307000434,0.9338670895957863,0.11236146239626714,16905047.9446805,462796.5775485709,17367844.52222907,3328,0,2225.6098829648895,100,669,68,38.239131307454564,0.5948958333333334,43.07962046204623,131597.56322236935,1315.9756322236935,0
3330,512.0966856950718,2,0,769,0.002600780234070221,0.0,1.0,769,21000,14600,6400,0.6952380952380952,274,146,128,187.81677981873415,0.4115157615861147,0.933634445499077,0.11261402870912798,16927277.721005008,461045.358531314,17388323.079536323,3329,0,2226.6020806241872,107,662,76,38.05283592167452,0.5952102803738317,42.88194444444445,131669.30408236172,1230.55424376039,0
3331,511.64362735585473,2,0,771,0.0025940337224383916,0.0,1.0,771,20450,13900,6550,0.6797066014669927,270,139,131,189.00721915485056,0.4120741882415034,0.9342764823706349,0.11372825466428763,16929338.732377566,465303.44718743145,17394642.179564998,3330,0,2221.8236057068743,117,654,81,37.89030775653999,0.5944622507122508,42.75247175141241,131619.05848143378,1124.9492177900322,0
3332,511.40073025265986,5,0,776,0.006443298969072165,0.0,1.0,776,21250,15100,6150,0.7105882352941176,274,151,123,186.78009204387772,0.41326664865314267,0.934193183563321,0.11368158744697855,16976308.016512904,457717.2747779002,17434025.291290805,3331,0,2208.5012886597938,91,685,77,37.52201703505146,0.6049679487179487,42.33469202898551,131770.22665715337,1448.0244687599272,0
3333,511.2930726774357,0,0,776,0.0,0.0,1.0,776,20600,14200,6400,0.6893203883495146,270,142,128,187.83456655169317,0.41348152920962195,0.9349211294119322,0.11475271418746319,16990670.515135862,462487.0463266361,17453157.5614625,3332,1,2209.5012886597938,93,683,65,37.35617979138012,0.6057347670250897,42.19858156028369,131812.0793746441,1417.33418682413,0
3334,510.97712922812093,0,0,776,0.0,0.0,1.0,776,22050,15700,6350,0.7120181405895691,284,157,127,183.87742013727035,0.4141150509921295,0.932390311768245,0.11281691076945141,17000586.726011433,447954.8055997881,17448541.53161122,3333,2,2210.5012886597938,104,672,71,37.30041599364152,0.6043669871794872,42.04365079365082,131809.7947836284,1267.4018729195038,0
3335,511.3769109617336,0,0,776,0.0,0.0,1.0,776,20500,14100,6400,0.6878048780487804,269,141,128,181.20150559062714,0.4144581739829287,0.9314416191873818,0.11151243065107871,17028322.0973212,441411.5203433551,17469733.617664557,3334,3,2211.5012886597938,108,668,77,37.258060534241885,0.6045524691358024,41.93425076452601,131968.86566906318,1221.9339413802145,0
3336,510.9639956195019,2,0,778,0.002570694087403599,0.0,1.0,778,22800,16200,6600,0.7105263157894737,294,162,132,183.12251794622523,0.41536701731110476,0.9329874754639924,0.11330902788583282,17040393.622130632,445695.9573758802,17486089.579506513,3335,0,2206.813624678663,115,663,83,37.00915623551229,0.605072463768116,41.73850574712647,131962.32501811316,1147.4984784183753,0
3337,510.7764650063807,0,0,778,0.0,0.0,1.0,778,20100,13400,6700,0.6666666666666666,268,134,134,182.95968088599975,0.4158013251040243,0.9336431077354743,0.11354998408435332,17048412.514105674,448134.4226387254,17496546.9367444,3336,1,2207.813624678663,85,693,85,36.90320621005422,0.6140931372549019,41.63032945736431,131969.14698462936,1552.578199819169,0
3338,510.58458750507793,3,0,781,0.0038412291933418692,0.0,1.0,781,21950,16000,5950,0.7289293849658315,279,160,119,177.20266706504023,0.4168090028125239,0.9312187396901672,0.11056284440156297,17067096.862928204,426717.01663364307,17493813.87956185,3337,0,2200.329065300896,91,690,91,36.8584690839026,0.614010989010989,41.44021739130431,132016.63994866167,1450.7323071281503,0
3339,510.8748107939383,0,0,781,0.0,0.0,1.0,781,20500,14800,5700,0.7219512195121951,262,148,114,172.600276743176,0.417173495518566,0.9293653956121055,0.10829332827411893,17103057.485651832,413698.4910355815,17516755.976687413,3338,1,2201.329065300896,97,684,69,36.77531766896703,0.6142611683848798,41.241496598639415,132193.20146649063,1362.8165099638209,0
3340,511.0286188479808,3,0,784,0.003826530612244898,0.0,1.0,784,21400,15500,5900,0.7242990654205608,273,155,118,168.94237400016212,0.41801846856239305,0.9279214616100604,0.10649425287193684,17130134.675254185,400601.12379597896,17530735.799050163,3339,0,2193.901785714286,103,681,75,36.701392918391306,0.614381067961165,41.07572115384612,132317.71660495747,1284.6380252908493,0
3341,511.5014646457554,2,0,786,0.002544529262086514,0.0,1.0,786,21750,15100,6650,0.6942528735632184,284,151,133,164.97483607739989,0.41856658860202156,0.9262330214340981,0.10437214652482178,17163040.989292968,387343.9747596531,17550384.96405262,3340,0,2189.3167938931297,109,677,80,36.67324657601014,0.6142966360856269,40.94696969696967,132506.00442091952,1215.6514167056837,0
3342,511.3230132173224,1,0,787,0.0012706480304955528,0.0,1.0,787,20900,14400,6500,0.6889952153110048,274,144,130,161.91139672975,0.41888949241976,0.9247351400654718,0.10286092754737981,17176506.735441726,377914.43929465563,17554421.17473638,3341,0,2187.533672172808,112,675,88,36.60340647746402,0.6151413690476191,40.80014749262533,132534.8496095539,1183.346871513874,0
3343,511.7631163836472,2,0,789,0.0025348542458808617,0.0,1.0,789,22850,16200,6650,0.7089715536105032,295,162,133,163.67716248981176,0.4193165892485294,0.9262405034658721,0.1044040387485447,17210177.11694006,382732.5912895683,17592909.708229627,3342,0,2182.9860583016475,126,663,92,36.4129689954352,0.6140046296296297,40.65780839895013,132721.76818351826,1053.3473665358592,0
3344,511.4485444262012,1,0,790,0.0012658227848101266,0.0,1.0,790,22350,16900,5450,0.756152125279642,278,169,109,160.88115607935427,0.4199850395469349,0.925802328084047,0.10341420992925153,17235432.41576613,374221.25851520436,17609653.674281336,3343,0,2181.221518987342,100,690,100,36.21111751152074,0.6220833333333333,40.387788778877876,132778.28754430986,1327.7828754430986,0
3345,511.31754981215323,0,0,790,0.0,0.0,1.0,790,22350,15100,7250,0.6756152125279642,296,151,145,161.20952636625063,0.4201413956672175,0.9262819518013266,0.10417171636491811,17255380.112440873,375996.33103924326,17631376.443480115,3344,1,2182.221518987342,103,687,66,36.01617318220374,0.6231796116504854,40.20432692307693,132838.0870094916,1289.6901651406952,0
3346,511.81263581788187,0,0,790,0.0,0.0,1.0,790,22200,16000,6200,0.7207207207207207,284,160,124,162.50260710799856,0.4204615279716353,0.9272356281907717,0.10532516825866772,17286068.09284868,381606.22634686064,17667674.319195542,3345,2,2183.221518987342,104,686,69,35.87575069343723,0.6239983974358974,40.099206349206355,133020.51024957228,1279.043367784349,0
3347,511.73817769919197,3,0,793,0.0037831021437578815,0.0,1.0,793,21150,14300,6850,0.6761229314420804,280,143,137,161.34173558687243,0.4211673932473113,0.9275201120788552,0.10510174160716043,17306831.5660982,378712.84847679257,17685544.414574992,3346,0,2175.9583858764186,109,684,73,35.7281350131081,0.6246177370030581,39.924242424242436,133090.6942455556,1221.0155435372073,0
3348,511.9144106999275,2,0,795,0.0025157232704402514,0.0,1.0,795,21400,15200,6200,0.7102803738317757,276,152,124,159.6729745686057,0.42153335551225385,0.9272061674496823,0.10441442158962772,17330446.888157535,373040.8010470721,17703487.689204607,3347,0,2171.481761006289,114,681,79,35.63684280757936,0.6249086257309941,39.79166666666667,133204.39561754392,1168.4596106802098,0
3349,512.0429077331348,0,0,795,0.0,0.0,1.0,795,22750,16600,6150,0.7296703296703296,289,166,123,164.91253209304196,0.4217559368217607,0.9297382405038395,0.10811878394383757,17346630.297884066,390385.3451411836,17737015.64302525,3348,1,2172.481761006289,121,674,79,35.41024295304948,0.6244834710743802,39.702868852459005,133283.29990737923,1101.5148752675968,0
3350,512.373020725483,0,0,795,0.0,0.0,1.0,795,21900,16400,5500,0.7488584474885844,274,164,110,170.69774045132493,0.4218997037529902,0.9324008026892086,0.11234217608961096,17375434.274186376,412289.473992823,17787723.7481792,3349,2,2173.481761006289,82,713,82,35.12531524585158,0.6360518292682926,39.57078313253011,133436.90453155705,1627.279323555574,0
3351,512.0613989287427,0,1,794,0.0,0.0012578616352201257,0.9987421383647799,795,20800,14400,6400,0.6923076923076923,272,144,128,169.37734501757782,0.42188887832749816,0.9316129150212089,0.11204962824239699,17388457.78915041,409242.1628552994,17797699.95200571,3350,3,2174.481761006289,87,708,87,34.97986312984495,0.6360153256704981,39.39393939393938,133446.3039632473,1533.865562795946,0
3352,512.3496723039851,0,0,794,0.0,0.0,1.0,794,22700,15900,6800,0.7004405286343612,295,159,136,167.467488359763,0.4219226957540952,0.9299589786548139,0.11141857931851608,17424210.213269923,402097.744213767,17826307.95748369,3351,4,2176.598236775819,94,700,80,34.83200196202085,0.6357491134751774,39.19956140350876,133621.0192516474,1421.5002048047597,0
3353,511.98689476518075,1,0,795,0.0012578616352201257,0.0,1.0,795,22500,16200,6300,0.72,288,162,126,167.97241678762794,0.4222497478467964,0.9296766947121184,0.11237442626766075,17437001.2311748,404287.0476658583,17841288.278840657,3352,0,2174.8591194968553,101,694,69,34.62754995565296,0.6357260726072607,39.011437908496745,133622.72347445897,1322.997262123356,0
3354,511.9204400390803,0,0,795,0.0,0.0,1.0,795,23550,17600,5950,0.7473460721868365,295,176,119,170.2867469376519,0.4223671773099082,0.9306621017450794,0.11462926656272791,17462720.06440139,412183.9584899537,17874904.022891343,3353,1,2175.8591194968553,107,688,74,34.35422897972748,0.6363901869158879,38.80208333333333,133712.55243729078,1249.6500227784186,0
3355,512.3659574231467,1,1,795,0.001256281407035176,0.001256281407035176,0.9987437185929648,796,20450,14400,6050,0.7041564792176039,265,144,121,171.24391003299792,0.4225902178607925,0.9315501925097935,0.1155865257466377,17490164.821289957,419366.84222386236,17909531.66351382,3354,0,2174.1243718592964,110,686,76,34.23616348812986,0.6366477272727273,38.710585585585605,133875.80098097603,1217.0527361906911,0
3356,512.6320836036259,1,0,796,0.001256281407035176,0.0,1.0,796,21300,14800,6500,0.6948356807511737,278,148,130,174.3981756343651,0.4226004564225741,0.932840337494375,0.11815775488819315,17516161.016342986,430457.30507361185,17946618.321416598,3355,0,2174.860552763819,121,675,80,34.02531681745442,0.6357610192837466,38.58435792349731,134010.04528425977,1107.5210354071055,0
3357,512.9685746972209,0,0,796,0.0,0.0,1.0,796,24000,18200,5800,0.7583333333333333,298,182,116,171.43512369029966,0.42276687420330167,0.9320341172479671,0.11680302212817331,17552883.475055207,418636.1499335021,17971519.62498871,3356,1,2175.860552763819,85,711,85,33.91151186838283,0.646813725490196,38.39631782945737,134194.4679785682,1578.7584468066846,0
3358,513.3573235189172,0,0,796,0.0,0.0,1.0,796,23900,16800,7100,0.702928870292887,310,168,142,169.31801391693432,0.4225172310715,0.9308978579902158,0.11605980226669879,17593307.05883978,412672.7618867073,18005979.820726488,3357,2,2176.860552763819,89,707,80,33.76160477453579,0.6474719101123596,38.19444444444445,134399.79928238346,1510.1101042964435,0
3359,513.0538398782018,1,2,795,0.0012547051442910915,0.002509410288582183,0.9974905897114178,797,20850,14500,6350,0.6954436450839329,272,145,127,171.72447432187897,0.4227437506436406,0.9316450057150776,0.11812804642234934,17598787.0419978,424178.4906979524,18022965.532695755,3358,0,2175.1279799247177,93,704,67,33.57836915439724,0.6474014336917563,38.07624113475177,134380.99024114752,1444.956884313414,0
3360,513.0563797559017,1,0,796,0.001256281407035176,0.0,1.0,796,24100,17400,6700,0.7219917012448133,308,174,134,168.7580944853776,0.42275061102156486,0.9302649188688144,0.11679682379082698,17626036.477396067,411607.2658510192,18037643.743247088,3359,0,2178.845477386935,102,694,71,33.450605733245844,0.6469566993464052,37.874190938511305,134485.318637673,1318.4835160556174,0
3361,512.8810975956395,0,0,796,0.0,0.0,1.0,796,24150,17900,6250,0.7412008281573499,304,179,125,174.48909165345643,0.4228811773753463,0.9324288082335672,0.12142133485306533,17644153.030142926,432392.44704483764,18076545.477187764,3360,1,2179.845477386935,106,690,75,33.11776276722086,0.6477987421383649,37.69470404984421,134531.42809206364,1269.1644159628645,0
3362,512.627855940538,0,0,796,0.0,0.0,1.0,796,21650,15200,6450,0.7020785219399538,281,152,129,172.29088765680186,0.42293855941131236,0.9314827894838997,0.12019094857495306,17646481.154606145,427215.5804292158,18073696.73503536,3361,2,2180.845477386935,110,686,80,33.091917024320416,0.6477272727272727,37.61261261261258,134507.08382223395,1222.7916711112177,0
3363,512.2735542981372,0,1,795,0.0,0.001256281407035176,0.9987437185929648,796,20150,13800,6350,0.684863523573201,265,138,127,172.11937822501463,0.42307485409226425,0.9318000861132132,0.12052805441908752,17651053.614750233,428267.6746374443,18079321.289387677,3362,3,2181.845477386935,85,711,85,32.96954544056355,0.6560049019607843,37.48788759689924,134478.01286704926,1582.0942690241088,0
3364,512.5643084679259,0,0,795,0.0,0.0,1.0,795,21650,15500,6150,0.7159353348729792,278,155,123,172.04559702932232,0.4229921476059968,0.9308595387840679,0.11469706468621381,17440751.516866866,419470.90147187735,17860222.418338742,3363,4,2185.5509433962266,91,704,71,34.642288773148145,0.6373626373626373,39.13043478260867,133712.4282959793,1469.3673439118604,8
3365,512.9823687089388,0,0,795,0.0,0.0,1.0,795,22800,16900,5900,0.7412280701754386,287,169,118,172.99004403972475,0.4232231120193907,0.9313171151073603,0.11577914633643557,17472784.638853785,422723.5568343819,17895508.195688166,3364,5,2186.5509433962266,95,700,73,34.48231063440588,0.6375,38.9973958333333,133889.73412461666,1409.365622364386,0
3366,512.6704328130456,0,2,793,0.0,0.0025157232704402514,0.9974842767295597,795,22050,16300,5750,0.7392290249433107,278,163,115,174.27975335609563,0.4232297788972852,0.9316010992456527,0.11726400137022121,17486252.71629125,428449.9621035139,17914702.67839476,3365,6,2187.5509433962266,101,694,76,34.265518084066436,0.6376856435643564,38.81740196078429,133900.59557999915,1325.7484710891006,0
3367,512.5493668128304,0,0,793,0.0,0.0,1.0,793,21300,14900,6400,0.6995305164319249,277,149,128,176.40317489828854,0.4232995014245014,0.9325398030187868,0.11895812859480162,17492220.53302318,437236.6476092597,17929457.18063244,3366,7,2193.312736443884,103,690,76,34.1333128865716,0.6379449838187703,38.74198717948716,133907.62904593116,1300.0740684070986,0
3368,512.2230791825657,0,0,793,0.0,0.0,1.0,793,23450,16600,6850,0.7078891257995735,303,166,137,177.14717340944165,0.42357097403203964,0.9334421150555163,0.11997345676736704,17500429.980205517,437980.340888647,17938410.321094163,3367,8,2194.312736443884,111,682,78,33.96679831115536,0.637575075075075,38.59747023809522,133896.40870075408,1206.2739522590457,0
3369,512.3080437423635,1,0,794,0.0012594458438287153,0.0,1.0,794,22600,15900,6700,0.7035398230088495,293,159,134,172.8135010249046,0.42358455280937424,0.9319102540144906,0.11757198302242582,17523788.56944987,424269.45078136877,17948058.02023124,3368,0,2192.5478589420654,85,709,85,33.924739896884915,0.6463235294117646,38.44476744186047,133996.84952243968,1576.4335237934079,0
3370,512.6716498314836,0,0,794,0.0,0.0,1.0,794,24050,17800,6250,0.7401247401247402,303,178,125,170.5936358493848,0.4236140007602203,0.9305183801561423,0.11661013584722761,17557382.678240385,416185.5494160078,17973568.227656394,3369,1,2193.5478589420654,89,705,89,33.82238044696034,0.6465355805243446,38.28703703703704,134172.81650450817,1507.5597360057097,0
3371,512.7406460342572,0,0,794,0.0,0.0,1.0,794,22650,16100,6550,0.7108167770419426,292,161,131,163.68168521147084,0.42378294597035565,0.9269756032780874,0.1124952034009874,17584065.313691128,394187.88868270157,17978253.20237383,3370,2,2194.5478589420654,97,697,71,33.81914004897382,0.6459407216494846,38.10586734693875,134283.76676911084,1384.3687295784623,0
3372,513.1664819639917,0,0,794,0.0,0.0,1.0,794,24650,18200,6450,0.7383367139959433,311,182,129,165.28203001398367,0.42394828463370193,0.9281740642768925,0.109225866553179,17421185.185823474,392431.7705524902,17813616.956375964,3371,3,2195.5478589420654,94,700,94,35.123067805644396,0.6334219858156028,39.429824561403514,133715.88023456495,1422.5093641974995,8
3373,513.5857171716024,3,1,796,0.0037641154328732747,0.0012547051442910915,0.998745294855709,797,22700,16700,6000,0.73568281938326,287,167,120,160.22219900129699,0.42465523193130017,0.9259024438154781,0.10681211689323118,17475391.956209227,377889.145526689,17853281.101735916,3372,0,2188.279799247177,105,692,67,34.95159346040834,0.633531746031746,39.13128930817612,133978.44386829287,1275.9851796980274,0
3374,513.9825967043059,0,0,796,0.0,0.0,1.0,796,22500,16300,6200,0.7244444444444444,287,163,124,158.01606512416478,0.42460155204744904,0.9254838469771955,0.1059383969684584,17514635.44916655,371818.75515230565,17886454.20431886,3373,1,2192.028894472362,109,687,73,34.814216966531255,0.6345565749235473,38.93939393939396,134180.60820023128,1231.014754130562,0
3375,513.6509841359807,0,0,796,0.0,0.0,1.0,796,23900,17400,6500,0.7280334728033473,304,174,130,159.5002814127432,0.42480085832727577,0.9267187832257049,0.10751014125830395,17527733.69560773,376035.69139541197,17903769.387003142,3374,2,2193.028894472362,110,686,80,34.59068240055558,0.6361742424242425,38.75750750750751,134187.46336690563,1219.886030608233,0
3376,513.4234238781039,0,0,796,0.0,0.0,1.0,796,22950,17100,5850,0.7450980392156863,288,171,117,162.78469547102316,0.42472092511825377,0.9283339877151882,0.11015983472790647,17537893.091794163,388830.11723021406,17926723.209024377,3375,3,2194.028894472362,113,683,82,34.369100681699,0.636891592920354,38.623903508771924,134196.61038041973,1187.580622835573,0
3377,513.6484604446678,0,0,796,0.0,0.0,1.0,796,21950,15800,6150,0.7198177676537585,281,158,123,167.76965546911885,0.4248221255649316,0.9303736634264308,0.11405801010356474,17566383.896530453,408271.23483183887,17974655.131362293,3376,4,2195.028894472362,85,711,85,34.08129554155858,0.646078431372549,38.468992248062015,134334.9994903255,1580.4117587097119,0
3378,513.0789003203861,0,1,795,0.0,0.001256281407035176,0.9987437185929648,796,20350,14200,6150,0.6977886977886978,265,142,123,165.59106449704183,0.4248932358332543,0.9294876376874521,0.11300225390402518,17563856.577709608,402133.54147526005,17965990.119184867,3377,5,2196.028894472362,88,708,88,34.00988548935408,0.6463068181818181,38.34269662921348,134250.84147428063,1525.5777440259162,0
3379,513.5241024311874,0,0,795,0.0,0.0,1.0,795,23200,16500,6700,0.7112068965517241,299,165,134,163.48170278540854,0.4249483151941447,0.9281258830463162,0.11190882818087249,17592999.814117964,393026.71334307414,17986026.527461037,3378,6,2199.3194968553457,92,703,87,33.95993795464268,0.6460597826086957,38.239247311827945,134420.45557590516,1461.0919084337518,0
3380,513.3152956566953,1,1,795,0.001256281407035176,0.001256281407035176,0.9987437185929648,796,21100,14500,6600,0.6872037914691943,277,145,132,163.8924425694304,0.42501037024746374,0.9275255692709665,0.11266077845886921,17604595.232182607,396752.0226097048,18001347.25479231,3379,0,2197.5552763819096,98,698,71,33.80740026515607,0.6457270408163265,38.099747474747446,134437.40555756175,1371.8102607914464,0
3381,513.2124305495416,0,0,795,0.0,0.0,1.0,795,20650,14600,6050,0.7070217917675545,267,146,121,162.92013004611533,0.42499702960885893,0.9268027591524501,0.11263226005063788,17626492.290502,394692.08324507903,18021184.37374708,3380,8,2201.3194968553457,103,692,75,33.64069406759149,0.6463389967637541,37.910657051282016,134507.50871584204,1305.8981428722527,0
3382,512.7955015262227,0,0,795,0.0,0.0,1.0,795,22750,16300,6450,0.7164835164835165,292,163,129,167.59924339075587,0.4250831709519509,0.9292885336470089,0.11658565038682872,17639639.490284823,409528.0464514805,18049167.536736302,3381,9,2202.3194968553457,105,690,78,33.310346496322055,0.6479166666666667,37.70636792452827,134502.9946072746,1280.9809010216627,0
3383,512.6206228662398,0,0,795,0.0,0.0,1.0,795,22450,16000,6450,0.7126948775055679,289,160,129,170.71011458733196,0.4250143238861693,0.9312958085095964,0.11921137290638287,17650805.135920934,421184.1934623417,18071989.329383276,3382,10,2203.3194968553457,105,690,79,33.09881790493304,0.6492063492063492,37.57861635220124,134522.61313895404,1281.1677441805145,0
3384,512.4478186057553,0,0,795,0.0,0.0,1.0,795,21450,15100,6350,0.703962703962704,278,151,127,174.36027258211178,0.425187992754886,0.9330771238821058,0.11964065655520519,17566796.049020633,432140.2695003204,17998936.318520952,3383,11,2204.3194968553457,89,706,79,33.5942680015913,0.6478230337078652,38.15972222222222,134179.47917034724,1507.634597419632,8
3385,512.2728897016259,1,0,796,0.001256281407035176,0.0,1.0,796,22450,16400,6050,0.7305122494432071,285,164,121,171.91442528711605,0.4253530163922337,0.9318979176454807,0.1185148089385554,17581641.46080535,422857.55746769294,18004499.01827304,3384,0,2202.5489949748744,94,702,71,33.50030342345362,0.6478280141843972,38.00438596491227,134213.25029090547,1427.8005350096328,0
3386,511.9322159293651,0,1,795,0.0,0.001256281407035176,0.9987437185929648,796,21650,16600,5050,0.766743648960739,267,166,101,173.28587725287517,0.42540243144443396,0.9305902676467699,0.11050312647308502,17214597.797280338,415759.33617142716,17630357.133451764,3385,1,2203.5489949748744,122,674,86,36.17347549691944,0.6145833333333333,40.667344173441734,132760.74116013732,1088.2027963945682,8
3387,511.5381299621866,0,0,795,0.0,0.0,1.0,795,20650,14300,6350,0.6924939467312349,270,143,127,169.11038055067826,0.4254976395291732,0.9285903662418222,0.10814286676738906,17214395.125482615,402576.58212402445,17616971.70760664,3386,2,2203.794968553459,92,703,92,36.181748841493246,0.6225090579710144,40.56899641577063,132708.85042769086,1442.4875046488137,0
3388,511.2191910658393,0,0,795,0.0,0.0,1.0,795,20200,13600,6600,0.6732673267326733,268,136,132,165.56678363036008,0.4255844409591855,0.9270602749689021,0.10619983635437363,17217823.779033896,390939.9408417961,17608763.719875693,3387,3,2204.794968553459,95,700,95,36.16515636105193,0.6226973684210526,40.46223958333334,132680.6839312483,1396.6387782236661,0
3389,511.4415427760022,0,0,795,0.0,0.0,1.0,795,22450,16500,5950,0.734966592427617,284,165,119,166.36993697566731,0.42569097898811314,0.9270614790107117,0.10716013525580165,17244629.808310404,392347.5948754669,17636977.40318587,3388,4,2205.794968553459,97,698,92,35.996403135360836,0.6236039518900344,40.31675170068029,132812.8011432887,1369.2041354978217,0
3390,511.2604575883983,0,0,795,0.0,0.0,1.0,795,20650,14200,6450,0.6876513317191283,271,142,129,163.8042903497954,0.4257583078539782,0.9257544648324656,0.10592677442620185,17256874.525288396,385700.01705407037,17642574.542342465,3389,5,2206.794968553459,104,691,72,35.92258495609014,0.6231971153846154,40.17857142857145,132836.42246270107,1277.2732929105873,0
3391,510.8596208270256,3,0,798,0.0037593984962406013,0.0,1.0,798,23050,16900,6150,0.7331887201735358,292,169,123,160.0038655032954,0.4264304306877608,0.9238154197945652,0.10399717080553553,17266818.675679527,369901.54661064,17636720.222290166,3390,0,2199.4949874686718,116,682,75,35.84170861441173,0.6223958333333333,40.001780626780615,132822.59176470392,1145.0223427991716,0
3392,510.9995441911326,0,0,798,0.0,0.0,1.0,798,23500,16500,7000,0.7021276595744681,305,165,140,160.8390257111159,0.42665664710710277,0.9240437090034417,0.10502475514903424,17292827.146800168,373172.2940164148,17665999.44081658,3391,1,2200.4949874686718,124,674,81,35.65730538027057,0.6225638440860215,39.84166666666667,132940.78975085815,1072.1031431520819,0
3393,510.5573062426401,0,0,798,0.0,0.0,1.0,798,24900,18700,6200,0.751004016064257,311,187,124,162.47134687458544,0.426759207722359,0.9253203600201836,0.10643147768423479,17292567.63771374,377409.3510038436,17669976.988717586,3392,2,2201.4949874686718,126,672,87,35.50234516156143,0.6233465608465609,39.73097112860892,132882.25427896503,1054.6210657060717,0
3394,510.7482945761508,2,0,800,0.0025,0.0,1.0,800,20800,14800,6000,0.7115384615384616,268,148,120,165.60412191789976,0.42708665780141847,0.9279363065542741,0.10902115070314355,17321647.44160542,392907.24294770375,17714554.684553124,3393,0,2196.98875,92,708,92,35.24795358105396,0.6326992753623188,39.560931899641595,133018.80987326097,1445.8566290571844,0
3395,510.9191054676604,0,2,798,0.0,0.0025,0.9975,800,21450,15300,6150,0.7132867132867133,276,153,123,161.80352239740228,0.4270887111493534,0.9258887184042626,0.10697346598222378,17346866.22677227,379906.8116096636,17726773.038381934,3394,1,2197.98875,98,702,98,35.19862580419393,0.6324404761904762,39.41498316498319,133137.8636996234,1358.549629587994,0
3396,510.97372639031283,0,0,798,0.0,0.0,1.0,798,22500,15900,6600,0.7066666666666667,291,159,132,157.4106165260775,0.4269881429315656,0.923229986232275,0.10449377148072463,17367259.056825183,364658.19110059814,17731917.24792578,3395,2,2203.907268170426,104,694,94,35.17171784432355,0.6323116987179487,39.27579365079368,133223.21927841243,1280.992493061658,0
3397,511.50256857440434,0,0,798,0.0,0.0,1.0,798,22900,17300,5600,0.7554585152838428,285,173,112,154.11948481223334,0.4270323969690013,0.9214479297820282,0.10275487115517903,17405001.968079865,353989.9872952809,17758991.955375146,3396,3,2204.907268170426,111,687,72,35.107052241910004,0.632225975975976,39.12760416666669,133436.90053891027,1202.1342390892817,0
3398,511.1352715839142,0,0,798,0.0,0.0,1.0,798,22350,16200,6150,0.7248322147651006,285,162,123,150.41691236719,0.4270266645807325,0.9191422982073163,0.10076723516396238,17414177.988235798,341927.3768806236,17756105.36511642,3397,4,2205.907268170426,122,676,78,35.03870215964269,0.6317452185792349,38.96510840108402,133424.14021028992,1093.6404935269666,0
3399,511.3232340067195,0,0,798,0.0,0.0,1.0,798,21850,15900,5950,0.7276887871853547,278,159,119,150.9953170315241,0.4270152653172035,0.9193605956991007,0.10147201525077743,17434740.69420247,345062.83969670883,17779803.53389918,3398,5,2206.907268170426,127,671,82,34.91594341778594,0.6319717847769029,38.859049479166686,133527.4353519025,1051.3971287551378,0
3400,511.5656576440913,0,1,797,0.0,0.0012531328320802004,0.9987468671679198,798,21500,14700,6800,0.6837209302325581,283,147,136,154.14694957274992,0.42694287344249376,0.9204051695211921,0.10388600608013743,17455890.312389962,357054.4487462898,17812944.761136252,3399,6,2207.907268170426,131,667,87,34.73573183502498,0.6323155216284988,38.76262626262628,133640.06889717592,1020.1531976883658,0
3401,511.67333018726146,0,0,797,0.0,0.0,1.0,797,20300,14000,6300,0.6896551724137931,266,140,126,154.1996636045836,0.4268359914377408,0.9211680189657085,0.10429643451296848,17475793.920954138,359252.308766836,17835046.229720972,3400,7,2211.589711417817,135,662,92,34.61109442311639,0.6329475308641975,38.64123774509806,133730.3082565878,990.5948759747245,0
3402,511.7729007531295,0,0,797,0.0,0.0,1.0,797,22050,15400,6650,0.6984126984126984,287,154,133,156.2854113593131,0.4269314210113722,0.9223076958064533,0.10611935843529424,17496697.20097049,365445.70389660244,17862142.90486709,3401,8,2212.589711417817,99,698,99,34.42371595692418,0.6413089225589226,38.510416666666664,133823.28257922694,1351.7503290831005,0
3403,511.5061982926325,1,0,798,0.0012531328320802004,0.0,1.0,798,19750,13900,5850,0.7037974683544304,256,139,117,153.62862340951506,0.42714543966566354,0.9213093892420277,0.10474897603967462,17506178.756589733,358540.0287071541,17864718.785296887,3402,0,2210.815789473684,103,695,103,34.35202997588151,0.6416868932038835,38.371394230769226,133824.65350162084,1299.2684805982606,0
3404,512.0211621683761,0,1,797,0.0,0.0012531328320802004,0.9987468671679198,798,22950,16600,6350,0.7233115468409586,293,166,127,151.32438381164465,0.42723031176854726,0.9193602086396819,0.10358862350969468,17541591.947577797,348344.118508502,17889936.0660863,3403,1,2211.815789473684,109,689,102,34.27754865783956,0.6416284403669725,38.23863636363636,134027.35761986944,1229.6087855033893,0
3405,511.81869729560304,1,1,797,0.0012531328320802004,0.0012531328320802004,0.9987468671679198,798,22750,15700,7050,0.6901098901098901,298,157,141,146.48848363287215,0.42724256270119043,0.9153710389635428,0.10092371386858127,17563279.991795305,332213.65072353435,17895493.64251884,3404,0,2212.7593984962405,122,676,81,34.187436693174675,0.6412226775956285,38.02506775067752,134083.66854795304,1099.0464635078117,0
3406,511.571688856316,0,0,797,0.0,0.0,1.0,797,22350,15700,6650,0.7024608501118568,290,157,133,147.6991518512105,0.42700681891263087,0.9163145596688638,0.10206062499891715,17568014.991149567,337206.18278043496,17905221.17393,3405,3,2216.5357590966123,126,671,83,34.055705954765486,0.6415343915343915,37.92650918635173,134069.37830000973,1064.0426849207122,0
3407,511.5800385288287,0,0,797,0.0,0.0,1.0,797,23100,17300,5800,0.7489177489177489,289,173,116,145.8434505099317,0.4268882708187529,0.9155042609809974,0.10131493356572169,17591852.151538473,330631.2837281914,17922483.435266662,3406,4,2217.5357590966123,136,661,92,33.92618122602033,0.6417738970588236,37.750912408759135,134161.39833407788,986.4808701035138,0
3408,511.12616526031644,0,0,797,0.0,0.0,1.0,797,22750,17000,5750,0.7472527472527473,285,170,115,144.79253832631642,0.4269038364133508,0.9155217309014922,0.10093468776895276,17591584.905485265,327276.0463296294,17918860.951814894,3407,5,2218.5357590966123,144,653,98,33.8376664567418,0.6418547453703703,37.636494252873575,134100.85259678264,931.2559208109906,0
3409,511.16652210342187,0,0,797,0.0,0.0,1.0,797,21250,16100,5150,0.7576470588235295,264,161,103,146.25715510261506,0.4268577964057006,0.9176829375569238,0.10233668916269344,17609420.503201794,334450.7491607964,17943871.25236259,3408,6,2219.5357590966123,149,648,104,33.67484170238286,0.6424776286353467,37.51388888888891,134174.1125171204,900.4973994437611,0
3410,511.2016671554915,0,0,797,0.0,0.0,1.0,797,21600,15000,6600,0.6944444444444444,282,150,132,146.38890786148616,0.4267610532797825,0.9179290106494411,0.10274395505359425,17624145.340209484,334995.87766906765,17959141.21787855,3409,7,2220.5357590966123,107,690,107,33.56921487603303,0.6504088785046729,37.41319444444442,134234.81277303354,1254.5309604956406,0
3411,511.3457685459151,0,0,797,0.0,0.0,1.0,797,22100,15600,6500,0.7058823529411765,286,156,130,145.26121743986724,0.42650497626148304,0.9164788386705953,0.10241727936462658,17649085.59138586,331245.5319410195,17980331.12332688,3410,8,2221.5357590966123,114,683,114,33.44796478889423,0.6504020467836258,37.26449275362316,134348.68987719773,1178.4972796245415,0
3412,511.68417034435413,0,0,797,0.0,0.0,1.0,797,23100,17300,5800,0.7489177489177489,289,173,116,148.94812607290004,0.42634111061371266,0.9185317849348809,0.10535794224634455,17674982.250825282,344031.0969264326,18019013.347751714,3411,9,2222.5357590966123,115,682,103,33.24379341760618,0.651268115942029,37.15876436781607,134491.6995867375,1169.4930398846739,0
3413,512.174215072151,0,0,797,0.0,0.0,1.0,797,20750,14900,5850,0.7180722891566265,266,149,117,147.5904856194502,0.4261108448978477,0.9177937423772853,0.10488043341936729,17712102.762897205,342677.5696235146,18054780.33252072,3412,10,2223.5357590966123,122,675,72,33.12730780790447,0.6514685792349727,37.008807588075854,134697.3075444646,1104.0762913480705,0
3414,511.9395109916317,0,0,797,0.0,0.0,1.0,797,21700,15600,6100,0.7188940092165899,278,156,122,149.43562646540488,0.4259588012206579,0.9185058478146277,0.10667379539163362,17723746.434408687,348611.8303479607,18072358.264756646,3413,11,2224.5357590966123,128,669,78,32.92986211270339,0.6519368489583333,36.86208010335914,134710.6980352393,1052.427328400307,0
3415,511.5951564345631,1,0,798,0.0012531328320802004,0.0,1.0,798,21000,15000,6000,0.7142857142857143,270,150,120,147.33318954633512,0.42587943352735663,0.9175832356119658,0.10565340566151617,17731633.33333048,341891.61897313653,18073524.952303614,3414,0,2222.74686716792,137,661,87,32.835913608562684,0.6520681265206812,36.71497584541062,134695.34311924435,983.1776870017836,0
3416,511.3135067157141,0,0,798,0.0,0.0,1.0,798,22450,15300,7150,0.6815144766146993,296,153,143,168.7227873569559,0.4257143079887087,0.9281564745353859,0.12009891830254388,17689659.282018386,414879.72429140843,18104539.006309792,3415,1,2223.74686716792,104,694,72,32.51618580677611,0.6557491987179487,36.954365079365125,134498.78601753374,1293.2575578609014,8
3417,511.80922296452803,0,0,798,0.0,0.0,1.0,798,23500,17300,6200,0.7361702127659574,297,173,124,168.6709743016808,0.425594648478159,0.9277473428438394,0.1206272403781479,17727266.71776175,414915.06979813357,18142181.787559886,3416,2,2224.74686716792,111,687,77,32.363076728270734,0.6556869369369369,36.80245535714288,134706.93080983384,1213.5759532417462,0
3418,511.4407136614149,1,1,798,0.0012515644555694619,0.0012515644555694619,0.9987484355444305,799,24150,18500,5650,0.7660455486542443,298,185,113,168.05188361911274,0.42575024597371613,0.926884978351525,0.12061963042583075,17730192.556732934,411968.45121771324,18142161.00795065,3417,0,2222.9612015018774,118,681,82,32.260881730438925,0.6554555084745763,36.685924369747916,134669.53875743295,1141.267277605364,0
3419,511.63327978799435,0,0,798,0.0,0.0,1.0,798,21450,14900,6550,0.6946386946386947,280,149,131,168.08675418254032,0.4254182547019996,0.9277032702024366,0.12101455304652749,17750135.149930436,415662.52073065104,18165797.670661088,3418,1,2226.7431077694237,120,678,84,32.159849772316306,0.6560763888888889,36.58746556473832,134770.61893038233,1123.0884910865195,0
3420,511.4998701611017,0,0,798,0.0,0.0,1.0,798,22250,15300,6950,0.6876404494382022,292,153,139,167.42893002463038,0.42528765451898254,0.928237682701939,0.1212043372897676,17769221.20985151,413166.33890727576,18182387.548758786,3419,2,2227.7431077694237,88,710,88,31.998283083936496,0.6658380681818181,36.41151685393256,134825.47490517408,1532.1076693769783,0
3421,511.700033932203,0,0,798,0.0,0.0,1.0,798,22550,17300,5250,0.7671840354767184,278,173,105,168.25136670992086,0.42539394937573966,0.9284618033958678,0.12243458539200237,17798571.239450067,416776.7873042694,18215348.02675434,3420,3,2228.7431077694237,92,706,92,31.807814534850777,0.666213768115942,36.24551971326163,134963.17651249378,1466.9910490488455,0
3422,512.0660671566563,0,0,798,0.0,0.0,1.0,798,21750,15800,5950,0.7264367816091954,277,158,119,167.60817328597017,0.42533007419217217,0.9288185341755153,0.12252609900064254,17830974.433236886,416373.41053272877,18247347.843769614,3421,4,2229.7431077694237,92,706,86,31.676729199383157,0.6676856884057971,36.09991039426521,135134.28100669658,1468.8508805075714,0
3423,512.4388729529,0,0,798,0.0,0.0,1.0,798,20700,14000,6700,0.6763285024154589,274,140,134,165.31087658385886,0.4253516607285675,0.9281738391614678,0.12171288806614158,17874556.968965154,410671.73621754587,18285228.7051827,3422,5,2230.7431077694237,97,701,76,31.50742987645377,0.6684922680412371,35.8737244897959,135348.57093969508,1395.346092161805,0
3424,512.5479742948579,0,0,798,0.0,0.0,1.0,798,23600,17100,6500,0.7245762711864406,301,171,130,164.51433025116788,0.4252195865028527,0.9273609351555607,0.12163747194897237,17896340.51670994,405640.8948106705,18301981.411520608,3423,6,2231.7431077694237,105,693,78,31.393519207169696,0.6677579365079365,35.740959119496836,135445.4360924029,1289.956534213361,0
3425,512.1475952560543,0,0,798,0.0,0.0,1.0,798,24150,17600,6550,0.7287784679089027,307,176,131,169.89613150583415,0.4249710301475143,0.9288003046344038,0.12186431447845031,17751882.465023126,419445.23155074124,18171327.69657387,3424,7,2232.7431077694237,108,690,83,32.23355474090475,0.6573109567901234,36.70680428134559,134844.97703459184,1248.5646021721466,8
3426,512.3517273046505,0,0,798,0.0,0.0,1.0,798,21850,16100,5750,0.7368421052631579,276,161,115,168.86400177761385,0.424815109186601,0.9282855050606631,0.12133705797139474,17766592.08158599,418577.56736941996,18185169.64895541,3425,8,2233.7431077694237,113,685,85,32.203189514590086,0.6568030973451328,36.65021929824563,134927.71502784573,1194.0505754676612,0
3427,512.7553943713931,0,0,798,0.0,0.0,1.0,798,21250,15200,6050,0.7152941176470589,273,152,121,170.79692881670982,0.42475162708108627,0.9293949583329624,0.12306137691665568,17792436.926496007,426928.7166421114,18219365.643138118,3426,9,2234.7431077694237,119,679,86,32.063068406484824,0.6565126050420168,36.562500000000014,135078.99920471464,1135.1176403757534,0
3428,513.095061348592,0,0,798,0.0,0.0,1.0,798,21250,14900,6350,0.7011764705882353,276,149,127,171.74712312433468,0.42466338105825,0.9297952033730228,0.12408300975760346,17816015.817546938,431119.89244027284,18247135.709987212,3427,10,2235.7431077694237,122,676,90,31.949309594969534,0.6568476775956285,36.47527100271005,135213.23699173715,1108.3052212437472,0
3429,512.8171966521263,1,0,799,0.0012515644555694619,0.0,1.0,799,21000,14900,6100,0.7095238095238096,271,149,122,167.4413269894537,0.4246349342275171,0.9278652242997101,0.12172243668137567,17833086.02598101,416399.11770147114,18249485.14368248,3428,0,2233.9436795994993,97,702,97,31.86183379683742,0.6644115120274914,36.27763605442178,135241.36337304368,1394.2408595159143,0
3430,512.9386307704515,0,0,799,0.0,0.0,1.0,799,23050,16600,6450,0.720173535791757,295,166,129,167.59686146357228,0.4245502418959372,0.9279841790161512,0.12231730262070264,17854313.43654664,415615.3791104236,18269928.81565706,3429,1,2234.9436795994993,101,698,90,31.72995045672702,0.6646039603960396,36.15196078431374,135337.8519667632,1339.9787323441901,0
3431,513.3208996629478,0,0,799,0.0,0.0,1.0,799,22850,16700,6150,0.7308533916849015,290,167,123,167.6079247143197,0.4243240689332844,0.9278544952081578,0.12292620522659595,17888686.137016397,417007.1118582294,18305693.248874627,3430,2,2235.9436795994993,105,694,70,31.57155375643651,0.6651785714285714,35.99646226415095,135518.53350476746,1290.6527000454043,0
3432,513.0500537792357,0,1,798,0.0,0.0012515644555694619,0.9987484355444305,799,22350,16300,6050,0.7293064876957495,284,163,121,166.6819441396423,0.4242866892931118,0.9274209135522173,0.12260228102398918,17891684.676822934,414294.15717326046,18305978.833996195,3431,3,2236.9436795994993,110,689,71,31.502662094615435,0.6649621212121213,35.904654654654664,135494.13113227574,1231.764828475234,0
3433,512.9800596915309,0,0,798,0.0,0.0,1.0,798,20250,14700,5550,0.725925925925926,258,147,111,167.80550604918056,0.42404110574428544,0.9280224587011034,0.12371500866610184,17899157.206538465,420865.4265794063,18320022.63311787,3432,4,2238.6691729323306,112,686,73,31.39859661979042,0.6652715773809523,35.83148967551623,135513.17819487685,1209.9390910256861,0
3434,512.6964266242381,0,0,798,0.0,0.0,1.0,798,22350,16500,5850,0.738255033557047,282,165,117,170.7623835677759,0.4240662627396597,0.9298640792853501,0.12623844920194482,17900893.2765144,429409.8407779947,18330303.117292393,3433,5,2239.6691729323306,113,685,74,31.23314315352696,0.665929203539823,35.74561403508772,135482.2794039928,1198.9582248140957,0
3435,512.5878849498822,0,0,798,0.0,0.0,1.0,798,21400,14600,6800,0.6822429906542056,282,146,136,170.78283631622566,0.4238647447246305,0.9299249997653325,0.12657221793603005,17907845.483479884,430670.52879628335,18338516.012276165,3434,6,2240.6691729323306,120,678,76,31.15195679313902,0.6653645833333333,35.666322314049594,135494.24076606566,1129.1186730505472,0
3436,512.3231697225897,0,0,798,0.0,0.0,1.0,798,24600,18000,6600,0.7317073170731707,312,180,132,169.0989275116495,0.4236439986415223,0.9296358472647859,0.12586754343274423,17916982.308252547,421748.4985141443,18338730.806766693,3435,7,2241.6691729323306,127,671,84,31.05844975075389,0.6655183727034121,35.53059895833334,135493.80183630213,1066.8803294197019,0
3437,512.4253683313382,0,1,797,0.0,0.0012531328320802004,0.9987468671679198,798,20050,14100,5950,0.7032418952618454,260,141,119,169.24700784573463,0.42354867721373696,0.9299856660414052,0.12618986750778005,17927693.33802667,427191.6910073938,18354885.029034063,3436,8,2242.6691729323306,135,663,86,31.00098447996296,0.6648148148148147,35.477941176470615,135547.81342441292,1004.0578772178735,0
3438,512.7425721236459,0,0,797,0.0,0.0,1.0,797,23150,16500,6650,0.712742980561555,298,165,133,165.9435786579387,0.42329708454442855,0.9292365517646701,0.12446031718257834,17963821.407140814,413646.16213460354,18377467.569275416,3437,9,2246.440401505646,92,705,92,30.900823706963397,0.6758378623188406,35.29345878136199,135726.31280239765,1475.2860087217136,0
3439,512.3462084358838,0,0,797,0.0,0.0,1.0,797,23450,16600,6850,0.7078891257995735,303,166,137,167.62525406326483,0.42312908120695486,0.9284681491713438,0.12633122440959474,17970332.87260247,419606.32267427957,18389939.19527675,3438,10,2247.440401505646,98,699,98,30.703427088299144,0.6755952380952381,35.14309764309762,135698.42970063075,1384.677854088069,0
3440,511.9517917269707,0,0,797,0.0,0.0,1.0,797,21850,15400,6450,0.7048054919908466,283,154,129,166.42044845354886,0.42301243776389263,0.9274781958537817,0.1262435176127067,17983865.994431492,417326.60874435626,18401192.60317585,3439,11,2248.440401505646,102,695,74,30.53022498632782,0.6765727124183006,34.94134304207117,135697.25434235457,1330.365238650535,0
3441,512.2076072740152,0,0,797,0.0,0.0,1.0,797,22550,17000,5550,0.753880266075388,281,170,111,166.56919212927636,0.42290131124043473,0.9274220810380001,0.1268375944896573,18008765.307181094,417991.09769257193,18426756.404873665,3440,12,2249.440401505646,108,689,76,30.407146461006178,0.6763117283950617,34.8241590214067,135825.08301451846,1257.6396575418376,0
3442,511.96334294947206,0,0,797,0.0,0.0,1.0,797,22200,16600,5600,0.7477477477477478,278,166,112,163.33935861005997,0.4226281580424078,0.9257631421104728,0.12482841796593348,18015259.819652464,406920.19682711497,18422180.016479578,3441,13,2250.440401505646,113,684,82,30.379905337604285,0.6763458702064897,34.713084795321606,135817.17594893847,1201.9219110525528,0
3443,512.3271398851136,0,0,797,0.0,0.0,1.0,797,23300,17200,6100,0.7381974248927039,294,172,122,162.4527569881271,0.42223901817746196,0.9260890662617396,0.12465583368270292,18044974.24464392,403591.1631644233,18448565.40780834,3442,14,2251.440401505646,116,681,86,30.276995068934216,0.6769935344827587,34.58867521367519,135977.42492089528,1172.2191803525454,0
3444,512.5723084262858,0,0,797,0.0,0.0,1.0,797,22950,16500,6450,0.7189542483660131,294,165,129,164.4019951998345,0.4219720386751827,0.9274847860945734,0.12669637216364202,18071524.479702685,411848.93615314853,18483373.415855832,3443,15,2252.440401505646,126,671,88,30.091441441441404,0.6765046296296297,34.45702099737531,136109.97773376686,1080.2379185219593,0
3445,512.4196506169487,0,1,796,0.0,0.0012547051442910915,0.998745294855709,797,22050,15300,6750,0.6938775510204082,288,153,135,144.11026984115938,0.42172121586603023,0.917109785055449,0.10873199040982282,17977669.168815408,336703.3510066087,18314372.519822016,3444,16,2253.440401505646,107,690,99,31.290659287309403,0.6736760124610592,35.10802469135799,135735.85343888588,1268.559377933513,8
3446,512.7091336291088,0,0,796,0.0,0.0,1.0,796,22000,15400,6600,0.7,286,154,132,142.05656259145613,0.4215819005931123,0.9148710508529541,0.1078097315268755,18012346.302148186,330554.3999780128,18342900.702126198,3445,17,2256.384422110553,114,682,82,31.162007927829404,0.6739766081871346,34.92753623188403,135905.07324748219,1192.149765328791,0
3447,512.4047136220174,0,1,795,0.0,0.001256281407035176,0.9987437185929648,796,21900,16100,5800,0.7351598173515982,277,161,116,143.5403369158229,0.42146766326390867,0.9152868532409284,0.10937927898980682,18018658.80744625,336180.8711984097,18354839.678644657,3446,18,2257.384422110553,116,680,86,30.995694430456258,0.6748383620689655,34.80235042735039,135888.52568250327,1171.4528076077868,0
3448,512.027843616958,0,0,795,0.0,0.0,1.0,795,20400,14100,6300,0.6911764705882353,267,141,126,142.6812264253646,0.42134120420977034,0.9174889509288771,0.10656692687878859,17921119.144140784,332001.4516802238,18253120.595821008,3447,19,2258.761006289308,145,650,99,31.648795719512094,0.6640086206896552,35.423801369863035,135470.38045696262,934.278485910087,8
3449,512.3209411747723,0,0,795,0.0,0.0,1.0,795,22800,16700,6100,0.7324561403508771,289,167,122,142.87726747387322,0.42106073327735793,0.9172885471091157,0.10727741320362583,17953664.22342489,331234.09707726946,18284898.32050216,3448,20,2259.761006289308,105,690,105,31.476893095768386,0.6726190476190477,35.25943396226412,135632.1359595929,1291.7346281865991,0
3450,512.3225792592316,0,0,795,0.0,0.0,1.0,795,20650,15500,5150,0.7506053268765133,258,155,103,141.58666886781512,0.4208240921164499,0.9166776963983723,0.10671079335930643,17969646.86296721,329202.4880116937,18298849.350978907,3449,21,2260.761006289308,109,686,109,31.392009903822082,0.6728784403669725,35.14204545454542,135692.7104100495,1244.8872514683442,0
3451,512.4704653651019,0,0,795,0.0,0.0,1.0,795,21700,15800,5900,0.728110599078341,276,158,118,124.71535010828597,0.42066237082098973,0.9071628007801547,0.09223862741229044,17894903.13288708,265653.82187437225,18160556.954761453,3450,22,2261.761006289308,128,667,92,32.43575640908119,0.663330078125,35.73158914728681,135429.75549098518,1058.0449647733217,8
3452,512.5140174574694,0,0,795,0.0,0.0,1.0,795,22800,16300,6500,0.7149122807017544,293,163,130,125.34044291823055,0.4203803816886607,0.9078780526405015,0.09300177581846371,17910221.85744756,267175.02807524934,18177396.88552281,3451,23,2262.761006289308,131,664,96,32.316106235634756,0.6638835877862596,35.629734848484844,135493.46668909915,1034.3012724358714,0
3453,512.2428883636913,0,0,795,0.0,0.0,1.0,795,23150,16800,6350,0.7257019438444925,295,168,127,126.35958812703258,0.42024592198300675,0.9083800933848309,0.09410858361838774,17916598.677099768,270636.80589513324,18187235.482994903,3452,24,2263.761006289308,140,655,101,32.17065631313833,0.663764880952381,35.51270685579196,135481.73497568362,967.7266783977401,0
3454,512.0493488820983,0,0,795,0.0,0.0,1.0,795,22850,16100,6750,0.7045951859956237,296,161,135,127.12854886263439,0.42013126488496005,0.9091897393034458,0.09500211244260352,17924157.37588518,273884.42335634615,18198041.799241528,3453,25,2264.761006289308,106,689,106,32.043198179967376,0.6708922955974843,35.40693146417442,135484.70846248395,1278.1576270045655,0
3455,511.6476989256151,0,0,795,0.0,0.0,1.0,795,20400,13900,6500,0.6813725490196079,269,139,130,127.52228004624409,0.419910795853598,0.9094403519168748,0.09567251251778487,17926731.543586414,277811.53604300716,18204543.07962942,3454,26,2265.761006289308,109,686,109,31.90837327991226,0.6714449541284404,35.28409090909088,135441.28575536417,1242.5806032602218,0
3456,511.6185743152938,0,0,795,0.0,0.0,1.0,795,22900,16600,6300,0.7248908296943232,292,166,126,127.88495285166984,0.41970689500393416,0.9086089930304326,0.09633999781492376,17943029.229396775,277028.6894035038,18220057.91880028,3455,27,2266.761006289308,115,680,115,31.769296951819065,0.6714673913043478,35.15624999999998,135498.98179131487,1178.252015576651,0
3457,512.0237429110122,0,0,795,0.0,0.0,1.0,795,23100,17300,5800,0.7489177489177489,289,173,116,129.09990684181682,0.4195532267689009,0.9090660438135703,0.09771963442003741,17977255.85985906,282072.41135585826,18259328.271214917,3456,28,2267.761006289308,119,676,104,31.58764509013878,0.6721813725490196,35.008680555555536,135681.84722087096,1140.1835900913525,0
3458,512.2718777623518,0,0,795,0.0,0.0,1.0,795,20700,14900,5800,0.7198067632850241,265,149,116,128.8945681070271,0.41929427467008856,0.9091112113208342,0.0978401164168885,17997811.471367016,284264.0272947066,18282075.498661723,3457,29,2268.761006289308,121,674,83,31.504729541110972,0.6726928374655647,34.92144808743168,135792.28754277554,1122.2503102708722,0
3459,512.5637978723123,0,0,795,0.0,0.0,1.0,795,22350,16400,5950,0.7337807606263982,283,164,119,129.48375692560714,0.41911723935807865,0.9100011894437194,0.09861070578698641,18021822.892126374,285356.6669440797,18307179.559070453,3458,30,2269.761006289308,123,672,85,31.386581187104714,0.6733570460704608,34.82022849462363,135921.55080170577,1105.0532585504534,0
3460,513.0064925646099,0,1,794,0.0,0.0012578616352201257,0.9987421383647799,795,21650,15300,6350,0.7066974595842956,280,153,127,130.39784996373336,0.41889531813549213,0.9110291127210657,0.09968465514775439,18053267.732876018,290171.4594373341,18343439.19231335,3459,31,2270.761006289308,129,666,86,31.244116655088742,0.673530361757106,34.703525641025635,136098.81380065402,1055.0295643461552,0
3461,513.0033434581783,0,0,794,0.0,0.0,1.0,794,22550,15900,6650,0.70509977827051,292,159,133,132.28471026070497,0.4185345270275278,0.9126257970391798,0.10154516967494415,18070365.321723446,296736.6081778564,18367101.9299013,3460,32,2274.455919395466,133,661,90,31.06597547641361,0.6741854636591479,34.5771144278607,136162.8277288252,1023.7806596152271,0
3462,513.3654654916654,0,0,794,0.0,0.0,1.0,794,21450,15800,5650,0.7365967365967366,271,158,113,133.89248726544346,0.418372861086141,0.9140861991482145,0.10305620098473689,18094324.575457834,304288.8245592619,18398613.400017094,3461,33,2275.455919395466,138,656,91,30.939990309257,0.6742904589371981,34.49490407673863,136301.14715905578,987.6894721670709,0
3463,512.8031808937752,0,0,794,0.0,0.0,1.0,794,22800,17300,5500,0.7587719298245614,283,173,110,131.51407031997041,0.4181865779813503,0.9129088060426884,0.10150791408889981,18086073.81361323,294114.6366671377,18380188.450280365,3462,34,2276.455919395466,148,646,97,30.91707247521274,0.6738457207207207,34.40995525727068,136195.41975779078,920.2393226877755,0
3464,512.5311394945942,0,0,794,0.0,0.0,1.0,794,20700,15400,5300,0.7439613526570048,260,154,106,128.290490114763,0.41787704362161354,0.9104477052525579,0.0995751032287947,18099625.630012523,284901.968593611,18384527.598606136,3463,35,2277.455919395466,107,687,107,30.830520674554222,0.6824376947040498,34.2399691358025,136210.29145094712,1272.9933780462347,0
3465,512.5292456332677,0,0,794,0.0,0.0,1.0,794,22750,16500,6250,0.7252747252747253,290,165,125,126.1318186199794,0.41759086909704246,0.9086512430733542,0.09817855646913903,18111303.037811756,275332.317947353,18386635.35575911,3464,36,2278.455919395466,112,682,112,30.800594102893072,0.6821986607142857,34.153761061946916,136253.97229736255,1216.5533240835941,0
3466,512.7453328641938,0,0,794,0.0,0.0,1.0,794,24100,18100,6000,0.7510373443983402,301,181,120,126.51158908282332,0.4173415872299921,0.908619289019106,0.09891477947786934,18137330.15984501,276016.4920483667,18413346.651893377,3465,37,2279.455919395466,116,678,99,30.653905160390526,0.6827406609195402,34.01887464387467,136380.58065632076,1175.6946608303513,0
3467,512.5338008783572,0,0,794,0.0,0.0,1.0,794,20750,15600,5150,0.7518072289156627,259,156,103,126.44642416472243,0.4171610944526149,0.9085585434711938,0.09922144007381144,18144676.03580719,279315.88047103345,18423991.91627822,3466,38,2280.455919395466,120,674,77,30.54551263386068,0.6830729166666667,33.910123966942166,136380.05553847508,1136.5004628206257,0
3468,512.4602820419592,0,0,794,0.0,0.0,1.0,794,23050,17200,5850,0.7462039045553145,289,172,117,124.5697336671892,0.4170225567332971,0.9069588155211521,0.09818167700869121,18160168.674112484,270591.4750170847,18430760.14912957,3467,39,2281.455919395466,128,666,83,30.46112762494056,0.6830240885416667,33.77745478036175,136428.48060918375,1065.847504759248,0
3469,512.8823249172957,0,0,794,0.0,0.0,1.0,794,21400,14600,6800,0.6822429906542056,282,146,136,127.28144105106358,0.4167345623915389,0.9088238268851969,0.1007221637368315,18191519.76565562,282888.5701363088,18474408.335791927,3468,40,2282.455919395466,134,660,85,30.26736050756129,0.6833022388059702,33.6574074074074,136602.40811338826,1019.4209560700616,0
3470,512.49451724707,0,0,794,0.0,0.0,1.0,794,21600,16300,5300,0.7546296296296297,269,163,106,128.75986511224593,0.4165563195699567,0.9103916002786723,0.10225184428789938,18192123.413327288,288083.0713610662,18480206.484688353,3469,41,2283.455919395466,137,657,89,30.121456462411587,0.683926399026764,33.55223429951689,136553.01905422812,996.7373653593294,0
3471,512.8373701769092,0,0,794,0.0,0.0,1.0,794,20750,14400,6350,0.6939759036144578,271,144,127,132.1019857069752,0.4163749003401933,0.9128222239283685,0.10514939614330412,18213726.26936098,301663.8814611728,18515390.15082215,3470,42,2284.455919395466,138,656,91,29.962473756232885,0.6844806763285024,33.48321342925658,136679.76793293943,990.4331009633293,0
3472,512.7904076320274,0,0,794,0.0,0.0,1.0,794,20900,16000,4900,0.7655502392344498,258,160,98,130.82340724716124,0.4160887589032074,0.9123338995958059,0.10448377621894324,18225765.515870515,297171.3488947977,18522936.864765313,3471,43,2285.455919395466,146,648,98,29.894961240310067,0.6844320776255708,33.3829365079365,136718.6726697487,936.4292648612924,0
3473,512.3409606135816,0,0,794,0.0,0.0,1.0,794,22050,16300,5750,0.7392290249433107,278,163,115,132.6474217498644,0.415848774647604,0.9133985214267519,0.10644166265333256,18228885.458595797,302752.9314912606,18531638.390087057,3472,44,2286.455919395466,103,691,103,29.704728782587974,0.6934668284789645,33.243189102564074,136670.4407454064,1326.8974829651108,0
3474,512.177088381431,0,0,794,0.0,0.0,1.0,794,20300,14600,5700,0.7192118226600985,260,146,114,131.72374593272917,0.41552170386770043,0.9126611155238809,0.10607553829341802,18237343.416018713,301358.238123912,18538701.654142626,3473,45,2287.455919395466,106,688,106,29.623431343936968,0.6937893081761006,33.13862928348908,136680.27985505926,1289.4366024062194,0
3475,511.7717543887739,0,0,794,0.0,0.0,1.0,794,21550,15900,5650,0.7378190255220418,272,159,113,130.3064476435393,0.4151753430256135,0.9111611429644981,0.10529226349768156,18236608.676319666,294919.53873531334,18531528.21505498,3474,46,2288.455919395466,112,682,104,29.559665630755063,0.6934523809523809,33.038348082595874,136623.4329562954,1219.8520799669234,0
3476,511.29962621160035,0,0,794,0.0,0.0,1.0,794,22800,16500,6300,0.7236842105263158,291,165,126,130.2384586957533,0.41500153394045086,0.9108331907584846,0.10566813000375501,18236156.618321747,293409.7861009178,18529566.404422663,3475,47,2289.455919395466,117,677,99,29.440003029802227,0.6936431623931624,32.918432203389834,136558.70578241532,1167.1684254907293,0
3477,510.98361538917226,0,0,794,0.0,0.0,1.0,794,22450,16000,6450,0.7126948775055679,289,160,129,130.5519236141941,0.41467876454662594,0.9107164381201129,0.1061970601708859,18235232.09173847,294878.9254255492,18530111.017164018,3476,48,2290.455919395466,120,674,80,29.354840009022716,0.6938368055555555,32.8426308539945,136513.038364086,1137.6086530340501,0
3478,511.3642574155214,0,0,794,0.0,0.0,1.0,794,19650,13700,5950,0.6972010178117048,256,137,119,130.16182746131759,0.414352984182546,0.9098638694545715,0.10621244237846517,18261338.30807201,296935.8332136041,18558274.141285613,3477,49,2291.455919395466,126,668,84,29.272422224268315,0.6937003968253967,32.750984251968504,136661.59448302115,1084.6158292303267,0
3479,511.4410924656406,0,0,794,0.0,0.0,1.0,794,22600,15900,6700,0.7035398230088495,293,159,134,134.33468012949385,0.4140260457529834,0.9126117213889575,0.1100504540884926,18279780.664136138,309721.6976708079,18589502.361806944,3478,50,2292.455919395466,126,668,88,29.044531194077152,0.6948578042328042,32.63615485564305,136740.85704644464,1085.244897194005,0
3480,511.8562591209895,0,0,794,0.0,0.0,1.0,794,22750,16600,6150,0.7296703296703296,289,166,123,135.64137655405818,0.41366691310300135,0.9137835589987535,0.11168586407107138,18314769.95861188,315298.12169140374,18630068.08030328,3479,51,2293.455919395466,131,663,93,28.86039534106218,0.6955311704834606,32.488952020202014,136927.20429247455,1045.2458342936989,0
3481,511.64428075598533,0,0,794,0.0,0.0,1.0,794,21800,15400,6400,0.7064220183486238,282,154,128,137.76100393769664,0.41332472129665215,0.9149520162112812,0.11374481443276005,18318124.709578324,324104.6500494911,18642229.359627817,3480,52,2294.455919395466,141,653,94,28.722677595628447,0.6948877068557919,32.40903755868546,136911.3855150895,971.0027341495709,0
3482,511.38894214933083,0,0,794,0.0,0.0,1.0,794,21750,15800,5950,0.7264367816091954,277,158,119,140.62226168562333,0.4130655793292061,0.9177126993186622,0.11649265264554558,18322077.00668557,334748.38149165956,18656825.38817723,3481,53,2295.455919395466,143,651,97,28.54909809485205,0.6955856643356644,32.313368055555564,136891.9835375875,957.2865981649477,0
3483,510.9384610858446,0,0,794,0.0,0.0,1.0,794,20750,14900,5850,0.7180722891566265,266,149,117,139.27450495401533,0.41270270778209417,0.9166228206316813,0.11578805703853574,18319973.607018244,330751.05097761657,18650724.65799586,3482,54,2296.455919395466,102,692,102,28.48113914170975,0.7041462418300654,32.21076051779934,136823.82191638387,1341.4100187880772,0
3484,510.7943374906183,0,0,794,0.0,0.0,1.0,794,22100,14900,7200,0.6742081447963801,293,149,144,138.2822797651378,0.41228699536138524,0.915615780741867,0.11548238645265466,18332501.8463436,326112.0298221956,18658613.876165796,3483,55,2297.455919395466,108,686,108,28.376582842874992,0.7039930555555556,32.08142201834861,136851.2925415655,1267.1415976070878,0
3485,511.0456787359305,0,0,794,0.0,0.0,1.0,794,21350,15000,6350,0.702576112412178,277,150,127,138.11772501484742,0.41205759913305234,0.9156664131981915,0.11598618426672716,18363228.759216044,327107.4760300256,18690336.23524607,3484,56,2298.455919395466,112,682,105,28.220315670025055,0.7047061011904762,31.922935103244825,136999.6255836977,1223.2109427115865,0
3486,511.14017693557975,0,0,794,0.0,0.0,1.0,794,21900,15800,6100,0.7214611872146118,280,158,122,136.0776305881746,0.411658033453931,0.9148928269393202,0.11475712230376645,18383125.685603924,319606.4372203157,18702732.12282424,3485,57,2299.455919395466,114,680,77,28.152968691951767,0.7055007309941521,31.802536231884044,137086.49908410775,1202.5131498605942,0
3487,510.7476597925033,0,0,794,0.0,0.0,1.0,794,23300,16400,6900,0.703862660944206,302,164,138,133.76248512400085,0.41142655270772915,0.9127058823897591,0.11321285412860946,18383057.053960256,309692.6791427999,18692749.733103056,3486,58,2300.455919395466,124,670,80,28.11115252412307,0.7046370967741935,31.699999999999985,137033.59712232766,1105.1096542123198,0
3488,510.9944950694055,0,0,794,0.0,0.0,1.0,794,21250,13900,7350,0.6541176470588236,286,139,147,132.41972416179843,0.41095872734029815,0.9118686666204627,0.11258797336138174,18409615.574397605,307509.24325729266,18717124.817654897,3487,59,2301.455919395466,132,662,85,28.016587401161228,0.7046243686868687,31.57111528822054,137165.68240533868,1039.1339576162022,0
3489,510.84244764592427,0,0,794,0.0,0.0,1.0,794,20400,14400,6000,0.7058823529411765,264,144,120,123.67841837680108,0.4108119508122605,0.9062112334493357,0.10130181391189245,18257648.6494265,272415.4216480818,18530064.071074583,3488,60,2302.455919395466,130,664,89,29.334892286034354,0.6941506410256411,32.641539440203566,136578.05039121298,1050.6003876247153,8
3490,510.49903856611155,0,0,794,0.0,0.0,1.0,794,24850,17700,7150,0.7122736418511066,320,177,143,125.0294834953701,0.41047564859608054,0.9072935519308312,0.1029301762650079,18265517.119372606,273095.6342422015,18538612.75361481,3489,61,2303.455919395466,138,656,92,29.14939115493801,0.6944444444444444,32.494004796163075,136561.55336222998,989.5764736393477,0
3491,510.29723739361646,0,0,794,0.0,0.0,1.0,794,20650,14100,6550,0.6828087167070218,272,141,131,145.38187871581567,0.4103571619534063,0.918281942152348,0.11002282053127893,17915834.773748275,341477.54363392637,18257312.3173822,3490,62,2304.455919395466,113,681,96,31.162212643678124,0.6733038348082596,35.01461988304091,135221.30742338006,1196.6487382600005,8
3492,510.3573640851586,0,0,794,0.0,0.0,1.0,794,20600,14400,6200,0.6990291262135923,268,144,124,146.43487719508136,0.4102156132638335,0.9190619537652167,0.11131052054669331,17936402.518055372,345902.9800105938,18282305.498065967,3491,63,2305.455919395466,117,677,73,30.995869820974715,0.6738782051282051,34.87817796610168,135306.87425467404,1156.4690107237097,0
3493,510.10238217663834,0,0,794,0.0,0.0,1.0,794,19700,14000,5700,0.7106598984771574,254,140,114,148.55113124995302,0.4100246978971119,0.9200999267458922,0.11344004974485124,17946597.2716914,354697.46535940893,18301294.73705081,3492,64,2306.455919395466,120,674,78,30.796051991042727,0.6747395833333334,34.736570247933855,135311.50742087254,1127.5958951739378,0
3494,510.5656466515968,0,0,794,0.0,0.0,1.0,794,22500,16000,6500,0.7111111111111111,290,160,130,147.35779039336308,0.4098614437516345,0.9200124114678281,0.11296238670994106,17978874.670937076,348565.44905368995,18327440.119990766,3493,65,2307.455919395466,123,671,83,30.70801414959956,0.6753895663956639,34.61861559139782,135494.61813987207,1101.5822612997729,0
3495,510.3176466548165,0,0,794,0.0,0.0,1.0,794,23300,16900,6400,0.7253218884120172,297,169,128,148.87984275553052,0.4096479295642074,0.9211065894182955,0.11451676553573958,17984187.074012205,353396.58873299154,18337583.662745196,3494,66,2308.455919395466,133,661,85,30.562387756695546,0.674812030075188,34.51492537313431,135481.71850555926,1018.6595376357839,0
3496,509.94155780870295,0,0,794,0.0,0.0,1.0,794,19500,13100,6400,0.6717948717948717,259,131,128,149.67801392170875,0.40948153209813404,0.9220995437894275,0.11531447783339605,17977524.868624143,359868.043512759,18337392.9121369,3495,67,2309.455919395466,136,658,86,30.49178430642652,0.6748621323529411,34.46624087591241,135406.69877853835,995.6374910186644,0
3497,510.27095310402234,0,0,794,0.0,0.0,1.0,794,22400,15700,6700,0.7008928571428571,291,157,134,152.0272381340298,0.4092520366070455,0.9239672029024115,0.11764874588257988,18007575.2548903,366328.38629833737,18373903.641188636,3496,68,2310.455919395466,92,702,92,30.291292494062414,0.6855751811594203,34.330197132616505,135563.58352009833,1473.5172121749818,0
3498,510.5491057869095,0,0,794,0.0,0.0,1.0,794,20900,15400,5500,0.7368421052631579,264,154,110,147.44299982040437,0.4091083041368481,0.9212094249885112,0.11456652163836521,18034152.865934808,352101.91955463693,18386254.785489444,3497,69,2311.455919395466,98,696,98,30.28771294353616,0.6850552721088435,34.20664983164985,135700.55725255882,1384.6995638016206,0
3499,510.9207046602845,0,0,794,0.0,0.0,1.0,794,22550,16100,6450,0.7139689578713969,290,161,129,145.57335024990607,0.40873696216791977,0.919804369589641,0.11349590981157906,18061144.272484165,344494.2562184854,18405638.52870265,3498,70,2312.455919395466,103,691,103,30.233838412375547,0.6847694174757282,34.104567307692314,135851.48183710544,1318.9464256029655,0
3500,511.28802656879043,0,0,794,0.0,0.0,1.0,794,22750,17200,5550,0.756043956043956,283,172,111,145.37413605676682,0.40852632660040683,0.9197211746068716,0.11383346906926098,18091935.206741244,344469.890055004,18436405.096796248,3499,71,2313.455919395466,108,686,91,30.106288393145814,0.6848958333333333,33.973623853211016,136016.10087533883,1259.4083414383224,0
3501,511.62192205741275,0,0,794,0.0,0.0,1.0,794,22400,15100,7300,0.6741071428571429,297,151,146,145.26471251960822,0.40846220286024965,0.9194507366085245,0.1141828890594506,18119384.86249252,345221.4466164252,18464606.309108946,3500,72,2314.455919395466,112,682,73,29.99268296906934,0.6851748511904762,33.85877581120945,136163.68465818217,1215.7471844480551,0
3502,511.967724283038,0,0,794,0.0,0.0,1.0,794,23000,16600,6400,0.7217391304347827,294,166,128,146.03102777931122,0.4082367109669727,0.9196177407944253,0.11520904600711016,18146696.66593367,348196.15298514086,18494892.81891881,3501,73,2315.455919395466,117,677,75,29.86013256633839,0.6852742165242165,33.748234463276845,136312.31048817784,1165.0624828049388,0
3503,511.65347773651706,0,0,794,0.0,0.0,1.0,794,22000,15800,6200,0.7181818181818181,282,158,124,148.10306146705747,0.40805426602206757,0.9209756272440788,0.11726454582554201,18150209.01388018,356820.3042445303,18507029.318124708,3502,74,2316.455919395466,121,673,77,29.69584775825964,0.6856060606060606,33.640710382513674,136283.65686021585,1126.3112137207922,0
3504,511.2639348066132,0,0,794,0.0,0.0,1.0,794,23200,16300,6900,0.7025862068965517,301,163,138,156.1383713697397,0.4076816998124861,0.9253781294693697,0.1243343600434503,18159562.536013037,385080.9038320053,18544643.43984504,3503,75,2317.455919395466,128,666,81,29.309060704295057,0.6861165364583333,33.470607235142126,136266.86608657887,1064.5848913013974,0
3505,511.1599974439081,0,1,793,0.0,0.0012594458438287153,0.9987405541561712,794,19450,13700,5750,0.7043701799485861,252,137,115,160.61082706750747,0.40735234598920234,0.9282002779218528,0.12838760147384265,18171398.970189847,405454.68351517,18576853.653705016,3504,76,2318.455919395466,133,661,84,29.074073399220605,0.6864818295739348,33.356654228855724,136297.41194281346,1024.7925709985975,0
3506,511.0359364326978,0,0,793,0.0,0.0,1.0,793,23050,16200,6850,0.702819956616052,299,162,137,156.55329547716406,0.4071947140594681,0.9263456668659071,0.12588151798517794,18190676.9417294,387912.08443763765,18578589.02616704,3505,77,2322.1601513240857,89,704,89,29.005760277042754,0.6981507490636705,33.18287037037036,136353.14169656186,1532.0577718714815,0
3507,510.98072207228205,1,0,794,0.0012594458438287153,0.0,1.0,794,22750,16600,6150,0.7296703296703296,289,166,123,154.12083328487708,0.4071132550983998,0.9254354212412563,0.12443673854535114,18205249.905973673,379611.65713361715,18584861.56310729,3506,0,2320.234256926952,91,703,91,28.94751724917994,0.6987179487179487,33.06159420289854,136400.37934302638,1498.9052675057844,0
3508,510.5367158515587,0,0,794,0.0,0.0,1.0,794,21550,14700,6850,0.6821345707656613,284,147,137,153.68792187252797,0.4068609291735092,0.9251461217796635,0.12460795689504894,18206197.045736857,379264.51783220744,18585461.563569065,3507,1,2321.234256926952,94,700,86,28.834185279465686,0.6990248226950355,32.93859649122805,136344.65187807532,1450.4750199795246,0
3509,510.79683569751586,0,0,794,0.0,0.0,1.0,794,24100,17700,6400,0.7344398340248963,305,177,128,147.05924973679544,0.40647704700978227,0.9164117236993028,0.11725030926972256,18148004.549175117,350866.38664432964,18498870.935819447,3508,2,2322.234256926952,134,660,97,29.513537113690525,0.685556592039801,33.433641975308646,136161.25218242366,1016.1287476300273,8
3510,511.2688627133303,0,0,794,0.0,0.0,1.0,794,20450,14600,5850,0.7139364303178484,263,146,117,147.25515473926987,0.40623236431707754,0.9172704115128325,0.1176833128166982,18174302.14458973,356001.9349159617,18530304.07950569,3509,3,2323.234256926952,136,658,100,29.43739068856697,0.685968137254902,33.36374695863747,136322.8138506012,1002.3736312544206,0
3511,511.50125449979447,0,0,794,0.0,0.0,1.0,794,22750,16400,6350,0.7208791208791209,291,164,127,148.81080853858222,0.40594877062415363,0.918208372200886,0.11941181873480122,18199009.05256201,360091.85034254513,18559100.902904555,3510,4,2324.234256926952,103,691,103,29.273559431282017,0.6934668284789645,33.243189102564095,136446.4434204026,1324.722751654394,0
3512,511.8574630655459,1,0,795,0.0012578616352201257,0.0,1.0,795,21700,15800,5900,0.728110599078341,276,158,118,145.04422166720605,0.4057101479122771,0.9149970996069927,0.11688616095193158,18228849.652964935,348097.8619605632,18576947.5149255,3511,0,2322.309433962264,110,685,110,29.246515934690592,0.6930871212121212,33.11749249249249,136605.80322936413,1241.8709384487647,0
3513,512.1484559417398,0,0,795,0.0,0.0,1.0,795,20800,14400,6400,0.6923076923076923,272,144,128,144.1217022460772,0.40557806451953593,0.9147784536308803,0.11659014783029874,18254675.88994434,346378.992641842,18601054.88258618,3512,1,2323.309433962264,113,682,107,29.156399726214925,0.6935840707964602,33.00438596491229,136741.39147128738,1210.1008094804192,0
3514,512.3586514201916,0,0,795,0.0,0.0,1.0,795,20900,14600,6300,0.6985645933014354,272,146,126,143.47997514008384,0.4053990489467653,0.9142711237050849,0.11634663330666264,18271690.763630364,344424.3473066003,18616115.110936966,3513,2,2324.309433962264,114,681,101,29.102931533487105,0.694078947368421,32.93478260869566,136833.1746238497,1200.291005472366,0
3515,512.3612783282733,0,0,795,0.0,0.0,1.0,795,23050,17400,5650,0.754880694143167,287,174,113,144.1124601656206,0.4052470969377247,0.9144566545160362,0.11733143530168456,18287931.424489997,345053.7577846847,18632985.18227468,3514,3,2325.309433962264,120,675,82,28.96636164454181,0.6940972222222221,32.816804407713505,136894.3236414975,1140.7860303458124,0
3516,512.1511268232481,0,1,794,0.0,0.0012578616352201257,0.9987421383647799,795,23150,16800,6350,0.7257019438444925,295,168,127,141.83055274928913,0.40472067761882885,0.9134667829804528,0.11601545467109269,18299124.468233537,336924.98763152456,18636049.455865063,3515,4,2326.309433962264,125,670,88,28.888813720942245,0.6945833333333333,32.68022486772488,136908.1240561329,1095.2649924490631,0
3517,512.4768908887852,0,0,794,0.0,0.0,1.0,794,21150,15500,5650,0.7328605200945626,268,155,113,142.6783815723241,0.4042842334744718,0.9140372065029738,0.11715884495826462,18326092.23874364,342997.4362338182,18669089.67497746,3516,10,2330.234256926952,127,667,92,28.752688008439318,0.6953740157480315,32.568359375000014,137052.53571278794,1079.1538245101412,0
3518,512.2238136973292,0,1,793,0.0,0.0012594458438287153,0.9987405541561712,794,21400,16000,5400,0.7476635514018691,268,160,108,142.52893726994918,0.4040213195223106,0.9137616192238245,0.11738899352408483,18329002.799606033,342282.65804916003,18671285.45765519,3517,11,2331.234256926952,131,663,95,28.66814159292039,0.6956106870229007,32.48106060606063,137029.5713726299,1046.0272623864878,0
3519,511.8543816631811,0,1,792,0.0,0.0012610340479192938,0.9987389659520807,793,22150,16100,6050,0.7268623024830699,282,161,121,144.34314690809288,0.40367379660412445,0.9140933392176693,0.11923698541509492,18327556.627788782,348341.4397582685,18675898.06754705,3518,12,2330.841109709962,140,653,99,28.532401144760712,0.6951636904761904,32.39509456264778,136974.74340267177,978.3910243047983,0
3520,512.1004863435683,0,0,792,0.0,0.0,1.0,792,22050,15900,6150,0.7210884353741497,282,159,123,143.80137067265056,0.40344281149037786,0.9132364978799339,0.11957607237873845,18362447.672304045,347659.0288364189,18710106.701140463,3519,91,2334.7689393939395,107,685,107,28.353930307941617,0.7029789719626168,32.204861111111065,137138.0208654409,1281.6637464059897,0
3521,512.079596716271,0,0,792,0.0,0.0,1.0,792,20400,14200,6200,0.696078431372549,266,142,124,141.57559088563315,0.4033091596006419,0.9121497782476253,0.1183161622967724,18381403.216382794,341671.60433328425,18723074.82071608,3520,92,2335.7689393939395,112,680,112,28.26785018004994,0.7033110119047619,32.06120943952798,137205.98781484933,1225.0534626325832,0
3522,512.4515940925057,0,0,792,0.0,0.0,1.0,792,20150,13700,6450,0.6799007444168734,266,137,129,140.73353710720338,0.40291325869312594,0.912017862115851,0.11810617981970907,18411203.45046842,339664.7567969435,18750868.207265366,3521,93,2336.7689393939395,115,677,100,28.1689683762688,0.7038949275362318,31.941451149425244,137367.03066859822,1194.4959188573757,0
3523,512.4093330433831,0,0,792,0.0,0.0,1.0,792,21550,15600,5950,0.7238979118329466,275,156,119,140.81150582964534,0.40258795817424137,0.9121292735423179,0.11864414996141177,18425308.52006662,338949.0876172633,18764257.607683882,3522,94,2337.7689393939395,118,674,82,28.051556991774376,0.7044491525423728,31.827731092436927,137413.9734516523,1164.5251987428162,0
3524,511.9346791288771,0,0,792,0.0,0.0,1.0,792,22300,15900,6400,0.7130044843049327,287,159,128,138.51504159470412,0.4023014662533468,0.9099794067119593,0.11716287808433168,18423374.49562173,329682.8969151627,18753057.392536893,3523,95,2338.7689393939395,126,666,86,28.00140379304369,0.7041170634920635,31.717519685039335,137343.10547593635,1090.0246466344154,0
3525,512.2328251577686,0,0,792,0.0,0.0,1.0,792,20000,13300,6700,0.665,267,133,134,140.2067110689605,0.4019836481119667,0.9112852313457152,0.11886095464907168,18442869.011611093,338762.8013587182,18781631.81296981,3524,96,2339.7689393939395,128,664,87,27.891352210720534,0.7044270833333333,31.653746770025798,137455.75941248902,1073.8731204100704,0
3526,511.98996438060925,0,0,792,0.0,0.0,1.0,792,23000,16900,6100,0.7347826086956522,291,169,122,141.59937175402763,0.40159190408084217,0.9112735383279833,0.12039038288431796,18445400.23429158,340971.41698544857,18786371.651277028,3525,97,2340.7689393939395,135,657,90,27.770763187429843,0.7041666666666666,31.571691176470562,137432.60027330412,1018.0192612837343,0
3527,512.1457572740251,0,0,792,0.0,0.0,1.0,792,19200,13400,5800,0.6979166666666666,250,134,116,141.6765012812336,0.40135492887152174,0.9120349071006986,0.12066929591884232,18457880.73341834,345409.59267539193,18803290.326093733,3526,98,2341.7689393939395,137,655,91,27.718033063427782,0.7043795620437956,31.521739130434757,137500.00222465483,1003.6496512748528,0
3528,512.4457756082107,0,0,792,0.0,0.0,1.0,792,20400,14500,5900,0.7107843137254902,263,145,118,143.5585188905253,0.40100954232591396,0.913632949620317,0.12267727977917474,18481513.76846568,351835.7486911495,18833349.51715683,3527,99,2342.7689393939395,139,653,96,27.572999778368775,0.7050359712230216,31.428571428571402,137628.2940204891,990.1316116581949,0
3529,512.1769993617876,0,0,792,0.0,0.0,1.0,792,21600,15400,6200,0.7129629629629629,278,154,124,145.17262249044285,0.4006361550609338,0.9152516172873293,0.12436286050696804,18481354.92252321,356597.35225586296,18837952.274779074,3528,100,2343.7689393939395,142,650,99,27.459337744154276,0.7053257042253521,31.35926573426571,137591.60518256927,968.9549660744315,0
3530,512.3616347997394,0,0,792,0.0,0.0,1.0,792,24700,19600,5100,0.7935222672064778,298,196,102,146.36080405550317,0.4002660600420556,0.9165877782497374,0.12600172869249737,18507081.567809578,358642.26779707946,18865723.835606657,3529,101,2344.7689393939395,106,686,106,27.286920327912416,0.7131485849056604,31.22079439252337,137712.1531852222,1299.1712564643606,0
3531,511.94654272551577,0,1,791,0.0,0.0012626262626262627,0.9987373737373737,792,20000,14500,5500,0.725,255,145,110,142.49413681560245,0.4001020795821681,0.913764299467664,0.12326873740397358,18510705.622909132,349133.4039168306,18859839.026825964,3530,102,2345.7689393939395,113,679,113,27.253652735304133,0.7129424778761062,31.085526315789473,137669.83509148323,1218.3171247033913,0
3532,511.4665456440494,0,0,791,0.0,0.0,1.0,791,20800,14900,5900,0.7163461538461539,267,149,118,143.04962354430046,0.3999800631577824,0.9135589135897881,0.11838611448275485,18320943.815214988,345160.8231485639,18666104.63836355,3531,103,2349.4943109987357,144,647,99,28.513115751426977,0.6951678240740741,32.34195402298853,136898.13618970028,950.6815013173631,8
3533,511.2889384666243,0,0,791,0.0,0.0,1.0,791,21700,16100,5600,0.7419354838709677,273,161,112,143.68120637708128,0.39977195986493624,0.9144608361577464,0.11911635496422718,18321464.353723187,346590.02018753573,18668054.37391072,3532,104,2350.4943109987357,153,638,101,28.445201037613522,0.6945806100217865,32.29166666666669,136876.30956867128,894.6164024096162,0
3534,511.60673324963983,0,0,791,0.0,0.0,1.0,791,22900,17200,5700,0.7510917030567685,286,172,114,141.45349329567185,0.39961813279137126,0.9136794292408303,0.11783179747147877,18351699.97230618,338082.41379935126,18689782.386105534,3533,105,2351.4943109987357,105,686,105,28.36531405928963,0.7039682539682539,32.15408805031443,137031.77202684744,1305.0644954937852,0
3535,511.1856011371056,0,0,791,0.0,0.0,1.0,791,22700,15800,6900,0.6960352422907489,296,158,138,140.6175553960439,0.3993089450409939,0.9123872508387381,0.11757109983083996,18351166.840448458,335199.2439537529,18686366.08440221,3534,106,2352.4943109987357,110,681,110,28.279792549527727,0.7038825757575757,32.04767267267263,136973.37152090413,1245.2124683718557,0
3536,510.95638819186735,0,0,791,0.0,0.0,1.0,791,21450,14900,6550,0.6946386946386947,280,149,131,138.22632538488818,0.3989324787829325,0.9109316588052501,0.11591569550715362,18354571.249630872,327766.98757030827,18682338.23720118,3535,107,2353.4943109987357,113,678,107,28.25773846048953,0.7040929203539823,31.962719298245567,136955.36084813543,1211.9943437888091,0
3537,511.08446016183063,0,0,791,0.0,0.0,1.0,791,21350,14900,6450,0.6978922716627635,278,149,129,136.98866714166581,0.39859768652616195,0.9093635716161692,0.11527310029251918,18372594.524642754,323817.4471730085,18696411.97181576,3536,108,2354.4943109987357,121,670,81,28.191605103383854,0.703512396694215,31.864754098360624,137039.75740199714,1132.5599785289019,0
3538,510.8069879068479,0,0,791,0.0,0.0,1.0,791,21750,15600,6150,0.7172413793103448,279,156,123,136.8025133526442,0.3982270212890802,0.9083436524950186,0.11548026481199854,18374915.140883137,322796.91478286724,18697712.055666003,3537,109,2355.4943109987357,124,667,87,28.105614585598726,0.7038810483870968,31.77499999999997,137011.20433131242,1104.9290671880033,0
3539,510.3953685860156,0,0,791,0.0,0.0,1.0,791,22000,16000,6000,0.7272727272727273,280,160,120,136.6206229718387,0.39790943206004253,0.9090565054676716,0.11586193733521406,18378087.603192654,321965.15547583386,18700052.758668486,3538,110,2356.4943109987357,126,665,92,27.97740030971734,0.7048611111111112,31.643700787401542,136967.81224899125,1087.046128960248,0
3540,510.62634269899957,0,0,791,0.0,0.0,1.0,791,23000,16900,6100,0.7347826086956522,291,169,122,134.99666940882028,0.397618447513429,0.9081362604178531,0.11485603727927671,18398949.97968728,315559.393575444,18714509.373262726,3539,111,2357.4943109987357,130,661,96,27.928206457345926,0.7051282051282051,31.552162849872737,137076.5372894237,1054.4349022263361,0
3541,510.3385030942598,0,0,791,0.0,0.0,1.0,791,21200,14800,6400,0.6981132075471698,276,148,128,134.22015202001563,0.39727965455253456,0.9086492970976743,0.11469083560723292,18405299.644143358,314672.4232421613,18719972.06738552,3540,112,2358.4943109987357,132,659,99,27.82538907196251,0.7060448232323233,31.430137844611483,137061.54142860946,1038.345010822799,0
3542,510.85797141256137,0,0,791,0.0,0.0,1.0,791,21350,15600,5750,0.7306791569086651,271,156,115,134.1388772411076,0.3970361450281916,0.908940195265763,0.11493161608133158,18434459.009526744,315005.52681701496,18749464.53634376,3541,113,2359.4943109987357,139,652,100,27.75058162078319,0.7057853717026379,31.354166666666618,137239.8654451002,987.337161475541,0
3543,511.1097098281119,0,0,791,0.0,0.0,1.0,791,22850,17400,5450,0.7614879649890591,283,174,109,133.06823826110724,0.39685651341302736,0.9086843505057323,0.11435064527069025,18454888.458669744,310101.89890007535,18764990.35756982,3542,114,2360.4943109987357,144,647,105,27.69562960586695,0.7059461805555556,31.271551724137893,137349.71922083184,953.8174945891101,0
3544,511.27944839790064,0,0,791,0.0,0.0,1.0,791,19050,13300,5750,0.6981627296587927,248,133,115,131.56356247971112,0.3964810473309969,0.9067679374531608,0.11344882031287917,18474295.75036614,308858.8326443969,18783154.583010536,3543,115,2361.4943109987357,110,681,110,27.638166468849708,0.7126893939393939,31.17492492492496,137444.73609991034,1249.497600908276,0
3545,511.5356644070367,0,0,791,0.0,0.0,1.0,791,21600,16600,5000,0.7685185185185185,266,166,100,130.95238188417454,0.39622200173897276,0.9062207999027143,0.11338895218789921,18499390.748275563,304707.85637855425,18804098.60465412,3544,116,2362.4943109987357,114,677,114,27.537946403511746,0.7129934210526316,31.059782608695677,137572.51278903522,1206.7764279739931,0
3546,512.0299590235826,0,0,791,0.0,0.0,1.0,791,21400,15400,6000,0.719626168224299,274,154,120,129.10295991283866,0.39579919399147584,0.9047117750670504,0.11205224999783428,18526326.74711687,298760.7238730398,18825087.470989913,3545,117,2363.4943109987357,117,674,117,27.521050055240188,0.7130519943019943,30.993997175141264,137739.13260351127,1177.2575436197544,0
3547,511.8926229279942,0,1,790,0.0,0.0012642225031605564,0.9987357774968394,791,21500,16100,5400,0.7488372093023256,269,161,108,125.30243687155951,0.3954837384713043,0.9008209834215664,0.109176791355541,18536198.541041005,284826.16950549744,18821024.7105465,3546,118,2364.4943109987357,125,666,108,27.51418243630702,0.7126666666666667,30.88624338624339,137757.3467390219,1102.0587739121752,0
3548,512.0632446852773,0,0,790,0.0,0.0,1.0,790,21700,15900,5800,0.7327188940092166,275,159,116,128.10214280304064,0.39509005684704773,0.9023151871910104,0.11191665875529476,18552631.580162194,295626.3720108315,18848257.952173024,3547,119,2368.2101265822785,125,665,91,27.363480595395284,0.7134166666666666,30.811838624338638,137841.36334488617,1102.7309067590893,0
3549,511.8873225908112,0,0,790,0.0,0.0,1.0,790,19000,13400,5600,0.7052631578947368,246,134,112,127.4874182891136,0.39484028145438604,0.9023738672596244,0.11164766335398729,18555407.810974803,296116.2074245697,18851524.018399373,3548,120,2369.2101265822785,127,663,93,27.3127858711641,0.713746719160105,30.74544270833335,137827.9944274064,1085.2597986409953,0
3550,512.3565329614677,0,0,790,0.0,0.0,1.0,790,22300,16300,6000,0.7309417040358744,283,163,120,126.59178068278588,0.3944584489793736,0.9018935307749516,0.11128663993592045,18586905.71497552,290289.89836836327,18877195.613343883,3549,121,2370.2101265822785,134,656,95,27.230561364309114,0.7136971393034826,30.640432098765444,138008.13432987643,1029.9114502229584,0
3551,512.306266064924,0,0,790,0.0,0.0,1.0,790,19850,14200,5650,0.7153652392947103,255,142,113,126.0809264882416,0.39414129138523907,0.9020436123816604,0.11130289504525843,18600964.56762505,291195.3692522269,18892159.936877277,3550,122,2371.2101265822785,137,653,100,27.127801120448208,0.7144160583941606,30.525362318840592,138053.545429634,1007.6901126250656,0
3552,512.4598189650405,0,1,789,0.0,0.0012658227848101266,0.9987341772151899,790,20800,14900,5900,0.7163461538461539,267,149,118,127.0637143326996,0.3938064526479601,0.902349288808632,0.11230538229529945,18611088.670028847,294158.8108378188,18905247.480866667,3551,123,2372.2101265822785,142,648,100,27.067960880768346,0.7140551643192488,30.49242424242425,138111.80348243474,972.6183343833433,0
3553,512.5351582468403,0,0,789,0.0,0.0,1.0,789,21650,16200,5450,0.7482678983833718,271,162,109,132.57590472003855,0.3935269403322761,0.9090405660051939,0.10718049940505385,18265855.184947237,304872.45532592206,18570727.64027316,3552,124,2375.95690747782,120,669,109,29.48394976138268,0.6920138888888889,33.02341597796145,136834.88573993754,1140.2907144994795,8
3554,512.9140847892928,0,0,789,0.0,0.0,1.0,789,22050,15300,6750,0.6938775510204082,288,153,135,133.73738120537317,0.393390761614329,0.9099980044221632,0.10852593920478973,18294440.536066063,309480.11358218355,18603920.649648245,3553,125,2376.95690747782,123,666,74,29.34135895661657,0.6925813008130082,32.91330645161292,136992.52698077023,1113.7603819574815,0
3555,512.4857628054514,0,0,789,0.0,0.0,1.0,789,22200,15500,6700,0.6981981981981982,289,155,134,132.124413661732,0.3930861019431738,0.9088713212296262,0.1077458172595204,18298863.022860788,303545.3095143709,18602408.332375158,3554,126,2377.95690747782,132,657,78,29.23865523642046,0.692550505050505,32.76942355889726,136951.86581236022,1037.5141349421228,0
3556,512.4029681123676,0,0,789,0.0,0.0,1.0,789,21250,15500,5750,0.7294117647058823,270,155,115,132.9687852999383,0.3930117799952391,0.9121029074583513,0.1026758966188236,18073782.815798372,301599.78935831774,18375382.60515669,3555,127,2378.95690747782,144,645,100,30.86485493526634,0.6744791666666667,34.396551724137915,136095.99523743012,945.1110780377091,7
3557,512.5276326825835,0,0,789,0.0,0.0,1.0,789,21650,16400,5250,0.7575057736720554,269,164,105,133.89713480214544,0.3928867931305879,0.9129122696305252,0.10363811818657619,18087998.759688422,304936.24164541357,18392935.001333836,3556,128,2379.95690747782,102,687,102,30.767113944930845,0.6828022875816994,34.32443365695796,136166.0690794055,1334.961461562799,0
3558,512.2228475416184,0,0,789,0.0,0.0,1.0,789,20000,13800,6200,0.69,262,138,124,136.79662736526697,0.3926240191379351,0.914123770370513,0.10629510557918452,18093315.462585706,317220.9066275189,18410536.369213223,3557,129,2380.95690747782,104,685,104,30.57038170598193,0.6834935897435898,34.206349206349245,136145.58066800833,1309.0921218077724,0
3559,512.5464374264626,0,0,789,0.0,0.0,1.0,789,20650,15200,5450,0.7360774818401937,261,152,109,137.4765339559671,0.3924290664359134,0.9142305329012725,0.10722541543327586,18120234.437619306,319771.40499069646,18440005.84261,3558,130,2381.95690747782,106,683,99,30.437077445022087,0.6841588050314465,34.09267912772588,136289.8499987007,1285.7533018745348,0
3560,512.8027184206064,0,0,789,0.0,0.0,1.0,789,20800,15200,5600,0.7307692307692307,264,152,112,137.5323023692242,0.392345563147251,0.914623321976497,0.10754600931116144,18139916.166637212,320364.8870364714,18460281.053673685,3559,131,2382.95690747782,106,683,98,30.356641778298357,0.6849449685534591,34.01479750778819,136397.93489766304,1286.7729707326703,0
3561,512.6914298676562,0,0,789,0.0,0.0,1.0,789,21550,15200,6350,0.7053364269141531,279,152,127,135.81908749822722,0.3921764790402724,0.91369215010129,0.10670740329781156,18155306.811326314,313817.4408729438,18469124.25219926,3560,132,2383.95690747782,109,680,83,30.258594871247464,0.685684250764526,33.87310606060609,136440.9777800277,1251.7520897250247,0
3562,512.3394798255995,0,0,789,0.0,0.0,1.0,789,21700,15300,6400,0.7050691244239631,281,153,128,135.25136932301425,0.3919938574820019,0.9128291119109844,0.10663380491260975,18157161.584705107,311656.1934701266,18468817.778175235,3561,133,2384.95690747782,114,675,87,30.167293254400242,0.685672514619883,33.76811594202902,136401.1049912523,1196.5009209758973,0
3563,512.7899982312961,0,0,789,0.0,0.0,1.0,789,21850,16000,5850,0.7322654462242563,277,160,117,136.5528459626148,0.3916668811213406,0.9135871620254057,0.10814132600279819,18191354.412893046,317166.2433990313,18508520.656292077,3562,134,2385.95690747782,120,669,90,29.997347101472723,0.6858506944444445,33.63464187327827,136589.4915226823,1138.2457626890193,0
3564,512.6500180836426,0,0,789,0.0,0.0,1.0,789,20200,13600,6600,0.6732673267326733,268,136,132,138.0887040395685,0.39155201383661553,0.9150545737633511,0.10975474269203706,18201152.348012798,324674.70795277273,18525827.05596557,3563,135,2386.95690747782,123,666,92,29.846848302386448,0.6863990514905149,33.52654569892476,136607.62116625853,1110.6310663923457,0
3565,512.6887254431638,0,0,789,0.0,0.0,1.0,789,20500,14000,6500,0.6829268292682927,270,140,130,137.70353537972707,0.3913465394521541,0.9149999357628384,0.10978542578236214,18215014.997701913,323354.39243566483,18538369.39013758,3564,136,2387.95690747782,132,657,95,29.764458155820037,0.685842803030303,33.43515037593986,136664.79300170887,1035.3393409220369,0
3566,512.598338659415,0,0,789,0.0,0.0,1.0,789,22000,16100,5900,0.7318181818181818,279,161,118,139.09980998281603,0.3911754448326074,0.9165924901065741,0.11122234232296205,18223624.820571758,327180.5499479332,18550805.37051969,3565,137,2388.95690747782,135,654,97,29.639536776392625,0.6862654320987654,33.348651960784316,136685.0380061957,1012.4817630088571,0
3567,512.4175946791545,0,0,789,0.0,0.0,1.0,789,21100,14800,6300,0.7014218009478673,274,148,126,135.69711737037713,0.3910167483738974,0.9142255976497327,0.1088888619139872,18231612.06784822,315895.44052439346,18547507.508372612,3566,138,2389.95690747782,103,686,103,29.623376074794415,0.6934668284789645,33.24318910256409,136690.88340434546,1327.0959553819946,0
3568,512.0242723514368,0,0,789,0.0,0.0,1.0,789,22900,16600,6300,0.7248908296943232,292,166,126,135.50574481088782,0.3908340597985413,0.91350315426256,0.10957261719834765,18248509.711329397,313855.5800244811,18562365.291353878,3567,139,2390.95690747782,111,678,101,29.399341601058996,0.6938813813813813,33.01711309523809,136701.71839769642,1231.5470125918596,0
3569,512.2473151717273,0,0,789,0.0,0.0,1.0,789,22250,16200,6050,0.7280898876404495,283,162,121,134.46209687106312,0.39076355782448596,0.9131170282925756,0.10916900640236517,18272677.282406304,311346.5005681176,18584023.782974422,3568,140,2391.95690747782,114,675,75,29.30704862995116,0.6944444444444444,32.89855072463767,136822.00026978133,1200.1929848226432,0
3570,511.7943673886743,0,0,789,0.0,0.0,1.0,789,21900,14300,7600,0.6529680365296804,295,143,152,137.98484278132497,0.3905881741114607,0.9147535856557643,0.11244472132489523,18271328.80595722,324533.28653917834,18595862.0924964,3569,141,2392.95690747782,116,673,77,29.103152522795675,0.6951329022988506,32.790242165242155,136756.44897112017,1178.9349049234497,0
3571,512.1285013370865,0,0,789,0.0,0.0,1.0,789,23550,18200,5350,0.772823779193206,289,182,107,138.36944023613907,0.3904948193112145,0.914780644996001,0.11308172637838004,18294700.012757324,324935.48001066485,18619635.49276799,3570,142,2393.95690747782,122,667,78,29.008116300192235,0.6948428961748634,32.70663956639567,136888.548096216,1122.0372794771802,0
3572,512.4609114002747,0,0,789,0.0,0.0,1.0,789,21000,14400,6600,0.6857142857142857,276,144,132,139.02589167759817,0.39039214913606934,0.9157767863995137,0.11408216100862412,18322818.801526397,330669.2443858554,18653488.045912255,3571,143,2394.95690747782,122,667,83,28.870357761168815,0.6960382513661203,32.588075880758815,137038.158353448,1123.2635930610493,0
3573,511.9985560038824,0,0,789,0.0,0.0,1.0,789,21650,15600,6050,0.7205542725173211,277,156,121,139.23397657289104,0.39024538171859685,0.9160866278660744,0.11466621641721224,18320631.067866098,330720.8633807683,18651351.931246866,3572,144,2395.95690747782,124,665,88,28.758592403380888,0.6967405913978495,32.48333333333333,136968.1470403048,1104.5818309702,0
3574,512.0726076560516,0,0,789,0.0,0.0,1.0,789,22450,16800,5650,0.7483296213808464,281,168,113,139.20376998715497,0.38983550522304355,0.9164285534925578,0.11509150796591033,18338811.135107316,330316.3294178713,18669127.464525186,3573,145,2396.95690747782,132,657,92,28.644476798064648,0.6965751262626263,32.36998746867168,137045.99840393916,1038.2272606359027,0
3575,512.4779256607345,0,0,789,0.0,0.0,1.0,789,22650,17500,5150,0.7726269315673289,278,175,103,140.03007183307625,0.3896498678959209,0.9176901092673837,0.11626638300210482,18370088.17367963,334022.9533080627,18704111.126987696,3574,146,2397.95690747782,94,695,94,28.498471135864136,0.7060062056737588,32.24780701754387,137217.08845076233,1459.7562601144928,0
3576,512.1731615985368,0,0,789,0.0,0.0,1.0,789,20900,14000,6900,0.6698564593301436,278,140,138,139.74832173634218,0.38952843293680667,0.917174417556992,0.116376056508385,18370822.95241362,334758.3353030594,18705581.28771668,3575,147,2398.95690747782,96,693,96,28.41982077703378,0.7062717013888888,32.16280068728524,137179.02516569154,1428.948178809287,0
3577,512.5331051916147,0,0,789,0.0,0.0,1.0,789,22300,16300,6000,0.7309417040358744,283,163,120,139.93254621703647,0.38922357221439463,0.9174628463183028,0.11694723627885976,18397822.83274491,334790.83876718924,18732613.6715121,3576,148,2399.95690747782,98,691,98,28.310835133189364,0.7067389455782314,32.060185185185205,137328.02529150416,1401.3063805255526,0
3578,512.50163699379,0,0,789,0.0,0.0,1.0,789,21150,14700,6450,0.6950354609929078,276,147,129,141.0484802719664,0.38899222923489,0.9177793412743949,0.11828683297154398,18410228.798084565,340396.9586858059,18750625.75677037,3577,149,2400.95690747782,100,689,98,28.180993240730064,0.7071875000000001,31.96163366336635,137370.10152466653,1373.7010152466653,0
3579,512.0218386623751,0,0,789,0.0,0.0,1.0,789,20350,15100,5250,0.742014742014742,256,151,105,140.60097781674148,0.38869340005018244,0.9173623529424741,0.11852128937869026,18413172.26922295,339632.0051521722,18752804.274375122,3578,150,2401.95690747782,106,683,75,28.0439293838633,0.7071540880503144,31.81464174454829,137316.7602362844,1295.44113430457,0
3580,512.2286087744429,0,0,789,0.0,0.0,1.0,789,20250,13700,6550,0.6765432098765433,268,137,131,138.35104924158694,0.38841568124743997,0.91594539299019,0.1170171537194818,18433718.808062363,332014.8677039602,18765733.675766323,3579,151,2402.95690747782,110,679,77,28.0075264679819,0.7071969696969698,31.71921921921922,137421.09110026062,1249.2826463660056,0
3581,511.8061839460788,0,0,789,0.0,0.0,1.0,789,21850,16000,5850,0.7322654462242563,277,160,117,142.27175654451574,0.3881763632347485,0.9155831217082631,0.11087632522637447,18090757.991982073,335110.7833482122,18425868.775330286,3580,152,2403.95690747782,108,681,108,30.33420794095802,0.6834490740740741,34.11697247706425,136080.57769254578,1260.0053490050534,8
3582,512.2852518048569,0,0,789,0.0,0.0,1.0,789,21850,16100,5750,0.7368421052631579,276,161,115,142.74732407726154,0.38805747492488724,0.9154012203067303,0.1117790638296239,18127313.433511794,337875.0970687238,18465188.530580517,3581,153,2404.95690747782,113,676,98,30.175488310320382,0.6838126843657817,33.972953216374286,136281.73264845303,1206.033032287195,0
3583,512.5615222878955,0,0,789,0.0,0.0,1.0,789,20050,14100,5950,0.7032418952618454,260,141,119,141.66354266643566,0.3879665327397228,0.9145282490740627,0.11138584809233229,18153897.372176632,336499.0829890941,18490396.455165725,3582,154,2405.95690747782,116,673,82,30.079335875649537,0.6844468390804598,33.84971509971513,136418.39518584864,1176.0206481538676,0
3584,512.6764532522723,0,0,789,0.0,0.0,1.0,789,21950,16700,5250,0.7608200455580866,272,167,105,143.6997094042969,0.3878332357564567,0.9153188542699415,0.11335664149643901,18171343.47474426,342493.3553612889,18513836.83010555,3583,155,2406.95690747782,121,668,83,29.92572742626857,0.684486914600551,33.75170765027325,136499.23020633345,1128.0928116225905,0
3585,512.7373937818,0,0,789,0.0,0.0,1.0,789,21200,15100,6100,0.7122641509433962,273,151,122,145.7938308677067,0.38758259185629823,0.9164414080832397,0.11545122305361614,18189192.005248316,351374.39656668593,18540566.401815,3584,156,2407.95690747782,126,663,86,29.75340005132156,0.6847718253968254,33.63681102362206,136574.36731515778,1083.9235501202998,0
3586,512.5400832549848,0,0,789,0.0,0.0,1.0,789,20200,13600,6600,0.6732673267326733,268,136,132,170.20213969276915,0.3872995787037931,0.9294264186625798,0.13025600071196275,18041415.21716421,436137.4946093997,18477552.71177361,3585,157,2408.95690747782,112,677,75,30.154011627233647,0.6769903273809523,34.66998525073743,135992.26784963164,1214.216677228854,8
3587,512.2738203957541,0,0,789,0.0,0.0,1.0,789,22150,15600,6550,0.7042889390519187,287,156,131,171.7743869948256,0.387316332975194,0.9302633813034786,0.13195558418833125,18047729.835277572,440077.54582059826,18487807.38109817,3586,158,2409.95690747782,115,674,80,29.994925575101437,0.677536231884058,34.5545977011494,135980.73034211842,1182.4411334097254,0
3588,512.7396714938992,0,0,789,0.0,0.0,1.0,789,22000,16100,5900,0.7318181818181818,279,161,118,170.64319742116163,0.38742912273026536,0.9302980305028021,0.13164434903449426,18081785.185050227,437306.72781190753,18519091.912862133,3587,159,2410.95690747782,124,665,85,29.893143284487508,0.6771673387096775,34.42499999999998,136170.83825699124,1098.1519214273487,0
3589,513.1730104361615,0,0,789,0.0,0.0,1.0,789,22550,16100,6450,0.7139689578713969,290,161,129,163.81397286827135,0.38730668251486705,0.9271454441840659,0.11457488515094964,17676753.523477174,398789.84441879526,18075543.36789597,3588,160,2411.95690747782,114,675,85,33.22750227191675,0.6477521929824561,37.52717391304345,134693.97032072884,1181.5260554449899,8
3590,513.3376397049652,0,0,789,0.0,0.0,1.0,789,20200,14700,5500,0.7277227722772277,257,147,110,163.64763434310595,0.38756965755877665,0.927531481746358,0.11488104893998591,17698705.26525274,401270.2495189012,18099975.51477164,3589,161,2412.95690747782,88,701,88,33.109084358471435,0.6557765151515151,37.40636704119852,134799.1957446242,1531.8090425525477,0
3591,512.9478071005132,0,0,789,0.0,0.0,1.0,789,19350,13500,5850,0.6976744186046512,252,135,117,165.01259967008764,0.3877741266869541,0.9281868354425302,0.11624630624803439,17700717.881390616,407018.2947270171,18107736.176117633,3590,162,2413.95690747782,89,700,89,32.956648162833744,0.6566011235955056,37.291666666666686,134755.66349036474,1514.108578543424,0
3592,513.3079754304905,0,1,788,0.0,0.0012674271229404308,0.9987325728770595,789,22450,17000,5450,0.7572383073496659,279,170,109,163.71900441772578,0.3877637390386855,0.9267304023506062,0.11572340952192517,17727935.811348647,400230.00028307154,18128165.811631717,3591,163,2414.95690747782,94,695,85,32.879187700780136,0.6561391843971631,37.18201754385966,134906.56648128806,1435.176239162639,0
3593,513.3659476494198,0,0,788,0.0,0.0,1.0,788,23750,17000,6750,0.7157894736842105,305,170,135,161.54888478868276,0.3878618511578807,0.9250786340453288,0.11449964344795266,17741849.19333746,391885.19025453576,18133734.383591995,3592,164,2417.992385786802,99,689,87,32.84652885085252,0.6556186868686869,37.09375000000002,134967.11617420628,1363.3042037798614,0
3594,513.2659032196716,0,0,788,0.0,0.0,1.0,788,20450,14400,6050,0.7041564792176039,265,144,121,158.51774832504572,0.38774484430799133,0.9236335827179127,0.1128003107646349,17755865.99054408,384873.9792764662,18140739.969820548,3593,165,2418.992385786802,104,684,78,32.794702798521534,0.6556490384615384,36.96428571428574,135007.26347188983,1298.1467641527868,0
3595,513.6850809871307,0,0,788,0.0,0.0,1.0,788,21350,15300,6050,0.7166276346604216,274,153,121,143.01785838866914,0.3877259646497548,0.917038756407403,0.09929895390773721,17661862.288980436,326242.34394511615,17988104.63292555,3594,166,2419.992385786802,127,661,83,34.01817671642411,0.6429625984251969,37.7685546875,134704.3812227239,1060.6644190765662,8
3596,513.2674542665533,1,0,789,0.0012674271229404308,0.0,1.0,789,19500,13400,6100,0.6871794871794872,256,134,122,170.20625812479975,0.38817589411514924,0.9304407492256372,0.11614406512005265,17570014.30106924,420805.2778768427,17990819.578946084,3595,0,2417.9239543726235,89,700,89,33.8913739844591,0.6459503745318351,38.344907407407405,134299.04327087913,1508.9780142795407,8
3597,513.1448633997979,1,0,790,0.0012658227848101266,0.0,1.0,790,20450,14700,5750,0.7188264058679706,262,147,115,170.30166556450533,0.3883942848128005,0.9303175634062435,0.1165382027108907,17578502.87161302,420279.66343322565,17998782.535046242,3596,0,2415.862025316456,92,698,88,33.79280956252585,0.6459465579710144,38.25044802867383,134315.4380912842,1459.9504140356978,0
3598,513.5636747453314,1,0,791,0.0012642225031605564,0.0,1.0,791,22850,17600,5250,0.7702407002188184,281,176,105,167.4784809899988,0.3887920940752239,0.9290217491525796,0.11510466647454778,17612290.48117587,408885.9313083827,18021176.41248425,3597,0,2413.8065739570166,97,694,68,33.71970419524599,0.6459407216494846,38.105867346938744,134499.31315954588,1386.590857314906,0
3599,513.8656395580708,0,1,790,0.0,0.0012642225031605564,0.9987357774968394,791,20250,14600,5650,0.7209876543209877,259,146,113,165.6534496540966,0.3886963438898579,0.9282682741613697,0.11441807963964434,17644880.418728266,406137.06201926386,18051017.48074753,3598,1,2414.8065739570166,103,688,72,33.59960250726188,0.6460355987055016,37.940705128205096,134663.26716143018,1307.4103607905843,0
3600,513.3334521369785,1,0,791,0.0012642225031605564,0.0,1.0,791,24550,18600,5950,0.7576374745417516,305,186,119,165.65129305639894,0.38900273114734857,0.9284824695431662,0.11508361478616805,17652475.971205216,402081.094055423,18054557.065260638,3599,0,2415.802781289507,108,683,78,33.40424045866431,0.6467978395061729,37.7484709480122,134622.48273645606,1246.5044697820006,0
3601,512.8479470377824,0,0,791,0.0,0.0,1.0,791,21750,15700,6050,0.7218390804597701,278,157,121,166.2331637621285,0.3892751124197859,0.9289927186560716,0.11584676208587723,17649538.241482772,406837.7161644597,18056375.95764723,3600,1,2416.802781289507,113,678,81,33.285008591065264,0.6467551622418879,37.64619883040931,134547.6083273805,1190.6867993573496,0
3602,512.8058365476279,0,0,791,0.0,0.0,1.0,791,22050,15800,6250,0.7165532879818595,283,158,125,166.8137263952791,0.38949108376407576,0.9296175211417694,0.11673820085581435,17666575.29926932,409155.4516627726,18075730.75093209,3601,2,2417.802781289507,117,674,86,33.13011462361973,0.6473468660968661,37.508827683615785,134607.0052060688,1150.487223983494,0
3603,512.5252739957659,0,0,791,0.0,0.0,1.0,791,22200,16300,5900,0.7342342342342343,281,163,118,160.31166464188436,0.38955309467799665,0.9258499692289788,0.11183270139273069,17642891.219537973,385272.25209996424,18028163.47163794,3602,3,2418.802781289507,128,663,87,33.406680207628085,0.6443684895833333,37.61304909560724,134479.9439051876,1050.624561759278,8
3604,512.1298651089179,0,0,791,0.0,0.0,1.0,791,21150,14600,6550,0.6903073286052009,277,146,131,160.1907766959913,0.38965998015650755,0.9262423892443208,0.11235876797780385,17653319.715144455,386229.79928633163,18039549.514430787,3603,4,2419.802781289507,94,697,94,33.22814875135727,0.6535904255319149,37.4342105263158,134467.78234537496,1430.5083228231379,0
3605,512.543451656474,0,0,791,0.0,0.0,1.0,791,21100,15600,5500,0.7393364928909952,266,156,110,158.34644030234168,0.3897703329119258,0.9248594667808241,0.11155020179958279,17686764.450769212,380827.23824906175,18067591.689018276,3604,5,2420.802781289507,99,692,99,33.13177372455725,0.6536195286195285,37.29166666666667,134649.4359455864,1360.0953125816807,0
3606,512.1553554093659,0,1,790,0.0,0.0012642225031605564,0.9987357774968394,791,23200,16500,6700,0.7112068965517241,299,165,134,159.84633314216327,0.3898492134615692,0.9252909006292047,0.11291039502463072,17685190.93933641,383982.58451438905,18069173.523850802,3605,6,2421.802781289507,101,690,95,33.00313961320746,0.6539810231023102,37.203839869281055,134592.4607919653,1332.5986217026268,0
3607,511.826232834694,1,1,790,0.0012642225031605564,0.0012642225031605564,0.9987357774968394,791,22650,16200,6450,0.7152317880794702,291,162,129,155.65106097778488,0.39006585158987983,0.9232948467789115,0.11032841345842659,17688990.582597774,369812.03036147647,18058802.61295925,3606,0,2422.5297092288242,106,685,91,32.99891690735394,0.6538915094339622,37.0911214953271,134563.66086384087,1269.4684987154799,0
3608,511.7397831683955,0,1,789,0.0,0.0012658227848101266,0.9987341772151899,790,21750,15300,6450,0.7034482758620689,282,153,129,157.3076117911315,0.3902026078516308,0.9237233945734629,0.112077294013325,17708448.60728889,377384.7517877202,18085833.359076608,3607,1,2426.3151898734177,113,677,73,32.785961758882976,0.654037610619469,36.92434210526316,134626.28012793555,1191.3830099817305,0
3609,511.7751903699165,0,0,789,0.0,0.0,1.0,789,20750,15200,5550,0.7325301204819277,263,152,111,156.07459673701817,0.3900377627873961,0.9235351836549768,0.11153567926290683,17722848.170881666,374667.2762603536,18097515.44714202,3608,9,2430.3891001267425,115,674,77,32.71903896679972,0.6546195652173913,36.826508620689665,134685.66365096273,1171.179683921415,0
3610,511.3722326802451,0,0,789,0.0,0.0,1.0,789,21300,14700,6600,0.6901408450704225,279,147,132,144.12287988494248,0.38998837119530605,0.919240570163695,0.10232724471831028,17680572.187524993,330534.99633594946,18011107.183860943,3609,10,2431.3891001267425,107,682,72,33.247139084507104,0.6542056074766356,37.03703703703707,134471.95748258446,1256.7472661923782,8
3611,511.23965287386034,0,0,789,0.0,0.0,1.0,789,24900,19000,5900,0.7630522088353414,308,190,118,145.48493534706049,0.38989722795888476,0.919403345144751,0.1036247226284487,17689912.98385979,332023.16935039655,18021936.153210185,3610,11,2432.3891001267425,113,676,73,33.10625795993982,0.6539454277286136,36.93347953216376,134490.0366067117,1190.1773151036434,0
3612,511.26029629185126,0,0,789,0.0,0.0,1.0,789,20800,15700,5100,0.7548076923076923,259,157,102,145.19323920563892,0.38994608341429,0.9192433808719049,0.10383609128032763,17708222.80428819,335622.84590595384,18043845.650194142,3611,12,2433.3891001267425,120,669,76,32.98123889270492,0.65390625,36.80268595041323,134562.3367642113,1121.3528063684275,0
3613,511.43697198414515,1,0,790,0.0012658227848101266,0.0,1.0,790,19200,13300,5900,0.6927083333333334,251,133,118,147.72091486985272,0.3901538092335007,0.9206477108525661,0.1060686785490195,17731765.626304064,346670.52811508457,18078436.15441915,3612,0,2431.307594936709,125,665,81,32.78339403072542,0.6543333333333333,36.6732804232804,134675.02010283433,1077.4001608226747,0
3614,511.23604667219905,0,0,790,0.0,0.0,1.0,790,21800,15900,5900,0.7293577981651376,277,159,118,147.98016396047336,0.39023596471525673,0.9209586637691993,0.1064774144132348,17733861.926603265,345051.9591102275,18078913.88571349,3613,1,2432.307594936709,126,664,85,32.70826197074914,0.6548445767195767,36.60597112860892,134656.52203727275,1068.702555851371,0
3615,511.17476602434846,0,0,790,0.0,0.0,1.0,790,21900,15700,6200,0.7168949771689498,281,157,124,150.70758130906705,0.3903202927382308,0.9229136311089701,0.10869710489975158,17741980.17546097,354870.1839754234,18096850.359436393,3614,2,2433.307594936709,130,660,87,32.55920404016017,0.6549679487179487,36.5298982188295,134679.2676324,1035.994366403077,0
3616,511.649554666244,1,0,791,0.0012642225031605564,0.0,1.0,791,19550,13100,6450,0.670076726342711,260,131,129,151.15696889585868,0.39056233897165904,0.9236187986088917,0.10934391663584689,17771229.281841457,359499.03035929066,18130728.312200747,3615,0,2431.2300884955753,89,702,89,32.45121933368468,0.6652621722846441,36.435185185185155,134852.82012568958,1515.2002261313437,0
3617,511.17892561190723,0,0,791,0.0,0.0,1.0,791,21700,14500,7200,0.6682027649769585,289,145,144,160.45493987385666,0.39058627651800054,0.9232249868705913,0.1057567223513634,17341674.804050535,376611.47759918286,17718286.281649716,3616,1,2432.2300884955753,98,693,98,35.34067498788173,0.6313775510204082,39.52020202020203,133151.78327492025,1358.6916660706147,8
3618,511.61208332132355,1,0,792,0.0012626262626262627,0.0,1.0,792,20650,15100,5550,0.7312348668280871,262,151,111,161.1520083733413,0.3909124563162174,0.9238930166769752,0.10675013521185593,17379265.937182758,381090.72196628316,17760356.65914904,3617,0,2430.157828282828,101,691,101,35.147995598740984,0.6323226072607261,39.34844771241831,133352.48368678728,1320.32162066126,0
3619,511.33291424148763,0,0,792,0.0,0.0,1.0,792,23200,15700,7500,0.6767241379310345,307,157,150,157.12194229373296,0.3910685553384668,0.9220536584115255,0.10461260134030098,17392980.13315881,364963.76415964647,17757943.897318456,3618,1,2431.157828282828,106,686,93,35.07631320294616,0.6328616352201257,39.174454828660444,133368.68612108636,1258.1951520857203,0
3620,511.65822765370496,1,0,793,0.0012610340479192938,0.0,1.0,793,22350,16100,6250,0.7203579418344519,286,161,125,159.02609517809543,0.39154908161055707,0.9222714508727821,0.10638539308954029,17425641.626636032,373276.348771366,17798917.9754074,3619,0,2429.09079445145,114,679,75,34.86230173879845,0.6327668128654971,39.01268115942031,133536.30899806463,1171.3711315619705,0
3621,511.62367618485183,0,0,793,0.0,0.0,1.0,793,23450,17600,5850,0.7505330490405118,293,176,117,157.07648163957296,0.39174578646914715,0.9188631336754032,0.10904838351816783,17590513.11823141,370561.1821693149,17961074.300400723,3620,1,2430.09079445145,133,660,88,33.65309316297595,0.6419956140350878,37.77207711442789,134162.0139050359,1008.7369466544054,8
3622,511.2577808940783,0,0,793,0.0,0.0,1.0,793,22050,15900,6150,0.7210884353741497,282,159,123,153.64419459512646,0.3918414520361242,0.9180115088913852,0.10712562356719073,17596957.935169373,360084.08585468563,17957042.02102406,3621,2,2431.09079445145,143,650,96,33.599048800661734,0.6420454545454546,37.63020833333334,134138.59746114223,938.0321500779177,0
3623,510.9512408430436,0,0,793,0.0,0.0,1.0,793,21650,16100,5550,0.74364896073903,272,161,111,155.31914560831834,0.3918062242857325,0.9204927109092109,0.10870084695822817,17602953.82314721,366565.1495987883,17969518.972746,3622,3,2432.09079445145,152,641,101,33.42978645225436,0.6422012061403508,37.506808278867126,134121.22202276555,882.3764606760891,0
3624,511.1837111097287,0,0,793,0.0,0.0,1.0,793,21950,16400,5550,0.7471526195899773,275,164,111,152.45749271240118,0.39189552099388164,0.9183411647774444,0.1074263153406408,17640850.963686623,357345.98144736036,17998196.945133984,3623,4,2433.09079445145,110,683,110,33.2788593201167,0.6510416666666667,37.28415915915915,134296.0584883334,1220.8732589848491,0
3625,511.4570205766426,0,1,792,0.0,0.0012610340479192938,0.9987389659520807,793,22250,16500,5750,0.7415730337078652,280,165,115,147.79206807178937,0.39183899737178424,0.9153807940693202,0.10462507789240465,17670686.59063394,341467.46309564204,18012154.053729583,3624,5,2434.09079445145,118,675,98,33.24737762237764,0.6509533898305084,37.13235294117646,134445.5035706974,1139.368674327944,0
3626,511.15743327511905,0,0,792,0.0,0.0,1.0,792,20000,13700,6300,0.685,263,137,126,145.44585509200596,0.39184632353880144,0.9140511641847548,0.10342455149523982,17679813.612687267,335891.12175291113,18015704.734440178,3625,6,2435.64898989899,125,667,76,33.162025104251775,0.6511666666666667,36.98743386243384,134440.82822597923,1075.5266258078339,0
3627,511.59693291559194,0,0,792,0.0,0.0,1.0,792,19900,14100,5800,0.7085427135678392,257,141,116,144.42774988268337,0.39180907792633457,0.9140781408325305,0.1031030468815685,17712059.053923897,333322.5669894865,18045381.620913383,3626,7,2436.64898989899,131,661,80,33.06033513270361,0.6514790076335878,36.86079545454545,134621.2099753028,1027.6428242389527,0
3628,511.3906136137605,0,0,792,0.0,0.0,1.0,792,20150,13600,6550,0.674937965260546,267,136,131,146.5664060304222,0.39191718996752184,0.9157468813940854,0.10507263716789621,17723268.04572746,340977.1401152189,18064245.18584268,3627,8,2437.64898989899,136,656,87,32.8657174762703,0.6521139705882353,36.72445255474452,134636.6437575276,989.9753217465266,0
3629,510.9547656832781,0,0,792,0.0,0.0,1.0,792,20050,14800,5250,0.7381546134663342,253,148,105,146.53518255395178,0.3919848639151737,0.9161383127393818,0.1053205122896775,17719293.22952917,340849.9736232098,18060143.203152377,3628,9,2438.64898989899,141,651,91,32.78260006685047,0.6522606382978724,36.641725352112665,134564.1655134629,954.355783783425,0
3630,510.5098962816042,0,0,792,0.0,0.0,1.0,792,21250,15500,5750,0.7294117647058823,270,155,115,146.6758184768563,0.3919263018405717,0.9170410612450854,0.10571728803426192,17715968.15814422,340050.82594114274,18056018.984085362,3629,10,2439.64898989899,144,648,96,32.687574989092475,0.6527777777777778,36.551724137931025,134492.95198591164,933.9788332354975,0
3631,510.6613010855558,0,0,792,0.0,0.0,1.0,792,20950,15500,5450,0.7398568019093079,264,155,109,149.47486413569018,0.3919449911568274,0.9190045801479261,0.10791220917846137,17728327.188344322,350637.8595661498,18078965.04791047,3630,11,2440.64898989899,153,639,97,32.560238902009054,0.6522331154684096,36.4989177489177,134559.8054997856,879.4758529397752,0
3632,510.89393874814675,0,0,792,0.0,0.0,1.0,792,22450,16500,5950,0.734966592427617,284,165,119,142.5555986044791,0.3919059165187484,0.914034694681717,0.10361358142471958,17765457.489463042,325663.0853785697,18091120.57484161,3631,12,2441.64898989899,112,680,112,32.523755010253545,0.6607142857142857,36.28318584070798,134731.3218999546,1202.9582312495947,0
3633,510.93775300759205,0,1,791,0.0,0.0012626262626262627,0.9987373737373737,792,23450,17400,6050,0.7420042643923241,295,174,121,142.54213532715244,0.39203115489066814,0.9142610811191723,0.10411634716849116,17788156.57879825,325262.364455131,18113418.94325338,3632,13,2442.64898989899,115,677,106,32.364762350405535,0.6616847826086957,36.12607758620691,134823.148995404,1172.375208655687,0
3634,511.17343644247626,0,1,790,0.0,0.0012642225031605564,0.9987357774968394,791,21750,15600,6150,0.7172413793103448,279,156,123,159.8362598216882,0.39215021843844516,0.9270921087108632,0.10830318068064054,17466792.227877457,378415.3481572977,17845207.576034755,3633,14,2445.7572692793933,132,659,85,34.40240078295087,0.6339962121212122,38.58082706766919,133630.53697977072,1012.3525528770509,8
3635,511.11920387638554,1,0,791,0.0012642225031605564,0.0,1.0,791,22000,15500,6500,0.7045454545454546,285,155,130,159.23860687978916,0.39233331733051685,0.9267142238193198,0.10835260846921846,17483792.454547912,376618.9506875087,17860411.40523542,3634,0,2446.7383059418457,91,700,91,34.27471574102131,0.6443452380952381,38.43976449275359,133688.459338182,1469.1039487712308,0
3636,511.4175762291508,0,0,791,0.0,0.0,1.0,791,21750,16000,5750,0.735632183908046,275,160,115,158.6395186068413,0.3924808766342876,0.9264991424598312,0.10818830255076511,17504086.66270872,375417.9763649026,17879504.63907362,3635,1,2447.7383059418457,93,698,93,34.21378653113084,0.644489247311828,38.36436170212763,133805.06399346332,1438.7641289619712,0
3637,511.2362737056848,1,0,792,0.0012626262626262627,0.0,1.0,792,21650,15600,6050,0.7205542725173211,277,156,121,153.52530886255303,0.3927487647758665,0.9233206190428092,0.10529729603691387,17523272.148162797,358003.1537658455,17881275.301928643,3636,0,2445.6464646464647,104,688,86,34.15492068303526,0.6434294871794872,38.17460317460314,133854.64023452633,1287.063848408907,0
3638,511.7430362465447,0,0,792,0.0,0.0,1.0,792,23250,17400,5850,0.7483870967741936,291,174,117,152.38904494049174,0.3928313702235162,0.9226807367336027,0.10486646579899314,17555486.356652007,353402.75987120136,17908889.116523206,3637,1,2446.6464646464647,108,684,71,34.07221776302185,0.6436149691358024,38.06383792048927,134044.00688533444,1241.1482119012448,0
3639,511.44972805892434,0,0,792,0.0,0.0,1.0,792,20750,14600,6150,0.7036144578313253,269,146,123,148.62812823519894,0.3928676181856492,0.9203918585634052,0.10273854480034407,17565382.652365576,342991.9890712208,17908374.641436797,3638,2,2447.6464646464647,117,675,77,34.01957936160417,0.6432514245014245,37.91490112994348,134043.3525453853,1145.6696798750881,0
3640,511.6100197788803,0,0,792,0.0,0.0,1.0,792,21950,15900,6050,0.724373576309795,280,159,121,146.30847085989265,0.3932144346967356,0.9187758888348538,0.10147630479449402,17585831.187383518,334241.2139652629,17920072.40134878,3639,3,2448.6464646464647,126,666,82,33.967320465897096,0.6427744708994709,37.80347769028873,134142.36796482615,1064.6219679748108,0
3641,511.3933369606933,0,0,792,0.0,0.0,1.0,792,21750,15900,5850,0.7310344827586207,276,159,117,162.63228670156656,0.39373121756971313,0.9262354987316654,0.10514683623823676,17260390.45604389,381269.35384567187,17641659.809889562,3640,4,2449.6464646464647,101,691,70,35.960449340303725,0.6238655115511551,40.18586601307194,132867.21696912998,1315.5169996943562,8
3642,511.6252806234924,0,0,792,0.0,0.0,1.0,792,22600,16500,6100,0.7300884955752213,287,165,122,161.57580912017733,0.39397148502513546,0.925645204407018,0.10479843431164146,17283001.050004642,377502.9757358817,17660504.025740523,3641,5,2450.6464646464647,105,687,74,35.874921235034684,0.6240079365079365,40.074685534591225,132984.36195451592,1266.5177329001515,0
3643,511.2936272742301,0,0,792,0.0,0.0,1.0,792,20950,14400,6550,0.6873508353221957,275,144,131,161.82248198576784,0.3942058663435876,0.925959448321316,0.10528150160468844,17285966.449654125,380101.5988811544,17666068.04853528,3642,6,2451.6464646464647,110,682,75,35.760192235976284,0.6239583333333334,39.96809309309312,132952.65688946866,1208.660517176988,0
3644,510.8776551900221,2,0,794,0.0025188916876574307,0.0,1.0,794,18850,13700,5150,0.726790450928382,240,137,103,159.02586841525505,0.3950602088170738,0.9253775921741532,0.1040174221576276,17296502.337463178,372468.26095231087,17668970.59841549,3643,0,2446.4685138539044,119,675,81,35.64486245010065,0.6240371148459384,39.7829861111111,132939.0578961042,1117.1349403033967,0
3645,511.2078294602636,1,0,795,0.0012578616352201257,0.0,1.0,795,21350,15500,5850,0.7259953161592506,272,155,117,159.23353737350533,0.3954755002138681,0.9264436885612362,0.10452884043088922,17324186.272377808,371368.2924536446,17695554.56483145,3644,0,2444.3899371069183,123,672,85,35.51343535219902,0.6245765582655827,39.658938172043,133088.38913644955,1082.0194238735735,0
3646,511.32386571010653,0,0,795,0.0,0.0,1.0,795,21100,15000,6100,0.7109004739336493,272,150,122,158.43786927523593,0.3955417729406608,0.9254869636868617,0.10447376029867288,17348626.23427935,369635.87508234085,17718262.10936169,3645,1,2445.3899371069183,92,703,92,35.37769990397152,0.6332653985507246,39.50492831541221,133197.34705219592,1447.797250567347,0
3647,511.60916688298835,0,0,795,0.0,0.0,1.0,795,19400,14100,5300,0.7268041237113402,247,141,106,155.38215267771935,0.3956724701508694,0.923817327601175,0.10286756261561002,17376485.4020433,361599.1415484928,17738084.543591794,3646,2,2446.3899371069183,96,699,96,35.318809229501454,0.6334635416666667,39.36855670103094,133341.4355696969,1388.9732871843428,0
3648,511.51355440806384,2,0,797,0.002509410288582183,0.0,1.0,797,21300,15500,5800,0.7276995305164319,271,155,116,154.95262975645838,0.39618070223556096,0.9229370659655682,0.10300215411885323,17391798.96738827,358280.9972384992,17750079.964626767,3647,0,2441.2484316185696,102,695,95,35.188659427315606,0.6332720588235294,39.22936893203886,133387.712382808,1307.7226704196864,0
3649,511.5225665984848,0,2,795,0.0,0.002509410288582183,0.9974905897114178,797,21600,15100,6500,0.6990740740740741,281,151,130,137.39542315542863,0.39641648487103015,0.914863535857487,0.09186736961573473,17418677.88558341,297649.3237795705,17716327.20936298,3648,1,2442.2484316185696,112,685,82,35.44463087248323,0.6329985119047619,39.0302359882006,133491.92349191723,1191.8921740349754,8
3650,511.6791327858563,0,0,795,0.0,0.0,1.0,795,21450,15500,5950,0.7226107226107226,274,155,119,136.4777344696068,0.39609657599712733,0.9141082011497728,0.09158686592804866,17440510.028420452,295598.25933466165,17736108.287755113,3649,5,2449.3899371069183,116,679,86,35.34335288367546,0.633441091954023,38.90669515669518,133595.99579841678,1151.6896189518689,0
3651,511.5172961994566,0,0,795,0.0,0.0,1.0,795,23850,17400,6450,0.7295597484276729,303,174,129,136.48449692357767,0.39618482961836415,0.9136148623906593,0.09190347059225673,17450359.720818248,293490.71352626965,17743850.43434452,3650,6,2450.3899371069183,124,671,89,35.2265778699421,0.6331485215053764,38.79166666666667,133612.5804114334,1077.520809769624,0
3652,511.07979040337875,0,0,795,0.0,0.0,1.0,795,22200,16800,5400,0.7567567567567568,276,168,108,140.6071532922841,0.3963903806853286,0.915782750397709,0.09511861570072681,17456268.218129262,309695.2362515501,17765963.454380814,3651,7,2451.3899371069183,132,663,93,34.960681929419785,0.6334438131313131,38.6356516290727,133578.03638433036,1011.9548210934119,0
3653,510.8300700444768,0,0,795,0.0,0.0,1.0,795,21950,16000,5950,0.7289293849658315,279,160,119,143.0136029586821,0.39638166753798143,0.9180786288807021,0.09701733606116066,17460289.302773606,318461.7763781216,17778751.079151727,3652,8,2452.3899371069183,136,659,96,34.80245683930939,0.6338082107843137,38.54166666666668,133560.7787303798,982.0645494880868,0
3654,510.70357873703495,1,0,796,0.001256281407035176,0.0,1.0,796,21800,15400,6400,0.7064220183486238,282,154,128,139.45456365688972,0.3968230499984198,0.9157648838418275,0.09499932951462205,17474694.658789437,306385.18373576755,17781079.842525207,3653,0,2450.3077889447236,103,693,103,34.753331036067046,0.6413834951456311,38.40144230769228,133599.3196059068,1297.0807728728817,0
3655,511.24702320736253,0,0,796,0.0,0.0,1.0,796,21950,15200,6750,0.6924829157175398,287,152,135,136.92673541325502,0.39695496613044257,0.9142201427180128,0.09374852671835716,17515821.317903876,298526.8462284868,17814348.164132364,3654,1,2451.3077889447236,107,689,103,34.64873495455663,0.6421339563862929,38.23302469135798,133827.586900536,1250.7251112199626,0
3656,510.82543047297037,1,0,797,0.0012547051442910915,0.0,1.0,797,19500,14000,5500,0.717948717948718,250,140,110,135.74500751345286,0.3973334100447869,0.9135234061714921,0.09339372786739195,17523095.876730286,296834.5562891368,17819930.433019422,3655,0,2449.2308657465496,114,683,81,34.515092045048455,0.6422697368421053,38.070652173913025,133800.17185676406,1173.68571804179,0
3657,511.24266233263756,0,1,796,0.0,0.0012547051442910915,0.998745294855709,797,21500,15800,5700,0.7348837209302326,272,158,114,133.74019482907747,0.3973567255978765,0.9117764005160056,0.09245646661804541,17558709.913338553,288761.05695143004,17847470.970289983,3656,1,2450.2308657465496,123,674,87,34.40645132856825,0.6421917344173442,37.911626344086024,133990.75791428066,1089.3557554006559,0
3658,511.46698719473454,0,0,796,0.0,0.0,1.0,796,24050,18400,5650,0.7650727650727651,297,184,113,134.09972817913098,0.3972597197201943,0.912036780564768,0.09309009347774849,17584794.5082745,288373.2327290947,17873167.741003595,3657,2,2454.28391959799,128,668,92,34.25811161749909,0.6427408854166667,37.77454780361756,134119.66200065985,1047.809859380155,0
3659,511.9234702179294,0,0,796,0.0,0.0,1.0,796,22050,16200,5850,0.7346938775510204,279,162,117,136.09821894324386,0.39738488696101054,0.9129281103446973,0.09471562089309624,17611641.247457117,298132.6012892565,17909773.848746374,3658,3,2455.28391959799,135,661,94,34.12151064326799,0.6425154320987654,37.69148284313725,134281.88637066027,994.6806397826687,0
3660,511.56627079019336,0,0,796,0.0,0.0,1.0,796,20650,15100,5550,0.7312348668280871,262,151,111,151.35065059274405,0.3975122928584221,0.9218573646902903,0.10622348186836411,17636595.171650004,354012.0306940194,17990607.202344023,3659,4,2456.28391959799,96,700,96,33.43983450569823,0.6532118055555556,37.414089347079056,134330.09507476268,1399.2718236954445,8
3661,511.8153341404492,0,0,796,0.0,0.0,1.0,796,21350,15900,5450,0.7447306791569087,268,159,109,149.76829649560307,0.39750409542471266,0.9204335631646594,0.10554600798172172,17663254.812790647,348529.1167758853,18011783.929566532,3660,5,2457.28391959799,103,693,103,33.34492947007241,0.6527103559870551,37.279647435897445,134464.3050330933,1305.4786896416824,0
3662,512.1843106275694,1,1,796,0.0012547051442910915,0.0012547051442910915,0.998745294855709,797,23550,15900,7650,0.6751592356687898,312,159,153,148.6605894768213,0.3973871343333144,0.9190646927563504,0.10521470277148404,17694764.285089757,343152.81785496976,18037917.102944728,3661,0,2455.1994981179423,109,688,93,33.23246151259701,0.6527140672782874,37.140151515151516,134632.6902878794,1235.1622962190772,0
3663,512.5731696209681,0,1,795,0.0,0.001256281407035176,0.9987437185929648,796,21850,15400,6450,0.7048054919908466,283,154,129,148.63756180737877,0.3973177601845706,0.9193332201972977,0.10563176059111028,17726199.909377947,345905.826928022,18072105.73630597,3662,1,2458.5917085427136,113,683,73,33.09750885970398,0.6532079646017699,37.00657894736842,134803.3714184089,1192.9501895434416,0
3664,512.7331511999253,0,0,795,0.0,0.0,1.0,795,22050,15600,6450,0.7074829931972789,285,156,129,149.3933423833703,0.39712327519287743,0.9202698079294849,0.10661285237500037,17749964.380026218,349295.3011835768,18099259.681209795,3663,8,2462.6830188679246,115,680,77,32.9404420631129,0.6541666666666667,36.87140804597701,134914.7521233854,1173.1717575946557,0
3665,512.9641620425825,1,0,796,0.001256281407035176,0.0,1.0,796,21450,15700,5750,0.7319347319347319,272,157,115,153.14477412649984,0.3974105985904364,0.9218551098206631,0.1097719989225386,17777143.011031132,363845.3102077696,18140988.3212389,3664,0,2460.5879396984924,122,674,80,32.69748340678311,0.6542862021857924,36.72933604336043,135048.41552691197,1106.954225630426,0
3666,512.6159092565832,0,0,796,0.0,0.0,1.0,796,22250,16500,5750,0.7415730337078652,280,165,115,155.55019202305294,0.39740947926213877,0.9239988170695923,0.11204182723155812,17786278.093123246,371881.79455214745,18158159.887675393,3665,1,2461.5879396984924,127,669,85,32.474642158377094,0.6550196850393701,36.572265625,135037.24758004228,1063.285414016081,0
3667,512.1606897884302,0,0,796,0.0,0.0,1.0,796,22000,16500,5500,0.75,275,165,110,153.70490283392172,0.3975336259389189,0.9231431021974124,0.11121971387366045,17790252.07993257,365689.79346739966,18155941.87339997,3666,2,2462.5879396984924,95,701,95,32.37451628175038,0.6634868421052631,36.425781249999986,134992.3536854461,1420.9721440573276,0
3668,512.0605662879195,0,0,796,0.0,0.0,1.0,796,21800,16400,5400,0.7522935779816514,272,164,108,150.95250700134332,0.3976525710312569,0.9216494464739557,0.10968753350304268,17804879.730751198,356538.24644285894,18161417.977194056,3667,3,2463.5879396984924,99,697,99,32.3109232632854,0.6637205387205387,36.291666666666664,135034.6385015101,1363.9862474900012,0
3669,512.3463057224374,0,0,796,0.0,0.0,1.0,796,22350,16600,5750,0.7427293064876958,281,166,115,145.63025458004066,0.3976458550614708,0.9186978361679956,0.10171687284664369,17642203.85671819,332297.72780136357,17974501.584519554,3668,4,2464.5879396984924,143,653,94,33.750597239833134,0.6426282051282051,37.57233796296295,134453.84316405107,940.2366654828746,8
3670,511.94786286235984,0,0,796,0.0,0.0,1.0,796,21150,14700,6450,0.6950354609929078,276,147,129,145.02358850778768,0.3977435987589941,0.9191688626421806,0.10171019955279177,17646603.85720322,331484.7632694015,17978088.62047262,3669,5,2465.5879396984924,99,697,99,33.629724404242396,0.6521464646464646,37.437500000000036,134418.31074280007,1357.7607145737381,0
3671,512.2041856192753,0,0,796,0.0,0.0,1.0,796,21650,15900,5750,0.7344110854503464,274,159,115,142.2427857950727,0.3976635009428695,0.9168159755912801,0.10022980061796288,17676114.99449209,322009.9677701272,17998124.962262217,3670,6,2466.5879396984924,105,691,105,33.54685668686572,0.6521825396825397,37.28380503144657,134564.33469286415,1281.565092312992,0
3672,512.4296940469754,0,0,796,0.0,0.0,1.0,796,21850,15700,6150,0.7185354691075515,280,157,123,138.6884137552846,0.39766597004940846,0.9137992339421592,0.09814636158667368,17702771.772316564,309983.867234884,18012755.63955145,3671,7,2467.5879396984924,113,683,96,33.49812719435464,0.651825221238938,37.143640350877206,134695.4039533024,1191.9947252504637,0
3673,512.8199110477154,0,0,796,0.0,0.0,1.0,796,22200,16400,5800,0.7387387387387387,280,164,116,137.43105098426358,0.3977660511677887,0.9130921968248753,0.09765638236767413,17734227.335899733,306046.7002333177,18040274.03613305,3672,8,2468.5879396984924,116,680,83,33.396032928219185,0.6525682471264368,37.01032763532766,134866.34038852082,1162.640865418283,0
3674,513.045820701636,0,1,795,0.0,0.001256281407035176,0.9987437185929648,796,20900,14400,6500,0.6889952153110048,274,144,130,139.44456290052037,0.3977437962875172,0.913697060000612,0.09943314818865512,17757282.117734354,315131.2886417457,18072413.4063761,3673,9,2469.5879396984924,120,676,86,33.22855997644133,0.6529513888888889,36.897382920110225,134983.69810850223,1124.8641509041852,0
3675,512.5767947824512,0,0,795,0.0,0.0,1.0,795,22300,16500,5800,0.7399103139013453,281,165,116,138.36972874472073,0.39751846923202844,0.9137075156650039,0.09907421931550833,17759011.422709532,310161.9186669431,18069173.341376476,3674,10,2473.6691823899373,125,670,89,33.121833223412196,0.6534166666666666,36.76421957671958,134928.5526014224,1079.428420811379,0
3676,512.54213494246,0,0,795,0.0,0.0,1.0,795,22650,16600,6050,0.7328918322295805,287,166,121,137.57628315977087,0.39759906584499044,0.9131467903053887,0.09879516856894133,17770551.966935866,307311.29786172166,18077863.264797587,3675,11,2474.6691823899373,132,663,93,33.0470004758789,0.6532512626262627,36.669799498746876,134967.82315973897,1022.4835087859012,0
3677,512.98147141501,0,0,795,0.0,0.0,1.0,795,21650,15600,6050,0.7205542725173211,277,156,121,143.48199357114913,0.39769629664834266,0.9167005463080913,0.10359488962927182,17809259.44927874,330411.60996167385,18139671.059240412,3676,12,2475.6691823899373,137,658,99,32.71526803021192,0.6542731143552312,36.49607487922707,135172.63123208613,986.6615418400447,0
3678,512.7688779967096,0,0,795,0.0,0.0,1.0,795,20350,15800,4550,0.7764127764127764,249,158,91,143.47663325425947,0.39778448426088747,0.9173326299553017,0.10410360787720901,17823224.691959184,332093.2545072998,18155317.946466483,3677,13,2476.6691823899373,103,692,103,32.55520944132097,0.6622168284789645,36.338141025641036,135197.59559680938,1312.5980155030036,0
3679,513.20958824605,0,0,795,0.0,0.0,1.0,795,22300,15500,6800,0.695067264573991,291,155,136,142.67494318084914,0.3976807846057169,0.9154213289482525,0.10369015162168983,17845556.713513885,327922.7580262475,18173479.47154013,3678,14,2477.6691823899373,108,687,108,32.52378148215257,0.6615547839506173,36.2863149847095,135340.39170154688,1253.151775014323,7
3680,513.0291203342352,0,0,795,0.0,0.0,1.0,795,22250,15400,6850,0.6921348314606741,291,154,137,142.68150768429055,0.3976662626934715,0.9155038641099711,0.10407421775469985,17855019.437584016,328266.21861736156,18183285.656201378,3679,15,2478.6691823899373,111,684,102,32.40564887604141,0.6620683183183182,36.17001488095239,135352.46518341973,1219.3915782290067,0
3681,512.7631894752813,0,0,795,0.0,0.0,1.0,795,21000,15300,5700,0.7285714285714285,267,153,114,140.66854164237532,0.3977023694480089,0.914216721287133,0.10308507809432679,17865782.824515387,322630.7230448002,18188413.54756019,3680,16,2479.6691823899373,116,679,77,32.308740865654876,0.6625359195402298,36.02207977207979,135358.16032712098,1166.880692475181,0
3682,512.4187528531693,1,0,796,0.001256281407035176,0.0,1.0,796,21200,15900,5300,0.75,265,159,106,137.67278354399895,0.39774429010882506,0.912620914730772,0.10128358881445607,17870466.881195903,311655.3837530193,18182122.264948923,3681,0,2477.5527638190956,120,676,83,32.26280505030754,0.6630208333333334,35.898760330578526,135330.42785838165,1127.7535654865137,0
3683,512.2820891205351,0,0,796,0.0,0.0,1.0,796,21300,15700,5600,0.7370892018779343,269,157,112,136.57926857907438,0.3975688518588751,0.9121729237950513,0.10074071597240238,17876809.303971108,307820.307852797,18184629.611823905,3682,1,2478.5527638190956,124,672,86,32.20847002292179,0.663138440860215,35.816666666666684,135336.3899108279,1091.42249928087,0
3684,512.7220676572288,0,0,796,0.0,0.0,1.0,796,22000,15800,6200,0.7181818181818181,282,158,124,138.03409837694156,0.39748812853576054,0.9125072270662993,0.10236322999200168,17915116.285568114,313379.38475929265,18228495.670327406,3683,2,2479.5527638190956,130,666,94,31.998295483030034,0.6638621794871795,35.647264631043264,135539.48106921618,1042.6113928401246,0
3685,513.0267590120021,0,0,796,0.0,0.0,1.0,796,22550,16800,5750,0.7450110864745011,283,168,115,140.31405387832552,0.3975427451724029,0.9143272987289957,0.10438748843475573,17939379.992005568,321679.42614841205,18261059.41815398,3684,3,2480.5527638190956,135,661,95,31.83622599704582,0.6641203703703704,35.54687500000003,135671.52962934788,1004.974293550725,0
3686,512.6398913728012,0,0,796,0.0,0.0,1.0,796,22500,16000,6500,0.7111111111111111,290,160,130,141.06583844152362,0.39759110673914644,0.9155032889969834,0.10528760775126894,17939611.32408427,324433.26254940603,18264044.58663368,3685,4,2481.5527638190956,144,652,100,31.71344068502326,0.6639178240740741,35.445402298850595,135621.24022769404,941.8141682478753,0
3687,512.2390082056404,0,0,796,0.0,0.0,1.0,796,22200,15700,6500,0.7072072072072072,287,157,130,136.71666677065485,0.3975560125048723,0.9127741987680076,0.10263753666343219,17950206.13201354,309418.47004300775,18259624.602056548,3686,5,2482.5527638190956,108,688,108,31.64437585733879,0.671875,35.263761467889886,135608.22826177868,1255.6317431646175,0
3688,512.03322188053,0,0,796,0.0,0.0,1.0,796,21450,15300,6150,0.7132867132867133,276,153,123,138.27091415591917,0.3975817241342983,0.9130849757443313,0.10419531152204495,17958832.6427843,315986.84133818495,18274819.484122485,3687,6,2483.5527638190956,111,685,111,31.484802062483137,0.6723911411411412,35.146949404761884,135613.5608211657,1221.743791181673,0
3689,512.1918538509802,0,1,795,0.0,0.001256281407035176,0.9987437185929648,796,23050,16700,6350,0.7245119305856833,294,167,127,137.175933239551,0.39747074602572613,0.9125801983701778,0.10385584716060632,17984096.831355922,311147.05326233513,18295243.884618256,3688,7,2484.5527638190956,117,679,100,31.366627524789816,0.6726317663817664,35.00176553672314,135729.93697698117,1160.0849314271895,0
3690,512.357506176191,0,0,795,0.0,0.0,1.0,795,21450,15200,6250,0.7086247086247086,277,152,125,135.24931218413104,0.39740123779499287,0.911643666636285,0.10277756102097955,18005458.67054125,306595.1801500944,18312053.850691345,3689,8,2488.2251572327045,121,674,80,31.301663982823385,0.6730371900826446,34.88729508196719,135832.48434742613,1122.5825152679845,0
3691,512.1198545711584,0,0,795,0.0,0.0,1.0,795,22450,16800,5650,0.7483296213808464,281,168,113,139.84157794435288,0.39743833467991063,0.9146688319460767,0.10684871013560798,18019906.280458998,322536.42573374306,18342442.70619274,3690,9,2489.2251572327045,123,672,86,31.009696581061228,0.6743733062330624,34.71942204301073,135855.4510038848,1104.5158618202017,0
3692,512.0028645949797,0,0,795,0.0,0.0,1.0,795,21900,15500,6400,0.7077625570776256,283,155,128,138.16526884098417,0.3972688243587916,0.913978189503023,0.10604319403640287,18034494.794625092,317448.16434213496,18351942.958967227,3691,10,2490.2251572327045,130,665,92,30.91458451920867,0.674599358974359,34.581743002544506,135894.90789850213,1045.3454453730933,0
3693,511.65392887703865,0,0,795,0.0,0.0,1.0,795,20400,14600,5800,0.7156862745098039,262,146,116,139.7246169865733,0.3972127829792627,0.914997756755547,0.10769591698976286,18039805.98102979,324720.9962422946,18364526.977272086,3692,11,2491.2251572327045,134,661,97,30.741803477165956,0.6752953980099503,34.45216049382716,135868.59538814242,1013.9447417025553,0
3694,511.2493241406807,0,0,795,0.0,0.0,1.0,795,21850,16400,5450,0.7505720823798627,273,164,109,139.26263441716046,0.3971632104515523,0.9144705520739358,0.10750764376060332,18032004.61966298,321386.89343133115,18353391.513094313,3693,12,2492.2251572327045,140,655,101,30.705798633324964,0.6749255952380953,34.40455082742315,135785.49388431926,969.8963848879947,0
3695,510.8873449364949,0,0,795,0.0,0.0,1.0,795,20700,14600,6100,0.7053140096618358,268,146,122,139.97605288397264,0.3968796371106147,0.9142320250695752,0.10857601939919022,18038957.35385563,325304.40970700805,18364261.76356264,3694,13,2493.2251572327045,107,688,107,30.539525261324023,0.6822429906542056,34.259259259259274,135763.58147849535,1268.8185184906108,0
3696,511.2658905872034,0,0,795,0.0,0.0,1.0,795,20150,13800,6350,0.684863523573201,265,138,127,138.25665937326193,0.3966779805564797,0.9131829039247878,0.1076233211199709,18066928.206364334,320424.6277896998,18387352.834154032,3695,14,2494.2251572327045,111,684,111,30.476257113536725,0.6824324324324325,34.15178571428572,135919.12403780388,1224.496612953188,0
3697,511.49009595943915,0,0,795,0.0,0.0,1.0,795,22600,16500,6100,0.7300884955752213,287,165,122,137.93812477354737,0.39658966092655085,0.9128751920883691,0.10782764100469037,18092124.685304236,317518.75045201636,18409643.43575625,3696,15,2495.2251572327045,115,680,101,30.355972236289784,0.6828804347826087,34.02478448275863,136043.68850774702,1182.9885957195393,0
3698,511.27534103101397,0,0,795,0.0,0.0,1.0,795,22200,16700,5500,0.7522522522522522,277,167,110,137.3896230403451,0.39640569470187836,0.9130335736137893,0.10788463842020601,18103013.197761968,316233.231826984,18419246.42958895,3697,16,2496.2251572327045,119,676,77,30.232798364648552,0.6834733893557423,33.8888888888889,136056.04908547617,1143.32814357543,0
3699,511.6967474574753,0,0,795,0.0,0.0,1.0,795,20800,14700,6100,0.7067307692307693,269,147,122,138.07728972957713,0.396407542945255,0.9136848119719534,0.10887222867390899,18134774.597260445,321000.1052493058,18455774.70250975,3698,17,2497.2251572327045,122,673,83,30.089146547062416,0.6841700819672132,33.765243902439046,136231.45875525742,1116.6513012726018,0
3700,512.1010677184183,0,0,795,0.0,0.0,1.0,795,20800,15300,5500,0.7355769230769231,263,153,110,137.14587322532296,0.39623598635468316,0.9132640500454037,0.10843437306834276,18160282.10883391,318321.5495668485,18478603.65840076,3699,18,2498.2251572327045,127,668,85,30.030844155844168,0.6841371391076115,33.68326822916667,136381.08269112365,1073.8667928434934,0
3701,511.9566084597505,0,0,795,0.0,0.0,1.0,795,21650,16400,5250,0.7575057736720554,269,164,105,139.1345118855741,0.3960060780803616,0.9149094703730611,0.11053573952787074,18174687.65627896,325095.2591458274,18499782.915424787,3700,19,2499.2251572327045,130,665,91,29.832699194270354,0.6850961538461539,33.54007633587786,136415.91880952803,1049.353221611754,0
3702,512.2919381404191,0,0,795,0.0,0.0,1.0,795,23200,17300,5900,0.7456896551724138,291,173,118,119.45004296089887,0.39602416446197636,0.901355392131423,0.08571702744452754,17758763.719108276,242057.01783597484,18000820.73694425,3701,20,2500.2251572327045,150,645,99,33.54767612460374,0.650625,36.692880794701935,134890.11442384843,899.2674294923229,8
3703,512.5686555323829,0,1,794,0.0,0.0012578616352201257,0.9987421383647799,795,21550,15000,6550,0.6960556844547564,281,150,131,122.62882982967045,0.39591234573768674,0.904068107842634,0.08833581597009829,17784984.07376859,255640.35710109823,18040624.430869687,3702,21,2501.2251572327045,158,637,104,33.3392916355798,0.6509757383966245,36.569706498951724,135026.11136632864,854.5956415590421,0
3704,512.4548801968922,0,0,794,0.0,0.0,1.0,794,22450,16200,6250,0.7216035634743875,287,162,125,123.96033169555527,0.39591982428109945,0.9053657062456015,0.08963140827455617,17797319.43148837,259982.32400381262,18057301.75549218,3703,22,2504.492443324937,112,682,112,33.182129532470576,0.6590401785714286,36.449115044247804,135057.93717578583,1205.8744390695163,0
3705,512.4267435462817,0,0,794,0.0,0.0,1.0,794,21050,14900,6150,0.7078384798099763,272,149,123,137.00222761741037,0.3958907072061055,0.9135253863144552,0.09967506101960498,17822989.34356245,308507.84857388755,18131497.192136336,3704,23,2505.492443324937,110,684,110,32.63846883709898,0.6614583333333333,36.25187687687689,135151.59184842661,1228.6508349856965,8
3706,511.9900369647837,1,0,795,0.0012578616352201257,0.0,1.0,795,20900,15400,5500,0.7368421052631579,264,154,110,133.37637018256228,0.3959566375700352,0.9117336556595823,0.09754936445402772,17830422.443508,295731.4048673646,18126153.848375365,3705,0,2503.3396226415093,116,679,105,32.56439125594581,0.6619073275862069,36.08440170940174,135122.15692438814,1164.8461803826563,0
3707,511.5158859728534,0,0,795,0.0,0.0,1.0,795,22200,16400,5800,0.7387387387387387,280,164,116,133.6865502686013,0.39600310768922053,0.9112627878057138,0.09809813733758281,17827980.671256594,295472.246839126,18123452.91809572,3706,1,2504.3396226415093,121,674,79,32.45060151348556,0.6620179063360881,35.98019125683063,135050.3263836474,1116.1183998648544,0
3708,511.98689626368423,0,0,795,0.0,0.0,1.0,795,22650,16800,5850,0.7417218543046358,285,168,117,131.7754665412027,0.39601347105386836,0.9100546457542136,0.09716101843352411,17864909.18175722,289181.3484284574,18154090.530185677,3707,2,2505.3396226415093,128,667,86,32.34735595292679,0.662353515625,35.828488372093034,135252.3523196585,1056.659002497332,0
3709,511.9588088245173,0,0,795,0.0,0.0,1.0,795,22450,16400,6050,0.7305122494432071,285,164,121,131.65116405934776,0.39602132608821927,0.9097202990348923,0.09740467082754499,17878626.51079959,289298.39838582114,18167924.909185413,3708,3,2506.3396226415093,133,662,91,32.24055921600927,0.662672305764411,35.71983830845773,135300.5567755543,1017.2974193650698,0
3710,511.68086479454803,0,0,795,0.0,0.0,1.0,795,19400,13400,6000,0.6907216494845361,254,134,120,132.17060999586485,0.3959250194065555,0.9106095083766477,0.09807507297659343,17881338.720960654,294277.48925841413,18175616.21021907,3709,4,2507.3396226415093,137,658,94,32.133798728491,0.6630170316301703,35.628019323671516,135274.0836999125,987.4020708022811,0
3711,511.9289419436097,0,0,795,0.0,0.0,1.0,795,21600,15500,6100,0.7175925925925926,277,155,122,134.7595631293401,0.39566864164673204,0.9122177724564058,0.10030149894154616,17902950.517481428,301918.7580924056,18204869.275573835,3710,5,2508.3396226415093,143,652,97,31.96845368344277,0.6631701631701632,35.53240740740743,135388.6148543016,946.7735304496615,0
3712,511.8959991383724,0,0,795,0.0,0.0,1.0,795,23500,17100,6400,0.7276595744680852,299,171,128,137.87590738299187,0.3957270593391738,0.9150972738755312,0.10293087420311609,17914572.018112633,311497.5744750533,18226069.592587687,3711,6,2509.3396226415093,145,650,99,31.79039917118382,0.6638649425287356,35.43807077625573,135428.19309396547,933.9875385790722,0
3713,511.58868707687935,0,0,795,0.0,0.0,1.0,795,21550,15000,6550,0.6960556844547564,281,150,131,140.28123631225375,0.39559728625065343,0.9163274950121794,0.10500631632941618,17915091.349671993,322080.2326357832,18237171.58230778,3712,7,2510.3396226415093,100,695,100,31.64230969082873,0.6729166666666666,35.35478547854782,135389.49783820703,1353.8949783820703,0
3714,511.18469673354474,0,0,795,0.0,0.0,1.0,795,21450,15400,6050,0.717948717948718,275,154,121,138.4619343808237,0.3954341127639687,0.9146377572596647,0.10418542398596783,17922870.535815798,315877.0648092183,18238747.600625016,3713,8,2511.3396226415093,106,689,106,31.526184699091928,0.6730542452830188,35.19275700934576,135365.4102010219,1277.0321717077538,0
3715,511.3366819078607,0,0,795,0.0,0.0,1.0,795,20650,14900,5750,0.7215496368038741,264,149,115,136.54393271747728,0.39538368212326197,0.9132084147503448,0.10324287919188124,17948614.15958699,310504.8728357152,18259119.032422703,3714,9,2512.3396226415093,113,682,102,31.424191870423364,0.6730272861356932,35.04203216374266,135482.72811843982,1198.9621957384054,0
3716,511.08271878791663,0,0,795,0.0,0.0,1.0,795,24700,18300,6400,0.7408906882591093,311,183,128,136.04737201642237,0.3951335091804889,0.9112117780749429,0.10351171738668691,17965814.243842613,305140.3628019986,18270954.60664461,3715,10,2513.3396226415093,122,673,87,31.241948534500185,0.6732411202185793,34.84925474254742,135513.96377482102,1110.770194875582,0
3717,511.3438540173158,0,0,795,0.0,0.0,1.0,795,21250,15200,6050,0.7152941176470589,273,152,121,135.13493319605806,0.3951209675290042,0.9094621602074915,0.10319713989359328,17990367.106074024,305975.4114103698,18296342.517484393,3716,11,2514.3396226415093,126,669,95,31.151247642311635,0.673693783068783,34.735892388451425,135641.17111855198,1076.5172310996188,0
3718,511.51472056692984,0,0,795,0.0,0.0,1.0,795,20600,14000,6600,0.6796116504854369,272,140,132,141.66198963067026,0.39520585470694786,0.9164956015082635,0.1003305358074284,17674645.43146842,321165.08756769635,17995810.519036114,3717,12,2515.3396226415093,108,687,96,33.39369456158213,0.6531635802469136,37.11773700305813,134468.14729888437,1245.0754379526331,8
3719,511.94034530318817,0,0,795,0.0,0.0,1.0,795,22450,16500,5950,0.734966592427617,284,165,119,144.16743687818268,0.3954271818513062,0.9166718739364008,0.10251323279254979,17706796.860063232,329098.70372759807,18035895.56379083,3718,13,2516.3396226415093,115,680,80,33.1963720737023,0.6529891304347826,36.98814655172416,134646.37907314295,1170.8380788968952,0
3720,512.1947211062052,0,0,795,0.0,0.0,1.0,795,24750,18300,6450,0.7393939393939394,312,183,129,142.79133702432625,0.39550804249903626,0.9161450540623723,0.10198237360186099,17734785.704846755,322724.75252700073,18057510.457373757,3719,14,2517.3396226415093,120,675,85,33.088115022245496,0.6534722222222222,36.845730027548235,134786.22791644852,1123.2185659704044,0
3721,511.9674006326747,0,0,795,0.0,0.0,1.0,795,22600,15700,6900,0.6946902654867256,295,157,138,145.40634400715624,0.39557279702591236,0.9171765991895682,0.10441222711585305,17750384.016655523,334603.6889169925,18084987.705572516,3720,15,2518.3396226415093,126,669,90,32.842625759227566,0.654183201058201,36.671587926509204,134815.56264199608,1069.9647828729846,0
3722,512.3959125605556,0,0,795,0.0,0.0,1.0,795,22850,16600,6250,0.7264770240700219,291,166,125,145.58238540592976,0.3956513473694216,0.9178012191406792,0.1050266131161666,17785437.52884725,335999.2841875506,18121436.813034803,3721,16,2519.3396226415093,130,665,97,32.68617021276598,0.6550480769230769,36.52194656488552,135005.07762956576,1038.5005971505059,0
3723,512.6346246922619,0,0,795,0.0,0.0,1.0,795,21500,15800,5700,0.7348837209302326,272,158,114,146.29870616868874,0.39585049559325974,0.9182781739661818,0.10595572961914236,17810595.64050492,340633.4196599173,18151229.060164835,3722,17,2520.3396226415093,101,694,101,32.54058189989157,0.6621287128712872,36.39705882352944,135131.99481777792,1337.9405427502763,0
3724,512.3114397409847,0,0,795,0.0,0.0,1.0,795,20850,14000,6850,0.6714628297362111,277,140,137,143.95030143178468,0.39601822367969414,0.9172295789209413,0.10471631551016845,17818412.60032364,333143.1729705033,18151555.773294143,3723,18,2521.3396226415093,102,693,102,32.4594661093856,0.663296568627451,36.256067961165066,135119.03354576492,1324.6964073114207,0
3725,512.6251050908517,0,0,795,0.0,0.0,1.0,795,24150,17000,7150,0.7039337474120083,313,170,143,142.01011318254214,0.3960234383663641,0.915395074804803,0.10388814080384202,17853539.33076884,323926.6282142943,18177465.958983134,3724,19,2522.3396226415093,111,684,92,32.329035545218574,0.6630067567567568,36.07700892857145,135293.55103388417,1218.8608201250827,0
3726,512.6656225498394,0,0,795,0.0,0.0,1.0,795,22200,16400,5800,0.7387387387387387,280,164,116,140.8111825136253,0.39599597875048187,0.9148726979605664,0.1034944892804091,17875026.6730958,322200.72866025113,18197227.401756052,3725,20,2523.3396226415093,117,678,78,32.210252724476845,0.6632834757834758,35.928672316384215,135380.29160448568,1157.0965094400485,0
3727,512.2451349049197,0,0,795,0.0,0.0,1.0,795,23900,17200,6700,0.7196652719665272,306,172,134,138.97463611525893,0.3961001404664966,0.9138499605837205,0.10252734032252943,17876344.212714404,313971.6864066265,18190315.89912103,3726,21,2524.3396226415093,118,677,85,32.13901129849903,0.6642831920903955,35.8105742296919,135329.74804416645,1146.8622715607326,0
3728,512.0007731435502,0,0,795,0.0,0.0,1.0,795,22000,15900,6100,0.7227272727272728,281,159,122,142.76339161041116,0.3961284581953752,0.9159625280379993,0.10562879351043215,17880193.782161407,329527.42139855446,18209721.20355996,3727,22,2525.3396226415093,123,672,86,31.946122059758448,0.6642953929539295,35.7190860215054,135312.03228407464,1100.0978234477614,0
3729,511.8821882126999,0,0,795,0.0,0.0,1.0,795,21450,14800,6650,0.6899766899766899,281,148,133,144.8869912811958,0.39626172974457274,0.9174472358295591,0.10759888309186352,17891842.714923706,338009.05188834405,18229851.76681205,3728,23,2526.3396226415093,128,667,89,31.771612762015355,0.6646321614583333,35.60239018087859,135340.42707242173,1057.3470865032948,0
3730,512.0445489514456,0,0,795,0.0,0.0,1.0,795,21650,15200,6450,0.7020785219399538,281,152,129,147.72071589512646,0.3963016650032476,0.9192867301170531,0.11005012746514864,17910912.06784108,348512.5505992384,18259424.61844032,3729,24,2527.3396226415093,131,664,93,31.59631057871134,0.6651558524173028,35.50347222222226,135434.0052651981,1033.8473684366268,0
3731,512.0362134470419,1,0,796,0.001256281407035176,0.0,1.0,796,20100,14100,6000,0.7014925373134329,261,141,120,147.79975109780653,0.39637910464271037,0.9198814375679905,0.11048954044612327,17925229.704868417,350568.8977501043,18275798.602618523,3730,0,2525.1633165829144,98,698,98,31.484776788081206,0.6730442176870748,35.39562289562286,135487.02331403643,1382.5206460615962,0
3732,512.0076180030121,0,0,796,0.0,0.0,1.0,796,21850,16000,5850,0.7322654462242563,277,160,117,149.75734596777653,0.396380092285326,0.9206936450925016,0.11243408346436953,17942341.292218175,356349.48247411894,18298690.774692293,3731,1,2526.1633165829144,100,696,100,31.29731712701438,0.6738541666666666,35.26196369636959,135547.89136261435,1355.4789136261434,0
3733,511.63678312347076,0,0,796,0.0,0.0,1.0,796,22150,15500,6650,0.6997742663656885,288,155,133,147.0928251899569,0.3962716820475543,0.9192927848593146,0.11092299300909889,17947955.348687824,346653.09172433,18294608.440412153,3732,2,2527.1633165829144,106,690,96,31.228483656767587,0.6737421383647799,35.12461059190027,135519.99216533467,1278.4904921257987,0
3734,511.6038526832038,0,0,796,0.0,0.0,1.0,796,19800,13700,6100,0.6919191919191919,259,137,122,147.6833545629629,0.3961949422163227,0.9191751138987323,0.11172328124000959,17960159.85131136,351483.33106573427,18311643.182377093,3733,3,2528.1633165829144,111,685,98,31.11281736281735,0.6736111111111112,35.026041666666636,135561.69794405033,1221.2765580545076,0
3735,511.5887158104282,0,0,796,0.0,0.0,1.0,796,21700,16100,5600,0.7419354838709677,273,161,112,145.90273589536662,0.39610160998914906,0.9178968555450671,0.11066676051824034,17970643.00577953,343493.19606843014,18314136.20184796,3734,4,2529.1633165829144,116,680,76,31.07757269378477,0.6734015804597702,34.944800569800556,135599.2490953718,1168.959043925619,0
3736,511.3755985938154,0,0,796,0.0,0.0,1.0,796,22400,15400,7000,0.6875,294,154,140,145.74939293080948,0.39601219541101734,0.9177630253082429,0.11088207240526868,17975679.078113668,342388.8626308184,18318067.940744486,3735,5,2530.1633165829144,119,677,80,30.987920827194863,0.6737570028011204,34.852430555555536,135589.99704034667,1139.411739834846,0
3737,511.5717072266711,0,0,796,0.0,0.0,1.0,796,21050,15300,5750,0.7268408551068883,268,153,115,152.59719712862363,0.39592251746152146,0.9231228361758999,0.10473097247176648,17537762.577370048,354992.68264277873,17892755.260012828,3736,6,2531.1633165829144,106,690,93,34.15653542526428,0.6431800314465409,38.152258566978155,133953.8961183367,1263.716001116384,8
3738,511.5333480850747,0,1,795,0.0,0.001256281407035176,0.9987437185929648,796,20550,14500,6050,0.7055961070559611,266,145,121,155.67168239328296,0.3960393226615257,0.9244138040903158,0.10718705064260801,17550853.993129816,366684.19370986964,17917538.186839685,3737,7,2532.1633165829144,108,688,70,33.96682292996728,0.6438078703703703,38.04472477064217,133998.85898661878,1240.7301758020258,0
3739,511.43185648387646,0,0,795,0.0,0.0,1.0,795,20200,14300,5900,0.7079207920792079,261,143,118,155.00078577699105,0.395945218066315,0.9236344843653044,0.10706243624449413,17561402.88194221,365206.2492094653,17926609.131151672,3738,33,2536.3396226415093,115,680,71,33.87806399844652,0.6433876811594204,37.94001436781606,134025.82496200418,1165.4419561913408,0
3740,511.1283544086681,0,0,795,0.0,0.0,1.0,795,23100,17000,6100,0.7359307359307359,292,170,122,154.01870406318733,0.3960728788766905,0.9236054845328052,0.10677531600829257,17567257.97840355,359037.2615554716,17926295.23995902,3739,34,2537.3396226415093,120,675,75,33.780441087943935,0.6436631944444444,37.81852617079886,134008.38527475658,1116.7365439563048,0
3741,511.49417175397093,0,0,795,0.0,0.0,1.0,795,23050,16800,6250,0.7288503253796096,293,168,125,151.75714971610796,0.39619129847018253,0.9221380736628371,0.10543857246898794,17589549.92701015,351817.99234244553,17941367.919352595,3740,35,2538.3396226415093,126,669,81,33.766171993911684,0.6433531746031746,37.74606299212598,134141.36029906032,1064.613970627463,0
3742,511.36552666730523,0,0,795,0.0,0.0,1.0,795,22150,15600,6550,0.7042889390519187,287,156,131,155.14624378698295,0.39633169895811876,0.9247890082244803,0.10838892783914288,17609470.066400275,365258.62717626034,17974728.693576533,3741,36,2539.3396226415093,128,667,89,33.49301282051278,0.6448567708333333,37.56459948320413,134200.416801416,1048.4407562610625,0
3743,511.66715277295236,0,0,795,0.0,0.0,1.0,795,20250,13300,6950,0.6567901234567901,272,133,139,155.57519414856864,0.39636292106944643,0.9243075973299382,0.10911685303879864,17637187.599151656,369531.7769945519,18006719.37614621,3742,37,2540.3396226415093,96,699,96,33.350715746421265,0.6529947916666667,37.43556701030929,134345.59584728035,1399.433290075837,0
3744,511.301024472521,0,0,795,0.0,0.0,1.0,795,20900,14900,6000,0.7129186602870813,269,149,120,154.50430823191508,0.3963492572701974,0.9235602792230628,0.10893986305585525,17647770.15836908,365431.3040309319,18013201.46240001,3743,38,2541.3396226415093,100,695,100,33.203385672227675,0.6536458333333333,37.2627887788779,134337.80526441341,1343.3780526441342,0
3745,511.39959948400843,0,0,795,0.0,0.0,1.0,795,21700,15500,6200,0.7142857142857143,279,155,124,156.75419367177741,0.39636945592995687,0.9235587842743813,0.11096756264282957,17668624.260082323,373226.189835766,18041850.449918088,3744,39,2542.3396226415093,104,691,94,33.012385049879896,0.6539463141025641,37.13293650793653,134430.11098737956,1292.5972210324958,0
3746,511.3802611017355,2,0,797,0.002509410288582183,0.0,1.0,797,21750,15500,6250,0.7126436781609196,280,155,125,158.79438899666377,0.39686388077989276,0.9247199704698044,0.11306193356239531,17693131.854934797,380764.01246836066,18073895.867403157,3745,0,2536.9573400250943,108,689,75,32.76856426651169,0.6548996913580247,36.94571865443427,134520.767078426,1245.5626581335741,0
3747,511.84823523476865,0,0,797,0.0,0.0,1.0,797,23400,16800,6600,0.717948717948718,300,168,132,158.70072782257398,0.3968753086847874,0.9249160709930209,0.1134428086964073,17726544.55970577,379843.10468092165,18106387.664386693,3746,1,2537.9573400250943,112,685,78,32.64112667834214,0.6553199404761905,36.81784660766963,134709.32075915113,1202.761792492421,0
3748,512.0011660385354,0,0,797,0.0,0.0,1.0,797,23100,17400,5700,0.7532467532467533,288,174,114,157.36661126398621,0.39698453055742955,0.9241649436492276,0.11288886954947412,17747261.67891264,376065.2859251387,18123326.96483778,3747,2,2538.9573400250943,118,679,82,32.560022496315305,0.65527895480226,36.703431372549026,134808.1501512005,1142.4419504339025,0
3749,511.8450153910254,0,1,796,0.0,0.0012547051442910915,0.998745294855709,797,22750,17100,5650,0.7516483516483516,284,171,113,155.94280153760386,0.3967959701266685,0.9236979332849502,0.11221482998797919,17755294.551333103,371612.0748920469,18126906.62622515,3748,3,2539.9573400250943,128,669,85,32.49620619884113,0.654541015625,36.60368217054263,134818.09235335796,1053.266346510609,0
3750,511.51055052409043,0,0,796,0.0,0.0,1.0,796,21550,15400,6150,0.7146171693735499,277,154,123,156.94248414065441,0.3966968621935674,0.9247560807268074,0.11331247354955346,17758156.12308876,376651.8271430295,18134807.950231787,3749,4,2543.071608040201,136,660,89,32.36085862957833,0.6544117647058824,36.49635036496352,134784.89688992576,991.0654183082777,0
3751,511.46861848634205,0,1,795,0.0,0.001256281407035176,0.9987437185929648,796,20200,14500,5700,0.7178217821782178,259,145,114,159.70925880835765,0.39701797772931746,0.9221570817048184,0.1042807513395748,17308423.960977793,373463.11238971644,17681887.07336751,3750,5,2544.071608040201,123,673,85,35.688813813813766,0.6227134146341464,39.84375,133061.75777808754,1081.8029087649393,8
3752,511.43974817929853,0,0,795,0.0,0.0,1.0,795,22150,16000,6150,0.7223476297968398,283,160,123,185.31483944912554,0.3975048054327794,0.9337870547605309,0.1162429447453602,17120845.132605232,453399.33339641494,17574244.46600165,3751,6,2547.6993710691822,99,696,61,36.45497852925389,0.6136363636363636,41.24999999999999,132335.0348413931,1336.7175236504352,8
3753,511.17682098393374,0,0,795,0.0,0.0,1.0,795,21100,15100,6000,0.7156398104265402,271,151,120,183.1551480152383,0.3977542522799402,0.932580621817092,0.11536778792793018,17131621.255837377,447448.92537077505,17579070.181208152,3752,7,2548.6993710691822,106,689,66,36.36017522749487,0.6134040880503144,41.10202492211836,132342.64385948825,1248.5155081083797,0
3754,511.67291515764833,0,0,795,0.0,0.0,1.0,795,19500,13500,6000,0.6923076923076923,255,135,120,183.34979826138067,0.3982424525661539,0.9325884826422881,0.11571150912941604,17157229.943344153,450654.929767248,17607884.8731114,3753,8,2549.6993710691822,111,684,66,36.286093952018376,0.612987987987988,41.03422619047617,132505.7724111739,1193.745697397963,0
3755,511.3663702133966,1,0,796,0.001256281407035176,0.0,1.0,796,22800,16600,6200,0.7280701754385965,290,166,124,180.9985112424921,0.39860436221990453,0.9323982614078847,0.11469491152827375,17166078.11945461,439406.916698722,17605485.03615333,3754,0,2547.494974874372,117,679,73,36.199975015898964,0.6132478632478633,40.88983050847458,132500.22685825964,1132.4805714381166,0
3756,511.8469388715573,0,0,796,0.0,0.0,1.0,796,20650,14700,5950,0.711864406779661,266,147,119,179.98144182378184,0.39871046795823983,0.932644034104704,0.114462115261659,17199069.68926188,439252.67214021366,17638322.361402094,3755,1,2548.494974874372,120,676,79,36.09695148274832,0.6139756944444444,40.76274104683196,132689.79743663268,1105.748311971939,0
3757,511.68827868856374,2,0,798,0.002506265664160401,0.0,1.0,798,22100,16000,6100,0.7239819004524887,282,160,122,180.3773010037326,0.39906597448242104,0.9334347289348623,0.11505976280533362,17207793.325407065,439079.06325339037,17646872.388660457,3756,0,2543.1052631578946,130,668,84,35.97884409014256,0.6133814102564102,40.65680661577607,132702.8722123681,1020.7913247105238,0
3758,511.87166165419285,3,0,801,0.003745318352059925,0.0,1.0,801,22650,16300,6350,0.7196467991169978,290,163,127,177.89957606738017,0.399956369642114,0.9336122489029162,0.1141458653307881,17241240.484373126,430591.87460915337,17671832.35898228,3757,0,2534.576779026217,89,712,89,35.834030100334445,0.6246488764044944,40.45138888888892,132855.5788494839,1492.7593129155493,0
3759,512.176292166854,1,0,802,0.0012468827930174563,0.0,1.0,802,20900,14600,6300,0.6985645933014354,272,146,126,174.8794208373614,0.40024493359817265,0.9322468244339952,0.11279023126326537,17275540.28337205,422927.29588172614,17698467.579253774,3758,0,2532.415211970075,96,706,83,35.728486176576,0.6243489583333333,40.27061855670105,133027.23155442034,1385.7003286918787,0
3760,512.5585787133421,1,1,802,0.0012453300124533001,0.0012453300124533001,0.9987546699875467,803,21000,15300,5700,0.7285714285714285,267,153,114,174.0123101742536,0.40056420281798616,0.9310536130828679,0.11272073386065241,17308618.68419846,420782.5446325301,17729401.228830993,3759,0,2530.2602739726026,104,699,67,35.596799129638136,0.6237980769230769,40.11904761904764,133204.21158705186,1280.8097267985756,0
3761,512.7635810212993,1,0,803,0.0012453300124533001,0.0,1.0,803,22400,16100,6300,0.71875,287,161,126,176.16565634076628,0.40057216081837743,0.932215197968119,0.11477970642360508,17342367.759648763,428025.9197762974,17770393.67942506,3760,0,2531.2590286425902,108,695,73,35.3360585461449,0.624903549382716,39.91781345565751,133360.6733323275,1234.821049373403,0
3762,513.055591543282,1,1,803,0.0012437810945273632,0.0012437810945273632,0.9987562189054726,804,23400,17600,5800,0.7521367521367521,292,176,116,173.31005042722353,0.4009046196993447,0.9313218582516067,0.1133891028308001,17371398.44831372,417927.588213723,17789326.036527444,3761,0,2529.1094527363184,119,685,78,35.26433273289302,0.624124649859944,39.774305555555536,133510.24759795453,1121.9348537643239,0
3763,512.6431590645706,1,0,804,0.0012437810945273632,0.0,1.0,804,21500,14700,6800,0.6837209302325581,283,147,136,183.57399274256903,0.4007367879882447,0.9351533945223538,0.12089873037024157,17387715.237768833,456086.46217360126,17843801.699942432,3762,0,2530.103233830846,86,718,86,34.76618167609062,0.6348110465116279,39.54741379310342,133519.23657963984,1552.5492625539516,0
3764,512.1535838532866,1,0,805,0.0012422360248447205,0.0,1.0,805,22700,16600,6100,0.7312775330396476,288,166,122,181.24864481981606,0.40113543308303207,0.9339523068286151,0.11990651745870486,17391724.08866419,446745.28443010565,17838469.373094294,3763,0,2527.95900621118,92,713,92,34.66945315969685,0.6343976449275363,39.3929211469534,133470.84941212353,1450.7701023056904,0
3765,512.4536060956499,1,0,806,0.0012406947890818859,0.0,1.0,806,20200,14700,5500,0.7277227722772277,257,147,110,176.93716133345018,0.40150068199682504,0.9321460960795727,0.11752023036730731,17420048.42826436,435050.78383766674,17855099.212102026,3764,0,2525.821339950372,98,708,89,34.64364499683899,0.6340348639455782,39.257154882154886,133618.61124427948,1363.455216778362,0
3766,512.2947077920962,0,0,806,0.0,0.0,1.0,806,19950,14000,5950,0.7017543859649122,259,140,119,177.21373987366357,0.40167593334669066,0.9317137726124207,0.11820451427629566,17433964.174024235,436757.598420465,17870721.7724447,3765,1,2526.821339950372,103,703,65,34.489296592057954,0.634203074433657,39.112580128205146,133651.24452985602,1297.5848983481167,0
3767,512.351900879949,1,0,807,0.0012391573729863693,0.0,1.0,807,21300,14400,6900,0.676056338028169,282,144,138,176.1442855058916,0.4021439139333971,0.9307926117957943,0.11804518162368915,17457267.451454416,432299.58042434533,17889567.031878762,3766,0,2524.6889714993804,113,694,69,34.3546545206343,0.6335730088495575,38.95285087719301,133748.00307236315,1183.610646658081,0
3768,512.5523458392131,0,1,806,0.0,0.0012391573729863693,0.9987608426270136,807,21300,15400,5900,0.7230046948356808,272,154,118,180.15338102020286,0.40234537950091376,0.9324957828864051,0.12123176776907718,17482810.90459717,447217.4988400188,17930028.40343719,3767,1,2525.6889714993804,118,689,73,34.107653551399835,0.6340042372881356,38.813025210084064,133871.99663122065,1134.5084460272938,0
3769,512.0745387767181,0,0,806,0.0,0.0,1.0,806,22350,15400,6950,0.6890380313199105,293,154,139,179.9534475531027,0.40228815714439836,0.9329548717520004,0.12141714453936142,17478427.708074927,445510.66477516165,17923938.37285009,3768,2,2529.817617866005,119,687,77,34.02220588723876,0.6347163865546219,38.723958333333364,133792.8085298669,1124.3093153770326,0
3770,512.0154647532875,0,1,805,0.0,0.0012406947890818859,0.9987593052109182,806,22100,15800,6300,0.7149321266968326,284,158,126,184.83269176446558,0.4025115721118526,0.9355472936875269,0.1250809808549218,17489827.879722316,463238.39310125966,17953066.272823576,3769,3,2530.817617866005,126,680,79,33.792598926789466,0.6345072751322751,38.62368766404201,133828.714036197,1062.1326510809286,0
3771,511.78920887197916,1,0,806,0.0012406947890818859,0.0,1.0,806,25450,18400,7050,0.7229862475442044,325,184,141,184.1760205049056,0.40269138295085,0.9354742144292318,0.12516405226721045,17501084.554776166,458006.0215637076,17959090.576339874,3770,0,2531.346153846154,86,720,86,33.665262643836,0.6455910852713178,38.48180076628352,133842.19229144815,1556.3045615284668,0
3772,511.33255954031586,0,0,806,0.0,0.0,1.0,806,22750,16500,6250,0.7252747252747253,290,165,125,182.1368925390237,0.4028629417567005,0.933445642368206,0.12445065027852403,17509729.688267063,453883.5509238451,17963613.23919091,3771,1,2532.346153846154,94,712,94,33.533924107205195,0.6448359929078014,38.300438596491205,133815.50656303312,1423.5692187556715,0
3773,510.95091310290167,0,0,806,0.0,0.0,1.0,806,20650,14600,6050,0.7070217917675545,267,146,121,179.3978087033276,0.40295580121141134,0.9317374899574649,0.12320345964140991,17519323.479932852,446735.6484529387,17966059.12838579,3772,2,2533.346153846154,103,703,85,33.433137311149295,0.6441140776699029,38.1310096153846,133802.19975035347,1299.0504830131404,0
3774,510.5195007574443,0,0,806,0.0,0.0,1.0,806,23250,17800,5450,0.7655913978494624,287,178,109,177.38509390790603,0.4031028607904485,0.9312957095976708,0.12226113437757981,17520553.837271105,437127.01754856785,17957680.854819674,3773,3,2534.346153846154,107,699,67,33.363897274478745,0.6443730529595015,38.01118827160492,133750.39736761537,1250.0037137160316,0
3775,510.5444705335611,0,0,806,0.0,0.0,1.0,806,20850,14400,6450,0.6906474820143885,273,144,129,155.54453965629023,0.40321386187445096,0.9228960239742496,0.10451097997238801,17407401.287493236,359475.2439750945,17766876.53146833,3774,4,2535.346153846154,115,691,85,34.803129298486944,0.6340579710144927,38.86494252873565,133321.05965441864,1159.313562212336,8
3776,510.4759994414453,0,0,806,0.0,0.0,1.0,806,20150,14500,5650,0.7196029776674938,258,145,113,157.4495820620167,0.4034071264172947,0.9245142420937256,0.10626533834032131,17425214.591886662,367368.55096670036,17792583.14285336,3775,5,2536.346153846154,120,686,88,34.59990335299225,0.6346354166666667,38.7138429752066,133380.3121474452,1111.5026012287099,0
3777,510.72163131083107,1,0,807,0.0012391573729863693,0.0,1.0,807,21950,15000,6950,0.683371298405467,289,150,139,155.7309288979112,0.40372655568572346,0.9238418524420804,0.1055205252935387,17451314.441079076,360191.88167975616,17811506.32275883,3776,0,2534.2019826517967,131,676,95,34.510023294191036,0.6341444020356234,38.58112373737374,133512.27494029285,1019.1776712999454,0
3778,510.64548927824166,1,0,808,0.0012376237623762376,0.0,1.0,808,21400,15400,6000,0.719626168224299,274,154,120,153.89153985014502,0.4039843459252988,0.9234015762879078,0.10471809343009124,17467752.861025255,354627.87710098637,17822380.73812624,3777,0,2532.0643564356437,100,708,100,34.41332163558221,0.6417708333333334,38.438531353135296,133565.18413351278,1335.6518413351278,0
3779,511.0628756502753,0,0,808,0.0,0.0,1.0,808,22600,16800,5800,0.7433628318584071,284,168,116,154.18771152863846,0.40406872645907715,0.9237458644827348,0.10538244087187394,17501721.620114878,355510.08088335407,17857231.70099823,3778,1,2533.0643564356437,103,705,103,34.25603894778471,0.6424959546925566,38.291266025640994,133749.618167727,1298.5399822109416,0
3780,510.9290986754806,0,0,808,0.0,0.0,1.0,808,23650,17400,6250,0.7357293868921776,299,174,125,153.21523703574692,0.404078726878264,0.9235643783178973,0.1051437627665926,17515250.215767894,351470.6427098515,17866720.858477745,3779,2,2534.0643564356437,107,701,92,34.14401306419133,0.6429127725856698,38.15586419753083,133783.78829901392,1250.3157784954572,0
3781,511.23978579333686,2,0,810,0.0024691358024691358,0.0,1.0,810,22250,16500,5750,0.7415730337078652,280,165,115,151.180661328635,0.4042240839933465,0.9229175515720689,0.10435797666167398,17552007.625042077,346454.82407981536,17898462.449121892,3780,0,2528.804938271605,112,698,76,33.99939022960197,0.6437872023809523,37.96091445427726,133964.80596387564,1196.1143389631754,0
3782,511.7574722200765,0,0,810,0.0,0.0,1.0,810,23900,16800,7100,0.702928870292887,310,168,142,154.29709834007048,0.40430995564304867,0.9240156854654924,0.10681799827008348,17582641.664795514,356690.11800622905,17939331.782801744,3781,1,2529.804938271605,116,694,77,33.82036194228393,0.6439475574712643,37.865028490028465,134149.53040042333,1156.4614689691666,0
3783,511.48525573453736,0,0,810,0.0,0.0,1.0,810,22850,17100,5750,0.7483588621444202,286,171,115,154.34804344785414,0.4044124865835483,0.9243018315445923,0.10708730540625715,17582988.06846964,357929.96126704384,17940918.029736683,3782,2,2530.804938271605,120,690,78,33.74558134699145,0.6439236111111111,37.79269972451788,134115.16803686606,1117.6264003072172,0
3784,511.14836150526907,0,0,810,0.0,0.0,1.0,810,23700,17900,5800,0.7552742616033755,295,179,116,154.3447285596998,0.4045700822027906,0.92455087297593,0.10745460000849612,17586644.10918891,357181.1622617616,17943825.271450672,3783,3,2531.804938271605,127,683,83,33.6302506669976,0.6438648293963254,37.679036458333336,134084.93070280654,1055.7868559276105,0
3785,511.29060288528694,0,0,810,0.0,0.0,1.0,810,24000,16800,7200,0.7,312,168,144,153.84648432283745,0.4047762250301394,0.9246677491129955,0.10753733450207813,17609204.80637479,355822.85023630905,17965027.656611096,3784,4,2532.804938271605,131,679,90,33.5096067111672,0.64456106870229,37.54734848484846,134189.57442202253,1024.347896351317,0
3786,511.25714355438384,0,0,810,0.0,0.0,1.0,810,23650,17000,6650,0.718816067653277,303,170,133,157.46785039229337,0.4049022506574697,0.9265811929365717,0.11079443623011445,17636961.372902036,369800.8789685662,18006762.251870602,3785,5,2533.804938271605,92,718,92,33.19581254530728,0.6552309782608696,37.33198924731187,134290.89688053337,1459.683661744928,0
3787,511.345758412434,0,0,810,0.0,0.0,1.0,810,21700,15800,5900,0.728110599078341,276,158,118,156.74479701932478,0.4048946522404839,0.9262463839392663,0.11084452201814553,17662172.763404842,369990.73694403394,18032163.500348877,3786,6,2534.804938271605,96,714,93,33.04732720463059,0.6557074652777778,37.1670962199313,134398.49051916314,1399.9842762412827,0
3788,511.09457559337983,0,0,810,0.0,0.0,1.0,810,21600,15200,6400,0.7037037037037037,280,152,128,158.9002617746609,0.4047425567306078,0.9273741490954217,0.11300227151013488,17678043.619203698,378209.15175107506,18056252.770954773,3787,7,2535.804938271605,98,712,78,32.80510327906017,0.6569940476190477,36.98442760942764,134425.83234541104,1371.6921667899085,0
3789,511.49694970256934,0,0,810,0.0,0.0,1.0,810,22400,15400,7000,0.6875,294,154,140,160.99234626550447,0.4047616322544217,0.9283334799565992,0.11487758945386083,17706685.71528004,385728.1755777702,18092413.890857812,3788,8,2536.804938271605,99,711,80,32.638888888888914,0.6578282828282829,36.87500000000002,134587.63489048963,1359.4710594998953,0
3790,511.9143105856495,0,0,810,0.0,0.0,1.0,810,22250,15800,6450,0.7101123595505618,287,158,129,157.87272151102962,0.4048183501452283,0.9267339708630309,0.11305751680525646,17736787.056403883,375780.96869122254,18112568.025095105,3789,9,2537.804938271605,103,707,85,32.602953859422136,0.6579692556634305,36.75881410256412,134756.9301964359,1308.3197106450086,0
3791,511.88316931096784,1,0,811,0.0012330456226880395,0.0,1.0,811,22150,16000,6150,0.7223476297968398,283,160,123,167.24812405971147,0.4052337204995103,0.929302585403422,0.11368490389141704,17505279.99681464,401195.048121444,17906475.044936083,3790,0,2535.6744759556104,92,719,92,34.100496809285204,0.6436820652173914,38.47446236559138,133870.5210600549,1455.1143593484228,8
3792,511.6918172164825,0,0,811,0.0,0.0,1.0,811,20900,15100,5800,0.722488038277512,267,151,116,167.2348237211586,0.40539895115008145,0.9292500703959499,0.11393686821314193,17509022.591044977,402523.6613086343,17911546.252353612,3791,1,2536.6744759556104,93,718,93,34.02270336482113,0.6441532258064516,38.3976063829787,133859.8041780742,1439.3527330975721,0
3793,511.63640754111424,0,0,811,0.0,0.0,1.0,811,23350,17000,6350,0.728051391862955,297,170,127,169.2976334176488,0.4054311727126496,0.9290656254281411,0.11579958125767077,17524838.834884718,407832.7481543325,17932671.58303905,3792,2,2537.6744759556104,97,714,88,33.83419969677279,0.6443298969072164,38.265306122448955,133912.99850438224,1380.5463763338375,0
3794,511.9263324372622,2,2,811,0.0024600246002460025,0.0024600246002460025,0.997539975399754,813,23150,17200,5950,0.7429805615550756,291,172,119,167.73760330055643,0.4060121774247299,0.9286789978672978,0.11536514646954503,17559324.617783476,403321.80539268564,17962646.423176162,3793,0,2532.429274292743,101,712,72,33.68875989394467,0.6451113861386139,38.08210784313723,134082.66593155987,1327.5511478372264,0
3795,511.5934152230469,1,0,812,0.0012315270935960591,0.0,1.0,812,22800,16600,6200,0.7280701754385965,290,166,124,167.49520676047987,0.40591886574988,0.9293837022877109,0.11574588767976107,17568995.98944661,403344.5231652756,17972340.512611885,3794,0,2536.5467980295566,102,710,76,33.53512258496048,0.6464460784313726,37.924757281553376,134075.96846773796,1314.4702790954702,0
3796,511.315591297185,0,0,812,0.0,0.0,1.0,812,22550,15600,6950,0.6917960088691796,295,156,139,166.45663224847974,0.40601598833972125,0.9294862530752901,0.11546109483308663,17576112.432593323,400182.09671002196,17976294.529303346,3795,1,2537.5467980295566,103,709,80,33.43599587439834,0.6474514563106797,37.80048076923076,134066.70221331785,1301.6184680904646,0
3797,510.9011512835954,2,0,814,0.002457002457002457,0.0,1.0,814,21700,14600,7100,0.6728110599078341,288,146,142,169.76903658174786,0.4068669579509063,0.9310680267477129,0.1044364422354573,17010640.927349873,393076.0243748523,17403716.951724727,3796,0,2532.3095823095823,110,704,76,37.567277620190595,0.6039772727272728,41.94819819819822,131838.9626313479,1198.5360239213446,8
3798,510.62454652972957,3,0,817,0.0036719706242350062,0.0,1.0,817,23050,17200,5850,0.7462039045553145,289,172,117,167.91608109924044,0.407749738002096,0.9306992178555282,0.10392740765111892,17030328.25793613,385483.1961812679,17415811.4541174,3797,0,2524.0073439412486,116,701,85,37.392202994472974,0.6049748563218391,41.72898860398864,131879.51807586517,1136.8923972057341,0
3799,510.423431476914,1,1,817,0.0012224938875305623,0.0012224938875305623,0.9987775061124694,818,24550,17700,6850,0.7209775967413442,314,177,137,168.4798585148949,0.4082570958014243,0.930838858119126,0.10475818688214635,17045424.5418898,386212.14302877465,17431636.684918575,3798,0,2521.9205378973106,90,728,90,37.2095126308485,0.6130787037037038,41.56364468864465,131911.97129640722,1465.6885699600803,0
3800,510.67083404804697,4,0,821,0.0048721071863581,0.0,1.0,821,21950,15000,6950,0.683371298405467,289,150,139,169.28986710963613,0.4092080473941158,0.9301227940968189,0.1057183609958504,17074110.572171792,391944.7819556317,17466055.354127426,3799,0,2513.6662606577343,96,725,96,37.03124999999997,0.6128472222222222,41.40893470790375,132054.91499008614,1375.5720311467305,0
3801,511.179542597158,1,1,821,0.0012165450121654502,0.0012165450121654502,0.9987834549878345,822,22450,16400,6050,0.7305122494432071,285,164,121,166.67955233216384,0.4098027016387548,0.9287867971082429,0.10465369607791167,17116639.152787104,383748.7502835406,17500387.903070644,3800,0,2511.6070559610707,103,719,73,36.90254447755802,0.6129652103559871,41.21594551282048,132285.1146041928,1284.3215010115805,0
3802,511.46454020247336,1,2,820,0.0012165450121654502,0.0024330900243309003,0.9975669099756691,822,23900,17700,6200,0.7405857740585774,301,177,124,166.13432710014166,0.4099846832883365,0.9281815768733388,0.10474085556603949,17145494.7787947,381391.047574805,17526885.8263695,3801,0,2512.604622871046,109,713,77,36.76836088456521,0.6130542813455657,41.07007575757574,132433.47464731158,1214.9860059386383,0
3803,511.4413717955017,0,0,820,0.0,0.0,1.0,820,24700,18100,6600,0.7327935222672065,313,181,132,166.4585231277992,0.40979019004933637,0.9282288262348399,0.10527254282823335,17159321.930296417,382563.07727831084,17541885.00757473,3802,1,2519.728048780488,111,709,81,36.64787687299535,0.6137387387387387,40.959821428571395,132483.86427872113,1193.5483268353255,0
3804,511.87903701995765,0,0,820,0.0,0.0,1.0,820,20650,15100,5550,0.7312348668280871,262,151,111,170.8190028282945,0.4100420215511679,0.9291653581771862,0.10840692358480414,17190313.626346536,402636.4463916279,17592950.072738163,3803,2,2520.728048780488,117,703,85,36.40986556759085,0.6137820512820513,40.83686440677965,132660.17627852954,1133.8476605002525,0
3805,511.5924074537823,0,0,820,0.0,0.0,1.0,820,23100,16600,6500,0.7186147186147186,296,166,130,172.36423768810945,0.4103259911948936,0.9298595555027236,0.10975434694642061,17196329.034168568,405706.4290016706,17602035.463170238,3804,3,2521.728048780488,121,699,90,36.2498422080987,0.6142389807162534,40.71892076502731,132646.23153303404,1096.2498473804467,0
3806,511.162719901639,3,0,823,0.0036452004860267314,0.0,1.0,823,24200,16400,7800,0.6776859504132231,320,164,156,139.56420669394834,0.4112514030424958,0.9188250579854873,0.08903092951179012,17190390.135972835,291032.63241729885,17481422.768390134,3805,0,2513.53219927096,139,684,97,37.0352306633004,0.6121103117505995,40.654761904761884,132567.61729829863,953.7238654553859,8
3807,510.7906037880908,3,0,826,0.0036319612590799033,0.0,1.0,826,23050,16600,6450,0.720173535791757,295,166,129,134.45466033202626,0.41192454203047424,0.9160405305459505,0.08623359570841249,17202854.706933077,274350.7972723783,17477205.504205454,3806,0,2505.399515738499,104,722,104,36.976717887950244,0.620292467948718,40.46626984126985,132567.39073115357,1274.686449338015,0
3808,511.1053619534898,1,0,827,0.0012091898428053204,0.0,1.0,827,24900,17900,7000,0.7188755020080321,319,179,140,133.6107560728083,0.41242407185652113,0.9145462212012712,0.08616349398835825,17238875.68520192,270359.84282899555,17509235.528030917,3807,0,2503.3688029020554,112,715,98,36.804495711327995,0.6204427083333333,40.27470501474926,132746.99090191335,1185.2409901956548,0
3809,511.1904495407268,0,0,827,0.0,0.0,1.0,827,22400,16300,6100,0.7276785714285714,285,163,122,131.8480820143496,0.4126359728610564,0.9133722448810673,0.08530467450989425,17256836.83004799,267256.1675352823,17524092.997583274,3808,1,2504.3688029020554,118,709,82,36.73513789695909,0.620409604519774,40.161064425770306,132827.18228437423,1125.6540871557138,0
3810,511.4156735862774,0,0,827,0.0,0.0,1.0,827,24000,18700,5300,0.7791666666666667,293,187,106,132.59652766552543,0.4128399443518928,0.9140148935880756,0.08616702909053854,17284741.717681017,268979.34667199326,17553721.06435301,3809,2,2505.3688029020554,124,703,86,36.56093411113602,0.6208837365591398,40.00833333333335,132963.8133351532,1072.2888172189773,0
3811,511.60528243987534,2,1,828,0.0024125452352231603,0.0012062726176115801,0.9987937273823885,829,22800,16800,6000,0.7368421052631579,288,168,120,130.91636888575462,0.41330443669399725,0.912896148191394,0.08541135449170316,17309316.26039664,264614.5665412567,17573930.8269379,3810,0,2500.3220747889022,129,700,95,36.46629086577954,0.6214470284237725,39.871794871794876,133082.9638551935,1031.6508825983992,0
3812,511.36545017729185,2,0,830,0.0024096385542168677,0.0,1.0,830,21850,16500,5350,0.7551487414187643,272,165,107,138.49719996707805,0.4133436944400037,0.919852028468271,0.09133367571768954,17350475.981337346,292748.46830225363,17643224.4496396,3811,0,2498.3024096385543,101,729,101,35.893804558047094,0.6307755775577557,39.501633986928105,133209.8642067236,1318.9095466012238,8
3813,511.24605864829726,0,0,830,0.0,0.0,1.0,830,22500,16700,5800,0.7422222222222222,283,167,116,138.70908676101226,0.413572141400342,0.919894892269346,0.09196540726091897,17370889.410741474,293400.0412780971,17664289.452019572,3812,1,2499.3024096385543,105,725,105,35.70210697276992,0.6316468253968254,39.318003144654085,133272.6434528633,1269.2632709796505,0
3814,511.63735611294425,0,1,829,0.0,0.0012048192771084338,0.9987951807228915,830,25100,18500,6600,0.7370517928286853,317,185,132,139.11102224137278,0.41359436539886935,0.9201959164281805,0.09263181006652459,17403874.106337983,293114.14357857057,17696988.249916553,3813,2,2500.3024096385543,110,720,91,35.54199347581014,0.6320075757575758,39.170420420420434,133450.15649214762,1213.1832408377056,0
3815,511.17813298194085,0,1,828,0.0,0.0012062726176115801,0.9987937273823885,829,22050,15500,6550,0.7029478458049887,286,155,131,139.4566679555282,0.41340866224172457,0.9203176869317844,0.09325563009948465,17407436.680713028,297666.6234278206,17705103.304140847,3814,3,2504.299155609168,115,714,76,35.387132108366025,0.6324275362318841,39.02658045977014,133403.90535848893,1160.0339596390343,0
3816,510.77099201437994,0,0,828,0.0,0.0,1.0,828,21750,16300,5450,0.7494252873563219,272,163,109,136.9216418022957,0.4130847034077345,0.9183291014227377,0.0919485649889723,17412690.04635494,289484.82186828146,17702174.86822322,3815,4,2508.31884057971,121,707,85,35.30794258060298,0.6327479338842975,38.88319672131147,133370.88864227914,1102.238749109745,0
3817,510.6275992573066,0,1,827,0.0,0.0012077294685990338,0.998792270531401,828,23650,17900,5750,0.7568710359408034,294,179,115,136.19697514218905,0.4132008640060596,0.9178199768245814,0.0917205554525965,17420532.924333815,285274.7779318349,17705807.70226565,3816,5,2509.31884057971,126,702,89,35.23009754974306,0.632853835978836,38.78772965879265,133382.194500881,1058.5888452450874,0
3818,510.6878973490543,0,0,827,0.0,0.0,1.0,827,20950,15500,5450,0.7398568019093079,264,155,109,138.83397497580086,0.4128949629777105,0.9190918444201341,0.09368229509401237,17431532.398537386,297667.78656168445,17729200.18509907,3817,6,2513.3470374848853,127,700,91,35.09325878859613,0.6333661417322834,38.72070312500002,133432.17474193446,1050.6470452120823,0
3819,511.02251029758935,0,0,827,0.0,0.0,1.0,827,23900,17600,6300,0.7364016736401674,302,176,126,139.860150093281,0.41289270611611933,0.9193211508588857,0.09470141021228028,17458496.335572094,299049.58357922634,17757545.91915132,3818,7,2514.3470374848853,132,695,97,34.948439450686635,0.6337594696969697,38.60432330827069,133579.07488394578,1011.9626885147408,0
3820,511.5385985200093,0,0,827,0.0,0.0,1.0,827,23650,16400,7250,0.693446088794926,309,164,145,142.23490965222703,0.4129249121409882,0.9209041031061453,0.09678322279523896,17498168.34054365,308720.0785993311,17806888.41914298,3819,8,2515.3470374848853,101,726,101,34.71923967931703,0.6415016501650165,38.4395424836601,133798.26986615913,1324.7353452094962,0
3821,511.415853836684,0,0,827,0.0,0.0,1.0,827,21700,15500,6200,0.7142857142857143,279,155,124,141.49775079741045,0.4127822418906693,0.9192593388117509,0.09674505447386483,17515464.226157945,308579.75843476655,17824043.98459271,3820,9,2516.3470374848853,110,717,110,34.575609260520835,0.6410037878787879,38.27890390390388,133848.31782705657,1216.8028893368778,0
3822,511.3006529127753,1,0,828,0.0012077294685990338,0.0,1.0,828,22950,16400,6550,0.7145969498910676,295,164,131,144.51547406167728,0.4127122775606688,0.9208896812886527,0.09931506091176132,17534341.717720915,318246.74113917124,17852588.458860084,3821,0,2514.3067632850243,112,716,73,34.32366830928071,0.6422991071428572,38.10840707964599,133905.3424525424,1195.5834147548428,0
3823,510.85627062389113,0,0,828,0.0,0.0,1.0,828,23200,17800,5400,0.7672413793103449,286,178,108,145.05008508020458,0.41275535859975426,0.9215057803951534,0.10002662094977774,17534426.226511344,319874.0031976035,17854300.229708947,3822,1,2515.3067632850243,115,713,77,34.19349287680936,0.6428442028985507,37.9938936781609,133847.4623562603,1163.8909770109592,0
3824,510.61671842568995,0,0,828,0.0,0.0,1.0,828,25250,18700,6550,0.7405940594059406,318,187,131,167.53466907590837,0.41274066358430356,0.9317803691033821,0.11019323587277925,17313089.190773427,389258.53365158243,17702347.72442501,3823,2,2516.3067632850243,123,705,89,35.22899260191188,0.6252540650406504,39.591733870967744,132968.8143017303,1081.0472707457748,8
3825,510.8586483848089,0,0,828,0.0,0.0,1.0,828,23550,17200,6350,0.7303609341825902,299,172,127,164.7053114779555,0.41323460473511736,0.929181151895496,0.09900824903450134,16898635.890572067,367509.01758184575,17266144.908153914,3824,3,2517.3067632850243,129,699,85,38.55205088265837,0.5920542635658914,42.78846153846154,131398.73888743887,1018.5948750964253,8
3826,510.45639780952615,6,0,834,0.007194244604316547,0.0,1.0,834,23000,16400,6600,0.7130434782608696,296,164,132,160.15723794715095,0.414655370541502,0.9277830132060476,0.09677454725378039,16910255.947631326,351859.9771104029,17262115.92474173,3825,0,2500.189448441247,94,740,94,38.47621583244585,0.6013962765957447,42.598684210526315,131392.1484493271,1397.7888132907137,0
3827,510.29708667529565,0,1,833,0.0,0.001199040767386091,0.9988009592326139,834,22950,16300,6650,0.710239651416122,296,163,133,158.51229942160984,0.4149195949362959,0.9271859829239675,0.09626741756736391,16929282.25166051,346949.8914536324,17276232.143114142,3826,1,2501.189448441247,98,736,91,38.330661193034125,0.6021471088435374,42.41372053872055,131445.52797661984,1341.2808977206105,0
3828,510.56609908132975,1,1,833,0.001199040767386091,0.001199040767386091,0.9988009592326139,834,23950,17200,6750,0.7181628392484343,307,172,135,156.61585479681466,0.41517596247131944,0.9262603773793909,0.0955136128549589,16958178.7398419,340433.9318275024,17298612.671669405,3827,0,2502.113908872902,104,730,73,38.2253175519631,0.6021634615384616,42.261904761904766,131592.3338703667,1265.3109025996798,0
3829,511.06627164722295,1,0,834,0.001199040767386091,0.0,1.0,834,24900,17300,7600,0.6947791164658634,325,173,152,153.39343224519246,0.41537151431315933,0.9245776704345909,0.09408713329866258,17002209.999622177,329905.4695191166,17332115.469141293,3828,0,2503.1127098321344,112,722,81,38.097110046934915,0.6024925595238095,42.053834808259595,131827.58493024186,1177.0320083057309,0
3830,510.62652642964537,3,2,835,0.0035842293906810036,0.0023894862604540022,0.997610513739546,837,24500,18400,6100,0.7510204081632653,306,184,122,153.25556095931196,0.41596788722920586,0.9255361024529805,0.0947179089197305,17023606.630572166,329892.47674379963,17353499.107315965,3829,0,2495.1373954599762,118,719,91,37.82310417302285,0.6040783898305084,41.78046218487395,131853.7456508061,1117.4046241593735,0
3831,510.22126621759713,0,0,835,0.0,0.0,1.0,835,23300,17400,5900,0.7467811158798283,292,174,118,153.30646690147503,0.41557765763437154,0.9252245906736114,0.09502862202373791,17024027.239103287,331678.6936922816,17355705.93279557,3830,1,2502.1041916167665,128,707,96,37.71444833442739,0.6034342447916667,41.67474160206719,131803.040435782,1029.7112534045468,0
3832,510.65792809759574,1,0,836,0.0011961722488038277,0.0,1.0,836,22300,15800,6500,0.7085201793721974,288,158,130,174.29720504871548,0.4159424273462644,0.9337179261447324,0.11266925564234546,17234777.669483844,411294.71548541135,17646072.384969257,3831,0,2500.1100478468898,100,736,67,35.66344792452333,0.6240625,40.191831683168324,132673.10093550503,1326.7310093550504,8
3833,511.13100930937543,1,0,837,0.0011947431302270011,0.0,1.0,837,22150,17000,5150,0.7674943566591422,273,170,103,171.94151718637022,0.4162267363314336,0.9327061217387118,0.11162656683779568,17270640.513442013,404358.02653232205,17674998.539974336,3832,0,2498.1218637992833,108,729,70,35.57229247849424,0.6236496913580247,40.04204892966361,132872.5699085782,1230.301573227576,0
3834,510.88046911207294,0,0,837,0.0,0.0,1.0,837,22700,15900,6800,0.7004405286343612,295,159,136,150.74190557721442,0.4164869550056307,0.9237174159301755,0.09865858793760203,17299370.741721313,331448.0221787487,17630818.763900064,3833,1,2499.1218637992833,133,704,87,35.8392515757087,0.6219454887218046,39.76212686567162,132950.44670759205,999.6274188540756,8
3835,510.8246103674121,0,0,837,0.0,0.0,1.0,837,26600,19400,7200,0.7293233082706767,338,194,144,150.57918797252947,0.41674961509072994,0.924287184503574,0.09902297174228837,17319303.86983802,327585.3425939265,17646889.21243195,3834,2,2500.1218637992833,141,696,97,35.676892594887946,0.6224881796690307,39.59800469483564,133019.74779065404,943.4024666003833,0
3836,510.94506217571666,2,0,839,0.0023837902264600714,0.0,1.0,839,21100,14700,6400,0.6966824644549763,275,147,128,147.9140052100133,0.4171785201915756,0.9228641824082373,0.09770657527253096,17343825.126733653,324178.92803145415,17668004.05476511,3835,0,2495.159713945173,104,735,104,35.5904628642502,0.6306089743589743,39.44444444444447,133129.57453356322,1280.0920628227234,0
3837,510.8186173825035,0,1,838,0.0,0.0011918951132300357,0.99880810488677,839,21900,15200,6700,0.6940639269406392,286,152,134,147.124235521139,0.41728442296441476,0.9221000924325946,0.09757126185645515,17357603.229054667,321044.82111078664,17678648.050165452,3836,1,2496.159713945173,109,730,109,35.473311477593384,0.6308295107033639,39.30871212121213,133165.96323790716,1221.7060847514417,0
3838,510.5328524861932,0,2,836,0.0,0.002386634844868735,0.9976133651551312,838,23450,15900,7550,0.6780383795309168,310,159,151,142.35065794391426,0.41707923085916004,0.918753152065569,0.09484783306462621,17369115.08544793,303450.9920634179,17672566.077511348,3837,2,2500.1026252983293,119,719,75,35.43607875762619,0.6304271708683473,39.149305555555564,133172.8491077272,1119.0995723338422,0
3839,510.52563329004954,1,0,837,0.0011947431302270011,0.0,1.0,837,21950,15000,6950,0.683371298405467,289,150,139,139.63983705847795,0.41685507213237827,0.9171938372021995,0.09342832849464888,17387647.95715009,296251.6655133283,17683899.62266342,3838,0,2504.0358422939066,124,713,83,35.363849952637935,0.6309643817204301,39.008333333333354,133242.93590842688,1074.53980571312,0
3840,510.5040753424018,1,0,838,0.0011933174224343676,0.0,1.0,838,21350,15700,5650,0.7353629976580797,270,157,113,137.74518653289866,0.41715711014733264,0.9163243294465895,0.09258754433306407,17407778.574395813,290617.54137071525,17698396.11576653,3839,0,2502.046539379475,130,708,90,35.254590158942804,0.6315705128205128,38.851781170483484,133317.22998087923,1025.517153699071,0
3841,510.2869253036145,0,0,838,0.0,0.0,1.0,838,21500,14500,7000,0.6744186046511628,285,145,140,139.7804694679372,0.417267483692279,0.9177406268790433,0.09426882652380579,17415359.096871506,297765.41410269425,17713124.510974202,3840,1,2503.046539379475,136,702,93,35.0874416732148,0.6318167892156863,38.7393552311436,133317.89112194296,980.278611190757,0
3842,509.90299511523443,0,0,838,0.0,0.0,1.0,838,22000,16100,5900,0.7318181818181818,279,161,118,141.66457905783537,0.4172699192764248,0.9189975753159707,0.09580496734666234,17414717.102827065,303809.7135566682,17718526.816383734,3841,2,2504.046539379475,139,699,97,34.943370532748744,0.6323441247002398,38.64583333333338,133265.2723691828,958.7429666847685,0
3843,510.0091555526514,1,1,838,0.0011918951132300357,0.0011918951132300357,0.99880810488677,839,20150,15000,5150,0.7444168734491315,253,150,103,142.16201536495092,0.4173430339562099,0.919860842550253,0.09655260921034521,17437472.244322523,307839.239424655,17745311.483747177,3842,0,2502.060786650775,105,734,105,34.78485531754978,0.6398809523809523,38.502358490566024,133366.19132523565,1270.1542030974824,0
3844,510.35663507933907,2,0,840,0.002380952380952381,0.0,1.0,840,24850,17800,7050,0.716297786720322,319,178,141,136.3819946919067,0.41776316878559133,0.9166204275057404,0.09338387070171,17485712.22498606,284097.2623704502,17769809.48735651,3843,0,2499.4261904761906,116,724,103,34.65998628211229,0.6402658045977012,38.23005698005697,133596.02728456803,1151.689890384207,0
3845,510.0049157543119,1,1,840,0.0011890606420927466,0.0011890606420927466,0.9988109393579072,841,23550,16600,6950,0.7048832271762208,305,166,139,136.4422131964742,0.4179977539965649,0.9168414546145478,0.09386942754492603,17494760.91306389,285654.77966432273,17780415.692728214,3844,0,2497.4530321046373,121,720,76,34.4982600971412,0.6409263085399449,38.07206284153006,133584.5355242066,1104.0044258198893,0
3846,510.45454803752807,1,1,840,0.0011890606420927466,0.0011890606420927466,0.9988109393579072,841,22850,17100,5750,0.7483588621444202,286,171,115,135.94111620576973,0.41805414000717206,0.916255583513073,0.09398231127735092,17531845.537657768,285609.73030726693,17817455.267965034,3845,0,2498.3959571938167,126,715,86,34.34722569944297,0.6416997354497355,37.91010498687664,133784.97890412688,1061.78554685815,0
3847,510.8141019710387,0,0,840,0.0,0.0,1.0,840,23850,17200,6650,0.7211740041928721,305,172,133,138.6990236015185,0.41774073206954615,0.9182271201126386,0.09622554814348927,17559713.817755826,295253.03224896087,17854966.85000479,3846,1,2502.3678571428572,130,710,87,34.157442506949685,0.6422275641025641,37.79421119592874,133938.41453955858,1030.295496458143,0
3848,510.4487465185555,0,2,838,0.0,0.002380952380952381,0.9976190476190476,840,22750,16100,6650,0.7076923076923077,294,161,133,136.47074169744553,0.41778081663734223,0.9170810313075515,0.09500463172014456,17562288.788798947,288597.7153824227,17850886.50418137,3847,2,2503.3678571428572,137,703,94,34.10127474677721,0.6423357664233577,37.68115942028985,133900.32336211353,977.3746230811206,0
3849,510.41622190179976,0,0,838,0.0,0.0,1.0,838,22150,15400,6750,0.6952595936794582,289,154,135,137.083424169403,0.41770865114736205,0.917715866468068,0.09559233868793099,17568610.701439273,291923.0625705006,17860533.764009774,3848,3,2509.096658711217,140,698,96,34.028872776760956,0.6424851190476191,37.625591016548455,133920.15455705026,956.572532550359,0
3850,510.5556462092285,0,0,838,0.0,0.0,1.0,838,22750,16000,6750,0.7032967032967034,295,160,135,139.41442067887607,0.4176248611122992,0.9198446772866529,0.09745934238078936,17584339.18750513,299952.0921693745,17884291.279674504,3849,4,2510.096658711217,141,697,98,33.884999161495905,0.6431737588652482,37.54401408450703,133998.385490564,950.343159507546,0
3851,510.53363936883517,0,0,838,0.0,0.0,1.0,838,23200,16100,7100,0.6939655172413793,303,161,142,141.04593669088933,0.41748953768098174,0.9207973564229182,0.09888600999143975,17596323.04974102,305577.9733732452,17901901.023114264,3850,5,2511.096658711217,101,737,101,33.745761860308306,0.6515057755775577,37.448937908496745,134041.14924972894,1327.1400915814747,0
3852,510.2695928630351,0,1,837,0.0,0.0011933174224343676,0.9988066825775657,838,23700,17200,6500,0.7257383966244726,302,172,130,141.06542179592265,0.4174584394297549,0.9208395046517293,0.0993638255826494,17607750.914442763,305468.96192468796,17913219.87636745,3851,6,2512.096658711217,101,737,101,33.58990307365368,0.653052805280528,37.29575163398696,134049.98985711674,1327.2276223476906,0
3853,509.8825181032723,0,0,837,0.0,0.0,1.0,837,22500,15800,6700,0.7022222222222222,292,158,134,140.58967876264077,0.41726904014679905,0.9204964012005723,0.09938235912531578,17609971.090803917,305256.0357351069,17915227.126539025,3852,7,2516.0334528076464,103,734,98,33.484502032520346,0.6537216828478964,37.179487179487204,134007.5848861176,1301.0445134574525,0
3854,509.6209545390762,0,0,837,0.0,0.0,1.0,837,23450,15800,7650,0.673773987206823,311,158,153,140.80586792052623,0.41709980868865987,0.9204279392558881,0.10003376203686273,17622701.36871677,305425.95226528606,17928127.320982054,3853,8,2517.0334528076464,109,728,81,33.31409113823771,0.6539564220183487,37.017045454545475,134021.62432296216,1229.5561864491942,0
3855,509.9625431786587,0,0,837,0.0,0.0,1.0,837,23350,16600,6750,0.7109207708779444,301,166,135,141.4782125576668,0.4171309515643132,0.9207612100642737,0.1008683397631325,17649922.46406338,308665.89639942284,17958588.360462803,3854,9,2518.0334528076464,114,723,83,33.17991289678442,0.6540570175438596,36.9021739130435,134170.03649608188,1176.9301447024727,0
3856,509.9781131072413,0,0,837,0.0,0.0,1.0,837,23000,15700,7300,0.6826086956521739,303,157,146,142.61039489432457,0.4170708094908717,0.9218268067292983,0.10223350272533603,17674184.125395816,313704.47551154526,17987888.60090736,3855,10,2519.0334528076464,116,721,87,32.9708582733083,0.6554418103448276,36.725427350427374,134264.2697889458,1157.450601628843,0
3857,510.2406479883857,0,1,836,0.0,0.0011947431302270011,0.998805256869773,837,21150,15300,5850,0.723404255319149,270,153,117,145.50373721620397,0.41709843911669037,0.9227566993322265,0.10460187263162621,17695466.54713246,326401.3028784194,18021867.85001088,3856,11,2520.0334528076464,123,714,89,32.80268173264009,0.6550643631436315,36.63474462365592,134379.6585608528,1092.5175492752262,0
3858,510.07422988867177,0,1,835,0.0,0.0011961722488038277,0.9988038277511961,836,23900,17300,6600,0.7238493723849372,305,173,132,147.09626786013843,0.41703727712040034,0.9235945420578389,0.10604424042604639,17701822.078611538,329674.3924175893,18031496.47102913,3857,12,2524.0107655502393,132,704,92,32.669153933051874,0.6545138888888888,36.54448621553884,134381.86830353297,1018.0444568449468,0
3859,510.3754946314174,0,0,835,0.0,0.0,1.0,835,23850,17600,6250,0.7379454926624738,301,176,125,145.3395943393456,0.4167979388943935,0.9227171960221183,0.10519659883188863,17729468.235934664,324508.7442526156,18053976.98018728,3858,13,2527.9952095808385,99,736,99,32.58575719253873,0.6624579124579124,36.416666666666686,134526.4741265988,1358.8532740060484,0
3860,510.6414633369169,0,0,835,0.0,0.0,1.0,835,23350,16800,6550,0.7194860813704497,299,168,131,143.84812598071912,0.416661700579656,0.9218162715795624,0.10450933087063999,17754882.356390495,320451.310794984,18075333.667185478,3859,14,2528.9952095808385,102,733,102,32.50319590923614,0.6628880718954249,36.296521035598715,134657.9303854184,1320.1757880923374,0
3861,510.9776607136255,0,1,834,0.0,0.0011976047904191617,0.9988023952095808,835,21150,15900,5250,0.75177304964539,264,159,105,141.07424430610934,0.4164674846948788,0.9198972670975942,0.10285756011839613,17781775.726788566,313560.11461548554,18095335.84140405,3860,15,2529.9952095808385,109,726,109,32.46194377639783,0.6623662079510704,36.18371212121213,134804.229638456,1236.736051728954,0
3862,511.0225638071489,0,0,834,0.0,0.0,1.0,834,20950,15100,5850,0.720763723150358,268,151,117,141.9045715048784,0.41627253419353355,0.9206064656009774,0.10387180383639287,17800235.389793217,317436.95513491734,18117672.344928134,3861,16,2533.994004796163,111,723,97,32.312955882871144,0.6631944444444444,36.05840773809524,134880.10917301997,1215.1361186758556,0
3863,511.1071098366145,0,1,833,0.0,0.001199040767386091,0.9988009592326139,834,22350,16200,6150,0.7248322147651006,285,162,123,159.2343408442987,0.4161226241095959,0.9274384947728169,0.11421980387568335,17715933.474430915,375046.99784848845,18090980.472279403,3862,17,2534.994004796163,121,713,82,32.51339705548529,0.6547004132231404,36.705942622950815,134571.464703139,1112.1608653151984,8
3864,511.59113880890186,0,0,833,0.0,0.0,1.0,833,24150,18400,5750,0.7619047619047619,299,184,115,161.78832580757648,0.41596085549604456,0.929243926759475,0.11639552905254336,17745532.47625199,383453.9979793584,18128986.474231347,3863,18,2538.9879951980793,122,711,85,32.34944214012411,0.6554815573770492,36.61077235772358,134747.59491950966,1104.4884829468006,0
3865,512.1092458154613,0,0,833,0.0,0.0,1.0,833,22400,15600,6800,0.6964285714285714,292,156,136,161.6869776408243,0.41592424229307107,0.9301973043695546,0.1167579022303721,17779678.541698705,385948.49736653577,18165627.03906524,3864,19,2539.9879951980793,127,706,88,32.230286184887774,0.6558398950131233,36.490885416666664,134945.45393477066,1062.562629407643,0
3866,511.66385665514406,0,0,833,0.0,0.0,1.0,833,21650,15700,5950,0.7251732101616628,276,157,119,162.90847935453687,0.4159818374465171,0.9302271894481788,0.11804845967020852,17779178.56991369,391025.78899948084,18170204.35891317,3865,20,2540.9879951980793,92,741,92,32.085333814865166,0.6648550724637681,36.37992831541218,134884.86256984147,1466.1398105417552,0
3867,511.35177687727537,1,0,834,0.001199040767386091,0.0,1.0,834,22150,15700,6450,0.708803611738149,286,157,129,158.38717613884594,0.4159925061151559,0.9282299112847554,0.11543846744631274,17793233.44631228,374693.99998813565,18167927.446300413,3866,0,2538.9400479616306,98,736,98,32.016957828121654,0.6649659863945578,36.1952861952862,134897.0091526419,1376.5000933943052,0
3868,511.13412303748197,0,0,834,0.0,0.0,1.0,834,23250,17000,6250,0.7311827956989247,295,170,125,151.36374052261453,0.415975233018867,0.9258462539062495,0.1036576746143767,17513016.020876326,340117.12255045434,17853133.14342678,3867,1,2539.9400479616306,101,733,97,34.26275861844755,0.6436674917491749,38.22508169934636,133802.09329881085,1324.7732009783253,8
3869,511.2470022009072,0,0,834,0.0,0.0,1.0,834,24000,17600,6400,0.7333333333333333,304,176,128,154.11129763536601,0.4158978939297542,0.9263699954751199,0.10600421475648282,17536479.090404887,349713.9097155439,17886193.00012043,3868,2,2540.9400479616306,107,727,73,34.04220061864781,0.6436915887850467,38.07870370370367,133906.477544055,1251.4624069537851,0
3870,510.80289075077263,0,0,834,0.0,0.0,1.0,834,22900,16300,6600,0.7117903930131004,295,163,132,154.41613551106394,0.4158919263148904,0.9268016677212556,0.10667279416208471,17540395.739312083,352004.02507985116,17892399.764391933,3869,3,2541.9400479616306,109,725,78,33.88890896388904,0.6446865443425076,37.93560606060602,133863.24998708937,1228.1032108907282,0
3871,511.1255958729727,0,1,833,0.0,0.001199040767386091,0.9988009592326139,834,25000,18800,6200,0.752,312,188,124,155.86335668699547,0.4158521322197944,0.9269245610100261,0.10798946825894654,17564510.86625578,355732.724435962,17920243.59069174,3870,4,2542.9400479616306,116,718,79,33.75217913015915,0.6442169540229885,37.83831908831907,133997.54537104184,1155.1512531986366,0
3872,511.25977346872355,1,0,834,0.001199040767386091,0.0,1.0,834,23150,16100,7050,0.6954643628509719,302,161,141,156.19321824673352,0.4156799410411647,0.9270500039628295,0.1086789487727714,17587933.808343627,359473.1967671355,17947407.005110763,3871,0,2543.896882494005,120,714,86,33.60102344459393,0.6448784722222223,37.698002754820905,134104.45969196202,1117.5371640996834,0
3873,511.59525516867905,0,0,834,0.0,0.0,1.0,834,21800,15900,5900,0.7293577981651376,277,159,118,154.81719344027545,0.4157714944490986,0.9267057263989671,0.10803455923720372,17612298.355066184,356737.3202728138,17969035.675339,3872,1,2544.896882494005,121,713,91,33.5400939303223,0.6456611570247934,37.6024590163934,134241.33693513932,1109.432536654044,0
3874,511.34724298839313,0,0,834,0.0,0.0,1.0,834,24200,17700,6500,0.731404958677686,307,177,130,156.71148890217788,0.415754551220968,0.9279685098300108,0.10977140044751252,17620454.214816276,361265.5230273077,17981719.737843584,3873,2,2545.896882494005,94,740,94,33.3640499262106,0.6531471631205674,37.478070175438624,134239.86503978318,1428.0836706359912,0
3875,511.1110132362309,0,0,834,0.0,0.0,1.0,834,22000,15800,6200,0.7181818181818181,282,158,124,158.77937693499058,0.4157350889996286,0.9283634886433445,0.1116879357654591,17630769.489261735,371080.51887788903,18001850.008139625,3874,3,2546.896882494005,97,737,97,33.17007102100279,0.6536726804123711,37.34056122448982,134248.13188861188,1384.001359676411,0
3876,511.49907331727303,0,0,834,0.0,0.0,1.0,834,24150,17800,6350,0.7370600414078675,305,178,127,154.90388899858013,0.4157329898386213,0.9240300481804979,0.10719089200733514,17571811.325468954,353438.3822128753,17925249.707681827,3875,4,2547.896882494005,117,717,79,33.819243312116186,0.6436075498575499,37.87959039548018,134074.34661025312,1145.9345864124198,7
3877,511.5524289798039,0,0,834,0.0,0.0,1.0,834,22350,15900,6450,0.7114093959731543,288,159,129,153.33999099943043,0.41576198824853683,0.9234685391661444,0.1064786452386579,17589073.20642957,350271.6654324415,17939344.871862013,3876,5,2548.896882494005,125,709,83,33.7434321143337,0.6433333333333333,37.764550264550245,134147.18127677936,1073.1774502142348,0
3878,511.2341897672916,0,0,834,0.0,0.0,1.0,834,21700,15200,6500,0.7004608294930875,282,152,130,153.71152141551076,0.4158208847087996,0.9239645256208622,0.1070057525313706,17589266.412347578,352234.58016493265,17941500.99251251,3877,6,2549.896882494005,131,703,86,33.64936499102513,0.6432092875318066,37.681502525252505,134106.1845174745,1023.7113321944618,0
3879,511.48611757796385,0,0,834,0.0,0.0,1.0,834,22200,16400,5800,0.7387387387387387,280,164,116,156.11922235832648,0.4159740634863058,0.9255467800982313,0.10908119592955326,17614129.113673374,360980.8279491618,17975109.941622537,3878,7,2550.896882494005,136,698,91,33.463647294008574,0.6436887254901961,37.56082725060825,134233.99356995724,987.0146586026267,0
3880,511.0716927484626,0,0,834,0.0,0.0,1.0,834,23700,17800,5900,0.7510548523206751,296,178,118,151.8995962428996,0.4159656368542621,0.9234894363902963,0.10653464094000459,17616487.397283934,344687.4645731192,17961174.861857053,3879,8,2551.896882494005,98,736,98,33.44854532339505,0.6524234693877551,37.43686868686872,134188.58397354055,1369.271265036128,0
3881,510.8598383802506,1,0,835,0.0011976047904191617,0.0,1.0,835,21300,15300,6000,0.7183098591549296,273,153,120,150.30767964229977,0.41607007806928115,0.9224389569356721,0.10580772128514729,17625377.365813196,341545.9149350658,17966923.280748263,3880,0,2549.839520958084,101,734,101,33.36783687116086,0.6528465346534653,37.31617647058827,134194.61563334332,1328.6595607261715,0
3882,511.0921587076863,0,0,835,0.0,0.0,1.0,835,22850,16100,6750,0.7045951859956237,296,161,135,147.7779188095907,0.41596040532843187,0.9208733867795849,0.10434133827955279,17646619.04461071,331706.1272876549,17978325.171898365,3881,1,2550.839520958084,106,729,101,33.33433667987998,0.6526139937106918,37.21767912772587,134305.98364482736,1267.037581554975,0
3883,510.82665568369896,0,0,835,0.0,0.0,1.0,835,24150,18000,6150,0.7453416149068323,303,180,123,148.73543756270678,0.4159550802471795,0.9211662150578785,0.1055056176473788,17657719.20952034,334115.71859748673,17991834.928117827,3882,2,2551.839520958084,112,723,77,33.15599107153295,0.6528087797619048,37.066740412979364,134313.3176628522,1199.2260505611805,0
3884,510.43519826517263,1,0,836,0.0011961722488038277,0.0,1.0,836,21850,15800,6050,0.7231121281464531,279,158,121,146.12362556398907,0.41619983716776976,0.9192541059158572,0.10397441209785968,17657676.693205528,326990.7474895845,17984667.44069511,3883,0,2549.785885167464,120,716,80,33.12270897427501,0.6522569444444444,36.966253443526156,134261.68257398403,1118.8473547832002,0
3885,510.1078872049666,0,0,836,0.0,0.0,1.0,836,23700,17000,6700,0.7172995780590717,304,170,134,149.7494631386287,0.41622863722316134,0.9210346614061531,0.10695818734059957,17662783.68759341,338098.4749501645,18000882.162543576,3884,1,2550.785885167464,126,710,81,32.90308253334991,0.65244708994709,36.84383202099736,134238.0368527234,1065.3812448628842,0
3886,510.5473136167112,0,1,835,0.0,0.0011961722488038277,0.9988038277511961,836,22800,16000,6800,0.7017543859649122,296,160,136,150.61817534323234,0.41616157636879353,0.9213046441298813,0.10799643636312614,17694808.30692636,343031.9480475034,18037840.254973862,3885,2,2551.785885167464,131,705,88,32.75325585229144,0.6529103053435115,36.71875,134417.53491314978,1026.0880527721358,0
3887,510.6469448508845,0,0,835,0.0,0.0,1.0,835,22550,16400,6150,0.7272727272727273,287,164,123,152.80282680953428,0.4158347573438255,0.9233432295073711,0.11000715965682906,17715771.404382132,351853.98994022334,18067625.394322354,3886,3,2555.7904191616767,135,700,93,32.56354012193114,0.6536265432098766,36.58854166666668,134510.2564366335,996.3722699009888,0
3888,510.69751038420225,0,1,834,0.0,0.0011976047904191617,0.9988023952095808,835,22000,15700,6300,0.7136363636363636,283,157,126,153.8105576195183,0.415661961448805,0.9245937816861767,0.11112990435651385,17732984.408816066,356504.0440356485,18089488.452851713,3887,4,2556.7904191616767,135,700,98,32.420338506849625,0.6547839506172839,36.47365196078433,134582.24986426934,996.9055545501433,0
3889,511.1119066680822,1,0,835,0.0011976047904191617,0.0,1.0,835,22700,16600,6100,0.7312775330396476,288,166,122,152.99381627250943,0.4156370711813782,0.9240504133729919,0.111281548716954,17776172.976344332,354228.90847423475,18130401.884818565,3888,0,2557.7700598802394,104,731,104,32.22486051031286,0.6627604166666667,36.25992063492064,134800.69482907723,1296.1605272026657,0
3890,511.4236167899407,1,0,836,0.0011961722488038277,0.0,1.0,836,22800,15400,7400,0.6754385964912281,302,154,148,152.873577349034,0.4157133102216619,0.9242365765779816,0.11177134864955182,17809241.236761495,354512.4835471328,18163753.720308628,3889,0,2555.7093301435407,108,728,97,32.06077614822867,0.6634837962962963,36.09518348623853,134967.15574975358,1249.6958865717925,0
3891,511.79009637868063,0,1,835,0.0,0.0011961722488038277,0.9988038277511961,836,22500,15700,6800,0.6977777777777778,293,157,136,153.40884199009895,0.4157257554269451,0.9242783267645818,0.11278618063112074,17845734.062775593,357838.67940673354,18203572.742182326,3890,1,2556.7093301435407,115,721,77,31.868312477330445,0.663768115942029,35.91954022988506,135153.76395747348,1175.2501213693347,0
3892,511.73949021415075,0,0,835,0.0,0.0,1.0,835,24300,17800,6500,0.7325102880658436,308,178,130,155.85757052342527,0.4154056993925817,0.9254017068687324,0.11494544665902885,17857320.95845853,365339.7321284789,18222660.69058701,3891,3,2560.7700598802394,115,720,82,31.703328064629414,0.6647644927536231,35.82076149425288,135190.9488380939,1175.5734681573383,0
3893,512.0599253652032,0,0,835,0.0,0.0,1.0,835,22950,16100,6850,0.7015250544662309,298,161,137,155.4654698804767,0.41526605063254785,0.9244120914432961,0.11509670501235345,17884842.467912253,366145.08760246,18250987.555514712,3892,4,2561.7700598802394,124,711,86,31.591047631058977,0.6643145161290323,35.70000000000001,135337.43827402385,1091.430953822773,0
3894,511.96557831013195,0,0,835,0.0,0.0,1.0,835,24450,17900,6550,0.7321063394683026,310,179,131,154.73722971793472,0.4151380691853703,0.9244081349825528,0.1149827284873864,17897294.07072255,362425.54079017154,18259719.61151272,3893,5,2562.7700598802394,130,705,91,31.492146072033652,0.6645032051282052,35.58365139949112,135372.06882591455,1041.3236063531888,0
3895,512.0562313647781,0,0,835,0.0,0.0,1.0,835,24250,17600,6650,0.7257731958762886,309,176,133,153.72276432618315,0.4149814280312277,0.9251952879944563,0.1147596521595622,17920118.755088273,359696.03841713484,18279814.793505408,3894,6,2563.7700598802394,142,693,96,31.371607606670587,0.6642458920187793,35.43851981351983,135470.35450857782,954.0165810463227,0
3896,511.6920024525042,0,0,835,0.0,0.0,1.0,835,22800,16500,6300,0.7236842105263158,291,165,126,143.91075404277305,0.4148082731419655,0.9198190698971564,0.1026673528669328,17712525.75467346,320004.58747142006,18032530.34214488,3895,7,2564.7700598802394,122,713,84,33.0952208525111,0.6527493169398907,36.88177506775068,134635.49139733124,1103.569601617469,8
3897,511.6067624226848,0,0,835,0.0,0.0,1.0,835,19450,13600,5850,0.699228791773779,253,136,117,144.28874667737222,0.4147714762321879,0.92047557365089,0.1032064890579074,17720949.96036795,324936.7319427788,18045886.69231073,3896,8,2565.7700598802394,125,710,86,32.99956942132318,0.6530833333333333,36.79728835978834,134656.28716311886,1077.250297304951,0
3898,511.65062502585187,2,0,837,0.0023894862604540022,0.0,1.0,837,23650,17700,5950,0.7484143763213531,296,177,119,151.6067652227634,0.4150872524528439,0.9260176415901025,0.1066271607270962,17648746.954268027,344083.88719434076,17992830.841462366,3897,0,2560.636798088411,100,737,100,33.363274040915705,0.6528125,37.345297029703,134387.44294073334,1343.8744294073333,8
3899,512.1530783058819,0,0,837,0.0,0.0,1.0,837,23550,17500,6050,0.7430997876857749,296,175,121,150.0620558333144,0.4151706177031587,0.9248720011325644,0.10608078872301657,17688490.934797857,339924.26285294414,18028415.1976508,3898,1,2561.636798088411,106,731,99,33.23478843328266,0.6530070754716981,37.178738317757016,134604.71821479689,1269.855832215065,0
3900,511.7397392156045,0,0,837,0.0,0.0,1.0,837,23800,17700,6100,0.7436974789915967,299,177,122,149.53339630309642,0.41506819753848617,0.9241590856183011,0.1059932308599778,17686048.094483875,337730.967749615,18023779.06223349,3899,2,2562.636798088411,111,726,90,33.15940285835578,0.6527777777777778,37.0907738095238,134541.09884809016,1212.081971604416,0
3901,511.7083375609156,2,0,839,0.0023837902264600714,0.0,1.0,839,23300,17600,5700,0.7553648068669528,290,176,114,146.1450442748062,0.41553563453480535,0.9222711636448806,0.104294262859198,17714467.06030493,326676.3145665717,18041143.3748715,3900,0,2557.5256257449346,120,719,81,33.02606467091992,0.6532118055555556,36.8715564738292,134645.01840176806,1122.0418200147337,0
3902,511.9630852470486,0,0,839,0.0,0.0,1.0,839,23900,17900,6000,0.7489539748953975,299,179,120,144.21786904598656,0.41554381281273023,0.9213111165639112,0.1032430085053046,17736967.74161964,319897.53820675355,18056865.27982639,3901,1,2558.5256257449346,126,713,85,32.97376634572441,0.6531911375661376,36.77001312335956,134764.0362109037,1069.55584294368,0
3903,511.46758477888244,1,0,840,0.0011904761904761906,0.0,1.0,840,22650,15900,6750,0.7019867549668874,294,159,135,145.60822263066297,0.41564844178632915,0.9225204990860174,0.10479242746184123,17742790.845749866,326049.2479114487,18068840.093661316,3902,0,2556.4785714285713,132,708,92,32.76398015719624,0.6539614898989898,36.59931077694236,134720.91434601072,1020.6129874697781,0
3904,511.50399106326813,0,0,840,0.0,0.0,1.0,840,22200,15900,6300,0.7162162162162162,285,159,126,150.18728103770377,0.4154845266473693,0.9243351204437975,0.1113433413211362,17871317.931836147,346608.92974856927,18217926.861584716,3903,1,2557.4785714285713,125,715,86,31.686310919989594,0.6645833333333333,35.656415343915356,135212.79856355904,1081.7023885084723,8
3905,511.8560448809639,1,0,841,0.0011890606420927466,0.0,1.0,841,24750,17900,6850,0.7232323232323232,316,179,137,151.02660857818293,0.415563954475964,0.9250479900527369,0.11231084290867872,17896693.751085095,347625.39239775506,18244319.14348285,3904,0,2555.436385255648,130,711,89,31.566045726084546,0.6647435897435898,35.55979643765906,135355.31670293855,1041.194743868758,0
3906,512.1680246654221,0,0,841,0.0,0.0,1.0,841,22550,16800,5750,0.7450110864745011,283,168,115,154.564482484721,0.41555669979049886,0.9266142289213546,0.11527086010742447,17919727.61973337,363200.68516225164,18282928.30489562,3905,1,2556.436385255648,135,706,93,31.381591964173694,0.664891975308642,35.470281862745104,135483.6632036592,1003.5826903974756,0
3907,512.2261683352751,0,0,841,0.0,0.0,1.0,841,24350,17000,7350,0.6981519507186859,317,170,147,153.58644488033838,0.41553169176905796,0.9265700695909607,0.11512576303366352,17943290.27301452,358619.23249764455,18301909.505512163,3906,2,2557.436385255648,98,743,98,31.24619043833146,0.6738945578231292,35.31144781144778,135580.40288975195,1383.47349887502,0
3908,512.2019909614985,0,2,839,0.0,0.0023781212841854932,0.9976218787158145,841,22400,15600,6800,0.6964285714285714,292,156,136,153.99411959885705,0.4154408017666044,0.9262260601238821,0.11582959015963272,17956974.361249752,362453.6914839716,18319428.052733723,3907,3,2558.436385255648,102,739,102,31.12658977198946,0.6739174836601307,35.20428802588993,135628.8908712046,1329.6950085412216,0
3909,512.2681747944328,1,0,840,0.0011904761904761906,0.0,1.0,840,23700,16800,6900,0.7088607594936709,306,168,138,154.0651432899905,0.41532217823561685,0.9260500267522771,0.11620167587126246,17970859.07625888,362036.5957256019,18332895.671984483,3908,0,2562.2619047619046,104,736,99,31.038155430711626,0.6742788461538461,35.119047619047585,135690.0820139996,1304.7123270576885,0
3910,512.4638690408225,0,0,840,0.0,0.0,1.0,840,22150,14800,7350,0.6681715575620768,295,148,147,151.5673232045525,0.41515761275706153,0.9240914786967427,0.11489274292655786,17998808.333907943,355456.24000843405,18354264.573916376,3909,1,2563.2619047619046,114,726,71,30.94668489405329,0.6736111111111112,34.96376811594199,135821.49282730257,1191.4166037482682,0
3911,512.1735835002019,0,1,839,0.0,0.0011904761904761906,0.9988095238095238,840,22200,16100,6100,0.7252252252252253,283,161,122,152.60972949290118,0.41491719403295685,0.9244016898871579,0.1160042522364014,18000233.168461688,359202.14292960614,18359435.311391294,3910,2,2564.2619047619046,117,723,73,30.832161011775923,0.6738782051282051,34.87817796610165,135788.39365520191,1160.584561155572,0
3912,512.0608697275746,0,1,838,0.0,0.0011918951132300357,0.99880810488677,839,22350,16900,5450,0.756152125279642,278,169,109,151.43247637034924,0.4146619811060445,0.9237924517848868,0.1154785082182587,18009655.2069688,355299.33731347945,18364954.54428228,3911,7,2568.3158522050057,120,719,79,30.76331634640349,0.6743055555555555,34.779614325068835,135808.9813581859,1131.7415113182158,0
3913,511.7585471569032,0,0,838,0.0,0.0,1.0,838,23350,17300,6050,0.7408993576017131,294,173,121,150.6279468215286,0.4144338003476826,0.9237802941384143,0.11527474454056243,18013865.71623361,351728.3214309924,18365594.037664603,3912,8,2572.3675417661098,126,712,83,30.673668428699475,0.6743551587301587,34.67027559055116,135784.75428131947,1077.656780010472,0
3914,512.1817024609801,0,0,838,0.0,0.0,1.0,838,22350,15800,6550,0.7069351230425056,289,158,131,150.89603534225722,0.4143817917154971,0.9255213633964186,0.1125549414999854,17920956.551659048,350890.25863724947,18271846.810296297,3913,9,2573.3675417661098,129,709,93,31.473011449688038,0.665859173126615,35.46474358974362,135490.11798915913,1050.3109921640244,8
3915,512.6215837782579,0,0,838,0.0,0.0,1.0,838,21300,14200,7100,0.6666666666666666,284,142,142,152.53798044754302,0.4142918830178242,0.926205278286133,0.11411505332055143,17948817.118987057,358675.26295051235,18307492.38193757,3914,10,2574.3675417661098,94,744,94,31.33623725863928,0.6744237588652482,35.37280701754385,135653.6107774608,1443.1235189091574,0
3916,512.6424353373756,0,0,838,0.0,0.0,1.0,838,26150,19400,6750,0.7418738049713193,329,194,135,152.46616925196014,0.4141983506461783,0.9276821656546708,0.10909286205784081,17758310.768984336,347758.32306658215,18106069.092050917,3915,11,2575.3675417661098,107,731,78,32.77314645169171,0.6567367601246106,36.7862654320988,134934.5299031364,1261.0703729265083,8
3917,512.3486762182048,0,0,838,0.0,0.0,1.0,838,23500,17300,6200,0.7361702127659574,297,173,124,152.50215828589984,0.41420815238725267,0.9275143565960304,0.10971847886016856,17771955.651775386,350952.31877141783,18122907.970546804,3916,12,2576.3675417661098,116,722,82,32.59292748332432,0.6566091954022988,36.60968660968665,134947.6783942274,1163.34205512265,0
3918,512.5046939708565,0,0,838,0.0,0.0,1.0,838,23600,17500,6100,0.7415254237288136,297,175,122,150.93722863257582,0.41416653954105515,0.9273231993216291,0.1090774429724165,17796669.72651523,346036.0014819019,18142705.72799713,3917,13,2577.3675417661098,123,715,87,32.489035786767,0.6567581300813008,36.46673387096777,135062.0359086018,1098.0653325902585,0
3919,512.9139139935627,0,1,837,0.0,0.0011933174224343676,0.9988066825775657,838,26950,20800,6150,0.7717996289424861,331,208,123,145.0228529040595,0.4143264564317956,0.9238038688939108,0.10187518676139717,17687073.95057594,318455.98476752307,18005529.935343463,3918,14,2578.3675417661098,98,740,98,33.57573086528573,0.6529549319727892,37.384259259259274,134699.26745965285,1374.4823210168659,7
3920,513.2228421543548,0,0,837,0.0,0.0,1.0,837,22100,15700,6400,0.7104072398190046,285,157,128,144.0699347153451,0.41416582825043496,0.9228927416941521,0.10164721073177026,17716897.269546825,320994.44659642084,18037891.716143247,3919,15,2580.3189964157705,104,733,104,33.456511616199755,0.6528445512820513,37.24206349206351,134853.37497321755,1296.6670670501687,0
3921,513.0221264926037,0,0,837,0.0,0.0,1.0,837,21450,14800,6650,0.6899766899766899,281,148,133,143.3808690000683,0.414113546329166,0.9220622663578604,0.1015850193264521,17728334.02578873,319530.78770821425,18047864.813496944,3920,16,2581.3189964157705,110,727,92,33.33645677161418,0.6528409090909091,37.10585585585586,134870.512871282,1226.095571557109,0
3922,512.8608514773188,0,0,837,0.0,0.0,1.0,837,21650,15700,5950,0.7251732101616628,276,157,119,140.60499238557514,0.41405108193803725,0.9161087401113392,0.10044762823637798,17759012.40334775,310351.16074960516,18069363.564097356,3921,17,2582.3189964157705,131,706,89,33.13691975530763,0.6517175572519084,36.8371212121212,134965.93809237296,1030.2743365829997,8
3923,513.1664812561095,0,0,837,0.0,0.0,1.0,837,24350,17600,6750,0.7227926078028748,311,176,135,141.4628791454081,0.41399784727105043,0.9178501311480227,0.10149309848621296,17788210.529586703,311524.2952719998,18099734.824858703,3922,18,2583.3189964157705,133,704,93,32.9745886353124,0.6528038847117794,36.69931592039801,135117.08556145572,1015.9179365522987,0
3924,513.4945496181595,0,0,837,0.0,0.0,1.0,837,23600,17100,6500,0.7245762711864406,301,171,130,141.28829664892905,0.413885244636518,0.9191632643547545,0.10179031577174916,17817670.921782453,312485.67495796346,18130156.596740417,3923,19,2584.3189964157705,135,702,96,32.843543447500586,0.653858024691358,36.565563725490215,135272.14720869437,1002.015905249588,0
3925,513.7432258933667,0,0,837,0.0,0.0,1.0,837,23250,16400,6850,0.7053763440860215,301,164,137,142.27938466674664,0.41382545984272073,0.9206258213569716,0.10297899378151287,17846346.14454437,317183.4295991112,18163529.57414348,3924,20,2585.3189964157705,101,736,101,32.66724783675579,0.6619224422442245,36.417483660130735,135413.73223353623,1340.73002211422,0
3926,513.7515835172045,1,0,838,0.0011933174224343676,0.0,1.0,838,21400,14800,6600,0.6915887850467289,280,148,132,140.23466583976085,0.4137913110713814,0.919319205119939,0.10192693487881134,17864838.840732276,312053.94102225685,18176892.781754535,3925,0,2583.232696897375,106,732,106,32.584874549325086,0.6620479559748428,36.283099688473534,135484.97513529623,1278.1601427858136,0
3927,513.596262849853,0,0,838,0.0,0.0,1.0,838,23950,18100,5850,0.755741127348643,298,181,117,137.07528829243773,0.4137216593052621,0.9168778115519622,0.10014159500625669,17881501.852288205,298672.4043008354,18180174.25658904,3926,1,2584.232696897375,113,725,102,32.50310923739285,0.6621497050147493,36.12024853801171,135527.65419262587,1199.359771616158,0
3928,513.8572524886123,0,0,838,0.0,0.0,1.0,838,21850,16500,5350,0.7551487414187643,272,165,107,138.2115300262685,0.41359408816006704,0.9172971740726876,0.10125608237580593,17902694.692550674,305421.76501012134,18208116.457560796,3927,2,2585.232696897375,116,722,81,32.38262673277345,0.6624461206896552,36.030982905982924,135642.39386605227,1169.3309816038989,0
3929,514.0266706197073,0,0,838,0.0,0.0,1.0,838,21400,14600,6800,0.6822429906542056,282,146,136,140.32948281208635,0.41346518041381647,0.9179489231283495,0.10316735378880558,17923601.818688415,314041.9546692679,18237643.773357682,3928,3,2586.232696897375,121,717,83,32.21460845808145,0.6626205234159779,35.92042349726778,135743.94548836286,1121.8507891600236,0
3930,513.4808514687132,0,1,837,0.0,0.0011933174224343676,0.9988066825775657,838,21600,16200,5400,0.75,270,162,108,138.52825412803668,0.4134529430885963,0.9167816875017771,0.10212958567454558,17916601.777399093,307191.1128260793,18223792.890225172,3929,4,2587.232696897375,127,711,86,32.172228469034614,0.662483595800525,35.831705729166686,135645.3606732264,1068.0737060883966,0
3931,513.4235687446029,0,0,837,0.0,0.0,1.0,837,23050,15700,7350,0.6811279826464208,304,157,147,138.4110810212144,0.4130190796857463,0.9174924513989693,0.102427926527322,17930687.60973184,305911.17110333825,18236598.78083518,3930,26,2591.3189964157705,129,708,91,32.055118040606786,0.6633559431524547,35.713141025641036,135691.10230691775,1051.8690101311454,0
3932,513.4230335657655,0,0,837,0.0,0.0,1.0,837,22350,15900,6450,0.7114093959731543,288,159,129,139.51747256010455,0.4129903782209951,0.9184326700199685,0.10357649414773738,17944270.217786238,310957.84554422094,18255228.06333046,3931,27,2592.3189964157705,137,700,93,31.924261025143206,0.663169099756691,35.61292270531402,135742.415260225,990.8205493447081,0
3933,513.5622113401766,0,0,837,0.0,0.0,1.0,837,22800,17400,5400,0.7631578947368421,282,174,108,140.62997468336013,0.41283097195307156,0.9199509421471157,0.10473671153815274,17962744.32564302,315020.05595177313,18277764.381594796,3932,28,2593.3189964157705,140,697,96,31.793222721897965,0.663764880952381,35.512706855791976,135830.67913851788,970.2191367036992,0
3934,513.7281810779483,0,0,837,0.0,0.0,1.0,837,23600,16400,7200,0.6949152542372882,308,164,144,142.90837526425773,0.4126218442679959,0.9211970483182095,0.10679553904709356,17982975.860562135,322983.5725298554,18305959.43309199,3933,29,2594.3189964157705,102,735,102,31.625291442112868,0.671875,35.40655339805823,135929.1100479596,1332.6383338035255,0
3935,514.0344543502827,1,0,838,0.0011933174224343676,0.0,1.0,838,23500,16800,6700,0.7148936170212766,302,168,134,139.92511601764187,0.4127577323262133,0.918674416720596,0.10507350170575333,18014222.825478256,313028.4437645372,18327251.269242793,3934,0,2592.2219570405728,109,729,109,31.551243874521514,0.6717316513761468,35.255681818181806,136087.70113892792,1248.511019623192,0
3936,514.372849207327,0,0,838,0.0,0.0,1.0,838,22400,15900,6500,0.7098214285714286,289,159,130,140.62955556559388,0.4126085379461634,0.919050165683845,0.10596453608589207,18040566.55308019,317407.37130223546,18357973.924382426,3935,1,2593.2219570405728,112,726,112,31.424753170211016,0.6721540178571428,35.14933628318583,136231.99051046878,1216.3570581291856,0
3937,514.5544007648386,2,1,839,0.002380952380952381,0.0011904761904761906,0.9988095238095238,840,21500,16100,5400,0.7488372093023256,269,161,108,139.5623834061126,0.4128556470760732,0.9175873588235923,0.10568631853358773,18067995.726633776,314822.50939609105,18382818.236029867,3936,0,2588.045238095238,120,720,76,31.296359462473855,0.6721354166666667,34.99483471074379,136359.57402499949,1136.3297835416624,0
3938,513.9328672309882,0,0,839,0.0,0.0,1.0,839,22100,15900,6200,0.7194570135746606,283,159,124,129.43432465096177,0.41277682878146976,0.914580467729635,0.09584022091943237,17950941.792399563,274793.60554959247,18225735.397949155,3937,1,2592.129916567342,130,709,91,32.27396030767071,0.6633814102564102,35.69497455470738,135835.0395506585,1044.8849196204499,8
3939,514.0329153674705,0,0,839,0.0,0.0,1.0,839,24750,17300,7450,0.6989898989898989,322,173,149,132.41200115176417,0.41256721596248136,0.9163909299105308,0.09838452852273766,17969187.776091892,283317.2225008302,18252504.998592723,3938,2,2593.129916567342,134,705,93,32.08526662386684,0.6638681592039801,35.586419753086425,135917.28351707186,1014.3080859482975,0
3940,513.8376385008256,0,0,839,0.0,0.0,1.0,839,24050,17700,6350,0.735966735966736,304,177,127,133.17698157237814,0.41255180761276783,0.9171608592439076,0.099372666942412,17980375.03149668,287064.41484681907,18267439.4463435,3939,3,2594.129916567342,139,700,100,31.930723526930116,0.6644934052757794,35.45386904761906,135933.75920310244,977.9407136913844,0
3941,513.9387773342199,0,0,839,0.0,0.0,1.0,839,23250,16800,6450,0.7225806451612903,297,168,129,132.27821822441015,0.4123600921846005,0.9157163110685522,0.09912558341109305,18002090.235457398,285206.88413226634,18287297.119589664,3940,4,2595.129916567342,107,732,107,31.819079027281735,0.6715342679127726,35.32021604938269,136029.2045486643,1271.3009770903207,0
3942,514.2165848793742,0,0,839,0.0,0.0,1.0,839,21450,15200,6250,0.7086247086247086,277,152,125,130.75809075877766,0.41231226703760493,0.914407887699249,0.09821478318654382,18021685.677411936,282046.2422866328,18303731.91969857,3941,5,2596.129916567342,110,729,110,31.785897844888684,0.6715909090909091,35.24774774774772,136139.9989922739,1237.6363544752173,0
3943,513.8910957078278,0,0,839,0.0,0.0,1.0,839,24000,17500,6500,0.7291666666666666,305,175,130,129.0655645697231,0.4122873173636456,0.9130487347916587,0.09721508117174651,18022107.267546546,273406.6898443942,18295513.95739094,3942,6,2597.129916567342,113,726,113,31.742656868157134,0.6718289085545723,35.16081871345026,136098.49705770728,1204.4114783867901,0
3944,514.159783498196,1,0,840,0.0011904761904761906,0.0,1.0,840,23250,16900,6350,0.7268817204301076,296,169,127,126.6006396678865,0.4121145259852053,0.911158959148531,0.09571082994494023,18047101.908801395,265704.9291611549,18312806.83796255,3943,0,2595.0369047619047,120,720,105,31.692159188138334,0.6716145833333333,35.04648760330577,136228.44057096986,1135.237004758082,0
3945,514.4024140556091,0,0,840,0.0,0.0,1.0,840,23850,17000,6850,0.7127882599580713,307,170,137,127.74302457729345,0.412017625385474,0.9121330662546705,0.0969286766639914,18071043.68262556,269839.95545739227,18340883.63808295,3944,1,2596.0369047619047,124,716,83,31.547291561871177,0.6720430107526882,34.933333333333316,136350.93321900573,1099.604300153272,0
3946,514.384784285292,0,0,840,0.0,0.0,1.0,840,23000,16800,6200,0.7304347826086957,292,168,124,126.63633924365223,0.41187115117203016,0.9109933927485199,0.09644945781122426,18086164.850262918,267073.1415188968,18353237.991781816,3945,2,2597.0369047619047,126,714,92,31.45974451764559,0.6728670634920635,34.81791338582674,136405.63041935323,1082.5843684075653,0
3947,514.5685112068247,0,0,840,0.0,0.0,1.0,840,22850,16100,6750,0.7045951859956237,296,161,135,129.3637988231941,0.41166375196284316,0.9121174304036532,0.09894582450530612,18110424.6799992,277716.6669811964,18388141.346980397,3946,3,2598.0369047619047,129,711,97,31.25531671247224,0.6736918604651163,34.687499999999964,136521.45812955813,1058.3058769733188,0
3948,514.2237887834702,0,0,840,0.0,0.0,1.0,840,21950,15400,6550,0.7015945330296127,285,154,131,132.5530378407518,0.41161580419811944,0.9139218660686828,0.10181201417129988,18115851.63766489,290312.23352896224,18406163.871193852,3947,4,2599.0369047619047,135,705,100,31.040320098491826,0.674074074074074,34.55882352941175,136496.16746384627,1011.0827219544168,0
3949,513.6633960818567,0,1,839,0.0,0.0011904761904761906,0.9988095238095238,840,22500,15600,6900,0.6933333333333334,294,156,138,132.25629538299566,0.41147024637228746,0.9141266341005743,0.10176565275855887,18103549.924139187,288361.6892495485,18391911.613388736,3948,5,2600.0369047619047,136,704,102,30.99290957863183,0.6744791666666667,34.50425790754256,136375.44452848306,1002.7606215329637,0
3950,513.2980104958473,0,0,839,0.0,0.0,1.0,839,21000,15100,5900,0.719047619047619,269,151,118,130.94261343643302,0.4114291315474819,0.9133463123062062,0.10098952523909349,18100347.001381338,285221.34809342644,18385568.349474765,3949,6,2600.258641239571,142,697,107,30.955874957712695,0.674369131455399,34.43327505827502,136314.87156648267,959.9638842710048,0
3951,513.3872548320091,0,0,839,0.0,0.0,1.0,839,23200,16200,7000,0.6982758620689655,302,162,140,133.8040732881313,0.41129816057491636,0.9157553956834503,0.10355660460495758,18117956.68484117,293851.28081793804,18411807.965659108,3950,7,2601.258641239571,108,731,108,30.772407074340514,0.6813271604938271,34.327217125382276,136393.0206835813,1262.8983396627898,0
3952,513.6070682772811,0,1,838,0.0,0.0011918951132300357,0.99880810488677,839,21800,15400,6400,0.7064220183486238,282,154,128,128.73969179508552,0.411084517879849,0.9116579017781106,0.10019448694344295,18148813.2908572,277694.5259023004,18426507.8167595,3951,8,2602.258641239571,119,720,119,30.735544217687004,0.6807598039215687,34.1579861111111,136538.33737839994,1147.3809863731087,0
3953,513.5945590805553,0,0,838,0.0,0.0,1.0,838,21300,14200,7100,0.6666666666666666,284,142,142,152.622704508861,0.41094969722718844,0.9269200841850349,0.11113876049504878,17867458.972694855,356495.98222276155,18223954.954917617,3952,9,2604.527446300716,101,737,101,32.19761863280293,0.6638820132013201,36.223447712418306,135474.20206792987,1341.3287333458404,8
3954,513.8349027359505,0,0,838,0.0,0.0,1.0,838,23000,17600,5400,0.7652173913043478,284,176,108,154.2269649840254,0.41093012344728536,0.9276120978753086,0.11271616772355428,17891502.08348557,361270.4130682717,18252772.496553842,3953,10,2605.527446300716,103,735,97,32.03784270188891,0.6645428802588997,36.107772435897445,135597.0370831745,1316.4760881861603,0
3955,514.1456385158747,0,0,838,0.0,0.0,1.0,838,23350,17000,6350,0.728051391862955,297,170,127,153.08700176021068,0.4108363237554284,0.9269975692899888,0.1120329889175955,17908091.4193696,357349.2045278118,18265440.62389741,3954,11,2606.527446300716,105,733,95,32.02475364261427,0.6644841269841271,36.06525157232706,135700.89975687323,1292.3895214940308,0
3956,514.1698789060661,1,0,839,0.0011918951132300357,0.0,1.0,839,21500,15100,6400,0.7023255813953488,279,151,128,137.71543148092735,0.4108578373504086,0.9182562417823714,0.09471527241629787,17636209.432590727,296455.6383394433,17932665.07093017,3955,0,2604.419547079857,117,722,76,34.47562071677338,0.641559829059829,38.082627118644055,134670.02389780097,1151.0258452803503,8
3957,513.9310318341027,0,0,839,0.0,0.0,1.0,839,22000,15900,6100,0.7227272727272728,281,159,122,140.60853196533074,0.41091224067747434,0.9215638506145065,0.09150833336995069,17376579.69008283,298859.07216022676,17675438.762243055,3956,1,2605.419547079857,116,723,81,36.30084223500412,0.6228448275862069,39.95726495726496,133644.03114147516,1152.103716736855,8
3958,513.7602515716517,0,0,839,0.0,0.0,1.0,839,25700,18700,7000,0.7276264591439688,327,187,140,140.0507207741279,0.41093807929468634,0.9216515757291852,0.09165605625202701,17396619.30174515,293781.8144485052,17690401.116193656,3957,2,2606.419547079857,120,719,87,36.11949617916577,0.6240451388888889,39.764118457300285,133698.85196934844,1114.1570997445704,0
3959,513.9343731045576,0,0,839,0.0,0.0,1.0,839,21700,15600,6100,0.7188940092165899,278,156,122,137.87709535321812,0.4110784138028471,0.9207117478137596,0.09051711324135936,17416977.47252653,290780.4527488847,17707757.925275415,3958,3,2607.419547079857,128,711,91,36.06646040755567,0.623779296875,39.65600775193801,133799.7264475473,1045.3103628714632,0
3960,513.9618551691008,1,0,840,0.0011904761904761906,0.0,1.0,840,24000,16500,7500,0.6875,315,165,150,139.9369145283093,0.41128696884991583,0.9216068851783141,0.09220782020875175,17434821.914739285,295955.03681983455,17730776.95155912,3959,0,2605.3142857142857,96,744,96,35.88469731326877,0.6318359375,39.52963917525774,133871.82986605007,1394.498227771355,0
3961,514.2727905383568,0,1,839,0.0,0.0011904761904761906,0.9988095238095238,840,23900,17500,6400,0.7322175732217573,303,175,128,136.0409704110164,0.4115484053673118,0.9192572736949514,0.08997699500901142,17462565.957041793,283224.8837324706,17745790.840774264,3960,1,2606.3142857142857,102,738,102,35.85608441995247,0.6315359477124183,39.401294498381894,134018.82348900128,1313.9100342058948,0
3962,513.9420615721799,0,0,839,0.0,0.0,1.0,839,21800,14900,6900,0.6834862385321101,287,149,138,136.40640311920015,0.41172657195983775,0.919692665218975,0.0905242493427427,17466819.171672005,286917.19542825775,17753736.36710026,3961,2,2609.414779499404,104,735,100,35.72940449010649,0.6322115384615384,39.285714285714306,133992.0374813195,1288.3849757819185,0
3963,513.9762430518074,1,2,838,0.0011904761904761906,0.002380952380952381,0.9976190476190476,840,21600,14600,7000,0.6759259259259259,286,146,140,136.02556485951322,0.4121656072043438,0.9198446463224776,0.09067017502426654,17488113.638408337,286166.10719836963,17774279.745606706,3962,0,2607.307142857143,106,734,77,35.58709011295214,0.633254716981132,39.13551401869159,134078.1484503138,1264.8881929274887,0
3964,513.7223073942858,0,0,838,0.0,0.0,1.0,838,22850,17500,5350,0.7658643326039387,282,175,107,138.48561421766743,0.411871149994915,0.9212582052424825,0.09263985748123256,17495724.730996158,294131.2371110463,17789855.968107205,3963,4,2614.4582338902146,107,731,80,35.39999784421698,0.6342484423676013,39.01427469135802,134074.18900252646,1253.0298037619295,0
3965,513.5883614118192,0,0,838,0.0,0.0,1.0,838,21600,15200,6400,0.7037037037037037,280,152,128,139.132526029877,0.4120306510542158,0.9213108718834109,0.09341755319148946,17507973.616646875,297985.7189897074,17805959.335636582,3964,5,2615.4582338902146,116,722,81,35.255984042553195,0.6336206896551724,38.88888888888891,134103.62770197607,1156.0657560515178,0
3966,513.071472712947,0,1,837,0.0,0.0011933174224343676,0.9988066825775657,838,24450,18400,6050,0.7525562372188139,305,184,121,138.68982117998328,0.41202491852079964,0.920644565513371,0.09337721359210241,17502835.505440384,293443.02527843666,17796278.530718822,3965,6,2616.4582338902146,122,716,85,35.17309438122102,0.633452868852459,38.79573170731707,134016.45861183418,1098.4955623920835,0
3967,513.4512329819199,1,0,838,0.0011933174224343676,0.0,1.0,838,24050,17300,6750,0.7193347193347194,308,173,135,140.58631839956743,0.41225012094754443,0.921590376557307,0.09503817407529874,17534113.40446507,301361.28998684825,17835474.69445192,3966,0,2617.4498806682577,132,706,89,34.98505304483336,0.6332070707070707,38.65914786967418,134185.78275486096,1016.5589602640982,0
3968,513.4056758268514,1,0,839,0.0011918951132300357,0.0,1.0,839,23600,16700,6900,0.7076271186440678,305,167,138,141.30564379200226,0.41243600793838175,0.9227328390119929,0.09592131191311866,17551267.95663433,304618.64359562786,17855886.60022996,3967,0,2615.3289630512513,94,745,94,34.82487314966247,0.6426196808510638,38.519736842105246,134245.45122196092,1428.1430981059673,0
3969,513.5598027132078,0,1,838,0.0,0.0011918951132300357,0.99880810488677,839,21950,14900,7050,0.6788154897494305,290,149,141,137.57449300803208,0.4126370869021441,0.9181574567722754,0.09132431358025594,17455073.034809794,290524.5646364321,17745597.599446226,3968,1,2616.3289630512513,111,728,106,35.68952217029929,0.6307244744744744,39.27641369047622,133897.15354780076,1206.2806625927997,8
3970,513.9345428791767,1,2,837,0.0011918951132300357,0.0023837902264600714,0.9976162097735399,839,23400,16700,6700,0.7136752136752137,301,167,134,136.48107467432993,0.41307237278155323,0.9179352338152111,0.09104901636081159,17490464.234105356,286223.47104473016,17776687.705150086,3969,0,2616.2955899880812,115,724,79,35.546709175185555,0.6316123188405798,39.107399425287376,134081.7194169258,1165.9279949297895,0
3971,513.9158011686759,0,0,837,0.0,0.0,1.0,837,23050,16300,6750,0.7071583514099783,298,163,135,136.25660855775058,0.4132050437405559,0.9177204154495529,0.09126213006581724,17507970.631413918,286665.34019303066,17794635.971606947,3970,1,2622.0131421744327,120,717,84,35.41542990006923,0.63203125,38.97210743801652,134146.3585333624,1117.8863211113533,0
3972,514.1602003492759,1,0,838,0.0011933174224343676,0.0,1.0,838,21100,14000,7100,0.6635071090047393,282,140,142,140.05516074442096,0.41336288587969494,0.9198538616290657,0.09428992420377164,17539661.217233174,302604.0142364544,17842265.231469627,3971,0,2619.8830548926016,129,709,87,35.13980919074795,0.6322674418604651,38.79807692307692,134299.63310084667,1041.0824271383462,0
3973,513.7351047757212,0,1,837,0.0,0.0011933174224343676,0.9988066825775657,838,24500,17300,7200,0.7061224489795919,317,173,144,141.1779329207484,0.4134030136136085,0.9213603290053498,0.09533381252963394,17538861.730335288,303120.04897431063,17841981.779309597,3972,1,2620.8830548926016,134,704,88,35.00695162163499,0.6325404228855722,38.69598765432099,134241.04416072366,1001.7988370203258,0
3974,514.0277655887159,0,0,837,0.0,0.0,1.0,837,22550,16900,5650,0.7494456762749445,282,169,113,143.08227399070964,0.41330829755773163,0.9230570634616482,0.09689339905479968,17561645.09398732,312602.02301309863,17874247.11700042,3973,2,2624.861409796894,140,697,91,34.86060867271476,0.6326636904761904,38.600768321513,134366.46298629983,959.7604499021417,0
3975,514.4161522979017,0,0,837,0.0,0.0,1.0,837,23900,16500,7400,0.6903765690376569,313,165,148,148.6358654197967,0.4133870777192792,0.9248081014039349,0.09967703138152087,17530659.617527194,329836.95272620796,17860496.570253402,3974,3,2625.861409796894,117,720,74,35.04964946687407,0.6330128205128205,38.93008474576271,134298.58128582407,1147.8511221010604,8
3976,513.8938193552989,0,0,837,0.0,0.0,1.0,837,21950,16600,5350,0.7562642369020501,273,166,107,150.35452013167816,0.41340547762095586,0.925296938595527,0.10114991482112431,17527262.213605087,337710.6198697392,17864972.833474826,3975,4,2626.861409796894,125,712,77,34.89583333333335,0.6326666666666667,38.82275132275133,134217.37385146058,1073.7389908116847,0
3977,513.7474630140509,1,0,838,0.0011933174224343676,0.0,1.0,838,23100,16500,6600,0.7142857142857143,297,165,132,153.57897048417504,0.4135588018921994,0.9279802305826284,0.10389601902653806,17547478.518436033,348284.73709091695,17895763.25552695,3976,0,2624.7255369928403,133,705,84,34.620932722622115,0.6333020050125313,38.63495024875622,134275.63123024278,1009.5912122574646,0
3978,513.4939974467829,0,0,838,0.0,0.0,1.0,838,23000,16500,6500,0.717391304347826,295,165,130,156.1178793758319,0.41347516036836485,0.929791961405297,0.10588403111408606,17550364.98641735,357385.1527902731,17907750.139207624,3977,1,2625.7255369928403,142,696,88,34.467232716668576,0.6329225352112676,38.548951048951075,134253.5442625306,945.4474948065536,0
3979,513.145925539031,0,0,838,0.0,0.0,1.0,838,23150,16100,7050,0.6954643628509719,302,161,141,145.4827791948237,0.4137716184824956,0.9240045125418404,0.09398784825988223,17316023.997498065,313086.6591520587,17629110.656650122,3978,2,2626.7255369928403,105,733,92,36.43279996973823,0.6226190476190476,40.21226415094341,133309.01815595423,1269.6096967233736,8
3980,512.7168333585807,1,1,838,0.0011918951132300357,0.0011918951132300357,0.99880810488677,839,23750,17000,6750,0.7157894736842105,305,170,135,144.75260534878535,0.41399444398614477,0.9238945405091088,0.09403781417997116,17327304.317493636,310084.488725696,17637388.806219332,3979,0,2624.5935637663883,109,730,81,36.25564580753262,0.6236620795107033,40.01893939393941,133296.66612714564,1222.9051938270243,0
3981,512.6426195047943,1,0,839,0.0011918951132300357,0.0,1.0,839,23900,17100,6800,0.7154811715481172,307,171,136,143.2394886289381,0.4142499855398564,0.9229717055343645,0.09351501395424915,17347564.246876143,305271.24633603834,17652835.493212182,3980,0,2625.5637663885577,117,722,87,36.12176224409001,0.6237535612535612,39.84816384180791,133364.9187571177,1139.8711004881854,0
3982,512.9395705892788,0,0,839,0.0,0.0,1.0,839,22850,16100,6750,0.7045951859956237,296,161,135,158.34999897172594,0.4143589107197548,0.9302315561720558,0.10103015249709543,17250857.00484017,355684.6377955644,17606541.642635733,3981,1,2626.5637663885577,127,712,87,36.54259756084807,0.6139271653543308,40.64941406249999,133031.17818285857,1047.4895919910123,8
3983,513.2767034262532,1,0,840,0.0011904761904761906,0.0,1.0,840,23400,17400,6000,0.7435897435897436,294,174,120,141.4638380208436,0.4145468256333125,0.9227048574524725,0.08967108385247598,17231696.72358848,296132.39082600037,17527829.114414483,3982,0,2624.4357142857143,114,726,87,37.21299274070447,0.6139437134502924,40.878623188405776,133000.96607712575,1166.675141027419,8
3984,513.0058269592997,1,0,841,0.0011890606420927466,0.0,1.0,841,24000,18300,5700,0.7625,297,183,114,143.02124606660098,0.4149721962705019,0.9235382413586322,0.090950702217358,17237702.753792547,300871.5454346138,17538574.29922716,3983,0,2622.3139120095125,118,723,90,37.05744555124085,0.6143185028248588,40.76505602240895,132989.036811971,1127.0257356946695,0
3985,512.5454345060066,0,0,841,0.0,0.0,1.0,841,21750,15400,6350,0.7080459770114943,281,154,127,143.92192518019448,0.4150321211520676,0.9242170516002326,0.0917779507052868,17235218.322479066,306155.1603744245,17541373.48285349,3984,1,2623.3139120095125,122,719,92,36.934978664576676,0.6145833333333333,40.66734417344171,132919.76876221853,1089.5063013296601,0
3986,512.7195855192533,4,0,845,0.004733727810650888,0.0,1.0,845,23550,17500,6050,0.7430997876857749,296,175,121,140.51212400048382,0.4159034184918253,0.9229819261067504,0.09011627796661426,17267700.6377348,292714.2586425333,17560414.896377333,3985,0,2611.891124260355,98,747,98,36.82042082218441,0.621811224489796,40.46717171717176,133067.56414581332,1357.8322872021768,0
3987,512.8259502763859,0,0,845,0.0,0.0,1.0,845,22250,15900,6350,0.7146067415730337,286,159,127,141.46153764121397,0.41601985707208095,0.9231396965442089,0.09110378485110328,17290662.92601351,297942.75286996574,17588605.678883478,3986,1,2612.891124260355,102,743,101,36.648151393594745,0.6222426470588236,40.3216019417476,133169.82125047443,1305.5864828477886,0
3988,512.7650782361666,0,1,844,0.0,0.001183431952662722,0.9988165680473373,845,24000,17100,6900,0.7125,309,171,138,140.00952086013476,0.4160668882096152,0.9218385805533462,0.09064925110351801,17313275.625760596,291804.68497643515,17605080.310737032,3987,2,2613.891124260355,112,733,76,36.49809329549484,0.6218377976190477,40.13643067846606,133248.96345388502,1189.7228879811162,0
3989,512.4171226655181,4,0,848,0.0047169811320754715,0.0,1.0,848,25050,18400,6650,0.7345309381237525,317,184,133,136.11801572962688,0.41666315700808626,0.9199373393474128,0.08871936543056676,17332337.896157227,277198.6884760688,17609536.584633294,3988,0,2605.629716981132,122,726,86,36.364789550230064,0.6222677595628415,39.90514905149052,133277.05514315222,1092.434878222559,0
3990,512.1717604328168,0,1,847,0.0,0.0011792452830188679,0.9988207547169812,848,23350,16500,6850,0.7066381156316917,302,165,137,138.71157408861276,0.41672992753744253,0.9214690688582425,0.09062470309617478,17334972.7416149,287962.27115452103,17622935.012769423,3989,1,2606.629716981132,125,723,87,36.2141270269984,0.6225833333333333,39.82308201058201,133255.27011062493,1066.0421608849995,0
3991,512.0343083428912,0,0,847,0.0,0.0,1.0,847,23700,17200,6500,0.7257383966244726,302,172,130,151.70904647354814,0.4167086495423053,0.9279423232995796,0.10331643198825587,17518886.50894894,338454.71351018344,17857341.222459123,3990,2,2610.7024793388427,95,752,95,34.44292351086772,0.6434210526315789,38.4114583333333,133942.30800271564,1409.919031607533,8
3992,512.2426064299887,1,0,848,0.0011792452830188679,0.0,1.0,848,22750,16000,6750,0.7032967032967034,295,160,135,151.64644921938358,0.4168501550979038,0.9285296021422937,0.10384839003933434,17550871.55586714,339955.4704305417,17890827.02629768,3991,0,2608.622641509434,98,750,95,34.256300494392825,0.6444515306122449,38.22601010101008,134091.79088143518,1368.283580422808,0
3993,512.0791702489707,0,0,848,0.0,0.0,1.0,848,23950,17600,6350,0.7348643006263048,303,176,127,148.55328566738885,0.4168244272701284,0.9268833199725526,0.10214356736567197,17563381.717691805,328269.6123187261,17891651.33001053,3992,1,2609.622641509434,103,745,74,34.20020045380956,0.6445186084142395,38.09094551282048,134118.17130248575,1302.1181679852984,0
3994,512.0555395183329,1,0,849,0.001177856301531213,0.0,1.0,849,22800,16700,6100,0.7324561403508771,289,167,122,145.84563343305268,0.4171767122437792,0.9252815441002664,0.10070705905006237,17581418.35172443,320234.61923174333,17901652.970956173,3993,0,2607.547703180212,110,739,79,34.128572195960416,0.6443181818181818,37.950450450450425,134183.9234751293,1219.8538497739028,0
3995,511.68510761479536,0,0,849,0.0,0.0,1.0,849,22350,16200,6150,0.7248322147651006,285,162,123,145.8190226453915,0.41718249966664445,0.9252324800648704,0.10105892265076144,17584995.32131247,320695.3661955076,17905690.687507976,3994,1,2608.547703180212,113,736,84,34.005994702356055,0.6449115044247787,37.82894736842103,134149.02327927202,1187.159498046655,0
3996,511.9477363207119,0,0,849,0.0,0.0,1.0,849,23000,17300,5700,0.7521739130434782,287,173,114,144.2794183973484,0.4172152564800616,0.9244997412678526,0.10035256482957511,17609978.238478616,315351.4836475255,17925329.72212614,3995,2,2609.547703180212,118,731,89,33.92578038090153,0.6451271186440678,37.71008403361342,134278.72873873962,1137.9553282944037,0
3997,512.0198789656207,0,1,848,0.0,0.001177856301531213,0.9988221436984688,849,21050,14800,6250,0.7030878859857482,273,148,125,143.11978219097577,0.4173348825106859,0.923923903416378,0.09978140174896327,17622910.903799586,313587.43402455444,17936498.33782414,3996,3,2610.547703180212,125,724,92,33.8772739685741,0.6446666666666667,37.63227513227513,134337.49073125774,1074.6999258500618,0
3998,511.56536152877544,0,0,848,0.0,0.0,1.0,848,24350,17500,6850,0.7186858316221766,312,175,137,146.3938639896461,0.41724114846702753,0.925384815244769,0.10242680496344464,17622921.93318831,322027.52731746435,17944949.460505776,3997,4,2614.6167452830186,132,716,97,33.67305454436949,0.6447285353535354,37.515664160401,134277.89415942493,1017.2567739350374,0
3999,511.33363001423714,1,0,849,0.001177856301531213,0.0,1.0,849,25150,18800,6350,0.7475149105367793,315,188,127,148.3430046061994,0.4173093021016216,0.9259816270380525,0.10435440183185885,17638767.43402991,328367.55174279795,17967134.98577271,3998,0,2612.5359246171965,102,747,102,33.44178345910982,0.6523692810457516,37.33818770226539,134307.81794831954,1316.7433132188191,0
4000,511.00375605402314,1,0,850,0.001176470588235294,0.0,1.0,850,20900,13700,7200,0.6555023923444976,281,137,144,148.8297504824461,0.41745516640107166,0.9266267559053363,0.10504569555843442,17641970.400534056,334230.0105460414,17976200.411080096,3999,0,2610.4611764705883,103,747,103,33.31876151451628,0.6532160194174756,37.229567307692335,134276.67808571146,1303.6570687933151,0
4001,510.9885108706878,0,0,850,0.0,0.0,1.0,850,25250,18600,6650,0.7366336633663366,319,186,133,147.0343438817612,0.4173533164738215,0.9253214749641339,0.10409401560351522,17654724.1907539,323920.15756019397,17978644.348314095,4000,1,2611.4611764705883,109,741,97,33.26560004563087,0.6528096330275229,37.130681818181834,134323.20145132113,1232.3229490946892,0
4002,510.7056148633648,0,0,850,0.0,0.0,1.0,850,25300,18900,6400,0.7470355731225297,317,189,128,138.40262926544918,0.417500317559297,0.9204322683186872,0.09549202328816835,17531556.585889377,289982.7053206098,17821539.29120999,4001,2,2612.4611764705883,117,733,78,34.35022347999906,0.6426282051282051,37.9766949152542,133816.773131834,1143.7331036908888,8
4003,510.7369291422227,0,0,850,0.0,0.0,1.0,850,23050,16300,6750,0.7071583514099783,298,163,135,140.8778012672981,0.41741275780041115,0.9206332215941653,0.09755610832899639,17548855.62036948,301398.8389109816,17850254.45928046,4002,3,2613.4611764705883,125,725,80,34.162455191480795,0.6424166666666666,37.85548941798941,133886.88232614665,1071.095058609173,0
4004,510.75628702159065,0,0,850,0.0,0.0,1.0,850,25150,18500,6650,0.73558648111332,318,185,133,140.09386080692724,0.4175202371879258,0.9207451308282522,0.097414103212258,17567760.39397387,297077.0758645612,17864837.46983843,4003,4,2614.4611764705883,132,718,84,34.0449066332218,0.6426767676767677,37.71929824561402,133961.51738548634,1014.8599801930783,0
4005,511.24014667640654,0,0,850,0.0,0.0,1.0,850,22450,15900,6550,0.7082405345211581,290,159,131,153.34633956590923,0.4177365816762512,0.9269864622019894,0.09985816011520068,17288366.450364266,337771.54244748515,17626137.99281175,4004,5,2615.4611764705883,117,733,81,35.948461190314525,0.6228632478632479,39.9364406779661,132954.93221298466,1136.366941991322,8
4006,511.20037838932035,0,1,849,0.0,0.001176470588235294,0.9988235294117647,850,24800,17700,7100,0.7137096774193549,319,177,142,154.90378125306998,0.4179521178318206,0.9282117479957324,0.10136479374012601,17309402.842905693,341458.3903197418,17650861.233225435,4005,6,2616.4611764705883,123,727,85,35.737055329588756,0.6234756097560976,39.768145161290306,133030.622662502,1081.5497777439186,0
4007,511.57190814956493,0,0,849,0.0,0.0,1.0,849,23700,17500,6200,0.7383966244725738,299,175,124,156.11307531533453,0.41802624804616606,0.9291089029727027,0.1024705601801218,17336083.69768514,347777.8679939364,17683861.565679077,4006,7,2620.3427561837457,131,718,87,35.598034758007486,0.6232506361323156,39.66224747474749,133181.4808227136,1016.652525364226,0
4008,512.019611798745,0,0,849,0.0,0.0,1.0,849,24350,17700,6650,0.7268993839835729,310,177,133,160.51860559544716,0.41806184069678715,0.9315082632083835,0.10574680036065405,17367949.74089294,363425.8148919883,17731375.555784926,4007,8,2621.3427561837457,89,760,89,35.3561218746297,0.6338951310861423,39.53703703703704,133362.14518424726,1498.4510694859243,0
4009,512.4855181725675,1,0,850,0.001176470588235294,0.0,1.0,850,24600,16900,7700,0.6869918699186992,323,169,154,167.3227782989952,0.4182641631446454,0.9326231747846543,0.11126140055347243,17426337.293778118,388564.63431407197,17814901.92809219,4008,0,2619.2576470588237,96,754,86,34.854739746335035,0.6349826388888888,39.21821305841925,133646.88921072462,1392.155095945048,0
4010,512.149473680203,1,1,850,0.0011750881316098707,0.0011750881316098707,0.9988249118683902,851,23100,16400,6700,0.70995670995671,298,164,134,166.9090089931189,0.4186112071150434,0.932237637440108,0.1112756055211379,17426755.97578167,388436.5139765297,17815192.4897582,4009,0,2617.1786133960045,100,751,73,34.77537492422445,0.6347916666666666,39.12953795379539,133604.66983567574,1336.0466983567574,0
4011,512.5985790916377,0,0,850,0.0,0.0,1.0,850,24450,18100,6350,0.7402862985685071,308,181,127,174.15645357226614,0.4185827039885448,0.9334266502492361,0.11297751564145436,17316667.790119264,408711.8900032579,17725379.68012252,4010,2,2621.2576470588237,102,748,75,35.54190011153479,0.6247957516339869,40.06877022653724,133240.3790434202,1306.2782259158841,8
4012,513.0040738848091,1,0,851,0.0011750881316098707,0.0,1.0,851,23350,17000,6350,0.728051391862955,297,170,127,177.60460030427726,0.41887243381488903,0.9343937622923129,0.11574920502589196,17351776.650655963,422801.0713217737,17774577.721977737,4011,0,2619.1762632197415,108,743,78,35.28890787281991,0.625,39.908256880733965,133428.1238039859,1235.445590777647,0
4013,513.3557149017338,0,0,851,0.0,0.0,1.0,851,25950,19500,6450,0.7514450867052023,324,195,129,179.62163790759342,0.4189459920278335,0.935631980270434,0.11757765730283072,17383879.556386087,428354.1838212786,17812233.740207367,4012,1,2620.1762632197415,113,738,82,35.08241605514789,0.6254609144542773,39.75694444444444,133597.25983293378,1182.2766356896796,0
4014,512.9765679428793,2,2,851,0.0023446658851113715,0.0023446658851113715,0.9976553341148886,853,24100,17300,6800,0.7178423236514523,309,173,136,159.6208029325061,0.41952233624490204,0.9280021683427158,0.09820081544510274,17080094.821703225,350567.68992072763,17430662.511623953,4013,0,2615.0304806565064,126,727,80,37.826452016188846,0.6010251322751323,41.9455380577428,132375.89222948684,1050.6023192816415,8
4015,512.493500817293,1,0,852,0.0011737089201877935,0.0,1.0,852,23050,16200,6850,0.702819956616052,299,162,137,158.59265665813618,0.41977227725275795,0.9282300271510271,0.09811159322862527,17090465.43187371,348634.46327299025,17439099.895146698,4014,0,2618.989436619718,131,721,89,37.64985536474569,0.6022582697201018,41.74558080808085,132353.7113932064,1010.3336747573009,0
4016,512.825719726227,2,0,854,0.00234192037470726,0.0,1.0,854,23250,16800,6450,0.7225806451612903,297,168,129,156.95632702584206,0.4203478527363129,0.9285863753255847,0.09754884875906632,17123499.036320873,343478.3029142894,17466977.33923516,4015,0,2613.8536299765806,95,759,95,37.52379352816035,0.6114035087719298,41.579861111111086,132524.4937174447,1394.9946707099443,0
4017,513.041171371455,0,0,854,0.0,0.0,1.0,854,23600,17300,6300,0.7330508474576272,299,173,126,154.87941640489296,0.42059260354921285,0.9269550798619091,0.09662979459189401,17148976.46305498,336804.6933078368,17485781.156362817,4016,1,2614.8536299765806,101,753,101,37.43746214814231,0.6111798679867987,41.441993464052274,132650.90254067018,1313.3752726799028,0
4018,512.9831568775908,2,2,854,0.002336448598130841,0.002336448598130841,0.9976635514018691,856,23500,16600,6900,0.7063829787234043,304,166,138,155.03380716477193,0.42124605468109527,0.927409824387166,0.09732618535243974,17176283.014981493,337880.909750435,17514163.92473193,4017,0,2609.7418224299067,109,747,73,37.20965071175033,0.6115252293577982,41.2215909090909,132748.9652272145,1217.8804149285734,0
4019,512.9977441760126,0,0,854,0.0,0.0,1.0,854,23150,17000,6150,0.734341252699784,293,170,123,159.24514137071853,0.42126891427875895,0.9281458825714806,0.10040486590262893,17197236.462902505,353765.2703441175,17551001.73324662,4018,1,2616.7025761124123,112,742,79,36.94410326699656,0.6124441964285714,41.067477876106196,132831.79974336314,1185.9982119943138,0
4020,513.3759944134727,1,0,855,0.0011695906432748538,0.0,1.0,855,23050,16700,6350,0.7245119305856833,294,167,127,160.6143673893967,0.4215678084099137,0.9288451551668107,0.10188532990278719,17238493.26012778,359699.93794435926,17598193.19807214,4019,0,2614.640935672515,118,737,87,36.6903113212858,0.6134357344632768,40.85259103641456,133040.05877635517,1127.458125223349,0
4021,513.2434081289982,1,1,855,0.0011682242990654205,0.0011682242990654205,0.9988317757009346,856,23350,16900,6450,0.7237687366167024,298,169,129,161.17018354176585,0.4216720409538905,0.9292092680770292,0.10267252191461027,17253926.75407253,361613.708354009,17615540.462426536,4020,0,2612.5852803738317,119,737,94,36.524032506444335,0.6147584033613445,40.70312499999999,133082.41184219846,1118.339595312592,0
4022,513.4415664513291,1,0,856,0.0011682242990654205,0.0,1.0,856,24050,16500,7550,0.6860706860706861,316,165,151,159.98196618360546,0.42173130613397464,0.9287858658186265,0.10244302079952455,17284728.636354234,357798.97443880216,17642527.610793035,4021,0,2613.5782710280373,100,756,100,36.3706824595572,0.6207291666666667,40.52186468646864,133226.86025524914,1332.2686025524913,0
4023,513.5619264757828,4,0,860,0.004651162790697674,0.0,1.0,860,25500,18700,6800,0.7333333333333333,323,187,136,183.40924145159647,0.4226745878116793,0.9398499804807325,0.11812667657097439,17315785.280081,437675.00867168116,17753460.288752683,4022,0,2602.4174418604653,91,769,85,35.55650933798418,0.6253434065934066,40.319293478260896,133362.12390989787,1465.5178451637128,6
4024,513.7722298773051,1,2,859,0.0011614401858304297,0.0023228803716608595,0.9976771196283392,861,22600,16400,6200,0.7256637168141593,288,164,124,162.8359426819708,0.4227770012334675,0.933770090481058,0.11177594559322045,17613918.042138882,378835.7897429308,17992753.831881814,4023,0,2600.3937282229967,94,767,87,33.8830206719428,0.6463874113475176,38.1469298245614,134532.83576425328,1431.2003804707795,8
4025,513.9238011156247,0,0,859,0.0,0.0,1.0,859,23550,17000,6550,0.721868365180467,301,170,131,165.40913564339652,0.4224267276508254,0.9343751229526207,0.11397369209401109,17636087.646004584,388084.0027313578,18024171.64873594,4024,2,2607.4470314318974,97,762,72,33.68745858184227,0.6467998281786942,38.02083333333332,134637.32914643656,1388.0137025405832,0
4026,513.7854942366594,0,1,858,0.0,0.0011641443538998836,0.9988358556461001,859,22000,15100,6900,0.6863636363636364,289,151,138,167.97658901576105,0.42251644681796025,0.934783990880363,0.1162112976796379,17649372.97249929,399136.2940374714,18048509.26653676,4025,3,2608.4470314318974,104,755,73,33.48401839445893,0.6463341346153846,37.88690476190473,134669.90618280368,1294.90294406542,0
4027,513.4399275750948,1,0,859,0.0011641443538998836,0.0,1.0,859,24250,18000,6250,0.7422680412371134,305,180,125,167.78422231427984,0.42255432447516267,0.935050623673094,0.11676561624184155,17663757.454290975,396689.9615232465,18060447.41581422,4026,0,2609.1443538998838,113,746,78,33.29076967290207,0.6462942477876106,37.691885964912245,134679.4590725331,1191.8536201109123,0
4028,513.1913068182955,0,1,858,0.0,0.0011641443538998836,0.9988358556461001,859,22800,16000,6800,0.7017543859649122,296,160,136,167.72553264947737,0.4225779556105516,0.9353774938410659,0.11696711124842124,17664399.344382714,397954.15779392794,18062353.502176642,4027,1,2610.1443538998838,117,742,79,33.22286521768387,0.6461894586894588,37.623587570621446,134649.29397292738,1150.8486664352768,0
4029,512.8150619903392,0,0,858,0.0,0.0,1.0,858,24550,17800,6750,0.725050916496945,313,178,135,164.71403376165284,0.422308932154323,0.9346486846486859,0.11529982363315712,17668081.432635937,385886.19231976615,18053967.624955703,4028,2,2614.146853146853,104,754,85,33.17625661375667,0.6502403846153846,37.50000000000001,134613.95377246427,1294.3649401198488,0
4030,512.3414999013726,1,1,858,0.0011641443538998836,0.0011641443538998836,0.9988358556461001,859,22450,14800,7650,0.6592427616926503,301,148,153,168.80822421336913,0.4224773254167899,0.9341668267461596,0.11631580380729317,17581788.540113032,399340.1003902838,17981128.640503317,4029,0,2612.102444703143,103,756,71,33.598409542743504,0.6452265372168284,38.020833333333314,134222.7991929106,1303.133972746705,8
4031,512.742178574387,0,0,858,0.0,0.0,1.0,858,22850,15800,7050,0.6914660831509847,299,158,141,167.51339138989934,0.42234644488145073,0.933816358243784,0.11598563532904371,17617169.82620642,395772.3728559242,18012942.199062344,4030,1,2616.1375291375293,109,749,76,33.468649904872,0.6454510703363914,37.85984848484847,134410.31237969786,1233.1221319238336,0
4032,512.7165946711242,0,0,858,0.0,0.0,1.0,858,24950,18200,6750,0.7294589178356713,317,182,135,169.9526872466978,0.4221872991199129,0.9350981898131447,0.11798727800582501,17628080.14360194,402637.9182810584,18030718.061883,4031,2,2617.1375291375293,110,748,78,33.31551432081973,0.6461174242424242,37.77214714714714,134448.57174263484,1222.2597431148622,0
4033,513.0281697686179,0,0,858,0.0,0.0,1.0,858,23500,17500,6000,0.7446808510638298,295,175,120,171.79977831476035,0.42219982225087244,0.9363318043027544,0.1197073555829048,17655046.807967976,411526.62554912275,18066573.4335171,4032,3,2618.1375291375293,116,742,80,33.14420934152327,0.6461027298850575,37.65135327635328,134592.24606990622,1160.2779833612606,0
4034,513.1728399412808,0,0,858,0.0,0.0,1.0,858,23100,17300,5800,0.7489177489177489,289,173,116,173.00929702345505,0.42229541737272197,0.9370916006569878,0.12098056848273382,17675807.621754594,416915.8101923148,18092723.431946907,4033,4,2619.1375291375293,121,737,85,32.99324983734544,0.6463498622589532,37.53415300546447,134690.34408977866,1113.1433395849476,0
4035,512.8463591833868,0,0,858,0.0,0.0,1.0,858,25600,18400,7200,0.71875,328,184,144,154.5921098787447,0.42238268262918205,0.9285001724833148,0.10312113391147157,17452985.657100968,342418.7752829422,17795404.43238391,4034,5,2620.1375291375293,107,751,72,35.07758296671477,0.63327492211838,39.11072530864198,133796.11467545776,1250.4309782753062,8
4036,512.3804744846743,0,0,858,0.0,0.0,1.0,858,24250,17200,7050,0.709278350515464,313,172,141,151.30493713450784,0.42254386835775404,0.9266212760867061,0.10118247225915863,17448552.231559925,332160.41969687055,17780712.651256796,4035,6,2621.1375291375293,111,747,78,35.07662152530291,0.6332582582582582,39.02529761904762,133718.34183444924,1204.6697462562995,0
4037,512.2324607646759,1,0,859,0.0011641443538998836,0.0,1.0,859,21750,15400,6350,0.7080459770114943,281,154,127,151.7976594636491,0.42279221877592077,0.9259369633894234,0.10196415153474132,17463654.99768716,336638.3908659133,17800293.388553075,4036,0,2619.0849825378345,121,738,82,34.910836902854484,0.6328340220385675,38.87465846994535,133756.87625995622,1105.4287294211258,0
4038,511.8857602149533,1,0,860,0.0011627906976744186,0.0,1.0,860,25300,19100,6200,0.7549407114624506,315,191,124,157.2343762655127,0.4230185574988043,0.9285718100018707,0.10616367575756683,17475188.625685412,352240.0767363638,17827428.702421777,4037,0,2617.038372093023,124,736,87,34.5914657481822,0.6340725806451613,38.699999999999996,133755.74914416694,1078.6753963239269,0
4039,512.381682036232,0,1,859,0.0,0.0011627906976744186,0.9988372093023256,860,24250,18300,5950,0.7546391752577319,302,183,119,131.75819580881378,0.4230969567551958,0.9181387971427861,0.08897362451006388,17492692.398373865,264711.11804967077,17757403.516423535,4038,1,2618.038372093023,141,719,92,35.252817860251,0.6315750591016549,38.69571596244136,133887.52857844112,949.5569402726321,8
4040,512.2193274162215,1,1,859,0.0011627906976744186,0.0011627906976744186,0.9988372093023256,860,25350,18000,7350,0.7100591715976331,327,180,147,138.41868527718893,0.4233933792674012,0.9225130000110411,0.0938424210131494,17505002.94280764,287253.8986233659,17792256.841431007,4039,0,2617.859302325581,150,710,95,34.94357661793942,0.6318055555555555,38.56236203090513,133913.41108181942,892.7560738787961,0
4041,512.6437151739854,0,0,859,0.0,0.0,1.0,859,23400,17000,6400,0.7264957264957265,298,170,128,137.80227041670238,0.4234464846368222,0.9224848566233661,0.09391435764078557,17543021.853248157,288293.64826947893,17831315.501517635,4040,1,2621.884749708964,100,759,100,34.781876659044926,0.6422916666666667,38.38696369636961,134114.27886863842,1341.1427886863842,0
4042,512.1840853065229,0,0,859,0.0,0.0,1.0,859,23600,16100,7500,0.6822033898305084,311,161,150,134.28283010214085,0.4234870759172273,0.9197346896485514,0.09187072831740466,17544634.500993047,275788.6347801979,17820423.135773245,4041,2,2622.884749708964,109,750,96,34.742824409069,0.6414373088685015,38.257575757575744,134060.30414651707,1229.911047215753,0
4043,512.1334324184814,0,0,859,0.0,0.0,1.0,859,26450,19700,6750,0.7448015122873346,332,197,135,134.31864887638238,0.42350556247529475,0.919630371693948,0.09232626430543674,17563806.713783484,273579.3573842642,17837386.07116775,4042,3,2623.884749708964,115,744,76,34.58386907823304,0.6417572463768115,38.10165229885057,134126.89975291814,1166.3208674166794,0
4044,511.93800421703196,0,2,857,0.0,0.002328288707799767,0.9976717112922002,859,23350,17400,5950,0.7451820128479657,293,174,119,136.95729557660513,0.4231915171234147,0.9206855869931727,0.09456369760498526,17577104.161372535,286312.53000197496,17863416.69137451,4043,4,2624.884749708964,121,738,79,34.36359600534359,0.6421315426997245,37.95252732240438,134152.0601726859,1108.6947121709577,0
4045,512.294417472302,0,0,857,0.0,0.0,1.0,857,22100,15600,6500,0.7058823529411765,286,156,130,136.44335789114695,0.42286896758234366,0.9192506349097418,0.09461269685346549,17608353.292017967,287008.57001930836,17895361.862037275,4044,5,2631.9381563593934,133,724,84,34.233549770714774,0.6416040100250626,37.81094527363182,134317.98905865697,1009.9096921703531,0
4046,512.6873914823506,0,1,856,0.0,0.0011668611435239206,0.9988331388564761,857,23050,16000,7050,0.6941431670281996,301,160,141,137.86631877914255,0.422775193840718,0.9205125814063102,0.09587091776179563,17634447.0444653,291789.259545228,17926236.30401053,4045,6,2632.9381563593934,138,719,87,34.10133146661329,0.641832729468599,37.71732613908871,134469.01989276547,974.4131876287353,0
4047,512.9854144046649,0,0,856,0.0,0.0,1.0,856,23900,17000,6900,0.7112970711297071,308,170,138,135.51738448817062,0.42276172892641783,0.9197277273578672,0.09453088141798867,17658475.98619375,283506.0959392236,17941982.082132973,4046,7,2636.7605140186915,144,712,93,34.059168857007265,0.6420717592592593,37.61494252873561,134599.7074404868,934.720190558936,0
4048,513.0954855057136,0,0,856,0.0,0.0,1.0,856,23400,17100,6300,0.7307692307692307,297,171,126,137.6291257243638,0.4227747945929205,0.9218031449339872,0.0963403880070548,17677742.899064075,291994.4599956545,17969737.35905973,4047,8,2637.7605140186915,108,748,99,33.887235449735456,0.6493055555555556,37.50000000000001,134687.5649452501,1247.1070828263898,0
4049,513.2344283814929,0,0,856,0.0,0.0,1.0,856,24800,18500,6300,0.7459677419354839,311,185,126,136.4314999453038,0.42278381815780364,0.9211447473583931,0.09594536921417608,17702973.32644061,287048.6408836044,17990021.967324216,4048,9,2638.7605140186915,102,754,102,33.76490444470114,0.6522671568627452,37.348300970873815,134801.8946146431,1321.587202104344,0
4050,513.4037570083522,0,1,855,0.0,0.0011682242990654205,0.9988317757009346,856,20950,14800,6150,0.7064439140811456,271,148,123,155.8659991863887,0.4228719188938077,0.9295508564943222,0.10625063914003288,17570113.24693167,355566.65141019307,17925679.89834186,4049,10,2639.7605140186915,95,761,95,34.30112293144208,0.64375,38.37890624999996,134317.25244388223,1413.8658151987604,8
4051,513.6920410676182,0,0,855,0.0,0.0,1.0,855,25300,18500,6800,0.7312252964426877,321,185,136,139.963585180893,0.4230704265216776,0.9169170553775281,0.09044152502903782,17335444.425606314,288966.19050239504,17624410.616108708,4050,11,2643.3730994152047,118,737,81,36.56864561923686,0.6199682203389831,40.2048319327731,133454.71014395804,1130.9721198640511,7
4052,513.6084889685095,1,0,856,0.0011682242990654205,0.0,1.0,856,24350,16900,7450,0.6940451745379876,318,169,149,141.60457246033076,0.4233155537793081,0.9175124994428172,0.09182399595623517,17348932.46567774,295787.6328890904,17644720.09856683,4051,0,2641.283878504673,120,736,85,36.40209602985337,0.6208333333333333,40.082644628099175,133495.76014925318,1112.4646679104433,0
4053,513.5645080754718,3,0,859,0.0034924330616996507,0.0,1.0,859,25950,18400,7550,0.7090558766859345,335,184,151,139.01414916924023,0.4237816171023389,0.9162717491997945,0.09075263323123814,17378565.393397592,285423.29638902465,17663988.689786617,4052,0,2633.055878928987,132,727,95,36.233165743416805,0.6212121212121212,39.84962406015034,133603.99984519536,1012.1515139787527,0
4054,513.0426472640946,1,0,860,0.0011627906976744186,0.0,1.0,860,22500,16900,5600,0.7511111111111111,281,169,112,138.64538494569715,0.42396718850114157,0.9172776534822138,0.09101113623607968,17386233.922405113,287604.21898555453,17673838.141390666,4053,0,2630.993023255814,135,725,100,36.050431499460586,0.6226851851851851,39.65992647058822,133565.56051245728,989.3745223144983,0
4055,512.9778318971396,2,0,862,0.002320185614849188,0.0,1.0,862,22650,16400,6250,0.7240618101545254,289,164,125,139.0011943370204,0.42420364883546086,0.9184166721151874,0.09171284832387407,17407523.145744517,288883.3015415675,17696406.447286084,4054,0,2625.8863109048725,104,758,104,35.8629252348312,0.6302083333333333,39.48412698412701,133638.8677144743,1284.989112639176,0
4056,513.1849140226244,0,0,862,0.0,0.0,1.0,862,22850,16300,6550,0.7133479212253829,294,163,131,138.6912492141443,0.42421341732890316,0.9186402194768337,0.09190822433345608,17434511.645829186,288352.83991972625,17722864.485748913,4055,1,2626.8863109048725,108,754,108,35.71966502908541,0.630787037037037,39.33486238532114,133769.4162354866,1238.6057058841352,0
4057,513.4348421101118,1,1,862,0.0011587485515643105,0.0011587485515643105,0.9988412514484357,863,25000,17700,7300,0.708,323,177,146,135.51029178055856,0.42438936057333404,0.9168833701469898,0.09018700537292845,17462634.04758617,275673.3270091105,17738307.37459528,4056,0,2624.8412514484357,115,748,99,35.653950328237606,0.6307971014492754,39.18821839080463,133909.85591097618,1164.4335296606625,0
4058,512.9372161371568,1,1,862,0.0011587485515643105,0.0011587485515643105,0.9988412514484357,863,23750,16600,7150,0.6989473684210527,309,166,143,138.97145298503278,0.4242527505715328,0.9185224718828284,0.09297542735754355,17469503.53001194,289202.45769858477,17758705.987710524,4057,0,2625.800695249131,119,744,84,35.38340650568751,0.631827731092437,39.01041666666667,133871.27031579695,1124.9686581159408,0
4059,512.8070220100768,0,1,861,0.0,0.001160092807424594,0.9988399071925754,862,24500,17800,6700,0.726530612244898,312,178,134,141.57282707107152,0.4241908768109888,0.9200584982968822,0.09505604103343465,17481338.142288122,298076.4923578222,17779414.634645946,4058,2,2629.8468677494197,122,740,88,35.19226507092197,0.6325136612021858,38.88888888888891,133899.61130263243,1097.5377975625609,0
4060,512.8751662583509,0,1,860,0.0,0.0011614401858304297,0.9988385598141696,861,25800,19100,6700,0.7403100775193798,325,191,134,140.07869713843704,0.42410337267824505,0.9197081716788529,0.09448502273264181,17504413.051949628,292399.074898034,17796812.126847662,4059,3,2633.6353077816493,129,732,94,35.07419391114113,0.6329134366925064,38.73397435897437,133996.85633830054,1038.7353204519422,0
4061,512.4876709666318,1,0,861,0.0011614401858304297,0.0,1.0,861,25350,18500,6850,0.7297830374753451,322,185,137,138.30835426942446,0.4240501400030612,0.919044912152849,0.09364934437490664,17508488.27682489,286764.03986263456,17795252.316687524,4060,0,2634.628339140534,131,730,101,34.98948395926416,0.6339058524173028,38.604797979797986,133961.818285186,1022.6092998869159,0
4062,512.1662140980686,0,0,861,0.0,0.0,1.0,861,25000,17700,7300,0.708,323,177,146,138.66416372107184,0.423782175944683,0.9197156784556257,0.09426159577139925,17515259.563070502,288547.7639341309,17803807.327004634,4061,1,2635.628339140534,104,757,104,34.845769162683645,0.6404246794871795,38.4722222222222,133945.69182592415,1287.9393444800398,0
4063,512.4473949951021,0,0,861,0.0,0.0,1.0,861,21950,16100,5850,0.7334851936218679,278,161,117,136.12131006514582,0.42371729510484474,0.9186269165123002,0.0932104374709408,17557588.409373213,283842.3871736964,17841430.79654691,4062,2,2636.628339140534,112,749,102,34.66497341268444,0.6410900297619048,38.22824483775809,134144.25401618524,1197.7165537159397,0
4064,512.6513260399062,0,0,861,0.0,0.0,1.0,861,25450,19000,6450,0.7465618860510805,319,190,129,135.66030875440248,0.42395250925100614,0.9188009013855665,0.09320843266889828,17579649.545268398,279322.13702105434,17858971.68228945,4063,3,2637.628339140534,114,747,78,34.56321481276517,0.6418128654970761,38.11594202898548,134255.20958755058,1177.677277083777,0
4065,512.7818300999872,0,0,861,0.0,0.0,1.0,861,22050,15900,6150,0.7210884353741497,282,159,123,132.03581203268465,0.42381290008913375,0.9164576284219532,0.09106072828494713,17600947.105965924,270541.06873610406,17871488.174702026,4064,4,2638.628339140534,120,741,84,34.531241443513515,0.6419270833333333,37.99070247933882,134353.6070858552,1119.6133923821267,0
4066,512.6112886692582,1,0,862,0.001160092807424594,0.0,1.0,862,23250,16100,7150,0.6924731182795699,304,161,143,140.1116983404293,0.42390975192068797,0.9234570295852205,0.09629545549957381,17579603.152495444,296971.61076937214,17876574.763264816,4065,0,2636.566125290023,109,753,75,34.43662014270563,0.6429663608562691,38.106060606060566,134249.78976739358,1231.6494474072806,8
4067,512.3165790895084,1,0,863,0.0011587485515643105,0.0,1.0,863,23600,17600,6000,0.7457627118644068,296,176,120,138.8885639700835,0.4241746717103147,0.9229081897638844,0.09588459888141501,17589519.131528437,292396.6106204497,17881915.742148887,4066,0,2634.5098493626883,113,750,81,34.31739196131756,0.6436209439528023,37.95687134502919,134249.03924642387,1188.044595101096,0
4068,512.1348613128469,0,1,862,0.0,0.0011587485515643105,0.9988412514484357,863,26100,19400,6700,0.7432950191570882,328,194,134,138.80629546110967,0.4241122198234723,0.9231792841831303,0.09631555664900296,17605834.00521291,290060.11935335665,17895894.12456627,4067,1,2635.5098493626883,118,745,85,34.14920992600008,0.644332627118644,37.78886554621844,134287.46297816877,1138.0293472726166,0
4069,511.751792597433,1,0,863,0.0011587485515643105,0.0,1.0,863,23750,17600,6150,0.7410526315789474,299,176,123,139.40787618172533,0.42419718799597445,0.9233419679039283,0.0970674747693975,17607947.717560004,294587.3190447709,17902535.036604777,4068,0,2636.4484356894554,124,739,87,34.01798288806292,0.6444052419354839,37.67499999999996,134245.28899311923,1082.6232983316067,0
4070,511.4785449936645,0,0,863,0.0,0.0,1.0,863,22300,15000,7300,0.672645739910314,296,150,146,141.32845334644767,0.4241396090366256,0.9250468434187431,0.09871455969931868,17612427.03059152,302927.41438213305,17915354.444973655,4069,1,2637.4484356894554,130,733,88,33.862704400610056,0.6444711538461538,37.57156488549618,134226.51415733053,1032.511647364081,0
4071,511.77010409481363,0,0,863,0.0,0.0,1.0,863,24050,16900,7150,0.7027027027027027,312,169,143,140.58401232685787,0.424165149897971,0.9246633407877904,0.09850755069189274,17636498.712036334,299231.95046710846,17935730.662503444,4070,2,2638.4484356894554,94,769,94,33.776312492168934,0.6532579787234043,37.46710526315791,134356.48686778714,1429.3243283807142,0
4072,511.62870069913635,0,0,863,0.0,0.0,1.0,863,21800,15500,6300,0.7110091743119266,281,155,126,140.092645230487,0.4241993724117474,0.9239394803865624,0.09856518253716488,17649598.44038486,300115.786553883,17949714.226938743,4071,3,2639.4484356894554,99,764,99,33.6535665186125,0.6531986531986532,37.33333333333336,134387.8053836411,1357.4525796327384,0
4073,512.0871337527858,0,0,863,0.0,0.0,1.0,863,23050,16200,6850,0.702819956616052,299,162,137,157.88940934913623,0.4242698898337514,0.9304140752670023,0.10448827065672023,17391008.142274007,353521.20071393414,17744529.34298794,4072,4,2640.4484356894554,97,766,97,35.266485514634944,0.6330541237113403,39.38137755102042,133459.44337249795,1375.8705502319376,8
4074,512.1225755880185,0,0,863,0.0,0.0,1.0,863,24150,17100,7050,0.7080745341614907,312,171,141,161.53559227406936,0.4244597659740164,0.931447466497993,0.10446844277165498,17286362.35088256,361722.5561228024,17648084.907005362,4073,5,2641.4484356894554,101,762,74,35.97856562639204,0.6239686468646864,40.17565359477126,133061.91348152034,1317.444687935845,8
4075,511.9996153719419,0,0,863,0.0,0.0,1.0,863,21250,15100,6150,0.7105882352941176,274,151,123,162.15597209139287,0.424518857221208,0.9312107995898098,0.10529004856129415,17300708.334779102,367232.6355791549,17667940.970358256,4074,6,2642.4484356894554,107,756,77,35.821190281848644,0.6239291277258567,40.036651234567906,133101.13457870347,1243.9358371841445,0
4076,511.9311648657027,2,0,865,0.0023121387283236996,0.0,1.0,865,23700,17300,6400,0.729957805907173,301,173,128,161.1579665669984,0.4250221892171555,0.9311473878738115,0.10510954635258954,17318950.176524423,361517.3587047701,17680467.535229195,4075,0,2637.3364161849713,114,751,81,35.69024155262271,0.6239948830409356,39.88224637681161,133162.3846145695,1168.091093110259,0
4077,511.59159685725217,1,0,866,0.0011547344110854503,0.0,1.0,866,22650,15000,7650,0.6622516556291391,303,150,153,159.2754732287034,0.4253384940394345,0.9309879230078462,0.10431186628097436,17326452.335408546,356085.77901935676,17682538.1144279,4076,0,2635.2898383371826,119,747,86,35.594273230605054,0.6244747899159664,39.73958333333334,133147.0421612344,1118.8827072372637,0
4078,511.37882983620483,1,1,866,0.0011534025374855825,0.0011534025374855825,0.9988465974625144,867,25000,17400,7600,0.696,326,174,152,158.0942537254425,0.4255572004194514,0.9307915654984527,0.10385821832207257,17333390.272929616,349661.87994613586,17683052.15287575,4077,0,2633.249134948097,124,743,91,35.517085947168574,0.6246639784946236,39.633333333333354,133146.0013283545,1073.7580752286653,0
4079,511.44058433946117,0,0,866,0.0,0.0,1.0,866,24950,18800,6150,0.7535070140280561,311,188,123,157.2245819982214,0.4257285228299225,0.9301966560793498,0.10367119913133824,17352475.237569872,347497.1331722844,17699972.370742157,4078,1,2635.7113163972285,93,773,93,35.41015264956538,0.6329525089605734,39.50576241134753,133227.3250894036,1432.5518826817593,0
4080,511.6389909009179,1,0,867,0.0011534025374855825,0.0,1.0,867,25150,18400,6750,0.731610337972167,319,184,135,153.9864349274648,0.4258828990093524,0.929115441511086,0.10208760838447843,17383935.785973012,336828.0593379941,17720763.84531101,4079,0,2633.670126874279,98,769,98,35.30617221661621,0.6333971088435374,39.32028619528621,133373.90571938446,1360.958221626372,0
4081,511.5225603832782,2,0,869,0.0023014959723820483,0.0,1.0,869,21800,14600,7200,0.6697247706422018,290,146,144,180.7467478092345,0.4264986791145427,0.9378922880098988,0.11527986958026118,17201591.098305367,426226.32963258476,17627817.42793795,4080,0,2628.606444188723,113,756,83,35.97409156037861,0.616334808259587,40.661549707602305,132657.46809939673,1173.959894684927,8
4082,511.2257563333153,2,0,871,0.002296211251435132,0.0,1.0,871,26550,19600,6950,0.7382297551789078,335,196,139,183.44473844901214,0.42688722611522406,0.9384934788394987,0.11760321519912335,17215513.110565692,430869.0599666564,17646382.17053235,4081,0,2623.5683122847304,86,785,86,35.720588235294144,0.6253633720930232,40.48132183908048,132672.63252543914,1542.7050293655714,0
4083,510.8947223070967,3,0,874,0.003432494279176201,0.0,1.0,874,22750,16600,6150,0.7296703296703296,289,166,123,177.62451240884076,0.42753344683238054,0.9363506019052195,0.11467990364260171,17237122.99898202,414797.1136050826,17651920.1125871,4082,0,2615.559496567506,95,779,86,35.6203007518797,0.625,40.234375000000014,132712.88684930519,1396.9777563084756,0
4084,510.7150968873831,1,0,875,0.001142857142857143,0.0,1.0,875,24650,18200,6450,0.7383367139959433,311,182,129,181.55126662860127,0.42789757001198647,0.9370535289183113,0.11781200113561496,17254501.972502187,426865.3376306966,17681367.310132883,4083,0,2613.5691428571427,100,775,69,35.33847140665503,0.6254166666666667,40.05775577557757,132756.42844420028,1327.5642844420029,0
4085,510.4638454519986,2,1,876,0.002280501710376283,0.0011402508551881414,0.9988597491448119,877,24950,18400,6550,0.7374749498997996,315,184,131,188.84995392130514,0.42828237566145827,0.9391539496938128,0.12324598038139639,17272116.31637433,452017.67409414984,17724133.99046848,4084,0,2608.60661345496,104,773,74,34.948389393130505,0.6264022435897436,39.861111111111136,132791.49757383365,1276.8413228253235,0
4086,510.4041016009133,0,0,876,0.0,0.0,1.0,876,22650,16700,5950,0.7373068432671082,286,167,119,186.50278078583932,0.4281500869754294,0.9385411833539248,0.12226095720153586,17290637.60659426,447100.39903801214,17737738.005632274,4085,1,2612.5810502283107,109,767,80,34.85189210657162,0.626815749235474,39.70643939393941,132854.9009536402,1218.8523023269743,0
4087,510.47111364925286,0,0,876,0.0,0.0,1.0,876,23650,18200,5450,0.7695560253699789,291,182,109,187.94858705181352,0.4281964285714286,0.9393451423099521,0.12341438226221349,17300537.487619765,451472.3152070205,17752009.802826785,4086,2,2613.5810502283107,110,766,81,34.75576421679946,0.6271780303030303,39.64902402402405,132901.65264612786,1208.196842237526,0
4088,510.99573510882874,1,0,877,0.0011402508551881414,0.0,1.0,877,25350,18300,7050,0.7218934911242604,324,183,141,197.11404333176597,0.42840576182467904,0.9407341394990831,0.12770025566240667,17256378.147600465,479544.8939870988,17735923.041587565,4087,0,2611.599771949829,95,782,66,34.992319388195355,0.6262061403508772,40.11501736111114,132800.11774730566,1397.895976287428,8
4089,511.0738044357802,1,0,878,0.0011389521640091116,0.0,1.0,878,25450,18500,6950,0.7269155206286837,324,185,139,195.35380005709933,0.42865637302393317,0.9404461554360626,0.12692603327927712,17272337.249915816,473793.34352777514,17746130.59344359,4088,0,2609.624145785877,98,780,68,34.93581960689088,0.6263818027210885,40.014730639730665,132871.6607092152,1355.8332725430123,0
4090,511.4671635109972,0,0,878,0.0,0.0,1.0,878,23700,15700,8000,0.6624472573839663,317,157,160,194.20312284889053,0.4288382168450635,0.9403975796327382,0.12656000851370441,17299543.140529353,472625.0603499844,17772168.20087934,4089,1,2610.624145785877,101,777,68,34.85910423538038,0.6266501650165017,39.910130718954264,133027.4276991232,1317.1032445457743,0
4091,511.19292782284947,0,0,878,0.0,0.0,1.0,878,24150,18000,6150,0.7453416149068323,303,180,123,195.40040600982675,0.42887357912362584,0.9411752701049134,0.1278142805395963,17307341.305808168,476622.3036211201,17783963.60942929,4090,2,2611.624145785877,104,774,72,34.69707078408948,0.6272035256410257,39.78174603174606,133021.73111898312,1279.0551069132994,0
4092,510.82441376421275,1,0,879,0.0011376564277588168,0.0,1.0,879,25000,18400,6600,0.736,316,184,132,194.9991857830794,0.42901449324187163,0.941420763865157,0.1280827210059843,17313891.921845246,474438.9654992153,17788330.88734446,4091,0,2609.6518771331057,112,767,78,34.561617806731824,0.6268601190476191,39.63864306784662,132998.937521723,1187.4905135868125,0
4093,510.44068407271465,0,0,879,0.0,0.0,1.0,879,23150,16900,6250,0.7300215982721382,294,169,125,197.76043975424773,0.42909013184548256,0.9426252782843108,0.13025177841765068,17313365.917967696,485829.771512695,17799195.68948039,4092,1,2610.6518771331057,80,799,80,34.39397866982669,0.637109375,39.54475308641973,132946.95440489487,1661.836930061186,0
4094,510.49679479056795,1,1,879,0.0011363636363636363,0.0011363636363636363,0.9988636363636364,880,24350,17400,6950,0.7145790554414785,313,174,139,197.49642965792341,0.4291950811442066,0.9409801136363634,0.1306514842352413,17335327.33825083,484383.05125118454,17819710.389502015,4093,0,2608.684090909091,87,793,87,34.24706274224805,0.6360153256704981,39.393939393939384,133038.5586423901,1529.1788349700012,0
4095,510.64496014878387,0,1,878,0.0,0.0011376564277588168,0.9988623435722411,879,23600,17000,6600,0.7203389830508474,302,170,132,190.38532965420922,0.4292234847012421,0.9375413547881297,0.12639774182867303,17356602.20106128,461488.4863452088,17818090.687406488,4094,1,2612.641638225256,96,783,88,34.30802682702474,0.6344401041666667,39.27190721649486,133139.4865491022,1386.869651553148,0
4096,511.0461468152404,2,0,880,0.0022727272727272726,0.0,1.0,880,24950,17800,7150,0.7134268537074149,321,178,143,186.2847516257043,0.4292836104216224,0.9363778981525082,0.12454835010540799,17402159.016404912,447401.37402440305,17849560.390429314,4095,0,2610.5761363636366,103,777,70,34.171024435488995,0.6350121359223301,39.032451923076934,133366.4598885332,1294.819998917798,0
4097,511.556451263307,1,1,880,0.0011350737797956867,0.0011350737797956867,0.9988649262202043,881,27050,20500,6550,0.7578558225508318,336,205,131,188.05863033973932,0.4296041430192963,0.9369619471538393,0.12634893907750333,17441605.64476583,452758.8936961059,17894364.53846194,4096,0,2608.61180476731,111,770,75,33.95635959444858,0.6348536036036037,38.8671875,133584.1748709066,1203.4610348730325,0
4098,511.3704260349916,0,0,880,0.0,0.0,1.0,880,24550,17800,6750,0.725050916496945,313,178,135,190.16567146057997,0.4295924259661461,0.9381418000604056,0.12834050921442725,17455554.338317223,463339.44229254604,17918893.780609768,4097,1,2612.572727272727,113,767,80,33.746539313399815,0.6359697640117994,38.71527777777778,133613.27971921224,1182.4184045947986,0
4099,511.6811253140419,0,0,880,0.0,0.0,1.0,880,24250,16900,7350,0.6969072164948453,316,169,147,189.75166509803276,0.4297309431775089,0.9382051272040097,0.12834585667390733,17476166.119304832,462976.32413358265,17939142.443438414,4098,2,2613.572727272727,115,765,83,33.68110433487945,0.636322463768116,38.640445402298845,133732.75100812822,1162.893487027202,0
4100,511.8590803997462,0,0,880,0.0,0.0,1.0,880,24650,18300,6350,0.742393509127789,310,183,127,190.40762630508286,0.42972418295583825,0.9382661601854234,0.12925748478018073,17498559.163108837,465721.8228013192,17964280.985910155,4099,3,2614.572727272727,89,791,89,33.539711697355955,0.6441947565543071,38.518518518518505,133841.6706526738,1503.8389960974587,0
4101,511.81403150411114,0,0,880,0.0,0.0,1.0,880,26400,19200,7200,0.7272727272727273,336,192,144,195.0776622001687,0.4297038753576723,0.9389388768228362,0.13292501168523072,17513840.398037415,480911.8081991995,17994752.206236616,4100,4,2615.572727272727,90,790,90,33.28948615851345,0.6451388888888889,38.39285714285713,133894.2064559857,1487.7134050665077,0
4102,511.9040830685453,0,0,880,0.0,0.0,1.0,880,23450,16100,7350,0.6865671641791045,308,161,147,190.08378229091835,0.4296564191402075,0.9369045914291314,0.13012432360913934,17537686.6179975,467275.96099635144,18004962.578993853,4101,5,2616.572727272727,95,785,89,33.26217321616089,0.6451754385964912,38.23784722222219,133997.1147997554,1410.495945260583,0
4103,512.1472710190894,1,2,879,0.0011350737797956867,0.0022701475595913734,0.9977298524404086,881,22900,16500,6400,0.7205240174672489,293,165,128,191.41937448040647,0.42982535342069966,0.9377453373112814,0.1314997739840686,17561714.29055937,473230.4728604931,18034944.763419863,4102,0,2614.6015891032916,98,783,68,33.1079158128758,0.6455144557823129,38.120791245791224,134120.72210010546,1368.5787969398516,0
4104,512.2806386232983,0,0,879,0.0,0.0,1.0,879,25550,19000,6550,0.7436399217221135,321,190,131,188.37194382159413,0.42967969183936666,0.9365306865471696,0.12989891368323137,17583230.441654425,461087.4593914893,18044317.901045915,4103,7,2621.401592718999,98,781,76,33.05908062594541,0.6467899659863945,37.9945286195286,134220.3302015852,1369.5952061386245,0
4105,511.89295188610487,0,0,879,0.0,0.0,1.0,879,22000,15700,6300,0.7136363636363636,283,157,126,188.0291428130415,0.42956194180762114,0.9365068110777726,0.13014566159412388,17586456.584347624,463553.27133472555,18050009.85568235,4104,8,2622.401592718999,100,779,80,32.94250340992548,0.6475,37.87128712871285,134181.84060578735,1341.8184060578735,0
4106,512.302718862576,0,0,879,0.0,0.0,1.0,879,26150,18400,7750,0.7036328871892925,339,184,155,195.81964580990075,0.4295777605876769,0.9382005871716814,0.13620825086997934,17622424.17355474,488213.371995457,18110637.545550197,4105,9,2623.401592718999,104,775,83,32.57214720677785,0.6481370192307692,37.70833333333331,134372.73396832842,1292.0455189262348,0
4107,512.7519922601375,0,0,879,0.0,0.0,1.0,879,25400,18800,6600,0.7401574803149606,320,188,132,201.36614007305667,0.42946028050098345,0.939955152593269,0.1404243681916614,17649190.668824017,509589.8800788915,18158780.54890291,4106,10,2624.401592718999,108,771,84,32.340875978874436,0.6480516975308642,37.624235474006085,134533.6959814784,1245.6823701988742,0
4108,512.9086636625585,0,1,878,0.0,0.0011376564277588168,0.9988623435722411,879,25450,19700,5750,0.7740667976424361,312,197,115,201.24716553287914,0.42935068280981264,0.940453617928019,0.14087301587301582,17671306.30274914,510010.0609383151,18181316.363687452,4107,11,2625.401592718999,96,783,88,32.217261904761884,0.65234375,37.50000000000001,134638.52421142202,1402.4846272023126,0
4109,513.0640912079177,0,0,878,0.0,0.0,1.0,878,23350,15900,7450,0.6809421841541756,308,159,149,200.42262566694706,0.42921781345426746,0.9405726842861137,0.14108277342960518,17701336.41535271,510599.66443579155,18211936.079788502,4108,12,2629.3473804100227,90,788,90,32.05208514903263,0.6560185185185186,37.31684981684984,134773.29172435185,1497.481019159465,0
4110,513.0845864539509,2,1,879,0.0022727272727272726,0.0011363636363636363,0.9988636363636364,880,24600,17200,7400,0.6991869918699187,320,172,148,198.25417957287758,0.4291743964818837,0.9390927192037661,0.14042494330285515,17729315.230649758,502382.16908828064,18231697.39973804,4109,0,2624.369318181818,99,781,84,31.9027700730409,0.6554082491582491,37.11458333333334,134882.45529519176,1362.4490433857754,0
4111,512.6469855904252,0,1,878,0.0,0.0011376564277588168,0.9988623435722411,879,23850,17000,6850,0.7127882599580713,307,170,137,202.48939563919004,0.4291184760759578,0.9405479157721319,0.14404661383435635,17733130.489810158,518504.1751345129,18251634.66494467,4110,1,2627.9556313993176,102,777,67,31.64811468266178,0.6560457516339869,36.97411003236247,134839.42962414862,1321.955192393614,0
4112,512.9756352420933,0,0,878,0.0,0.0,1.0,878,24400,18800,5600,0.7704918032786885,300,188,112,199.64282744649572,0.4289323719555432,0.9402687492598973,0.14263197639841732,17763230.561363887,509260.3147709436,18272490.87613483,4111,2,2631.9476082004558,104,774,72,31.58142332968929,0.6569511217948718,36.83531746031748,134997.07019907868,1298.048751914218,0
4113,513.3381167157281,0,0,878,0.0,0.0,1.0,878,24350,17300,7050,0.7104722792607803,314,173,141,195.38462436107093,0.4288794232339315,0.938947851774341,0.140169033168954,17793835.990078133,495378.39217279013,18289214.382250924,4112,3,2632.9476082004558,106,772,79,31.557269713327944,0.6578223270440251,36.70171339563865,135161.04657996199,1275.1042130185092,0
4114,513.670479652017,0,0,878,0.0,0.0,1.0,878,24000,17400,6600,0.725,306,174,132,195.98517223927,0.4287356472979864,0.9398949407825932,0.1412098292288089,17824190.07296047,499055.3922949369,18323245.465255406,4113,4,2633.9476082004558,109,769,82,31.39951561882169,0.6585435779816513,36.56250000000003,135320.06698332977,1241.4685044342182,0
4115,513.9108279818785,1,0,879,0.0011376564277588168,0.0,1.0,879,22900,16100,6800,0.7030567685589519,297,161,136,161.8589955883717,0.42861141129000907,0.9300834793889761,0.11588171403240534,17804814.03264288,377673.8631922673,18182487.895835146,4114,0,2631.9499431171785,117,762,82,32.506644253663794,0.6548254985754987,36.76730225988702,135278.13364752577,1156.2233645087672,8
4116,513.9355178859435,0,0,879,0.0,0.0,1.0,879,25500,18200,7300,0.7137254901960784,328,182,146,164.49722205474689,0.4285188741261339,0.9310942186368816,0.11823608993176882,17822866.990677927,385062.42180355144,18207929.41248148,4115,1,2632.9499431171785,125,754,86,32.30801628160053,0.6546666666666667,36.64021164021163,135349.94922101972,1082.7995937681578,0
4117,514.1439550931474,0,0,879,0.0,0.0,1.0,879,23800,16500,7300,0.6932773109243697,311,165,146,178.01013665849894,0.4284673686101847,0.9335469989451748,0.12746846416365287,17813694.63020483,434603.64310311276,18248298.27330794,4116,2,2633.9499431171785,109,770,79,32.07544907307477,0.6565366972477065,36.76136363636366,135342.55363332832,1241.674803975489,8
4118,514.4431287644019,0,0,879,0.0,0.0,1.0,879,25450,18000,7450,0.7072691552062869,329,180,149,177.36113885916706,0.4283874648747498,0.9333036250555502,0.1274134022745891,17838113.58586894,431507.62813778635,18269621.214006726,4117,3,2634.9499431171785,114,765,83,31.98693805248855,0.6565241228070176,36.6576086956522,135474.6837189097,1188.3744185869273,0
4119,514.3768645635905,0,0,879,0.0,0.0,1.0,879,24100,16900,7200,0.7012448132780082,313,169,144,179.57572213481126,0.4281802010637131,0.9345203109499272,0.12931667925730866,17846348.928052746,441054.19924497814,18287403.127297726,4118,4,2635.9499431171785,119,760,84,31.84947494452869,0.6563375350140056,36.579861111111114,135497.22510457234,1138.632143735902,0
4120,514.6570701081712,1,0,880,0.0011363636363636363,0.0,1.0,880,23400,16100,7300,0.688034188034188,307,161,146,178.81916256892038,0.4282974799186403,0.9343119134554443,0.12913245213273944,17868236.34560834,439636.61198104103,18307872.95758938,4119,0,2633.953409090909,130,750,89,31.778078698814085,0.6553685897435897,36.4901399491094,135617.21251840456,1043.2093270646506,0
4121,514.0852129734533,0,0,880,0.0,0.0,1.0,880,25550,19300,6250,0.7553816046966731,318,193,125,176.089098483839,0.42814678892163965,0.9332664734273679,0.1275962096811459,17863202.265852347,427553.0366056775,18290755.302458026,4120,1,2634.953409090909,93,787,93,31.73871502234926,0.6645385304659498,36.3807624113475,135522.75189966083,1457.2338913942024,0
4122,513.6178421660104,0,1,879,0.0,0.0011363636363636363,0.9988636363636364,880,25700,19400,6300,0.754863813229572,320,194,126,175.439241355042,0.42799359314131075,0.9331999684979388,0.1278347355240571,17871008.001237355,425355.2171973855,18296363.21843474,4121,2,2635.953409090909,97,783,97,31.575200795121834,0.6651632302405499,36.203231292516975,135490.72711390202,1396.8116197309487,0
4123,513.4380010857088,1,1,879,0.0011363636363636363,0.0011363636363636363,0.9988636363636364,880,23650,17000,6650,0.718816067653277,303,170,133,170.07831476885985,0.42797950710173405,0.9303537263459978,0.12462847113544595,17888993.052987065,408855.95827277313,18297849.01125984,4122,0,2636.9443181818183,107,773,68,31.534651430450477,0.6644275700934579,36.02430555555554,135535.15289076685,1266.6836718763257,0
4124,513.7500870670968,0,0,879,0.0,0.0,1.0,879,24050,17100,6950,0.7110187110187111,310,171,139,173.27691480624262,0.4279151690115173,0.9318121308159031,0.1272820524993419,17910332.468224306,420839.4306495928,18331171.8988739,4123,4,2640.94425483504,107,772,70,31.371718656779986,0.6652063862928349,35.94714506172838,135657.1772148516,1267.8240861201084,0
4125,513.9112769096504,0,0,879,0.0,0.0,1.0,879,25750,18700,7050,0.7262135922330097,328,187,141,172.21433566103474,0.42765969301416756,0.9311705465862463,0.126980072897122,17932143.70784756,416084.4431250311,18348228.150972594,4124,5,2641.94425483504,113,766,73,31.278427761059802,0.6650995575221239,35.82785087719297,135761.04647966774,1201.4251900855552,0
4126,514.2824206047255,0,0,879,0.0,0.0,1.0,879,26250,19300,6950,0.7352380952380952,332,193,139,171.8234967342751,0.42755166100429925,0.9316463447510475,0.1272462853257708,17963783.21978666,415270.00948004564,18379053.229266703,4125,6,2642.94425483504,117,762,78,31.148863598410173,0.6656873219373219,35.69032485875705,135929.81952088658,1161.7933292383468,0
4127,513.8829839752383,0,0,879,0.0,0.0,1.0,879,23500,17400,6100,0.7404255319148936,296,174,122,172.29280911699195,0.42734526101742937,0.9323276994177265,0.12808229232725024,17966129.464877624,419786.9828926653,18385916.44777029,4126,7,2643.94425483504,121,758,82,31.014422559466162,0.6661501377410468,35.57035519125683,135885.89492582934,1123.0239250068541,0
4128,513.6386362554802,0,0,879,0.0,0.0,1.0,879,23600,16700,6900,0.7076271186440678,305,167,138,170.65016812163861,0.42716240023910657,0.9321102777347383,0.127453017444207,17977378.00851974,414168.51590803,18391546.524427768,4127,8,2644.94425483504,129,750,89,30.909697194544542,0.6662629198966408,35.42467948717949,135896.10681506185,1053.4581923648207,0
4129,513.2202208194261,0,0,879,0.0,0.0,1.0,879,23950,16300,7650,0.6805845511482255,316,163,153,166.9788265879527,0.42695519041708024,0.9302868930107282,0.12530859527118604,17982980.93099392,400805.4108821752,18383786.341876093,4128,9,2645.94425483504,95,784,95,30.855270798322202,0.675109649122807,35.27560763888887,135861.91110385698,1430.1253800405998,0
4130,513.3823157787018,0,0,879,0.0,0.0,1.0,879,24800,18000,6800,0.7258064516129032,316,180,136,164.74848211536667,0.4266691026508172,0.9292124243018587,0.12402726268341527,18002053.07751656,392562.18389621866,18394615.261412777,4129,10,2646.94425483504,99,780,99,30.814165978313536,0.6749789562289562,35.17708333333331,135955.4022296023,1373.2868912081042,0
4131,513.0796550285171,0,0,879,0.0,0.0,1.0,879,24950,17600,7350,0.7054108216432866,323,176,147,161.90500611239142,0.42662812499190167,0.9273165084912738,0.12234960648662904,18007417.07538173,382348.1943316037,18389765.269713335,4130,11,2647.94425483504,104,775,92,30.770004867819942,0.6748798076923077,35.059523809523775,135935.5681268987,1307.072770450949,0
4132,513.097968433753,0,0,879,0.0,0.0,1.0,879,25850,18500,7350,0.7156673114119922,332,185,147,163.5746705180361,0.42657165248699297,0.9315199403999022,0.11403579515020229,17659764.09241789,376088.01856870006,18035852.110986587,4131,12,2648.94425483504,131,748,86,33.34251335960135,0.6436863867684479,37.63415404040404,134619.3825482717,1027.6288744142878,8
4133,513.2835516663641,0,0,879,0.0,0.0,1.0,879,24200,17500,6700,0.7231404958677686,309,175,134,161.94234025215337,0.4265335362456301,0.9315493371083365,0.11327911992156509,17681080.31966196,372663.10503046913,18053743.42469243,4132,13,2649.94425483504,133,746,92,33.272712127943066,0.6445018796992481,37.52332089552238,134724.96208033848,1012.9696397017931,0
4134,513.4073985416911,0,0,879,0.0,0.0,1.0,879,23000,16200,6800,0.7043478260869566,298,162,136,159.74800064718826,0.42652700357536827,0.9304293012164164,0.11225535180613325,17705509.71401828,366883.955450764,18072393.669469047,4133,14,2650.94425483504,98,781,98,33.178335336538474,0.653061224489796,37.3737373737374,134834.26628367772,1375.8598600375278,0
4135,512.925665763997,1,0,880,0.0011363636363636363,0.0,1.0,880,23000,16000,7000,0.6956521739130435,300,160,140,149.6667501597299,0.4263534448581377,0.9269097364868837,0.10433564176301424,17653652.479873568,329432.95902237727,17983085.438895945,4134,0,2648.9306818181817,122,758,92,33.708777168065374,0.6451502732240437,37.63550135501351,134573.48514031444,1103.0613536091348,8
4136,512.947913812795,0,0,880,0.0,0.0,1.0,880,24300,16700,7600,0.6872427983539094,319,167,152,152.65305262966444,0.42621595110662946,0.9287937978327021,0.10692712104827554,17675550.65355925,339345.3528352219,18014896.006394472,4135,1,2649.9306818181817,96,784,96,33.47105184215554,0.6525607638888888,37.47852233676979,134659.84429840773,1402.706711441747,0
4137,512.8043550593129,0,0,880,0.0,0.0,1.0,880,25800,19100,6700,0.7403100775193798,325,191,134,155.21440889080856,0.42618179986727345,0.9299677210988748,0.10940597266420826,17698268.703053884,347605.2630270457,18045873.96608093,4136,2,2650.9306818181817,100,780,100,33.195202297767686,0.6535416666666667,37.273102310231046,134727.4973265372,1347.2749732653722,0
4138,513.1772980506663,0,1,879,0.0,0.0011363636363636363,0.9988636363636364,880,24400,18300,6100,0.75,305,183,122,153.30736667296662,0.4260103434084876,0.9293065676194743,0.10834915794752278,17722819.62693608,343007.76140511205,18065827.388341192,4137,3,2651.9306818181817,102,778,94,33.157363938379454,0.6539011437908497,37.18648867313918,134869.92763392773,1322.2541924894874,0
4139,513.2915481721797,0,0,879,0.0,0.0,1.0,879,25800,19100,6700,0.7403100775193798,325,191,134,153.3721249720504,0.4258559741647468,0.9286363176708674,0.10873265941776745,17740423.365398396,342577.2858909981,18083000.651289392,4138,4,2655.8168373151307,107,772,91,33.05288314562776,0.6537188473520249,37.085262345679034,134951.91272787013,1261.2328292324312,0
4140,513.2873748533973,1,0,880,0.0011363636363636363,0.0,1.0,880,24900,18400,6500,0.7389558232931727,314,184,130,158.70715233736843,0.4257529971213845,0.9314229004543204,0.11333821726990291,17772182.876871835,363214.50704146095,18135397.383913297,4139,0,2653.797727272727,111,769,78,32.67256308758043,0.6552177177177176,36.848958333333364,135072.107367022,1216.8658321353332,0
4141,512.9090471655312,0,0,880,0.0,0.0,1.0,880,23900,16600,7300,0.694560669456067,312,166,146,162.91766336277297,0.42563080140138587,0.9326289587682408,0.1167267358365372,17773356.370937146,379218.7380133944,18152575.10895054,4140,1,2654.797727272727,116,764,80,32.45431589389789,0.6552622126436782,36.743233618233646,135026.77720475232,1164.0239414202786,0
4142,512.7235880324724,0,0,880,0.0,0.0,1.0,880,24500,18100,6400,0.7387755102040816,309,181,128,167.2939443853137,0.4255448577067604,0.934388529022864,0.12034700748809553,17784473.41034549,394546.94112649,18179020.351471983,4141,2,2655.797727272727,120,760,82,32.20699188320535,0.6558159722222222,36.6132920110193,135044.5779601721,1125.371483001434,0
4143,512.7315107863215,0,1,879,0.0,0.0011363636363636363,0.9988636363636364,880,26300,18700,7600,0.7110266159695817,339,187,152,165.14986246342755,0.42540119626297096,0.9339464630613228,0.11917260110165769,17798160.49112061,385572.75144211453,18183733.242562726,4142,3,2656.797727272727,130,750,87,32.16252716079185,0.6551282051282051,36.51399491094147,135097.57746036502,1039.2121343105002,0
4144,513.0126744105193,0,0,879,0.0,0.0,1.0,879,23300,17300,6000,0.7424892703862661,293,173,120,162.90023420261946,0.4251840809299585,0.9331686189755939,0.11791852388465843,17821502.900595646,381525.3992699387,18203028.299865585,4143,4,2658.580204778157,92,787,92,32.119700703975965,0.6645153985507246,36.41353046594982,135223.19967408993,1469.8173877618472,0
4145,512.9145086307468,0,0,879,0.0,0.0,1.0,879,24700,17300,7400,0.7004048582995951,321,173,148,158.83489632906543,0.42505472326097077,0.9312175502926254,0.11552831772926225,17838799.316416625,366184.7680116092,18204984.084428236,4144,5,2659.580204778157,99,780,99,32.07131172900461,0.6640361952861953,36.26041666666668,135275.8587918951,1366.4228160797484,0
4146,512.37669371876,0,1,878,0.0,0.0011376564277588168,0.9988623435722411,879,25900,19600,6300,0.7567567567567568,322,196,126,162.30455506718576,0.425006295118616,0.9336155102245713,0.11369250659471271,17656057.596915405,371431.7145016016,18027489.311417006,4145,6,2660.580204778157,90,789,90,33.21624008023024,0.6543981481481482,37.477106227106276,134510.61233683876,1494.5623592982085,8
4147,512.7620653437068,0,0,878,0.0,0.0,1.0,878,24200,17000,7200,0.7024793388429752,314,170,144,160.0376111680891,0.4249405740561329,0.9318902365559982,0.11257299771063733,17687722.515840795,366340.1716878428,18054062.687528636,4146,7,2664.1093394077448,97,781,97,33.13702231125138,0.6536726804123711,37.340561224489825,134681.796308551,1388.4721268922785,0
4148,512.6817074420161,0,0,878,0.0,0.0,1.0,878,24200,16900,7300,0.6983471074380165,315,169,146,158.96278399003853,0.42476665766240784,0.9312852939523899,0.1123460937598359,17705704.171908602,363109.6055341317,18068813.777442735,4147,8,2665.1093394077448,102,776,93,33.0087319300676,0.6539011437908497,37.18648867313918,134739.67972588778,1320.977252214586,0
4149,512.2010954733422,0,0,878,0.0,0.0,1.0,878,25950,19500,6450,0.7514450867052023,324,195,129,159.86972296340548,0.42467723736351837,0.9319642322384625,0.11348859624085594,17708501.46399137,364660.6446290756,18073162.108620446,4148,9,2666.1093394077448,106,772,68,32.83855034368712,0.6543828616352201,37.04244548286606,134687.14748666793,1270.633466855358,0
4150,512.0637123103817,1,0,879,0.0011376564277588168,0.0,1.0,879,23350,16700,6650,0.715203426124197,300,167,133,159.50565980023293,0.4245726553868507,0.9325262670887038,0.11405074112087313,17735249.38690521,366624.5310359995,18101873.91794121,4149,0,2664.075085324232,112,767,75,32.61057697920678,0.6554129464285714,36.80862831858408,134770.75083124771,1203.3102752789976,0
4151,512.1784346763144,0,0,879,0.0,0.0,1.0,879,25950,19400,6550,0.7475915221579962,325,194,131,158.46715447628455,0.42443341772895443,0.9323766807513807,0.11371938089950184,17754973.446667742,360966.0239790889,18115939.470646832,4150,1,2665.075085324232,115,764,81,32.51924038833186,0.6559782608695652,36.6918103448276,134860.77641504127,1172.7024036090545,0
4152,512.4408411208763,0,1,878,0.0,0.0011376564277588168,0.9988623435722411,879,25900,19400,6500,0.749034749034749,324,194,130,159.1533652675057,0.4243897406195174,0.9330197311979518,0.11463765855338287,17780222.20223815,364256.4397380466,18144478.641976196,4151,2,2666.075085324232,118,761,85,32.37958563168736,0.6566031073446328,36.572128851540626,134991.19986599896,1143.993219203381,0
4153,512.2148643302959,0,0,878,0.0,0.0,1.0,878,24300,17100,7200,0.7037037037037037,315,171,144,160.4706954035398,0.4242442050235106,0.9338115015415251,0.1162073159877766,17795552.17056832,371232.92638020637,18166785.096948527,4152,3,2669.7870159453305,89,789,89,32.170462861324545,0.6656132958801498,36.400462962962926,135019.60110095303,1517.0741696736295,0
4154,512.0197745103617,0,1,877,0.0,0.0011389521640091116,0.9988610478359908,878,24100,16800,7300,0.6970954356846473,314,168,146,160.2591183893968,0.4240206948603864,0.9337404788693267,0.11671011819686529,17813063.53535592,371241.17159808136,18184304.706954002,4153,4,2670.7870159453305,91,787,91,31.99325556938657,0.6667811355311355,36.22056159420285,135060.2885730038,1484.178995307734,0
4155,512.0919953174774,0,0,877,0.0,0.0,1.0,877,26150,19100,7050,0.7304015296367112,332,191,141,159.40908854025375,0.42376985893517577,0.9334072142715275,0.11639649822851679,17826869.62767256,366803.0077746349,18193672.635447197,4154,5,2674.726339794755,93,784,92,31.930751543404238,0.667002688172043,36.13696808510634,135122.14650381517,1452.9263064926363,0
4156,512.5059444020204,0,0,877,0.0,0.0,1.0,877,23300,16600,6700,0.7124463519313304,300,166,134,155.11336698075172,0.42364446605193784,0.9311558852225856,0.11355469129911447,17852444.558761723,355130.5568693363,18207575.11563106,4155,6,2675.726339794755,97,780,90,31.96027303479381,0.6666666666666667,36.054421768707435,135273.67784216354,1394.57399837282,0
4157,512.196619138756,0,1,876,0.0,0.0011402508551881414,0.9988597491448119,877,25100,18800,6300,0.749003984063745,314,188,126,150.13356996624697,0.42352764240553015,0.9287022094225439,0.11035047594535971,17858834.740735054,335742.1230127505,18194576.863747805,4156,7,2676.726339794755,103,774,79,31.96286901826919,0.6663632686084142,35.92748397435894,135257.04991579652,1313.1752419009372,0
4158,512.4187142719186,0,0,876,0.0,0.0,1.0,876,24350,18000,6350,0.7392197125256673,307,180,127,148.37141093837562,0.42322972385301155,0.9278703756864961,0.10952408766541656,17884910.68416074,331171.8865431458,18216082.570703886,4157,8,2680.6198630136987,110,766,81,31.871951291705084,0.6660984848484848,35.79204204204201,135385.10211722442,1230.773655611131,0
4159,511.94244028120534,0,0,876,0.0,0.0,1.0,876,25650,18000,7650,0.7017543859649122,333,180,153,146.24365757505154,0.4231587845183736,0.9267961812955638,0.1083560756113225,17884141.133498095,322238.44239023625,18206379.575888332,4158,9,2681.6198630136987,116,760,86,31.809269987761986,0.6660380747126438,35.67485754985754,135319.25845360276,1166.5453314965755,0
4160,511.47092215733824,0,0,876,0.0,0.0,1.0,876,24100,17500,6600,0.7261410788381742,307,175,132,147.39860788247108,0.42294053055011954,0.9275950962302526,0.10963956478651833,17884259.98519541,327923.004965197,18212182.990160607,4159,10,2682.6198630136987,122,754,89,31.65424379256603,0.6661543715846995,35.55216802168022,135257.37648446002,1108.6670203644264,0
4161,511.1580702937611,0,0,876,0.0,0.0,1.0,876,24950,17500,7450,0.7014028056112225,324,175,149,151.1285347324148,0.42275600674059577,0.9294147930823273,0.11287249696038483,17890541.143489335,340604.2537171073,18231145.39720644,4160,11,2683.6198630136987,127,749,91,31.426318528087933,0.6665846456692913,35.42480468750001,135239.74628353294,1064.8798919963224,0
4162,511.11606696936053,0,0,876,0.0,0.0,1.0,876,25650,19200,6450,0.7485380116959064,321,192,129,150.54984833041664,0.42261711785170686,0.9291966466664425,0.11282591707072065,17903519.366938613,338224.4250546545,18241743.791993268,4161,12,2684.6198630136987,94,782,94,31.333198696438664,0.6749778368794326,35.317982456140335,135283.2318045322,1439.1833170694915,0
4163,511.27584330061916,0,0,876,0.0,0.0,1.0,876,23950,17300,6650,0.7223382045929019,306,173,133,155.8976800241011,0.4225017938682322,0.9300608600117188,0.11266399100638073,17754066.61916225,354413.55938414665,18108480.178546395,4162,13,2685.6198630136987,131,745,94,32.357794330488616,0.655454834605598,36.46622474747475,134738.45318043063,1028.5378105376385,8
4164,511.2734099789984,0,0,876,0.0,0.0,1.0,876,23400,17700,5700,0.7564102564102564,291,177,114,155.61728026639693,0.42244107414655363,0.9295500533525229,0.11297623270613151,17773668.955900252,354578.0046544987,18128246.96055475,4163,14,2686.6198630136987,97,779,97,32.21683899705728,0.6639819587628866,36.320153061224495,134812.4944871283,1389.819530795137,0
4165,511.5094520135281,0,1,875,0.0,0.001141552511415525,0.9988584474885844,876,25400,17600,7800,0.6929133858267716,332,176,156,156.7151104916698,0.42227421722113506,0.9290793597915339,0.11416412364128378,17796625.476011477,357200.02557040594,18153825.501581885,4164,15,2687.6198630136987,100,776,100,32.076833352882126,0.6642708333333334,36.21080858085811,134930.6647498982,1349.3066474989819,0
4166,511.32009805534364,0,0,875,0.0,0.0,1.0,875,25450,18000,7450,0.7072691552062869,329,180,149,161.40090519895236,0.42215473466274384,0.9303878991596639,0.1180709009437094,17807992.42640554,374395.2194795913,18182387.645885132,4165,16,2691.4685714285715,103,772,92,31.817994939911433,0.664846278317152,36.07772435897437,134948.76385975935,1310.1821733957217,0
4167,511.74904368789703,0,0,875,0.0,0.0,1.0,875,23350,16200,7150,0.6937901498929336,305,162,143,163.12137470576607,0.42203612291598563,0.9304473574350853,0.1197856961895135,17839268.882009227,383643.2127558297,18222912.094765056,4166,17,2692.4685714285715,107,768,72,31.649680985778325,0.6651090342679128,35.9567901234568,135123.8601466041,1262.8398144542439,0
4168,512.1549145442349,0,0,875,0.0,0.0,1.0,875,22900,16700,6200,0.7292576419213974,291,167,124,162.91726589971682,0.4218388362209873,0.9303967312133585,0.11994000650660622,17864276.46351747,384179.8157425899,18248456.279260058,4167,18,2693.4685714285715,110,765,75,31.573473677977134,0.6652462121212122,35.876501501501515,135272.1478026237,1229.7467982056698,0
4169,512.0155048773837,0,1,874,0.0,0.001142857142857143,0.9988571428571429,875,23500,16400,7100,0.6978723404255319,306,164,142,162.01434293435963,0.4217307398932113,0.9295279645942927,0.11966888096527518,17873471.82015248,380651.75857956114,18254123.57873204,4168,19,2694.4685714285715,119,756,78,31.491706089775167,0.6644782913165266,35.77256944444445,135288.5412583571,1136.8784979693874,0
4170,511.82374880540317,0,0,874,0.0,0.0,1.0,874,23700,16800,6900,0.7088607594936709,306,168,138,160.84835836831664,0.42160508207492686,0.9283279412925114,0.11916867426557821,17879693.658211578,376683.8746103498,18256377.532821927,4169,20,2698.453089244851,131,743,80,31.425492610837424,0.6634064885496183,35.67708333333334,135286.74610351224,1032.7232526985667,0
4171,511.52777568878275,0,0,874,0.0,0.0,1.0,874,23400,16200,7200,0.6923076923076923,306,162,144,162.05182944040445,0.42157829643085254,0.9297589007471274,0.12046672874018796,17883702.257918693,381417.3336126443,18265119.591531336,4170,21,2699.453089244851,134,740,84,31.285867133547313,0.664023631840796,35.57098765432099,135262.78451276702,1009.4237650206494,0
4172,511.1140047850378,0,0,874,0.0,0.0,1.0,874,24300,18100,6200,0.7448559670781894,305,181,124,161.24911052308397,0.4214049952250016,0.9301966092677856,0.12019917090181124,17880846.521057718,377554.11938406364,18258400.640441783,4171,22,2700.453089244851,136,738,89,31.219818045934055,0.6645986519607843,35.48509732360096,135197.27123225795,994.097582590132,0
4173,510.864689976376,0,0,874,0.0,0.0,1.0,874,22650,16000,6650,0.7064017660044151,293,160,133,163.74762540993618,0.4212878865324075,0.9316135325533528,0.1226303578814648,17891748.906336676,388496.2795686873,18280245.185905363,4172,23,2701.453089244851,94,780,94,31.006166190219695,0.6747562056737588,35.33991228070174,135205.49366183908,1438.3563155514796,0
4174,511.21299552866174,0,0,874,0.0,0.0,1.0,874,24550,17700,6850,0.7209775967413442,314,177,137,162.58240237301953,0.42123431524425886,0.931039714213989,0.1223965773032052,17925984.58609584,383539.9277818302,18309524.51387767,4173,24,2702.453089244851,99,775,99,30.871528733823688,0.6749789562289562,35.17708333333331,135380.9165138025,1367.4840051899243,0
4175,510.87676922786045,0,1,873,0.0,0.0011441647597254005,0.9988558352402745,874,24150,17500,6650,0.7246376811594203,308,175,133,161.23118857244447,0.4211448659374419,0.9308244027918591,0.12192198156549228,17932907.135924466,379318.7864168694,18312225.922341336,4174,25,2703.453089244851,101,773,87,30.766806385302235,0.6758457095709571,35.03880718954246,135362.51815376556,1340.2229520174808,0
4176,510.77370504963966,0,0,873,0.0,0.0,1.0,873,26000,19300,6700,0.7423076923076923,327,193,134,160.52970895900197,0.42065716613946774,0.9299040930091664,0.12180224907816753,17943420.269055612,375490.4067041025,18318910.675759714,4175,26,2707.3802978235967,107,766,74,30.679323435945893,0.6754283489096573,34.934413580246876,135388.53165677068,1265.3133799698194,0
4177,511.2582128438026,0,0,873,0.0,0.0,1.0,873,23800,16800,7000,0.7058823529411765,308,168,140,157.4826953425162,0.4205341786030805,0.928059860906453,0.12001763403043607,17978833.26401123,367871.0243060247,18346704.288317256,4176,27,2708.3802978235967,117,756,78,30.622267714089116,0.6746794871794872,34.79872881355928,135586.32795068182,1158.8575038519814,0
4178,511.64131513343494,0,1,872,0.0,0.001145475372279496,0.9988545246277205,873,23900,17100,6800,0.7154811715481172,307,171,136,168.02572598798128,0.42063527249703125,0.9329711388096886,0.12460867732630306,17877499.342020284,402275.9611585267,18279775.30317881,4177,28,2709.3802978235967,117,756,84,31.2043622965783,0.6661324786324787,35.64618644067798,135254.33283003126,1156.0199387182158,8
4179,511.9319803133145,0,0,872,0.0,0.0,1.0,872,21550,15500,6050,0.7192575406032483,276,155,121,167.55560223926074,0.42062987484068715,0.9336061198270083,0.12311694251493582,17848253.52750082,402164.973743886,18250418.501244705,4178,29,2713.098623853211,107,765,71,31.512984878369494,0.665303738317757,35.937500000000014,135182.0385514855,1263.3835378643503,8
4180,512.3768400216863,0,1,871,0.0,0.0011467889908256881,0.9988532110091743,872,26200,19500,6700,0.7442748091603053,329,195,134,167.89177640101147,0.42059931793923816,0.9337324395969948,0.12391364711702253,17882764.244617093,399873.81119785475,18282638.055814948,4179,30,2714.098623853211,114,758,74,31.361352052477613,0.6652046783625731,35.797101449275374,135371.44628399116,1187.468827052554,0
4181,512.521469201655,0,1,870,0.0,0.001148105625717566,0.9988518943742825,871,24250,16800,7450,0.6927835051546392,317,168,149,165.302365949594,0.42044331833317933,0.9332896567185671,0.12261839613156093,17909272.804973748,393639.0334197795,18302911.838393528,4180,31,2715.4098737083814,121,750,80,31.268705725297636,0.665461432506887,35.6386612021858,135490.8617607729,1119.7591881055612,0
4182,512.2937361019193,0,0,870,0.0,0.0,1.0,870,21900,15800,6100,0.7214611872146118,280,158,122,169.62834774162437,0.42009176774290263,0.9358118094720762,0.12640291150742092,17920697.738552213,412071.6695535381,18332769.40810575,4181,32,2719.46091954023,131,739,82,31.00883604829247,0.665235368956743,35.49558080808082,135503.95712329712,1034.3813520862375,0
4183,512.5056305370216,0,0,870,0.0,0.0,1.0,870,22750,15500,7250,0.6813186813186813,300,155,145,167.94075123188532,0.42004729199458574,0.9358218652626888,0.12560279340396005,17943570.844812036,405941.3534920611,18349512.198304098,4182,33,2720.46091954023,88,782,88,30.9375322511684,0.6762547348484849,35.38155430711612,135618.44336155872,1541.1186745631674,0
4184,512.4457304882246,0,0,870,0.0,0.0,1.0,870,24550,18600,5950,0.7576374745417516,305,186,119,167.9502484108509,0.41993128028429205,0.9352688466899739,0.12632872487053565,17965578.49918749,404914.6743566373,18370493.173544127,4183,34,2721.46091954023,92,778,92,30.756595180688894,0.6767436594202898,35.203853046594986,135693.6549560052,1474.9310321304913,0
4185,512.4953087488409,0,0,870,0.0,0.0,1.0,870,25450,18100,7350,0.7111984282907662,328,181,147,164.81003520430403,0.41968848237944706,0.9340634714089506,0.1247847409404013,17994991.528443623,393701.03746078804,18388692.565904412,4184,35,2722.46091954023,99,771,88,30.632534067085974,0.6767676767676767,34.99999999999999,135811.25681844243,1371.830876953964,0
4186,512.96327611639,1,0,871,0.001148105625717566,0.0,1.0,871,25350,18700,6650,0.73767258382643,320,187,133,161.9664535649678,0.41954578346112054,0.9320977412770752,0.1231596080095578,18029449.261801843,384483.19133270736,18413932.45313455,4185,0,2720.334098737084,109,762,72,30.573165940424293,0.6756498470948012,34.867424242424214,136003.27466578144,1247.736464823683,0
4187,513.3663164327338,0,0,871,0.0,0.0,1.0,871,23200,16400,6800,0.7068965517241379,300,164,136,168.73406653743308,0.41961484575354874,0.9364850037359385,0.12308137749506441,17866894.882785827,405550.7659938567,18272445.648779683,4186,1,2721.334098737084,89,782,84,31.717253418147227,0.6679541198501873,36.16898148148146,135441.9581375473,1521.819754354464,7
4188,513.4081777446148,0,0,871,0.0,0.0,1.0,871,26700,20400,6300,0.7640449438202247,330,204,126,167.44414086082838,0.4194539570054238,0.9357819709284982,0.12269822466452424,17887953.96055418,398146.61653660453,18286100.577090785,4187,2,2722.334098737084,95,776,69,31.604187219116476,0.6675438596491228,36.02430555555553,135527.28025359035,1426.602950037793,0
4189,512.9758557619758,0,0,871,0.0,0.0,1.0,871,24300,17900,6400,0.7366255144032922,307,179,128,167.48363391854568,0.4192678847143592,0.9357633186772001,0.12300268636774622,17882509.88359773,400505.5477778494,18283015.43137558,4188,3,2723.334098737084,98,773,70,31.530932456664647,0.6674107142857143,35.953282828282816,135449.5907023015,1382.1386806357295,0
4190,512.9806701468365,0,0,871,0.0,0.0,1.0,871,24050,18200,5850,0.7567567567567568,299,182,117,169.18204708093475,0.4191619818678491,0.9364388276968247,0.12491660736523742,17905572.04821801,407610.2666545341,18313182.314872544,4189,4,2724.334098737084,101,770,74,31.314258658008647,0.6683168316831682,35.78431372549018,135537.5398084035,1341.9558396871632,0
4191,513.0303218218924,0,1,870,0.0,0.001148105625717566,0.9988518943742825,871,25300,18800,6500,0.7430830039525692,318,188,130,167.98483291447542,0.4191342689734352,0.93619061513512,0.1244077526903435,17920193.090100575,402564.128407134,18322757.21850771,4190,5,2725.334098737084,106,765,75,31.249232658072444,0.6680424528301887,35.68925233644859,135599.42793481628,1279.239886177512,0
4192,513.4077856862226,0,0,870,0.0,0.0,1.0,870,24700,17700,7000,0.7165991902834008,317,177,140,170.5231969610708,0.4190544136255616,0.9365985666744832,0.12675454534408687,17949105.49306869,413447.7702539167,18362553.263322607,4191,6,2729.2816091954023,112,758,79,31.064290279472445,0.6678757440476191,35.573377581120944,135758.68669256347,1212.1311311836023,0
4193,512.8668236887885,0,0,870,0.0,0.0,1.0,870,23350,17800,5550,0.7623126338329764,289,178,111,168.21982726125762,0.4189166324969467,0.9358807847250625,0.12581312273086023,17956270.895212542,406770.15764979995,18363041.052862342,4192,7,2730.2816091954023,87,783,87,30.92974166853056,0.6766044061302682,35.381155303030305,135714.2263679316,1559.933636413007,0
4194,512.6023976111899,0,0,870,0.0,0.0,1.0,870,24700,18000,6700,0.728744939271255,314,180,134,166.3727513881039,0.41869003765282686,0.9351953039002137,0.1249767900894923,17965491.331148393,399093.64456045924,18364584.975708853,4193,8,2731.2816091954023,90,780,90,30.840160981163606,0.6769675925925926,35.24496336996338,135714.06655619558,1507.9340728466175,0
4195,513.0625583193824,0,0,870,0.0,0.0,1.0,870,25250,17500,7750,0.693069306930693,330,175,155,167.6751993922784,0.41855481925320426,0.935914663537722,0.12640753913579061,17996748.50167871,404271.6786863354,18401020.180365045,4194,9,2732.2816091954023,91,779,87,30.6924525142849,0.6777701465201464,35.13360507246378,135893.03019435416,1493.33000213576,0
4196,513.3850368575513,0,0,870,0.0,0.0,1.0,870,25950,17600,8350,0.6782273603082851,343,176,167,160.01163023703393,0.41850361978581097,0.932751893534117,0.11027075496309224,17618253.799652204,363875.10248242394,17982128.902134627,4195,10,2733.2816091954023,106,764,70,33.82391649015892,0.644555817610063,38.01596573208719,134498.68308872016,1268.8555008369826,8
4197,512.9696585472193,0,0,870,0.0,0.0,1.0,870,22400,16400,6000,0.7321428571428571,284,164,120,161.95828894248362,0.4184598329431372,0.9336664480703172,0.11209804556863759,17623348.571857218,374449.47602698667,17997798.047884203,4196,11,2734.2816091954023,111,759,73,33.62664395874725,0.6448948948948949,37.87202380952379,134463.69844210104,1211.384670649559,0
4198,513.0141903030801,0,0,870,0.0,0.0,1.0,870,21850,15200,6650,0.6956521739130435,285,152,133,161.91197238828568,0.4185669164362966,0.9333191074926419,0.11242308162570182,17639021.477145012,375343.75167277193,18014365.228817783,4197,12,2735.2816091954023,120,750,76,33.521005000930145,0.6441840277777777,37.7668732782369,134529.31517580937,1121.077626465078,0
4199,513.4119196312417,0,0,870,0.0,0.0,1.0,870,25500,19000,6500,0.7450980392156863,320,190,130,163.28774504663224,0.4186044204595056,0.9344275692255457,0.11379705784137921,17669061.712587282,377528.24882763415,18046589.961414915,4198,13,2736.2816091954023,128,742,79,33.361418898122515,0.64404296875,37.64534883720931,134696.0050776737,1052.3125396693258,0
4200,513.4933417460502,0,1,869,0.0,0.0011494252873563218,0.9988505747126437,870,23750,16000,7750,0.6736842105263158,315,160,155,169.16084700563985,0.41857534864136786,0.9376198722547742,0.11832972169904775,17688353.18270542,400685.36130428006,18089038.5440097,4199,14,2737.2816091954023,135,735,82,33.08289440407762,0.6442129629629629,37.5229779411765,134780.20318853893,998.3718754706588,0
4201,513.841865738214,0,0,869,0.0,0.0,1.0,869,21550,14600,6950,0.6774941995359629,285,146,139,170.91630011749976,0.41838107788495704,0.938224286185535,0.11991004080935054,17713377.323232684,410150.9829344331,18123528.30616712,4200,15,2741.005753739931,84,785,84,32.93866097265004,0.6569940476190477,37.42647058823531,134921.2722464097,1606.205621981068,0
4202,513.4119817533318,0,0,869,0.0,0.0,1.0,869,25900,18200,7700,0.7027027027027027,336,182,154,166.91848994511278,0.41827297430349697,0.9362613341737114,0.1178368011928698,17726003.61192142,392059.55113271356,18118063.16305413,4201,16,2742.005753739931,93,776,93,32.8367263385766,0.6560259856630825,37.22296099290783,134912.8803559051,1450.6761328591947,0
4203,513.6424633591928,0,1,868,0.0,0.0011507479861910242,0.998849252013809,869,20500,14300,6200,0.697560975609756,267,143,124,164.37459888301527,0.4183012016566529,0.9348250973854508,0.11650240104488768,17751405.534276802,389276.0328613019,18140681.567138106,4202,17,2743.005753739931,99,770,87,32.7722390612412,0.6556186868686869,37.09375000000002,135039.81388252886,1364.0385240659482,0
4204,513.1684264759167,0,0,868,0.0,0.0,1.0,868,24900,18600,6300,0.7469879518072289,312,186,126,164.0491116434272,0.4180806256721537,0.9337925108677678,0.11673442990883438,17752420.178414606,383953.751957956,18136373.930372562,4203,18,2747.0437788018435,108,760,66,32.64976323693263,0.6547067901234568,36.96483180428136,134981.34337082578,1249.827253433572,0
4205,513.2795001007462,0,0,868,0.0,0.0,1.0,868,22800,15500,7300,0.6798245614035088,301,155,146,164.23429609342796,0.41806742067478475,0.9335565142016751,0.11726905001758803,17771303.768061113,387331.51300200005,18158635.281063113,4204,19,2748.0437788018435,115,753,69,32.53167940667938,0.6543478260869565,36.85344827586207,135067.73052220076,1174.5020045408762,0
4206,513.7051113522381,1,0,869,0.0011507479861910242,0.0,1.0,869,25100,17800,7300,0.7091633466135459,324,178,146,164.07887541178823,0.4182076812869994,0.9337344330333199,0.1176933338764539,17805930.099449858,385415.3972757192,18191345.496725578,4205,0,2745.880322209436,125,744,74,32.38625659382061,0.654,36.706349206349174,135255.2941992875,1082.0423535943,0
4207,513.2404230766851,0,0,869,0.0,0.0,1.0,869,26300,18800,7500,0.714828897338403,338,188,150,168.81210147221125,0.41815575621465784,0.9360295838736059,0.12151389989935614,17805074.545420386,401042.4101763475,18206116.955596734,4206,1,2746.880322209436,130,739,78,32.14689116303404,0.6543269230769231,36.59351145038164,135190.8576243475,1039.9296740334423,0
4208,513.5025768382691,1,0,870,0.0011494252873563218,0.0,1.0,870,25850,18200,7650,0.7040618955512572,335,182,153,169.60777007386662,0.4180652002345586,0.937761159787903,0.12257391357526169,17831458.162094325,405020.77120764833,18236478.933301974,4207,0,2744.7218390804596,140,730,83,31.995974900949367,0.6541666666666667,36.46572104018911,135325.5313310769,966.6109380791207,0
4209,513.0197037365472,0,0,870,0.0,0.0,1.0,870,26050,18800,7250,0.7216890595009597,333,188,145,163.744071398033,0.41794951919897355,0.9346052849765203,0.11909695038817286,17842383.747337148,384266.9116470141,18226650.658984162,4208,1,2745.7218390804596,94,776,94,31.942394573095495,0.665447695035461,36.26096491228069,135303.32164446413,1439.397038770895,0
4210,512.532468894873,0,0,870,0.0,0.0,1.0,870,24650,18200,6450,0.7383367139959433,311,182,129,159.8391907963361,0.417889198620866,0.9295441903515915,0.10993732578301363,17580297.37823579,363354.10137923073,17943651.47961502,4209,2,2746.7218390804596,112,758,72,33.89425615035372,0.642578125,38.08075221238938,134242.11871967188,1198.5903457113561,8
4211,512.3118695795554,0,0,870,0.0,0.0,1.0,870,23350,16100,7250,0.6895074946466809,306,161,145,158.01138499754433,0.41782940161104715,0.9292343323488543,0.10896474072496681,17584387.6226441,358356.6885175329,17942744.311161634,4210,3,2747.7218390804596,115,755,74,33.85389890438814,0.6428442028985507,37.993893678160916,134228.83817100094,1167.2072884434865,0
4212,511.92579791519785,0,0,870,0.0,0.0,1.0,870,21950,15700,6250,0.715261958997722,282,157,125,149.90234803968542,0.4178102500341698,0.9197929236135245,0.10015953188119485,17429221.017406084,326586.2310023615,17755807.248408444,4211,4,2748.7218390804596,123,747,87,35.14245914217345,0.6306741192411924,39.05409946236559,133584.93834542832,1086.0564093124253,8
4213,511.9824192988428,0,0,870,0.0,0.0,1.0,870,25900,19600,6300,0.7567567567567568,322,196,126,155.3808112923122,0.41803323501272,0.9210153424632765,0.10420562294716534,17447953.45080285,342315.43251526,17790268.88331811,4212,5,2749.7218390804596,131,739,88,34.87179341857356,0.6306456743002544,38.928345959596,133664.0970459594,1020.3366186714459,0
4214,511.9942569608245,1,0,871,0.001148105625717566,0.0,1.0,871,24450,17500,6950,0.7157464212678937,314,175,139,153.26983229922405,0.41816008375452535,0.9203863377242278,0.10314565485856222,17463985.408929814,336690.42298056174,17800675.831910376,4213,0,2747.563719862227,138,733,94,34.808218326495094,0.6308121980676329,38.811450839328565,133727.0371541959,969.0365011173615,0
4215,511.84311459847737,0,0,871,0.0,0.0,1.0,871,23350,16700,6650,0.715203426124197,300,167,133,155.53006689726323,0.4183504999318175,0.9238111412007208,0.10514577576467929,17479429.74737799,346165.3755871569,17825595.12296515,4214,1,2748.563719862227,143,728,98,34.59274431650436,0.6317016317016317,38.657407407407455,133766.40656983692,935.4294165722862,0
4216,511.6478866499296,0,0,871,0.0,0.0,1.0,871,22900,15900,7000,0.6943231441048034,299,159,140,157.01874447396315,0.41848219116618496,0.9255676808002498,0.10664530126759125,17493602.43254824,352264.6980570745,17845867.130605314,4215,2,2749.563719862227,103,768,103,34.39558755936876,0.6403721682847896,38.50160256410255,133795.1024104195,1298.9815768001893,0
4217,512.0533064183846,1,1,871,0.0011467889908256881,0.0011467889908256881,0.9988532110091743,872,26400,19400,7000,0.7348484848484849,334,194,140,154.53312751272554,0.41868312043347133,0.9244551439669688,0.10573044873726063,17540379.364712995,341313.93619775336,17881693.30091075,4216,0,2747.4094036697247,112,760,104,34.211086262355835,0.6408110119047619,38.25589970501474,134026.93199155212,1196.6690356388583,0
4218,511.90251655527913,0,0,871,0.0,0.0,1.0,871,23650,15900,7750,0.6723044397463002,314,159,155,156.47649441736522,0.4185947473067905,0.9243256131477737,0.10749270455761906,17553226.746571105,351483.47740331513,17904710.22397442,4217,1,2751.4098737083814,118,753,74,34.023715613196536,0.6409781073446328,38.121498599439775,134056.26389867184,1136.0700330395919,0
4219,511.7938725154298,0,0,871,0.0,0.0,1.0,871,24900,18500,6400,0.7429718875502008,313,185,128,155.11520099483423,0.41863571180349357,0.9226248111138722,0.10702613846611285,17569044.909056682,345945.18647112494,17914990.095527805,4218,2,2752.4098737083814,126,745,82,33.91132692668874,0.6410383597883598,37.97572178477692,134102.42004083082,1064.304920958975,0
4220,511.85475856600647,0,0,871,0.0,0.0,1.0,871,24650,17200,7450,0.6977687626774848,321,172,149,154.03567884406633,0.4186834945519969,0.9213720114535429,0.10664354272284811,17586255.664050706,342932.16590747784,17929187.82995818,4219,3,2753.4098737083814,131,740,90,33.82516005378613,0.6413804071246819,37.86300505050507,134176.06826109372,1024.2447958862117,0
4221,511.42257602716876,0,0,871,0.0,0.0,1.0,871,22300,15400,6900,0.6905829596412556,292,154,138,157.32476355153457,0.4186157519212074,0.9234133922063554,0.10940102065599348,17590897.314885467,356996.7521447388,17947894.067030206,4220,4,2754.4098737083814,133,738,97,33.5913110057301,0.6425438596491229,37.7176616915423,134137.10910414145,1008.5496925123417,0
4222,511.8766118392371,0,0,871,0.0,0.0,1.0,871,23350,17000,6350,0.728051391862955,297,170,127,155.93084295488862,0.4186925672257633,0.9227565669346551,0.10878142782995436,17620755.695168428,351973.857809959,17972729.55297839,4221,5,2755.4098737083814,139,732,104,33.52016281487783,0.6427607913669064,37.61160714285716,134310.48152165813,966.2624569903463,0
4223,511.9584347104171,0,0,871,0.0,0.0,1.0,871,22100,15300,6800,0.6923076923076923,289,153,136,162.13266853067032,0.418623230003827,0.9254078765076892,0.11341784996405212,17635651.636550628,375563.0522222485,18011214.688772876,4222,6,2756.4098737083814,143,728,107,33.2660706903679,0.6431381118881119,37.52170138888889,134377.97890239817,939.7061461706165,0
4224,511.50624264377325,0,0,871,0.0,0.0,1.0,871,23650,16900,6750,0.7145877378435518,304,169,135,161.6092900169308,0.41852035138190563,0.9265538281050243,0.11352309022661573,17638389.859914064,372255.5324605014,18010645.392374568,4223,7,2757.4098737083814,108,763,108,33.14122392042696,0.650462962962963,37.3853211009174,134329.0476667691,1243.78747839601,0
4225,511.3126660368394,0,0,871,0.0,0.0,1.0,871,25450,18500,6950,0.7269155206286837,324,185,139,157.81139160570544,0.4186194359766156,0.9251718140491827,0.11131150940206316,17649741.45520874,357416.05210547254,18007157.507314213,4224,8,2758.4098737083814,112,759,112,33.10462933726272,0.6509486607142857,37.25110619469024,134346.8373898217,1199.5253338376938,0
4226,511.4357817769769,1,0,872,0.0011467889908256881,0.0,1.0,872,23050,16500,6550,0.7158351409978309,296,165,131,158.05671552101853,0.4186419755931001,0.9234799910350899,0.11195958992960518,17672608.035634104,361204.8761605288,18033812.911794633,4225,0,2756.2454128440368,120,752,103,32.95749145844928,0.65078125,37.11260330578509,134450.02124761813,1120.4168437301512,0
4227,511.764355801075,0,0,872,0.0,0.0,1.0,872,23650,16600,7050,0.7019027484143763,307,166,141,158.40744288815915,0.41875361525997395,0.9233030606667108,0.112796486709672,17706810.01302318,362928.0991738842,18069738.112197064,4226,1,2757.2454128440368,128,744,79,32.775808085459026,0.651123046875,36.94282945736431,134623.2834216036,1051.7444017312782,0
4228,511.73462117307344,1,0,873,0.001145475372279496,0.0,1.0,873,24650,18700,5950,0.7586206896551724,306,187,119,159.5404544582574,0.4187459606229704,0.9236929123269688,0.11406843728869212,17723577.493158095,366275.52157690667,18089853.014735002,4227,0,2755.085910652921,135,738,84,32.61172710164329,0.6513888888888889,36.81066176470585,134683.09629862758,997.6525651750192,0
4229,512.1292487524283,0,0,873,0.0,0.0,1.0,873,22100,16600,5500,0.751131221719457,276,166,110,157.98869420804965,0.41878651859558413,0.9234928115343313,0.11327485369492943,17749390.274155002,364140.59848054574,18113530.872635547,4228,1,2756.085910652921,142,731,88,32.56105377712602,0.6513350938967136,36.720571095571046,134833.09613678986,949.5288460337314,0
4230,512.3352180250004,0,0,873,0.0,0.0,1.0,873,23950,16700,7250,0.697286012526096,312,167,145,156.64311354046077,0.4187334812467816,0.9231876345811605,0.11266650201476708,17770287.418964744,358168.6299630924,18128456.048927836,4229,2,2757.085910652921,142,731,97,32.49290132846559,0.652362089201878,36.61858974358971,134939.5722474475,950.2786777989261,0
4231,511.8941838120285,0,1,872,0.0,0.001145475372279496,0.9988545246277205,873,23300,16100,7200,0.6909871244635193,305,161,144,161.06332346927672,0.4186721243138532,0.9254339088258199,0.11606366424237824,17763130.49706331,374297.7666150853,18137428.263678394,4230,3,2758.085910652921,145,728,98,32.31513830209796,0.6525862068965518,36.558219178082155,134854.3153758202,930.0297612125531,0
4232,511.4754732773321,0,0,872,0.0,0.0,1.0,872,25150,18100,7050,0.7196819085487077,322,181,141,164.91598536867465,0.41861978480919326,0.9282018496019304,0.11916068793553802,17760250.767307248,386239.8511370291,18146490.61844428,4231,4,2761.946100917431,154,718,100,32.125772490415514,0.6523944805194806,36.471774193548335,134788.22401628635,875.2482078979633,0
4233,511.7787453331679,0,0,872,0.0,0.0,1.0,872,22850,17100,5750,0.7483588621444202,286,171,115,162.19026126047393,0.4184924278132977,0.9268566045282041,0.11791460552100977,17797319.517831452,380060.3804666483,18177379.8982981,4232,5,2762.946100917431,107,765,107,31.997715746870046,0.6618964174454829,36.27507716049385,134968.81012389023,1261.390748821404,0
4234,511.84720842172203,0,0,872,0.0,0.0,1.0,872,24600,17400,7200,0.7073170731707317,318,174,144,163.12293986574073,0.41839376248608756,0.9255786085918303,0.11911541911071,17818606.18679431,382324.6850999582,18200930.87189427,4233,6,2763.946100917431,115,757,105,31.830814955985137,0.6615942028985506,36.13505747126439,135058.5342336928,1174.42203681472,0
4235,512.299716983872,1,1,872,0.001145475372279496,0.001145475372279496,0.9988545246277205,873,23150,16000,7150,0.6911447084233261,303,160,143,160.86369531238674,0.41844984910901634,0.9241898215695978,0.11775466287454081,17844907.48072175,376369.551971317,18221277.032693066,4234,0,2761.77892325315,121,752,106,31.811151457315695,0.6612431129476584,36.057035519125705,135217.90600343747,1117.5033554003096,0
4236,512.6418140178212,0,0,872,0.0,0.0,1.0,872,25500,19000,6500,0.7450980392156863,320,190,130,161.62625825503963,0.41837958123110625,0.924342691335907,0.11889463821538601,17877845.704899684,378005.86138877843,18255851.566288464,4235,1,2765.4770642201834,130,742,77,31.6331958369715,0.661298076923077,35.90171755725193,135387.82259044255,1041.4447891572504,0
4237,512.3334449263448,0,0,872,0.0,0.0,1.0,872,23800,16200,7600,0.680672268907563,314,162,152,159.91040118493765,0.4182474514337276,0.9243774872907418,0.11802116840548364,17881185.63772138,373677.51379807957,18254863.15151946,4236,2,2766.4770642201834,133,739,83,31.57270304332051,0.6618890977443609,35.79757462686569,135359.73874931465,1017.7423966113884,0
4238,512.3910860151713,0,0,872,0.0,0.0,1.0,872,23050,16400,6650,0.7114967462039046,297,164,133,145.58248606504065,0.4181810710912621,0.9247969361185853,0.10441844568052555,17760072.399920635,319661.09853510966,18079733.498455744,4237,3,2767.4770642201834,128,744,87,32.87559549367193,0.6534830729166667,36.70865633074934,134908.13752108027,1053.9698243834396,8
4239,512.0699687557977,0,0,872,0.0,0.0,1.0,872,23050,16200,6850,0.702819956616052,299,162,137,147.38986240868383,0.41811743373815463,0.9256378831209209,0.10594102688272634,17758221.937122907,326026.37758708064,18084248.314709987,4238,4,2768.4770642201834,131,741,90,32.75817402291273,0.6537054707379135,36.63983585858585,134858.83102341503,1029.4567253695805,0
4240,511.96682382196565,0,0,872,0.0,0.0,1.0,872,22000,16700,5300,0.759090909090909,273,167,106,138.0978020675888,0.4181054743045534,0.923287151183211,0.09743362774539686,17673538.428248677,291735.3623396481,17965273.790588327,4239,5,2769.4770642201834,104,768,104,33.61343414130735,0.6528445512820513,37.24206349206352,134523.34618798358,1293.493713345996,8
4241,512.3675124728964,0,0,872,0.0,0.0,1.0,872,23350,16800,6550,0.7194860813704497,299,168,131,139.19502228040102,0.41797499030078966,0.9235698025053545,0.0984480548186668,17698094.084565643,294947.32008435304,17993041.404649995,4240,6,2770.4770642201834,107,765,98,33.50385459860804,0.652940031152648,37.16242283950619,134669.43559412615,1258.5928560198706,0
4242,512.0348801953684,0,0,872,0.0,0.0,1.0,872,23200,16200,7000,0.6982758620689655,302,162,140,138.89509607644476,0.417982752960673,0.9228600372385367,0.09873688286133313,17708857.285120152,294334.6868041644,18003191.971924316,4241,7,2771.4770642201834,115,757,79,33.34414549758721,0.6528985507246376,36.99712643678162,134666.64485598062,1171.0143030954837,0
4243,511.77903687229355,0,0,872,0.0,0.0,1.0,872,22050,15700,6350,0.7120181405895691,284,157,127,141.93654301622334,0.4178030597278252,0.9249777277319995,0.10130245179532814,17717409.977852695,306499.5846915182,18023909.56254421,4242,8,2772.4770642201834,116,756,81,33.133071110359225,0.6540050287356323,36.867877492877525,134665.50422685943,1160.9095191970641,0
4244,511.996025497442,0,0,872,0.0,0.0,1.0,872,24200,17300,6900,0.7148760330578512,311,173,138,143.24569121680994,0.4177004719258331,0.9259306316414768,0.10263479937699342,17741827.380043622,309688.0653007388,18051515.445344362,4243,9,2773.4770642201834,120,752,84,32.97137290167866,0.6545138888888888,36.74242424242426,134786.8324699717,1123.2236039164309,0
4245,511.5009661138558,0,0,872,0.0,0.0,1.0,872,24450,17600,6850,0.7198364008179959,313,176,137,144.18400239030746,0.4177271886421808,0.9263538359168182,0.10357714615903835,17735997.642194804,312599.4252873397,18048597.067482144,4244,10,2774.4770642201834,124,748,87,32.861367783719956,0.6546538978494624,36.65833333333333,134699.51691803272,1086.2864267583284,0
4246,511.39518179179095,1,0,873,0.001145475372279496,0.0,1.0,873,22600,16300,6300,0.7212389380530974,289,163,126,148.08735735426157,0.41783326940389737,0.9292801148805274,0.10688914317677257,17752941.395216227,328597.23529652494,18081538.63051275,4245,0,2772.2978235967926,132,741,89,32.60330281683163,0.6549084595959596,36.50532581453632,134749.90680624248,1020.8326273200188,0
4247,511.4981516565501,0,0,873,0.0,0.0,1.0,873,23850,17200,6650,0.7211740041928721,305,172,133,148.16939513643575,0.4176809443866452,0.9295660498955718,0.10729087982071196,17770319.85401505,328153.5088300792,18098473.362845127,4246,1,2773.2978235967926,93,780,93,32.49722362354784,0.6643145161290323,36.40292553191488,134829.41637249908,1449.778670672033,0
4248,511.61343522136275,0,0,873,0.0,0.0,1.0,873,23550,15900,7650,0.6751592356687898,312,159,153,142.82513795198966,0.41757585490294985,0.9265064371394369,0.10399679642835835,17798229.83772234,310256.92637478345,18108486.76409712,4247,2,2774.2978235967926,102,771,102,32.458368478899835,0.6636029411764706,36.22572815533981,134950.46134146038,1323.0437386417684,0
4249,511.8206033951014,0,1,872,0.0,0.001145475372279496,0.9988545246277205,873,23250,16900,6350,0.7268817204301076,296,169,127,140.58787136853582,0.4174656204132819,0.9245186229562861,0.1027980270053561,17823449.21295605,303302.1570589441,18126751.37001499,4248,3,2775.2978235967926,110,763,93,32.38212075954774,0.6630681818181818,36.09234234234236,135073.3765829313,1227.9397871175572,0
4250,511.7806557091531,0,0,872,0.0,0.0,1.0,872,24550,17700,6850,0.7209775967413442,314,177,137,135.97902349503545,0.4174225522440725,0.922188661896644,0.09808827054354761,17763629.889694244,284146.2092255758,18047776.09891982,4249,4,2778.9162844036696,139,733,95,32.9425943445069,0.6537020383693046,36.52529761904764,134841.25594729924,970.080978038124,8
4251,512.061189791526,0,0,872,0.0,0.0,1.0,872,24550,18200,6350,0.7413441955193483,309,182,127,132.93933888988238,0.4172902304374388,0.9205847633838544,0.09621766146867584,17787862.261602413,273991.3298643447,18061853.59146676,4250,5,2779.9162844036696,102,770,102,32.91383698474213,0.6616625816993464,36.417880258899686,134970.17384240084,1323.2369984549102,0
4252,512.0164695553605,0,0,872,0.0,0.0,1.0,872,23500,16900,6600,0.7191489361702128,301,169,132,130.47976003940352,0.41719943748968635,0.9190983402543547,0.09478326694362162,17802072.662193052,266662.03383339866,18068734.696026452,4251,6,2780.9162844036696,105,767,105,32.86036371767164,0.6621031746031746,36.30110062893084,135018.17948161028,1285.8874236343836,0
4253,512.3196779762463,0,0,872,0.0,0.0,1.0,872,26250,18900,7350,0.72,336,189,147,130.92799648153078,0.4170565826039176,0.9188428585434432,0.09543879965335827,17827526.16762191,266174.4566697626,18093700.624291673,4252,7,2781.9162844036696,108,764,108,32.73674756988469,0.6625192901234568,36.19074923547402,135154.67039883765,1251.432133322571,0
4254,512.4698733363167,0,0,872,0.0,0.0,1.0,872,22550,15800,6750,0.7006651884700665,293,158,135,130.90297243031762,0.4170027651527121,0.9176170371695282,0.09577717855861279,17848783.62917241,270341.76626485324,18119125.395437263,4253,8,2782.9162844036696,115,757,101,32.61730490059319,0.6622282608695652,36.07219827586208,135255.0471195019,1176.1308445174077,0
4255,512.8107897378129,0,1,871,0.0,0.0011467889908256881,0.9988532110091743,872,22600,15400,7200,0.6814159292035398,298,154,144,128.98448424960134,0.41705468994126055,0.9158654989774384,0.09475039246127032,17877755.24725573,264190.60802158114,18141945.85527731,4254,9,2783.9162844036696,123,749,86,32.54001235431978,0.6620088075880759,35.94590053763443,135409.79127880395,1100.8926120227964,0
4256,512.6318569775486,0,0,871,0.0,0.0,1.0,871,25400,18000,7400,0.7086614173228346,328,180,148,130.72416544547852,0.41723269153788967,0.9162183970475768,0.09651104263021099,17892956.62265576,268208.3643697649,18161164.987025525,4255,10,2787.8036739380022,131,740,91,32.33366810031558,0.6622932569974554,35.78756313131313,135443.71214855814,1033.9214667828867,0
4257,512.4343107682251,0,1,870,0.0,0.001148105625717566,0.9988518943742825,871,24600,17600,7000,0.7154471544715447,316,176,140,130.6331244559419,0.41701450748028207,0.915748011668343,0.09674808557422347,17899489.030016374,268853.2356311817,18168342.265647557,4256,11,2788.8036739380022,137,734,95,32.2356208590359,0.6624087591240876,35.68840579710146,135442.32960341382,988.6301430906118,0
4258,512.5435738133499,0,0,870,0.0,0.0,1.0,870,22850,16000,6850,0.700218818380744,297,160,137,130.1886471514919,0.4168621780881711,0.9156767857683701,0.0968352048958105,17921632.09658994,269788.6074803709,18191420.70407031,4257,12,2792.9758620689654,144,726,101,32.11036329720287,0.6628327546296297,35.55316091954027,135540.52798594552,941.2536665690661,0
4259,512.6301060361762,0,0,870,0.0,0.0,1.0,870,25950,18500,7450,0.7129094412331407,334,185,149,128.82899786644228,0.41681334845619,0.9148617538612003,0.09599331426390148,17932158.675393917,262086.40634662323,18194245.08174054,4258,13,2793.9758620689654,153,717,104,32.09028061920357,0.6623093681917211,35.49783549783557,135591.77263554814,886.2207361800532,0
4260,512.9832652427126,0,0,870,0.0,0.0,1.0,870,22650,16900,5750,0.7461368653421634,284,169,115,129.5814418375596,0.41665746288727523,0.915057082877379,0.09694799194242376,17961783.918745752,268852.771633151,18230636.690378904,4259,14,2794.9758620689654,112,758,112,31.941468979691354,0.669921875,35.37057522123892,135750.46640230878,1212.0577357348998,0
4261,513.2187708412132,0,0,870,0.0,0.0,1.0,870,25000,19000,6000,0.76,310,190,120,127.79308877314395,0.4165396324660838,0.9138627978304301,0.09603372810239165,17988740.64427188,260767.34601409754,18249507.990285978,4260,15,2795.9758620689654,118,752,118,31.849301859137512,0.6701094632768362,35.23284313725489,135883.4748042199,1151.5548712222026,0
4262,512.830464209668,0,0,870,0.0,0.0,1.0,870,25200,17800,7400,0.7063492063492064,326,178,148,128.77740377674124,0.41655878404296126,0.914631912308572,0.09707907272316565,17988430.827162772,264100.6839879013,18252531.511150673,4261,16,2796.9758620689654,121,749,113,31.72404043497418,0.6705406336088154,35.13490437158469,135830.8899440575,1122.5693383806406,0
4263,512.6664728000055,0,0,870,0.0,0.0,1.0,870,24600,17900,6700,0.7276422764227642,313,179,134,129.04346481762374,0.4163442312694823,0.9134328703265839,0.09761254620851788,17997052.422592983,265880.4002231615,18262932.822816145,4262,17,2797.9758620689654,128,742,109,31.609793076126042,0.67041015625,35.02906976744186,135841.712196862,1061.2633765379844,0
4264,512.4056551191215,0,0,870,0.0,0.0,1.0,870,24450,17300,7150,0.7075664621676891,316,173,143,129.46073657155858,0.41621474456481006,0.9132092052451746,0.09825242947593053,18001767.21638854,267654.4086846766,18269421.625073217,4263,18,2798.9758620689654,133,737,80,31.4952723442525,0.6706610275689223,34.92692786069651,135824.94118397735,1021.2401592780252,0
4265,512.6700163088306,0,0,870,0.0,0.0,1.0,870,23000,16600,6400,0.7217391304347827,294,166,128,128.26231963341317,0.4161088735455824,0.912663167653162,0.09769028072638612,18025976.577121943,265410.71388783946,18291387.291009784,4264,19,2799.9758620689654,138,732,86,31.415849488498253,0.6710446859903382,34.817146282973596,135951.2979399283,985.1543328980312,0
4266,513.0203375626301,0,0,870,0.0,0.0,1.0,870,22800,16300,6500,0.7149122807017544,293,163,130,128.30438372984355,0.4159828589253513,0.912244891607433,0.09812402558556217,18055447.249096435,266518.606452398,18321965.855548833,4265,20,2800.9758620689654,144,726,94,31.287062359535334,0.6715133101851851,34.691091954022966,136108.86556411814,945.2004553063759,0
4267,513.280771309575,0,0,870,0.0,0.0,1.0,870,21850,15900,5950,0.7276887871853547,278,159,119,130.8269552756313,0.41584309374848444,0.9132358890926169,0.10025751413295551,18073129.048375268,277040.4891404972,18350169.537515763,4266,21,2801.9758620689654,151,719,95,31.156789892312055,0.6712886313465783,34.62856359649122,136210.05556072202,902.0533480842518,0
4268,513.3533503423289,0,0,870,0.0,0.0,1.0,870,23100,15600,7500,0.6753246753246753,306,156,150,134.43057363978335,0.41568109069745907,0.916395751551045,0.10336918473547707,18089825.470728546,289265.1230147181,18379090.593743265,4267,22,2802.9758620689654,152,718,100,30.95598355260345,0.6722176535087719,34.524782135076244,136282.59252381756,896.5960034461681,0
4269,513.2295080927353,0,0,870,0.0,0.0,1.0,870,25500,18500,7000,0.7254901960784313,325,185,140,135.0864132260987,0.41543245087276076,0.9181260179164707,0.10424944579310653,18100482.716193087,289525.857558304,18390008.57375139,4268,23,2803.9758620689654,157,713,106,30.826858471518896,0.6727707006369427,34.414556962025316,136306.28628697086,868.1929062864386,0
4270,513.1424671210473,0,0,870,0.0,0.0,1.0,870,24400,17600,6800,0.7213114754098361,312,176,136,131.97567077932646,0.41535939931836924,0.9162775823725815,0.10222665303466304,18112769.39582612,279688.9781370811,18392458.3739632,4269,24,2804.9758620689654,113,757,113,30.795332095283996,0.6804941002949852,34.30190058479532,136340.97824329117,1206.5573295866475,0
4271,512.9149946751696,0,0,870,0.0,0.0,1.0,870,24000,16800,7200,0.7,312,168,144,130.97638785740085,0.4150779675850606,0.915226757120819,0.10186407950660151,18121475.095831856,276697.07013998297,18398172.165971838,4270,25,2805.9758620689654,116,754,116,30.697505330966482,0.6811242816091954,34.17913105413106,136343.5095799199,1175.3750825855163,0
4272,512.6199941419482,0,0,870,0.0,0.0,1.0,870,24450,17100,7350,0.6993865030674846,318,171,147,131.1269614619592,0.41482050976813084,0.9149517524732511,0.10258988843259384,18135563.29284507,277162.2617983651,18412725.554643437,4271,26,2806.9758620689654,121,749,102,30.51133080824289,0.6819903581267217,33.99931693989071,136357.26859202766,1126.9195751407244,0
4273,512.4477954308413,0,0,870,0.0,0.0,1.0,870,24750,17700,7050,0.7151515151515152,318,177,141,133.2999373696964,0.41465001939958296,0.915205028082414,0.10473836810645118,18147076.655224625,285050.83631690126,18432127.491541527,4272,27,2807.9758620689654,129,741,83,30.32268363793292,0.6819282945736433,33.87019230769229,136377.63325035575,1057.1909554291144,0
4274,512.6116837018143,0,0,870,0.0,0.0,1.0,870,24100,17200,6900,0.7136929460580913,310,172,138,131.39552240396455,0.4143553055654758,0.9140421176273161,0.10364570802247261,18168856.457557175,279361.27714467153,18448217.734701846,4273,28,2808.9758620689654,133,737,91,30.254744525547427,0.6824874686716792,33.753109452736304,136481.26684380465,1026.1749386752228,0
4275,512.365593336132,0,0,870,0.0,0.0,1.0,870,23450,17500,5950,0.746268656716418,294,175,119,131.68359448740253,0.4141067208532289,0.9150017492529021,0.1042303121373367,18174153.135075267,281197.5623182395,18455350.697393507,4274,29,2809.9758620689654,137,733,93,30.142974550813342,0.6829379562043796,33.65036231884057,136468.39014537047,996.1196360975947,0
4276,512.5067857509434,0,0,870,0.0,0.0,1.0,870,23850,17700,6150,0.7421383647798742,300,177,123,132.7708840799477,0.41386532831589573,0.9156495601026566,0.10539261212139361,18190841.00302318,285192.8084258336,18476033.811449014,4275,30,2810.9758620689654,143,727,96,30.027331306110593,0.6829836829836831,33.564814814814824,136549.84037021745,954.8939886029193,0
4277,512.2511658403113,0,0,870,0.0,0.0,1.0,870,22350,14900,7450,0.6666666666666666,298,149,149,133.63059146851415,0.41355865507982487,0.9163110751327679,0.10638745819451254,18193721.328299362,289897.548422788,18483618.87672215,4276,31,2811.9758620689654,151,719,99,29.915688505481075,0.6828780353200883,33.47724780701753,136526.59053382237,904.1496061842541,0
4278,512.0727735787768,0,0,870,0.0,0.0,1.0,870,22350,15900,6450,0.7114093959731543,288,159,129,135.97402797079803,0.4132059629467966,0.9175653165753155,0.10868186627069172,18203408.11866595,298688.14493826195,18502096.26360421,4277,32,2812.9758620689654,156,714,108,29.734259397498416,0.6834935897435898,33.35987261146495,136539.1495792441,875.2509588413084,0
4279,511.9538902383779,0,0,870,0.0,0.0,1.0,870,23950,18000,5950,0.7515657620041754,299,180,119,134.9243891713958,0.41287063123597384,0.9176018852099661,0.10847920889380275,18222946.401018813,293793.98241211206,18516740.383430924,4278,33,2813.9758620689654,112,758,112,29.58586696148885,0.6919642857142857,33.185840707964616,136596.54682024053,1219.612025180719,0
4280,512.4347555600557,0,0,870,0.0,0.0,1.0,870,23650,15700,7950,0.6638477801268499,316,157,159,133.47731654202116,0.4125838811511007,0.9169141421823859,0.10776921968475031,18257054.29285797,289730.5229945363,18546784.815852508,4279,34,2814.9758620689654,114,756,114,29.49857199411828,0.6927997076023391,33.06159420289856,136788.51672422938,1199.899269510784,0
4281,512.001144998491,0,0,870,0.0,0.0,1.0,870,23800,16700,7100,0.7016806722689075,309,167,142,139.9936312023638,0.4123424886137675,0.9194826214577692,0.10679716954204685,18009182.302568488,306434.1651043777,18315616.467672866,4280,35,2815.9758620689654,129,741,86,31.054543921130268,0.6728843669250646,34.76762820512819,135799.27804963881,1052.7075817801458,8
4282,512.2929217294137,0,0,870,0.0,0.0,1.0,870,22600,16000,6600,0.7079646017699115,292,160,132,140.2257061692845,0.41217213602634817,0.9203557223071042,0.10730576570808237,18032357.127885666,309120.00243089476,18341477.13031656,4281,36,2816.9758620689654,132,738,89,30.952047111609623,0.6733743686868687,34.67261904761903,135925.33920290708,1029.7374182038416,0
4283,512.1591027967816,0,0,870,0.0,0.0,1.0,870,21450,15500,5950,0.7226107226107226,274,155,119,140.07430135257934,0.4119442460396192,0.9207208093065189,0.10755022067216544,18041615.565891784,309983.3391328207,18351598.905024603,4282,37,2817.9758620689654,138,732,94,30.85184976048635,0.6735356280193237,34.56984412470023,135942.47048830288,985.0903658572672,0
4284,512.088743406356,0,0,870,0.0,0.0,1.0,870,23350,17300,6050,0.7408993576017131,294,173,121,138.28967551748013,0.4117813060769193,0.9201363151184516,0.10651052491842866,18052046.44347444,301932.3290189056,18353978.772493348,4283,38,2818.9758620689654,145,725,99,30.802947656921724,0.6735632183908046,34.47488584474883,135972.42205058993,937.7408417282064,0
4285,511.62012515961226,0,0,870,0.0,0.0,1.0,870,22950,16800,6150,0.7320261437908496,291,168,123,140.40753556324475,0.4113922948383883,0.9217354068064012,0.10849673202614392,18049098.65370219,309895.8922208416,18358994.54592303,4284,39,2819.9758620689654,110,760,103,30.64542483660132,0.6803977272727273,34.37500000000001,135899.09574552235,1235.446324959294,0
4286,512.0772617798154,0,0,870,0.0,0.0,1.0,870,24400,17000,7400,0.6967213114754098,318,170,148,139.17304917537172,0.4110419174283207,0.9208950326449019,0.10799589006742114,18082606.68012441,304922.3017423795,18387528.981866788,4285,40,2820.9758620689654,105,765,105,30.548686351366392,0.6828373015873016,34.24724842767299,136085.94133561073,1296.0565841486737,0
4287,512.3053735362159,0,0,870,0.0,0.0,1.0,870,25200,18600,6600,0.7380952380952381,318,186,132,139.46089193930186,0.41082615218090995,0.92091275790676,0.10880407031916597,18112882.906322148,306007.7611415713,18418890.66746372,4286,41,2821.9758620689654,110,760,100,30.37559700263509,0.6833333333333333,34.08408408408412,136230.15263253023,1238.455933023002,0
4288,512.6359063836281,0,0,870,0.0,0.0,1.0,870,24550,19000,5550,0.7739307535641547,301,190,111,136.99297967571448,0.41048748616677466,0.9192048870882905,0.1073818313250041,18143882.415365588,298566.90299335204,18442449.31835894,4287,42,2822.9758620689654,117,753,81,30.297641759846087,0.6833155270655271,33.94244350282489,136390.65662514442,1165.7321079072171,0
4289,512.7378938727068,0,0,870,0.0,0.0,1.0,870,24250,17800,6450,0.734020618556701,307,178,129,134.97428049968835,0.41041625332328086,0.9181077374468758,0.10631866703342416,18167562.04682847,292180.72314082755,18459742.7699693,4288,43,2823.9758620689654,123,747,87,30.202284967444022,0.6836890243902439,33.79536290322582,136493.20496414916,1109.7008533670664,0
4290,512.5161231763268,0,0,870,0.0,0.0,1.0,870,23900,17200,6700,0.7196652719665272,306,172,134,134.48933631271586,0.41025157731836037,0.9175987128852858,0.10633420329994103,18175009.409509167,290968.9905924538,18465978.40010162,4289,44,2824.9758620689654,130,740,91,30.101529220908485,0.6836538461538462,33.68320610687024,136491.65074285638,1049.9357749450492,0
4291,512.6365669823804,0,0,870,0.0,0.0,1.0,870,24650,17300,7350,0.7018255578093306,320,173,147,133.38865237225787,0.410132148636077,0.9172068609348836,0.10591040595692026,18196501.34647734,286791.3584993202,18483292.704976663,4290,45,2825.9758620689654,134,736,97,30.00305281244874,0.6843128109452736,33.55709876543211,136588.37418571507,1019.3162252665304,0
4292,512.1718666638834,0,0,870,0.0,0.0,1.0,870,24800,17500,7300,0.7056451612903226,321,175,146,165.1634616597115,0.41002195128941094,0.9329801484777518,0.12255596654813684,17898465.466193125,392434.50295865594,18290899.96915178,4291,46,2826.9758620689654,127,743,80,31.261799954852357,0.6645341207349081,35.62825520833335,135403.77002313684,1066.1714175050145,8
4293,512.5884987522157,0,0,870,0.0,0.0,1.0,870,25300,18600,6700,0.7351778656126482,320,186,134,165.59593463999965,0.4097690678059513,0.9339196712282911,0.12339805551942089,17931008.91744892,394560.43614462967,18325569.35359355,4292,47,2827.9758620689654,131,739,87,31.115495156831166,0.665235368956743,35.495580808080824,135581.92314691373,1034.9765125718604,0
4294,512.8760863852816,0,1,869,0.0,0.0011494252873563218,0.9988505747126437,870,24650,17300,7350,0.7018255578093306,320,173,147,166.14847166329403,0.409653910338655,0.9349884782089146,0.12439315748423521,17960995.865008842,398188.4025043907,18359184.267513234,4293,48,2828.9758620689654,91,779,91,30.951591511936332,0.6755952380952381,35.34873188405796,135733.30664820576,1491.5747983319316,0
4295,512.3593379596538,0,0,869,0.0,0.0,1.0,869,23750,16600,7150,0.6989473684210527,309,166,143,162.5499978023756,0.40948548440126636,0.9321197624070225,0.12232220819383809,17964460.554265503,386474.60472333827,18350935.15898884,4294,49,2832.995397008055,100,769,100,30.885278729812494,0.6745833333333333,35.18976897689766,135677.99465193824,1356.7799465193823,0
4296,512.6578542062597,0,0,869,0.0,0.0,1.0,869,24050,17000,7050,0.7068607068607069,311,170,141,162.52866910717344,0.40943775752626305,0.9319931114739481,0.12292455834885452,17996160.03388788,387128.3878694933,18383288.421757374,4295,50,2833.995397008055,105,764,90,30.726945258316945,0.6749007936507936,35.0334119496855,135837.20246622636,1293.6876425354892,0
4297,512.7994763471203,0,0,869,0.0,0.0,1.0,869,25250,18100,7150,0.7168316831683168,324,181,143,160.0222311811867,0.4092824794641863,0.9306733000069409,0.12151365554855134,18017916.204256732,377603.43044815696,18395519.634704888,4296,51,2834.995397008055,110,759,74,30.667879141886118,0.675,34.90990990990988,135938.05938300744,1235.800539845522,0
4298,512.5634166667057,0,0,869,0.0,0.0,1.0,869,24100,17500,6600,0.7261410788381742,307,175,132,159.11554398480283,0.4091406798251429,0.9307462647885083,0.12136989479137475,18028448.78438835,375821.2871060091,18404270.071494356,4297,52,2835.995397008055,112,757,79,30.551186917836795,0.6759672619047619,34.77138643067842,135946.48436886194,1213.807896150553,0
4299,512.1139103359384,0,0,869,0.0,0.0,1.0,869,24550,17700,6850,0.7209775967413442,314,177,137,159.07574959161911,0.4090928977107009,0.930132600753294,0.11451585028215482,17766385.738702603,366890.22578359384,18133275.964486197,4298,53,2836.995397008055,125,744,90,32.40040382482791,0.6551666666666667,36.59060846560847,134895.61351788757,1079.1649081431005,8
4300,511.9151385678348,0,0,869,0.0,0.0,1.0,869,22700,16700,6000,0.73568281938326,287,167,120,164.0261957925347,0.40897043187518894,0.9322529811874332,0.1183324188457574,17768749.698980696,386408.0834227098,18155157.782403406,4299,54,2837.995397008055,130,739,90,32.2002162869071,0.6550480769230769,36.521946564885496,134878.40423381998,1037.5261864139998,0
4301,512.415233568845,0,0,869,0.0,0.0,1.0,869,23550,16100,7450,0.6836518046709129,310,161,149,157.48156305994917,0.409067929484426,0.9284758603616807,0.11284287784864977,17756668.01854684,361919.5668594714,18118587.58540631,4300,55,2838.995397008055,121,748,83,32.59423750527037,0.6543560606060606,36.7400956284153,134898.385387877,1114.8626891560082,8
4302,512.850851989287,0,0,869,0.0,0.0,1.0,869,23600,17400,6200,0.7372881355932204,298,174,124,158.75948982178326,0.4088776848576767,0.9291455840453697,0.11411704631044547,17785445.084785275,367321.63758276607,18152766.722368043,4301,56,2839.995397008055,126,743,87,32.457670227454415,0.6545138888888888,36.63877952755904,135065.02630022864,1071.9446531764177,0
4303,512.3151161979472,0,0,869,0.0,0.0,1.0,869,25100,17700,7400,0.7051792828685259,325,177,148,157.8966782574649,0.4087456625992763,0.929516566125868,0.11394165701281812,17783819.407230124,362701.2022264491,18146520.609456573,4302,57,2840.995397008055,132,737,92,32.3527881814398,0.6548295454545454,36.51315789473682,134988.29212978669,1022.6385767408083,0
4304,511.9885140792229,0,0,869,0.0,0.0,1.0,869,24650,17500,7150,0.7099391480730223,318,175,143,155.63066864401995,0.4087873131360269,0.9284986727439706,0.11261084594005757,17784181.78986656,355102.82064874907,18139284.610515308,4303,58,2841.995397008055,97,772,97,32.324432727077216,0.6629080756013745,36.4264455782313,134946.63247898102,1391.202396690526,0
4305,511.75247543426036,0,1,868,0.0,0.0011507479861910242,0.998849252013809,869,25050,18400,6650,0.7345309381237525,317,184,133,152.28098124898588,0.4087641678112279,0.9269343873130309,0.11074785527330576,17797860.85956936,343205.14316563285,18141066.002734993,4304,59,2842.995397008055,101,768,101,32.24810422717006,0.6634694719471947,36.264297385620935,134967.3986733035,1336.3108779535,0
4306,512.0070201266842,0,0,868,0.0,0.0,1.0,868,26300,18900,7400,0.7186311787072244,337,189,148,153.1935913234605,0.40873364684267127,0.9270866044891215,0.11174944306428397,17819737.078867175,346073.90391030256,18165810.982777476,4305,60,2847.15668202765,103,765,96,32.12612941801756,0.6639360841423948,36.167868589743605,135083.90341703797,1311.4942079324076,0
4307,511.74049162056565,0,0,868,0.0,0.0,1.0,868,23700,17900,5800,0.7552742616033755,295,179,116,152.20138729766273,0.4086988487678436,0.9267885089613146,0.11144756938392054,17826729.428441897,345350.5899977903,18172080.018439688,4306,61,2848.15668202765,108,760,96,32.030005430847254,0.663966049382716,36.047400611620816,135075.23297553658,1250.6966016253386,0
4308,512.0794064504881,0,0,868,0.0,0.0,1.0,868,24500,18100,6400,0.7387755102040816,309,181,128,149.88949158913087,0.4087121921823758,0.9253297805528624,0.10992791676366581,17845292.096757095,336864.3519284947,18182156.44868559,4307,62,2849.15668202765,112,756,77,32.04029761281238,0.6635974702380952,35.99741887905606,135190.2850418108,1207.0561164447392,0
4309,512.2865750968817,0,0,868,0.0,0.0,1.0,868,23150,17000,6150,0.734341252699784,293,170,123,152.44053438454043,0.408595118945744,0.926660814763232,0.11218730695569087,17867356.210975662,347991.8657680195,18215348.07674368,4308,63,2850.15668202765,114,754,80,31.861538857260463,0.6642909356725146,35.88768115942031,135301.19525973752,1186.8525899976976,0
4310,512.043761028903,0,0,868,0.0,0.0,1.0,868,24500,17500,7000,0.7142857142857143,315,175,140,152.38605519197898,0.4085148646745225,0.926706440758899,0.11260900484896684,17876422.22878119,346723.49287803756,18223145.72165923,4309,64,2851.15668202765,118,750,85,31.731374432702804,0.6648128531073446,35.75805322128853,135303.4402501715,1146.6393241539956,0
4311,512.1974507476685,0,0,868,0.0,0.0,1.0,868,23200,16700,6500,0.7198275862068966,297,167,130,155.73451042084753,0.4082269569750734,0.9285133026743502,0.11555893063483874,17899341.614682958,360709.040643639,18260050.655326597,4310,65,2852.15668202765,122,746,88,31.511209170217093,0.6653859289617486,35.62838753387537,135410.46595520157,1109.9218520918162,0
4312,512.2231852843194,0,0,868,0.0,0.0,1.0,868,24350,17200,7150,0.7063655030800822,315,172,143,156.0016904884672,0.4081486128607041,0.9289487932210545,0.11612198561087163,17913605.293711096,360960.5417124262,18274565.83542352,4311,66,2853.15668202765,128,740,91,31.403934619768762,0.6653645833333333,35.52971576227393,135467.81140529938,1058.3422766039014,0
4313,512.6688381831523,0,0,868,0.0,0.0,1.0,868,24600,17300,7300,0.7032520325203252,319,173,146,157.41623943665266,0.4081469795381783,0.9301942311877367,0.11739463536686243,17937141.552515723,366519.47388799815,18303661.02640372,4312,67,2854.15668202765,133,735,92,31.30696734158121,0.6651785714285714,35.47108208955227,135615.73301099785,1019.6671654962245,0
4314,512.3740851049848,0,0,868,0.0,0.0,1.0,868,21650,14600,7050,0.674364896073903,287,146,141,154.28824809526876,0.40794497353020903,0.9289264359436131,0.11564791693512502,17948329.1025917,358593.2506952343,18306922.353286937,4313,68,2855.15668202765,99,769,99,31.22868293322837,0.6736111111111112,35.31249999999997,135619.01565122418,1369.8890469820624,0
4315,511.88886904610905,1,0,869,0.0011507479861910242,0.0,1.0,869,24750,18200,6550,0.7353535353535353,313,182,131,152.38024676526157,0.40787459189102715,0.9280807998770861,0.11465299946268802,17947367.6517892,348414.8623132928,18295782.514102492,4314,0,2852.8699654775605,102,767,102,31.15905705774516,0.6740196078431373,35.19417475728151,135551.15440031438,1328.932886277592,0
4316,511.4820628366936,0,0,869,0.0,0.0,1.0,869,23950,17900,6050,0.7473903966597077,300,179,121,149.6182768933972,0.4077809058030577,0.9264465266705162,0.11292294517386929,17946081.761341356,339262.36602397606,18285344.127365332,4315,1,2853.8699654775605,107,762,94,31.134967231021275,0.6737733644859814,35.0983796296296,135492.42723581806,1266.2843666898884,0
4317,511.59247421618403,0,0,869,0.0,0.0,1.0,869,23300,18100,5200,0.776824034334764,285,181,104,147.08630504273242,0.4076098845009625,0.9250842749938601,0.11157634771651492,17971219.81316767,331564.0638859076,18302783.877053577,4316,2,2854.8699654775605,113,756,77,31.04287323037321,0.6740412979351033,34.94152046783623,135601.92335583764,1200.0170208481206,0
4318,511.890769185688,0,0,869,0.0,0.0,1.0,869,24200,17500,6700,0.7231404958677686,309,175,134,147.351425425208,0.40755342979465065,0.9245557805344569,0.11206927136921149,17992609.994394083,332247.3459587599,18324857.34035284,4317,3,2855.8699654775605,119,750,79,30.95425178976775,0.6736694677871149,34.8611111111111,135722.14977437127,1140.5222670115234,0
4319,511.9001349530953,0,0,869,0.0,0.0,1.0,869,24400,17400,7000,0.7131147540983607,314,174,140,149.36337339720117,0.40754867920292587,0.9253248367305789,0.11395643097264135,18006045.076457694,339688.7268323552,18345733.80329005,4318,4,2856.8699654775605,122,747,83,30.80292048490265,0.6740949453551912,34.76456639566395,135774.05425640184,1112.9020840688675,0
4320,511.7437082559559,0,0,869,0.0,0.0,1.0,869,23450,17000,6450,0.7249466950959488,299,170,129,152.70660688136167,0.4073719682386485,0.9267545883185733,0.11689679916261365,18014457.092957262,352935.3234950763,18367392.416452337,4319,5,2857.8699654775605,126,743,86,30.61018804739825,0.6744378306878307,34.66207349081365,135785.0144527573,1077.6588448631533,0
4321,511.5651166556942,0,0,869,0.0,0.0,1.0,869,24800,18500,6300,0.7459677419354839,311,185,126,154.93812892901795,0.4070938929044278,0.9286435180845387,0.11919120097063131,18028652.886522155,360065.1490696889,18388718.035591844,4320,6,2858.8699654775605,129,740,90,30.39778443445103,0.67546834625323,34.51121794871792,135814.7997608405,1052.8279051227946,0
4322,512.0619381163601,0,0,869,0.0,0.0,1.0,869,24200,17200,7000,0.7107438016528925,312,172,140,155.92699054056268,0.4070210873242723,0.9295599823994392,0.12028018654217526,18057498.927865945,365130.29290231504,18422629.220768258,4321,7,2859.8699654775605,137,732,93,30.286851367611263,0.6751064476885644,34.427838164251206,135989.39589936507,992.6233277325917,0
4323,511.61328446170336,0,0,869,0.0,0.0,1.0,869,23400,16600,6800,0.7094017094017094,302,166,136,156.50794679960566,0.40691585619362264,0.9302399204117395,0.12110710904982544,18054635.733313184,367938.79376713105,18422574.527080316,4322,8,2860.8699654775605,97,772,97,30.174575231388907,0.6840635738831615,34.332482993197296,135919.03095063652,1401.2271232024384,0
4324,511.2508105244005,0,0,869,0.0,0.0,1.0,869,26300,19500,6800,0.7414448669201521,331,195,136,150.57891488986846,0.4065539826309528,0.9269751124817165,0.11704267092092471,18060328.18298007,343800.9240696148,18404129.107049685,4323,9,2861.8699654775605,104,765,104,30.193987235471955,0.68359375,34.19642857142859,135892.29133313862,1306.6566474340252,0
4325,511.1121249948963,1,1,869,0.0011494252873563218,0.0011494252873563218,0.9988505747126437,870,23450,16200,7250,0.6908315565031983,307,162,145,143.7367786029493,0.40656852241313174,0.9221642718863532,0.11224996898427947,18074717.66732507,322150.3383318234,18396868.00565689,4324,0,2859.5793103448277,116,754,106,30.231872049814214,0.6823814655172413,34.054487179487175,135927.97619054947,1171.792898194392,0
4326,511.21230524719624,0,0,869,0.0,0.0,1.0,869,22900,16500,6400,0.7205240174672489,293,165,128,143.88875520826824,0.40636605806062726,0.9228679424544122,0.11294061512157302,18099063.6274964,324150.34715913713,18423213.974655535,4325,1,2863.522439585731,120,749,75,30.072657176749722,0.6831597222222222,33.90151515151514,136032.81986217934,1133.606832184828,0
4327,511.1537784976809,0,0,869,0.0,0.0,1.0,869,24300,17900,6400,0.7366255144032922,307,179,128,144.31001890359255,0.40616769323639473,0.9228088257367302,0.11366885050625375,18111305.943050694,324628.5806020753,18435934.52365277,4326,2,2864.522439585731,125,744,78,29.95471014492756,0.6833333333333333,33.79629629629628,136071.02899822436,1088.568231985795,0
4328,511.4575906702855,0,0,869,0.0,0.0,1.0,869,21750,15400,6350,0.7080459770114943,281,154,127,145.43011382401193,0.4060464426685333,0.9228494150179682,0.11490375066708627,18134607.87525945,331913.6174905578,18466521.492750008,4327,3,2865.522439585731,131,738,82,29.83148738084649,0.6832856234096691,33.704229797979785,136198.9930332125,1039.6869697191794,0
4329,511.783756231656,0,0,869,0.0,0.0,1.0,869,24400,17500,6900,0.7172131147540983,313,175,138,148.73636259917745,0.40564893966792703,0.9247960439858391,0.11816372044902358,18168543.351904668,342264.61037754954,18510807.962282218,4328,4,2866.522439585731,135,734,89,29.576907691128408,0.6843364197530863,33.54013480392155,136369.8306950285,1010.1468940372482,0
4330,511.6006896972922,0,0,869,0.0,0.0,1.0,869,22450,16500,5950,0.734966592427617,284,165,119,147.48910272735486,0.4054127358282115,0.9245739345833317,0.11764409772036229,18178323.275350455,339970.91779384034,18518294.193144295,4329,5,2867.522439585731,142,727,97,29.488992421758297,0.6845657276995305,33.4207459207459,136382.13024593453,960.4375369432009,0
4331,511.3441362953627,0,0,869,0.0,0.0,1.0,869,22050,15100,6950,0.6848072562358276,290,151,139,145.30122745729,0.4050139070810774,0.9238013183145317,0.1163953752417612,18186485.24253338,332653.72577480046,18519138.96830818,4330,6,2868.522439585731,105,764,105,29.418754605748003,0.6924603174603174,33.29402515723272,136378.53635078826,1298.8432033408405,0
4332,511.8566757081,0,0,869,0.0,0.0,1.0,869,21400,14000,7400,0.6542056074766355,288,140,148,147.00653973768146,0.4048355389336402,0.9243256764771295,0.11817666521555867,18218920.115334924,340460.0807825291,18559380.196117453,4331,7,2869.522439585731,108,761,108,29.267702997958374,0.6928047839506173,33.189984709480136,136568.4874722337,1264.5230321503122,0
4333,511.3881227056611,0,0,869,0.0,0.0,1.0,869,22450,15900,6550,0.7082405345211581,290,159,131,145.74031588866572,0.40464474191250427,0.9236411594699745,0.1177530162888077,18222584.98579213,334903.05842748424,18557488.044219613,4332,8,2870.522439585731,113,756,102,29.150265836071565,0.6932153392330384,33.040935672514635,136519.69474569353,1208.13889155481,0
4334,511.8643992579478,0,0,869,0.0,0.0,1.0,869,22550,16200,6350,0.7184035476718403,289,162,127,147.29603919395103,0.404508134780695,0.9243407725959674,0.11976014879331996,18264748.75063937,341715.0295683722,18606463.780207742,4333,9,2871.522439585731,117,752,76,28.921722512281615,0.6942663817663818,32.85663841807911,136741.17629187947,1168.7280024946963,0
4335,512.2450002710146,0,0,869,0.0,0.0,1.0,869,23700,17200,6500,0.7257383966244726,302,172,130,146.12306635552602,0.40419443000853783,0.9237417665040568,0.11909029907975469,18287876.12496735,336956.107302054,18624832.232269406,4334,10,2872.522439585731,121,748,78,28.882285276073652,0.6942148760330579,32.78688524590166,136878.58203963295,1131.2279507407682,0
4336,512.4234563544471,0,0,869,0.0,0.0,1.0,869,24150,18300,5850,0.7577639751552795,300,183,117,143.87424197940075,0.40403699760835327,0.9228570253438151,0.11779906850837987,18312644.668270256,328993.5740571036,18641638.24232736,4335,11,2873.522439585731,126,743,85,28.806118014010302,0.6946924603174602,32.652559055118125,136995.09973649392,1087.2626963213804,0
4337,512.2371968942417,0,0,869,0.0,0.0,1.0,869,22000,15400,6600,0.7,286,154,132,145.72660016415796,0.40375052587945603,0.9227358002710675,0.11975358408310474,18320567.53916429,338158.8041120524,18658726.34327634,4336,12,2874.522439585731,130,739,92,28.648605123631146,0.6951121794871795,32.54611959287533,136999.82599823407,1053.8448153710312,0
4338,512.634718654411,0,0,869,0.0,0.0,1.0,869,25450,18600,6850,0.730844793713163,323,186,137,148.43677899122457,0.403571494858755,0.9241533415736092,0.12239316454548,18348198.204090487,345459.48834155314,18693657.69243204,4337,13,2875.522439585731,132,737,95,28.476857137281325,0.6957859848484849,32.4483082706767,137156.28621517366,1039.0627743573762,0
4339,512.1486476616802,0,0,869,0.0,0.0,1.0,869,24650,17400,7250,0.7058823529411765,319,174,145,149.0837856876597,0.4031099141093016,0.9252845818878197,0.12336398754612525,18344866.371795382,348534.42532830243,18693400.797123685,4338,14,2876.522439585731,134,735,99,28.355387069495716,0.6965174129353233,32.34567901234569,137078.7985346334,1022.9761084674134,0
4340,512.1937790153564,0,0,869,0.0,0.0,1.0,869,24900,18200,6700,0.7309236947791165,316,182,134,149.8195366607394,0.4029423176524034,0.924502669261684,0.12001788875457887,18216806.93181872,347146.71479265054,18563953.64661137,4339,15,2877.522439585731,103,766,103,29.297481347954555,0.6929611650485437,33.293269230769255,136605.52832152482,1326.2672652575225,8
4341,511.7742826971909,0,0,869,0.0,0.0,1.0,869,25050,18000,7050,0.718562874251497,321,180,141,147.408266717736,0.40267390921994844,0.9228527555936163,0.11857044622625414,18218395.680042543,338258.42591459694,18556654.10595714,4340,16,2878.522439585731,109,760,109,29.239088322627225,0.6927561162079511,33.172348484848506,136555.5299579439,1252.8030271371,0
4342,511.4560417830008,0,0,869,0.0,0.0,1.0,869,23400,17500,5900,0.7478632478632479,293,175,118,148.84463456304485,0.40235252616581735,0.9227611697098617,0.12038761356987146,18229221.471365526,345464.3616548456,18574685.83302037,4341,17,2879.522439585731,115,754,108,29.036055428494556,0.6931159420289855,33.01005747126438,136553.6192016188,1187.4227756662503,0
4343,511.19223459096537,0,0,869,0.0,0.0,1.0,869,24450,18100,6350,0.7402862985685071,308,181,127,150.1454443526766,0.4022164714283947,0.9235447955314346,0.12198717731273423,18237826.33129924,349415.3077079766,18587241.63900722,4342,18,2880.522439585731,118,751,78,28.867438392974194,0.6938559322033898,32.87815126050421,136550.61476521334,1157.2085997051977,0
4344,511.17292799514473,0,0,869,0.0,0.0,1.0,869,24750,17500,7250,0.7070707070707071,320,175,145,148.4037462232602,0.40207555562036984,0.922542222967907,0.12086056255404999,18246681.349232364,343025.17367363896,18589706.522906,4343,19,2881.522439585731,122,747,81,28.84304014791335,0.693818306010929,32.80826558265584,136581.18121821602,1119.5178788378362,0
4345,510.736803583153,0,0,869,0.0,0.0,1.0,869,24100,16900,7200,0.7012448132780082,313,169,144,154.05853200205448,0.4017906858351938,0.925021120048994,0.12611454858708057,18251641.99681411,364464.2345312512,18616106.23134536,4344,20,2882.522439585731,127,742,84,28.53924411230506,0.6944717847769029,32.657877604166686,136541.4610555854,1075.1296146109084,0
4346,511.0320981842616,0,1,868,0.0,0.0011507479861910242,0.998849252013809,869,24800,18300,6500,0.7379032258064516,313,183,130,154.555181017987,0.40155061523477203,0.926384707075729,0.12730024880712404,18286554.09386831,366656.335634611,18653210.429502923,4345,21,2883.522439585731,132,737,91,28.34497077221849,0.6954703282828283,32.479636591478716,136711.49261967422,1035.6931259066228,0
4347,510.822881522085,0,0,868,0.0,0.0,1.0,868,23950,16700,7250,0.697286012526096,312,167,145,156.44863531932117,0.4013485098340412,0.9271405438291831,0.12932272928063449,18293243.887447625,374840.6083509406,18668084.495798565,4346,22,2887.692396313364,135,733,97,28.18897689438388,0.6960648148148147,32.375919117647065,136708.50416102356,1012.6555863779523,0
4348,511.37820635809226,0,0,868,0.0,0.0,1.0,868,23750,17300,6450,0.728421052631579,302,173,129,156.34190552045493,0.40102109787621565,0.9280884354502321,0.129705322000813,18327487.12621507,375720.8521428064,18703207.978357878,4347,23,2888.692396313364,100,768,100,28.085314020827692,0.7040625,32.27103960396036,136910.7555574416,1369.107555574416,0
4349,511.756634515691,0,0,868,0.0,0.0,1.0,868,22250,15500,6750,0.6966292134831461,290,155,135,154.3733496893953,0.40069075147453037,0.9272659690543317,0.12847149073590708,18353321.13958304,370802.7324485173,18724123.87203156,4348,24,2889.692396313364,103,765,103,28.04708634080056,0.7041868932038835,32.18149038461535,137057.89914177574,1330.6592149686965,0
4350,512.0245804546813,0,0,868,0.0,0.0,1.0,868,24000,17300,6700,0.7208333333333333,307,173,134,151.38339141445633,0.40043955200676096,0.9255111487381189,0.1264985728493962,18378991.491876546,358854.8125635327,18737846.304440077,4349,25,2890.692396313364,109,759,109,28.008293866779745,0.7039373088685015,32.064393939393895,137189.61628205012,1258.620332862845,0
4351,512.1703629882381,0,0,868,0.0,0.0,1.0,868,24250,17100,7150,0.7051546391752578,314,171,143,152.49657849018342,0.4001417336384269,0.9258252058326042,0.12800660489485813,18401976.919374533,363397.7035319789,18765374.622906514,4350,26,2891.692396313364,110,758,96,27.847161444658383,0.7050189393939394,31.93506006006002,137294.91759345704,1248.135614485973,0
4352,511.85712771123696,0,1,867,0.0,0.001152073732718894,0.9988479262672811,868,23500,17200,6300,0.7319148936170212,298,172,126,151.4746170628178,0.3999201554435816,0.9254972560176602,0.1275559709309165,18403228.35221123,360424.3934741475,18763652.745685376,4351,27,2892.692396313364,113,755,76,27.782048988539422,0.7052912979351033,31.84393274853797,137257.59436167218,1214.6689766519662,0
4353,512.2501456540346,0,0,867,0.0,0.0,1.0,867,22750,16000,6750,0.7032967032967034,295,160,135,150.49603990573902,0.3996334461874231,0.9250049987861724,0.12717668689253375,18431040.34038572,358609.7165141835,18789650.056899905,4352,28,2896.6851211072662,117,750,79,27.70720898600318,0.7054843304843305,31.74435028248583,137413.99564031156,1174.4785952163381,0
4354,512.3664299256345,0,0,867,0.0,0.0,1.0,867,22950,17100,5850,0.7450980392156863,288,171,117,151.01762909223632,0.39945181192524104,0.9248329303318745,0.12815606705969398,18451632.083461184,360954.3460253,18812586.429486483,4353,29,2897.6851211072662,124,743,83,27.572064379237112,0.7053931451612903,31.62499999999996,137506.34063128964,1108.922101865239,0
4355,512.4424986782299,0,0,867,0.0,0.0,1.0,867,25250,19100,6150,0.7564356435643564,314,191,123,154.2976186023738,0.39928688157779074,0.9256580583317524,0.13140592272775695,18468188.964859575,371269.51543528255,18839458.480294857,4354,30,2898.6851211072662,128,739,86,27.38203551090787,0.7057291666666667,31.52454780361753,137578.23155727918,1074.8299340412436,0
4356,512.3116335304015,0,0,867,0.0,0.0,1.0,867,23250,16600,6650,0.7139784946236559,299,166,133,153.7181170896836,0.399069231233679,0.925627057632652,0.1314363531755029,18478950.96781448,371459.90971299686,18850410.877527475,4355,31,2899.6851211072662,134,733,92,27.28335344307504,0.7059235074626866,31.412037037037006,137600.7380521564,1026.8711794937044,0
4357,512.284840541134,0,0,867,0.0,0.0,1.0,867,23300,16700,6600,0.7167381974248928,299,167,132,154.28314955521256,0.3988527462789671,0.9260540031226676,0.13232917411132544,18489970.477744404,373838.17609785276,18863808.653842255,4356,32,2900.6851211072662,138,729,97,27.179736602328042,0.706219806763285,31.3249400479616,137638.16024490757,997.3779727891853,0
4358,512.3187004249536,0,0,867,0.0,0.0,1.0,867,25100,19200,5900,0.7649402390438247,310,192,118,153.93559505700293,0.39847893375527094,0.9257599621537176,0.13235017265061594,18500506.376757894,371077.2915924128,18871583.668350305,4357,33,2901.6851211072662,142,725,102,27.12037739769961,0.7063526995305165,31.257284382284354,137681.91881393886,969.5909775629497,0
4359,511.88351549574736,0,0,867,0.0,0.0,1.0,867,22300,15800,6500,0.7085201793721974,288,158,130,151.67807915559172,0.39816588796456864,0.925056660404278,0.13090248862898157,18499314.77018852,365488.1060073784,18864802.8761959,4358,34,2902.6851211072662,105,762,105,27.07389063528037,0.7140873015873016,31.151729559748453,137618.99780790877,1310.6571219800835,0
4360,511.9259819429389,0,0,867,0.0,0.0,1.0,867,24000,17300,6700,0.7208333333333333,307,173,134,149.19658797857443,0.39790278743386137,0.9237868966973681,0.1291824115424254,18513392.985066436,355027.0130556829,18868419.99812212,4359,35,2903.6851211072662,109,758,109,27.04812206572772,0.7140672782874617,31.060606060606084,137677.0633255645,1263.0923240877476,0
4361,512.1188351769986,0,1,866,0.0,0.0011534025374855825,0.9988465974625144,867,24350,18300,6050,0.7515400410677618,304,183,121,150.4655726017798,0.39761809945188964,0.9244915780776279,0.1308508343423519,18537074.702307045,360088.3118889233,18897163.014195967,4360,36,2904.6851211072662,113,754,104,26.890890669926897,0.7144174041297935,30.939327485380133,137791.03820012792,1219.389718585203,0
4362,511.7064221003329,0,0,866,0.0,0.0,1.0,866,23550,17000,6550,0.721868365180467,301,170,131,146.9944403474317,0.39721317420692664,0.9225935770621816,0.1284660746133095,18541011.68753985,348335.12729702465,18889346.814836875,4361,37,2908.714780600462,120,746,75,26.84528568382903,0.7144097222222222,30.802341597796158,137750.17061878025,1147.9180884898353,0
4363,511.6582948914846,0,0,866,0.0,0.0,1.0,866,25400,17900,7500,0.7047244094488189,329,179,150,147.89317097873786,0.396922571609108,0.9231201056350007,0.1296735089960185,18551662.97683023,350132.85291445715,18901795.829744685,4362,38,2909.714780600462,123,743,78,26.72978537559274,0.7147696476964769,30.71236559139786,137783.2518568674,1120.1890394867269,0
4364,512.07751753183,0,0,866,0.0,0.0,1.0,866,24500,17900,6600,0.7306122448979592,311,179,132,147.62696870351277,0.39655851878056486,0.9223416549228463,0.12985147655349835,18578912.4480919,350849.70530395565,18929762.153395858,4363,39,2910.714780600462,129,737,82,26.648298530549074,0.7146317829457365,30.625000000000004,137940.8812851371,1069.3091572491248,0
4365,512.2995657419566,0,0,866,0.0,0.0,1.0,866,23100,16200,6900,0.7012987012987013,300,162,138,147.47757101239702,0.3963357206744183,0.9225442429421817,0.13003612538439788,18596195.615675054,352204.35189422837,18948399.967569284,4364,40,2911.714780600462,133,733,84,26.584483761768762,0.7146773182957393,30.55814676616915,138034.94440439914,1037.8567248451063,0
4366,511.81458558978005,0,0,866,0.0,0.0,1.0,866,21700,15800,5900,0.728110599078341,276,158,118,145.35269969848673,0.39595339567564203,0.9210842651042979,0.128511370299689,18588868.56980395,345488.446192267,18934357.015996218,4365,41,2912.714780600462,139,727,90,26.566137766980436,0.7145533573141487,30.483630952380942,137942.40873376865,992.3914297393428,0
4367,511.6732512919234,0,0,866,0.0,0.0,1.0,866,24350,17200,7150,0.7063655030800822,315,172,143,145.92210921488962,0.39561924023370576,0.9216017913451477,0.12951225410583878,18598249.821520697,345229.16833234625,18943478.989853043,4366,42,2913.714780600462,146,720,96,26.44402612420826,0.7146832191780822,30.37840136054421,137958.15999437572,944.9189040710665,0
4368,511.42100839757416,0,0,866,0.0,0.0,1.0,866,25650,18900,6750,0.7368421052631579,324,189,135,146.41799242981529,0.39523658149666036,0.9229495305454591,0.13047397282957962,18604140.78902124,345946.1890420199,18950086.97806326,4367,43,2914.714780600462,153,713,101,26.31986587924535,0.7149373638344226,30.26920995670994,137945.9926398124,901.6077950314536,0
4369,511.3996161985186,0,0,866,0.0,0.0,1.0,866,24400,18200,6200,0.7459016393442623,306,182,124,143.98515754068333,0.39500335406960446,0.9223218776886797,0.12904743999068363,18624948.551258415,338743.23026801355,18963691.781526428,4368,44,2915.714780600462,108,758,108,26.226792016335576,0.7238618827160495,30.11276758409786,138020.22707437276,1277.9650655034513,0
4370,511.0534234056455,0,0,866,0.0,0.0,1.0,866,22550,15400,7150,0.6829268292682927,297,154,143,144.62518029156837,0.3946432504772457,0.9222365295965527,0.13026939671281182,18630950.16095811,343150.9052063611,18974101.06616447,4369,45,2916.714780600462,112,754,112,26.07267627110928,0.7243303571428572,29.9778761061947,137995.7308111932,1232.1047393856536,0
4371,511.4884182297499,0,0,866,0.0,0.0,1.0,866,26550,19600,6950,0.7382297551789078,335,196,139,145.59559846613212,0.3942603414364985,0.9221856949307883,0.131931610231464,18669089.96001987,343877.46510943334,19012967.425129306,4370,46,2917.714780600462,116,750,101,25.882843993365604,0.7251257183908046,29.81659544159545,138195.68222950748,1191.3420881854092,0
4372,511.64485069327486,0,0,866,0.0,0.0,1.0,866,22900,16900,6000,0.7379912663755459,289,169,120,144.81824356887458,0.3939239888842907,0.9204740555122353,0.13177804878597593,18690326.241026197,345240.0435909314,19035566.28461713,4371,47,2918.714780600462,123,743,82,25.789926239018747,0.7249322493224932,29.704301075268816,138295.40251937832,1124.3528660112058,0
4373,511.16653906310523,0,0,866,0.0,0.0,1.0,866,25450,19000,6450,0.7465618860510805,319,190,129,147.43679433691597,0.39344649285577615,0.920685423535591,0.1348758721425205,18692473.14187441,352541.66365337564,19045014.805527788,4372,48,2919.714780600462,128,738,89,25.575092313357825,0.7255045572916667,29.562338501292,138238.6834606149,1079.989714536054,0
4374,510.9908891613082,0,1,865,0.0,0.0011547344110854503,0.9988452655889145,866,25000,18200,6800,0.728,318,182,136,146.01000824287482,0.3930439210686744,0.9201762744366335,0.13405821422268313,18699451.155093033,347861.4034584789,19047312.558551513,4373,49,2920.714780600462,135,731,92,25.515303690910958,0.7253858024691358,29.465379901960798,138240.72607281484,1024.005378317147,0
4375,511.2002666609135,0,0,865,0.0,0.0,1.0,865,24350,17800,6550,0.731006160164271,309,178,131,144.87423077883017,0.392589080229073,0.9193844304355043,0.13337323431994777,18716976.106444973,344971.50318539544,19061947.60963037,4374,50,2924.428901734104,141,724,96,25.47369021478856,0.7252511820330969,29.39407276995307,138333.8221600249,981.0909373051411,0
4376,511.29654052386144,0,0,865,0.0,0.0,1.0,865,26700,19100,7600,0.7153558052434457,343,191,152,145.3466437853366,0.3922164351851852,0.9195229078276712,0.1341153122201073,18728905.90084269,344736.7228917802,19073642.62373447,4375,51,2925.428901734104,149,716,99,25.39928417487686,0.7248322147651007,29.333333333333353,138390.9303017933,928.7981899449214,0
4377,511.7934981394595,0,0,865,0.0,0.0,1.0,865,23650,17000,6650,0.718816067653277,303,170,133,149.1782999210733,0.3918714430350389,0.9221193325914574,0.13809410221744192,18758881.551608413,363033.6116579522,19121915.163266364,4376,52,2926.428901734104,152,713,101,25.20933916716962,0.725328947368421,29.248366013071916,138568.92588514605,911.6376702970134,0
4378,511.7154267889852,0,0,865,0.0,0.0,1.0,865,22200,16400,5800,0.7387387387387387,280,164,116,146.30365581730211,0.39145118595232997,0.9205891015732603,0.13604558339792666,18772497.173465043,354096.993059575,19126594.16652462,4377,53,2927.428901734104,111,754,111,25.166529322895173,0.7331081081081081,29.129464285714256,138608.6317875952,1248.7264125008576,0
4379,511.93191946092986,0,0,865,0.0,0.0,1.0,865,22500,16100,6400,0.7155555555555555,289,161,128,145.38822348781594,0.3910147608470706,0.9197603574524318,0.135697174257495,18793961.221806828,350984.12686747545,19144945.348674305,4378,54,2928.428901734104,115,750,115,25.09241231703946,0.7332427536231885,29.031968390804575,138717.18453424412,1206.2363872542967,0
4380,511.79593426446206,0,0,865,0.0,0.0,1.0,865,24300,17300,7000,0.7119341563786008,313,173,140,145.93778058303266,0.39059946567473064,0.919376100126045,0.1368659726008427,18806407.66871609,351613.0791824238,19158020.747898515,4379,55,2929.428901734104,119,746,119,24.949967979506834,0.733718487394958,28.90624999999997,138744.67905450487,1165.9216727269318,0
4381,512.2975187579434,0,0,865,0.0,0.0,1.0,865,24600,18400,6200,0.7479674796747967,308,184,124,147.5403443011212,0.3901855085456362,0.9196382874375524,0.13892044826682617,18839249.531615186,358309.87245384196,19197559.40406903,4380,56,2930.428901734104,122,743,104,24.801249622667008,0.7342042349726776,28.802506775067727,138933.80287250545,1138.8016628893888,0
4382,512.3800753619673,0,0,865,0.0,0.0,1.0,865,24500,17800,6700,0.726530612244898,312,178,134,143.8728382873562,0.38962107730321843,0.9169419833986578,0.13597378107168884,18855771.641982306,345066.67684604146,19200838.318828348,4381,57,2931.428901734104,130,735,76,24.802279344236656,0.7338141025641025,28.705470737913462,139005.91134859572,1069.276241143044,0
4383,512.6343159916272,0,0,865,0.0,0.0,1.0,865,23750,16400,7350,0.6905263157894737,311,164,147,141.62809156040214,0.38935157309284235,0.9215978608417541,0.12081908731396646,18481628.60245463,326753.5575787489,18808382.16003338,4382,58,2932.428901734104,132,733,91,27.67409216858677,0.7055713383838385,31.4771303258145,137654.03762353255,1042.833618360095,8
4384,512.8260147977159,0,0,865,0.0,0.0,1.0,865,22650,16200,6450,0.7152317880794702,291,162,129,139.68126582226822,0.3890484505459217,0.9205252155050092,0.11946346227946666,18498454.31841126,321127.50299020903,18819581.82140147,4383,59,2933.428901734104,140,725,95,27.653374865912976,0.7051339285714286,31.4051418439716,137742.4307033115,983.8745050236535,0
4385,513.269747158331,0,0,865,0.0,0.0,1.0,865,25600,18500,7100,0.72265625,327,185,142,141.64886741283064,0.3886703975772497,0.9219143989436074,0.1216619032279404,18530900.281275544,326376.20739654335,18857276.48867209,4384,60,2934.428901734104,144,721,101,27.479615024729267,0.7058015046296297,31.285919540229838,137922.80813546613,957.7972787185148,0
4386,513.3147518895405,0,0,865,0.0,0.0,1.0,865,21650,14800,6850,0.6836027713625866,285,148,137,148.32080642666833,0.3884943333868551,0.9241968721741609,0.1198041126982175,18290099.373710856,347910.45774654124,18638009.8314574,4385,61,2935.428901734104,109,756,104,29.089807260257786,0.6939984709480123,33.04924242424243,137029.76189172518,1257.1537788231667,8
4387,513.6046051952858,0,0,865,0.0,0.0,1.0,865,23250,16300,6950,0.7010752688172043,302,163,139,146.10385770552554,0.388508605848141,0.923078507082616,0.11839112318521343,18313298.232756816,338878.7038235131,18652176.93658033,4386,62,2936.428901734104,112,753,99,29.05375861553156,0.6942894345238095,32.955383480825965,137155.3448368573,1224.6012931862258,0
4388,513.8583907028286,0,0,865,0.0,0.0,1.0,865,24150,18200,5950,0.7536231884057971,301,182,119,144.47203406705063,0.38826993238421464,0.9225047235389958,0.11772966662922606,18344964.16241265,332916.85748618405,18677881.019898836,4387,63,2937.428901734104,118,747,81,28.930187927231408,0.6947387005649718,32.79061624649861,137307.7839162695,1163.6252874260126,0
4389,513.337682675299,0,0,865,0.0,0.0,1.0,865,23400,16200,7200,0.6923076923076923,306,162,144,145.04887003511809,0.38811137425961606,0.9220871025709925,0.118715396363595,18343789.034297958,335749.17431750416,18679538.208615463,4388,64,2938.428901734104,125,740,85,28.786007514611793,0.69475,32.66369047619049,137233.8016259196,1097.8704130073568,0
4390,513.7232062721687,0,0,865,0.0,0.0,1.0,865,24000,17800,6200,0.7416666666666667,302,178,124,146.899858659459,0.3879527046314137,0.9227330516254315,0.12050988405072526,18366841.910613623,342617.29613795853,18709459.20675158,4389,65,2939.428901734104,129,736,86,28.667995125654265,0.6947674418604651,32.59615384615386,137371.56121566464,1064.8958233772453,0
4391,513.2460926560661,0,0,865,0.0,0.0,1.0,865,24600,19000,5600,0.7723577235772358,302,190,112,146.67117066118843,0.3877110763219867,0.9232173569141198,0.12080653909511116,18365778.725385636,341146.05315133673,18706924.77853697,4390,66,2940.428901734104,132,733,91,28.555884103795226,0.6954703282828283,32.479636591478716,137303.78122535575,1040.1801607981497,0
4392,513.23321388095,0,0,865,0.0,0.0,1.0,865,23300,18200,5100,0.7811158798283262,284,182,102,151.25928170206114,0.38748015235852423,0.9241872021093196,0.12495331966692089,18377027.396451507,359639.1927612742,18736666.589212783,4391,67,2941.428901734104,141,724,95,28.34658260233918,0.6950354609929078,32.39436619718311,137344.09948926917,974.0716275834693,0
4393,513.2530595223849,0,0,865,0.0,0.0,1.0,865,23300,17100,6200,0.7339055793991416,295,171,124,151.4595670451527,0.38736692044886895,0.9247820729622005,0.12547414422715567,18388983.99101759,360737.5107359588,18749721.50175355,4392,68,2942.428901734104,149,716,100,28.258116714660027,0.6948406040268457,32.312500000000014,137391.42837089958,922.090123294628,0
4394,512.9088411524293,0,0,865,0.0,0.0,1.0,865,25350,18400,6950,0.7258382642998028,323,184,139,150.01431911678844,0.3872118746877899,0.9233096536797643,0.12479213139715081,18393007.733387556,353492.9063267827,18746500.639714338,4393,69,2943.428901734104,105,760,105,28.175913694407758,0.7035714285714285,32.193396226415054,137360.3747944751,1308.1940456616676,0
4395,513.2862631316284,0,1,864,0.0,0.0011560693641618498,0.9988439306358381,865,24650,17700,6950,0.718052738336714,316,177,139,152.1307170032168,0.38689420092057375,0.9229759042182151,0.1272190932637932,18427252.88557456,363020.2387764033,18790273.124350965,4394,70,2944.428901734104,112,753,112,27.966320352277414,0.7034970238095238,32.0427728613569,137538.7637971053,1228.0246767598687,0
4396,513.3803005839814,0,0,864,0.0,0.0,1.0,864,25250,18600,6650,0.7366336633663366,319,186,133,153.6676961555375,0.38668024798649553,0.9224781131315778,0.12927753916342286,18454197.576684963,369112.80520165036,18823310.381886613,4395,71,2948.6643518518517,118,746,77,27.751229691053727,0.704007768361582,31.871498599439754,137651.8906441507,1166.5414461368703,0
4397,512.9202798980018,0,0,864,0.0,0.0,1.0,864,24200,17100,7100,0.7066115702479339,313,171,142,155.41363261259252,0.3864035531826245,0.9230171263217255,0.13130616361678007,18454374.779208828,376612.28440620715,18830987.063615035,4396,72,2949.6643518518517,124,740,80,27.58102930516724,0.704133064516129,31.749999999999986,137590.86508263805,1109.6037506664359,0
4398,512.8629858263762,0,0,864,0.0,0.0,1.0,864,24950,18500,6450,0.7414829659318637,314,185,129,157.9319125065274,0.38619556407629146,0.9237252535828642,0.13384154493835415,18464217.519077204,385467.8371448773,18849685.356222082,4397,73,2950.6643518518517,130,734,81,27.425596120033944,0.7040064102564103,31.66348600508905,137619.8657736709,1058.6143521051608,0
4399,512.430955646099,0,0,864,0.0,0.0,1.0,864,23650,16200,7450,0.6849894291754757,311,162,149,155.30208919984864,0.3860284239857374,0.9228546275989764,0.13220378421449996,18466082.482359353,377114.23776942724,18843196.720128782,4398,74,2951.6643518518517,137,727,88,27.367546720650804,0.704227493917275,31.536835748792267,137568.83581302184,1004.1520862264368,0
4400,512.7370746170338,0,0,864,0.0,0.0,1.0,864,22300,15800,6500,0.7085201793721974,288,158,130,154.91227616142115,0.3857258003948328,0.9231828075165935,0.13223968474971615,18487921.37488643,377701.19633540895,18865622.57122184,4399,75,2952.6643518518517,139,725,93,27.29829325058185,0.704736211031175,31.45833333333333,137691.26857944898,990.5846660392014,0
4401,512.6601413831042,0,0,864,0.0,0.0,1.0,864,24350,18400,5950,0.75564681724846,303,184,119,156.56127693843774,0.38556125877108277,0.9248745936525857,0.1340103047903618,18495651.900491245,381990.57586994703,18877642.476361193,4400,76,2953.6643518518517,141,723,96,27.176525206182724,0.7052304964539007,31.382042253521114,137709.72019634966,976.6646822436146,0
4402,512.1328244009344,0,0,864,0.0,0.0,1.0,864,23100,16300,6800,0.7056277056277056,299,163,136,155.8578856307451,0.3855036733938457,0.9253243481386422,0.1338022599443437,18488016.30852954,380400.62627082964,18868416.93480037,4401,77,2954.6643518518517,147,717,100,27.1113552226035,0.7052862811791383,31.299268018018022,137610.4647885312,936.1256108063346,0
4403,512.5448522220337,0,1,863,0.0,0.0011574074074074073,0.9988425925925926,864,23300,17300,6000,0.7424892703862661,293,173,120,154.74515128617998,0.38531742199905583,0.9250829941464873,0.1333147755316827,18516445.22135714,376966.0234122411,18893411.244769383,4402,78,2955.6643518518517,105,759,105,27.041328495350903,0.7135912698412699,31.20086477987424,137771.6130388113,1312.1106003696316,0
4404,512.8710798942055,0,0,863,0.0,0.0,1.0,863,24550,16300,8250,0.6639511201629328,328,163,165,153.39141346016103,0.3849391477776314,0.924809203743048,0.13270062680895936,18544275.90621777,371756.5385699969,18916032.444787767,4403,79,2959.710312862109,106,757,106,26.95956871689053,0.7145243710691824,31.08450155763243,137918.98208642722,1301.1224725134643,0
4405,512.8973358166924,0,0,863,0.0,0.0,1.0,863,23950,17300,6650,0.7223382045929019,306,173,133,150.40087320855014,0.38481525219584195,0.9234021062562145,0.13073306671204912,18563452.610667333,361841.8964819895,18925294.507149324,4404,80,2960.710312862109,111,752,105,26.905881268436577,0.7147147147147147,30.952380952380985,137993.8070173501,1243.1874506067577,0
4406,512.9728821538392,0,0,863,0.0,0.0,1.0,863,22250,15400,6850,0.6921348314606741,291,154,137,149.66379582703442,0.3845536824096951,0.9230965265417115,0.13059309904872668,18580884.952939935,361327.1543764916,18942212.107316427,4405,81,2961.710312862109,115,748,102,26.817642822985174,0.714945652173913,30.845905172413826,138068.7517672166,1200.5978414540573,0
4407,512.4660713610615,0,0,863,0.0,0.0,1.0,863,21900,15100,6800,0.6894977168949772,287,151,136,149.47005760919032,0.3844080546914978,0.9233559393344297,0.13085274560723406,18575039.40610135,360782.44202459615,18935821.848125946,4406,82,2962.710312862109,119,744,78,26.730804881194175,0.7150735294117647,30.755208333333357,137978.82061984562,1159.4858875617278,0
4408,512.8395253880295,0,1,862,0.0,0.0011587485515643105,0.9988412514484357,863,25000,18100,6900,0.724,319,181,138,148.84512506378567,0.3840847051464387,0.9234602866648367,0.1309151472240188,18606332.577448864,356292.3798937559,18962624.95734262,4407,83,2963.710312862109,126,737,80,26.61714928039298,0.7151124338624338,30.626640419947513,138145.30587921356,1096.391316501695,0
4409,512.5626284285447,0,0,862,0.0,0.0,1.0,862,23150,16500,6650,0.712742980561555,298,165,133,150.74334178829184,0.38374636656956557,0.9249199029534807,0.13297998682205434,18607578.044147726,365443.69939225895,18973021.743539985,4408,84,2967.496519721578,129,733,81,26.483015146108396,0.7154392764857881,30.544871794871806,138112.62875637185,1070.6405329951306,0
4410,512.0915389556494,0,0,862,0.0,0.0,1.0,862,24250,18100,6150,0.7463917525773196,304,181,123,149.89243617100522,0.38335467243883575,0.9246752829064191,0.13249290061855803,18598008.582529295,360890.16287291737,18958898.745402213,4409,85,2968.496519721578,132,730,84,26.450541493514674,0.7155145202020202,30.49028822055138,138013.6430686316,1045.5579020350879,0
4411,512.0204984723109,0,0,862,0.0,0.0,1.0,862,24450,17900,6550,0.7321063394683026,310,179,131,148.51004462443365,0.3830779545987372,0.9241301642448212,0.13175563273461297,18609340.37330688,355884.79385421507,18965225.167161096,4410,86,2969.496519721578,137,725,91,26.385505907385657,0.7157846715328466,30.389492753623188,138046.10631366234,1007.6358125084843,0
4412,512.1336441374832,0,0,862,0.0,0.0,1.0,862,21200,14800,6400,0.6981132075471698,276,148,128,150.9695868354717,0.3829939399410567,0.9261261414087341,0.13427957484298642,18623057.424165726,368703.05698791594,18991760.48115364,4411,87,2970.496519721578,139,723,92,26.248591759782965,0.7162020383693046,30.319940476190485,138112.2316351427,993.6131772312424,0
4413,512.5004687939903,0,0,862,0.0,0.0,1.0,862,24450,17300,7150,0.7075664621676891,316,173,143,153.97900304679547,0.3828244509657559,0.928733297861047,0.12300545839800597,18216388.89807009,364138.28032750566,18580527.178397596,4412,88,2971.496519721578,145,717,92,29.27069396128802,0.6846264367816092,33.376141552511406,136644.85244599966,942.3782927310322,8
4414,511.9765623681918,0,1,861,0.0,0.001160092807424594,0.9988399071925754,862,25250,18400,6850,0.7287128712871287,321,184,137,151.2956213412163,0.3825909334457945,0.927900479080447,0.12155423874296178,18220853.45554713,353697.06898484833,18574550.52453198,4413,89,2972.496519721578,98,764,98,29.170610506389004,0.6951530612244898,33.2070707070707,136591.72680353362,1393.7931306483022,0
4415,512.1312396236309,0,0,861,0.0,0.0,1.0,861,22500,15800,6700,0.7022222222222222,292,158,134,147.74308979907872,0.38255994021734235,0.9254666801019464,0.11933028764007503,18247687.2421135,344493.9389674164,18592181.18108092,4414,90,2975.68524970964,106,755,99,29.107025637285297,0.6946737421383649,33.051012461059194,136712.9159045913,1289.7444896659556,0
4416,512.4011038781264,0,0,861,0.0,0.0,1.0,861,23750,17300,6450,0.728421052631579,302,173,129,147.08464649521247,0.38246011488354087,0.9255465401614864,0.11922776992847084,18271796.16579064,341550.1359755808,18613346.30176622,4415,91,2976.68524970964,109,752,94,29.01710784487551,0.6950496941896025,32.945075757575765,136839.237977908,1255.4058530083303,0
4417,512.4383176198043,0,0,861,0.0,0.0,1.0,861,23550,17400,6150,0.7388535031847133,297,174,123,145.13188056317597,0.382264459480143,0.924171732970775,0.11799431757911655,18285015.747632854,334997.7443162509,18620013.491949104,4416,92,2977.68524970964,113,748,78,28.9811077666804,0.6950589970501475,32.858187134502934,136893.70115070048,1211.4486827495618,0
4418,512.8677503873698,0,0,861,0.0,0.0,1.0,861,23000,14900,8100,0.6478260869565218,311,149,162,146.46787212426682,0.38205884405189566,0.9242958464512752,0.11942764957824892,18311997.17187088,341223.8520219066,18653221.023892786,4417,93,2978.68524970964,118,743,79,28.859093837351462,0.6949152542372881,32.77310924369749,137052.05430519715,1161.4580873321793,0
4419,513.148674974984,0,0,861,0.0,0.0,1.0,861,23250,17100,6150,0.7354838709677419,294,171,123,146.11222101392474,0.3820591254085299,0.924032811352844,0.1133149177351796,18118044.02920317,334003.53070699936,18452047.559910167,4418,94,2979.68524970964,103,758,103,30.382108037139012,0.6831512944983819,34.26482371794876,136361.65360338055,1323.899549547384,8
4420,512.8407546242761,0,0,861,0.0,0.0,1.0,861,23000,17100,5900,0.7434782608695653,289,171,118,141.6994711098108,0.381792399319342,0.9212605206710176,0.11044762352006356,18127972.532644466,318544.8240337855,18446517.35667825,4419,95,2980.68524970964,110,751,110,30.34462170143185,0.6830492424242425,34.11223723723727,136358.08090061726,1239.6189172783388,0
4421,513.1272628543772,0,0,861,0.0,0.0,1.0,861,23550,17000,6550,0.721868365180467,301,170,131,139.04183705348623,0.3819729177358219,0.9221190589521675,0.10356303554964585,17947905.351691782,303351.9462722655,18251257.297964048,4420,96,2981.68524970964,133,728,93,31.832432008778056,0.6647869674185464,35.50995024875622,135717.05528107402,1020.4289870757445,8
4422,512.9450173771685,0,0,861,0.0,0.0,1.0,861,24550,17700,6850,0.7209775967413442,314,177,137,131.27381700698487,0.38190184705003194,0.9145045972423527,0.09796715434488484,17949771.18048958,274516.9954529822,18224288.175942563,4421,97,2982.68524970964,159,702,107,31.97635966531316,0.6621462264150944,35.44921875000005,135700.00508542883,853.4591514806845,8
4423,512.5411030132125,0,1,860,0.0,0.0011614401858304297,0.9988385598141696,861,24200,17800,6400,0.7355371900826446,306,178,128,127.27124704186714,0.38190775553934936,0.9119127716350308,0.09548715589946585,17958165.748971354,260711.62989122575,18218877.37886258,4422,98,2983.68524970964,116,745,116,31.914034910705283,0.669989224137931,35.28311965811965,135678.2818366436,1169.6403606607207,0
4424,512.6586959791739,0,0,860,0.0,0.0,1.0,860,22700,16800,5900,0.7400881057268722,286,168,118,125.47022865669653,0.3818622756314806,0.9105275819322562,0.09452735390944023,17979794.91047426,256485.79572354237,18236280.706197802,4423,99,2987.724418604651,122,738,122,31.831105639582574,0.6701673497267759,35.15413279132791,135775.5369186711,1112.9142370382876,0
4425,512.4465617796495,0,0,860,0.0,0.0,1.0,860,22850,16000,6850,0.700218818380744,297,160,137,125.10093077515167,0.3819841610941152,0.9108164678069286,0.09458267823573493,17987217.985294383,255193.54240317174,18242411.527697556,4424,100,2988.724418604651,125,735,111,31.730026677899456,0.67075,35.04464285714284,135775.46179295506,1086.2036943436406,0
4426,512.22635948936,0,1,859,0.0,0.0011627906976744186,0.9988372093023256,860,25150,18700,6450,0.7435387673956262,316,187,129,127.15776877927786,0.3820439193762352,0.9119741499721898,0.09648644314721484,17994678.699866068,260482.63867498803,18255161.338541057,4425,101,2989.724418604651,126,734,84,31.562206681725854,0.671709656084656,34.93274278215221,135774.43618452645,1077.5748903533845,0
4427,512.2617073998304,0,0,859,0.0,0.0,1.0,859,21800,15700,6100,0.7201834862385321,279,157,122,124.35330984851835,0.3819549597343544,0.9100304822913241,0.09474804391248322,18013166.219671644,254399.36805353017,18267565.587725174,4426,102,2993.8055878928985,132,727,90,31.507986316203986,0.6720328282828283,34.80576441102753,135848.85191539724,1029.1579690560397,0
4428,512.3345675608995,0,0,859,0.0,0.0,1.0,859,22200,14800,7400,0.6666666666666666,296,148,148,124.72568985303185,0.3818863276808562,0.9101144809800272,0.09521182530006131,18023636.32956671,255602.09497306822,18279238.42453978,4427,103,2994.8055878928985,136,723,92,31.439187639740886,0.6720281862745099,34.74756690997564,135897.99060165187,999.249930894499,0
4429,512.4218122394897,0,1,858,0.0,0.0011641443538998836,0.9988358556461001,859,23250,16900,6350,0.7268817204301076,296,169,127,123.11153812560266,0.3818941858813803,0.9087132396940614,0.09436199555472234,18043638.63991897,249226.0212685875,18292864.66118756,4428,104,2995.8055878928985,146,713,98,31.355919003115254,0.6719463470319635,34.62301587301584,135984.9551329968,931.4038022808,0
4430,511.94098750528684,0,0,858,0.0,0.0,1.0,858,24400,17600,6800,0.7213114754098361,312,176,136,123.41487946994116,0.3819459177539691,0.909838601907736,0.09505818176567778,18047021.267286427,249454.19089871322,18296475.45818514,4429,105,2999.0361305361307,147,711,106,31.196544381416874,0.673327664399093,34.473536036035995,135933.88017049542,924.7202732686764,0
4431,512.4328032724658,0,0,858,0.0,0.0,1.0,858,21700,14900,6800,0.6866359447004609,285,149,136,123.41110635937396,0.38200912839915174,0.9103841594810764,0.09527730753115116,18074037.543423798,252807.3939229475,18326844.937346745,4430,106,3000.0361305361307,151,707,110,31.124643066019836,0.6735651214128036,34.40241228070171,136100.91641740117,901.3305723006699,0
4432,512.3544837650687,0,0,858,0.0,0.0,1.0,858,23150,16200,6950,0.6997840172786177,301,162,139,122.46721219159993,0.38191239996228327,0.9096993391397274,0.09496985700141072,18089673.885458026,248328.38604144735,18338002.271499474,4431,107,3001.0361305361307,115,743,115,31.012886365684412,0.6804347826086956,34.26724137931035,136149.37036257135,1183.9075683701856,0
4433,512.7317756778892,0,0,858,0.0,0.0,1.0,858,25150,18600,6550,0.7395626242544732,317,186,131,122.60843920458008,0.3818315096028048,0.9093645852485392,0.09552570727533446,18122333.491107892,247640.20481792695,18369973.69592582,4432,108,3002.0361305361307,120,738,120,30.865496697319006,0.6809027777777779,34.125344352617084,136322.38429783014,1136.0198691485846,0
4434,512.9991079195673,0,0,858,0.0,0.0,1.0,858,23550,16900,6650,0.7176220806794055,302,169,133,124.45690203124244,0.38154285426747503,0.9105038469170454,0.09728853642251181,18145471.156222984,256515.8252001546,18401986.98142314,4433,109,3003.0361305361307,124,734,112,30.714757548224075,0.6811995967741935,34.025,136444.93772890672,1100.3624010395704,0
4435,513.3467892474018,0,0,858,0.0,0.0,1.0,858,24950,18400,6550,0.7374749498997996,315,184,131,123.77205064647285,0.3817091115807569,0.9101547837092421,0.09716236628862776,18175127.06149684,253364.54943233155,18428491.61092917,4434,110,3004.0361305361307,130,728,83,30.604300512973744,0.6814903846153846,33.89790076335877,136602.6582551228,1050.78967888556,0
4436,512.9909018265136,0,0,858,0.0,0.0,1.0,858,25750,19200,6550,0.7456310679611651,323,192,131,125.18161729525843,0.3817108115532853,0.9121001471122088,0.09873373314002322,18181866.272431564,257857.08508581689,18439723.35751738,4435,111,3005.0361305361307,132,726,88,30.423383538271455,0.6826073232323233,33.756265664160395,136580.6133826006,1034.701616534853,0
4437,512.9961203554121,0,0,858,0.0,0.0,1.0,858,25550,19300,6250,0.7553816046966731,318,193,125,125.56554050621638,0.38152052796160146,0.9121173277779306,0.09938774478022273,18196518.599800523,259821.13866307313,18456339.738463596,4436,112,3006.0361305361307,137,721,93,30.305928696933616,0.6829379562043796,33.65036231884057,136636.33078850384,997.3454802080572,0
4438,512.5654539258225,0,0,858,0.0,0.0,1.0,858,21300,13900,7400,0.6525821596244131,287,139,148,126.27304923244192,0.38137909024723493,0.9125062052581896,0.10019174804951515,18191179.273272667,266511.1351940275,18457690.408466693,4437,113,3007.0361305361307,144,714,95,30.21338914954439,0.6827256944444444,33.577586206896555,136558.9254618754,948.3258712630236,0
4439,512.5915125091178,0,0,858,0.0,0.0,1.0,858,22000,15500,6500,0.7045454545454546,285,155,130,128.99177139753095,0.38121818784741773,0.9145904445893882,0.10270522286126402,18206239.655682642,276091.02073489706,18482330.67641754,4438,114,3008.0361305361307,147,711,99,30.03613429104607,0.683390022675737,33.47409909909911,136618.91466564857,929.3803718751603,0
4440,512.7873317810578,0,0,858,0.0,0.0,1.0,858,23150,16600,6550,0.7170626349892009,297,166,131,131.24204265975035,0.3811822617613166,0.9162692599412816,0.10482717049406604,18226006.214747023,283653.65703053924,18509659.87177756,4439,115,3009.0361305361307,154,704,103,29.881205941908476,0.683509199134199,33.38037634408602,136719.16541498536,887.7867884089958,0
4441,513.0108504230695,0,0,858,0.0,0.0,1.0,858,22450,15000,7450,0.6681514476614699,299,150,149,130.28262025508772,0.38104243902085205,0.9153055223380773,0.1045266627731577,18252046.993505254,281534.90146657283,18533581.89497183,4440,116,3010.0361305361307,109,749,109,29.77279249056297,0.6919915902140672,33.24810606060606,136846.615961813,1255.4735409340642,0
4442,513.0749701465747,0,0,858,0.0,0.0,1.0,858,26000,19700,6300,0.7576923076923077,323,197,126,127.4294249941252,0.3810644536650954,0.9126977774220213,0.10290729194903767,18280690.953114852,268299.58733014914,18548990.540445,4441,117,3011.0361305361307,119,739,102,29.653897849462354,0.6918767507002801,33.055555555555564,136962.51286412793,1150.9454862531759,0
4443,513.4781078619494,0,0,858,0.0,0.0,1.0,858,23350,16000,7350,0.6852248394004282,307,160,147,144.5577555184154,0.381136985826309,0.9227741573264894,0.10395525980108303,17809143.168796755,319939.95283747534,18129083.12163423,4442,118,3012.0361305361307,137,721,93,32.81709751996636,0.6529805352798054,36.6243961352657,135237.606729462,987.1358155435181,8
4444,513.0428094498202,0,0,858,0.0,0.0,1.0,858,22550,16300,6250,0.7228381374722838,288,163,125,145.93435866962093,0.38113511585652776,0.9238777663099973,0.10532653712676823,17809785.40841396,325661.92232408415,18135447.330738045,4443,119,3013.0361305361307,146,712,99,32.66268197791163,0.6529680365296804,36.50793650793648,135182.70852169633,925.9089624773721,0
4445,513.3401801824999,0,0,858,0.0,0.0,1.0,858,23100,16900,6200,0.7316017316017316,293,169,124,147.98042071791988,0.3812430357792085,0.9248579372760892,0.10726764048439875,17838899.556064803,333261.5722902447,18172161.12835505,4444,120,3014.0361305361307,104,754,104,32.46782569428765,0.6616586538461539,36.369047619047656,135332.36059692423,1301.2726980473485,0
4446,512.9924503184693,0,0,858,0.0,0.0,1.0,858,22650,16000,6650,0.7064017660044151,293,160,133,147.13397637167742,0.38136534880263,0.924172459859818,0.10708446939849435,17844200.72764767,330847.641646643,18175048.36929431,4445,121,3015.0361305361307,109,749,109,32.3597323448103,0.6617928134556574,36.24053030303033,135306.61665455025,1241.3451069224793,0
4447,513.4171181307123,0,0,858,0.0,0.0,1.0,858,23500,17000,6500,0.723404255319149,300,170,130,140.8235135776957,0.38161374312191115,0.920231425638746,0.09423316268243513,17486748.452995587,297409.07164003875,17784157.524635624,4446,122,3016.0361305361307,123,735,82,35.32825458388322,0.6311822493224932,39.00369623655916,133999.97012099487,1089.4306513902022,8
4448,513.0691049900024,0,0,858,0.0,0.0,1.0,858,24350,17600,6750,0.7227926078028748,311,176,135,140.98424103523422,0.38186097579329786,0.9202230414445616,0.09472562377120407,17493373.671242528,297308.0020371888,17790681.673279718,4447,123,3017.0361305361307,134,724,84,35.1841592057442,0.630830223880597,38.86574074074079,133979.9206803789,999.8501543311859,0
4449,513.1036504616466,0,0,858,0.0,0.0,1.0,858,23450,16000,7450,0.6823027718550106,309,160,149,138.13488473489826,0.3819796622086587,0.9183816476869626,0.09305040160671604,17506211.182607505,288593.69277087157,17794804.875378378,4448,124,3018.0361305361307,144,714,89,35.17035870780857,0.6303530092592593,38.77873563218397,134033.58432533772,930.7887800370676,0
4450,513.3679975085884,0,0,858,0.0,0.0,1.0,858,20650,14500,6150,0.7021791767554479,268,145,123,138.15896769865836,0.3822010552976131,0.919046853948384,0.09343985997209725,17533331.37318992,292227.3925676978,17825558.765757617,4449,125,3019.0361305361307,152,706,98,35.0329204438888,0.6307565789473684,38.64379084967325,134171.91372794288,882.7099587364663,0
4451,513.1834596139253,0,0,858,0.0,0.0,1.0,858,23150,16400,6750,0.7084233261339092,299,164,135,134.2381082582474,0.3822727658054379,0.9170047683737375,0.09111560091511062,17543270.005522516,276245.0756409958,17819515.08116351,4450,126,3020.0361305361307,109,749,109,35.01270582838377,0.6387614678899083,38.52272727272725,134185.81142859464,1231.062490170593,0
4452,512.6828901199947,0,0,858,0.0,0.0,1.0,858,24900,17700,7200,0.7108433734939759,321,177,144,130.89096094989833,0.38236756760677415,0.9147615851584006,0.08917482400356455,17542883.780754704,262740.9831790719,17805624.763933778,4451,127,3021.0361305361307,115,743,115,34.97385463865626,0.638768115942029,38.397988505747115,134118.87531407687,1166.251089687625,0
4453,512.4460950038326,1,0,859,0.0011641443538998836,0.0,1.0,859,23400,16800,6600,0.717948717948718,300,168,132,128.2538687124224,0.3826989447623906,0.9130635132507272,0.08778474778112856,17555587.69840369,255114.40796809865,17810702.10637179,4452,0,3018.5180442374854,121,738,113,34.885690869948114,0.6392045454545454,38.242827868852466,134136.44069785305,1108.5656256020914,0
4454,512.0651542018817,1,1,859,0.0011627906976744186,0.0011627906976744186,0.9988372093023256,860,22350,15700,6650,0.7024608501118568,290,157,133,130.0209006659371,0.38319024058983314,0.9139124075681919,0.0893138407156205,17558554.0654107,262245.80279524956,17820799.86820595,4453,0,3016.006976744186,126,734,78,34.71841591497539,0.6395502645502645,38.123359580052494,134097.90225851117,1064.2690655437393,0
4455,511.8977649708104,0,0,859,0.0,0.0,1.0,859,25400,18600,6800,0.7322834645669292,322,186,136,133.2265579969293,0.38328406976544344,0.9174443935640528,0.08296915080319733,17102136.462214086,258491.7550509125,17360628.217265,4454,2,3020.5180442374854,110,749,110,38.0633206268531,0.6084280303030303,41.507132132132135,132321.92132245656,1202.9265574768779,8
4456,511.8177361626115,2,0,861,0.0023228803716608595,0.0,1.0,861,23700,16500,7200,0.6962025316455697,309,165,144,130.7297032332474,0.3840511303784134,0.9157981032122204,0.08187719498290852,17126251.07596653,251881.94413183437,17378133.020098362,4455,0,3014.499419279907,117,744,104,37.9228160723426,0.6090633903133903,41.30473163841806,132404.82660880315,1131.6651846906252,0
4457,511.60324756868823,3,2,862,0.003472222222222222,0.0023148148148148147,0.9976851851851852,864,23300,16800,6500,0.721030042918455,298,168,130,129.9052690467165,0.385059978201937,0.9148592713319073,0.08177170666343411,17142784.010555383,249287.59382019122,17392071.604375575,4456,0,3005.028935185185,128,736,81,37.762731734198404,0.6089680989583333,41.12564599483205,132440.96022129065,1034.6950017288332,0
4458,511.83018293207357,1,0,863,0.0011587485515643105,0.0,1.0,863,21650,15400,6250,0.7113163972286374,279,154,125,127.0840889223511,0.38496373645774246,0.9133576484028707,0.080372425415819,17172440.515519187,242218.79149760396,17414659.30701679,4457,0,3009.508690614137,133,730,92,37.66727060388719,0.6098840852130325,40.959266169154226,132584.86618350015,996.8786931090237,0
4459,512.0168757648636,1,0,864,0.0011574074074074073,0.0,1.0,864,24300,17900,6400,0.7366255144032922,307,179,128,130.05976704703946,0.385639548061242,0.9154905221852185,0.08260653872142928,17198721.009246085,250272.32959391983,17448993.338840004,4458,0,3007.0243055555557,141,723,97,37.43735200332081,0.610298463356974,40.80839201877937,132710.47734301796,941.2090591703402,0
4460,511.7350072236175,1,0,865,0.0011560693641618498,0.0,1.0,865,22950,16900,6050,0.7363834422657952,290,169,121,133.1094092891317,0.3862126908941697,0.918604049884318,0.08496876769904273,17212682.594105035,262284.0024765386,17474966.596581575,4459,0,3004.5468208092484,152,713,105,37.17937360002803,0.6107456140350878,40.63180827886714,132727.7834639935,873.2091017367993,0
4461,511.9112738359284,0,0,865,0.0,0.0,1.0,865,22000,15200,6800,0.6909090909090909,288,152,136,148.11583038154785,0.3864868225041033,0.9255496170966633,0.09174643181184026,17077068.92101923,310876.84874393826,17387945.769763168,4460,1,3005.5468208092484,155,710,96,37.87422231126507,0.5996639784946236,41.70005341880342,132226.6546861329,853.0751915234381,8
4462,512.1997972445672,0,0,865,0.0,0.0,1.0,865,23600,17100,6500,0.7245762711864406,301,171,130,147.85872013641597,0.3870971932312852,0.9256407193163392,0.08642178374234878,16806281.62123687,300391.05815364525,17106672.679390512,4461,2,3006.5468208092484,132,733,89,40.04059913986383,0.5811237373737373,43.82832080200499,131211.0821450118,994.0233495834228,8
4463,512.3945502490113,5,0,870,0.005747126436781609,0.0,1.0,870,22050,15200,6850,0.6893424036281179,289,152,137,161.7183132654647,0.38878593882958784,0.9320340800691,0.09376020180531687,16772799.769605495,346443.7774959921,17119243.547101486,4462,0,2990.2620689655173,108,762,78,39.99441311222325,0.5823688271604939,44.13226299694188,131105.23402491363,1213.9373520825336,8
4464,512.5915487696014,3,1,872,0.003436426116838488,0.001145475372279496,0.9988545246277205,873,24500,17700,6800,0.7224489795918367,313,177,136,162.2180573246249,0.3899467349573162,0.9330420134175097,0.09453602911529954,16804660.89722754,346103.8889494596,17150764.786177002,4463,0,2980.9828178694156,115,758,83,39.784798936232335,0.5828804347826086,43.93857758620686,131254.9210952312,1141.3471399585321,0
4465,512.59815528614,5,0,877,0.005701254275940707,0.0,1.0,877,23250,16300,6950,0.7010752688172043,302,163,139,159.8992639729519,0.39154318287922885,0.9327086154958695,0.09384798126778081,16839722.10310829,339881.8339592149,17179603.937067505,4464,0,2968.3751425313567,94,783,94,39.574599677745915,0.5905363475177305,43.673245614035096,131392.6214487296,1397.793845199251,0
4466,512.7142476580948,1,0,878,0.0011389521640091116,0.0,1.0,878,25300,17100,8200,0.6758893280632411,335,171,164,159.09905060807324,0.3920396399508575,0.9324570686307194,0.09377284052693749,16864187.29130352,335715.23746462655,17199902.528768145,4465,0,2965.993166287016,97,781,97,39.43552286227381,0.5912800687285223,43.516156462585045,131502.92087574265,1355.7002152138418,0
4467,512.5785854681715,5,1,882,0.0056625141562853904,0.0011325028312570782,0.9988674971687429,883,22450,15100,7350,0.6726057906458798,298,151,147,159.16680507197964,0.3940064984091032,0.9329394756198133,0.09450323656957857,16895517.709266238,338791.11476419505,17234308.824030433,4466,0,2950.1925254813136,104,779,73,39.157345156678645,0.5922475961538461,43.244047619047635,131607.6028819626,1265.4577200188712,0
4468,512.1926664447291,1,0,883,0.0011325028312570782,0.0,1.0,883,23100,16700,6400,0.7229437229437229,295,167,128,163.34017564035275,0.3945017543949756,0.9350330145948145,0.09734012093038932,16900762.14388814,352414.69140770455,17253176.83529584,4467,0,2951.1913929784823,106,777,74,38.91138964680918,0.5931603773584906,43.107476635514026,131578.46653177124,1241.3062880355776,0
4469,512.1335277569224,2,0,885,0.0022598870056497176,0.0,1.0,885,24000,17900,6100,0.7458333333333333,301,179,122,161.66211175067735,0.39544225230292035,0.9342144545506774,0.09663009158568976,16913394.376607034,345851.0103588608,17259245.386965897,4468,0,2945.5197740112994,111,774,79,38.84188138578268,0.5931869369369369,42.99665178571427,131620.03136632201,1185.7660483452435,0
4470,512.1891450463389,3,1,887,0.0033783783783783786,0.0011261261261261261,0.9988738738738738,888,24950,17900,7050,0.717434869739479,320,179,141,170.15683175378615,0.39661140671392925,0.9384849913132836,0.10248522508968312,16952079.8819086,374352.4408685333,17326432.322777133,4469,0,2936.5653153153153,121,767,84,38.339023385214375,0.5940943526170799,42.716871584699454,131777.6255778804,1089.0712857676065,0
4471,512.0913345313585,4,0,891,0.004489337822671156,0.0,1.0,891,25450,18600,6850,0.730844793713163,323,186,137,164.05214695016656,0.39794464621243647,0.936237119964153,0.09972587820424751,16993336.341086406,353908.66212030296,17347245.003206708,4470,0,2927.6677890011224,94,797,88,38.15306448180461,0.6036125886524824,42.37938596491228,131925.28404401618,1403.4604685533636,0
4472,511.84828651574145,5,3,893,0.005580357142857143,0.0033482142857142855,0.9966517857142857,896,23300,16000,7300,0.6866952789699571,306,160,146,163.28851399660869,0.3994017483040702,0.9352023794226545,0.10012725223412122,17026832.071721323,353557.2214122387,17380389.29313356,4471,0,2912.324776785714,109,787,73,37.852601757348765,0.603019877675841,42.06439393939396,132023.89799352168,1211.2284219589144,0
4473,511.6620911018249,1,0,894,0.0011185682326621924,0.0,1.0,894,27300,20000,7300,0.7326007326007326,346,200,146,159.77212525981685,0.3991361680415995,0.9341710939905925,0.09843465294036166,17043141.529258642,338503.7886467042,17381645.317905348,4472,0,2919.836689038031,109,785,83,37.77012400939248,0.6047400611620795,41.89393939393941,132063.08669575234,1211.5879513371774,0
4474,512.1252017116185,0,0,894,0.0,0.0,1.0,894,24600,17900,6700,0.7276422764227642,313,179,134,159.45726562580674,0.39952930051698815,0.9340514395632669,0.09869203794621453,17080378.046030276,341318.07581501495,17421696.12184529,4473,1,2920.836689038031,116,778,90,37.61066967722659,0.6049748563218391,41.728988603988626,132267.09380744738,1140.233567305581,0
4475,512.2450203422518,2,0,896,0.002232142857142857,0.0,1.0,896,24100,17400,6700,0.7219917012448133,308,174,134,158.5245726429109,0.40041546122639,0.9339139628449091,0.09867295126539669,17111291.729082245,339212.0417441796,17450503.770826425,4474,0,2915.3147321428573,95,801,95,37.42815338007077,0.6119517543859649,41.52560763888885,132402.22037296667,1393.7075828733334,0
4476,511.80696513608814,1,0,897,0.0011148272017837235,0.0,1.0,897,27600,20900,6700,0.7572463768115942,343,209,134,152.70329992017807,0.4011005082251686,0.9308059714046533,0.09539430197529773,17113777.70659605,315666.0659795152,17429443.772575565,4475,0,2913.063545150502,103,794,103,37.447269129968895,0.6111448220064725,41.39623397435896,132355.2086623455,1285.0020258480147,0
4477,511.3312901650745,2,0,899,0.002224694104560623,0.0,1.0,899,25050,18500,6550,0.7385229540918163,316,185,131,153.43143549766185,0.40217188445794344,0.9310277653865777,0.09621205443338604,17115683.119408283,320366.7661067792,17436049.885515064,4476,0,2907.5806451612902,107,792,98,37.29171326325207,0.6115654205607477,41.26157407407406,132301.0531439835,1236.4584405979767,0
4478,511.73430716102814,2,3,898,0.0022197558268590455,0.003329633740288568,0.9966703662597114,901,23700,16400,7300,0.6919831223628692,310,164,146,150.72929075951356,0.4029064414025569,0.9298622678889041,0.09494595110088606,17150449.438053254,313115.0160009351,17463564.454054188,4477,0,2902.124306326304,115,786,77,37.198566647011894,0.6115036231884058,41.10093390804599,132487.53421120395,1152.0655148800342,0
4479,511.69995135780795,2,0,900,0.0022222222222222222,0.0,1.0,900,24350,17000,7350,0.6981519507186859,317,170,147,174.01842350251007,0.4032039199934083,0.939190100403839,0.10585826614280489,16983701.605924293,386745.3957399988,17370447.001664292,4478,0,2906.3355555555554,96,804,80,37.87043597865956,0.6032986111111112,42.35395189003437,131837.47028540098,1373.3069821395936,8
4480,511.7495264311919,5,2,903,0.0055248618784530384,0.0022099447513812156,0.9977900552486187,905,25400,18200,7200,0.7165354330708661,326,182,144,171.7422215911666,0.40462910901416255,0.9382313488157674,0.10501159781947345,17009943.89081244,377865.1105898478,17387809.00140229,4479,0,2891.2729281767956,103,802,69,37.73939476342167,0.6033576051779935,42.16746794871796,131945.67617579942,1281.0259822893147,0
4481,511.6137050873699,1,0,904,0.0011061946902654867,0.0,1.0,904,25800,18400,7400,0.7131782945736435,332,184,148,178.08874665188972,0.40436941287971595,0.940647546271193,0.10946345411089284,17030405.879134674,399984.7275976157,17430390.60673229,4480,0,2895.4701327433627,106,798,73,37.38311512727643,0.604559748427673,41.97819314641745,132007.4925976995,1245.353703751882,0
4482,511.2975675590034,2,0,906,0.002207505518763797,0.0,1.0,906,23450,16700,6750,0.7121535181236673,302,167,135,172.8903999454469,0.405180421905935,0.9391221322290813,0.1066663443273128,17037672.67330912,384480.00852561,17422152.68183473,4481,0,2890.0761589403974,111,795,80,37.38009781316432,0.6048235735735736,41.843377976190496,131994.8528900239,1189.1428188290442,0
4483,511.82722870520496,2,1,907,0.0022026431718061676,0.0011013215859030838,0.998898678414097,908,25900,18900,7000,0.7297297297297297,329,189,140,172.92768613459526,0.40599386987648683,0.9395950201388523,0.10742536450420845,17087965.919524442,383496.4814420328,17471462.400966477,4482,0,2884.708149779736,88,820,88,37.12792900927019,0.6133996212121212,41.59644194756552,132257.9770055411,1502.9315568811487,0
4484,511.8306917968636,2,1,908,0.0022002200220022,0.0011001100110011,0.9988998899889989,909,25750,19200,6550,0.7456310679611651,323,192,131,152.514539867979,0.4063279951343152,0.9289344379410054,0.09555341741017234,17128273.07669877,314912.1374051694,17443185.214103937,4483,0,2882.4994499449945,116,793,97,37.34707309518894,0.609375,41.292735042735075,132414.31839595333,1141.5027447927012,8
4485,512.2129982939539,3,2,909,0.003293084522502744,0.0021953896816684962,0.9978046103183315,911,25450,17400,8050,0.6836935166994106,335,174,161,152.69192283183543,0.40703665617222146,0.9288903059672236,0.09629412712347335,17171959.494118385,316753.9027894692,17488713.396907855,4484,0,2877.1668496158068,126,785,77,37.10590222785346,0.6099537037037037,41.059711286089254,132632.58166125524,1052.6395369940892,0
4486,511.9891260132362,1,0,910,0.001098901098901099,0.0,1.0,910,22900,16100,6800,0.7030567685589519,297,161,136,157.302091149368,0.40710492752571964,0.9321702979913473,0.09965157351845527,17185694.346144915,335769.1317004913,17521463.477845404,4485,0,2881.3252747252745,128,782,80,36.82384350879381,0.6112467447916667,40.899547803617565,132656.61406965976,1036.3797974192169,0
4487,512.1075959743323,1,0,911,0.0010976948408342481,0.0,1.0,911,26100,19700,6400,0.7547892720306514,325,197,128,157.84811309338545,0.4075778639582152,0.9325114569544457,0.10030195756694503,17203907.665036574,334820.87255177007,17538728.537588343,4486,0,2879.161361141603,136,775,85,36.70072990916466,0.6111366421568627,40.79227493917275,132742.24493887596,976.0459186682056,0
4488,512.4556023623305,1,0,912,0.0010964912280701754,0.0,1.0,912,25200,18200,7000,0.7222222222222222,322,182,140,156.93984383283683,0.4080099326137334,0.9330193677262466,0.10003287918302926,17230025.933693115,333215.5158539078,17563241.449547023,4487,0,2877.003289473684,141,771,92,36.613979255068365,0.6115543735224587,40.6836854460094,132888.09817714544,942.4687813981946,0
4489,512.2335467875289,4,0,916,0.004366812227074236,0.0,1.0,916,24750,17500,7250,0.7070707070707071,320,175,145,158.0335420820996,0.408810555714638,0.9342654598602118,0.10163639616375474,17264293.364744827,337717.48639502336,17602010.85113985,4488,0,2865.435589519651,101,815,101,36.26665978313598,0.6220090759075907,40.36968954248366,132991.354779201,1316.7460869227823,0
4490,512.2968513778854,0,0,916,0.0,0.0,1.0,916,26950,19100,7850,0.7087198515769945,348,191,157,156.65756076021987,0.40911465168905753,0.9331548115292223,0.10111120068224919,17282972.114360485,331351.65082452225,17614323.765185006,4489,1,2866.435589519651,106,810,92,36.176073757589386,0.6220518867924528,40.245327102803735,133071.50105592603,1255.3915193955286,0
4491,512.1775870196975,0,0,916,0.0,0.0,1.0,916,26500,20200,6300,0.7622641509433963,328,202,126,156.34514790890978,0.40945280124243366,0.932775291540278,0.10136011601038665,17299574.40135017,331240.90370805684,17630815.305058226,4490,2,2867.435589519651,112,804,75,36.026777797481806,0.6223028273809523,40.09033923303835,133119.9028947307,1188.5705615600957,0
4492,511.9791974476573,1,1,916,0.0010905125408942203,0.0010905125408942203,0.9989094874591058,917,24400,16800,7600,0.6885245901639344,320,168,152,157.03062072428074,0.4099034451942049,0.9334297371124711,0.10219783413072384,17310674.898990832,335861.20490894455,17646536.103899777,4491,0,2865.307524536532,119,798,77,35.87311952687737,0.6222864145658263,39.95659722222219,133136.81265572278,1118.7967450060737,0
4493,512.398028610021,1,0,917,0.0010905125408942203,0.0,1.0,917,25350,18100,7250,0.7140039447731755,326,181,145,176.85999517014028,0.4102838150160561,0.9423969935982193,0.11419579204829262,17288228.32486345,402769.1956071303,17690997.52047058,4492,0,2866.303162486369,89,828,78,35.63721558842751,0.62687265917603,40.2314814814815,133104.87678383553,1495.5604133015229,8
4494,512.4278756846921,1,0,918,0.0010893246187363835,0.0,1.0,918,26250,19100,7150,0.7276190476190476,334,191,143,176.52806099832347,0.4107051783110756,0.9422660652093551,0.11459412101331312,17314053.57803024,401433.26123015746,17715486.839260396,4493,0,2864.1797385620916,96,822,67,35.45616970297848,0.6266276041666667,40.04510309278353,133208.13559599916,1387.584745791658,0
4495,512.5316635615792,0,0,918,0.0,0.0,1.0,918,26650,19700,6950,0.7392120075046904,336,197,139,179.52448955459667,0.41093902573752145,0.9424928919065405,0.11705925370882922,17338115.349199817,412273.2615807707,17750388.610780586,4494,1,2865.1797385620916,104,814,70,35.22127719084127,0.6261017628205128,39.89087301587305,133314.16356072633,1281.8669573146763,0
4496,512.8651709700168,1,2,917,0.001088139281828074,0.002176278563656148,0.9978237214363439,919,24100,17000,7100,0.7053941908713693,312,170,142,176.36615583688288,0.4113642101744579,0.9415497127450074,0.11545723427130207,17367689.465461362,404714.52535843576,17772403.990819797,4495,0,2863.0609357997823,109,810,77,35.16392547849503,0.6263379204892967,39.753787878787904,133471.21807384613,1224.5065878334508,0
4497,512.4096947754756,2,1,918,0.002176278563656148,0.001088139281828074,0.998911860718172,919,25900,17800,8100,0.6872586872586872,340,178,162,174.47625017510185,0.4114643217541722,0.941053637694929,0.11510776990023833,17387787.175887316,397051.1810583074,17784838.356945623,4496,0,2864.044613710555,86,833,86,34.942224315960395,0.6354166666666667,39.4875478927203,133489.10606950166,1552.198907784903,0
4498,512.4592824376697,1,1,918,0.001088139281828074,0.001088139281828074,0.998911860718172,919,25050,17300,7750,0.6906187624750499,328,173,155,173.9424449378162,0.4116443447971217,0.9407375991455156,0.11522005499004018,17407937.67660839,396745.8481588759,17804683.52476727,4497,0,2865.025027203482,88,831,88,34.81542807962878,0.6361268939393939,39.349250936329575,133572.89583200906,1517.8738162728303,0
4499,512.7635153343355,1,0,919,0.001088139281828074,0.0,1.0,919,26500,19700,6800,0.7433962264150943,333,197,136,173.38523242827895,0.41199466124256495,0.9391667009518021,0.11564041154129581,17449508.05639556,394797.40202345495,17844305.458419014,4498,0,2866.006528835691,97,822,73,34.59229682746629,0.6357388316151202,39.1156462585034,133771.97832021627,1379.0925600022294,0
4500,512.4572055768316,1,0,920,0.0010869565217391304,0.0,1.0,920,27250,19700,7550,0.7229357798165138,348,197,151,172.0105581491939,0.41253439860592006,0.9383113451656384,0.11500882074491006,17450369.171690036,389079.5482263812,17839448.71991642,4499,0,2863.8902173913043,99,821,77,34.542311965300215,0.6360479797979798,39.031250000000014,133735.31636787957,1350.861781493733,0
4501,512.9161998686185,0,0,920,0.0,0.0,1.0,920,24200,16700,7500,0.6900826446280992,317,167,150,171.36255894505578,0.4126493234612291,0.9379225538832097,0.115024003796862,17483731.33483839,391011.388289158,17874742.723127548,4500,1,2864.8902173913043,104,816,80,34.42451270944948,0.6361177884615384,38.89880952380955,133923.03040022112,1287.7214461559722,0
4502,513.3596110818336,0,0,920,0.0,0.0,1.0,920,27650,20000,7650,0.7233273056057866,353,200,153,175.92795468742162,0.4126417833656621,0.9391262973733354,0.11850971013559368,17514987.906660587,404625.19975874876,17919613.106419336,4501,2,2865.8902173913043,109,811,82,34.18279107002597,0.6361811926605505,38.77840909090911,134100.61431526975,1230.2808652777042,0
4503,513.7479512068147,0,1,919,0.0,0.0010869565217391304,0.9989130434782608,920,22850,15700,7150,0.687089715536105,300,157,143,176.82331654359467,0.41289955114254623,0.9397803283672839,0.1194977989874019,17542844.136050012,413546.7763487482,17956390.91239876,4502,3,2866.8902173913043,113,807,83,34.0486596736597,0.6364306784660767,38.66959064327487,134257.96239505688,1188.1235610182025,0
4504,513.603830431097,1,0,920,0.0010869565217391304,0.0,1.0,920,25500,18400,7100,0.7215686274509804,326,184,142,175.5866213310978,0.41329486406144045,0.9391413866659022,0.11908364649007327,17553941.0464802,406947.4398793521,17960888.48635955,4503,0,2867.846739130435,120,800,90,33.95956810448913,0.6362847222222222,38.55027548209368,134281.57997755287,1119.0131664796072,0
4505,513.7711164306924,1,0,921,0.0010857763300760044,0.0,1.0,921,23950,17300,6650,0.7223382045929019,306,173,133,178.34289100695494,0.41375056059104004,0.9407479501113447,0.12143400562728086,17577549.309333317,418816.19212875515,17996365.501462072,4504,0,2865.731813246471,91,830,91,33.751974851750845,0.6445741758241759,38.41711956521736,134393.72852013318,1476.854159561903,0
4506,513.9415047703505,0,2,919,0.0,0.002171552660152009,0.997828447339848,921,24250,17000,7250,0.7010309278350515,315,170,145,175.017061964836,0.41378060630379704,0.9398704556516535,0.11996624065589567,17613327.578005534,408076.5688253446,18021404.14683088,4505,1,2866.731813246471,98,823,81,33.61240053050393,0.6447704081632653,38.19444444444442,134552.7411794587,1372.987154892436,0
4507,514.0637819140198,0,0,919,0.0,0.0,1.0,919,26100,18600,7500,0.7126436781609196,336,186,150,177.53253506396712,0.41367008557342255,0.9408757212866274,0.12227134421063231,17638848.3705621,416393.89336695446,18055242.263929054,4506,2,2873.2121871599566,102,817,66,33.38528999215014,0.6453227124183006,38.03600323624592,134666.20290168552,1320.2568911929952,0
4508,514.2036408960181,1,1,919,0.0010869565217391304,0.0010869565217391304,0.9989130434782608,920,25600,18700,6900,0.73046875,325,187,138,173.59151514814533,0.4140799703521471,0.9400489053165806,0.12021683544631973,17668226.986387763,403810.85850967333,18072037.844897438,4507,0,2871.0880434782607,108,812,73,33.302954078718706,0.6457368827160495,37.853593272171224,134796.6367872564,1248.117007289411,0
4509,514.2367621747778,1,0,920,0.0010869565217391304,0.0,1.0,920,25150,17900,7250,0.7117296222664016,324,179,145,175.03550855374985,0.41420719098421405,0.940439708428471,0.12173061348271841,17688199.61286132,410062.6029274748,18098262.215788797,4508,0,2872.083695652174,111,809,79,33.122975840100175,0.6464902402402403,37.713913690476154,134877.1477873018,1215.1094395252414,0
4510,514.5255665502746,0,0,920,0.0,0.0,1.0,920,25700,17600,8100,0.6848249027237354,338,176,162,165.91340648420407,0.4142115770528773,0.9354790678870537,0.11122577995235608,17532842.580781884,372086.72758576926,17904929.308367655,4509,1,2873.083695652174,111,809,79,34.61028328998776,0.6341028528528528,38.94159226190477,134321.22514415678,1210.1011274248358,8
4511,514.032432935534,1,0,921,0.0010857763300760044,0.0,1.0,921,24950,18400,6550,0.7374749498997996,315,184,131,165.23709032423983,0.41450347369746177,0.9353892719236421,0.11123006818470757,17534764.73744877,370328.70094722946,17905093.438396,4510,0,2870.9630836047772,119,802,83,34.486124958458014,0.6339285714285714,38.80208333333336,134264.200581861,1128.2705931248822,0
4512,513.84780550282,0,0,921,0.0,0.0,1.0,921,25300,17600,7700,0.6956521739130435,330,176,154,163.19907290762418,0.4145097680529985,0.9345391425315146,0.11017234298830739,17541404.101009,363048.17735653766,17904452.278365538,4511,1,2871.9630836047772,126,795,87,34.44141005116617,0.6336805555555556,38.70570866141734,134265.49819474638,1065.5991920217966,0
4513,513.5381599598461,1,0,922,0.0010845986984815619,0.0,1.0,922,25550,17100,8450,0.6692759295499021,340,171,169,164.77518478613462,0.41473118007321724,0.9359191362630317,0.11185371864826187,17555828.381460145,368602.97312574426,17924431.35458589,4512,0,2869.847071583514,93,829,93,34.21095383398312,0.6429211469534051,38.51950354609925,134280.21301432134,1443.8732582185091,0
4514,513.3013555497467,0,0,922,0.0,0.0,1.0,922,29050,21800,7250,0.7504302925989673,363,218,145,161.49473503931893,0.41492467966457913,0.9343523526495445,0.11020337542658497,17571330.248730663,354085.46456141636,17925415.71329208,4513,1,2870.847071583514,99,823,99,34.11813932348682,0.6429924242424243,38.34374999999996,134308.5078130613,1356.6515940713261,0
4515,513.4969575353526,0,0,922,0.0,0.0,1.0,922,27250,19700,7550,0.7229357798165138,348,197,151,161.60060877204944,0.4151077277755402,0.934085813103759,0.11068117166840226,17594501.935132984,357006.44475169026,17951508.379884675,4514,2,2871.847071583514,103,819,96,33.990791755943256,0.6432038834951457,38.22115384615381,134422.6410471133,1305.0741849234303,0
4516,512.990046585266,0,0,922,0.0,0.0,1.0,922,26350,19300,7050,0.7324478178368121,334,193,141,160.69284394524897,0.4152075811211524,0.9342970734461444,0.11044861747100215,17592925.284222584,354661.43944759207,17947586.723670177,4515,3,2872.847071583514,106,816,72,33.8950945406785,0.6436713836477987,38.1035825545171,134350.25538587046,1267.455239489344,0
4517,513.0725454653519,0,0,922,0.0,0.0,1.0,922,22100,14900,7200,0.6742081447963801,293,149,144,160.95008853625484,0.415207654723127,0.9348842727722235,0.11108789305292467,17614377.093681954,360507.11054780905,17974884.204229765,4516,4,2873.847071583514,111,811,73,33.74757459596316,0.6439564564564564,37.96502976190473,134442.94918099546,1211.1977403693286,0
4518,513.4767745003833,0,0,922,0.0,0.0,1.0,922,25200,18300,6900,0.7261904761904762,321,183,138,162.58301296586106,0.4154235538487749,0.9356374724670933,0.11266582158885066,17646123.86635275,364191.99707207957,18010315.86342483,4517,5,2874.847071583514,115,807,76,33.5698535708169,0.6444746376811594,37.83225574712642,134617.0476970058,1170.5830234522243,0
4519,513.6416443510794,1,0,923,0.0010834236186348862,0.0,1.0,923,25900,19000,6900,0.7335907335907336,328,190,138,162.77785462958104,0.41559851908603856,0.9354923158461754,0.11327698932045123,17670518.36215851,364773.813836953,18035292.175995465,4518,0,2872.7313109425786,123,800,82,33.42343875100077,0.6443936314363143,37.693212365591386,134731.68972498633,1095.3795912600515,0
4520,513.6374393983252,0,0,923,0.0,0.0,1.0,923,25500,18600,6900,0.7294117647058823,324,186,138,163.19885344328023,0.41546216086216387,0.936141573266023,0.11398469627432224,17686541.05042199,367184.6441612754,18053725.694583267,4519,1,2873.7313109425786,127,796,89,33.29046758871627,0.6449311023622047,37.5732421875,134792.20791241692,1061.3559678143065,0
4521,513.9209078136005,1,0,924,0.0010822510822510823,0.0,1.0,924,22400,16000,6400,0.7142857142857143,288,160,128,163.60236924667623,0.41576979847226325,0.9370545260979588,0.11459989032885913,17709203.45431362,372253.5285194308,18081456.98283305,4520,0,2871.62012987013,92,832,92,33.182669880820306,0.6537590579710144,37.47759856630827,134915.75086621044,1466.4755528935916,0
4522,513.9211732296533,0,0,924,0.0,0.0,1.0,924,25050,18400,6650,0.7345309381237525,317,184,133,159.63740425015007,0.415847234729277,0.9353995254772198,0.11232800494959339,17729140.763052594,356196.8021998506,18085337.565252446,4521,1,2872.62012987013,97,827,97,33.136735189381675,0.6537800687285223,37.329931972789126,134991.70953285758,1391.6671085861606,0
4523,514.0093840684893,0,0,924,0.0,0.0,1.0,924,27700,20400,7300,0.7364620938628159,350,204,146,158.24385839943622,0.4159455567906272,0.9348517506522547,0.1120687616716577,17760621.394431025,349601.8514052729,18110223.2458363,4522,2,2873.62012987013,103,821,88,32.959466839391446,0.6543284789644013,37.11939102564105,135123.09990246085,1311.8747563345714,0
4524,513.6358747931201,0,1,923,0.0,0.0010822510822510823,0.9989177489177489,924,25650,18200,7450,0.7095516569200779,331,182,149,155.6769820362716,0.41599328879258457,0.9336692274707594,0.11066334328368062,17764095.757846177,342642.16323696956,18106737.921083145,4523,3,2874.62012987013,109,815,71,32.90377194877518,0.6541475535168195,36.99810606060608,135087.20786580897,1239.3321822551281,0
4525,513.11823777133,0,0,923,0.0,0.0,1.0,923,25950,19000,6950,0.7321772639691715,329,190,139,154.6947581710085,0.41578188050378023,0.9335769299616545,0.11043380381280968,17764784.41218664,339073.8057206678,18103858.21790731,4524,4,2878.6782231852653,113,810,75,32.78974813065723,0.6546828908554572,36.860380116959085,135021.73804220476,1194.882637541635,0
4526,512.7322055033051,1,0,924,0.0010822510822510823,0.0,1.0,924,26300,18400,7900,0.6996197718631179,342,184,158,150.07227787592723,0.4159414284854426,0.9317759392757725,0.10772107139347874,17775220.958763655,322413.57980592176,18097634.538569577,4525,0,2876.561688311688,119,805,86,32.732385002527394,0.6552871148459384,36.68402777777779,135010.57918174806,1134.5426821995636,0
4527,512.8239760193613,0,0,924,0.0,0.0,1.0,924,26400,17900,8500,0.678030303030303,349,179,170,153.88590407529435,0.41585133860662027,0.9333434082108008,0.1107512715098926,17789902.780388534,336323.0545543363,18126225.83494287,4526,1,2877.561688311688,125,799,87,32.545503646045844,0.6550833333333334,36.59887566137566,135078.41187130328,1080.6272949704262,0
4528,512.8532700040709,0,0,924,0.0,0.0,1.0,924,25950,19600,6350,0.7552986512524085,323,196,127,155.28639169626328,0.41578010702130425,0.9347251294149161,0.11216436871551841,17806609.766797017,342274.8358058695,18148884.602602888,4527,2,2878.561688311688,127,797,90,32.39068306517198,0.6559219160104988,36.48274739583333,135145.68470053535,1064.1392496105145,0
4529,512.6926908245313,0,0,924,0.0,0.0,1.0,924,26000,19800,6200,0.7615384615384615,322,198,124,151.66924213741362,0.41573337656084136,0.9330974903057989,0.11015197399243332,17824652.53355845,329890.3082255049,18154542.841783956,4528,3,2879.561688311688,96,828,96,32.30859295459172,0.6643880208333333,36.307989690721634,135192.9663143932,1408.2600657749292,0
4530,512.3515855025039,0,0,924,0.0,0.0,1.0,924,25350,17700,7650,0.6982248520710059,330,177,153,147.70128656556926,0.4157491813741814,0.9309050219935953,0.10765856756664172,17828357.874836832,316504.2790929591,18144862.153929792,4529,4,2880.561688311688,101,823,101,32.296344327449155,0.6641914191419143,36.19281045751634,135162.03182905097,1338.2379389014948,0
4531,512.3456829467485,1,1,924,0.001081081081081081,0.001081081081081081,0.9989189189189189,925,22700,15600,7100,0.6872246696035242,298,156,142,145.38136838189052,0.4158000858000858,0.9292182997758447,0.10656368646524776,17852239.446836915,311376.5998924637,18163616.04672938,4530,0,2878.4464864864863,107,818,81,32.17680550481064,0.66452492211838,36.014660493827165,135251.74905721965,1264.0350379179406,0
4532,512.2225133750551,0,0,924,0.0,0.0,1.0,924,27150,18900,8250,0.6961325966850829,354,189,165,141.4101571593262,0.41558927672484014,0.9268092291652501,0.10414217232559939,17868101.00451044,293396.19423730957,18161497.19874775,4531,1,2882.5487012987014,115,809,87,32.13053307948593,0.6643115942028985,35.86566091954024,135295.55503245274,1176.4830872387195,0
4533,512.6056877973926,0,0,924,0.0,0.0,1.0,924,25150,17500,7650,0.6958250497017893,328,175,153,144.89511331183013,0.4156946584323345,0.92827215779467,0.10716880803260709,17899838.390680443,308769.8223762226,18208608.213056665,4532,2,2883.5487012987014,122,802,87,31.90087058697859,0.6643613387978142,35.73001355013552,135466.29816834143,1110.3794931831264,0
4534,512.8465670868986,0,1,923,0.0,0.0010822510822510823,0.9989177489177489,924,26150,18400,7750,0.7036328871892925,339,184,155,143.54920166243585,0.4155145031025313,0.9280847765026452,0.10659545071616322,17925154.11153532,303678.3124774079,18228832.424012724,4533,3,2884.5487012987014,126,798,92,31.80995036451064,0.6649305555555556,35.60531496062993,135593.90657846353,1076.1421157020916,0
4535,512.4137621913532,0,0,923,0.0,0.0,1.0,923,26850,18400,8450,0.6852886405959032,353,184,169,142.74374170218988,0.41543929576681404,0.9279714593272976,0.1066108309238375,17934515.64737126,300557.97382444906,18235073.621195707,4534,4,2888.6348862405202,130,793,101,31.6479703262906,0.6661057692307693,35.42461832061068,135572.06670954888,1042.8620516119145,0
4536,512.5491988196596,1,0,924,0.0010822510822510823,0.0,1.0,924,26400,19900,6500,0.7537878787878788,329,199,130,145.60662798981423,0.41543054461188267,0.9283965422475395,0.10926229643644977,17959174.201805484,311794.95940130466,18270969.16120679,4535,0,2886.507575757576,104,820,104,31.423246764603,0.672676282051282,35.27777777777774,135683.16290975807,1304.6457972092123,0
4537,512.4892548880186,0,0,924,0.0,0.0,1.0,924,27700,20300,7400,0.7328519855595668,351,203,148,145.17143843405745,0.4154814522332128,0.9282759993707936,0.10935406559725415,17973240.68401425,309340.2406839665,18282580.924698215,4536,1,2887.507575757576,108,816,108,31.313899012497128,0.6729359567901234,35.15863914373085,135728.35168875623,1256.7439971181132,0
4538,512.6504442405247,0,0,924,0.0,0.0,1.0,924,24950,18100,6850,0.7254509018036072,318,181,137,149.51515141891332,0.4154900508333607,0.9297155032091027,0.11309640822066279,17996431.501964264,328397.8362032501,18324829.338167515,4537,2,2888.507575757576,112,812,91,31.067788060116893,0.6733630952380952,35.02949852507371,135837.24529175364,1212.8325472478004,0
4539,512.392965508705,0,1,923,0.0,0.0010822510822510823,0.9989177489177489,924,24750,18500,6250,0.7474747474747475,310,185,125,150.25342114271447,0.41537563082457446,0.9301785829765934,0.11411451622212529,18004325.177584436,331492.29065958626,18335817.468244024,4538,3,2889.507575757576,115,809,74,30.921667344150464,0.6740036231884058,34.90481321839077,135832.9088971107,1181.155729540093,0
4540,512.5874476825286,0,0,923,0.0,0.0,1.0,923,25750,18000,7750,0.6990291262135923,335,180,155,150.28097287029473,0.4151442528019779,0.9303011184289363,0.11452317291494934,18025356.942498773,331423.6355305993,18356780.57802937,4539,4,2893.5557963163596,119,804,78,30.81490103979137,0.674282212885154,34.80034722222219,135938.01314365215,1142.33624490464,0
4541,512.2343112188593,0,1,922,0.0,0.0010834236186348862,0.9989165763813651,923,23000,16500,6500,0.717391304347826,295,165,130,150.51044362740632,0.41508716350609354,0.9310991849244441,0.11515273365385778,18029451.393609136,335124.14552216686,18364575.539131302,4540,5,2894.5557963163596,119,804,84,30.685458585528053,0.6755077030812324,34.678819444444414,135906.61217364777,1142.072371207124,0
4542,512.6119104647045,0,1,921,0.0,0.0010845986984815619,0.9989154013015185,922,25650,18500,7150,0.7212475633528265,328,185,143,151.0911865258755,0.4148994341872732,0.9316789333157658,0.11600930838054717,18057574.723034535,335618.0781365823,18393192.801171117,4541,11,2898.6898047722343,122,800,88,30.559366558186046,0.676058743169399,34.56978319783195,136062.69053001836,1115.267955164085,0
4543,512.9844950051591,0,0,921,0.0,0.0,1.0,921,28550,21500,7050,0.7530647985989493,356,215,141,153.67352093206043,0.4146924027128673,0.9325012653302651,0.11833622769530978,18082818.514187463,343020.0778901203,18425838.592077583,4542,12,2902.7958740499457,127,794,91,30.40046714888486,0.6760990813648293,34.48079427083331,136207.23566514577,1072.4979186231951,0
4544,512.7079547373261,0,0,921,0.0,0.0,1.0,921,25200,18200,7000,0.7222222222222222,322,182,140,153.18526982914062,0.414469395663189,0.9325547789672366,0.118187925247696,18081076.20569246,344550.9074740405,18425627.1131665,4543,13,2903.7958740499457,132,789,93,30.353728606957784,0.6758996212121212,34.42199248120297,136163.9570581741,1031.5451292285916,0
4545,512.3411247273176,0,0,921,0.0,0.0,1.0,921,25850,18400,7450,0.7117988394584139,333,184,149,154.4165872031664,0.4143291987285402,0.9326679374041824,0.11969418334035645,18087423.97310081,348549.6562446003,18435973.629345413,4544,14,2904.7958740499457,98,823,98,30.17715015443101,0.684311224489796,34.28030303030307,136139.12840765828,1389.1747796699824,0
4546,512.6224528770132,0,0,921,0.0,0.0,1.0,921,26100,18600,7500,0.7126436781609196,336,186,150,150.99965107052523,0.41414533470235565,0.9307171622149495,0.11752360295489168,18114189.926892925,336747.27167721937,18450937.198570143,4545,15,2905.7958740499457,104,817,104,30.142522172880053,0.683994391025641,34.15674603174607,136277.2209300151,1310.3578935578373,0
4547,512.1303668060493,0,0,921,0.0,0.0,1.0,921,24350,16600,7750,0.6817248459958932,321,166,155,150.65603066563827,0.41392788438842465,0.9305692641068519,0.11764482394629554,18110423.121942893,337138.89224543085,18447562.014188323,4546,16,2906.7958740499457,107,814,101,30.050116962245696,0.6842873831775701,34.056712962963,136197.63313988608,1272.8750760737016,0
4548,512.1006089309368,0,0,921,0.0,0.0,1.0,921,24550,17000,7550,0.6924643584521385,321,170,151,166.74090127900996,0.41396501125116053,0.9366350607252172,0.11897236219031491,17727320.462008074,382423.87821941875,18109744.340227492,4547,17,2907.7958740499457,106,815,78,32.48960954072319,0.6560534591194969,36.87694704049847,134745.47564432953,1271.1837324936748,8
4549,511.9738462116763,0,1,920,0.0,0.0010857763300760044,0.998914223669924,921,24750,17500,7250,0.7070707070707071,320,175,145,168.68844279923036,0.41407290043903133,0.9375219250674309,0.12084855412382318,17740489.029410616,389573.09377362696,18130062.12318424,4548,18,2908.7958740499457,111,810,80,32.305872048519106,0.65625,36.746651785714306,134778.82921337077,1214.2236866069438,0
4550,512.3891664571071,0,0,920,0.0,0.0,1.0,920,24700,17800,6900,0.7206477732793523,316,178,138,169.46615242548157,0.41402024096765544,0.9378035680450083,0.12169415808503038,17765194.60212587,393419.83526244666,18158614.437388316,4549,19,2912.8641304347825,117,803,81,32.2076488993184,0.6558048433048433,36.67019774011302,134927.3378832597,1153.2251101133306,0
4551,512.4192555962759,0,0,920,0.0,0.0,1.0,920,25850,18900,6950,0.7311411992263056,328,189,139,169.9721751231035,0.41395772716878776,0.9384078949505446,0.12264569078289729,17787084.65505655,394811.893583749,18181896.5486403,4550,20,2913.8641304347825,126,794,88,32.037248889719024,0.6557539682539683,36.51574803149607,135014.40425504264,1071.542890913037,0
4552,512.4094382323614,0,1,919,0.0,0.0010869565217391304,0.9989130434782608,920,24300,17100,7200,0.7037037037037037,315,171,144,171.6583191173974,0.4140084872892716,0.939036497053624,0.12402332125933237,17792365.11343766,402541.4976991429,18194906.6111368,4551,21,2914.8641304347825,131,789,90,31.9504751352538,0.6553753180661578,36.47411616161615,135033.15009731211,1030.7874053229932,0
4553,512.480782001796,0,0,919,0.0,0.0,1.0,919,24550,17400,7150,0.7087576374745418,317,174,143,168.69036728758797,0.4139256244552389,0.9379231817946438,0.12219264485496838,17805955.133462314,392388.6222740175,18198343.755736332,4552,22,2918.974972796518,93,826,93,31.945028305588252,0.6644265232974911,36.39184397163122,135094.11394347058,1452.624881112587,0
4554,512.4215656543139,0,0,919,0.0,0.0,1.0,919,25050,17400,7650,0.6946107784431138,327,174,153,143.6394598335566,0.4138821127128964,0.9275212509215849,0.10240875324644198,17735009.78586093,300639.44515678193,18035649.231017713,4553,23,2919.974972796518,121,798,80,33.12320157504162,0.6527203856749311,36.90232240437159,134816.92387356606,1114.189453500546,8
4555,512.8068506658703,0,1,918,0.0,0.001088139281828074,0.998911860718172,919,23400,16200,7200,0.6923076923076923,306,162,144,141.9082200709551,0.4138745068010681,0.9268870551758559,0.10145178948930712,17760286.805032294,296866.13769035944,18057152.942722652,4554,24,2920.974972796518,125,794,84,33.07899455525883,0.6529166666666666,36.813822751322746,134963.67469368345,1079.7093975494677,0
4556,512.6610203619728,0,0,918,0.0,0.0,1.0,918,23700,16600,7100,0.70042194092827,308,166,142,141.22253162960195,0.4138744556346712,0.9267042422499359,0.10134775304390348,17771851.760796797,294657.17948114406,18066508.94027794,4555,25,2924.6100217864923,129,789,90,32.972184605865074,0.6535045219638242,36.690705128205124,134988.4117797657,1046.42179674237,0
4557,512.6001031439346,0,0,918,0.0,0.0,1.0,918,23500,16000,7500,0.6808510638297872,310,160,150,144.14889247261775,0.41387326771251337,0.92715173377712,0.1037860215160287,17783911.386421785,305606.2260367764,18089517.61245856,4556,26,2925.6100217864923,138,780,95,32.788643907064966,0.6532306763285024,36.58573141486811,135026.18124632278,978.4505887414695,0
4558,513.0368137606438,0,0,918,0.0,0.0,1.0,918,25150,18200,6950,0.7236580516898609,321,182,139,150.1904597710777,0.41383404153292647,0.9305121760425237,0.10846686159824416,17812316.209870156,326297.9922296447,18138614.2020998,4557,27,2926.6100217864923,141,777,98,32.52997234749364,0.6538120567375887,36.48767605633803,135191.5230627192,958.8051281043915,0
4559,513.0292289403646,0,1,917,0.0,0.0010893246187363835,0.9989106753812637,918,25300,18100,7200,0.7154150197628458,325,181,144,148.0274193112049,0.4138907895643414,0.9298664677749651,0.10142619471323137,17580303.070972,311573.3788609586,17891876.449832957,4558,28,2927.6100217864923,105,813,97,34.33230105105102,0.6428571428571428,38.20754716981128,134307.18021787616,1279.116002075011,8
4560,513.1431506915123,1,0,918,0.0010893246187363835,0.0,1.0,918,24200,17500,6700,0.7231404958677686,309,175,134,144.93614450987525,0.4138108770508486,0.928519801652258,0.09969631487188696,17601661.023195345,302423.37713432685,17904084.40032967,4559,0,2928.5065359477126,109,809,80,34.281449980114914,0.6432530581039755,38.07765151515147,134403.65913803308,1233.0610930094779,0
4561,513.2552406041061,0,0,918,0.0,0.0,1.0,918,24600,18100,6500,0.7357723577235772,311,181,130,142.5305526925072,0.4138717580614377,0.9274010926768457,0.09839564840596168,17621598.15967702,294123.2250047999,17915721.38468182,4560,1,2929.5065359477126,115,803,83,34.22307466045252,0.6432065217391305,37.957974137931004,134494.44303222184,1169.516895932364,0
4562,512.9023618406067,0,0,918,0.0,0.0,1.0,918,25400,18300,7100,0.7204724409448819,325,183,142,140.06826257733903,0.41394068229497055,0.9257303475214951,0.09701161171637887,17623997.696065202,284712.54739097646,17908710.243456177,4561,2,2930.5065359477126,124,794,87,34.17811049653512,0.642641129032258,37.85,134457.354156515,1084.3335012622179,0
4563,512.6189274924665,0,0,918,0.0,0.0,1.0,918,24500,18400,6100,0.7510204081632653,306,184,122,141.53318840311746,0.4139969353588198,0.9269076463638264,0.09829837097047976,17626570.43622995,290848.9428903494,17917419.3791203,4562,3,2931.5065359477126,128,790,89,34.04680892556558,0.6429036458333333,37.758397932816536,134430.00879558548,1050.2344437155116,0
4564,512.0947648514685,0,0,918,0.0,0.0,1.0,918,26200,18500,7700,0.7061068702290076,339,185,154,140.72610664215262,0.4139445430419835,0.9271639107086249,0.09811292760337226,17625504.935499113,286273.737434962,17911778.672934074,4563,4,2932.5065359477126,133,785,93,33.93995116194081,0.6434053884711779,37.63215174129351,134357.20155862675,1010.2045229971936,0
4565,512.4456927530056,1,0,919,0.001088139281828074,0.0,1.0,919,24350,17400,6950,0.7145790554414785,313,174,139,139.85334243351576,0.41419030030905685,0.927399161772468,0.09782932591990537,17652287.27934759,285596.27552267147,17937883.554870263,4564,0,2930.3144722524485,136,783,97,33.85197898863489,0.6440716911764706,37.52281021897807,134505.30534919584,989.0095981558518,0
4566,512.7096798065091,0,1,918,0.0,0.001088139281828074,0.998911860718172,919,26000,18800,7200,0.7230769230769231,332,188,144,141.73003469918513,0.41431076017236385,0.9287241736969576,0.09946610646661662,17675781.315841284,291237.81984588277,17967019.135687165,4565,1,2931.3144722524485,98,821,98,33.6942184912112,0.6526360544217686,37.415824915824935,134629.44832966468,1373.7698809149458,0
4567,513.0693884926507,0,0,918,0.0,0.0,1.0,918,25400,18300,7100,0.7204724409448819,325,183,142,139.64451966694668,0.41413124480779023,0.9275167004812737,0.10072295605600874,17807955.783984054,288356.68634093774,18096312.470324993,4566,2,2935.4237472766886,133,785,96,32.84905806508723,0.6545269423558897,36.52829601990051,135179.26604618703,1016.3854589938874,8
4568,513.2962205085437,0,0,918,0.0,0.0,1.0,918,24300,17800,6500,0.7325102880658436,308,178,130,139.6143591905519,0.41400968077363826,0.9277580543559414,0.10089779612671279,17824285.267753482,289805.2331374043,18114090.500890885,4567,3,2936.4237472766886,139,779,99,32.78645759808769,0.6543015587529977,36.465773809523824,135271.12227821612,973.1735415699002,0
4569,512.8343641984189,0,0,918,0.0,0.0,1.0,918,24400,18200,6200,0.7459016393442623,306,182,124,140.04274945201993,0.41392135381152745,0.9272297718493088,0.10161205448111896,17825500.912957367,291266.4316420121,18116767.344599377,4568,4,2937.4237472766886,103,815,103,32.64574786000101,0.6622168284789645,36.33814102564104,135214.86181048956,1312.7656486455296,0
4570,513.054402091974,0,1,917,0.0,0.0010893246187363835,0.9989106753812637,918,27100,19600,7500,0.7232472324723247,346,196,150,138.47613041708308,0.41386059654282975,0.9263881676844059,0.1008803543917335,17850506.005484585,283673.7995252869,18134179.80500987,4569,5,2938.4237472766886,108,810,108,32.556998635414104,0.6623263888888888,36.20986238532113,135338.6913316601,1253.1360308487046,0
4571,512.7849074584892,0,0,917,0.0,0.0,1.0,917,26650,19500,7150,0.7317073170731707,338,195,143,138.35220419380482,0.413855809082525,0.9260742579129535,0.10130748092640006,17863146.202420358,284231.1301882156,18147377.332608573,4570,6,2939.652126499455,113,804,102,32.39530325059717,0.6628871681415929,36.04714912280704,135351.03821046726,1197.796798322719,0
4572,513.0011732837845,0,1,916,0.0,0.0010905125408942203,0.9989094874591058,917,26200,19200,7000,0.732824427480916,332,192,140,137.31099525170384,0.41374905949245927,0.9258123888268937,0.10093634275491503,17887339.53982325,281625.67892366095,18168965.21874691,4571,7,2940.652126499455,116,801,79,32.2980934560534,0.6635237068965517,35.924145299145316,135471.22329745776,1167.8553732539463,0
4573,512.7438394693079,0,0,916,0.0,0.0,1.0,916,25400,17700,7700,0.6968503937007874,331,177,154,137.89389967672162,0.4137089517662125,0.9262185363244335,0.10171262585461448,17893016.805042822,284867.57284570043,18177884.377888523,4572,8,2944.7434497816594,119,797,82,32.1730356399641,0.6640406162464986,35.81597222222225,135458.7327292458,1138.3086783970234,0
4574,513.1710438498196,0,0,916,0.0,0.0,1.0,916,25850,19300,6550,0.746615087040619,324,193,131,138.1830622172863,0.41359717151470315,0.9263435669513123,0.10207587794549206,17914208.283232126,286038.031555061,18200246.314787187,4573,9,2945.7434497816594,120,796,84,32.118411907166646,0.6643229166666667,35.769628099173566,135595.37576517407,1129.961464709784,0
4575,513.0776464743186,0,0,916,0.0,0.0,1.0,916,26700,20600,6100,0.7715355805243446,328,206,122,139.80143033087882,0.4135721408913388,0.9272895621570865,0.10376872887017308,17931436.8568777,291468.10409587173,18222904.960973572,4574,10,2946.7434497816594,128,788,88,31.922449426305477,0.6644694010416667,35.6185400516796,135648.21724172958,1059.7516972010123,0
4576,513.3353052411127,0,0,916,0.0,0.0,1.0,916,24150,17300,6850,0.7163561076604554,310,173,137,139.03089228814875,0.41349749644053096,0.9273464737303425,0.1036666586121699,17959766.079946574,292042.4606762788,18251808.540622853,4575,11,2947.7434497816594,139,777,94,31.798492349234927,0.6642685851318945,35.476190476190474,135789.41050544663,976.902233852134,0
4577,513.1664646552243,0,1,915,0.0,0.001091703056768559,0.9989082969432315,916,25150,18200,6950,0.7236580516898609,321,182,139,135.85187305040864,0.41343344091281486,0.925883773735634,0.10172674737965548,17971841.551483855,279951.66738684534,18251793.2188707,4576,12,2948.7434497816594,99,817,99,31.74834527230022,0.6732954545454546,35.34374999999998,135812.71216140827,1371.8455773879623,0
4578,513.4711585729259,0,0,915,0.0,0.0,1.0,915,24300,17400,6900,0.7160493827160493,312,174,138,133.78341812373912,0.41318002096511264,0.9245964477980448,0.10058869287597057,17999829.881848376,274315.75344789325,18274145.63529627,4577,13,2952.856830601093,103,812,103,31.673979926363067,0.6735436893203883,35.216346153846125,135958.76951155558,1319.9880535102484,0
4579,513.8269187518808,0,0,915,0.0,0.0,1.0,915,25750,19700,6050,0.7650485436893204,318,197,121,133.93083950654815,0.41310663310654344,0.9247801106148281,0.10121987773314824,18034060.108380783,274313.3620053918,18308373.470386174,4578,14,2953.856830601093,106,809,93,31.508053156960003,0.6744300314465409,35.0564641744548,136135.12065646693,1284.2935910987446,0
4580,513.5859867132332,0,0,915,0.0,0.0,1.0,915,24400,16800,7600,0.6885245901639344,320,168,152,135.3198540641473,0.41312950142092447,0.9251649203364982,0.10264506003402261,18041021.758297127,280861.68630016816,18321883.444597296,4579,15,2954.856830601093,109,806,84,31.35643682267474,0.6748853211009174,34.943181818181785,136129.46750097722,1248.8941972566718,0
4581,513.3863223551409,0,0,915,0.0,0.0,1.0,915,26500,18800,7700,0.7094339622641509,342,188,154,133.61135706916167,0.4129719641440774,0.9234147530340051,0.10166344177297001,18047004.70013012,272756.95780357905,18319761.657933697,4580,16,2955.856830601093,118,797,86,31.304953066367325,0.6739936440677966,34.84768907563023,136125.56976942753,1153.6065234697248,0
4582,513.4413170246357,0,0,915,0.0,0.0,1.0,915,25800,18600,7200,0.7209302325581395,330,186,144,136.5993817098445,0.41289160120051177,0.9245074448079127,0.10431435734586922,18064116.10283073,284709.4181562967,18348825.520987026,4581,17,2956.856830601093,123,792,88,31.112736327073463,0.6742039295392954,34.73622311827953,136197.38296107735,1107.2957964315233,0
4583,513.2288481146988,0,0,915,0.0,0.0,1.0,915,23000,15700,7300,0.6826086956521739,303,157,146,136.37598511668534,0.41284456919882184,0.9241406894680912,0.10447290074275306,18069821.790240787,286857.9495054003,18356679.739746187,4582,18,2957.856830601093,129,786,92,31.02054206802144,0.6741763565891472,34.63942307692305,136190.70322928103,1055.7418854983025,0
4584,512.7048703868753,0,0,915,0.0,0.0,1.0,915,24050,17200,6850,0.7151767151767152,309,172,137,134.3313983008366,0.4127676439757187,0.9232999554888508,0.10320379673935008,18063383.28211484,278245.90686608735,18341629.18898093,4583,19,2958.856830601093,135,780,95,30.985352886862714,0.6741512345679013,34.55116421568627,136096.9109451432,1008.12526626032,0
4585,512.2385104764487,0,1,914,0.0,0.001092896174863388,0.9989071038251366,915,23800,16500,7300,0.6932773109243697,311,165,146,132.58139669586635,0.4126347187845018,0.9225433197902622,0.10212915122792586,18057941.052919634,272029.40924953716,18329970.46216917,4584,20,2959.856830601093,141,774,99,30.949934847270935,0.6741282505910166,34.47036384976524,136014.5053089485,964.6418816237481,0
4586,512.4682632690462,0,0,914,0.0,0.0,1.0,914,25700,17900,7800,0.6964980544747081,335,179,156,135.79392541330213,0.412469027692229,0.9246706997897616,0.10493166963755203,18079019.54159605,282504.2062354271,18361523.74783148,4585,21,2963.964989059081,110,804,101,30.767973856209146,0.6803977272727273,34.37500000000001,136124.38243084087,1237.494385734917,0
4587,512.2487171610289,0,1,913,0.0,0.0010940919037199124,0.9989059080962801,914,22800,15400,7400,0.6754385964912281,302,154,148,133.3347712600563,0.4122817108897096,0.9232265952038066,0.10330069941157417,18082074.831041303,276593.8623008271,18358668.69334213,4586,22,2964.964989059081,104,810,104,30.752871846569352,0.6825921474358974,34.295634920634946,136106.72015599173,1308.718463038382,0
4588,512.5382161908552,0,0,913,0.0,0.0,1.0,913,23800,17100,6700,0.7184873949579832,305,171,134,130.4694645258712,0.41215970340692915,0.9211608375615583,0.10148597945334673,18108819.953683328,266129.60851050116,18374949.56219383,4587,23,2969.0985761226725,108,805,108,30.706098408589845,0.6828703703703703,34.17431192660554,136245.8239828461,1261.535407248575,0
4589,512.8843763603821,0,0,913,0.0,0.0,1.0,913,25900,19700,6200,0.7606177606177607,321,197,124,137.07943539089203,0.4119395244454693,0.9223034712122218,0.09837465363346311,17779602.38075952,278943.5711658109,18058545.95192533,4588,24,2970.0985761226725,138,775,95,33.08121774438369,0.6521739130434783,36.69064748201438,135047.25305604222,978.6032830147986,8
4590,512.5047558344687,0,0,913,0.0,0.0,1.0,913,24950,17900,7050,0.717434869739479,320,179,141,152.5165639318294,0.4118227795552225,0.9323929845739645,0.11243000169623071,17882071.224255387,337912.4118215381,18219983.636076923,4589,25,2971.0985761226725,111,802,78,31.806242591744997,0.6654466966966968,35.83519345238096,135385.71967974785,1219.6911682860166,8
4591,512.9261404498376,0,0,913,0.0,0.0,1.0,913,26800,20100,6700,0.75,335,201,134,152.69291644968712,0.41178334750485196,0.9326571361049947,0.11304712953767741,17915211.861342035,337705.18958447356,18252917.05092651,4590,26,2972.0985761226725,117,796,81,31.66346582052993,0.6655982905982907,35.6991525423729,135566.81360406318,1158.6907145646426,0
4592,513.2293443377603,0,0,913,0.0,0.0,1.0,913,24750,17600,7150,0.7111111111111111,319,176,143,151.7610026571678,0.41171789430449074,0.9323310866504924,0.11262263881400372,17935861.983010042,337042.879612438,18272904.86262248,4591,27,2973.0985761226725,124,789,83,31.612818492251158,0.665070564516129,35.62500000000001,135685.00790929582,1094.2339347523857,0
4593,513.042516035145,0,0,913,0.0,0.0,1.0,913,23400,17600,5800,0.7521367521367521,292,176,116,153.47135699883768,0.4115385985729201,0.9334372370856614,0.11427947639457042,17943783.19421969,344771.3513019691,18288554.545521658,4592,28,2974.0985761226725,132,781,87,31.459449988648384,0.6648516414141414,35.51848370927319,135690.2625625852,1027.9565345650394,0
4594,513.2540396167763,0,0,913,0.0,0.0,1.0,913,24300,17300,7000,0.7119341563786008,313,173,140,157.39363725610593,0.41128229024551155,0.9352771694506252,0.11762448253403943,17966526.291484453,358663.38437483774,18325189.67585929,4593,29,2975.0985761226725,92,821,92,31.240916338596595,0.674705615942029,35.40546594982079,135804.213461773,1476.1327550192718,0
4595,512.700689455083,0,0,913,0.0,0.0,1.0,913,24900,17500,7400,0.7028112449799196,323,175,148,156.87410513886957,0.4111295160706622,0.9348005272997679,0.11772004766448277,17964579.438610435,356135.46472562733,18320714.903336063,4594,30,2976.0985761226725,96,817,96,31.124244452557704,0.6748046875,35.27706185567009,135723.63290117265,1413.7878427205485,0
4596,512.2290154105973,0,0,913,0.0,0.0,1.0,913,24550,17300,7250,0.7046843177189409,318,173,145,153.75432669772857,0.41123985575475747,0.9321052852191565,0.11597239972808811,17969672.276441395,345432.97236861207,18315105.24881001,4595,31,2977.0985761226725,107,806,96,31.044989318962436,0.6735786604361371,35.117669753086396,135680.4152220401,1268.041263757384,0
4597,512.103643146949,0,0,913,0.0,0.0,1.0,913,25100,17500,7600,0.6972111553784861,327,175,152,156.33770525437112,0.411087832190004,0.9332184250272686,0.1185911169029618,17989065.414677355,354773.8413202795,18343839.255997635,4596,32,2978.0985761226725,111,802,67,30.798485619378443,0.6744557057057057,34.94233630952378,135736.9952199101,1222.855812791983,0
4598,512.3061579364231,0,0,913,0.0,0.0,1.0,913,23900,16800,7100,0.702928870292887,310,168,142,153.44188078148792,0.41088286559315407,0.9319985736476395,0.11712101887856725,18022213.442695297,346572.46529851475,18368785.907993812,4597,33,2979.0985761226725,121,792,75,30.680647653383122,0.6744146005509641,34.75068306010928,135888.85845673553,1123.0484169978142,0
4599,512.0035651859866,0,0,913,0.0,0.0,1.0,913,23200,17000,6200,0.7327586206896551,294,170,124,154.0469696521438,0.4107397993088782,0.9325858981010262,0.11787314267615027,18021848.52983291,349442.2307101419,18371290.760543052,4598,34,2980.0985761226725,124,789,78,30.587748777704526,0.6746471774193548,34.675000000000004,135847.3459329721,1095.5431123626781,0
4600,512.190759110388,0,0,913,0.0,0.0,1.0,913,25000,18200,6800,0.728,318,182,136,153.75346336289317,0.41065137743958285,0.932603135490961,0.11822674882265258,18048836.406794593,347414.22144298523,18396250.62823758,4599,35,2981.0985761226725,131,782,86,30.443165829394623,0.675015903307888,34.52493686868685,135973.87411010437,1037.9685046572852,0
4601,511.72454060085295,0,0,913,0.0,0.0,1.0,913,25000,17700,7300,0.708,323,177,146,154.8635140330639,0.41057896858566645,0.9338831260872367,0.11966726084373153,18052782.25508385,351543.4596192064,18404325.714703057,4600,36,2982.0985761226725,111,802,93,30.261437908496756,0.6801801801801801,34.37500000000001,135926.83109710194,1224.5660459198373,0
4602,511.3047331285152,0,0,913,0.0,0.0,1.0,913,24750,18500,6250,0.7474747474747475,310,185,125,151.80902399999923,0.4104391549451394,0.932364337349397,0.11771791563275472,18052411.19317399,340753.78481648554,18393164.977990475,4601,37,2983.0985761226725,97,816,97,30.234666666666712,0.6847079037800687,34.26870748299322,135869.66760430473,1400.718222724791,0
4603,511.5523546515951,0,0,913,0.0,0.0,1.0,913,25400,18700,6700,0.7362204724409449,321,187,134,150.3271681722721,0.4103674466606458,0.9314233898801934,0.11687427165321311,18071942.089620255,335340.7755411881,18407282.86516144,4602,38,2984.0985761226725,100,813,100,30.193500303935657,0.6846875,34.189356435643596,135976.06060680404,1359.7606060680403,0
4604,511.3944920438428,1,0,914,0.0010940919037199124,0.0,1.0,914,23750,16700,7050,0.7031578947368421,308,167,141,152.22192084818326,0.4103822041697724,0.93171032785146,0.11901967426227325,18089647.813283097,344178.18752102205,18433826.00080412,4603,0,2981.8326039387307,107,807,88,29.969305641174408,0.6846767912772586,34.0181327160494,136021.66191254972,1271.230485164016,0
4605,511.90058410569435,0,1,913,0.0,0.0010940919037199124,0.9989059080962801,914,27150,19300,7850,0.7108655616942909,350,193,157,166.92716599889158,0.410377011327586,0.936220191425625,0.1262024395088722,17967953.886314027,389917.9242082265,18357871.810522255,4604,1,2982.8326039387307,100,814,87,30.622567146749653,0.6760416666666667,35.045379537953764,135630.4249760224,1356.304249760224,8
4606,511.87943580073045,0,0,913,0.0,0.0,1.0,913,25550,18200,7350,0.7123287671232876,329,182,147,168.2100773618332,0.41026751543654677,0.9366850716044357,0.12762360915434348,17982063.129096463,396802.846014129,18378865.97511059,4605,41,2987.0985761226725,103,810,74,30.477252116082187,0.6763754045307444,34.9358974358974,135680.863271538,1317.2899346751262,0
4607,512.1180692463454,0,0,913,0.0,0.0,1.0,913,24000,18000,6000,0.75,300,180,120,152.0344867881039,0.4102555557156857,0.9331068076758608,0.11366021252791618,17928279.266809054,338543.3474646216,18266822.614273675,4606,42,2988.0985761226725,92,821,92,31.37134552432556,0.6748188405797102,35.3942652329749,135509.37800039895,1472.9280217434668,8
4608,512.3949828473534,0,0,913,0.0,0.0,1.0,913,26450,19500,6950,0.7372400756143668,334,195,139,150.3907353852956,0.41011449105833225,0.9318430963214754,0.11314243516512493,17964604.82138049,331292.0259987232,18295896.84737921,4607,43,2989.0985761226725,99,814,99,31.215538662260904,0.6747685185185186,35.19791666666665,135683.25894752578,1370.537969166927,0
4609,512.6574555226304,0,0,913,0.0,0.0,1.0,913,25750,18400,7350,0.7145631067961165,331,184,147,147.65032711391447,0.41015472375947165,0.9303151640822802,0.11156538169818071,17992141.63003123,322959.11943079164,18315100.749462023,4608,44,2990.0985761226725,105,808,93,31.151088031651813,0.6746031746031746,35.062893081760976,135821.98310622983,1293.542696249808,0
4610,513.0057545741132,0,0,913,0.0,0.0,1.0,913,23100,17600,5500,0.7619047619047619,286,176,110,145.40046732979977,0.4100055525130826,0.9293731702396901,0.11021957080704857,18017897.51002199,318262.14365151816,18336159.653673507,4609,45,2991.0985761226725,107,806,77,31.109703470528974,0.675136292834891,34.96334876543206,135965.32725638337,1270.703993050312,0
4611,513.0217434318611,0,0,913,0.0,0.0,1.0,913,24600,17600,7000,0.7154471544715447,316,176,140,146.54433706633426,0.40995861436175324,0.9297499054948688,0.11134689408617222,18028278.450782545,321188.4228034336,18349466.873585977,4610,46,2992.0985761226725,110,803,78,31.006120943952762,0.6751893939393939,34.891141141141105,136006.6089710009,1236.42371791819,0
4612,513.3067856201515,0,1,912,0.0,0.001095290251916758,0.9989047097480832,913,24850,17900,6950,0.7203219315895373,318,179,139,146.31641889778166,0.4098094931560372,0.9297680617492472,0.11153341392627139,18051834.46168023,320805.95459371404,18372640.416273944,4611,47,2993.0985761226725,114,799,80,30.911233307148432,0.6753472222222222,34.79166666666663,136133.23710300878,1194.1512026579717,0
4613,513.5941599570556,0,0,912,0.0,0.0,1.0,912,24750,17300,7450,0.6989898989898989,322,173,149,146.20470183429276,0.409661615304498,0.929375486991749,0.11172162616717096,18072196.082818642,321298.0079558649,18393494.090774506,4612,48,2996.0712719298244,118,794,83,30.83781539409135,0.6753177966101696,34.716386554621806,136248.1145978487,1154.6450389648196,0
4614,513.6912474617482,0,0,912,0.0,0.0,1.0,912,25100,18500,6600,0.7370517928286853,317,185,132,145.17365468635663,0.40957307454054087,0.9289783675337,0.11137970971735459,18092374.201569274,317807.216958983,18410181.41852826,4613,49,2997.0712719298244,123,789,87,30.74040957143761,0.6756436314363143,34.59341397849458,136337.0402579481,1108.4312216093342,0
4615,514.0906764957048,0,0,912,0.0,0.0,1.0,912,23400,16400,7000,0.7008547008547008,304,164,140,145.84085707980097,0.4095457425006901,0.9300824710781075,0.11239692020316809,18125230.47597493,322879.82947701344,18448110.30545194,4614,50,2998.0712719298244,128,784,91,30.583029243322652,0.6761881510416667,34.455749354005135,136513.82345414232,1066.5142457354868,0
4616,514.3659820265968,0,0,912,0.0,0.0,1.0,912,24400,17600,6800,0.7213114754098361,312,176,136,145.63629373317934,0.4093354362454343,0.9303792569659448,0.11253713606654794,18145967.871787947,321742.3014097108,18467710.173197657,4615,51,2999.0712719298244,110,802,95,30.506535947712443,0.6803977272727273,34.37500000000001,136628.46397581513,1242.076945234683,0
4617,514.629050633162,0,1,911,0.0,0.0010964912280701754,0.9989035087719298,912,24750,17900,6850,0.7232323232323232,316,179,137,145.74542636364183,0.40922382623683246,0.9296929041596549,0.11311952248609504,18173581.07014308,322593.2643244473,18496174.33446753,4616,52,3000.0712719298244,100,812,100,30.367607109593333,0.6841666666666666,34.240924092409266,136767.3409314711,1367.6734093147109,0
4618,514.1275360999751,0,0,911,0.0,0.0,1.0,911,25300,17600,7700,0.6956521739130435,330,176,154,143.32450857566,0.4089653622996104,0.9285250023529055,0.11173308548123538,18174154.28835338,313460.3464313,18487614.63478468,4617,53,3003.935236004391,104,807,104,30.296246548765055,0.6844951923076923,34.10714285714288,136702.83950944117,1314.4503798984729,0
4619,514.2067474933559,0,0,911,0.0,0.0,1.0,911,25400,18600,6800,0.7322834645669292,322,186,136,144.93187725758884,0.40882372749826096,0.9288408772325032,0.11342852368797761,18193083.89369245,319751.5603635343,18512835.454055984,4618,54,3004.935236004391,107,804,96,30.133853033599244,0.6849688473520249,33.98919753086422,136784.54953575294,1278.3602760350743,0
4620,513.9198238009697,0,0,911,0.0,0.0,1.0,911,26450,18300,8150,0.6918714555765595,346,183,163,145.70633787551424,0.40862137770754675,0.9288836815157113,0.11463402244904988,18204494.24884384,321852.03797498293,18526346.286818825,4619,55,3005.935236004391,114,797,75,29.95327831660148,0.685032894736842,33.83152173913045,136789.25744919927,1199.9057670982393,0
4621,514.2277874892046,0,0,911,0.0,0.0,1.0,911,23500,17700,5800,0.7531914893617021,293,177,116,148.231727101896,0.40829412994616066,0.9300693838627538,0.1173762407051574,18241871.42798569,335104.8214682119,18576976.249453902,4620,56,3006.935236004391,122,789,79,29.689884586035866,0.6854508196721312,33.63821138211383,136970.63323264342,1122.7101084642904,0
4622,514.3104589186888,0,0,911,0.0,0.0,1.0,911,26300,19000,7300,0.7224334600760456,336,190,146,148.48921860490162,0.4082136122201984,0.9257993529923321,0.10325420635550485,17690111.64292314,316858.17097822105,18006969.81390136,4621,57,3007.935236004391,142,769,89,33.823934436853065,0.6412852112676056,37.71853146853145,134894.1024462861,949.9584679315922,8
4623,514.3769772831154,0,0,911,0.0,0.0,1.0,911,24350,17200,7150,0.7063655030800822,315,172,143,150.54304231507288,0.40820446476319144,0.9281365808529392,0.10503740214800555,17707446.90332486,326596.58569182205,18034043.489016682,4622,58,3008.935236004391,145,766,92,33.656876807062346,0.6420258620689655,37.60702054794518,134968.9076308569,930.8200526265994,0
4624,513.9673694322838,0,0,911,0.0,0.0,1.0,911,24000,16500,7500,0.6875,315,165,150,153.02471255909512,0.4082461811880034,0.93107892464574,0.10715200811091588,17709216.114746682,335789.5411212061,18045005.65586789,4623,59,3009.935236004391,97,814,97,33.472309389804444,0.6521692439862543,37.48937074829934,134921.8975645113,1390.9473975722815,0
4625,513.522297460636,2,0,913,0.002190580503833516,0.0,1.0,913,26700,19600,7100,0.7340823970037453,338,196,142,155.28255758039927,0.408761291177469,0.9316184745180938,0.1093569064401043,17719137.05040169,340994.58386080427,18060131.634262495,4624,0,3004.3395399780943,99,814,99,33.22284289622904,0.6535143097643097,37.302083333333364,134901.23770479104,1362.638764694859,0
4626,513.722304584965,0,0,913,0.0,0.0,1.0,913,25500,18500,7000,0.7254901960784313,325,185,140,152.33006132371412,0.40875948971323894,0.929648330713206,0.10782420773612215,17748405.043763608,332623.1257429297,18081028.16950654,4625,1,3005.3395399780943,105,808,90,33.13219653071145,0.6536706349206349,37.1363993710692,135038.89470659726,1286.0847114914025,0
4627,513.8101809387543,0,1,912,0.0,0.001095290251916758,0.9989047097480832,913,25600,18900,6700,0.73828125,323,189,134,149.56217379778587,0.4089362333704835,0.9272785313237752,0.10631982879100899,17770256.515365567,323351.6386764703,18093608.15404204,4626,2,3006.3395399780943,115,798,82,33.06359828826372,0.6528985507246376,36.99712643678162,135133.55405293018,1175.074383068958,0
4628,513.3996814028435,0,0,912,0.0,0.0,1.0,912,24900,18600,6300,0.7469879518072289,312,186,126,149.08171511114887,0.4089417294952529,0.92644261340598,0.10627289035435877,17768206.219246164,322482.9315227605,18090689.150768925,4627,3,3010.5625,122,790,84,32.98494871134573,0.6524931693989071,36.90718157181572,135071.76916040605,1107.1456488557874,0
4629,512.8660009053168,0,0,912,0.0,0.0,1.0,912,25200,19300,5900,0.7658730158730159,311,193,118,151.91412465512707,0.40892964321708036,0.9273082648793887,0.10888504536799429,17773547.653896276,332410.5867715685,18105958.240667846,4628,4,3011.5625,129,783,91,32.7313377566756,0.6531007751937985,36.73076923076923,135021.8375460345,1046.6809112095698,0
4630,512.420544504389,0,0,912,0.0,0.0,1.0,912,23850,17700,6150,0.7421383647798742,300,177,123,152.8720730951521,0.4090045179611121,0.9280572800435927,0.1099259536898765,17772133.742091507,337122.5856955661,18109256.32778707,4629,5,3012.5625,135,777,93,32.600598111634554,0.6532407407407408,36.626838235294116,134957.81895931295,999.6875478467626,0
4631,512.2336240107213,1,0,913,0.001095290251916758,0.0,1.0,913,24850,17500,7350,0.704225352112676,322,175,147,150.8097317204801,0.40905528013169107,0.9277144867754687,0.10879421165578744,17779663.815251198,328819.26601166313,18108483.08126286,4630,0,3010.261774370208,144,769,98,32.54949876395094,0.6530671296296297,36.522988505747094,134961.78444121312,937.2346141750911,0
4632,512.2513302041457,0,0,913,0.0,0.0,1.0,913,23700,17200,6500,0.7257383966244726,302,172,130,153.6551559389915,0.409088256935237,0.9289179937502838,0.11144672015915776,17803601.854842383,340823.0438563115,18144424.898698695,4631,1,3011.261774370208,105,808,105,32.299121286667415,0.6616071428571428,36.35023584905663,135054.9423943316,1286.2375466126819,0
4633,511.97316956732163,0,0,913,0.0,0.0,1.0,913,23500,17400,6100,0.7404255319148936,296,174,122,150.08565599886293,0.40904702342063626,0.9270629618519177,0.10940273314761854,17815434.218210235,328668.22630894126,18144102.444519177,4632,2,3012.261774370208,112,801,112,32.23160831178512,0.6616443452380952,36.19100294985253,135063.12838014163,1205.9207891084075,0
4634,512.1371260301346,0,0,913,0.0,0.0,1.0,913,24200,17300,6900,0.7148760330578512,311,173,138,149.8936076488704,0.40910361942186607,0.93306051697904,0.10198728225241437,17518321.963683255,318376.8958181806,17836698.859501436,4633,3,3013.261774370208,93,820,93,34.52134439124966,0.6437051971326164,38.44193262411345,133953.59691588162,1440.3612571600174,8
4635,512.6079557984407,0,0,913,0.0,0.0,1.0,913,24450,17300,7150,0.7075664621676891,316,173,143,144.80648841677908,0.4091050706013848,0.929663417420725,0.09910240558759706,17560592.39372094,301527.5438106188,17862119.937531557,4634,4,3014.261774370208,105,808,94,34.456499974971194,0.6424603174603174,38.24685534591192,134176.74440494386,1277.8737562375607,0
4636,512.8211687615886,0,0,913,0.0,0.0,1.0,913,25200,17000,8200,0.6746031746031746,334,170,164,145.6294251316589,0.40919849653798607,0.9298893929914454,0.10004219445682672,17584770.631378613,304372.00762394443,17889142.639002558,4635,5,3015.261774370208,108,805,73,34.307451130654776,0.6430362654320987,38.12117737003056,134297.00389500844,1243.4907768056337,0
4637,513.0733873874677,0,0,913,0.0,0.0,1.0,913,22700,15700,7000,0.6916299559471366,297,157,140,145.25236426429655,0.4091733260794374,0.9293380150201764,0.10004318195983378,17605045.82862368,306134.90591777075,17911180.73454145,4636,6,3016.261774370208,112,801,76,34.22955227907193,0.6430431547619048,38.03466076696163,134407.44397840076,1200.066464092864,0
4638,513.1539897342436,0,0,913,0.0,0.0,1.0,913,24000,16000,8000,0.6666666666666666,320,160,160,148.44136359769325,0.4090555303350563,0.9305258600818482,0.10257592483811886,17622458.70216052,316580.35993854597,17939039.062099066,4637,7,3017.261774370208,114,799,80,34.035458357815216,0.6437317251461988,37.92572463768115,134484.46000888405,1179.6882456919654,0
4639,513.0379132140237,0,0,913,0.0,0.0,1.0,913,24700,17600,7100,0.7125506072874493,318,176,142,149.24453377540965,0.4090360144725633,0.9311822610956642,0.10347621008428287,17633346.0292018,319036.10140573245,17952382.13060753,4638,8,3018.261774370208,118,795,83,33.90216012286321,0.6440677966101696,37.81512605042014,134510.78060737267,1139.9218695540058,0
4640,512.5883419990523,1,0,914,0.0010940919037199124,0.0,1.0,914,25000,18100,6900,0.724,319,181,138,150.02594844315323,0.4092870637113802,0.9316069110580103,0.10445164650543115,17636348.421324737,321381.97979662544,17957730.401121363,4639,0,3015.9584245076585,122,792,89,33.74233252623079,0.6447233606557377,37.677845528455265,134463.27823018722,1102.1580182802231,0
4641,512.1432001172926,0,0,914,0.0,0.0,1.0,914,24350,17300,7050,0.7104722792607803,314,173,141,151.64912374536584,0.40929607628844406,0.9325115380254243,0.10596745395766197,17637154.595992714,327781.8079687631,17964936.403961476,4640,1,3016.9584245076585,125,789,93,33.57795847115029,0.6454166666666667,37.557870370370345,134407.95211411425,1075.263616912914,0
4642,512.5461529550278,0,0,914,0.0,0.0,1.0,914,25150,18600,6550,0.7395626242544732,317,186,131,153.32246454850758,0.4093068364566282,0.9333890999268197,0.10736122676764298,17660276.595146537,333593.4264352416,17993870.02158178,4641,2,3017.9584245076585,95,819,95,33.4642682456358,0.6527412280701754,37.48914930555557,134548.92663238992,1416.3044908672623,0
4643,512.2603646871399,0,1,913,0.0,0.0010940919037199124,0.9989059080962801,914,23950,17600,6350,0.7348643006263048,303,176,127,154.61182368523131,0.4092688388325532,0.9339963420453306,0.1086504249037174,17666126.118871417,339528.3953384032,18005654.51420982,4642,3,3018.9584245076585,97,817,97,33.31191651826669,0.6533505154639175,37.372448979591844,134533.68506260507,1386.9452068309802,0
4644,511.9421654408488,0,0,913,0.0,0.0,1.0,913,24100,16800,7300,0.6970954356846473,314,168,146,153.55134908655364,0.40917397660818716,0.9327115727238164,0.10828621197797703,17670640.172911033,335970.12755470903,18006610.30046574,4643,4,3023.0952902519166,102,811,102,33.22283166538365,0.6531862745098039,37.257281553398066,134509.07623536896,1318.716433680088,0
4645,511.64734404269603,1,0,914,0.0010940919037199124,0.0,1.0,914,26400,19300,7100,0.7310606060606061,335,193,142,152.43360557396215,0.40937184684630706,0.9318959218032672,0.10804223108373523,17682581.895795956,329883.94284660823,18012465.838642564,4644,0,3020.7866520787748,109,805,96,33.08521383375958,0.6531918960244648,37.09280303030303,134515.7690592553,1234.0896243968377,0
4646,512.0036611489186,0,1,913,0.0,0.0010940919037199124,0.9989059080962801,914,25100,17600,7500,0.701195219123506,326,176,150,152.9534495544181,0.4094522360378454,0.9325837087284559,0.108837250114358,17712058.240167562,333924.0813084761,18045982.32147604,4645,1,3021.7866520787748,112,802,72,32.94213336137003,0.6538318452380952,36.96533923303834,134674.70932174788,1202.4527618013203,0
4647,511.9686823340678,0,0,913,0.0,0.0,1.0,913,25050,18100,6950,0.7225548902195609,320,181,139,151.32532794460803,0.4092909216611262,0.931464704738646,0.10800858643712946,17724185.256571177,328773.6293003226,18052958.8858715,4646,7,3026.0952902519166,119,794,76,32.884440394110335,0.6534488795518207,36.866319444444436,134716.20371174082,1132.0689387541245,0
4648,511.78636836756164,0,0,913,0.0,0.0,1.0,913,26350,19100,7250,0.7248576850094877,336,191,145,150.17346499718576,0.4093056336190055,0.9309436108148905,0.10766375880910228,17737195.124166306,323781.2102254431,18060976.33439175,4647,8,3027.0952902519166,125,788,83,32.769159915426314,0.6538333333333333,36.72288359788357,134741.63927772132,1077.9331142217704,0
4649,511.854632006039,0,0,913,0.0,0.0,1.0,913,25150,18100,7050,0.7196819085487077,322,181,141,155.53196715990774,0.40925749449152266,0.9330590176988929,0.1118629806583164,17753450.87133519,344495.82757910166,18097946.698914293,4648,9,3028.0952902519166,128,785,87,32.52342847799203,0.6543782552083333,36.61983204134364,134812.35894816506,1053.2215542825395,0
4650,511.4719875962872,0,1,912,0.0,0.001095290251916758,0.9989047097480832,913,23850,16400,7450,0.6876310272536688,313,164,149,158.86701892013917,0.40910141763225144,0.9344835785746137,0.11455793460781369,17751385.816008404,357571.94925809425,18108957.765266497,4649,10,3029.0952902519166,132,781,90,32.35109050011393,0.654592803030303,36.536654135338324,134754.1211681651,1020.864554304281,0
4651,511.83712239165504,1,0,913,0.001095290251916758,0.0,1.0,913,23400,16600,6800,0.7094017094017094,302,166,136,138.2385834486247,0.4091205832100331,0.9228561789871976,0.09578911489768047,17589467.800887007,280308.6224819641,17869776.42336897,4650,0,3029.9222343921138,136,777,84,34.21041183294663,0.6409313725490196,37.8345498783455,134186.0095807807,986.6618351527992,8
4652,511.79548942897003,0,0,913,0.0,0.0,1.0,913,24450,17400,7050,0.7116564417177914,315,174,141,144.07269707426457,0.4091681718901123,0.9253006937690005,0.10018311183576604,17603607.294664033,300189.83623568836,17903797.13089972,4651,1,3030.9222343921138,142,771,88,33.9397716121387,0.6412852112676056,37.71853146853147,134234.47255521183,945.313187008534,0
4653,511.5664867326808,0,0,913,0.0,0.0,1.0,913,24200,17400,6800,0.71900826446281,310,174,136,147.43663393984286,0.409151007939253,0.9277050059553584,0.10284767924452962,17609737.971229162,312464.0982081273,17922202.069437288,4652,2,3031.9222343921138,145,768,91,33.745626676818226,0.6419540229885057,37.61415525114153,134227.80476655858,925.7089983900592,0
4654,511.98235960524994,1,0,914,0.0010940919037199124,0.0,1.0,914,24000,16500,7500,0.6875,315,165,150,148.90771644472647,0.4093534721739554,0.9286418596345147,0.10414663387110168,17635634.173688076,318416.4025716875,17954050.576259762,4653,0,3029.6039387308533,148,766,96,33.619553057745584,0.642454954954955,37.52796420581653,134381.0522162978,907.9800825425527,0
4655,512.3672973462773,0,0,914,0.0,0.0,1.0,914,27050,19800,7250,0.7319778188539742,343,198,145,146.8035651375116,0.40934206290049796,0.926527126378424,0.10310525796643946,17667334.780402727,308875.54644821957,17976210.326850947,4654,1,3030.6039387308533,104,810,104,33.53567740798107,0.6513421474358974,37.39087301587304,134552.3286513237,1293.7723908781127,0
4656,512.6240598491571,0,0,914,0.0,0.0,1.0,914,26100,18200,7900,0.6973180076628352,340,182,158,144.00468410556675,0.40930099450916857,0.924901783280647,0.10139346200547747,17687229.559126064,300508.7810729213,17987738.340198986,4655,2,3031.6039387308533,108,806,108,33.52599316065195,0.6512345679012346,37.30886850152907,134661.79431511578,1246.8684658807017,0
4657,512.109614927958,0,0,914,0.0,0.0,1.0,914,22150,15500,6650,0.6997742663656885,288,155,133,143.609340444439,0.40937289540097926,0.9247350811632844,0.10146613845676608,17684693.980953947,302987.4477133078,17987681.428667255,4656,3,3032.6039387308533,112,802,99,33.42168262653902,0.6515066964285714,37.19579646017699,134584.55947622744,1201.6478524663164,0
4658,511.95569776360327,1,0,915,0.001092896174863388,0.0,1.0,915,24500,17100,7400,0.6979591836734694,319,171,148,141.06126575141377,0.40952243585911124,0.9232061847561692,0.10011780370529097,17699187.222805243,291833.9504840309,17991021.173289273,4657,0,3030.288524590164,119,796,80,33.3393855363352,0.6516106442577031,37.04861111111111,134619.46177651946,1131.2559813152895,0
4659,512.1820226381807,0,0,915,0.0,0.0,1.0,915,23850,16800,7050,0.7044025157232704,309,168,141,155.3733561885327,0.40942249285552007,0.9284438784924096,0.10438112557447428,17462591.794812944,335794.2989820862,17798386.09379503,4658,1,3031.288524590164,126,789,85,34.812482331878044,0.6320271164021164,38.86975065616799,133746.2192809369,1061.4779308010866,8
4660,511.76578457745035,0,0,915,0.0,0.0,1.0,915,25150,18400,6750,0.731610337972167,319,184,135,160.95403096282243,0.40974075601949833,0.9294156858728262,0.1085842027430853,17467317.447894257,354137.03066916816,17821454.478563424,4659,2,3032.288524590164,133,782,92,34.522959436675606,0.6323621553884712,38.72823383084579,133709.95040149463,1005.3379729435686,0
4661,511.30182571981004,0,0,915,0.0,0.0,1.0,915,25550,18600,6950,0.7279843444227005,325,186,139,160.41855510898648,0.409790876987401,0.9301285351538133,0.1085635999447001,17465628.380350277,351812.1737692774,17817440.554119553,4660,3,3033.288524590164,141,774,95,34.42937680671331,0.632313829787234,38.62235915492963,133642.86496642532,947.8217373505341,0
4662,511.27876255552167,1,0,916,0.001091703056768559,0.0,1.0,916,23450,17200,6250,0.7334754797441365,297,172,125,160.79016629438632,0.4101538326930266,0.9304969600515551,0.10924099106779336,17482385.981988393,355549.14985330874,17837935.1318417,4661,0,3030.975982532751,102,814,102,34.286294376982,0.6407271241830066,38.49110032362458,133703.9466237924,1310.8230061156119,0
4663,511.40410079565066,0,0,916,0.0,0.0,1.0,916,24700,17700,7000,0.7165991902834008,317,177,140,159.00719552912688,0.41021430886645827,0.929384859739804,0.10845288986538215,17504196.776134048,348758.6478726125,17852955.42400666,4662,1,3031.975982532751,108,808,108,34.199828938076834,0.640625,38.36009174311927,133803.72201436677,1238.9233519848774,0
4664,511.5604450768417,0,0,916,0.0,0.0,1.0,916,25950,19000,6950,0.7321772639691715,329,190,139,157.09895260901297,0.41021162435074493,0.9282591249212873,0.1077037031833706,17532534.8654964,341718.5727900967,17874253.4382865,4663,2,3032.975982532751,114,802,95,34.075373074084304,0.6410818713450293,38.188405797101446,133932.45565671206,1174.8461022518602,0
4665,511.37524240688083,0,0,916,0.0,0.0,1.0,916,23350,16600,6750,0.7109207708779444,301,166,135,144.88630725875032,0.4103756532321569,0.9288837760056461,0.10026855721893328,17567984.86767388,302522.09069097025,17870506.95836485,4664,3,3033.975982532751,118,798,83,34.07858852340396,0.6434498587570621,37.87640056022407,134043.51920407842,1135.962027153207,8
4666,511.73899917571015,0,0,916,0.0,0.0,1.0,916,24700,18600,6100,0.7530364372469636,308,186,122,148.69271664981187,0.41047435889787703,0.9311498694118496,0.1034276962774104,17603033.08490521,315588.56213421415,17918621.647039425,4665,4,3034.975982532751,124,792,86,33.80824728620595,0.6440692204301075,37.70833333333333,134224.8749921287,1082.4586692913604,0
4667,511.565557357342,0,1,915,0.0,0.001091703056768559,0.9989082969432315,916,27650,20600,7050,0.7450271247739603,347,206,141,150.63489530687903,0.41056008940431593,0.9331617675833255,0.10526164114304619,17617383.169865984,319908.5338747919,17937291.703740776,4666,5,3035.975982532751,127,789,90,33.60365825296905,0.6450951443569554,37.55696614583335,134256.81688815978,1057.140290457951,0
4668,511.34062855412134,0,0,915,0.0,0.0,1.0,915,24900,18300,6600,0.7349397590361446,315,183,132,151.34027694501222,0.4103453464225786,0.9333910921349773,0.10600979186361208,17620257.60604052,325430.9331881302,17945688.539228648,4667,10,3040.288524590164,93,822,93,33.50481919234557,0.6534498207885304,37.477836879432644,134238.24789945938,1443.4220204242945,0
4669,511.6411261165993,0,0,915,0.0,0.0,1.0,915,25350,18000,7350,0.7100591715976331,327,180,147,150.80240715077153,0.4103591969484999,0.9330492038096481,0.10591177765127677,17642211.79670758,323747.6012814518,17965959.397989035,4668,11,3041.288524590164,95,820,95,33.43129355700631,0.6537280701754387,37.39149305555558,134361.31222085538,1414.3296023247935,0
4670,511.4684002257918,1,0,916,0.001091703056768559,0.0,1.0,916,22350,15400,6950,0.6890380313199105,293,154,139,149.17498661271966,0.4103997393036963,0.9317775344698054,0.10510891620411532,17650490.091116264,321052.32461004704,17971542.41572631,4669,0,3038.967248908297,101,815,101,33.36649659863948,0.6531559405940595,37.2855392156863,134370.14497353585,1330.3974749855035,0
4671,511.466354022341,0,0,916,0.0,0.0,1.0,916,25800,19300,6500,0.748062015503876,323,193,130,150.03214157000383,0.41039494197468995,0.9310260154030732,0.10642026689894664,17679619.43122172,321502.23308177275,18001121.664303493,4670,1,3039.967248908297,110,806,70,33.12349798938776,0.653219696969697,37.06831831831833,134480.7085866933,1222.5518962426663,0
4672,511.4530339696463,0,0,916,0.0,0.0,1.0,916,26000,18500,7500,0.7115384615384616,335,185,150,152.56966306206866,0.4102007620047566,0.9318354627502052,0.10850270160012983,17690540.65415027,330607.96539790917,18021148.61954818,4671,2,3040.967248908297,114,802,70,32.970864758756086,0.653234649122807,36.98369565217392,134520.48684217996,1180.0042705454382,0
4673,511.7156907180091,0,2,914,0.0,0.002183406113537118,0.9978165938864629,916,25100,17700,7400,0.7051792828685259,325,177,148,151.9417409268576,0.41011791486704685,0.9320345694943699,0.10838908866511318,17713038.365502313,329969.97727173445,18043008.34277405,4672,3,3041.967248908297,114,802,76,32.88622854126504,0.6542397660818713,36.88405797101452,134640.55601428362,1181.0575088972248,0
4674,511.74689114001404,0,0,914,0.0,0.0,1.0,914,25550,17600,7950,0.6888454011741683,335,176,159,152.06802703408417,0.41003101325133434,0.9322020048040658,0.10881239169847196,17727464.619946126,330806.1138143531,18058270.73376048,4673,16,3047.3074398249455,117,797,78,32.78229840918489,0.6546474358974359,36.784957627118665,134699.4796356104,1151.2776037231658,0
4675,512.2221979258067,0,0,914,0.0,0.0,1.0,914,26450,19400,7050,0.7334593572778828,335,194,141,153.25847663563468,0.4100563782881676,0.9333188171033888,0.1101191836821115,17761921.526634198,335183.00705873076,18097104.53369293,4674,17,3048.3074398249455,123,791,80,32.61550740587151,0.6548949864498645,36.651545698924735,134892.924082461,1096.6904396948048,0
4676,511.89783489712426,0,0,914,0.0,0.0,1.0,914,25250,18100,7150,0.7168316831683168,324,181,143,157.7759744225139,0.4100755518593171,0.9355610510492094,0.11374111220245209,17765021.182402413,352528.7055380201,18117549.887940433,4675,18,3049.3074398249455,131,783,82,32.38845414607349,0.6546596692111959,36.54513888888886,134861.97299589837,1029.4807098923538,0
4677,511.5535865074106,0,0,914,0.0,0.0,1.0,914,24550,18600,5950,0.7576374745417516,305,186,119,158.6649597077283,0.4101738663426333,0.9357132197352322,0.115017276520384,17776988.793749526,356767.0421369998,18133755.835886527,4676,19,3050.3074398249455,91,823,91,32.18483364828497,0.6652930402930404,36.3677536231884,134862.02115306287,1482.0002324512404,0
4678,512.0435218683608,0,0,914,0.0,0.0,1.0,914,23400,16100,7300,0.688034188034188,307,161,146,155.89426014388877,0.41010161593259853,0.9340198732024774,0.11350895171499206,17813040.107812412,349190.141704171,18162230.249516584,4677,20,3051.3074398249455,98,816,98,32.114779874213845,0.6646471088435374,36.22685185185187,135063.33175208358,1378.197262776363,0
4679,511.77010318392814,1,0,915,0.001092896174863388,0.0,1.0,915,24450,17700,6750,0.7239263803680982,312,177,135,155.10465654665822,0.4101522860342855,0.9337987086722455,0.11341863425237007,17821914.281799667,345402.37873650686,18167316.660536174,4678,0,3048.9715846994536,101,814,88,31.997329928024133,0.6652227722772277,36.090686274509814,135060.89671649435,1337.2366011534093,0
4680,511.8697589218741,0,1,914,0.0,0.001092896174863388,0.9989071038251366,915,24250,17700,6550,0.7298969072164948,308,177,131,153.2800265079817,0.40995768116288617,0.9326500935501869,0.1124217814999063,17838262.98298942,339599.88457779726,18177862.867567215,4679,1,3049.9715846994536,107,808,73,31.94870670758436,0.6647196261682242,35.99537037037039,135135.98612277824,1262.9531413343761,0
4681,511.44369179963724,0,1,913,0.0,0.0010940919037199124,0.9989059080962801,914,25050,17600,7450,0.7025948103792415,325,176,149,152.43199739548783,0.4096491146603522,0.9319847418329923,0.1122637388206723,17841103.260739725,336061.001154744,18177164.26189447,4680,2,3049.289934354486,113,801,77,31.838128884583924,0.6647308259587021,35.864400584795334,135090.4861006231,1195.4910274391425,0
4682,511.1480696597985,0,0,913,0.0,0.0,1.0,913,26750,19100,7650,0.7140186915887851,344,191,153,151.57409926534845,0.4092960758504513,0.9321079444629823,0.11214669896791232,17850376.703339346,331780.95407117007,18182157.657410517,4681,24,3053.6276013143483,116,797,82,31.713563423617675,0.6655890804597702,35.71937321937324,135086.5322274003,1164.5390709258647,0
4683,510.88214733109197,0,0,913,0.0,0.0,1.0,913,26200,19600,6600,0.7480916030534351,328,196,132,153.19202831364882,0.4092278203723987,0.932690059319436,0.11363516005383913,17851989.228852045,338156.48788025766,18190145.7167323,4682,25,3054.6276013143483,121,792,84,31.58885623237089,0.665461432506887,35.638661202185816,135057.48843635112,1116.1775903830671,0
4684,511.0723449145442,0,1,912,0.0,0.001095290251916758,0.9989047097480832,913,27500,20300,7200,0.7381818181818182,347,203,144,153.47123345165306,0.4090585327754399,0.9329917641089307,0.11420200738937789,17872008.56840602,338467.8398503676,18210476.408256385,4683,26,3055.6276013143483,126,787,88,31.480993290533405,0.6655919312169312,35.5396981627297,135158.34659678454,1072.685290450671,0
4685,511.0264666174954,0,0,912,0.0,0.0,1.0,912,26150,18900,7250,0.722753346080306,334,189,145,152.13373252756776,0.40884847458130325,0.9326051040678878,0.11353809548651507,17882767.621040132,335564.4372224022,18218332.058262534,4684,27,3059.7412280701756,131,781,93,31.423507536889037,0.6657124681933841,35.448232323232354,135192.95507327322,1032.0072906356734,0
4686,510.73719793455933,0,0,912,0.0,0.0,1.0,912,24500,17400,7100,0.710204081632653,316,174,142,149.9239044531547,0.40871056061875327,0.9318325935320237,0.1123076179567848,17888403.007999368,329479.84467816056,18217882.852677528,4685,28,3060.7412280701756,97,815,97,31.363621151271758,0.6739690721649485,35.331632653061206,135175.98032068918,1393.5668074297853,0
4687,510.45706620622093,0,0,912,0.0,0.0,1.0,912,25250,18100,7150,0.7168316831683168,324,181,143,148.43624743955488,0.40859017426708005,0.9302688517122877,0.11163459792643331,17895253.330929577,323610.85028466996,18218864.181214247,4686,29,3061.7412280701756,104,808,104,31.277865198006847,0.6733774038461539,35.20833333333331,135164.7773225208,1299.6613204088537,0
4688,510.4901575801136,0,0,912,0.0,0.0,1.0,912,24850,18500,6350,0.744466800804829,312,185,127,147.67649855129588,0.4084808461076768,0.9300641531382174,0.11126724384836255,17904118.72147926,321553.51248694595,18225672.233966205,4687,30,3062.7412280701756,105,807,105,31.240144150495333,0.6737103174603174,35.15133647798739,135202.6359762331,1287.644152154601,0
4689,510.8444645063785,0,1,911,0.0,0.0010964912280701754,0.9989035087719298,912,25500,19400,6100,0.7607843137254902,316,194,122,148.03111705396117,0.40833581076960607,0.929500634606498,0.11184084693001972,17928053.74140168,322881.96438862226,18250935.705790304,4688,31,3063.7412280701756,109,803,96,31.14444454373236,0.6736429663608563,35.066287878787854,135339.92029824623,1241.6506449380388,0
4690,511.1725781965509,0,0,911,0.0,0.0,1.0,911,23400,16600,6800,0.7094017094017094,302,166,136,147.83527705293292,0.40814586072544357,0.9293183067540505,0.11207815071085546,17953993.720269967,325246.72716854006,18279240.44743851,4689,32,3066.928649835346,113,798,72,31.04156611275821,0.6738569321533923,34.9597953216374,135481.28475117873,1198.9494225768028,0
4691,511.19745641329325,0,0,911,0.0,0.0,1.0,911,24250,16900,7350,0.6969072164948453,316,169,147,146.9584405858454,0.40807735531939704,0.9285305122372118,0.11189233364242607,17972792.70399533,321800.7177503568,18294593.421745684,4690,33,3067.928649835346,121,790,76,30.930594015305214,0.6736398071625345,34.82752732240435,135555.49354360902,1120.293335071149,0
4692,510.9865397998151,0,0,911,0.0,0.0,1.0,911,24500,17400,7100,0.710204081632653,316,174,142,150.54206467387544,0.4081149503624806,0.9299416442807651,0.11511663413572434,17983355.14494911,334750.2826568346,18318105.427605942,4691,34,3068.928649835346,126,785,80,30.700923864877648,0.6741071428571428,34.694881889763764,135567.34429432979,1075.9313039232522,0
4693,510.6552360735411,0,0,911,0.0,0.0,1.0,911,22750,16100,6650,0.7076923076923077,294,161,133,152.31245396666014,0.40795612638367856,0.931757930403156,0.11706300033437589,17992756.223903738,343154.1708173349,18335910.394721072,4692,35,3069.928649835346,132,779,85,30.496179264766617,0.6747159090909092,34.53947368421053,135558.80773399593,1026.9606646514842,0
4694,511.08589273065564,0,1,910,0.0,0.0010976948408342481,0.9989023051591658,911,25650,18400,7250,0.7173489278752436,329,184,145,153.0195095476772,0.4076473745793175,0.9323585750213883,0.11795595690952877,18020223.882408243,343639.16408509837,18363863.04649334,4693,36,3070.928649835346,140,771,90,30.385426809477515,0.6744791666666667,34.44887706855795,135719.43272904606,969.4245194931862,0
4695,511.23146508762864,0,0,910,0.0,0.0,1.0,910,25650,18100,7550,0.7056530214424951,332,181,151,152.9531204971085,0.40741239416981995,0.9328020812024351,0.11810798209387896,18032480.90687239,343974.84500213666,18376455.75187453,4694,37,3075.0516483516485,145,765,92,30.333914228919877,0.6743534482758621,34.39640410958906,135784.9154595984,936.4476928248165,0
4696,511.1276046114473,0,0,910,0.0,0.0,1.0,910,25150,18400,6750,0.731610337972167,319,184,135,150.9545904034683,0.4073422772680198,0.9318297159808366,0.11728859100898043,18054358.500033922,337927.6584740024,18392286.158507925,4695,38,3076.0516483516485,99,811,99,30.196086115901117,0.6847643097643097,34.20833333333335,135853.4579090184,1372.2571505961455,0
4697,511.2909766470603,0,1,909,0.0,0.001098901098901099,0.9989010989010989,910,23500,16300,7200,0.6936170212765957,307,163,144,149.2661488267237,0.4071641642186197,0.931214341509857,0.11642405372592868,18075965.342206016,334125.94659128593,18410091.2887973,4696,39,3077.0516483516485,102,808,90,30.12271960851429,0.6851511437908497,34.09182847896441,135956.44871542472,1332.9063599551444,0
4698,511.67358002418354,0,0,909,0.0,0.0,1.0,909,24450,17000,7450,0.6952965235173824,319,170,149,148.88201345803992,0.40708492655432943,0.9309637600944263,0.11678157819923166,18112648.95476085,333079.5290886954,18445728.483849544,4697,40,3080.732673267327,107,802,71,29.96025452809898,0.6856503115264798,33.92168209876545,136145.2454873386,1272.385471844286,0
4699,511.65042074482693,0,0,909,0.0,0.0,1.0,909,24550,18300,6250,0.745417515274949,308,183,125,148.84183260599704,0.40687572795458693,0.9310694328464382,0.11723035038109152,18128621.569813386,333309.45141432853,18461931.021227714,4698,41,3081.732673267327,111,798,73,29.83616914727606,0.6859984984984985,33.79836309523811,136202.17952528372,1227.0466623899433,0
4700,511.9099050593381,0,0,909,0.0,0.0,1.0,909,22300,16500,5800,0.7399103139013453,281,165,116,150.07510096008662,0.40676274859497696,0.9313694728770814,0.11857183265588887,18150579.97870828,340690.0245577588,18491270.003266037,4699,42,3082.732673267327,114,795,76,29.708280893907993,0.6863121345029239,33.70471014492756,136319.1965474604,1195.7824258549158,0
4701,511.81667871916306,0,0,909,0.0,0.0,1.0,909,24800,18600,6200,0.75,310,186,124,151.15121803588602,0.4065683413054962,0.93131119580114,0.11978071758957716,18159490.499804832,342365.82159132656,18501856.321396157,4700,43,3083.732673267327,121,788,78,29.58865535220147,0.6858643250688705,33.615095628415325,136340.23701638784,1126.778818317255,0
4702,511.9541472619268,0,0,909,0.0,0.0,1.0,909,24500,16500,8000,0.673469387755102,325,165,160,152.82422722514102,0.4063946822362119,0.9315556627630264,0.12149728553738584,18177467.77478439,349291.493118266,18526759.267902657,4701,44,3084.732673267327,128,781,82,29.446582426795107,0.6856282552083333,33.51905684754522,136426.02401316923,1065.8283126028846,0
4703,512.3719514844516,0,0,909,0.0,0.0,1.0,909,24250,17700,6550,0.7298969072164948,308,177,131,154.87819587838544,0.4061979527615023,0.9326320701345294,0.12370778673117987,18211297.157969084,358056.5696862841,18569353.727655366,4702,45,3085.732673267327,133,776,89,29.250612280599423,0.6862468671679198,33.379975124378106,136608.6224503553,1027.1324996267315,0
4704,512.7743299843632,0,0,909,0.0,0.0,1.0,909,24850,17400,7450,0.7002012072434608,323,174,149,138.92821846975318,0.40594968087117084,0.9230014920025842,0.11043870517085519,18206181.446113385,299220.4706891194,18505401.916802503,4703,46,3086.732673267327,137,772,96,29.819910253141853,0.6842305352798054,33.522041062801925,136643.0568496219,997.3945755446855,6
4705,512.3554547103959,0,0,909,0.0,0.0,1.0,909,24650,18400,6250,0.7464503042596349,309,184,125,140.55760480837952,0.4057397250371146,0.924169969374723,0.11211053518800965,18204972.425418213,305319.4639438744,18510291.889362086,4704,47,3087.732673267327,140,769,101,29.675029098769535,0.6848214285714286,33.42198581560283,136582.69967324074,975.5907119517196,0
4706,511.99884142771765,0,0,909,0.0,0.0,1.0,909,22250,14400,7850,0.647191011235955,301,144,157,145.26367187499963,0.40537236543037564,0.9272036578657894,0.11621093750000014,18204403.25076336,324837.69209981523,18529240.942863174,4705,48,3088.732673267327,137,772,103,29.459635416666696,0.6861313868613139,33.33333333333334,136533.02438072523,996.5914188374104,0
4707,511.58336752408036,0,0,909,0.0,0.0,1.0,909,27000,19600,7400,0.725925925925926,344,196,148,152.16092592245042,0.4052698359042953,0.9322596274064272,0.11359423441032421,17903590.76818507,336045.389724736,18239636.157909807,4706,49,3089.732673267327,143,766,90,31.412773767533405,0.6641171328671329,35.43836805555556,135345.33058780545,946.4708432713668,8
4708,511.3468062334525,0,1,908,0.0,0.0011001100110011,0.9988998899889989,909,26800,19400,7400,0.7238805970149254,342,194,148,152.10163301485377,0.4051367645942274,0.9322450439424417,0.11383074578588911,17905745.031041753,336098.61191381066,18241843.642955564,4707,50,3090.732673267327,93,816,93,31.33606039668913,0.6748431899641577,35.361258865248224,135322.1750848966,1455.0771514505009,0
4709,511.7170456001139,0,0,908,0.0,0.0,1.0,908,24300,17500,6800,0.720164609053498,311,175,136,150.19097753473855,0.40493269431586926,0.9306906371866517,0.11308804963504096,17944406.728376035,333117.597563143,18277524.32593918,4708,51,3094.9790748898677,101,807,101,31.194084528767494,0.6745049504950495,35.17156862745096,135517.2224928722,1341.7546781472497,0
4710,511.98503290791524,0,0,908,0.0,0.0,1.0,908,26150,19000,7150,0.7265774378585086,333,190,143,149.96069290929694,0.4047608278408916,0.9301716463901757,0.11357645442670182,17978359.30186054,331459.44365585584,18309818.745516397,4709,52,3095.9790748898677,109,799,72,31.016429932701996,0.6744074923547401,34.990530303030276,135680.88206371077,1244.7787345294566,0
4711,512.3856956103692,0,1,907,0.0,0.0011013215859030838,0.998898678414097,908,25650,19100,6550,0.7446393762183235,322,191,131,148.62072534160544,0.4046748187129958,0.928688649568546,0.11304938799200039,18010552.10718825,328098.2635946184,18338650.37078287,4710,53,3096.9790748898677,120,788,75,30.916520558026743,0.6735243055555555,34.85709366391184,135855.4324991712,1132.12860415976,0
4712,512.0065975180543,0,0,907,0.0,0.0,1.0,907,26200,18800,7400,0.7175572519083969,336,188,148,152.63681915503054,0.40447863603580364,0.9305090976751347,0.11656137456973076,18013639.176096473,342308.9170491591,18355948.09314563,4711,54,3101.137816979052,123,784,80,30.687321204252015,0.6742039295392954,34.736223118279554,135816.80384599703,1104.2016572845287,0
4713,511.64181214721685,0,0,907,0.0,0.0,1.0,907,24350,16400,7950,0.6735112936344969,323,164,159,151.064728416177,0.40432281867869313,0.9295557512471406,0.11565119372189263,18011275.046709422,338423.6746720441,18349698.721381467,4712,55,3102.137816979052,131,776,83,30.650725672138954,0.6736641221374046,34.65909090909091,135759.50356406244,1036.3320882752857,0
4714,512.0609136211391,0,0,907,0.0,0.0,1.0,907,26900,19000,7900,0.7063197026022305,348,190,158,154.8847310463821,0.4041947878206704,0.9317546934577308,0.11909261020772458,18044120.921747874,350651.7631866712,18394772.684934545,4713,56,3103.137816979052,137,770,88,30.41417875082931,0.6741180048661801,34.5259661835749,135938.8762987295,992.2545715235731,0
4715,512.2065741484638,0,0,907,0.0,0.0,1.0,907,24650,17300,7350,0.7018255578093306,320,173,147,157.13813417814623,0.4040661992044543,0.9334362208792193,0.12114087311745397,18060081.78139751,361535.5108467152,18421617.292244226,4714,57,3104.137816979052,145,762,90,30.273486476804624,0.6738505747126438,34.4463470319635,136018.32683936998,938.0574264784137,0
4716,512.4164655105566,0,0,907,0.0,0.0,1.0,907,24950,18100,6850,0.7254509018036072,318,181,137,152.30135257204293,0.4039817241908044,0.9333454022054741,0.11154811731169129,17851329.114253692,337406.31386190356,18188735.428115595,4715,58,3105.137816979052,101,806,69,32.019471956771284,0.6657384488448845,36.03962418300653,135257.64281098166,1339.1845822869473,8
4717,512.0286585527103,0,0,907,0.0,0.0,1.0,907,24950,17800,7150,0.7134268537074149,321,178,143,151.66962341439228,0.40403623237788344,0.9330306104571318,0.11159873104445504,17857547.886226717,335339.5126016982,18192887.398828417,4716,59,3106.137816979052,106,801,73,31.888001154975637,0.6659787735849056,35.89369158878505,135229.9988111031,1275.7547057651236,0
4718,512.0001077166129,0,0,907,0.0,0.0,1.0,907,25100,18200,6900,0.7250996015936255,320,182,138,153.79794508976215,0.40397665366177377,0.9337325171234141,0.11349603009468148,17869030.646605242,343144.03883877705,18212174.68544402,4717,60,3107.137816979052,110,797,74,31.738106655300175,0.6660037878787879,35.80142642642644,135269.69812824597,1229.7245284385997,0
4719,512.0668726135735,0,1,906,0.0,0.0011025358324145535,0.9988974641675854,907,25800,18800,7000,0.7286821705426356,328,188,140,150.95267691534156,0.40384284240065615,0.9323802041555833,0.11168692077654659,17882463.25479979,332681.1396304583,18215144.39443025,4718,61,3108.137816979052,116,791,77,31.729986412433192,0.6655890804597702,35.719373219373246,135329.3540479122,1166.6323624820018,0
4720,512.3853188321762,0,0,906,0.0,0.0,1.0,906,27800,20400,7400,0.7338129496402878,352,204,148,150.5403933267389,0.4035979189280386,0.93171374510069,0.11185064540648991,17911455.198840436,330279.5021375464,18241734.70097798,4719,62,3112.2969094922737,121,785,86,31.60695449065709,0.6659779614325069,35.587431693989096,135481.11811471145,1119.6786621050533,0
4721,512.8549201062867,0,0,906,0.0,0.0,1.0,906,25700,18900,6800,0.7354085603112841,325,189,136,155.1731004586494,0.4036584423873583,0.9343335376242639,0.11583217670200767,17947696.42616626,350099.9401077691,18297796.36627403,4720,63,3113.2969094922737,126,780,89,31.336033173151446,0.6665839947089947,35.44127296587927,135680.24481650535,1076.8273398135345,0
4722,513.141942629429,0,0,906,0.0,0.0,1.0,906,25250,18600,6650,0.7366336633663366,319,186,133,154.23413937255086,0.4034861207664069,0.9341332563718558,0.11576131737282426,17980856.224484127,348202.3769929768,18329058.601477105,4721,64,3114.2969094922737,92,814,92,31.188033283971542,0.6760643115942029,35.27105734767025,135843.5239028511,1476.5600424222946,0
4723,512.6409818877813,0,0,906,0.0,0.0,1.0,906,22700,15700,7000,0.6916299559471366,297,157,140,153.56213169457345,0.4034799718675171,0.9341847970801624,0.11563130706326437,17976985.345650055,348216.8382240279,18325202.18387408,4722,65,3115.2969094922737,92,814,92,31.10346881520328,0.6770833333333333,35.170250896057354,135762.58261374023,1475.6802458015243,0
4724,512.2970993056093,1,0,907,0.0011025358324145535,0.0,1.0,907,26250,19300,6950,0.7352380952380952,332,193,139,154.99446194654152,0.4036160883424076,0.9343994530886095,0.1172796181702208,17985407.792796157,349877.7207467136,18335285.513542872,4723,0,3112.861080485116,96,811,86,30.91227625802095,0.6774088541666667,35.01932989690721,135748.82866587056,1414.0502986028184,0
4725,512.1432874022904,0,1,906,0.0,0.0011025358324145535,0.9988974641675854,907,24800,18100,6700,0.7298387096774194,315,181,134,157.46214702923746,0.40351635103637556,0.9347870796593074,0.11964463982354202,17997485.538358163,360584.5427995036,18358070.081157666,4724,1,3113.861080485116,98,809,78,30.716102423665124,0.6781462585034014,34.89057239057238,135774.0137772313,1385.4491201758296,0
4726,512.357177556172,0,0,906,0.0,0.0,1.0,906,23500,16500,7000,0.7021276595744681,305,165,140,157.18704077844276,0.4033784388098171,0.9342654829667663,0.11985848112295666,18019786.95655416,361795.39743174234,18381582.353985902,4725,68,3118.2969094922737,104,802,80,30.612858781576463,0.6776842948717949,34.78174603174601,135886.47603954957,1306.600731149515,0
4727,512.703712034257,0,0,906,0.0,0.0,1.0,906,23000,15600,7400,0.6782608695652174,304,156,148,154.64177235845744,0.4033290443493143,0.9332942211349151,0.11830585632372058,18045702.375357587,353923.8797557,18399626.25511329,4726,69,3119.2969094922737,108,798,83,30.577867425470302,0.677758487654321,34.68081039755349,136030.1333830939,1259.5382720656842,0
4728,512.4477530101564,0,0,906,0.0,0.0,1.0,906,25600,17900,7700,0.69921875,333,179,154,155.20717821787665,0.40297982754625394,0.9338514716997091,0.11930956705950696,18056673.375460286,353705.064521401,18410378.439981688,4727,70,3120.2969094922737,117,789,85,30.41367384942801,0.6773504273504274,34.533898305084705,136037.50731392263,1162.7137377258343,0
4729,512.4620787401544,0,0,906,0.0,0.0,1.0,906,24100,17100,7000,0.7095435684647303,311,171,140,155.33532163051532,0.4028151539359051,0.9343487101172652,0.11993562555133747,18075478.20545614,356252.04413396947,18431730.24959011,4728,71,3121.2969094922737,127,779,87,30.27369881831454,0.6769192913385826,34.39941406249996,136110.2283841315,1071.734081764815,0
4730,512.5191821734846,0,2,904,0.0,0.002207505518763797,0.9977924944812362,906,25600,18300,7300,0.71484375,329,183,146,155.4942612753871,0.4026996715166742,0.9344196291424951,0.12069910611938056,18099520.97230499,356074.3286053899,18455595.30091038,4729,72,3122.2969094922737,90,816,90,30.105185137327517,0.6871527777777777,34.23763736263737,136208.30875139456,1513.425652793273,0
4731,512.4667708917154,0,0,904,0.0,0.0,1.0,904,25300,19000,6300,0.7509881422924901,316,190,126,156.3349003407932,0.4023856431936155,0.9343879744575612,0.12177879639533529,18112168.37789096,360212.8076626524,18472381.18555361,4730,77,3129.4148230088495,93,811,93,29.97474852728683,0.6872759856630825,34.13120567375888,136248.9225092431,1465.042177518743,0
4732,511.95730293400123,0,1,903,0.0,0.0011061946902654867,0.9988938053097345,904,24500,17900,6600,0.7306122448979592,311,179,132,154.30208775520214,0.4024182338778963,0.9334894699052367,0.12064962809662204,18109675.620925255,353572.15137565613,18463247.77230091,4731,78,3130.4148230088495,98,806,89,29.913086619987617,0.686968537414966,34.01725589225592,136171.8083003866,1389.5082479631285,0
4733,511.9648926363783,0,0,903,0.0,0.0,1.0,903,26850,19900,6950,0.7411545623836127,338,199,139,151.79231245376388,0.40219910391492925,0.9322986528841721,0.1191114683260069,18124581.141219497,342784.41673632164,18467365.55795582,4732,79,3134.1771871539313,102,801,73,29.87074480888858,0.6869893790849673,33.90978964401297,136228.8459764953,1335.5769213381893,0
4734,511.5871747707285,0,0,903,0.0,0.0,1.0,903,23300,17200,6100,0.7381974248927039,294,172,122,151.574604241603,0.40211889169631654,0.9322166408312342,0.11927802819547013,18122796.107022844,345491.12953465397,18468287.2365575,4733,80,3135.1771871539313,105,798,75,29.790143739693335,0.6871031746031746,33.82468553459121,136171.87712106953,1296.8750202006622,0
4735,511.79277151928386,0,0,903,0.0,0.0,1.0,903,22650,16100,6550,0.7108167770419426,292,161,131,152.10575642627242,0.4018825009678668,0.9323278269224513,0.1199409642875619,18138431.814426836,348541.97830395703,18486973.792730793,4734,81,3136.1771871539313,108,795,76,29.71376694545152,0.6870177469135803,33.76337920489299,136257.97803665776,1261.647944783868,0
4736,512.2853294932702,0,0,903,0.0,0.0,1.0,903,24650,18000,6650,0.7302231237322515,313,180,133,154.4932957433457,0.4017064228706316,0.9328160980901583,0.1222846665230986,18171306.091108527,356218.99319530255,18527525.08430383,4735,82,3137.1771871539313,114,789,77,29.535438984299738,0.686860380116959,33.6503623188406,136447.01189990694,1196.9036131570783,0
4737,511.81342008428453,0,0,903,0.0,0.0,1.0,903,24150,17200,6950,0.7122153209109731,311,172,139,155.30775391518046,0.40165577867648206,0.9332046327088515,0.12339996188285779,18170109.862778567,359641.7902360468,18529751.653014615,4736,83,3138.1771871539313,117,786,82,29.397983269836036,0.6874109686609686,33.5363700564972,136379.66176945876,1165.638134781699,0
4738,512.0567623302803,0,0,903,0.0,0.0,1.0,903,27150,19800,7350,0.7292817679558011,345,198,147,155.64870522631054,0.40143882713366547,0.9335108453667731,0.1241495270720248,18194429.127484407,358637.8672049673,18553066.994689375,4737,84,3139.1771871539313,129,774,85,29.272214123257893,0.6864502583979328,33.42147435897437,136503.33674652403,1058.1654011358453,0
4739,512.5072090803608,0,1,902,0.0,0.0011074197120708748,0.9988925802879292,903,23100,15500,7600,0.670995670995671,307,155,152,155.5466656593407,0.4011954792229892,0.93335325189086,0.11720890361003064,17975287.871117502,355499.2185238207,18330787.08964132,4738,85,3140.1771871539313,96,807,96,31.028514373758252,0.6761067708333333,35.148195876288646,135738.45895134102,1413.9422807431356,8
4740,512.9694662427571,0,0,902,0.0,0.0,1.0,902,25050,18500,6550,0.7385229540918163,316,185,131,152.98897592320077,0.40107815759446064,0.9317085358321053,0.1156377723957288,18004492.307139356,345447.76801727124,18349940.075156625,4739,86,3144.3547671840356,102,800,92,30.999185688474896,0.6754493464052287,35.05258899676372,135909.93200472853,1332.4503137718484,0
4741,512.7405562867012,0,0,902,0.0,0.0,1.0,902,23650,16900,6750,0.7145877378435518,304,169,135,151.65627596541358,0.4009626222157691,0.9311868933378213,0.1151414665368337,18015137.33570012,342371.72786754585,18357509.06356767,4740,87,3145.3547671840356,107,795,78,30.89494493766067,0.6756230529595015,34.91512345679009,135919.76706195518,1270.2781968407025,0
4742,512.9491015400737,0,0,902,0.0,0.0,1.0,902,23050,17300,5750,0.7505422993492408,288,173,115,149.1698092348147,0.40087518241618697,0.9297909423345991,0.1138250916551021,18043542.70282817,334860.3645802201,18378403.06740839,4741,88,3146.3547671840356,118,784,81,30.803576339614747,0.6748764124293785,34.76015406162464,136054.5406667166,1153.0045819213271,0
4743,513.0886242903792,0,0,902,0.0,0.0,1.0,902,25300,18200,7100,0.7193675889328063,324,182,142,147.0358451234517,0.40088192432978714,0.9292451980026188,0.11270658064366854,18067384.649465535,325610.6342209248,18392995.28368646,4742,89,3147.3547671840356,126,776,85,30.719041364034375,0.6748511904761905,34.62106299212597,136162.91370501238,1080.658045277876,0
4744,513.4389066376654,0,0,902,0.0,0.0,1.0,902,25050,18400,6650,0.7345309381237525,317,184,133,148.82671879134142,0.4008756694745839,0.9302499899321719,0.11443839192821685,18092819.25914149,333088.9848045593,18425908.24394605,4743,90,3148.3547671840356,131,771,89,30.573958612011133,0.675015903307888,34.52493686868686,136305.22615370585,1040.4979095702736,0
4745,513.2223671343993,0,0,902,0.0,0.0,1.0,902,25700,19600,6100,0.7626459143968871,318,196,122,150.2392475786859,0.40084834293504873,0.9309808457657276,0.11583720577019867,18096429.665611204,337658.79536440974,18434088.460975613,4744,91,3149.3547671840356,138,764,93,30.452729333634338,0.6748188405797102,34.442446043165475,136290.07645214806,987.6092496532468,0
4746,513.2445318934502,0,0,902,0.0,0.0,1.0,902,24600,16900,7700,0.6869918699186992,323,169,154,149.70973383972657,0.40070630132570123,0.9316098650846107,0.11584826729624734,18112261.59280382,337316.37245883764,18449577.96526266,4745,92,3150.3547671840356,96,806,96,30.35473678537263,0.6843532986111112,34.33204467353955,136352.62537062063,1420.3398476106315,0
4747,513.4656916341403,0,0,902,0.0,0.0,1.0,902,24350,17700,6650,0.7268993839835729,310,177,133,147.4169554168902,0.40058064025928325,0.9299388185488136,0.11466000930030765,18141278.61978143,330116.4122995445,18471395.032080974,4746,93,3151.3547671840356,104,798,104,30.257899483734484,0.6837940705128205,34.17658730158732,136491.202453739,1312.415408209029,0
4748,513.489792847828,0,0,902,0.0,0.0,1.0,902,26450,18000,8450,0.6805293005671077,349,180,169,147.64893198976097,0.40046956531012184,0.9298640961957936,0.11525980613877994,18157179.293136004,329327.62611562916,18486506.919251632,4747,94,3152.3547671840356,107,795,101,30.13987620291117,0.684190031152648,34.06635802469137,136554.21072917024,1276.2075769081332,0
4749,513.3611184816838,0,0,902,0.0,0.0,1.0,902,24400,16300,8100,0.6680327868852459,325,163,162,145.9524661357731,0.4003437760704416,0.9288383700954195,0.11440738939735755,18169646.103861872,325580.9315345792,18495227.035396453,4748,95,3153.3547671840356,112,790,71,30.058554500727602,0.6843377976190477,33.941740412979364,136583.9657228838,1219.4996939543196,0
4750,513.5731146143311,0,0,902,0.0,0.0,1.0,902,24900,16900,8000,0.678714859437751,329,169,160,148.41344411166946,0.4002280612491828,0.9295414281144156,0.11671010276387146,18190324.102056924,334637.7298987557,18524961.83195568,4749,96,3154.3547671840356,117,785,71,29.895245992260882,0.6842948717948718,33.845338983050844,136689.8782275959,1168.2895575008197,0
4751,513.4451935066377,0,0,902,0.0,0.0,1.0,902,22150,15400,6750,0.6952595936794582,289,154,135,147.1523007185125,0.40021570534669126,0.9284603399702946,0.1161389273798295,18200661.682662856,333103.84824062034,18533765.530903477,4750,97,3155.3547671840356,123,779,78,29.818431347804133,0.6842818428184282,33.73655913978494,136711.6839162157,1111.4771050098836,0
4752,513.2212087566093,0,0,902,0.0,0.0,1.0,902,24450,17100,7350,0.6993865030674846,318,171,147,146.6408357404938,0.40013082901235636,0.9285962744363052,0.11631284471234549,18213057.64459046,329305.59887850384,18542363.243468963,4751,98,3156.3547671840356,130,772,83,29.68109529210437,0.6846153846153846,33.58778625954197,136728.39836340115,1051.7569104877011,0
4753,513.3713754351796,0,1,901,0.0,0.0011086474501108647,0.9988913525498891,902,25400,18000,7400,0.7086614173228346,328,180,148,149.01012921928245,0.4000565654241448,0.9298675428404084,0.11879031796639813,18238946.929150876,337757.56774727395,18576704.49689815,4752,99,3157.3547671840356,139,763,90,29.465448742998536,0.6848021582733813,33.43749999999997,136845.557264438,984.500411974374,0
4754,513.515654861117,0,0,901,0.0,0.0,1.0,901,22200,14900,7300,0.6711711711711712,295,149,146,149.40487677320243,0.3997661548896288,0.9309670170884352,0.11946596760163032,18256366.95513485,343118.0510516521,18599485.006186504,4753,100,3160.2930077691453,144,757,94,29.363785764319147,0.6850405092592593,33.34770114942527,136930.1298644739,950.9036796144022,0
4755,513.1660876155407,0,0,901,0.0,0.0,1.0,901,25250,18000,7250,0.7128712871287128,325,180,145,149.89032770219436,0.39962891026431535,0.9314361102124091,0.12047381093988944,18264819.41781641,342093.9535915755,18606913.371407986,4754,101,3161.2930077691453,97,804,97,29.196006467205773,0.6955541237113403,33.19515306122446,136915.19946043327,1411.4969016539512,0
4756,513.5475379143853,0,0,901,0.0,0.0,1.0,901,23150,17200,5950,0.7429805615550756,291,172,119,146.96554024018658,0.39950877625683395,0.9298342606664687,0.11847000088331329,18290249.074849013,334257.2672825487,18624506.342131563,4755,102,3162.2930077691453,101,800,101,29.18627713578735,0.6953382838283828,33.10866013071894,137061.39048053994,1357.0434701043557,0
4757,513.0539716248439,0,0,901,0.0,0.0,1.0,901,25900,19600,6300,0.7567567567567568,322,196,126,144.26251058582798,0.3993196859456571,0.9285206810637954,0.11659105388582917,18283052.246471874,321411.80364957673,18604464.050121453,4756,103,3163.2930077691453,103,798,97,29.181517470798656,0.6955906148867315,33.032852564102555,136968.55528534192,1329.7917988868148,0
4758,513.0000606651887,0,0,901,0.0,0.0,1.0,901,25000,17800,7200,0.712,322,178,144,143.86324347640516,0.39920253216590623,0.9277159694657855,0.11684280186406468,18300939.33853533,321366.4983813268,18622305.83691666,4757,104,3164.2930077691453,109,792,78,29.045501412179014,0.6956230886850152,32.88825757575758,137028.34006802077,1257.140734568998,0
4759,513.2802170087889,0,0,901,0.0,0.0,1.0,901,26300,19200,7100,0.7300380228136882,334,192,142,139.34595594051183,0.3988890430385991,0.9250177714135113,0.11379980325608835,18333033.21312785,304426.8076744939,18637460.020802345,4758,105,3165.2930077691453,121,780,82,29.002777955254594,0.6948174931129476,32.72711748633881,137185.8831371775,1133.767629232872,0
4760,513.4298557003336,0,0,901,0.0,0.0,1.0,901,23500,16600,6900,0.7063829787234043,304,166,138,139.5004893105592,0.39866300818021133,0.9253168811448187,0.11429350610418851,18351249.788279645,308301.66498506657,18659551.453264713,4759,106,3166.2930077691453,124,777,84,28.903555250799997,0.695228494623656,32.633333333333354,137274.02908574726,1107.0486216592521,0
4761,513.3336941509208,0,0,901,0.0,0.0,1.0,901,25200,17800,7400,0.7063492063492064,326,178,148,139.37990743849912,0.39845911949685536,0.9252184057075699,0.1146886726650104,18365016.797946215,306542.8682808518,18671559.666227065,4760,107,3167.2930077691453,129,772,89,28.779711979151116,0.6956556847545219,32.508012820512846,137312.64993461868,1064.4391467799896,0
4762,513.6065496525792,0,0,901,0.0,0.0,1.0,901,23600,16700,6900,0.7076271186440678,305,167,138,139.3419742068074,0.39832881160850087,0.9252655888365131,0.11489406663960364,18382981.93434996,308504.198908083,18691486.133258045,4761,108,3168.2930077691453,132,769,92,28.72019017788316,0.6957859848484849,32.448308270676705,137416.30124280925,1041.0325851727973,0
4763,513.2341500002968,0,0,901,0.0,0.0,1.0,901,25600,18200,7400,0.7109375,330,182,148,165.30556323473493,0.3980247769967526,0.935258039644357,0.13176631088696156,18233619.205815148,397023.73852499435,18630642.944340143,4762,109,3169.2930077691453,125,776,85,29.034435122869056,0.6869166666666666,33.440806878306894,136807.2809065782,1094.4582472526256,8
4764,512.7917499784049,0,0,901,0.0,0.0,1.0,901,26250,19600,6650,0.7466666666666667,329,196,133,163.99615392824555,0.39785654827968925,0.9350863593160996,0.1312961810703257,18235658.955555823,391665.586611658,18627324.54216748,4763,110,3170.2930077691453,92,809,92,28.937333753324936,0.6958786231884058,33.310931899641545,136755.95393129135,1486.4777601227322,0
4765,513.0907504845316,0,0,901,0.0,0.0,1.0,901,24100,16400,7700,0.6804979253112033,318,164,154,161.86625609117394,0.39767197969334483,0.9337516968750958,0.13005259372242117,18260682.924041446,386857.67571651854,18647540.599757966,4764,111,3171.2930077691453,97,804,97,28.88728419654712,0.695446735395189,33.205782312925145,136889.64537799355,1411.2334575050882,0
4766,513.4590226228011,0,0,901,0.0,0.0,1.0,901,24150,17300,6850,0.7163561076604554,310,173,137,159.22575415871003,0.39732036420438194,0.9324198092708753,0.1285642025395879,18293727.739235684,378216.5191307793,18671944.25836646,4765,112,3172.2930077691453,102,799,102,28.80990717939002,0.6955678104575164,33.06027508090613,137062.61025615642,1343.75108094271,0
4767,513.4777399274362,0,0,901,0.0,0.0,1.0,901,25550,17800,7750,0.6966731898238747,333,178,155,141.70891784370292,0.3972763801537387,0.9261048865649308,0.1050764403952278,17941035.08312669,302730.9333251594,18243766.01645185,4766,113,3173.2930077691453,128,773,87,31.904776450703093,0.6641438802083333,35.650839793281655,135737.40933466164,1060.448510427044,8
4768,513.1916109799288,0,1,900,0.0,0.0011098779134295228,0.9988901220865705,901,22650,15400,7250,0.6799116997792495,299,154,145,142.81834813367496,0.39730582274838655,0.9270647477866791,0.10629374391513771,17946871.79637372,309778.5168249876,18256650.313198708,4767,114,3174.2930077691453,132,769,91,31.757090255772436,0.6646938131313131,35.534147869674186,135721.65670394152,1028.194368969254,0
4769,512.9565472369878,0,0,900,0.0,0.0,1.0,900,23850,17600,6250,0.7379454926624738,301,176,125,144.57148624700426,0.3973947132616487,0.9277398733869642,0.10818558317757727,17961733.188641187,315500.89253079495,18277234.081171982,4768,115,3177.2244444444445,98,802,98,31.538176083124533,0.6733630952380952,35.36405723905721,135746.73947345698,1385.1708109536428,0
4770,513.1161465958418,0,1,899,0.0,0.0011111111111111111,0.9988888888888889,900,25900,18700,7200,0.722007722007722,331,187,144,144.18385440039688,0.39707079368022086,0.9276719865293628,0.10824964488457878,17981187.585994747,312619.386569052,18293806.9725638,4769,116,3178.2244444444445,100,800,100,31.444868648304688,0.6738541666666666,35.261963696369605,135841.36104546732,1358.4136104546733,0
4771,512.6349074951341,0,0,899,0.0,0.0,1.0,899,25000,19000,6000,0.76,310,190,120,144.62308716353868,0.39702578258611193,0.9275087199620364,0.10891424231532557,17977313.32646401,315186.91043588275,18292500.23689989,4770,117,3181.1835372636265,103,796,103,31.336158806399197,0.6740493527508091,35.166266025640994,135763.01671753463,1318.0875409469381,0
4772,512.8292316289702,0,0,899,0.0,0.0,1.0,899,25350,19300,6050,0.7613412228796844,314,193,121,146.56074963561318,0.39696787364992697,0.9281033537983763,0.11087830573387726,18003339.839994967,322566.59657886665,18325906.436573833,4771,118,3182.1835372636265,108,791,94,31.14135139034154,0.6742862654320987,35.024847094801196,135887.00406514035,1258.2130006031514,0
4773,513.111273837594,0,0,899,0.0,0.0,1.0,899,25350,18500,6850,0.7297830374753451,322,185,137,145.24738038956897,0.3969716929558786,0.9275594142548813,0.11031196334717581,18029543.47164346,318598.79177520605,18348142.263418663,4772,119,3183.1835372636265,113,786,76,31.054534905096688,0.6744100294985251,34.90497076023388,136023.24814122845,1203.7455587719332,0
4774,513.0588663054795,0,0,899,0.0,0.0,1.0,899,23200,16600,6600,0.7155172413793104,298,166,132,144.1876946675343,0.3968596427772176,0.9268882746516229,0.10997735561611792,18045650.923916172,317392.16109890264,18363043.085015073,4773,120,3184.1835372636265,122,777,79,30.948788768972033,0.6740095628415301,34.773035230352285,136077.04585835757,1115.385621789816,0
4775,513.086113813626,0,0,899,0.0,0.0,1.0,899,23850,16900,6950,0.7085953878406709,308,169,139,141.88824013082103,0.3968699652257354,0.9258843835264452,0.10856100233264984,18059623.453856613,308839.6378585943,18368463.09171521,4774,121,3185.1835372636265,123,776,87,30.91280395136773,0.6747967479674797,34.677419354838676,136133.3318102261,1106.775055367692,0
4776,513.3414456487626,0,0,899,0.0,0.0,1.0,899,27200,20000,7200,0.7352941176470589,344,200,144,151.02635186035144,0.3967636956182445,0.9308717047492618,0.1056718512071866,17684267.509431206,327158.0814543861,18011425.59088559,4775,122,3186.1835372636265,143,756,96,33.55024435503134,0.6432109557109558,37.51446759259259,134744.70266790333,942.270648027296,8
4777,513.1970509659924,1,0,900,0.0011111111111111111,0.0,1.0,900,24500,17300,7200,0.7061224489795919,317,173,144,147.56096961694806,0.39685537943393895,0.9292888162926671,0.10358272486378904,17693626.136480186,317677.72574775876,18011303.862227947,4776,0,3183.6422222222222,101,799,101,33.53325652393731,0.6519183168316831,37.40808823529412,134761.39472516938,1334.2712349026672,0
4778,513.4945942423994,0,0,900,0.0,0.0,1.0,900,25250,17900,7350,0.7089108910891089,326,179,147,149.05854865635274,0.39697523997857703,0.9295217455777971,0.10488490578247578,17714452.304593477,322848.1101529808,18037300.41474646,4777,1,3184.6422222222222,103,797,103,33.414402605656136,0.6522046925566343,37.329727564102576,134879.76496401243,1309.5122812040042,0
4779,513.5442999167527,0,0,900,0.0,0.0,1.0,900,26700,19800,6900,0.7415730337078652,336,198,138,133.65349280180473,0.39699385634243806,0.9231124037054363,0.09823367527452584,17905663.370154567,271930.89007089933,18177594.260225467,4778,2,3185.6422222222222,117,783,81,32.39926678701169,0.6632834757834758,35.92867231638419,135612.32510337027,1159.0797017382074,8
4780,513.1359693156991,0,0,900,0.0,0.0,1.0,900,26150,19100,7050,0.7304015296367112,332,191,141,133.34268930000908,0.3969854107444486,0.9226216150953812,0.09837306510199972,17907460.607018612,271415.7911747692,18178876.39819338,4779,3,3186.6422222222222,126,774,82,32.28759184518269,0.6628637566137566,35.81036745406825,135565.20317961558,1075.91431094933,0
4781,513.2481588175573,0,0,900,0.0,0.0,1.0,900,23200,17200,6000,0.7413793103448276,292,172,120,132.45404844290653,0.39717821756684385,0.9222262745098038,0.09807137733142034,17926816.610050887,271695.8871389561,18198512.497189842,4780,4,3187.6422222222222,133,767,86,32.19571078431375,0.662907268170426,35.69651741293532,135653.2758068792,1019.9494421569864,0
4782,513.069298757498,0,1,899,0.0,0.0011111111111111111,0.9988888888888889,900,23450,17000,6450,0.7249466950959488,299,170,129,134.0815005193644,0.39702676327606806,0.9230859889242244,0.09952617417912216,17931278.119314253,277400.53529354103,18208678.654607795,4781,5,3188.6422222222222,139,761,89,32.07268009080762,0.6628447242206235,35.617559523809526,135646.51333891513,975.8741966828427,0
4783,512.8958706011442,0,0,899,0.0,0.0,1.0,899,23950,18100,5850,0.755741127348643,298,181,117,134.38663228435678,0.3971718452326391,0.9226157589465809,0.0932206706758589,17630654.23263133,270114.849458648,17900769.08208998,4782,6,3192.3348164627364,121,778,90,34.2752056943133,0.6436811294765841,37.798838797814184,134481.8928474246,1111.4206020448314,8
4784,512.6319798622366,0,0,899,0.0,0.0,1.0,899,26100,18800,7300,0.7203065134099617,334,188,146,136.4993551221582,0.3973707588155775,0.9243040400321554,0.09516571911592246,17643978.444354728,275778.3358887332,17919756.78024346,4783,7,3193.3348164627364,125,774,94,34.05097260734387,0.6446666666666667,37.63227513227512,134498.0862508916,1075.9846900071327,0
4785,512.8979864321336,0,0,899,0.0,0.0,1.0,899,25150,18600,6550,0.7395626242544732,317,186,131,136.83687661093518,0.3974720736477799,0.9248028652113214,0.09553107182224295,17659164.057485633,278334.9706372794,17937499.028122913,4784,8,3194.3348164627364,130,769,95,33.99669706978578,0.6443108974358974,37.587468193384204,134590.85917816995,1035.314301370538,0
4786,513.0795646247167,0,0,899,0.0,0.0,1.0,899,25850,18100,7750,0.7001934235976789,336,181,155,137.61031478729507,0.397456486750518,0.9254271960445795,0.09635780891788445,17678597.354732014,280901.46939650853,17959498.824128523,4785,9,3195.3348164627364,99,800,99,33.87716922608892,0.6516203703703703,37.489583333333364,134688.73029278786,1360.4922251796754,0
4787,512.9774420046496,0,0,899,0.0,0.0,1.0,899,24500,18500,6000,0.7551020408163265,305,185,120,139.14450067295144,0.3972995339208045,0.9262888752190013,0.09785773619927983,17694309.48994246,288113.17174614576,17982422.661688607,4786,10,3196.3348164627364,101,798,101,33.692139080057565,0.6525371287128713,37.346813725490215,134735.15962946974,1334.0114814798983,0
4788,512.6535065143976,0,0,899,0.0,0.0,1.0,899,25550,18300,7250,0.7162426614481409,328,183,145,138.39920383883276,0.3972716633098064,0.9257099536928679,0.09769014932054891,17699216.662315007,284561.49892708275,17983778.16124209,4787,11,3197.3348164627364,106,793,106,33.59066266548114,0.6525157232704403,37.22741433021808,134711.2874594693,1270.8612024478236,0
4789,512.2189467025889,0,0,899,0.0,0.0,1.0,899,24800,16400,8400,0.6612903225806451,332,164,168,137.1291874503172,0.3972183994754545,0.9248816471000758,0.09711742629123558,17698852.554607965,280805.85392327164,17979658.408531237,4788,12,3198.3348164627364,111,788,98,33.51380535408926,0.6524962462462462,37.118675595238095,134652.79509438868,1213.0882440935918,0
4790,512.4061709724451,0,0,899,0.0,0.0,1.0,899,22500,15700,6800,0.6977777777777778,293,157,136,135.45010594306763,0.39731135312435745,0.9238578020688288,0.09631504669374089,17722929.17217193,277814.52679843263,18000743.698970363,4789,13,3199.3348164627364,117,782,78,33.42549394732717,0.6525997150997151,36.98799435028248,134768.9747347544,1151.8715789295247,0
4791,512.7064164964297,0,0,899,0.0,0.0,1.0,899,23350,16300,7050,0.6980728051391863,304,163,141,139.50456368508327,0.397398577814333,0.9244059896620649,0.09334533372608725,17462287.235555362,284063.75234795053,17746350.98790331,4790,14,3200.3348164627364,118,781,84,35.36461128253282,0.6320621468926554,39.00560224089636,133813.502400714,1134.0127322094406,8
4792,512.4723018187257,0,0,899,0.0,0.0,1.0,899,24800,17400,7400,0.7016129032258065,322,174,148,138.44230403603777,0.39740941638527677,0.9238359885128509,0.09278244199030734,17461550.203941308,278883.4484549159,17740433.652396224,4791,15,3201.3348164627364,121,778,86,35.33748718955098,0.6320592286501377,38.951502732240435,133780.12428112814,1105.6208618275052,0
4793,512.6415200543435,0,0,899,0.0,0.0,1.0,899,24700,17900,6800,0.7246963562753036,315,179,136,142.0667279636804,0.3975240987883097,0.9251476477306133,0.0955342488931689,17482650.342962522,292240.58607156004,17774890.92903408,4792,16,3202.3348164627364,126,773,89,35.12668414936721,0.6323578042328042,38.83694225721785,133883.0269033002,1062.5637055817476,0
4794,512.3554514324009,0,1,898,0.0,0.0011123470522803114,0.9988876529477196,899,26100,18300,7800,0.7011494252873564,339,183,156,142.03103499810766,0.39753989213454194,0.9259936005067753,0.09588946925732858,17490799.568373844,290947.2731281176,17781746.841501962,4793,17,3203.3348164627364,128,771,94,34.99193938832061,0.6333821614583333,38.703165374677,133876.85766231446,1045.9129504868317,0
4795,511.90870123637023,0,0,898,0.0,0.0,1.0,898,25250,18400,6850,0.7287128712871287,321,184,137,144.4484902280297,0.3973061653172043,0.9275751152668741,0.09783338568463051,17489928.748383548,300428.76037996676,17790357.508763514,4794,141,3207.883073496659,134,764,97,34.81973306177072,0.6335509950248757,38.59567901234569,133815.14645436613,998.6204959281055,0
4796,511.80707986196734,0,0,898,0.0,0.0,1.0,898,25900,19600,6300,0.7567567567567568,322,196,126,147.82439511734856,0.39757688024670207,0.9290678986098659,0.10062056653156619,17508868.31300033,312147.5735117117,17821015.88651204,4795,142,3208.883073496659,100,798,100,34.56154877375598,0.641875,38.42821782178215,133874.29001092276,1338.7429001092275,0
4797,512.02504298625,0,0,898,0.0,0.0,1.0,898,24600,17700,6900,0.7195121951219512,315,177,138,144.9364014479748,0.3977131041440618,0.9273838696843713,0.09903864625634005,17533730.988669816,304055.1746909239,17837786.16336074,4796,143,3209.883073496659,106,792,106,34.50527614512811,0.6417059748427674,38.298286604361344,133997.83105097563,1264.1304816129775,0
4798,511.94146279406715,1,0,899,0.0011123470522803114,0.0,1.0,899,23950,17200,6750,0.7181628392484343,307,172,135,143.64567210675503,0.39805224686672397,0.9266883435583313,0.09850838770955533,17546861.636329465,300356.1466229539,17847217.782952417,4797,0,3207.3114571746387,111,788,98,34.417997288432595,0.6417980480480481,38.17894345238094,134037.05467927564,1207.5410331466273,0
4799,512.4060529864893,1,2,898,0.0011111111111111111,0.0022222222222222222,0.9977777777777778,900,26150,18700,7450,0.7151051625239006,336,187,149,140.92919867376563,0.3984254366992131,0.9251818507079066,0.09716899031348908,17586893.00966736,289551.3478027376,17876444.357470095,4798,0,3204.7466666666664,120,780,77,34.30695658364545,0.6418402777777779,37.99931129476585,134250.7387791917,1118.7561564932644,0
4800,512.8162621490723,0,0,898,0.0,0.0,1.0,898,24900,17600,7300,0.7068273092369478,322,176,146,138.59712133877184,0.3980802646617985,0.92405326501297,0.09585345940365769,17614582.183623213,283766.0768470837,17898348.260470297,4799,146,3212.883073496659,122,776,84,34.26537744892135,0.6425034153005464,37.89803523035232,134410.14987509963,1101.722539959833,0
4801,512.8602053187586,0,0,898,0.0,0.0,1.0,898,24350,17200,7150,0.7063655030800822,315,172,143,143.5279056823817,0.39810848191488746,0.9262424754110503,0.09971396359750959,17636211.878946576,302307.7110311888,17938519.589977764,4800,147,3213.883073496659,129,769,86,33.98435510811004,0.6428456072351421,37.74839743589744,134498.41073619926,1042.6233390403045,0
4802,513.063992041066,0,0,898,0.0,0.0,1.0,898,23100,15600,7500,0.6753246753246753,306,156,150,145.0979539287863,0.3981730376103137,0.9269238918488563,0.10095087691066622,17649649.1805574,309485.5967319499,17959134.77728935,4801,148,3214.883073496659,134,764,87,33.8947069090624,0.642568407960199,37.70061728395061,134576.3684062034,1004.301256762712,0
4803,513.256902235249,0,0,898,0.0,0.0,1.0,898,24100,16100,8000,0.6680497925311203,321,161,160,146.2912443174167,0.39820084104484216,0.9280077565515576,0.10203085749086384,17667153.230682313,313209.96593259415,17980363.196614906,4802,149,3215.883073496659,138,760,89,33.781513005064916,0.6428140096618358,37.6199040767386,134668.39524175983,975.8579365344915,0
4804,513.203014399101,0,0,898,0.0,0.0,1.0,898,24500,17300,7200,0.7061224489795919,317,173,144,145.18770471151402,0.39832126224592573,0.9282002333227275,0.10163139329806009,17681447.605469074,309325.7587629919,17990773.364232067,4803,150,3216.883073496659,104,794,97,33.688822751322746,0.6502403846153846,37.50000000000001,134715.79127976438,1295.3441469208115,0
4805,513.0048065186338,0,0,898,0.0,0.0,1.0,898,24850,17900,6950,0.7203219315895373,318,179,139,142.57210453767655,0.3984612363739894,0.9264790671096865,0.10010890390549843,17688240.255987912,299919.9277728532,17988160.183760766,4804,151,3217.883073496659,102,796,102,33.65490769981253,0.6517565359477124,37.39886731391587,134715.64326519947,1320.7416006392104,0
4806,512.8483601393086,0,0,898,0.0,0.0,1.0,898,23550,16400,7150,0.6963906581740976,307,164,143,141.0727563942125,0.3985097824638592,0.9260180341003197,0.09955514471430171,17704966.17515696,296387.67603914416,18001353.851196103,4805,152,3218.883073496659,105,793,105,33.52776686986551,0.6526785714285714,37.234669811320785,134758.76868872973,1283.4168446545689,0
4807,512.5420510210715,1,0,899,0.0011123470522803114,0.0,1.0,899,25800,18800,7000,0.7286821705426356,328,188,140,139.79021664542736,0.39874049612164963,0.923679776208989,0.09942825268442335,17728818.97808814,290063.0891628986,18018882.067251038,4806,0,3216.301446051168,117,782,84,33.30239273927391,0.6526887464387464,36.97916666666666,134809.23737793753,1152.215704084936,8
4808,512.8998480062546,0,0,899,0.0,0.0,1.0,899,24850,18500,6350,0.744466800804829,312,185,127,139.63969710384274,0.39882483052604023,0.9242012255958072,0.0996622553345583,17756172.230748586,291243.30240507965,18047415.533153664,4807,1,3217.301446051168,121,778,86,33.19380448655549,0.653064738292011,36.868169398907106,134960.2759209082,1115.3741811645307,0
4809,512.5872417623292,0,0,899,0.0,0.0,1.0,899,25050,17700,7350,0.7065868263473054,324,177,147,140.02459723265724,0.39882859821974925,0.9245581471189466,0.10017388230109807,17755670.09587256,292396.11075409834,18048066.206626657,4808,2,3218.301446051168,124,775,88,33.10610258033873,0.653309811827957,36.791666666666664,134917.23359219296,1088.0422063886529,0
4810,512.9648940522104,0,0,899,0.0,0.0,1.0,899,25300,18800,6500,0.7430830039525692,318,188,130,137.75771376957613,0.3989030230735627,0.9233062825958691,0.09876293260586864,17778056.96074972,284712.8964356361,18062769.857185356,4809,3,3219.301446051168,129,770,91,33.09590929380848,0.6531815245478036,36.72275641025641,135051.98336437077,1046.9145997238045,0
4811,512.9033651418341,0,0,899,0.0,0.0,1.0,899,25050,18200,6850,0.7265469061876247,319,182,137,154.2584779930629,0.3989053972367218,0.9299107402999833,0.11023962778372871,17761988.32659691,343137.45707828185,18105125.78367519,4810,4,3220.301446051168,118,781,78,32.7662980209546,0.6540430790960452,36.82598039215688,134982.84027476676,1143.9223752098878,7
4812,513.0534851610089,0,0,899,0.0,0.0,1.0,899,24850,18700,6150,0.7525150905432596,310,187,123,156.1233710712285,0.3989095262161289,0.9305172345249946,0.1118993031987518,17779938.529558197,350522.7881347744,18130461.317692973,4811,5,3221.301446051168,121,778,82,32.6213217011524,0.6544421487603306,36.7315573770492,135070.79202061723,1116.287537360473,0
4813,512.6604699433465,0,0,899,0.0,0.0,1.0,899,24200,17000,7200,0.7024793388429752,314,170,144,157.64615171438518,0.3989107132977085,0.9305354766042111,0.11322970475051708,17775503.879205924,356447.95626818633,18131951.83547411,4812,6,3222.301446051168,131,768,83,32.512111677155126,0.6534669211195929,36.6635101010101,135002.20866484716,1030.5512111820394,0
4814,512.5074185102311,1,0,900,0.0011111111111111111,0.0,1.0,900,24750,18100,6650,0.7313131313131314,314,181,133,159.54928217035948,0.39907222016232025,0.9313152430525924,0.11506203309258171,17787778.460904356,362855.45696853823,18150633.917872895,4813,0,3219.72,138,762,90,32.32968067051609,0.6537590579710144,36.533273381294975,135028.65192269406,978.4684921934352,0
4815,512.1973466236508,1,0,901,0.0011098779134295228,0.0,1.0,901,24850,18600,6250,0.7484909456740443,311,186,125,155.78537981269497,0.3990971965306038,0.9301825928180156,0.11283520500452215,17795740.85542081,349413.2496420053,18145154.105062816,4814,0,3217.1453940066594,97,804,97,32.28797043010754,0.6632302405498282,36.394557823129254,135018.00803854756,1391.9382272015212,0
4816,512.1968575738871,0,0,901,0.0,0.0,1.0,901,25600,17800,7800,0.6953125,334,178,156,152.48602347981225,0.3991591647141037,0.928583610299164,0.11085525604357631,17811695.10905044,337406.91172278766,18149102.02077323,4815,1,3218.1453940066594,102,799,102,32.254876583451534,0.6630923202614378,36.27629449838189,135078.45322567073,1324.2985610359876,0
4817,511.92265835833945,0,0,901,0.0,0.0,1.0,901,24900,17500,7400,0.7028112449799196,323,175,148,148.06819954247823,0.399028497143092,0.9261072590959816,0.10822480921736957,17825305.186306566,322772.16904632427,18148077.35535289,4816,2,3219.1453940066594,111,790,95,32.19746364042201,0.6627252252252251,36.10491071428572,135093.8756348546,1217.0619426563478,0
4818,511.9004184879552,0,0,901,0.0,0.0,1.0,901,24300,17500,6800,0.720164609053498,311,175,136,144.24961750048354,0.39888868335594196,0.9231193746322677,0.10587778120027223,17842536.85046618,310255.8231836083,18152792.673649788,4817,3,3220.1453940066594,121,780,81,32.1630541991398,0.6621039944903582,35.97165300546449,135156.2213191863,1116.9935646213744,0
4819,511.88568095711264,0,0,901,0.0,0.0,1.0,901,23800,16800,7000,0.7058823529411765,308,168,140,144.236312901158,0.39880924487195296,0.9222602040034773,0.10630044777748598,17859441.790328063,311196.006861961,18170637.797190025,4818,4,3221.1453940066594,131,770,84,32.0326970185816,0.6617366412213741,35.84280303030305,135218.28665055698,1032.2006614546335,0
4820,511.88062193274186,0,0,901,0.0,0.0,1.0,901,24350,18200,6150,0.7474332648870636,305,182,123,143.10435666822602,0.39881982981871994,0.9220075243297139,0.10577305001377235,17871651.475510895,306952.2374003535,18178603.71291125,4819,5,3222.1453940066594,136,765,88,31.969701329343405,0.6619178921568627,35.751216545012184,135263.83161991098,994.5869972052278,0
4821,512.2000405000074,0,1,900,0.0,0.0011098779134295228,0.9988901220865705,901,26350,19400,6950,0.7362428842504743,333,194,139,146.31637725190296,0.3986510872692893,0.9235452493133154,0.10853070738539033,17897875.813426923,317200.46990502544,18215076.28333195,4820,6,3223.1453940066594,139,762,93,31.771859461487992,0.6626199040767387,35.639880952380985,135405.26368277954,974.138587645896,0
4822,511.7133459696157,0,0,900,0.0,0.0,1.0,900,23450,16400,7050,0.6993603411513859,305,164,141,146.6356451137153,0.3985224838297697,0.9236433252137786,0.10906859430755907,17892602.295550756,321288.65607425844,18213890.951625016,4821,8,3227.72,144,756,97,31.675427634855588,0.6628327546296297,35.553160919540275,135320.97685695393,939.729005951069,0
4823,512.04777317172,0,0,900,0.0,0.0,1.0,900,24000,17700,6300,0.7375,303,177,126,146.4422832004395,0.3984368949038026,0.9242691684039801,0.10918675933960655,17914482.80895126,320687.55297959055,18235170.36193085,4822,9,3228.72,152,748,101,31.604219751370614,0.662623355263158,35.47794117647066,135447.93117539247,891.1048103644241,0
4824,512.2120446970767,0,0,900,0.0,0.0,1.0,900,25000,19100,5900,0.764,309,191,118,145.84054033873733,0.3985081932600008,0.9241916228288658,0.10911990469795177,17935069.358714733,318132.0412575314,18253201.399972264,4823,10,3229.72,107,793,107,31.509040407721933,0.6710475077881619,35.36844135802466,135547.47174337888,1266.7988013399895,0
4825,512.3950565011291,0,0,900,0.0,0.0,1.0,900,23700,16700,7000,0.7046413502109705,307,167,140,138.3954013607357,0.3986888724096733,0.919811376363102,0.0948637569327226,17560329.13422287,282353.759711479,17842682.893934347,4824,11,3230.72,119,781,101,34.57117595048637,0.6400560224089635,38.19444444444445,134147.87243119857,1127.2930456403242,8
4826,512.2101844056243,0,0,900,0.0,0.0,1.0,900,22700,16300,6400,0.7180616740088106,291,163,128,147.50944775322114,0.39886084847361264,0.9271632153195264,0.0955937849725425,17298834.65266731,307648.3092778508,17606482.96194516,4825,12,3231.72,113,787,78,36.27045758183034,0.6219579646017699,40.10416666666668,133121.2927179208,1178.0645373267328,8
4827,512.6160202576597,0,0,900,0.0,0.0,1.0,900,26850,19600,7250,0.7299813780260708,341,196,145,146.54314575265224,0.3990065092901578,0.9267902430970552,0.09540559754079703,17333811.797888603,301180.26174941193,17634992.059638016,4826,13,3232.72,123,777,82,36.13362217484469,0.6216971544715447,39.944556451612925,133308.58651811606,1083.8096464887485,0
4828,512.6687000256468,0,0,900,0.0,0.0,1.0,900,25200,18100,7100,0.7182539682539683,323,181,142,149.51360021121988,0.39917959255139457,0.9275970358597128,0.09761796962902543,17348770.350074492,313575.42285545805,17662345.77292995,4827,14,3233.72,130,770,85,35.95607788000115,0.6215544871794871,39.845737913486,133372.94735002404,1025.9457488463388,0
4829,512.7135637457322,0,0,900,0.0,0.0,1.0,900,22200,15100,7100,0.6801801801801802,293,151,142,150.9044562786049,0.3993214425493346,0.9289889960074011,0.09884155259120923,17365008.850480765,321891.44377098756,17686900.29425175,4828,15,3234.72,136,764,88,35.807892686726994,0.6217830882352942,39.735401459853996,133441.1898343693,981.1852193703625,0
4830,512.3159164586784,0,0,900,0.0,0.0,1.0,900,24150,17800,6350,0.7370600414078675,305,178,127,149.30712274600384,0.399590208256087,0.9289736848741614,0.09818614668938565,17369852.124309584,314538.52864083793,17684390.65295042,4829,16,3235.72,140,760,97,35.71012303298528,0.6226190476190476,39.59810874704489,133408.03356482892,952.9145254630637,0
4831,512.1245640815226,3,0,903,0.0033222591362126247,0.0,1.0,903,24650,17600,7050,0.7139959432048681,317,176,141,145.19591690381725,0.4004099315004023,0.9271684245081637,0.09597095970959728,17386714.17839844,299645.98141543777,17686360.15981388,4830,0,3225.966777408638,103,800,103,35.63960639606392,0.6310679611650485,39.42307692307695,133447.84314047513,1295.6101275774286,0
4832,512.2311296517497,0,0,903,0.0,0.0,1.0,903,24350,18200,6150,0.7474332648870636,305,182,123,142.62946514511214,0.40042231119230554,0.9255486514459801,0.09461660663722837,17406864.910247814,291596.36640037823,17698461.276648194,4831,1,3226.966777408638,109,794,102,35.580881462646836,0.6309250764525993,39.29924242424245,133539.04355409875,1225.1288399458601,0
4833,511.81602502914575,0,1,902,0.0,0.0011074197120708748,0.9988925802879292,903,22850,16100,6750,0.7045951859956237,296,161,135,142.23629654910792,0.40038210277149583,0.9253905478909239,0.09487470618822186,17417708.95088034,292036.08310869563,17709745.03398904,4832,2,3227.966777408638,114,789,78,35.40154908223969,0.6317616959064327,39.11231884057972,133526.4959500861,1171.2850521937378,0
4834,511.74491132257367,0,0,902,0.0,0.0,1.0,902,25300,18500,6800,0.7312252964426877,321,185,136,142.7340305038303,0.4004989426218548,0.9263007106557937,0.09552301626971776,17430335.528221045,291880.408595422,17722215.936816465,4833,3,3232.347006651885,115,787,81,35.274277481506964,0.6326992753623188,38.99964080459771,133565.6056716116,1161.4400493183618,0
4835,511.60988258684614,0,1,901,0.0,0.0011086474501108647,0.9988913525498891,902,22900,16200,6700,0.7074235807860262,296,162,134,142.92473341260913,0.4008341926068842,0.9270245981084462,0.09611854660914018,17447812.509220313,295444.7903026987,17743257.29952301,4834,4,3233.347006651885,120,782,85,35.10166353517702,0.6334201388888889,38.83436639118457,133614.91914632506,1113.457659552709,0
4836,511.49531822672185,1,0,902,0.0011086474501108647,0.0,1.0,902,25650,17600,8050,0.6861598440545809,337,176,161,145.07749106341635,0.40085298280714615,0.9286862168054864,0.09811069945170309,17468991.767672203,300821.49941226846,17769813.267084472,4835,0,3234.3414634146343,128,774,89,34.85499186389006,0.6339518229166667,38.64664082687337,133681.01961988045,1044.382965780316,0
4837,511.7664450308921,1,0,903,0.0011074197120708748,0.0,1.0,903,25700,17800,7900,0.6926070038910506,336,178,158,145.23578990809744,0.4011772166196443,0.9294030963631648,0.09852481964035716,17492294.81520776,301801.4509583988,17794096.266166158,4836,0,3231.7585825027686,94,809,94,34.74435590969457,0.64239804964539,38.54166666666664,133805.6017737008,1423.4638486563915,0
4838,512.0470402293058,1,0,904,0.0011061946902654867,0.0,1.0,904,23350,16400,6950,0.702355460385439,303,164,139,140.3339303099401,0.4015136573597677,0.9269111164892179,0.09567872709505441,17524431.426216893,287704.4676976054,17812135.8939145,4837,0,3229.1825221238937,98,806,98,34.701806421341914,0.6429634353741497,38.37331649831648,133965.16893204532,1366.9915197147482,0
4839,511.86576021389254,0,0,904,0.0,0.0,1.0,904,26050,17700,8350,0.6794625719769674,344,177,167,139.73518190180064,0.40153379365569375,0.9263177482867793,0.09559056998580664,17533242.452331863,283152.1646809877,17816394.61701285,4838,1,3230.1825221238937,103,801,98,34.603806316648786,0.6427993527508091,38.26121794871792,133975.1206521363,1300.72932671977,0
4840,512.0461326832013,1,0,905,0.0011049723756906078,0.0,1.0,905,24750,17400,7350,0.703030303030303,321,174,147,140.23890126046734,0.40192458522792096,0.9259919194418511,0.09635037062308062,17558716.531829312,286733.02279354,17845449.55462285,4839,0,3227.6121546961326,107,798,80,34.444669514830075,0.6433021806853583,38.11728395061724,134096.03196965696,1253.233943641654,0
4841,511.6960868751115,0,0,905,0.0,0.0,1.0,905,25600,18100,7500,0.70703125,331,181,150,139.01247926824678,0.40212000277057974,0.9246829641017773,0.0959497017960555,17567268.38118633,281813.9063278731,17849082.287514202,4840,1,3228.6121546961326,118,787,83,34.32130727687762,0.6425670903954802,37.963935574229666,134082.82878681982,1136.2951592103375,0
4842,511.84106274382367,0,0,905,0.0,0.0,1.0,905,22650,16300,6350,0.7196467991169978,290,163,127,140.00405829675003,0.4023623266350495,0.9251848462155174,0.09700012597659338,17589039.160569616,288857.37280404114,17877896.533373658,4841,2,3229.6121546961326,122,783,88,34.16838954214589,0.6431010928961749,37.83875338753388,134184.89107637035,1099.8761563636913,0
4843,511.47445372986806,0,0,905,0.0,0.0,1.0,905,24050,16600,7450,0.6902286902286903,315,166,149,141.70476998006686,0.40216258006160466,0.9263159276945789,0.09852779799201054,17592172.602528553,293528.9544181842,17885701.556946736,4842,3,3230.6121546961326,126,779,90,34.00484462790966,0.6436011904761905,37.72145669291337,134148.77466305663,1064.6728147861636,0
4844,511.57875049308484,0,0,905,0.0,0.0,1.0,905,24200,16700,7500,0.6900826446280992,317,167,150,143.09294020992738,0.402190540507505,0.9276420512760104,0.09988100268251193,17612961.865595445,298858.09983067255,17911819.965426117,4843,4,3231.6121546961326,133,772,94,33.83842872378248,0.643796992481203,37.59328358208954,134241.70010606694,1009.3360910230597,0
4845,511.69208073591784,0,0,905,0.0,0.0,1.0,905,25000,19200,5800,0.768,308,192,116,143.56876890742043,0.40238468480581496,0.9286182421017306,0.100531038554624,17630833.679571774,300247.41723752645,17931081.0968093,4844,5,3232.6121546961326,96,809,96,33.72042680848163,0.6524522569444444,37.48926116838491,134324.66616827357,1399.2152725861831,0
4846,511.64898660202124,0,0,905,0.0,0.0,1.0,905,25750,18400,7350,0.7145631067961165,331,184,147,141.70801349379795,0.40238524503332845,0.9273312455235885,0.09962948854656976,17647114.23348331,293397.5003850134,17940511.733868323,4845,6,3233.6121546961326,101,804,101,33.635164735464095,0.6524339933993399,37.35702614379087,134381.01141167164,1330.5050634818974,0
4847,511.2601575168156,0,0,905,0.0,0.0,1.0,905,25150,17300,7850,0.6878727634194831,330,173,157,149.2150381626512,0.4024791595364983,0.9299656218906216,0.10099752920251698,17464914.452001695,315055.5752925892,17779970.027294286,4846,7,3234.6121546961326,151,754,92,34.71682375920929,0.6311396247240618,38.617050438596536,133634.68796497668,884.9979335428919,8
4848,511.01675898584597,1,0,906,0.0011037527593818985,0.0,1.0,906,26850,20000,6850,0.74487895716946,337,200,137,147.99940415212143,0.4027541731204696,0.9302394639235316,0.10064431068337205,17477587.895382706,309284.5189065879,17786872.414289296,4847,0,3232.0408388520973,101,805,101,34.58919042040864,0.6412953795379538,38.459967320261406,133651.3398450507,1323.2805925252546,0
4849,511.29577164713703,0,0,906,0.0,0.0,1.0,906,24800,17500,7300,0.7056451612903226,321,175,146,145.74792886015362,0.4029486002870164,0.9296514452963713,0.09955440881906373,17507016.9161142,304322.29120865685,17811339.20732286,4848,1,3233.0408388520973,103,803,103,34.497239445784075,0.6422936893203883,38.311298076923045,133800.32678109553,1299.0322988455878,0
4850,511.5433796513103,0,0,906,0.0,0.0,1.0,906,22500,15300,7200,0.68,297,153,144,144.8271943104052,0.40300388955967786,0.9282962954947611,0.09937411653475013,17535708.68228082,304229.4977398635,17839938.180020683,4849,2,3234.0408388520973,111,795,97,34.36819196296425,0.6419857357357357,38.16034226190474,133942.3434460863,1206.6877787935703,0
4851,511.8121134434127,0,0,906,0.0,0.0,1.0,906,24900,17500,7400,0.7028112449799196,323,175,148,150.64508702103547,0.4031792094040548,0.9329124252340548,0.09914092607772705,17356233.087792132,316826.2487735639,17673059.336565696,4850,3,3235.0408388520973,92,814,92,35.648914742018306,0.6325860507246377,39.57213261648746,133290.13720511648,1448.8058391860486,8
4852,511.3386688974744,0,1,905,0.0,0.0011037527593818985,0.9988962472406181,906,24700,17400,7300,0.7044534412955465,320,174,146,147.59550439573934,0.4033152728484952,0.9315306705730104,0.09765124592900172,17364435.8768009,306682.5343567767,17671118.411157675,4851,4,3236.0408388520973,96,810,96,35.543548431404865,0.6332465277777778,39.390034364261155,133259.9529295945,1388.124509683276,0
4853,511.03619189136947,1,0,906,0.0011037527593818985,0.0,1.0,906,26250,18400,7850,0.700952380952381,341,184,157,143.70605487976084,0.4034510313888584,0.9295266770682604,0.09578582289133888,17387892.58485585,292299.08920853725,17680191.674064387,4852,0,3236.9900662251657,104,802,74,35.38814413386577,0.6337139423076923,39.136904761904766,133310.4827954721,1281.831565341078,0
4854,510.6233658834437,0,0,906,0.0,0.0,1.0,906,26250,19500,6750,0.7428571428571429,330,195,135,146.50977628259596,0.40348690843527296,0.9307230743827648,0.09791060965482387,17385704.35079797,301985.1309901538,17687689.481788125,4853,1,3237.9900662251657,106,800,75,35.2246937760368,0.6341391509433962,39.04789719626168,133248.24106800725,1257.0588780000685,0
4855,510.7888441021641,0,0,906,0.0,0.0,1.0,906,25800,18700,7100,0.7248062015503876,329,187,142,143.83646895458298,0.40376467604958144,0.9292219596172477,0.0964554376037462,17406902.177898385,293749.46894135186,17700651.646839738,4854,2,3238.9900662251657,114,792,79,35.176037401984594,0.6335891812865497,38.931159420289866,133351.05131080298,1169.7460641298508,0
4856,510.90000652010247,0,0,906,0.0,0.0,1.0,906,25150,17700,7450,0.7037773359840954,326,177,149,148.24362115897202,0.40397505986283383,0.9282749646926842,0.09068163205094022,16983719.531462967,297195.6168184842,17280915.14828145,4855,3,3239.9900662251657,117,789,77,38.3297599484177,0.6005163817663818,42.15218926553671,131734.44818543087,1125.9354545763322,8
4857,510.6514435389799,1,0,907,0.0011025358324145535,0.0,1.0,907,26100,18200,7900,0.6973180076628352,340,182,158,152.5445533205319,0.404401665405119,0.9303074270305531,0.09383989487088237,17002296.40780451,311221.54219036637,17313517.949994877,4856,0,3237.4167585446526,121,786,84,38.01199279797943,0.6018422865013774,41.94842896174864,131774.40725818512,1089.0446880841746,0
4858,511.06093042501755,1,0,908,0.0011013215859030838,0.0,1.0,908,22000,15200,6800,0.6909090909090909,288,152,136,151.2118997618622,0.4048231591618137,0.9294585174480829,0.09321788995873788,17026032.003195737,311307.72892191086,17337339.73211765,4857,0,3234.850220264317,131,777,87,37.96863854071136,0.6009860050890585,41.87184343434348,131919.21586334234,1007.0169149873461,0
4859,511.42338337486126,2,0,910,0.002197802197802198,0.0,1.0,910,25500,18000,7500,0.7058823529411765,330,180,150,152.8014164084722,0.40563524301148063,0.9317672671749773,0.0946165533247525,17059177.133384306,313833.28574884107,17373010.419133145,4858,0,3228.7384615384617,136,774,93,37.765614267490946,0.6018688725490196,41.712287104622916,132094.37601311182,971.2821765669987,0
4860,511.50055250068664,2,0,912,0.0021929824561403508,0.0,1.0,912,26000,19400,6600,0.7461538461538462,326,194,132,156.53525823903726,0.4061366597980498,0.9339340689495317,0.09748926781557081,17089070.547065884,326608.41423000814,17415678.96129589,4859,0,3222.655701754386,96,816,96,37.4592351792613,0.6118706597222222,41.50558419243982,132220.03650390718,1377.2920469156998,0
4861,511.7951110117412,2,0,914,0.002188183807439825,0.0,1.0,914,24850,18400,6450,0.7404426559356136,313,184,129,153.8642596693208,0.4068104524723122,0.9320041563304666,0.09633555862236469,17123975.71858666,319303.56930714776,17443279.28789381,4860,0,3216.601750547046,106,808,90,37.33598022981582,0.6112421383647799,41.31619937694702,132393.1044568133,1248.9915514793709,0
4862,511.55276312067167,1,0,915,0.001092896174863388,0.0,1.0,915,26550,19800,6750,0.7457627118644068,333,198,135,151.21217768299817,0.40751490675307805,0.9309777753208519,0.09501664726177644,17132827.6151714,308588.4347114899,17441416.04988289,4861,0,3214.085245901639,110,805,72,37.274511403604166,0.6116477272727272,41.18806306306304,132395.96146870186,1203.5996497154715,0
4863,511.3736409620506,2,0,917,0.0021810250817884407,0.0,1.0,917,25050,17400,7650,0.6946107784431138,327,174,153,146.18323097859275,0.40810045850734705,0.9271459002292153,0.09085962738633671,17075341.176128186,290775.70863764535,17366116.88476583,4862,0,3208.07306434024,104,813,104,37.79967561134784,0.6090745192307692,41.577380952380956,132150.5156093302,1270.678034705098,8
4864,510.9832839941964,1,0,918,0.0010893246187363835,0.0,1.0,918,25350,18100,7250,0.7140039447731755,326,181,145,145.07051705868312,0.408680562980069,0.9267083280518227,0.09040947149714412,17074943.980041552,286464.1903865322,17361408.170428086,4863,0,3205.5773420479304,106,812,106,37.73135944266618,0.6095715408805031,41.48169781931463,132098.53102089008,1246.2125568008498,0
4865,511.0282215275712,2,0,920,0.002173913043478261,0.0,1.0,920,23250,16900,6350,0.7268817204301076,296,169,127,138.10724908681436,0.4094052589456088,0.9221966879310748,0.08646918273333752,17098273.369868997,265029.0998493871,17363302.469718385,4864,0,3199.6065217391306,118,802,100,37.743920321241625,0.6087570621468927,41.31652661064425,132194.55534473702,1120.292841904551,0
4866,511.30830312867624,0,0,920,0.0,0.0,1.0,920,25300,18300,7000,0.7233201581027668,323,183,140,138.45809398499347,0.40952235219441424,0.9220210972944916,0.08703440479821652,17126368.921656307,264956.8795552677,17391325.801211573,4865,1,3200.6065217391306,124,796,81,37.591358382433405,0.6091229838709677,41.17499999999998,132339.3715572785,1067.2529964296652,0
4867,511.094876042046,0,1,919,0.0,0.0010869565217391304,0.9989130434782608,920,23150,15300,7850,0.6609071274298056,310,153,157,140.2111490549906,0.40969680930753344,0.9218490384538915,0.08844461063226655,17135609.254967086,273370.69267925847,17408979.947646346,4866,2,3201.6065217391306,131,789,85,37.42038459194244,0.6092557251908397,41.05113636363638,132347.43736145727,1010.28578138517,0
4868,511.62852935015036,1,0,920,0.0010869565217391304,0.0,1.0,920,24450,17600,6850,0.7198364008179959,313,176,137,142.43053915595533,0.4098980756493353,0.9240361324117159,0.09030101560268847,17177253.846231997,280863.105307502,17458116.951539498,4867,0,3202.6021739130433,134,786,92,37.1811382743253,0.6106187810945274,40.8719135802469,132577.32176825576,989.3829982705654,0
4869,511.90788608964067,2,0,922,0.0021691973969631237,0.0,1.0,922,25900,17800,8100,0.6872586872586872,340,178,162,144.70847746379962,0.4103841493142651,0.9272192281078468,0.09223555960517116,17211555.106693484,287831.58685477363,17499386.69354826,4868,0,3196.652928416486,140,782,99,36.93158077167792,0.6116815476190476,40.684101654846316,132745.8533513022,948.1846667950158,0
4870,512.0426191683138,2,0,924,0.0021645021645021645,0.0,1.0,924,24800,18300,6500,0.7379032258064516,313,183,130,144.58172177873587,0.410802592360691,0.9277935439552563,0.09259472140595444,17238293.143083084,288868.4206307037,17527161.56371379,4869,0,3190.7316017316016,105,819,105,36.76525121504767,0.6195436507936508,40.51690251572326,132866.40486575532,1265.3943320548126,0
4871,511.94383889968003,2,0,926,0.0021598272138228943,0.0,1.0,926,26600,19300,7300,0.7255639097744361,339,193,146,142.7021069527044,0.41143458253069487,0.9269953866949452,0.09190485488929233,17261028.35642828,280837.02292653377,17541865.379354816,4870,0,3184.838012958963,112,814,105,36.61511951248376,0.6199776785714286,40.32079646017697,132941.16834258713,1186.974717344528,0
4872,511.45261402736475,0,0,926,0.0,0.0,1.0,926,25200,19300,5900,0.7658730158730159,311,193,118,143.14799879513086,0.41161549238223105,0.9274609631423012,0.0925758649338022,17263701.440162897,283852.8625911868,17547554.302754086,4871,1,3185.838012958963,115,811,76,36.45667726550077,0.6208333333333333,40.17600574712643,132887.661047663,1155.5448786753302,0
4873,511.4785144991649,0,2,924,0.0,0.0021598272138228943,0.9978401727861771,926,26150,18500,7650,0.7074569789674953,338,185,153,143.15106342143147,0.4117409228883311,0.926804134071757,0.09299410392037051,17285292.756649625,283531.6079330306,17568824.364582654,4872,2,3186.838012958963,123,803,82,36.29852225238034,0.6209349593495934,40.02016129032258,132974.10170295794,1081.0902577476254,0
4874,511.7128105557628,1,0,925,0.001081081081081081,0.0,1.0,925,25550,18500,7050,0.7240704500978473,326,185,141,144.27106487671145,0.41175022425022423,0.927421318934903,0.09416776019878004,17315087.5496373,289063.2238439325,17604150.77348123,4873,0,3191.277837837838,129,796,87,36.10264071130823,0.6216085271317829,39.85576923076923,133119.13547679016,1031.9312827658152,0
4875,512.0566117749445,0,0,925,0.0,0.0,1.0,925,27200,19400,7800,0.7132352941176471,350,194,156,143.50947929150394,0.41182876057876056,0.9276632484473804,0.09408328676593508,17346929.621321704,285689.76745244465,17632619.38877415,4874,1,3192.277837837838,137,788,95,35.96861346324865,0.6219586374695864,39.70410628019322,133286.23339709427,972.8922145773305,0
4876,511.8162215601037,1,0,926,0.0010799136069114472,0.0,1.0,926,25000,18200,6800,0.728,318,182,136,145.21298547988164,0.411989448952192,0.9294047757346118,0.09576248277199666,17365770.518830743,294147.07643958664,17659917.59527033,4875,0,3189.829373650108,101,825,101,35.71885944278918,0.6307755775577557,39.50163398692811,133327.28941539177,1320.0721724296216,0
4877,512.2680847465575,1,0,927,0.0010787486515641855,0.0,1.0,927,25750,18400,7350,0.7145631067961165,331,184,147,170.43228421862904,0.412410987703508,0.941224374039562,0.10626353181898554,17120030.38095636,372411.17674374185,17492441.5577001,4876,0,3187.3872707659116,87,840,87,37.05917197014786,0.6150622605363985,41.465435606060595,132439.0061428683,1522.2874269295207,7
4878,512.4721709420702,1,0,928,0.0010775862068965517,0.0,1.0,928,28100,20900,7200,0.7437722419928826,353,209,144,170.77726843332758,0.41296081728384726,0.9412992584472064,0.10730436115846989,17163342.179251395,372521.7389118066,17535863.918163203,4877,0,3184.9515086206898,93,835,69,36.770275815314356,0.6159274193548387,41.190159574468055,132632.8407840416,1426.1595783230277,0
4879,512.4696067438093,2,0,930,0.002150537634408602,0.0,1.0,930,23700,16400,7300,0.6919831223628692,310,164,146,168.875481645961,0.4134617183852834,0.9406500415067816,0.10693517952842173,17199709.009246778,371221.82862137817,17570930.837868154,4878,0,3179.1,103,827,73,36.540162175745124,0.6159991909385114,40.915464743589716,132772.94989625376,1289.0577659830462,0
4880,512.746215542935,1,0,931,0.0010741138560687433,0.0,1.0,931,25350,19100,6250,0.7534516765285996,316,191,125,178.88971304608168,0.41402084319862636,0.9439033269537584,0.11387937769670659,17233875.014502637,405042.59120327217,17638917.60570591,4879,0,3176.684210526316,110,821,75,36.09012294290811,0.6162878787878787,40.72822822822819,132940.61977308535,1208.5510888462304,0
4881,512.2095940345063,0,0,931,0.0,0.0,1.0,931,24450,18700,5750,0.7648261758691206,302,187,115,166.37225847296696,0.4143648291235,0.9396954385091651,0.1029624543002505,17082756.824542098,357769.36676870764,17440526.191310804,4880,1,3177.684210526316,126,805,82,37.43542513550132,0.6031746031746033,41.73228346456691,132287.2022388321,1049.8984304669216,8
4882,512.6540399557435,2,0,933,0.0021436227224008574,0.0,1.0,933,25100,17400,7700,0.6932270916334662,328,174,154,155.33284769955398,0.4149805571272389,0.9314229371080736,0.09793750822299649,17185683.866034694,322200.24291508575,17507884.10894978,4881,0,3171.870310825295,119,814,79,37.04563931073782,0.6110819327731092,41.067708333333314,132742.68539791455,1115.4847512429794,8
4883,512.9789719617557,2,0,935,0.0021390374331550803,0.0,1.0,935,26700,19600,7100,0.7340823970037453,338,196,142,153.47006963853872,0.4153063892483215,0.9307204635343334,0.09713778170597492,17214754.99534763,314689.9295892691,17529444.924936898,4882,0,3166.083422459893,125,810,87,36.954950750444034,0.6114166666666667,40.93088624338621,132897.0076419089,1063.176061135271,0
4884,512.7708158972985,1,0,936,0.0010683760683760685,0.0,1.0,936,26650,18500,8150,0.6941838649155723,348,185,163,152.94349906776847,0.4156581367978427,0.9309151976786962,0.09720133168826665,17226955.840375587,313100.18090258416,17540056.021278173,4883,0,3163.699786324786,128,808,95,36.82199671868994,0.6123860677083333,40.7864987080103,132917.11854908647,1038.414988664738,0
4885,513.1516225448856,0,0,936,0.0,0.0,1.0,936,25700,18800,6900,0.7315175097276264,326,188,138,150.19065558218446,0.415859885620915,0.9293671147304101,0.0957647077112801,17255076.501261685,305410.25036904094,17560486.751630727,4884,1,3164.699786324786,134,802,104,36.77642149424257,0.6126399253731343,40.67129629629627,133074.94507801565,993.0966050598182,0
4886,513.5547634554312,0,0,936,0.0,0.0,1.0,936,25850,18900,6950,0.7311411992263056,328,189,139,150.00056782623892,0.41607970256867316,0.9299348248497519,0.09608316627001252,17290077.64032768,305654.29276177665,17595731.933089457,4885,2,3165.699786324786,108,828,108,36.61796118292638,0.6189236111111112,40.51032110091741,133262.16066614285,1233.9088950568782,0
4887,513.0072028960133,2,0,938,0.0021321961620469083,0.0,1.0,938,25950,18800,7150,0.7244701348747592,331,188,143,152.45230554193822,0.4165332147768552,0.9314752963146335,0.09819194516808356,17297243.255944483,313850.92277769075,17611094.178722173,4886,0,3159.9477611940297,111,827,103,36.359169621431874,0.6202139639639639,40.31808035714284,133218.69523864836,1200.1684255734087,0
4888,513.1791358811101,2,2,938,0.002127659574468085,0.002127659574468085,0.997872340425532,940,26850,18500,8350,0.6890130353817505,352,185,167,150.6027684183693,0.41702960841849257,0.9302243809182142,0.0973364204920576,17319093.11094969,306810.6738009024,17625903.784750592,4887,0,3154.222340425532,116,824,75,36.284954251053705,0.6204202586206897,40.19764957264955,133325.145692188,1149.354704243,0
4889,513.4324885421735,1,0,939,0.0010649627263045794,0.0,1.0,939,27350,18700,8650,0.6837294332723949,360,187,173,157.0150506629155,0.41687803187016387,0.9328302661745518,0.10208534431313787,17355176.920671985,329854.7966926284,17685031.717364613,4888,0,3158.56762513312,119,820,82,35.908791829421666,0.6219362745098039,39.99131944444442,133496.90390020446,1121.8227218504576,0
4890,513.4120351129218,0,1,938,0.0,0.0010649627263045794,0.9989350372736954,939,26300,20500,5800,0.779467680608365,321,205,116,162.86890674189033,0.4171586064050658,0.9350330091672925,0.1062662993293163,17370824.468374193,351733.4380738739,17722557.906448066,4889,1,3159.56762513312,123,816,84,35.63222566686047,0.6224593495934959,39.86895161290322,133554.41094847664,1085.808219093306,0
4891,513.7176378889257,0,0,938,0.0,0.0,1.0,938,24550,17700,6850,0.7209775967413442,314,177,137,165.19567643672747,0.4172625305398605,0.937029332612388,0.10831921461562007,17403994.93564009,362862.94321889203,17766857.87885898,4890,2,3161.60447761194,126,812,90,35.39808892109906,0.6236772486772486,39.698162729658804,133721.644980668,1061.2828966719683,0
4892,513.279956561574,1,0,939,0.0010649627263045794,0.0,1.0,939,24750,16800,7950,0.6787878787878788,327,168,159,169.91999999999933,0.4174888054024719,0.9391778487752929,0.11178947368421047,17404512.415960558,378924.9499440042,17783437.365904562,4891,0,3159.23642172524,131,808,94,35.158333333333395,0.6240458015267176,39.58333333333334,133666.65535457712,1020.3561477448635,0
4893,512.9787022860835,0,0,939,0.0,0.0,1.0,939,24750,17900,6850,0.7232323232323232,316,179,137,170.1448836492951,0.4177784627751248,0.9394727034930748,0.11218533979040526,17404445.51260153,379705.4713444202,17784150.983945947,4892,1,3160.23642172524,95,844,95,35.075229794087846,0.6323464912280702,39.50737847222224,133627.16694642036,1406.6017573307406,0
4894,513.2008164923916,0,0,939,0.0,0.0,1.0,939,25500,19500,6000,0.7647058823529411,315,195,120,167.9726118621134,0.4178493278321613,0.9387312179073928,0.11109211019755748,17425986.7564774,372117.70195202425,17798104.458429426,4893,2,3161.23642172524,97,842,97,35.025314067789694,0.6328393470790379,39.402636054421784,133738.77995263645,1378.7503087900666,0
4895,513.2643164531424,0,0,939,0.0,0.0,1.0,939,28150,20800,7350,0.738898756660746,355,208,147,168.67458120702187,0.4179780013669671,0.9392636863110659,0.1120900130436797,17449958.92199464,372722.9026494419,17822681.824644085,4894,3,3162.23642172524,99,840,91,34.841217925671465,0.6339436026936027,39.23958333333336,133839.0170184545,1351.9092628126716,0
4896,513.6455269599408,0,1,938,0.0,0.0010649627263045794,0.9989350372736954,939,28100,19800,8300,0.7046263345195729,364,198,166,170.64107581432864,0.41807289809888637,0.939225479445734,0.11423833854134935,17496619.47744722,381228.39414911263,17877847.871596333,4895,4,3163.23642172524,111,828,70,34.53416001520334,0.6336336336336337,38.98809523809526,134067.5973642478,1207.816192470701,0
4897,513.9164695707632,0,0,938,0.0,0.0,1.0,938,24750,18000,6750,0.7272727272727273,315,180,135,171.9282266919813,0.4181850078392911,0.9395554694062134,0.11551718150169459,17522291.13837844,390165.2886004113,17912456.426978853,4896,5,3167.594882729211,118,820,73,34.37590786180388,0.6334745762711864,38.86554621848742,134201.29657068604,1137.29912348039,0
4898,514.0286695031176,1,0,939,0.0010649627263045794,0.0,1.0,939,24150,17600,6550,0.7287784679089027,307,176,131,175.8616796945117,0.41844765976900833,0.94204659433533,0.11877007732459219,17549464.38899926,405305.65703768714,17954770.046036948,4897,0,3165.220447284345,124,815,77,34.096254424849306,0.6341565860215054,38.69166666666667,134319.9749134108,1083.2256041404098,0
4899,513.6495181864074,0,0,939,0.0,0.0,1.0,939,26400,19300,7100,0.7310606060606061,335,193,142,175.01207732475402,0.4185727853203176,0.9428491958062168,0.11866947952794583,17554570.785321597,400252.3799367122,17954823.16525831,4898,1,3166.220447284345,133,806,83,33.981649421186205,0.6340852130325815,38.557213930348254,134289.96109798824,1009.6989556239718,0
4900,513.6459947889908,0,0,939,0.0,0.0,1.0,939,27750,20000,7750,0.7207207207207207,355,200,155,172.47994384452917,0.41868064401861077,0.9414051681942242,0.11771264879205504,17583624.710831873,391014.52054151124,17974639.231373385,4899,2,3167.220447284345,92,847,92,33.82694448011641,0.6450407608695652,38.34005376344086,134400.5833811112,1460.8759063164262,0
4901,513.3893799147938,1,1,939,0.0010638297872340426,0.0010638297872340426,0.9989361702127659,940,27400,19600,7800,0.7153284671532847,352,196,156,171.25493057798602,0.41899315704801393,0.9401519614595077,0.1176036135479555,17602642.425814237,387507.861324376,17990150.287138615,4900,0,3164.85,101,839,89,33.648571354288485,0.6445957095709571,38.133169934640485,134439.64950750564,1331.0856386881746,0
4902,512.8427141857635,0,1,938,0.0,0.0010649627263045794,0.9989350372736954,939,24650,17800,6850,0.7221095334685599,315,178,137,169.4808187889536,0.4188782430461416,0.9393248043004074,0.11681318144542696,17600284.35860451,384132.12080293184,17984416.47940744,4901,1,3169.2012779552715,107,832,69,33.57098043907764,0.6443730529595015,38.0111882716049,134359.05329309098,1255.6920868513175,0
4903,513.2104008221397,0,0,938,0.0,0.0,1.0,938,25550,18400,7150,0.7201565557729941,327,184,143,168.87712230311718,0.41882157098332096,0.9398728467383264,0.11700772045287179,17636218.63161218,382520.7701630446,18018739.401775226,4902,5,3173.5788912579956,110,828,74,33.41051868556695,0.6454545454545455,37.83783783783779,134544.3483236393,1223.130439305812,0
4904,513.432012188426,0,0,938,0.0,0.0,1.0,938,27300,18100,9200,0.663003663003663,365,181,184,170.18335307419366,0.41897856065760536,0.9405931303067934,0.11844123339763224,17663709.862878643,386313.8744388655,18050023.73731751,4903,6,3174.5788912579956,114,824,78,33.226141556453356,0.6461074561403508,37.6902173913043,134678.23950148845,1181.3880658025303,0
4905,513.5194727286015,0,0,938,0.0,0.0,1.0,938,25900,18500,7400,0.7142857142857143,333,185,148,173.12512975850035,0.419103408100525,0.9421802008798907,0.12089477877216064,17681642.549245838,398727.3321363143,18080369.881382152,4904,7,3175.5788912579956,117,821,81,33.03628996086608,0.6466346153846154,37.579449152542345,134758.062904334,1151.778315421658,0
4906,513.4773878902579,0,0,938,0.0,0.0,1.0,938,24700,18400,6300,0.7449392712550608,310,184,126,176.70922111869518,0.41902542289315736,0.9430108331919669,0.12363365274981399,17688654.237400707,412849.6625857933,18101503.8999865,4905,8,3176.5788912579956,124,814,84,32.87834412766947,0.6460013440860215,37.51666666666665,134779.25636472696,1086.929486812314,0
4907,513.6346330318868,0,0,938,0.0,0.0,1.0,938,26350,19000,7350,0.7210626185958254,337,190,147,173.51735824274837,0.41896725398772267,0.9416361809914096,0.12189191512470571,17711926.875366397,400715.35216046864,18112642.227526866,4906,9,3177.5788912579956,89,849,89,32.82742030262965,0.6556647940074907,37.38425925925929,134888.5396237688,1515.601568806391,0
4908,513.5046924831116,0,0,938,0.0,0.0,1.0,938,25100,18800,6300,0.749003984063745,314,188,126,174.17171582218472,0.4190538199382718,0.941801592742997,0.12285194034558211,17725433.937697314,404753.84852431045,18130187.786221623,4907,10,3178.5788912579956,91,847,91,32.67455974029707,0.6563644688644689,37.250905797101474,134922.89281887675,1482.6691518557884,0
4909,513.0542556718727,1,0,939,0.0010649627263045794,0.0,1.0,939,22450,16300,6150,0.7260579064587973,286,163,123,171.61102430349385,0.41931809838681233,0.9409554795109496,0.12131441619690013,17719629.32010386,397926.7475802549,18117556.067684118,4908,0,3176.1927582534613,93,846,86,32.6683303818639,0.6564740143369175,37.178634751773075,134841.61992209576,1449.9098916354383,0
4910,513.3576407580489,0,0,939,0.0,0.0,1.0,939,25850,19600,6250,0.758220502901354,321,196,125,169.65853824262334,0.4193794548480782,0.9401763098460993,0.12050009493343863,17750764.190391496,388663.74104627065,18139427.931437768,4909,1,3177.1927582534613,100,839,68,32.56399194708085,0.6560416666666666,37.0255775577558,134999.9290846623,1349.999290846623,0
4911,513.6374363858982,0,1,938,0.0,0.0010649627263045794,0.9989350372736954,939,24700,17700,7000,0.7165991902834008,317,177,140,166.1671084087015,0.41935286862507787,0.9387492482365758,0.11852105773855998,17778975.597253677,378356.1930929087,18157331.790346585,4910,2,3178.1927582534613,108,831,72,32.51632948326796,0.6554783950617284,36.88837920489299,135143.9783885388,1251.333133227211,0
4912,513.3353096953272,2,0,940,0.002127659574468085,0.0,1.0,940,26250,18900,7350,0.72,336,189,147,169.28467109598296,0.4195235613562036,0.9399239967247293,0.12125062333804892,17786764.400740728,387955.3122882298,18174719.713028956,4911,0,3175.8074468085106,112,828,76,32.296955796010366,0.6559709821428572,36.75331858407081,135133.8167309139,1206.5519350974457,0
4913,513.1063773063037,0,0,940,0.0,0.0,1.0,940,25500,18200,7300,0.7137254901960784,328,182,146,171.11445560061574,0.41949009244782814,0.9407560632476921,0.12295761141666199,17792884.21376219,395423.9391605397,18188308.15292273,4912,1,3176.8074468085106,119,821,78,32.14299448436498,0.6556372549019608,36.64930555555555,135126.9207874879,1135.5203427519991,0
4914,512.5537697083911,0,0,940,0.0,0.0,1.0,940,26450,19300,7150,0.7296786389413988,336,193,143,170.51361756684943,0.41946391683471934,0.941140349122916,0.12283111470441291,17784518.323612723,392050.5112086249,18176568.834821347,4913,2,3177.8074468085106,121,819,81,32.07747895936646,0.6560778236914601,36.569330601092894,135022.38265721465,1115.8874599769806,0
4915,512.5101592224597,0,0,940,0.0,0.0,1.0,940,26250,18700,7550,0.7123809523809523,338,187,151,170.13002811418693,0.41944692274866124,0.9417891505006242,0.12307278629536895,17801266.27189356,391455.9862610746,18192722.258154634,4914,3,3178.8074468085106,85,855,85,31.950061274509743,0.6666666666666667,36.43410852713177,135080.1970043688,1589.1787882866915,0
4916,512.3670686408576,0,0,940,0.0,0.0,1.0,940,26000,18800,7200,0.7230769230769231,332,188,144,170.33257125438257,0.4192917100959977,0.9418844234305217,0.12362847913624468,17810611.39293589,392745.4468342697,18203356.83977016,4915,4,3179.8074468085106,87,853,87,31.836934156378568,0.6670258620689655,36.32812499999998,135096.78567678778,1552.8366169745723,0
4917,512.1630403493315,0,0,940,0.0,0.0,1.0,940,22200,15100,7100,0.6801801801801802,293,151,142,170.51511497190623,0.4192443390811109,0.9417343246345184,0.12414470124163071,17816854.28685289,397408.59143207985,18214262.87828497,4916,5,3180.8074468085106,90,850,90,31.731708110923037,0.6670138888888889,36.229395604395584,135093.55470203256,1501.0394966892507,0
4918,512.3343547422656,0,0,940,0.0,0.0,1.0,940,24550,16800,7750,0.6843177189409368,323,168,155,167.88488747475816,0.4192169833231369,0.9399179507567457,0.12290440818906834,17846467.46733298,386680.43651502626,18233147.903848007,4917,6,3181.8074468085106,97,843,85,31.623174398625462,0.6666666666666667,36.054421768707485,135228.38751020352,1394.107087734057,0
4919,512.372284127534,0,0,940,0.0,0.0,1.0,940,25300,18300,7000,0.7233201581027668,323,183,140,132.56067562110633,0.4189934874885762,0.9238323281874699,0.09958867811963788,17957893.621473733,262802.1022388981,18220695.72371263,4918,7,3182.8074468085106,112,828,112,31.731862864570605,0.6712239583333333,35.24151917404127,135654.90756293098,1211.2045318118837,8
4920,511.95545974055614,0,0,940,0.0,0.0,1.0,940,26450,19500,6950,0.7372400756143668,334,195,139,130.18320741545477,0.41874820617980496,0.9225033662358231,0.09822498126516242,17961427.89097146,253205.2585216091,18214633.14949307,4919,8,3183.8074468085106,117,823,109,31.65924478732739,0.6715633903133903,35.10769774011297,135613.0603851932,1159.0859861982326,0
4921,512.0427419307705,0,0,940,0.0,0.0,1.0,940,27250,19500,7750,0.7155963302752294,350,195,155,152.1896885341825,0.4186894113626236,0.9318248237135429,0.10895279621244262,17739843.349947196,324714.2468147311,18064557.596761927,4920,9,3184.8074468085106,123,817,86,32.76305116749114,0.6537093495934959,36.769153225806456,134785.4445430167,1095.8166223009487,8
4922,511.82563788345664,0,0,940,0.0,0.0,1.0,940,25400,18600,6800,0.7322834645669292,322,186,136,152.7196853009862,0.4187259250447511,0.9326644669830386,0.10974251241287869,17748583.70986587,328711.6237417847,18077295.333607655,4921,10,3185.8074468085106,125,815,89,32.62658269240832,0.6545833333333333,36.648478835978835,134790.06030735368,1078.3204824588295,0
4923,511.55778977204835,0,0,940,0.0,0.0,1.0,940,23350,15900,7450,0.6809421841541756,308,159,149,154.6266449997324,0.4186679799318726,0.9331514986799192,0.1114939492892816,17754120.11137509,337702.0055488447,18091822.116923936,4922,11,3186.8074468085106,129,811,94,32.46464416058399,0.6550387596899225,36.538461538461554,134775.80230532915,1044.7736612816213,0
4924,511.7141717558778,0,0,940,0.0,0.0,1.0,940,23850,16500,7350,0.6918238993710691,312,165,147,154.39795557409732,0.4184954899583834,0.9329810777540848,0.1117530282564927,17775971.31808878,337064.72597134445,18113036.044060126,4923,12,3187.8074468085106,99,841,99,32.34699388765939,0.6624579124579124,36.416666666666686,134879.32710532114,1362.4174455082943,0
4925,511.25267545464766,0,1,939,0.0,0.0010638297872340426,0.9989361702127659,940,23800,15600,8200,0.6554621848739496,320,156,164,151.58255826868904,0.41836883681145626,0.931607723321809,0.11011795521563437,17775718.527699057,327097.7778985572,18102816.305597614,4924,13,3188.8074468085106,104,836,104,32.302365097876965,0.6623597756410257,36.2996031746032,134817.53339543773,1296.3224364945936,0
4926,511.2086363826622,0,0,939,0.0,0.0,1.0,939,27850,19700,8150,0.7073608617594255,360,197,163,142.82003869944592,0.4183075853805671,0.9255438202799389,0.0972898820174208,17491880.491695963,283988.20975001896,17775868.70144598,4925,14,3193.139510117146,111,828,111,34.66601634254157,0.6395457957957957,38.402157738095234,133731.0762233548,1204.7844704806737,8
4927,510.78939705291634,0,0,939,0.0,0.0,1.0,939,26950,19100,7850,0.7087198515769945,348,191,157,162.58642503562461,0.4183327051037222,0.9361773429595166,0.10999838908330677,17446804.252625857,352572.70634616516,17799376.958972022,4926,15,3194.139510117146,137,802,89,34.382761508692916,0.6327554744525548,38.63224637681163,133503.87728226616,974.4808560749354,7
4928,510.5640829602642,1,1,939,0.0010638297872340426,0.0010638297872340426,0.9989361702127659,940,25500,18200,7300,0.7137254901960784,328,182,146,161.6902669323952,0.41847148581182636,0.9363172619950408,0.11006246389100963,17466497.025317833,351332.51327950077,17817829.538597334,4927,0,3191.7404255319148,99,841,99,34.19770386152149,0.6421506734006734,38.427083333333314,133549.73632515725,1348.987235607649,0
4929,510.8765812429655,1,0,940,0.0010638297872340426,0.0,1.0,940,26050,19500,6550,0.7485604606525912,326,195,131,158.91870846978878,0.41851125669378164,0.9349860376877579,0.10854369994862956,17492370.317745216,341922.97979426547,17834293.29753948,4928,0,3192.659574468085,104,836,104,34.154803876968224,0.6420272435897436,38.313492063492056,133689.50853201287,1285.4760435770468,0
4930,510.43346887616144,1,0,941,0.0010626992561105207,0.0,1.0,941,25450,18100,7350,0.7111984282907662,328,181,147,157.86646950182592,0.41857594531244113,0.9334888601341482,0.10839519936761849,17500704.37598948,338904.88272652414,17839609.258716006,4929,0,3190.2656748140275,115,826,92,34.00364213618646,0.6413949275362318,38.137571839080465,133663.34757451314,1162.2899789088099,0
4931,510.38691342383197,0,1,940,0.0,0.0010626992561105207,0.9989373007438895,941,26350,19600,6750,0.7438330170777988,331,196,135,158.1071895472798,0.41866930834105864,0.9334019013718777,0.10901185921605115,17517544.941129636,339379.9596820366,17856924.900811672,4930,1,3191.2656748140275,122,819,71,33.85724752453912,0.641478825136612,37.999661246612476,133721.5442123404,1096.078231248692,0
4932,510.0558720946171,0,0,940,0.0,0.0,1.0,940,25200,18200,7000,0.7222222222222222,322,182,140,160.77500541201854,0.4184364119064343,0.9340877269256098,0.11123374860255326,17521442.32706881,350201.9969921787,17871644.324060988,4931,3,3195.659574468085,126,814,76,33.6713526509581,0.6419477513227514,37.88549868766407,133693.0405555108,1061.0558774246888,0
4933,509.75579430123105,0,0,940,0.0,0.0,1.0,940,27600,19600,8000,0.7101449275362319,356,196,160,164.28668547987712,0.41835358933979866,0.9347905069378584,0.11402203506026504,17525055.783989772,360226.6655203318,17885282.449510105,4932,4,3196.659574468085,136,804,77,33.47342235238401,0.6414675245098039,37.78132603406328,133667.48842812277,982.8491796185498,0
4934,509.4594029359048,0,0,940,0.0,0.0,1.0,940,27950,19800,8150,0.7084078711985689,361,198,163,168.32187474712234,0.41832377888050515,0.9370094608278543,0.11725626411024219,17531192.18822325,374226.6271347758,17905418.815358028,4933,5,3197.659574468085,143,797,83,33.24337303994563,0.6417540792540792,37.65914351851854,133652.016108751,934.629483277979,0
4935,509.32184469708744,0,0,940,0.0,0.0,1.0,940,24200,17200,7000,0.7107438016528925,312,172,140,176.3352853270523,0.41841337547866675,0.9410877475883723,0.1231479226986517,17537517.702519454,406296.63760040654,17943814.34011986,4934,6,3198.659574468085,149,791,83,32.94893465470557,0.6418484340044743,37.57638888888891,133658.07770318355,897.034078544856,0
4936,509.26798559698994,0,0,940,0.0,0.0,1.0,940,25100,17600,7500,0.701195219123506,326,176,150,180.61848916281377,0.4183491047893111,0.9434888912915245,0.12670403958344542,17555262.662326153,421061.0037851447,17976323.666111298,4935,7,3199.659574468085,88,852,88,32.6872715521084,0.6555397727272727,37.429775280898895,133718.60942044633,1519.529652505072,0
4937,508.94346104262144,1,2,939,0.0010626992561105207,0.0021253985122210413,0.997874601487779,941,27050,19600,7450,0.7245841035120147,345,196,149,173.39732797778765,0.4185694447584809,0.940153474147402,0.12235805231956255,17569852.77082386,394063.1046848011,17963915.87550866,4936,0,3197.2582359192347,98,843,98,32.680711835448946,0.6544430272108843,37.23695286195288,133731.5346445441,1364.6074963728988,0
4938,509.11736460842974,0,1,938,0.0,0.0010649627263045794,0.9989350372736954,939,27150,19600,7550,0.7219152854511971,347,196,151,177.0901988704959,0.4183330362488486,0.9399529884618336,0.12550183020880487,17594571.592048347,408215.23645540513,18002786.82850375,4937,1,3204.5612353567626,105,834,87,32.441338354577034,0.6540674603174603,37.097091194968556,133848.43607870818,1274.7470102734112,0
4939,509.20100317353786,0,0,938,0.0,0.0,1.0,938,25950,18000,7950,0.6936416184971098,339,180,159,181.54873698541795,0.4182834493487737,0.9390700991265883,0.12554882001676593,17490054.891018223,421509.47505399864,17911564.366072223,4938,2,3207.271855010661,116,822,74,33.14226026699278,0.6435883620689655,37.90064102564103,133461.256520885,1150.5280734559053,8
4940,509.725742438563,0,0,938,0.0,0.0,1.0,938,24300,17200,7100,0.7078189300411523,314,172,142,183.4540155965453,0.41834780492263485,0.9400613325899072,0.1272823121750099,17522542.823438,431016.16888441803,17953558.99232242,4939,3,3208.271855010661,113,825,76,32.982093903912215,0.6452802359882006,37.792397660818686,133653.96477537317,1182.7784493395857,8
4941,509.9538111479249,0,0,938,0.0,0.0,1.0,938,24600,17000,7600,0.6910569105691057,322,170,152,185.21372551141744,0.4183340804742866,0.9408540246667885,0.12901909304773934,17548056.564169973,437828.1863469939,17985884.750516966,4940,4,3209.271855010661,116,822,81,32.80136428425979,0.6460129310344828,37.66025641025639,133781.15205915776,1153.285793613429,0
4942,509.9187598496265,0,0,938,0.0,0.0,1.0,938,28000,20700,7300,0.7392857142857143,353,207,146,186.8765877306244,0.41825915304556655,0.9418048395754806,0.1305198957529213,17558415.231582906,440651.3448871266,17999066.576470032,4941,5,3210.271855010661,126,812,83,32.66968797207895,0.6450892857142857,37.57381889763779,133816.03281978983,1062.0320065062685,0
4943,509.8517192086802,0,0,938,0.0,0.0,1.0,938,26050,18500,7550,0.710172744721689,336,185,151,188.76581499222277,0.41833825232732513,0.9411726148539867,0.13255671855025036,17579929.037431482,450047.9264512473,18029976.96388273,4942,6,3211.271855010661,89,849,89,32.438764379214604,0.6555477528089888,37.395833333333364,133889.18584636433,1504.3728746782508,0
4944,509.5492999362967,0,0,938,0.0,0.0,1.0,938,24300,17200,7100,0.7078189300411523,314,172,142,186.57651012050988,0.4182852034233468,0.9406672569475993,0.13164734175636073,17590415.474054936,444491.6661438027,18034907.140198737,4943,7,3212.271855010661,91,847,91,32.33709117938556,0.6564789377289377,37.23958333333336,133889.3863634707,1471.3119380601174,0
4945,509.9007927130892,2,0,940,0.002127659574468085,0.0,1.0,940,24300,17500,6800,0.720164609053498,311,175,136,183.592985471149,0.41872457967960486,0.93965136348546,0.1301309632398586,17622338.698800437,434767.5545393142,18057106.253339753,4944,0,3206.4351063829786,96,844,89,32.26511654821231,0.6564670138888888,37.09192439862546,134057.03615981512,1396.4274599980743,0
4946,510.27528118009417,0,1,939,0.0,0.0010638297872340426,0.9989361702127659,940,23050,14600,8450,0.6334056399132321,315,146,169,182.68797176747228,0.4186275009629982,0.9396187065515067,0.12994003625714695,17650411.45602142,433853.57395238813,18084265.02997381,4945,1,3207.4351063829786,99,841,75,32.17409240924093,0.6567760942760943,36.97916666666669,134213.02968539062,1355.6871685392991,0
4947,510.48061312103044,0,0,939,0.0,0.0,1.0,939,26100,18500,7600,0.7088122605363985,337,185,152,181.43130394553677,0.41832825829773995,0.9392295131675104,0.12961750128562738,17676715.77706234,427521.9185814185,18104237.69564376,4946,2,3211.849840255591,101,838,79,32.06157754149041,0.6576938943894389,36.83619281045754,134340.02164538356,1330.0992242117184,0
4948,510.0570592043956,0,0,939,0.0,0.0,1.0,939,25950,18900,7050,0.7283236994219653,330,189,141,181.68624313186498,0.41842528381975713,0.9396921386957091,0.1301451046497701,17673568.26821194,428458.8442772022,18102027.11248914,4947,3,3212.849840255591,106,833,79,31.967506132662773,0.6573309748427674,36.75038940809972,134272.3222152088,1266.7200208981963,0
4949,510.4057131832685,1,0,940,0.0010638297872340426,0.0,1.0,940,25950,18200,7750,0.7013487475915221,337,182,155,180.84780804002256,0.4184881966631168,0.9398758295498175,0.13008455869660773,17703651.29811517,426383.30631381203,18130034.604428984,4948,0,3210.43085106383,111,829,82,31.85320956483872,0.6575638138138138,36.61644345238098,134432.47202043456,1211.1033515354466,0
4950,510.4616697876717,0,0,940,0.0,0.0,1.0,940,25050,18900,6150,0.7544910179640718,312,189,123,179.69010976585548,0.41841866252766263,0.9393619141656182,0.12974841387099117,17722145.974507064,423848.8710891473,18145994.84559621,4949,1,3211.43085106383,118,822,87,31.758393404865558,0.6573975988700564,36.49334733893561,134510.04591752897,1139.9156433688895,0
4951,510.69066184608204,0,0,940,0.0,0.0,1.0,940,26700,19600,7100,0.7340823970037453,338,196,142,177.9410023894447,0.418303503991722,0.9390905590698715,0.1291677193108203,17752902.688156847,417093.8599305771,18169996.548087426,4950,2,3212.43085106383,92,848,92,31.63204621723802,0.6654211956521738,36.323924731182785,134656.9093920091,1463.6620586087947,0
4952,510.89113695608955,0,0,940,0.0,0.0,1.0,940,27050,19900,7150,0.7356746765249538,342,199,143,180.34503191021383,0.41826219892144195,0.9390580507859048,0.13152096898215151,17779775.19126283,426248.8248449439,18206024.016107775,4951,3,3213.43085106383,95,845,92,31.418284390337508,0.6660087719298246,36.17621527777777,134785.23333279448,1418.7919298188892,0
4953,511.4216635063018,0,0,940,0.0,0.0,1.0,940,26900,19200,7700,0.7137546468401487,346,192,154,183.48613838630135,0.4181786682678872,0.9397203688610458,0.13439756945101125,17816965.096648436,438933.2246695063,18255898.32131794,4952,4,3214.43085106383,98,842,73,31.194111159830467,0.6665603741496599,36.03745791245791,134996.16237776278,1377.5118609975793,0
4954,510.96616591211335,0,0,940,0.0,0.0,1.0,940,22150,14700,7450,0.6636568848758465,296,147,149,182.0891800792653,0.4181727911464588,0.9395138876647451,0.1336638994343796,17810364.67006926,438464.9399371236,18248829.61000638,4953,5,3215.43085106383,99,841,74,31.161026617219633,0.6669823232323233,35.96874999999999,134911.03549348237,1362.7377322573977,0
4955,510.53785750146574,0,0,940,0.0,0.0,1.0,940,25850,18700,7150,0.723404255319149,330,187,143,181.03360515803624,0.41806964648524536,0.9393500528697092,0.13333998024584243,17809875.167702824,430987.1818047631,18240862.349507585,4954,6,3216.43085106383,102,838,77,31.0798587181254,0.6672794117647058,35.86165048543688,134852.62704513784,1322.0845788739005,0
4956,510.45079776257506,0,0,940,0.0,0.0,1.0,940,26500,18700,7800,0.7056603773584905,343,187,156,172.39837472607533,0.4181726731319723,0.9397058654399075,0.11640036249753397,17426125.308644094,386347.13619664166,17812472.444840737,4955,7,3217.43085106383,117,823,83,34.19580518018023,0.6353276353276354,38.70056497175144,133380.5050650813,1140.0043167955666,8
4957,510.13107471263845,1,0,941,0.0010626992561105207,0.0,1.0,941,26750,19300,7450,0.7214953271028037,342,193,149,171.16839095989698,0.41833726192898757,0.940046957517434,0.1161565177155651,17437924.278015416,382014.28806967667,17819938.566085093,4956,0,3215.010626992561,90,851,90,34.05468362373404,0.64375,38.530219780219745,133383.85998839213,1482.0428887599126,0
4958,510.07332774348475,0,0,941,0.0,0.0,1.0,941,25100,17900,7200,0.7131474103585658,323,179,144,168.08729028531874,0.4183892192552061,0.9389766618097481,0.11444189464046453,17450684.028292846,373347.6383881997,17824031.666681044,4957,1,3216.010626992561,93,848,93,34.02293828991026,0.6439292114695341,38.419769503546064,133425.09864123244,1434.678480013252,0
4959,510.4374642324703,1,0,942,0.0010615711252653928,0.0,1.0,942,28300,21000,7300,0.7420494699646644,356,210,146,170.19571343380412,0.4185648643272241,0.9394995843289742,0.11652515526089034,17488032.437120333,378577.63143782987,17866610.068558164,4958,0,3213.5955414012737,97,845,95,33.778263355937234,0.6446520618556701,38.23341836734689,133615.47014937105,1377.479073704856,0
4960,510.71889629474964,0,0,942,0.0,0.0,1.0,942,28500,21600,6900,0.7578947368421053,354,216,138,170.83289495773187,0.4187486321413503,0.9404017015903336,0.11751008126615674,17518517.619273376,381647.8160536932,17900165.435327068,4959,1,3214.5955414012737,100,842,70,33.60306084947759,0.6454166666666667,38.077557755775544,133768.74061779387,1337.6874061779388,0
4961,511.07578659486046,1,0,943,0.0010604453870625664,0.0,1.0,943,23350,16000,7350,0.6852248394004282,307,160,147,169.39098173762008,0.4190082490343043,0.9396993939739187,0.11705594401996333,17551219.73388491,382653.66828308254,17933873.40216799,4960,0,3212.185577942736,102,841,78,33.48543901623316,0.6464460784313726,37.92475728155336,133940.3108193671,1313.1403021506578,0
4962,511.063119124484,0,0,943,0.0,0.0,1.0,943,28200,20400,7800,0.723404255319149,360,204,156,170.98753328893088,0.4190988709596318,0.9399678212317206,0.11852681138300665,17564554.47076406,383863.9684549949,17948418.439219054,4961,1,3213.185577942736,109,834,79,33.33905222856312,0.6458333333333333,37.82196969696967,133989.52193257853,1229.261669106225,0
4963,511.49684030402295,1,0,944,0.001059322033898305,0.0,1.0,944,26200,19200,7000,0.732824427480916,332,192,140,170.50248344597205,0.419262806038847,0.939983588660543,0.11875084860267761,17600392.648370057,385182.1312342569,17985574.779604316,4962,0,3210.780720338983,112,832,86,33.19306814721106,0.6467633928571428,37.66592920353979,134183.04831647928,1198.0629313971365,0
4964,511.22678379858945,0,0,944,0.0,0.0,1.0,944,26100,18200,7900,0.6973180076628352,340,182,158,175.71379208586177,0.4191633424774281,0.9425049035817339,0.12290128424759786,17609836.380145416,403958.225673377,18013794.605818793,4963,1,3211.780720338983,118,826,88,32.91423489522534,0.6469809322033898,37.52626050420166,134183.6056740245,1137.1492006273263,0
4965,511.5145896596026,0,0,944,0.0,0.0,1.0,944,27650,21000,6650,0.759493670886076,343,210,133,176.66399073413726,0.41921454865916563,0.943578612993105,0.12410235138568451,17638820.33081575,406778.8782968749,18045599.209112626,4964,2,3212.780720338983,89,855,89,32.74478478037314,0.6556647940074907,37.38425925925929,134331.7828631539,1509.3458748668977,0
4966,511.0454506392526,0,0,944,0.0,0.0,1.0,944,27100,19500,7600,0.7195571955719557,347,195,152,175.4929542212384,0.41931960558321496,0.9427758356824691,0.12392056985463255,17645377.914436985,403427.8997109533,18048805.814147938,4965,3,3213.780720338983,94,850,86,32.60321914378702,0.6558067375886525,37.214912280701775,134295.12357478536,1428.6715273913337,0
4967,511.1389009658832,0,0,944,0.0,0.0,1.0,944,25900,18100,7800,0.6988416988416989,337,181,156,174.51881190459997,0.4193102209036552,0.9425707996502168,0.1236024987406812,17661711.945785236,401760.1969959473,18063472.142781183,4966,4,3214.780720338983,97,847,80,32.529550110518116,0.6559278350515464,37.117346938775526,134369.5503687106,1385.2530965846454,0
4968,511.0324103172251,0,0,944,0.0,0.0,1.0,944,24500,17600,6900,0.7183673469387755,314,176,138,176.58047505721024,0.41922540773975353,0.9431150722734749,0.12533151525574499,17667408.98088825,410643.8941750602,18078052.87506331,4967,5,3215.780720338983,98,846,66,32.40433222626814,0.6563562925170068,37.04755892255895,134377.2197626041,1371.1961200265725,0
4969,511.5714757494575,0,0,944,0.0,0.0,1.0,944,25800,19000,6800,0.7364341085271318,326,190,136,176.9267788433801,0.4191722122867876,0.9432008277347259,0.12620216552652552,17707693.132343706,411993.02133052645,18119686.153674234,4968,6,3216.780720338983,106,838,67,32.23150306483639,0.6559551886792453,36.886682242990666,134601.26825428984,1269.8232854178286,0
4970,511.90569266465326,0,0,944,0.0,0.0,1.0,944,26750,18800,7950,0.702803738317757,347,188,159,176.36598617151114,0.4190707828573312,0.9431500169479548,0.12623950785599658,17734367.559620094,409997.84475609014,18144365.404376183,4969,7,3217.780720338983,111,833,71,32.13215202694742,0.6559684684684685,36.77455357142857,134746.6044809803,1213.9333737025254,0
4971,512.109558385191,0,0,944,0.0,0.0,1.0,944,26250,18900,7350,0.72,336,189,147,176.35125134731058,0.41900148600901077,0.943248393438525,0.12663836850482066,17755500.22891263,411190.93673323735,18166691.165645868,4970,8,3218.780720338983,117,827,75,32.026343725555904,0.6558048433048433,36.67019774011298,134853.70874496968,1152.5958012390572,0
4972,511.86825938991495,0,0,944,0.0,0.0,1.0,944,28500,21500,7000,0.7543859649122807,355,215,140,174.6576058797902,0.4188017397744906,0.9427061271106014,0.12576143329977618,17758844.479970634,403043.4520126407,18161887.931983273,4971,9,3219.780720338983,124,820,80,31.98256089844987,0.6554099462365591,36.583333333333336,134834.6306609602,1087.376053717421,0
4973,511.46122664612744,1,0,945,0.0010582010582010583,0.0,1.0,945,26700,20000,6700,0.7490636704119851,334,200,134,156.91130160654254,0.4189405191612112,0.9376060393028607,0.10963483664133529,17613280.445562623,337044.552054856,17950324.99761748,4972,0,3217.372486772487,119,826,88,33.44279567580677,0.6464460784313726,37.56076388888888,134227.49362146092,1127.9621312727809,8
4974,511.3714204135844,1,0,946,0.0010570824524312897,0.0,1.0,946,27050,19600,7450,0.7245841035120147,345,196,149,156.97082617866204,0.41906815012435167,0.9375621068994573,0.10995545546158629,17621383.341850124,336958.62031623285,17958341.962166358,4973,0,3214.970401691332,91,855,91,33.35651542597548,0.6540750915750916,37.47735507246381,134246.5778273271,1475.2371189816165,0
4975,511.642894964164,1,1,946,0.0010559662090813093,0.0010559662090813093,0.9989440337909187,947,25350,16900,8450,0.6666666666666666,338,169,169,156.45694655242278,0.41920370176061345,0.9374357431030531,0.11018211421231548,17654214.395365622,337674.8956161513,17991889.290981773,4974,0,3212.5744456177404,94,853,94,33.1925487658959,0.6549202127659575,37.30263157894739,134407.24207841596,1429.8642774299572,0
4976,511.54212366001093,0,0,946,0.0,0.0,1.0,946,26550,20000,6550,0.7532956685499058,331,200,131,156.78017378924255,0.4192302780481075,0.9375720432057919,0.11107545225807398,17677074.16284144,338532.95186712575,18015607.114708565,4975,1,3216.8594080338266,97,849,87,32.985072238170325,0.6560352233676976,37.10671768707485,134480.98793030548,1386.4019374258296,0
4977,511.36886437442365,0,0,946,0.0,0.0,1.0,946,26600,18700,7900,0.7030075187969925,345,187,158,154.77515279173022,0.41920688054408983,0.9366275162915698,0.11020456367952638,17692908.946403068,331884.5371019472,18024793.483505014,4976,2,3217.8594080338266,104,842,72,32.872998064061946,0.655849358974359,36.94444444444447,134518.42071182904,1293.4463529983561,0
4978,510.9063740531749,0,0,946,0.0,0.0,1.0,946,23900,17100,6800,0.7154811715481172,307,171,136,156.3515479259418,0.4191434928838029,0.9371931653030676,0.11175098049137176,17693436.649491157,340179.24165551225,18033615.89114667,4977,3,3218.8594080338266,108,838,75,32.70664633186877,0.656153549382716,36.82148318042816,134459.58175698138,1244.9961273794572,0
4979,511.3978339996443,0,0,946,0.0,0.0,1.0,946,27050,19100,7950,0.7060998151571165,350,191,159,173.82364490627108,0.41916171683613546,0.9441670686542063,0.12095367334886972,17592957.659144104,395364.4049988244,17988322.064142928,4978,4,3219.8594080338266,100,846,72,33.136492614582096,0.6492708333333334,37.695957095709566,134141.7193906037,1341.417193906037,7
4980,511.19339271720213,0,0,946,0.0,0.0,1.0,946,25150,17800,7350,0.7077534791252486,325,178,147,173.05594620575275,0.4192576139766062,0.9437100652729016,0.12078068291118152,17599148.781480346,394777.4689589762,17993926.250439323,4979,5,3220.8594080338266,106,840,76,33.05631817169993,0.6487814465408805,37.5973520249221,134138.49987635683,1265.4575460033664,0
4981,511.1850516893123,0,0,946,0.0,0.0,1.0,946,25900,18700,7200,0.722007722007722,331,187,144,173.75981574902906,0.4193485473039737,0.9440724303525574,0.12172611363625163,17615331.848052915,397067.3632551334,18012399.211308047,4980,6,3221.8594080338266,81,865,81,32.91295686957641,0.6576646090534979,37.47459349593495,134199.06349353772,1656.7785616486137,0
4982,511.0974519714235,0,0,946,0.0,0.0,1.0,946,26350,19200,7150,0.7286527514231499,335,192,143,173.56727375069585,0.4193083707134095,0.9439812162046468,0.12232855161950243,17638864.24889689,396755.91594792996,18035620.16484482,4981,7,3222.8594080338266,83,863,83,32.71677050882656,0.6588855421686747,37.276785714285715,134277.1653951709,1617.7971734357939,0
4983,510.76796658725596,0,0,946,0.0,0.0,1.0,946,24400,17300,7100,0.7090163934426229,315,173,142,174.44889464630836,0.4193404840207166,0.9443164037762692,0.12338790788216696,17643053.685459223,401962.24272276607,18045015.928181987,4982,8,3223.8594080338266,85,861,80,32.57565284178189,0.6593137254901961,37.160852713178286,134249.81679921784,1579.4096094025629,0
4984,510.96012233403303,1,0,947,0.0010559662090813093,0.0,1.0,947,24950,18400,6550,0.7374749498997996,315,184,131,172.62707702636285,0.41952699374085145,0.9435532507065771,0.12293594227278778,17679484.848729502,396041.5585536111,18075526.407283112,4983,0,3221.454065469905,90,857,71,32.39795918367347,0.6598379629629629,36.939102564102576,134413.62833514725,1493.484759279414,0
4985,511.04218301126815,1,0,948,0.0010548523206751054,0.0,1.0,948,24750,17600,7150,0.7111111111111111,319,176,143,180.0850541776517,0.4197283978051943,0.9455155323824023,0.12213198933625995,17466296.68433303,414733.7969362115,17881030.48126924,4984,0,3219.0548523206753,111,837,79,33.842660939371335,0.6380442942942943,38.550967261904766,133611.48443666092,1203.7070669969453,8
4986,510.85843070311506,1,0,949,0.001053740779768177,0.0,1.0,949,27450,20000,7450,0.7285974499089253,349,200,149,178.0450978936161,0.4199207489859042,0.9444516091827488,0.12172470978441143,17496059.38282999,405767.5211136998,17901826.90394369,4985,0,3216.6617492096943,87,862,87,33.621475953565536,0.6472701149425287,38.281250000000014,133701.22991058143,1536.7957460986372,0
4987,510.9922922416359,1,0,950,0.0010526315789473684,0.0,1.0,950,23950,17200,6750,0.7181628392484343,307,172,135,177.16892804715116,0.4202136366997578,0.9437091331858918,0.12167041379489224,17520656.725418046,406873.19414488744,17927529.919562932,4986,0,3214.274736842105,93,857,84,33.49215543142482,0.6468413978494624,38.13164893617022,133812.70897564423,1438.8463330714433,0
4988,510.888208976451,1,0,951,0.0010515247108307045,0.0,1.0,951,25700,18400,7300,0.7159533073929961,330,184,146,174.6078262115169,0.42046945043998013,0.9427519720588826,0.12059283110107177,17542271.032282364,396703.56235201744,17938974.59463438,4987,0,3211.8937960042063,100,851,68,33.3677699502801,0.6467708333333333,37.94348184818482,133881.58520918558,1338.8158520918557,0
4989,511.3021692867404,0,0,951,0.0,0.0,1.0,951,24750,17500,7250,0.7070707070707071,320,175,145,174.31217692924676,0.4205074990314904,0.9425817050468277,0.12067940097554192,17567190.0297048,397485.0273215172,17964675.05702632,4988,1,3212.8937960042063,105,846,68,33.294243986254294,0.6463293650793651,37.863600628930804,134030.9096474422,1276.4848537851638,0
4990,511.2084043747555,0,0,951,0.0,0.0,1.0,951,27550,19800,7750,0.7186932849364791,353,198,155,174.3199803020158,0.4204952312431974,0.9429712441746394,0.12111433854701475,17579702.804079175,395148.6893044718,17974851.493383646,4989,2,3213.8937960042063,109,842,72,33.174604607496235,0.6465978593272171,37.74621212121211,134066.3404427501,1229.9664260802763,0
4991,511.59872849523504,0,0,951,0.0,0.0,1.0,951,23200,16200,7000,0.6982758620689655,302,162,140,176.05515642960856,0.4205791687420444,0.943917515860055,0.12250230712880154,17599719.149127733,406304.26158336794,18006023.410711102,4990,3,3214.8937960042063,110,841,72,33.079093771242505,0.646875,37.697072072072054,134193.84440850423,1219.9440400773112,0
4992,511.6223825766157,1,0,952,0.0010504201680672268,0.0,1.0,952,26450,18100,8350,0.6843100189035917,348,181,167,174.0205946907018,0.42073310988433227,0.9435614260378633,0.12168455016804981,17622287.80172486,396478.2006133694,18018766.002338227,4991,0,3212.515756302521,118,834,81,32.96758271077907,0.6468926553672316,37.53501400560223,134282.96147739113,1137.9911989609418,0
4993,511.7653027045842,0,0,952,0.0,0.0,1.0,952,26650,18500,8150,0.6941838649155723,348,185,163,169.25130546461685,0.4207824461277676,0.9413327700326981,0.11897371178248176,17650371.848683048,380419.69546511123,18030791.54414816,4992,1,3213.515756302521,90,862,90,32.91746571362157,0.6555555555555556,37.36263736263739,134408.68939164496,1493.4298821293885,0
4994,512.1582175261225,0,0,952,0.0,0.0,1.0,952,26950,20100,6850,0.7458256029684601,338,201,137,165.68161957974544,0.42089563874971647,0.9399301373736155,0.11719036295674988,17691209.12692533,368871.6360945978,18060080.763019927,4993,2,3214.515756302521,97,855,89,32.805086002372484,0.6554982817869416,37.15986394557825,134615.73557595722,1387.79108841193,0
4995,512.2329457896068,0,0,952,0.0,0.0,1.0,952,25500,18700,6800,0.7333333333333333,323,187,136,162.70785766291138,0.4208641592809574,0.9383259981726038,0.11549904861310041,17709440.286138564,360393.01787337806,18069833.30401194,4994,3,3215.515756302521,104,848,69,32.765144369828235,0.6548477564102564,37.04365079365082,134694.90536805007,1295.1433208466353,0
4996,511.7776690102428,0,0,952,0.0,0.0,1.0,952,27650,20200,7450,0.7305605786618445,351,202,149,165.39617059850906,0.42101329556533446,0.9400485084698929,0.11805619023021835,17717739.43577209,368039.2508677868,18085778.68663988,4995,4,3216.515756302521,104,848,75,32.51292854270349,0.656650641025641,36.8650793650794,134666.5763177369,1294.8709261320857,0
4997,511.8353709158377,0,0,952,0.0,0.0,1.0,952,24750,17300,7450,0.6989898989898989,322,173,149,164.11933442039287,0.42113990377959803,0.939328396110878,0.11758454471594634,17736034.494995326,367015.2353151574,18103049.730310485,4996,5,3217.515756302521,112,840,79,32.42356199080234,0.6560639880952381,36.74410029498527,134743.68107130003,1203.0685809937502,0
4998,511.4242541463447,0,0,952,0.0,0.0,1.0,952,26750,18800,7950,0.702803738317757,347,188,159,167.06594501642704,0.4210661755501359,0.9401477885031289,0.12030809604813793,17743907.85928613,375730.5469592135,18119638.406245343,4997,6,3218.515756302521,119,833,85,32.179007667128026,0.6563375350140056,36.57986111111113,134719.44805837754,1132.0962021712398,0
4999,511.8489829286105,1,0,953,0.001049317943336831,0.0,1.0,953,25550,17600,7950,0.6888454011741683,335,176,159,163.4911735515482,0.4211621820816469,0.939662441606236,0.11864699721444069,17792022.67033575,365617.7332457856,18157640.403581537,4998,0,3216.137460650577,90,863,90,32.02168533472257,0.6659722222222222,36.33241758241757,134957.98389168456,1499.5331543520506,0
5000,511.73243283722,0,0,953,0.0,0.0,1.0,953,26800,19400,7400,0.7238805970149254,342,194,148,163.8746986209718,0.42101990323936506,0.9393794818936512,0.11943839364198575,17806493.87940471,366206.76359672396,18172700.643001433,4999,1,3217.137460650577,94,859,94,31.872081826620704,0.6661125886524824,36.195175438596486,134997.48466700275,1436.1434539042846,0
