period,mktsize,entries,exits,surviv,entryrate,exitrate,survivrate,firms,totresinv,totinninv,totimiinv,costshareinn,firmsres,firmsinn,firmsimi,hindex,div,gini,pcm,cs,totprofits,ts,maxage,minage,avgage,actfirms,inactfirms,profitablefirms,wmc,avgproxopt,price,totoutput,avgoutput,magtechshock
1,32,40,12,28,1.0,0.3,0.7,40,0,0,0,0,0,0,0,400.84378594387186,0.501829594017094,0.4393923240938167,0.17569694916605236,954691.8402777782,68536.4583333334,1023228.2986111116,0,0,0.0,33,7,28,45.9377221037669,0.516729797979798,55.72916666666667,7816.666666666671,236.86868686868698,0
2,32,31,14,45,0.5254237288135594,0.23728813559322035,0.7627118644067796,59,1450,1100,350,0.7586206896551724,18,11,7,302.83142515939755,0.49872150789012276,0.48437046314393584,0.1493535565950067,995413.4345064551,47038.49379888006,1042451.9283053351,1,0,0.4745762711864407,48,11,35,43.02057586863263,0.5462239583333333,50.57397959183673,7981.6326530612205,166.28401360544208,0
3,32,8,5,48,0.1509433962264151,0.09433962264150944,0.9056603773584906,53,1400,1100,300,0.7857142857142857,17,11,6,286.219716225533,0.4954190856313498,0.38821848893078403,0.14376951943057228,1001531.1979383623,45331.59505298744,1046862.7929913497,2,0,1.320754716981132,48,5,38,42.647704421219565,0.5540364583333333,49.80867346938777,8006.122448979619,166.7942176870754,0
4,32,11,4,55,0.1864406779661017,0.06779661016949153,0.9322033898305084,59,1650,1100,550,0.6666666666666666,22,11,11,258.1296899537386,0.49614017143970385,0.3778290268769384,0.1327493869007372,1009316.4704552921,38656.909516765234,1047973.3799720574,3,0,1.9661016949152543,51,8,43,42.35490774711543,0.5608660130718954,48.83814102564102,8037.179487179484,157.5917546505781,0
5,32,13,10,58,0.19117647058823528,0.14705882352941177,0.8529411764705882,68,1500,1100,400,0.7333333333333333,19,11,8,236.56279305061474,0.4946179031314018,0.39839440789093383,0.12522319752845762,1018737.7566767454,33099.08982111371,1051836.846497859,4,0,2.411764705882353,62,6,42,41.699429919402434,0.5640120967741935,47.6686507936508,8074.603174603179,130.2355350742448,0
6,32,10,3,65,0.14705882352941177,0.04411764705882353,0.9558823529411765,68,2450,1500,950,0.6122448979591837,34,15,19,223.39947424093552,0.4928802677787533,0.37288964486789333,0.1202457381466635,1024118.0514464137,29707.486850755915,1053825.5382971696,5,0,3.0588235294117645,64,4,34,41.35127003230507,0.5694986979166667,47.00320512820512,8095.897435897411,126.49839743589705,0
7,32,3,4,64,0.04411764705882353,0.058823529411764705,0.9411764705882353,68,2300,1200,1100,0.5217391304347826,34,12,22,251.29697005815333,0.49208004097161256,0.45791832571641566,0.13170912499203094,1015516.7188764588,35139.25489941026,1050655.973775869,6,0,3.9411764705882355,61,7,42,41.73689841058131,0.5606215846994536,48.06787634408602,8061.82795698924,132.16111404900394,8
8,32,9,9,64,0.1232876712328767,0.1232876712328767,0.8767123287671232,73,2200,1200,1000,0.5454545454545454,32,12,20,239.41203537011847,0.4904553526128868,0.46527283097896666,0.12830851102689583,1022728.7115154032,32170.712491072118,1054899.4240064754,7,0,4.383561643835616,65,8,37,41.12193593024944,0.5671474358974359,47.17487373737372,8090.404040404013,124.46775446775405,0
9,32,5,2,67,0.07246376811594203,0.028985507246376812,0.9710144927536232,69,1750,1300,450,0.7428571428571429,22,13,9,238.93566721995947,0.4880115089514066,0.43836776647137543,0.12937760782647523,1026029.2806183074,33480.99815034984,1059510.2787686572,8,0,5.0,57,12,41,40.71660756501183,0.5767543859649122,46.76724137931033,8103.448275862036,142.16575922564977,0
10,32,3,2,68,0.04285714285714286,0.02857142857142857,0.9714285714285714,70,2450,1700,750,0.6938775510204082,32,17,15,228.85160819109686,0.48712042788129745,0.4263324934120676,0.12525282933200269,1029448.6435844605,30668.195526889416,1060116.83911135,9,0,5.8,60,10,45,40.540707329114475,0.5788194444444444,46.345628415300546,8116.939890710382,135.28233151183971,0
11,32,9,7,70,0.11688311688311688,0.09090909090909091,0.9090909090909091,77,2800,2000,800,0.7142857142857143,36,20,16,212.3779939033245,0.487468671679198,0.4358754498513546,0.1181459349462192,1034608.0834294481,25745.597846981826,1060353.68127643,10,0,5.9480519480519485,67,10,36,40.310240963855435,0.5808457711442786,45.71078431372548,8137.254901960767,121.45156570090697,0
12,32,1,5,66,0.014084507042253521,0.07042253521126761,0.9295774647887324,71,2350,1700,650,0.723404255319149,30,17,13,223.52489946447525,0.4860663983903421,0.4234364494055911,0.12488136360650753,1035958.596318213,29762.50821827757,1065721.1045364905,11,0,7.197183098591549,64,7,41,39.85716609984467,0.5843098958333333,45.5448717948718,8142.564102564113,127.22756410256427,0
13,32,3,3,66,0.043478260869565216,0.043478260869565216,0.9565217391304348,69,1800,1100,700,0.6111111111111112,25,11,14,220.997013371903,0.48510763000852514,0.4022035552393708,0.12408630892153891,1037525.0657462233,30257.988165680697,1067783.053911904,12,0,7.898550724637682,64,5,41,39.72493182294945,0.5862630208333333,45.352564102564116,8148.717948717978,127.32371794871841,0
14,32,4,0,70,0.05714285714285714,0.0,1.0,70,2400,1700,700,0.7083333333333334,31,17,14,221.4024248136336,0.4828933747412008,0.40898047424590667,0.12574328710766167,1041100.1177431796,29700.418108420075,1070800.5358515996,13,0,8.3,67,3,41,39.266554568019856,0.5889303482587065,44.914215686274524,8162.745098039247,121.83201638864547,0
15,32,4,0,74,0.05405405405405406,0.0,1.0,74,3050,2100,950,0.6885245901639344,40,21,19,208.31242680417085,0.48262603356781436,0.40393725680545445,0.11973189977976964,1044814.8184613463,25679.582078928674,1070494.400540275,14,0,8.797297297297296,68,6,40,39.13631574801601,0.592984068627451,44.459541062801954,8177.2946859903805,120.2543336175056,0
16,32,1,2,73,0.013333333333333334,0.02666666666666667,0.9733333333333334,75,2400,1300,1100,0.5416666666666666,35,13,22,208.68690282980901,0.48225975975975977,0.411328706093806,0.1206646360541316,1046658.6800733999,26284.79165289085,1072943.4717262906,15,0,9.666666666666666,70,5,45,38.89665672383792,0.5941964285714285,44.23415492957747,8184.5070422535355,116.92152917505051,0
17,32,1,2,72,0.013513513513513514,0.02702702702702703,0.972972972972973,74,3200,2300,900,0.71875,41,23,18,208.05843641905767,0.4810371158830063,0.4015408107479743,0.12109057307690964,1048673.5260770917,25637.074829931673,1074310.6009070233,16,0,10.567567567567568,69,5,38,38.661551577152636,0.5972222222222222,43.98809523809522,8192.380952380907,118.73015873015807,0
18,32,1,7,66,0.0136986301369863,0.0958904109589041,0.904109589041096,73,3150,2500,650,0.7936507936507936,38,25,13,212.83627470421052,0.4798880644342973,0.4076177748078853,0.12466124661246615,1050624.9999999998,26972.22222222222,1077597.222222222,17,0,11.493150684931507,63,10,44,38.2960704607046,0.6031746031746033,43.75,8199.999999999998,130.15873015873012,0
19,32,3,0,69,0.043478260869565216,0.0,1.0,69,2450,1800,650,0.7346938775510204,31,18,13,214.37380625458826,0.4778790139244103,0.38005541849701485,0.12612849001763807,1052003.1398138537,28854.38345473482,1080857.5232685886,18,0,12.014492753623188,61,8,44,38.085058751583446,0.6062158469945356,43.58198924731184,8205.37634408604,134.51436629649245,0
20,32,1,1,69,0.014285714285714285,0.014285714285714285,0.9857142857142858,70,3450,2900,550,0.8405797101449275,40,29,11,214.54556508210865,0.477117839889579,0.40172585400664884,0.12354641283721395,1045396.3066539455,27407.028269163875,1072803.3349231093,19,0,12.82857142857143,61,9,46,38.90440822049864,0.59801912568306,44.38844086021504,8179.569892473095,134.09130971267368,8
21,32,2,2,69,0.028169014084507043,0.028169014084507043,0.971830985915493,71,2200,1100,1100,0.5,33,11,22,213.6174850257684,0.47699530516431926,0.4073633609915839,0.12407448595549227,1048050.5208770748,28376.38328994146,1076426.9041670163,20,0,13.450704225352112,62,9,44,38.59691625212653,0.600638440860215,44.064153439153436,8189.947089947088,132.09592080559818,0
22,32,1,3,67,0.014285714285714285,0.04285714285714286,0.9571428571428572,70,2000,1000,1000,0.5,30,10,20,214.43086960347557,0.47609558316080053,0.39972523926312586,0.1253732790051413,1050082.741944512,29034.03110215263,1079116.7730466644,21,0,14.17142857142857,62,8,47,38.32276472613052,0.6031586021505376,43.816137566137556,8197.883597883578,132.22392899812223,0
23,32,2,1,68,0.028985507246376812,0.014492753623188406,0.9855072463768116,69,2200,1400,800,0.6363636363636364,30,14,16,211.44717063171387,0.4752593066211992,0.3831307961118544,0.1245053257505255,1052245.5957276388,28498.87080525829,1080744.4665328972,22,0,14.73913043478261,57,12,48,38.129931484464386,0.6094663742690059,43.55244252873563,8206.321839080458,143.9705585803589,0
24,32,3,1,70,0.04225352112676056,0.014084507042253521,0.9859154929577465,71,2450,1800,650,0.7346938775510204,31,18,13,203.89995110901557,0.47486586183769286,0.37945341373644115,0.12133933534620955,1055470.8526234548,26392.091049382587,1081862.9436728375,23,0,15.140845070422536,59,12,45,37.92275021405072,0.6119350282485876,43.159722222222214,8218.888888888874,139.30320150659108,0
25,32,1,1,70,0.014084507042253521,0.014084507042253521,0.9859154929577465,71,2400,1600,800,0.6666666666666666,32,16,16,203.73169158111625,0.474069416498994,0.3770391935026549,0.12182620937574021,1056935.6775732336,26466.258696885634,1083401.9362701192,24,0,15.816901408450704,60,11,44,37.74527716873744,0.6130208333333333,42.981557377049185,8224.59016393443,137.0765027322405,0
26,32,1,0,71,0.014084507042253521,0.0,1.0,71,2400,1400,1000,0.5833333333333334,34,14,20,201.392910736547,0.47237592219986585,0.37141312224351664,0.12143833940318707,1059460.7035495422,26073.574979766418,1085534.2785293087,25,0,16.47887323943662,61,10,47,37.492382693479605,0.6154371584699454,42.674731182795696,8234.40860215053,134.99030495328736,0
27,32,1,0,72,0.013888888888888888,0.0,1.0,72,2100,1300,800,0.6190476190476191,29,13,16,197.98510289104905,0.47185951356285866,0.368720349563046,0.12003184030860597,1061090.7493141282,25516.03223593958,1086606.7815500677,26,0,17.23611111111111,62,10,48,37.378277153558074,0.6167674731182795,42.47685185185185,8240.740740740735,132.9151732377538,0
28,32,2,1,73,0.02702702702702703,0.013513513513513514,0.9864864864864865,74,2500,1900,600,0.76,31,19,12,192.2871265947685,0.4715576021226706,0.36602642804430485,0.11745766364244373,1063346.3581522284,23593.56315682066,1086939.921309049,27,0,17.743243243243242,65,9,47,37.24618382923145,0.6176282051282052,42.20328282828282,8249.494949494941,126.91530691530679,0
29,32,1,4,70,0.013513513513513514,0.05405405405405406,0.9459459459459459,74,2050,1300,750,0.6341463414634146,28,13,15,191.19319575290513,0.4713223497470073,0.36101037746607534,0.1172171144693527,1064438.7669859622,23852.689908665456,1088291.4568946275,28,0,18.472972972972972,66,8,37,37.13946654611212,0.6183712121212122,42.07089552238805,8253.731343283554,125.05653550429628,0
30,32,2,1,71,0.027777777777777776,0.013888888888888888,0.9861111111111112,72,2250,1700,550,0.7555555555555555,28,17,11,193.5713040933756,0.47003781950965046,0.34950259993173916,0.11934141707620921,1066107.6187780006,24623.568414148172,1090731.1871921488,29,0,19.22222222222222,66,6,43,36.87210142745286,0.6204229797979798,41.868781094527364,8260.199004975126,125.154530378411,0
31,32,1,2,70,0.013888888888888888,0.027777777777777776,0.9722222222222222,72,2500,1800,700,0.72,32,18,14,192.31417184501115,0.46934092983828896,0.345126780795741,0.11913304796658976,1067524.5248221834,24160.018983083395,1091684.5438052667,30,0,19.805555555555557,67,5,45,36.72977701340292,0.6215796019900497,41.697303921568626,8265.6862745098,123.36845185835523,0
32,32,1,2,69,0.014084507042253521,0.028169014084507043,0.971830985915493,71,2250,1400,850,0.6222222222222222,31,14,17,191.12470981643273,0.4685110663983903,0.3325987438002891,0.11881078202483876,1068560.749540857,24395.672635444997,1092956.422176302,31,0,20.690140845070424,65,6,45,36.63277146695983,0.6240384615384615,41.571969696969674,8269.696969696923,127.2261072261065,0
33,32,1,2,68,0.014285714285714285,0.02857142857142857,0.9714285714285714,70,2700,2000,700,0.7407407407407407,34,20,14,190.22207221915582,0.4674301242236025,0.31952767437603136,0.11893052641950756,1070258.1727948633,24017.34548770507,1094275.5182825683,32,0,21.314285714285713,65,5,49,36.44701846992535,0.6261217948717949,41.36679292929291,8276.26262626259,127.32711732711678,0
34,32,1,1,68,0.014492753623188406,0.014492753623188406,0.9855072463768116,69,2100,1500,600,0.7142857142857143,27,15,12,195.8628709767119,0.4660059676044331,0.3321235730921477,0.12335508802965954,1072409.6557015888,26109.04680577197,1098518.7025073608,33,0,21.942028985507246,66,3,48,36.03621186644248,0.6281565656565656,41.10696517412934,8284.57711442784,125.5238956731491,0
35,32,0,2,66,0.0,0.029411764705882353,0.9705882352941176,68,2250,1500,750,0.6666666666666666,30,15,15,195.5429986343006,0.46446078431372545,0.32078347814727604,0.1236410588328683,1073569.1915113477,26135.787789906073,1099704.9793012538,34,1,22.779411764705884,66,2,43,35.90183162275175,0.6295770202020202,40.96703980099502,8289.05472636815,125.59173827830529,0
36,32,0,0,66,0.0,0.0,1.0,66,2050,1500,550,0.7317073170731707,26,15,11,198.37830541900138,0.4633304195804196,0.31151548372450955,0.12580816518634946,1074442.184630396,27379.203971533607,1101821.3886019296,35,2,23.78787878787879,65,1,44,35.72100158353127,0.63125,40.86174242424243,8292.424242424253,127.57575757575773,0
37,32,0,1,65,0.0,0.015151515151515152,0.9848484848484849,66,2100,1600,500,0.7619047619047619,26,16,10,199.6896833513254,0.4623106060606061,0.31669147497865,0.12720829033652303,1075751.3622653312,27663.28977910425,1103414.6520444355,36,3,24.78787878787879,65,1,46,35.5260388134802,0.6328525641025642,40.703914141414145,8297.474747474756,127.65345765345779,0
38,32,0,1,64,0.0,0.015384615384615385,0.9846153846153847,65,1600,900,700,0.5625,23,9,14,205.3614087498386,0.46116786858974357,0.3221239632149644,0.13142460139080236,1077092.536603121,29638.64813415093,1106731.184737272,37,4,25.615384615384617,62,3,46,35.2140687399099,0.6364247311827957,40.54232804232805,8302.645502645522,133.91363713944392,0
39,32,0,3,61,0.0,0.046875,0.953125,64,2000,1200,800,0.6,28,12,16,205.1717839830082,0.45985759755291006,0.3124461173114297,0.13178754662686282,1078163.1512112108,29441.731431749293,1107604.88264296,38,5,26.546875,63,1,46,35.087427111417675,0.6370701058201058,40.41341145833334,8306.77083333335,131.85350529100555,0
40,32,0,0,61,0.0,0.0,1.0,61,1900,1300,600,0.6842105263157895,25,13,12,209.26948455815034,0.45839025500910746,0.29483616260190537,0.13472276808599665,1078817.0929260377,31052.69939383093,1109869.7923198687,39,6,28.081967213114755,60,1,47,34.900697093252646,0.6399305555555556,40.33469945355192,8309.289617486358,138.4881602914393,0
41,32,1,0,62,0.016129032258064516,0.0,1.0,62,2100,1200,900,0.5714285714285714,30,12,18,206.25557870922898,0.4581460426582055,0.29537626759402813,0.13327747653910577,1079895.2958795794,30046.88583940325,1109942.1817189825,40,0,28.612903225806452,61,1,45,34.846555756752664,0.6405396174863388,40.20497311827956,8313.440860215038,136.28591574123013,0
42,32,0,0,62,0.0,0.0,1.0,62,2200,1500,700,0.6818181818181818,29,15,14,205.7431845698652,0.4574134056054997,0.2925171131836677,0.13346133368890487,1081012.9828954213,29882.21073245461,1110895.193627876,41,1,29.612903225806452,61,1,50,34.72269353413913,0.641905737704918,40.07056451612903,8317.74193548387,136.3564251718667,0
43,32,0,0,62,0.0,0.0,1.0,62,2300,1600,700,0.6956521739130435,30,16,14,248.91119628570857,0.45672483694694166,0.41253905693068793,0.15082685243839833,1060931.790361604,38115.56022328895,1099047.350584893,42,2,30.612903225806452,53,9,41,36.08658264039755,0.623624213836478,42.49614197530863,8240.123456790105,155.47402748660573,8
44,32,1,0,63,0.015873015873015872,0.0,1.0,63,1850,1000,850,0.5405405405405406,27,10,17,283.6571314987409,0.4565198839392388,0.49534676001959355,0.1668342325525637,1051897.5482244333,45225.648231980114,1097123.1964564135,43,0,31.11111111111111,46,17,38,36.321743452329514,0.6197916666666667,43.59485815602836,8204.964539007076,178.3687943262408,8
45,32,1,1,63,0.015625,0.015625,0.984375,64,2350,1500,850,0.6382978723404256,32,15,17,280.37881258013545,0.45712425595238093,0.4949114389584053,0.1661483264127171,1054187.0418595646,43964.34220678989,1098151.3840663545,44,0,31.609375,47,17,38,36.119095930560256,0.6214539007092199,43.31597222222221,8213.888888888863,174.7635933806141,0
46,32,1,0,64,0.015625,0.0,1.0,64,2550,2000,550,0.7843137254901961,31,20,11,253.72761349437772,0.4575324487433863,0.4472576530612249,0.1445657332700521,1042100.6944444423,37531.944444444285,1079632.6388888867,45,0,32.359375,50,14,40,38.31632653061225,0.603125,44.79166666666666,8166.66666666665,163.333333333333,8
47,32,2,0,66,0.030303030303030304,0.0,1.0,66,1950,1200,750,0.6153846153846154,27,12,15,247.6089825558659,0.45934343434343433,0.44887950856240955,0.1421578228848041,1044465.0741598035,36573.78686556897,1081038.8610253725,46,0,32.34848484848485,53,13,43,38.17596262740659,0.6031839622641509,44.502314814814795,8175.92592592589,154.26275331935642,0
48,32,2,0,68,0.029411764705882353,0.0,1.0,68,2150,1300,850,0.6046511627906976,30,13,17,240.94656744648842,0.4613056043312847,0.44860806143020526,0.13883977678897608,1045597.5466358385,34636.62795847481,1080234.1745943134,47,0,32.36764705882353,55,13,41,38.2043737417837,0.602840909090909,44.36383928571427,8180.357142857116,148.73376623376575,0
49,32,4,2,70,0.05555555555555555,0.027777777777777776,0.9722222222222222,72,2100,1600,500,0.7619047619047619,26,16,10,232.2048056786414,0.46356611893583727,0.45744803086126873,0.13518848280074666,1048775.1205632675,32206.124614197266,1080981.2451774648,48,0,31.51388888888889,59,13,38,38.030687032390766,0.6036370056497176,43.97569444444443,8192.777777777746,138.86064030131774,0
50,32,1,2,69,0.014084507042253521,0.028169014084507043,0.971830985915493,71,2700,1900,800,0.7037037037037037,35,19,16,236.19815114654622,0.4618628437290409,0.4594265232290837,0.13828038527456832,1050482.6437114167,32724.411651234386,1083207.0553626511,49,0,32.943661971830984,59,12,41,37.71519355421551,0.605755649717514,43.7673611111111,8199.44444444442,138.97363465160035,0
51,32,1,2,68,0.014285714285714285,0.02857142857142857,0.9714285714285714,70,2200,1400,800,0.6363636363636364,30,14,16,242.6028059841362,0.4600457211870255,0.46792485275783546,0.1426848007584575,1051890.8131382419,34838.332571254476,1086729.1457094965,50,0,34.34285714285714,53,17,41,37.37523823853947,0.6124213836477987,43.595679012345684,8204.938271604944,154.81015606801782,0
52,32,1,0,69,0.014492753623188406,0.0,1.0,69,2350,1700,650,0.723404255319149,30,17,13,244.74649520705796,0.45872406933788007,0.46662890776833765,0.14426114554887562,1052559.852260591,35372.066967287654,1087931.9192278786,51,0,35.710144927536234,52,17,41,37.236749680715185,0.6141826923076923,43.514150943396224,8207.54716981132,157.83744557329462,0
53,32,3,1,71,0.041666666666666664,0.013888888888888888,0.9861111111111112,72,2700,1900,800,0.7037037037037037,35,19,16,231.6129726129548,0.4594418362023996,0.4594433577072956,0.13871581966451213,1057410.3456533242,31881.99068569177,1089292.336339016,52,0,35.18055555555556,57,15,40,36.96963345908437,0.6158625730994152,42.92385057471265,8226.436781609207,144.32345230893347,0
54,32,0,1,70,0.0,0.014084507042253521,0.9859154929577465,71,2000,1300,700,0.65,27,13,14,228.87675272102632,0.4591968477531858,0.4436678715127962,0.13774918512504153,1058888.310873302,32270.98361738697,1091159.294490689,53,1,36.225352112676056,57,14,43,36.8562668714512,0.6176900584795322,42.744252873563234,8232.183908046001,144.42427908852633,0
55,32,1,0,71,0.014084507042253521,0.0,1.0,71,1700,1000,700,0.5882352941176471,24,10,14,229.2995949896467,0.45866029510395706,0.44555313709473454,0.13869228830481545,1060388.0734670493,32729.311155569212,1093117.3846226186,54,0,37.183098591549296,56,15,44,36.65909467357611,0.6203497023809523,42.562134502923975,8238.011695906429,147.10735171261481,0
56,32,0,0,71,0.0,0.0,1.0,71,3150,2500,650,0.7936507936507936,38,25,13,279.67540897353274,0.4581405097250168,0.5480362204550724,0.1618973242335454,1047014.3254848776,41214.8319362261,1088229.1574211037,55,1,38.183098591549296,51,20,38,37.0363482119551,0.6082516339869282,44.190705128205124,8185.89743589743,160.50779286073393,8
57,32,0,0,71,0.0,0.0,1.0,71,2500,1600,900,0.64,34,16,18,278.8772782319862,0.4580482897384306,0.5460518274380175,0.16189304680600478,1047887.0062991951,41746.37524227667,1089633.3815414717,56,2,39.183098591549296,52,19,36,36.94720707574943,0.6083733974358974,44.08411949685534,8189.308176100614,157.48669569424257,0
58,32,3,0,74,0.04054054054054054,0.0,1.0,74,2600,1700,900,0.6538461538461539,35,17,18,269.34562245870404,0.4604004689621128,0.5482734803919647,0.15760265946245489,1050319.9626204644,39179.81682256234,1089499.7794430268,57,0,38.554054054054056,55,19,39,36.886222835293545,0.6087121212121211,43.78720238095238,8198.809523809521,149.06926406926402,0
59,32,1,0,75,0.013333333333333334,0.0,1.0,75,2000,1300,700,0.65,27,13,14,268.9785768096544,0.46064564564564564,0.5538368611523337,0.15847826594081965,1052432.667909683,39616.368240466945,1092049.03615015,58,0,39.026666666666664,51,24,38,36.63114439324116,0.6149918300653594,43.529647435897445,8207.051282051298,160.92257415786858,0
60,32,2,1,76,0.025974025974025976,0.012987012987012988,0.987012987012987,77,2550,1900,650,0.7450980392156863,32,19,13,255.60320666950696,0.4615658464342675,0.5441163566163563,0.14549720995033508,1041807.3721759835,35307.86101202291,1077115.2331880063,59,0,38.98701298701299,57,20,39,38.30529748498498,0.5964912280701755,44.82758620689656,8165.517241379331,143.25468844525142,7
61,32,3,0,79,0.0379746835443038,0.0,1.0,79,2150,1200,950,0.5581395348837209,31,12,19,247.01443218625732,0.46163988964621877,0.5397211404449591,0.14160022125586247,1043991.9838820314,33626.217421124915,1077618.2013031563,60,0,38.949367088607595,53,26,42,38.250453103760776,0.6025943396226415,44.56018518518519,8174.074074074084,154.22781271837894,0
62,32,6,4,81,0.07058823529411765,0.047058823529411764,0.9529411764705882,85,2150,1600,550,0.7441860465116279,27,16,11,228.2031393919175,0.46408146591970123,0.5359184137933735,0.13275099971378512,1048525.6399489404,28705.3685538536,1077231.008502794,61,0,37.129411764705885,60,25,39,38.16428746136569,0.6026041666666666,44.00614754098361,8191.80327868854,136.53005464480898,0
63,32,0,4,77,0.0,0.04938271604938271,0.9506172839506173,81,2400,1600,800,0.6666666666666666,32,16,16,263.31363653052057,0.46271862139917697,0.5731695316816914,0.1486036474675708,1039125.3906250016,36123.177083333445,1075248.5677083351,62,1,39.91358024691358,59,22,34,38.44586654404252,0.5916313559322034,45.15625000000001,8155.000000000013,138.22033898305105,8
64,32,4,0,81,0.04938271604938271,0.0,1.0,81,2100,1400,700,0.6666666666666666,28,14,14,258.0268151893336,0.4644804526748971,0.5632954435052955,0.14730282910392706,1042708.4219104277,35509.346655328576,1078217.7685657563,63,0,39.370370370370374,55,26,37,38.13028271640921,0.5992424242424242,44.71726190476189,8169.047619047595,148.52813852813807,0
65,32,4,1,84,0.047058823529411764,0.011764705882352941,0.9882352941176471,85,3350,2200,1150,0.6567164179104478,45,22,23,247.55111143722254,0.4658730158730158,0.5620118635689582,0.1437004012733141,1047871.4302231437,31530.347439010045,1079401.7776621538,64,0,38.470588235294116,61,24,34,37.75084252450979,0.6010928961748634,44.08602150537633,8189.247311827929,134.2499559316054,0
66,32,1,3,82,0.011764705882352941,0.03529411764705882,0.9647058823529412,85,2450,1600,850,0.6530612244897959,33,16,17,244.22933234753714,0.4655695611577964,0.5558124125745421,0.14243739893845403,1049311.3083497693,31804.52005259696,1081115.8284023663,65,0,38.705882352941174,64,21,35,37.6557937004589,0.6009114583333333,43.91025641025641,8194.871794871791,128.04487179487174,0
67,32,1,3,80,0.012048192771084338,0.03614457831325301,0.963855421686747,83,2350,1600,750,0.6808510638297872,31,16,15,270.3978355286581,0.46514717406210204,0.5889847692657426,0.15563732931167307,1045253.7961057745,37576.87280902283,1082830.6689147973,66,0,39.34939759036145,53,30,40,37.4946540880503,0.6041666666666667,44.40586419753085,8179.012345678996,154.32098765432067,8
68,32,2,2,80,0.024390243902439025,0.024390243902439025,0.975609756097561,82,2200,1500,700,0.6818181818181818,29,15,14,264.8200749337361,0.4641705560574125,0.5741480033671627,0.15293415961314347,1046281.0146923751,36815.24334251585,1083096.258034891,67,0,40.65853658536585,54,28,42,37.508332098948316,0.6045524691358024,44.28030303030302,8183.030303030277,151.53759820426438,0
69,32,3,3,80,0.03614457831325301,0.03614457831325301,0.963855421686747,83,2400,1500,900,0.625,33,15,18,254.64896784655446,0.4642900871779802,0.5632646351669084,0.14901071860440285,1050335.4719269664,34493.368763765015,1084828.8406907315,68,0,41.0,58,25,41,37.2608301176038,0.6063218390804598,43.785310734463266,8198.870056497159,141.35982856029585,0
70,32,1,0,81,0.012345679012345678,0.0,1.0,81,2750,2100,650,0.7636363636363637,34,21,13,251.71924261024031,0.4637409979423868,0.5477282051557673,0.14787700774315132,1051540.3778698978,33988.58949829927,1085528.967368197,69,0,42.79012345679013,55,26,41,37.185277898708456,0.6102272727272727,43.638392857142854,8203.571428571426,149.1558441558441,0
71,32,1,1,81,0.012195121951219513,0.012195121951219513,0.9878048780487805,82,2350,1600,750,0.6808510638297872,31,16,15,248.57716203061983,0.46468182274415337,0.5478891153519359,0.14666992952601124,1052874.009310556,33594.08664204364,1086468.0959525998,70,0,43.25609756097561,56,26,43,37.09927334900619,0.6110491071428572,43.47587719298245,8208.771929824554,146.58521303258132,0
72,32,3,0,84,0.03571428571428571,0.0,1.0,84,2150,1400,750,0.6511627906976745,29,14,15,238.45872899926977,0.4646293507362784,0.5403796653796655,0.1423060156931124,1056327.1604938258,31428.08641975299,1087755.2469135788,71,0,42.476190476190474,59,25,41,36.92849099099098,0.612994350282486,43.05555555555555,8222.222222222212,139.3596986817324,0
73,32,1,0,85,0.011764705882352941,0.0,1.0,85,2750,2000,750,0.7272727272727273,35,20,15,236.0716507235694,0.4648225957049486,0.5424514556470041,0.14169003540240063,1058059.554069993,30205.57309862941,1088265.1271686226,72,0,42.96470588235294,60,25,43,36.774243531000316,0.6144097222222222,42.84494535519126,8228.96174863388,137.14936247723134,0
74,32,1,2,84,0.011627906976744186,0.023255813953488372,0.9767441860465116,86,2400,1300,1100,0.5416666666666666,35,13,22,235.6779120803663,0.4646488828089375,0.5488063746571668,0.14226050885053312,1059775.5854472215,30353.139450389954,1090128.7248976114,73,0,43.45348837209303,57,29,43,36.57100488485696,0.6187865497076024,42.636494252873575,8235.632183908068,144.4847751562819,0
75,32,2,1,85,0.023255813953488372,0.011627906976744186,0.9883720930232558,86,2650,2200,450,0.8301886792452831,31,22,9,235.31420950223242,0.4636086411308709,0.5471600543381345,0.14316444654448823,1062143.4675980995,30137.490091161457,1092280.957689261,74,0,44.348837209302324,57,29,40,36.286247037501745,0.6217105263157895,42.34913793103449,8244.827586206911,144.64609800363002,0
76,32,0,2,83,0.0,0.023529411764705882,0.9764705882352941,85,2600,1500,1100,0.5769230769230769,37,15,22,236.68821542503267,0.4625116713352007,0.5431877518130537,0.1444668873413662,1063112.4517220478,30725.23779884459,1093837.6895208925,75,1,45.741176470588236,58,27,44,36.13056506849313,0.6221264367816092,42.2316384180791,8248.587570621477,142.21702707968063,0
77,32,2,2,83,0.023529411764705882,0.023529411764705882,0.9764705882352941,85,2400,1600,800,0.6666666666666666,32,16,16,234.41839865332895,0.4630368814192343,0.5391052252237738,0.1437103812810105,1064423.5422851027,30504.09245427551,1094927.6347393782,76,0,45.71764705882353,58,27,39,36.02645058981904,0.623742816091954,42.072740112994346,8253.672316384176,142.304695110072,0
78,32,2,0,85,0.023529411764705882,0.0,1.0,85,2350,1500,850,0.6382978723404256,32,15,17,231.6334219154169,0.46230158730158727,0.5329443161759926,0.14274305097820073,1065972.985496876,30032.994060006786,1096005.9795568828,77,0,45.8,61,24,42,35.90627644340298,0.6234631147540983,41.88508064516128,8259.67741935482,135.40454785827575,0
79,32,1,0,86,0.011627906976744186,0.0,1.0,86,3200,2300,900,0.71875,41,23,18,229.91680523770754,0.461687756497948,0.5361364126134456,0.14262105641270148,1067928.8552460573,28706.95812386707,1096635.8133699244,78,0,46.25581395348837,56,30,45,35.70845417462452,0.6296502976190477,41.64839181286549,8267.251461988293,147.62949039264808,0
80,32,3,1,88,0.033707865168539325,0.011235955056179775,0.9887640449438202,89,2800,2000,800,0.7142857142857143,36,20,16,221.78631839072872,0.4618605294518216,0.5352404521527481,0.13891710510047267,1070793.7934027766,26897.482638888814,1097691.2760416653,79,0,45.662921348314605,59,30,44,35.56451748204818,0.6308262711864407,41.30208333333333,8278.333333333323,140.31073446327667,0
81,32,1,1,88,0.011235955056179775,0.011235955056179775,0.9887640449438202,89,2550,1700,850,0.6666666666666666,34,17,17,219.5404792010543,0.461881809669731,0.5307913801335027,0.13795006230394619,1071734.0768610595,26707.80256203533,1098441.879423095,80,0,46.58426966292135,60,29,47,35.506565056743185,0.63125,41.18852459016394,8281.967213114758,138.03278688524597,0
82,32,0,2,86,0.0,0.022727272727272728,0.9772727272727273,88,2550,1900,650,0.7450980392156863,32,19,13,225.52598405155243,0.4612313871473354,0.5362296467710608,0.14225773802652847,1072865.7917525165,28241.8226880469,1101107.6144405634,81,1,47.20454545454545,60,28,47,35.211960344676015,0.6326388888888889,41.051912568306015,8286.338797814215,138.10564663023692,0
83,32,0,0,86,0.0,0.0,1.0,86,3150,2400,750,0.7619047619047619,39,24,15,228.1461112842026,0.4600005699954401,0.5293416513715725,0.1446605291855566,1074389.834104937,28673.572530864105,1103063.406635801,82,2,48.98837209302326,59,27,42,34.95606101210416,0.6352401129943503,40.86805555555555,8292.222222222212,140.54613935969851,0
84,32,1,1,86,0.011494252873563218,0.011494252873563218,0.9885057471264368,87,2450,1500,950,0.6122448979591837,34,15,19,251.5017834555553,0.4598870622828121,0.5866685332120067,0.1486382005563811,1053372.329400512,33135.00389739238,1086507.3332979043,83,0,49.41379310344828,55,32,40,36.96202455173744,0.6125,43.41517857142858,8210.714285714299,149.28571428571453,8
85,32,2,1,87,0.022727272727272728,0.011363636363636364,0.9886363636363636,88,2950,2100,850,0.711864406779661,38,21,17,247.32082584525062,0.46046129397422497,0.5833570352496986,0.14686756922284555,1054827.6407242513,31626.168645663976,1086453.8093699152,84,0,49.78409090909091,58,30,43,36.8877352219854,0.6118893678160919,43.2379943502825,8216.38418079098,141.66179622053411,0
86,32,1,1,87,0.011363636363636364,0.011363636363636364,0.9886363636363636,88,3300,2200,1100,0.6666666666666666,44,22,22,242.62476940896738,0.4605510928247997,0.5743647178235458,0.1448145539586171,1056373.963278989,30360.497850040418,1086734.4611290295,85,0,50.27272727272727,60,28,38,36.8156166234687,0.6123263888888889,43.04986338797815,8222.404371584715,137.04007285974524,0
87,32,0,1,86,0.0,0.011494252873563218,0.9885057471264368,87,2700,1900,800,0.7037037037037037,35,19,16,242.2067774019183,0.45990376904570973,0.5683859253805055,0.1450628264655247,1057415.0359732353,31122.617647882093,1088537.6536211174,86,1,51.47126436781609,62,25,39,36.696708043907044,0.612231182795699,42.92328042328042,8226.455026455013,132.6847584912099,0
88,32,0,1,85,0.0,0.011627906976744186,0.9883720930232558,86,2800,2200,600,0.7857142857142857,34,22,12,246.66535236892577,0.4592937756497948,0.5719140863830094,0.14833292952467586,1058639.5651367507,32225.94027322838,1090865.505409979,87,2,53.04651162790697,62,24,40,36.42960832208436,0.6137432795698925,42.774470899470884,8231.216931216903,132.76156340672424,0
89,32,2,1,86,0.022988505747126436,0.011494252873563218,0.9885057471264368,87,2800,2200,600,0.7857142857142857,34,22,12,243.82334460248526,0.4593246012652588,0.5689020849142157,0.1478857017761523,1061220.0806361553,31550.04588400546,1092770.1265201608,88,0,53.28735632183908,58,29,39,36.181760014624885,0.6197916666666667,42.46115819209041,8241.242937853134,142.09039548022645,0
90,32,0,3,83,0.0,0.03488372093023256,0.9651162790697675,86,2800,2000,800,0.7142857142857143,36,20,16,245.46784911470684,0.4585841313269494,0.5658574824577607,0.14953458788306634,1062530.0041495129,32163.39094768444,1094693.3950971973,89,1,54.77906976744186,58,28,42,35.97660888827989,0.6214080459770115,42.30225988700566,8246.327683615842,142.17806351061796,0
91,32,0,0,83,0.0,0.0,1.0,83,2500,1600,900,0.64,34,16,18,245.32190592796545,0.45717626603976885,0.5469636120238512,0.14991894251153523,1063476.5625000058,33078.8194444448,1096555.3819444505,90,2,56.204819277108435,59,24,42,35.862794612794616,0.6218220338983051,42.18750000000002,8250.000000000045,139.83050847457704,0
92,32,2,2,83,0.023529411764705882,0.023529411764705882,0.9764705882352941,85,2650,1900,750,0.7169811320754716,34,19,15,240.61812797579773,0.45720704948646124,0.5486125245946114,0.14795455103192742,1065318.877551026,31617.00680272145,1096935.8843537474,91,0,55.858823529411765,62,23,37,35.75547866205307,0.6219758064516129,41.96428571428574,8257.1428571429,133.17972350230485,0
93,32,0,0,83,0.0,0.0,1.0,83,1750,1000,750,0.5714285714285714,25,10,15,243.87379712596476,0.4568028210402586,0.5454383060438721,0.14977420028370278,1064956.3289438365,33592.98874257247,1098549.317686409,92,1,57.265060240963855,60,23,38,35.71645265201659,0.6229166666666667,42.00819672131149,8255.737704918065,137.5956284153011,0
94,32,0,1,82,0.0,0.012048192771084338,0.9879518072289156,83,2650,1800,850,0.6792452830188679,35,18,17,241.36567232329784,0.456545694975022,0.542896207422088,0.14908792814567715,1066666.9557174265,32241.35738235651,1098908.313099783,93,2,58.265060240963855,61,22,39,35.56903956272774,0.6243169398907105,41.801075268817215,8262.36559139787,135.44861625242407,0
95,32,1,0,83,0.012048192771084338,0.0,1.0,83,2950,2000,950,0.6779661016949152,39,20,19,265.181440026558,0.4566558918601234,0.5843359892493891,0.15556140369240073,1051099.5906207138,36196.4206104253,1087296.011231139,94,0,59.19277108433735,53,30,37,36.89532061413414,0.6114386792452831,43.69212962962963,8201.851851851856,154.75192173305388,8
96,32,1,0,84,0.011904761904761904,0.0,1.0,84,2600,1900,700,0.7307692307692307,33,19,14,261.8372173042242,0.4571739338305603,0.5837447213988589,0.15437794662390605,1052644.909320482,35724.32277318671,1088369.2320936688,95,0,59.476190476190474,54,30,38,36.787762435698625,0.6124614197530864,43.5037878787879,8207.878787878823,151.9977553310893,0
97,32,1,1,84,0.011764705882352941,0.011764705882352941,0.9882352941176471,85,2350,1400,950,0.5957446808510638,33,14,19,258.12893352465983,0.45759803921568626,0.5797265786523309,0.15293779105653915,1054136.1131041008,35070.6061330786,1089206.7192371795,96,0,59.76470588235294,55,30,40,36.69657523492043,0.6134469696969698,43.32217261904764,8213.690476190515,149.33982683982754,0
98,32,3,1,86,0.034482758620689655,0.011494252873563218,0.9885057471264368,87,2300,1400,900,0.6086956521739131,32,14,18,250.94959824689474,0.45922436068787315,0.5764523143833475,0.1497602441150829,1056327.1604938314,33316.975308642235,1089644.1358024736,97,0,58.275862068965516,59,28,36,36.60754504504504,0.612994350282486,43.05555555555557,8222.222222222255,139.35969868173314,0
99,32,2,0,88,0.022727272727272728,0.0,1.0,88,2900,1700,1200,0.5862068965517241,41,17,24,259.4089209321962,0.4598435867293626,0.5911182009368114,0.1495138689736483,1045671.1758584854,33751.28627587034,1079422.4621343557,98,0,58.59090909090909,61,27,36,37.723175166491416,0.5983606557377049,44.35483870967744,8180.645161290359,134.10893707033375,8
100,32,2,1,89,0.022222222222222223,0.011111111111111112,0.9888888888888889,90,2850,2200,650,0.7719298245614035,35,22,13,251.6215912883938,0.4607599875156055,0.5889482385857794,0.1462306409682668,1048224.0295410212,31901.15966796911,1080125.1892089904,99,0,58.266666666666666,63,27,37,37.602537199542155,0.6001984126984127,44.04296875000002,8190.625000000045,130.00992063492134,0
101,32,3,2,90,0.03260869565217391,0.021739130434782608,0.9782608695652174,92,2750,1900,850,0.6909090909090909,36,19,17,242.08167888113812,0.4630265567765568,0.5814254432249886,0.14167280070884827,1050370.0403455389,29705.0685626595,1080075.1089081983,100,0,57.880434782608695,66,26,40,37.578504247572795,0.601010101010101,43.781094527363194,8199.0049751244,124.22734810794546,0
102,32,0,0,90,0.0,0.0,1.0,90,3100,2200,900,0.7096774193548387,40,22,18,242.791375414918,0.46218789013732836,0.5750323836593894,0.1425319255515581,1051325.2532548024,29950.540849234207,1081275.7941040366,101,1,59.15555555555556,60,30,38,37.44101547753868,0.6060763888888889,43.664617486338805,8202.732240437177,136.7122040072863,0
103,32,2,0,92,0.021739130434782608,0.0,1.0,92,3100,2200,900,0.7096774193548387,40,22,18,237.11795174966306,0.4617624223602484,0.5761696619827801,0.14053315359052773,1054231.605529787,28495.447794596475,1082727.0533243835,102,0,58.84782608695652,63,29,41,37.223979138925856,0.6076388888888888,43.31054687500001,8214.062500000015,130.38194444444468,0
104,32,2,0,94,0.02127659574468085,0.0,1.0,94,2250,1200,1050,0.5333333333333333,33,12,21,230.93065736910611,0.4622488179669031,0.573652329892181,0.1376006942556702,1055858.4912811553,27716.019096061886,1083574.510377217,103,0,58.57446808510638,66,28,40,37.18024370070003,0.6077967171717171,43.11256218905472,8220.398009950239,124.55148499924604,0
105,32,2,1,95,0.020833333333333332,0.010416666666666666,0.9895833333333334,96,2950,1900,1050,0.6440677966101694,40,19,21,252.19761116794947,0.46321500365497076,0.62857961772779,0.14318037696752822,1040985.3282047859,30356.80260682626,1071342.1308116121,104,0,58.333333333333336,60,36,38,38.49543080939949,0.5932291666666667,44.9282786885246,8162.2950819672305,136.0382513661205,8
106,32,3,0,98,0.030612244897959183,0.0,1.0,98,2900,1700,1200,0.5862068965517241,41,17,24,246.3521963988218,0.46343099095308227,0.6275258332566778,0.1411752623643428,1043892.3995844838,28933.037088334626,1072825.4366728184,105,0,58.07142857142857,56,42,38,38.27985261501037,0.5998883928571428,44.572368421052616,8173.684210526286,145.95864661654082,0
107,32,2,2,98,0.02,0.02,0.98,100,3450,2600,850,0.7536231884057971,43,26,17,239.77284344246527,0.46416666666666667,0.6256287145242072,0.13847274703243034,1046288.6367538598,26724.32029920273,1073012.9570530625,106,0,57.89,60,40,42,38.147885364496396,0.5998263888888888,44.279371584699454,8183.0601092896195,136.384335154827,0
108,32,3,4,97,0.0297029702970297,0.039603960396039604,0.9603960396039604,101,3650,2300,1350,0.6301369863013698,50,23,27,234.96399598371528,0.46429042904290424,0.621345989417464,0.1370337465627655,1049311.3083497714,25460.07560815262,1074771.383957924,107,0,58.21782178217822,64,37,37,37.893069461827274,0.6009114583333333,43.910256410256416,8194.871794871808,128.044871794872,0
109,32,4,2,99,0.039603960396039604,0.019801980198019802,0.9801980198019802,101,3850,2900,950,0.7532467532467533,48,29,19,227.93965016910818,0.46386551155115513,0.6106863172617241,0.13482096715284428,1053616.710069441,23982.20486111084,1077598.9149305518,108,0,58.24752475247525,59,42,39,37.53615283133752,0.6096398305084746,43.38541666666665,8211.666666666639,139.1807909604515,0
110,32,3,1,101,0.029411764705882353,0.00980392156862745,0.9901960784313726,102,3450,2600,850,0.7536231884057971,43,26,17,222.15934877832288,0.4638136607778425,0.6047209386730688,0.13231765810174423,1055728.629212914,23057.996950514455,1078786.6261634284,109,0,58.588235294117645,61,41,43,37.421716593629384,0.6108265027322404,43.12836021505376,8219.892473118274,134.75233562488975,0
111,32,0,2,99,0.0,0.019801980198019802,0.9801980198019802,101,2800,1900,900,0.6785714285714286,37,19,18,222.21695722465998,0.46374587458745875,0.6012620089229952,0.13283520104203272,1056833.7425208094,23969.27571106473,1080803.018231874,110,1,59.87128712871287,61,40,39,37.282841406811784,0.6121926229508197,42.99395161290322,8224.19354838708,134.8228450555259,0
112,32,3,4,98,0.029411764705882353,0.0392156862745098,0.9607843137254902,102,3150,2300,850,0.7301587301587301,40,23,17,218.9058076535664,0.46346583187730533,0.5991285403050111,0.13200683552442383,1059479.7859690879,22835.25564803835,1082315.0416171262,111,0,59.76470588235294,57,45,44,37.03936348408714,0.618421052631579,42.672413793103466,8234.482758620718,144.46460980036346,0
113,32,2,0,100,0.02,0.0,1.0,100,2800,2200,600,0.7857142857142857,34,22,12,216.92172281487154,0.46320707070707073,0.587520059335177,0.1313665198475853,1060756.949266977,23220.244984568082,1083977.194251545,112,0,61.37,59,41,45,36.93200334884141,0.6184675141242938,42.51736111111112,8239.444444444458,139.6516007532959,0
114,32,0,1,99,0.0,0.01,0.99,100,3000,2000,1000,0.6666666666666666,40,20,20,217.65012753542086,0.4627630471380471,0.5891793005862132,0.13243729162579684,1062187.8906250019,23237.06597222233,1085424.956597224,113,1,62.37,59,41,44,36.73585843272016,0.6202330508474576,42.34375000000001,8245.000000000015,139.74576271186464,0
115,32,0,1,98,0.0,0.010101010101010102,0.98989898989899,99,2750,1700,1050,0.6181818181818182,38,17,21,219.01879901399525,0.461837765409194,0.587788450921938,0.13368737448913334,1063124.3887918456,24018.845367135706,1087143.2341589814,114,2,63.84848484848485,60,39,45,36.58454786353099,0.6206597222222222,42.230191256830615,8248.633879781448,137.4772313296908,0
116,32,1,0,99,0.010101010101010102,0.0,1.0,99,3550,2200,1350,0.6197183098591549,49,22,27,217.1269534296371,0.4616874527588813,0.5840140249778798,0.13330605237553317,1064863.1028514882,22892.096268354908,1087755.199119843,115,0,63.92929292929293,61,38,42,36.418037012916535,0.6220969945355191,42.01948924731184,8255.376344086042,135.33403842764002,0
117,32,1,2,98,0.01,0.02,0.98,100,3250,2300,950,0.7076923076923077,42,23,19,215.02760197622763,0.46143518518518517,0.5842447333034502,0.13288824930996243,1066821.2019890281,22629.200960219543,1089450.4029492477,116,0,64.28,62,38,44,36.23001643508142,0.6238239247311828,41.78240740740741,8262.962962962978,133.27359617682222,0
118,32,0,3,95,0.0,0.030612244897959183,0.9693877551020408,98,3000,1800,1200,0.6,42,18,24,219.80258023357982,0.46002963040886463,0.5845590304282651,0.13676497546165897,1068835.5444837683,24386.562104578905,1093222.1065883471,117,1,66.10204081632654,56,42,44,35.85769756534446,0.6307663690476191,41.53874269005846,8270.760233918094,147.6921470342517,0
119,32,2,1,96,0.020618556701030927,0.010309278350515464,0.9896907216494846,97,3200,2500,700,0.78125,39,25,14,218.22543833227354,0.45912532216494845,0.5771278270376712,0.13694216530885847,1071343.9688201856,24158.901440084428,1095502.87026027,118,0,67.22680412371135,57,40,46,35.588735424764025,0.6330409356725146,41.23563218390804,8280.459770114927,145.271224037104,0
120,32,0,1,95,0.0,0.010416666666666666,0.9895833333333334,96,3700,2500,1200,0.6756756756756757,49,25,24,216.8942598862065,0.45871482090643273,0.57006309686221,0.13634947898506786,1071868.3168948882,23596.417057678038,1095464.7339525663,119,1,68.85416666666667,58,38,44,35.55849249658933,0.6329022988505747,41.17231638418078,8282.485875706201,142.80148061562414,0
121,32,1,1,95,0.010416666666666666,0.010416666666666666,0.9895833333333334,96,3250,2200,1050,0.676923076923077,43,22,21,216.86383322562116,0.4585846125730994,0.5702257003612576,0.13707924589629825,1073477.4539962953,24109.687110983323,1097587.1411072786,120,0,68.72916666666667,58,38,43,35.360859291572964,0.6348778735632183,40.97810734463276,8288.700564971736,142.90863043054716,0
122,32,0,2,93,0.0,0.021052631578947368,0.9789473684210527,95,2900,1800,1100,0.6206896551724138,40,18,22,220.26564003735456,0.45761478163493846,0.5726490821574861,0.13943822268801256,1073916.5190398644,25409.381882600574,1099325.900922465,121,3,70.45263157894736,58,37,44,35.21861228476671,0.6354166666666667,40.92514124293784,8290.395480225967,142.93785310734427,0
123,32,1,1,93,0.010638297872340425,0.010638297872340425,0.9893617021276596,94,3350,2700,650,0.8059701492537313,40,27,13,221.45583137845324,0.45635295126973235,0.5697334580313302,0.14161202622741076,1076861.3419513686,25545.444752231357,1102406.7867036,122,0,70.47872340425532,56,38,45,34.82495069033529,0.640625,40.570175438596486,8301.754385964905,148.24561403508758,0
124,32,0,0,93,0.0,0.0,1.0,93,2700,2000,700,0.7407407407407407,34,20,14,223.52749179702147,0.4554601059685211,0.569555576248846,0.14345960081306386,1077923.5972179496,26889.111606990322,1104812.7088249398,123,1,72.19354838709677,56,37,44,34.64042221126991,0.6419270833333333,40.44225146198831,8305.847953216391,148.3187134502927,0
125,32,0,0,93,0.0,0.0,1.0,93,2500,1500,1000,0.6,35,15,20,222.51179874763687,0.45517278323203986,0.5676017356915972,0.14288235033505592,1078075.3907185122,26876.898874867555,1104952.2895933797,124,2,73.19354838709677,56,37,45,34.648103820520056,0.6421130952380952,40.42397660818714,8306.432748538016,148.32915622389314,0
126,32,0,0,93,0.0,0.0,1.0,93,2650,1800,850,0.6792452830188679,35,18,17,221.6745220107309,0.454822152095995,0.5653458048748194,0.14262343412145717,1078643.4025713457,26571.552137006365,1105214.954708352,125,3,74.19354838709677,57,36,45,34.599948698439064,0.6419956140350878,40.35560344827587,8308.620689655188,145.76527525710856,0
127,32,2,0,95,0.021052631578947368,0.0,1.0,95,3450,2100,1350,0.6086956521739131,48,21,27,217.26853537694646,0.4547918999626726,0.5657499765695078,0.14117067976310357,1081489.9498894212,24544.747487472352,1106034.6973768936,126,0,73.61052631578947,62,33,45,34.36453298566943,0.6418010752688172,40.01322751322751,8319.576719576722,134.18672128349553,0
128,32,1,3,93,0.010416666666666666,0.03125,0.96875,96,2800,2000,800,0.7142857142857143,36,20,16,215.5049187238609,0.4552700109649123,0.5663476680641593,0.14051342742252254,1082493.9346313495,24656.553480360373,1107150.48811171,127,0,73.83333333333333,63,33,43,34.287135243935474,0.6423611111111112,39.89257812500001,8323.437500000015,132.1180555555558,0
129,32,0,0,93,0.0,0.0,1.0,93,3300,2100,1200,0.6363636363636364,45,21,24,257.9465696016665,0.4529131603553062,0.6201337226281671,0.15875389506810733,1065589.6344042234,33073.03815953251,1098662.672563756,128,1,76.55913978494624,58,35,40,35.27470867255023,0.6251795977011494,41.93149717514123,8258.192090395458,142.38262224819755,8
130,32,2,1,94,0.021052631578947368,0.010526315789473684,0.9894736842105263,95,3100,2200,900,0.7096774193548387,40,22,18,253.32992983430174,0.45272489734975735,0.6221064760223431,0.15691991133510946,1067504.4266677867,31986.164301111374,1099490.590968898,129,0,75.92631578947369,62,33,42,35.15621666026541,0.6246639784946236,41.69973544973545,8265.608465608468,133.31626557433012,0
131,32,1,0,95,0.010526315789473684,0.0,1.0,95,2550,1800,750,0.7058823529411765,33,18,15,250.45597875584582,0.45301885031728256,0.6185960800037014,0.15627171032791579,1069657.3921028434,32030.41781450846,1101687.809917352,130,0,75.6,54,41,43,34.96358897353255,0.6334876543209876,41.43939393939392,8273.939393939369,153.2210998877661,0
132,32,0,0,95,0.0,0.0,1.0,95,3450,2500,950,0.7246376811594203,44,25,19,251.06149699494085,0.45289753639417696,0.6205037045464243,0.15010962849406737,1056898.2253086437,30619.29012345695,1087517.5154321005,131,1,76.6,59,36,37,36.53348194181756,0.6137005649717514,42.98611111111112,8224.444444444458,139.3973634651603,8
133,32,0,0,95,0.0,0.0,1.0,95,2350,1100,1250,0.46808510638297873,36,11,25,265.1814400265579,0.45275289287047404,0.6418034247959024,0.15556140369240057,1051099.5906207126,34396.42061042519,1085496.011231138,132,2,77.6,53,42,37,36.895320614134114,0.6114386792452831,43.692129629629626,8201.851851851847,154.7519217330537,8
134,32,3,0,98,0.030612244897959183,0.0,1.0,98,2750,2100,650,0.7636363636363637,34,21,13,260.51600989425316,0.454346816046006,0.6475509062046767,0.1546651527179501,1054752.6093275188,32605.988241511368,1087358.5975690302,133,0,76.1938775510204,57,41,37,36.55830302182431,0.6125730994152047,43.247126436781606,8216.091954022979,144.1419641056663,0
135,32,1,1,98,0.010101010101010102,0.010101010101010102,0.98989898989899,99,3750,2800,950,0.7466666666666667,47,28,19,258.81050207999374,0.454188998831856,0.6493476749076585,0.15450074024906593,1056423.9402789748,31132.722078585335,1087556.6623575601,134,0,76.41414141414141,58,41,36,36.39348861710411,0.6138649425287357,43.043785310734464,8222.598870056498,141.76894603545685,0
136,32,1,1,98,0.010101010101010102,0.010101010101010102,0.98989898989899,99,2500,1800,700,0.72,32,18,14,252.307178089813,0.4544466776609634,0.6394825030654123,0.15144367324873254,1058077.6860041635,31092.119031101978,1089169.8050352654,135,0,77.18181818181819,61,38,38,36.35447972472671,0.6137295081967213,42.84274193548388,8229.032258064526,134.90216816499222,0
137,32,3,0,101,0.0297029702970297,0.0,1.0,101,2400,1600,800,0.6666666666666666,32,16,16,245.2191555447034,0.45574257425742576,0.636210973361341,0.14823813396972765,1060219.362077225,29397.21933214437,1089616.5814093694,136,0,75.53465346534654,57,44,37,36.270247563896824,0.6193347953216375,42.58261494252874,8237.356321839097,144.5150231901596,0
138,32,3,0,104,0.028846153846153848,0.0,1.0,104,3250,2000,1250,0.6153846153846154,45,20,25,235.5417724426396,0.45613369741100324,0.633324102430441,0.14407571070853742,1063753.798307612,26061.691019193237,1089815.4893268053,137,0,74.32692307692308,61,43,41,36.080545057666,0.62073087431694,42.15389784946238,8251.075268817238,135.2635289970039,0
139,32,0,2,102,0.0,0.019230769230769232,0.9807692307692307,104,3350,2700,650,0.8059701492537313,40,27,13,236.32483721588653,0.45545299663928307,0.6343195645528665,0.14504878482463737,1064772.840206048,26176.453626718612,1090949.2938327666,138,1,75.32692307692308,62,42,36,35.933961457932774,0.6213037634408602,42.03042328042331,8255.026455026507,133.14558798429852,0
140,32,1,1,102,0.009708737864077669,0.009708737864077669,0.9902912621359223,103,2950,2100,850,0.711864406779661,38,21,17,231.20431101160372,0.45541833238149626,0.6225524019348756,0.14277242831383552,1066585.8029257131,25769.847140039845,1092355.650065753,139,0,75.66019417475728,64,39,40,35.84145407899366,0.6222330729166667,41.81089743589746,8262.051282051332,129.09455128205207,0
141,32,0,1,101,0.0,0.00980392156862745,0.9901960784313726,102,3250,2200,1050,0.676923076923077,43,22,21,231.5507184307988,0.45492784572574907,0.6204969150826045,0.14378109828252347,1068231.0422437657,25819.933056324902,1094050.9753000906,140,1,77.2843137254902,56,46,42,35.628845745809464,0.6300223214285714,41.61184210526315,8268.421052631566,147.6503759398494,0
142,32,0,1,100,0.0,0.009900990099009901,0.9900990099009901,101,3500,2400,1100,0.6857142857142857,46,24,22,224.7230769746856,0.45408003300330035,0.5991990378131038,0.13577446080455624,1060056.3824651286,23943.82640684359,1084000.208871972,141,2,79.00990099009901,58,43,44,36.81808308754604,0.6183548850574713,42.60240112994351,8236.723163841812,142.01246834210022,8
143,32,1,2,99,0.009900990099009901,0.019801980198019802,0.9801980198019802,101,3350,2200,1150,0.6567164179104478,45,22,23,224.17224020182948,0.4539067656765676,0.598194611274818,0.1366512596021086,1062726.446803001,24096.753660311817,1086823.200463313,142,0,79.42574257425743,62,39,41,36.50103718911057,0.6187836021505376,42.27843915343915,8247.089947089946,133.01757979177333,0
144,32,2,0,101,0.019801980198019802,0.0,1.0,101,2850,1900,950,0.6666666666666666,38,19,19,217.78642888818757,0.45382425742574256,0.5860780388225424,0.1336732700029074,1064779.044389603,23328.8851265177,1088107.9295161206,143,0,79.31683168316832,65,36,42,36.41142806158867,0.6193910256410257,42.029671717171716,8255.050505050503,127.00077700077698,0
145,32,0,0,101,0.0,0.0,1.0,101,2750,1900,850,0.6909090909090909,36,19,17,218.6030851081323,0.45367986798679866,0.5867508115615294,0.13470364935412135,1065951.959621463,23654.077390062008,1089606.037011525,144,1,80.31683168316832,65,36,45,36.24521014226898,0.6208333333333333,41.88762626262625,8259.595959595927,127.07070707070656,0
146,32,3,0,104,0.028846153846153848,0.0,1.0,104,3800,2700,1100,0.7105263157894737,49,27,22,209.61092834170256,0.45528379387602685,0.5794145873320549,0.13031896618857602,1068598.0410682752,20197.965482489053,1088796.0065507642,145,0,78.97115384615384,62,42,45,36.15043186180422,0.626008064516129,41.5674603174603,8269.84126984124,133.38453661034256,0
147,32,0,0,104,0.0,0.0,1.0,104,2300,1700,600,0.7391304347826086,29,17,12,233.21111675169016,0.4550076238486433,0.6225881735380074,0.13834471280390212,1054511.1627640051,26084.74517906345,1080595.9079430685,146,1,79.97115384615384,65,39,41,37.289438091725074,0.6067307692307693,43.276515151515156,8215.151515151525,126.38694638694653,8
148,32,3,1,106,0.028037383177570093,0.009345794392523364,0.9906542056074766,107,3800,2500,1300,0.6578947368421053,51,25,26,228.98185458418325,0.4567977429024863,0.6261654789273499,0.13670642395220584,1056451.2918912948,23181.63521902505,1079632.9271103197,147,0,78.70093457943925,68,39,35,37.15655171063198,0.6073835784313726,43.040458937198075,8222.705314009678,120.92213697073055,0
149,32,1,1,106,0.009345794392523364,0.009345794392523364,0.9906542056074766,107,3300,2400,900,0.7272727272727273,42,24,18,229.92098805931244,0.4562981249632634,0.6303950647358401,0.13800120192397208,1058065.6637261077,23954.300567107788,1082019.9642932154,148,0,79.69158878504673,68,39,40,36.931651403076216,0.609375,42.844202898550726,8228.985507246376,121.01449275362317,0
150,32,2,3,105,0.018518518518518517,0.027777777777777776,0.9722222222222222,108,2900,2100,800,0.7241379310344828,37,21,16,224.91448337435295,0.45685863043729086,0.6261954961862064,0.13581374572989846,1059887.1271163726,23176.793126101496,1083063.9202424742,149,0,79.49074074074075,60,48,41,36.834168214791234,0.6166666666666667,42.622950819672155,8236.06557377054,137.26775956284234,0
151,32,2,0,107,0.018691588785046728,0.0,1.0,107,3300,2500,800,0.7575757575757576,41,25,16,220.06524218801084,0.45642670310938693,0.6163689951381721,0.13384295877336416,1062044.7530864216,22043.827160494,1084088.5802469156,150,0,79.92523364485982,62,45,44,36.691374663072814,0.6179435483870968,42.36111111111112,8244.44444444446,132.9749103942655,0
152,32,0,0,107,0.0,0.0,1.0,107,3850,2800,1050,0.7272727272727273,49,28,21,221.50493997193354,0.45567727620055254,0.6188338036645218,0.13548207429133208,1063736.995108918,21874.599849505183,1085611.5949584232,151,1,80.92523364485982,65,42,44,36.44456091489665,0.6181089743589744,42.155934343434346,8251.010101010106,126.93861693861702,0
153,32,0,0,107,0.0,0.0,1.0,107,3550,2600,950,0.7323943661971831,45,26,19,222.67950852188798,0.4554384882148945,0.6205959673463215,0.1367362601915398,1064909.336419756,22476.69753086439,1087386.0339506203,152,2,81.92523364485982,65,42,39,36.26906684611936,0.6195512820512821,42.0138888888889,8255.55555555558,127.00854700854738,0
154,32,1,1,107,0.009259259259259259,0.009259259259259259,0.9907407407407407,108,2850,2000,850,0.7017543859649122,37,20,17,221.5807757312747,0.4556705751701858,0.6232045301942304,0.13660993759622606,1066107.6187780043,22795.79063637064,1088903.409414375,153,0,82.1574074074074,66,42,40,36.14908952197396,0.6204229797979798,41.86878109452738,8260.199004975155,125.15453037841144,0
155,32,1,2,106,0.009259259259259259,0.018518518518518517,0.9814814814814815,108,2950,2000,950,0.6779661016949152,39,20,19,222.95126904521254,0.4557859553478712,0.6111636745916216,0.13651294281110618,1064057.3005437877,22896.585098612148,1086953.8856423998,154,0,82.82407407407408,73,35,43,36.36758551673944,0.6141552511415524,42.11711711711712,8252.252252252258,113.04455140071586,8
156,32,0,1,105,0.0,0.009433962264150943,0.9905660377358491,106,2450,1300,1150,0.5306122448979592,36,13,23,223.72230712230052,0.4551044474393531,0.604583969517432,0.1373404275200025,1064830.803282876,23995.280801067558,1088826.0840839436,155,1,85.24528301886792,72,34,37,36.251889853789834,0.6155960648148149,42.02340182648402,8255.251141552515,114.65626585489605,0
157,32,0,1,104,0.0,0.009523809523809525,0.9904761904761905,105,2350,1500,850,0.6382978723404256,32,15,17,226.58875220679337,0.4542506105006105,0.6035514271167768,0.1393901008541927,1065451.7186105046,24933.87509130766,1090385.5937018122,156,2,86.98095238095237,73,32,37,36.10103462069971,0.6158675799086758,41.948198198198206,8257.657657657675,113.11859805010515,0
158,32,1,0,105,0.009523809523809525,0.0,1.0,105,4050,2600,1450,0.6419753086419753,55,26,29,228.4251699059252,0.45370115995115995,0.6066563064599688,0.1414614632559039,1067437.8925486677,23715.936393890395,1091153.828942558,157,0,87.9047619047619,75,30,39,35.80774078004775,0.6173611111111111,41.707785087719294,8265.350877192974,110.20467836257298,0
159,32,1,1,105,0.009433962264150943,0.009433962264150943,0.9905660377358491,106,3200,2100,1100,0.65625,43,21,22,227.37446069576333,0.4538653039832285,0.6067987901483505,0.1414073981729257,1068691.2727336523,24198.62035761675,1092889.893091269,158,0,88.06603773584905,65,41,37,35.67983460559797,0.624198717948718,41.55618686868688,8270.202020202041,127.23387723387756,0
160,32,0,1,104,0.0,0.009523809523809525,0.9904761904761905,105,3050,2100,950,0.6885245901639344,40,21,19,241.43780058231337,0.4532203907203907,0.6374626126998475,0.1409767421342105,1049676.1402606273,26636.29972565136,1076312.4399862785,159,1,89.68571428571428,71,34,39,37.681691519807174,0.5974178403755869,43.865740740740726,8196.296296296267,115.44079290558122,8
161,32,1,1,104,0.009523809523809525,0.009523809523809525,0.9904761904761905,105,3550,2600,950,0.7323943661971831,45,26,19,242.39024435062476,0.4530334249084249,0.6386883438963913,0.14210568606597968,1050914.5679721623,26396.287784480548,1077310.8557566428,160,0,90.15238095238095,58,47,41,37.502583356296476,0.6070402298850575,43.714689265536705,8201.129943502792,141.3987921293585,0
162,32,0,1,103,0.0,0.009615384615384616,0.9903846153846154,104,3050,1900,1150,0.6229508196721312,42,19,23,239.04452928925005,0.4527068552402291,0.6290376426717741,0.14083422383637165,1052416.757898308,26464.89370158375,1078881.651599892,161,1,91.51923076923077,61,43,40,37.4008488918004,0.6067281420765027,43.53158602150536,8206.989247311798,134.5408073329803,0
163,32,1,0,104,0.009615384615384616,0.0,1.0,104,2950,2200,750,0.7457627118644068,37,22,15,234.5588415666619,0.45270880009957676,0.6221327951404254,0.1391760744085622,1054580.831074725,25722.251615058984,1080303.082689784,162,0,92.02884615384616,66,38,40,37.24615959143301,0.6062184343434344,43.26803482587064,8215.422885572132,124.47610432685049,0
164,32,2,2,104,0.018867924528301886,0.018867924528301886,0.9811320754716981,106,3150,2300,850,0.7301587301587301,40,23,17,243.45741535479198,0.4530548068283917,0.643133782630299,0.14597588345767024,1057755.1118827118,27153.665123456514,1084908.7770061684,163,0,91.27358490566037,71,35,35,36.622214719783884,0.6073943661971831,42.88194444444443,8227.777777777745,115.88419405320766,0
165,32,1,0,105,0.009523809523809525,0.0,1.0,105,3250,2300,950,0.7076923076923077,42,23,19,249.29915646910223,0.452117673992674,0.6483849969981348,0.150397849799415,1059605.859386669,28581.769386963195,1088187.6287736322,164,0,92.28571428571429,60,45,37,36.24156713116567,0.6163194444444444,42.65710382513663,8234.972677595666,137.24954462659443,0
166,32,1,0,106,0.009433962264150943,0.0,1.0,106,2500,1500,1000,0.6,35,15,20,248.07337452765552,0.4523060796645702,0.650507641706384,0.15041410936550312,1061121.5169383788,28947.199098161924,1090068.7160365407,165,0,92.40566037735849,61,45,36,36.08456202157273,0.6174863387978142,42.47311827956991,8240.860215053799,135.0960690992426,0
167,32,1,0,107,0.009345794392523364,0.0,1.0,107,3550,2700,850,0.7605633802816901,44,27,17,247.79846335276517,0.4527052841944395,0.6524845257126646,0.15136649590142356,1063346.3581522293,27749.118712376337,1091095.4768646057,166,0,92.53271028037383,65,42,36,35.81511979102896,0.6176282051282052,42.20328282828283,8249.49494949495,126.91530691530693,0
168,32,0,0,107,0.0,0.0,1.0,107,3800,3000,800,0.7894736842105263,46,30,16,245.96227735117742,0.4522534238523482,0.6504539702976893,0.15094769499248611,1064740.724721259,27177.210688196657,1091917.9354094556,167,1,93.53271028037383,67,40,33,35.68933095803639,0.6181592039800995,42.034313725490186,8254.901960784297,123.20749195200443,0
169,32,1,0,108,0.009259259259259259,0.0,1.0,108,3150,2100,1050,0.6666666666666666,42,21,21,241.91385830076703,0.4523876485519787,0.6477044529191762,0.14933290475045305,1066480.607290299,26849.287702508318,1093329.8949928072,168,0,93.6574074074074,72,36,34,35.577985961421525,0.6176215277777778,41.8236301369863,8261.643835616444,114.7450532724506,0
170,32,0,1,107,0.0,0.009259259259259259,0.9907407407407407,108,2900,1800,1100,0.6206896551724138,40,18,22,239.250951884079,0.45219835294796357,0.6449727768417937,0.14822082622052374,1067548.160493833,26582.38271604971,1094130.5432098827,169,1,94.6574074074074,74,34,37,35.514459440083186,0.6179617117117118,41.694444444444464,8265.777777777823,111.6996996997003,0
171,32,2,2,107,0.01834862385321101,0.01834862385321101,0.981651376146789,109,3250,2600,650,0.8,39,26,13,234.87263764966391,0.45213217804960926,0.6432687361549632,0.14688552085363324,1070335.7315063514,25228.515285916015,1095564.2467922673,170,0,94.72477064220183,63,46,39,35.282615421727186,0.6274801587301587,41.357421875000014,8276.56250000003,131.3740079365084,0
172,32,1,0,108,0.009259259259259259,0.0,1.0,108,3950,3000,950,0.759493670886076,49,30,19,231.1814118051963,0.45194956443982925,0.6315024854722384,0.14531023274026167,1071826.220698147,24007.259782165296,1095833.4804803124,171,0,96.13888888888889,65,43,38,35.19390155903815,0.6280448717948718,41.177398989899004,8282.323232323264,127.42035742035792,0
173,32,2,1,109,0.01818181818181818,0.00909090909090909,0.990909090909091,110,3250,2300,950,0.7076923076923077,42,23,19,227.13676947932703,0.4524968723936614,0.6313161924036681,0.14365793687783918,1073651.3724065917,23523.14085509587,1097174.5132616875,172,0,95.37272727272727,68,42,35,35.07330943916702,0.6285232843137255,40.95712560386474,8289.371980676337,121.90252912759318,0
174,32,2,1,110,0.018018018018018018,0.009009009009009009,0.990990990990991,111,3200,2600,600,0.8125,38,26,12,225.39818765283394,0.45287674037674036,0.6339885903806037,0.143786223075168,1076159.2403628114,23112.86848072565,1099272.108843537,173,0,95.49549549549549,69,42,40,34.80916724045597,0.6310386473429952,40.654761904761905,8299.047619047617,120.27605244996546,0
175,32,0,0,110,0.0,0.0,1.0,110,3050,2200,850,0.7213114754098361,39,22,17,225.41668342296458,0.4518678760077843,0.6320910829132631,0.14412338072152847,1076817.9957168028,23496.548248929037,1100314.5439657317,174,1,97.34545454545454,62,48,41,34.72753346080305,0.6360887096774194,40.575396825396815,8301.587301587282,133.89656938044004,0
176,32,0,0,110,0.0,0.0,1.0,110,3600,2300,1300,0.6388888888888888,49,23,26,226.43453777480073,0.45160029190992496,0.6344988790601487,0.14497907798041365,1077229.8201688053,23184.40728143087,1100414.2274502362,175,2,98.34545454545454,62,48,40,34.65040145287706,0.6365927419354839,40.52579365079364,8303.174603174579,133.92217101894482,0
177,32,0,0,110,0.0,0.0,1.0,110,2800,1900,900,0.6785714285714286,37,19,18,226.7172246100679,0.4513778843480678,0.6355176067960329,0.14557193084472175,1078053.7052784048,24082.668808263847,1102136.3740866687,176,3,99.34545454545454,62,48,40,34.54161093063252,0.6376008064516129,40.42658730158729,8306.349206349183,133.97337429595456,0
178,32,0,0,110,0.0,0.0,1.0,110,2950,1800,1150,0.6101694915254238,41,18,23,227.54529854028362,0.4509747706422018,0.6339337951403172,0.14164716789487614,1068970.4183103242,23697.83859303103,1092668.2569033552,177,4,100.34545454545454,64,46,41,35.64090044846754,0.6251627604166667,41.522435897435905,8271.282051282067,129.2387820512823,7
179,32,0,1,109,0.0,0.00909090909090909,0.990909090909091,110,3700,2600,1100,0.7027027027027027,48,26,22,228.86983319744078,0.4503857381150959,0.6363861664976913,0.14317670960491055,1070428.99408284,23297.781065088766,1093726.7751479286,178,5,101.34545454545454,64,46,41,35.42634758364311,0.626953125,41.34615384615385,8276.923076923074,129.32692307692304,0
180,32,0,1,108,0.0,0.009174311926605505,0.9908256880733946,109,3650,2500,1150,0.684931506849315,48,25,23,251.88375706043684,0.44967224487484425,0.6654231223114719,0.15565124474760245,1066793.877551014,28291.609977323875,1095085.4875283379,179,6,101.64220183486239,69,40,36,35.28171584447516,0.6195652173913043,41.78571428571426,8262.857142857094,119.75155279503035,8
181,32,0,0,108,0.0,0.0,1.0,108,3100,2200,900,0.7096774193548387,40,22,18,248.53907962016132,0.4491570035767855,0.6603103103103112,0.14832170880557968,1056327.1604938237,27807.71604938249,1084134.8765432062,180,7,101.92592592592592,65,43,37,36.66948198198195,0.608974358974359,43.05555555555554,8222.222222222195,126.49572649572609,8
182,32,0,0,108,0.0,0.0,1.0,108,3600,2900,700,0.8055555555555556,43,29,14,253.3112231309908,0.4490398205838237,0.6653591828567287,0.1516887206749104,1057365.574941328,28368.513416997997,1085734.0883583261,181,8,102.92592592592592,65,43,37,36.41740340536998,0.6102564102564103,42.92929292929291,8226.26262626259,126.55788655788601,0
183,32,0,1,107,0.0,0.009259259259259259,0.9907407407407407,108,2450,1800,650,0.7346938775510204,31,18,13,254.689139907257,0.44883610245759775,0.6661773631484555,0.1528416263907524,1058014.8430325957,29842.978076216496,1087857.8211088122,182,9,103.92592592592592,65,43,37,36.301057202479576,0.6110576923076922,42.850378787878775,8228.787878787854,126.59673659673622,0
184,32,1,0,108,0.009259259259259259,0.0,1.0,108,2950,2100,850,0.711864406779661,38,21,17,255.45770923604235,0.44892984885196724,0.6674028032079491,0.15421085798385165,1059796.7155612241,29596.64824263036,1089393.3638038544,183,0,104.49074074074075,55,53,37,36.05931386720631,0.6204545454545455,42.63392857142857,8235.714285714283,149.7402597402597,0
185,32,1,1,108,0.009174311926605505,0.009174311926605505,0.9908256880733946,109,3750,2700,1050,0.72,48,27,21,250.00742227968666,0.4491590214067278,0.6636783651877962,0.15178353240276166,1061511.1049267491,27527.13101279993,1089038.235939549,184,0,104.5229357798165,58,51,38,35.98630246532776,0.6201508620689655,42.425847457627135,8242.372881355963,142.10987726475798,0
186,32,0,0,108,0.0,0.0,1.0,108,3800,2700,1100,0.7105263157894737,49,27,22,250.98138648074652,0.4481131735317872,0.6610135944077533,0.15330646473569198,1063337.9581454527,27975.60700659047,1091313.5651520432,185,1,106.36111111111111,61,47,38,35.73410888077859,0.6202185792349727,42.20430107526882,8249.462365591415,135.237087960515,0
187,32,2,2,108,0.01818181818181818,0.01818181818181818,0.9818181818181818,110,3500,2500,1000,0.7142857142857143,45,25,20,246.4887132675538,0.4491590214067278,0.6608628659476123,0.1519400575813426,1066056.2499999981,27054.166666666555,1093110.4166666646,186,0,105.4090909090909,64,46,37,35.51251008878127,0.62158203125,41.87499999999999,8259.999999999985,129.06249999999977,0
188,32,2,1,109,0.01818181818181818,0.00909090909090909,0.990909090909091,110,3350,2500,850,0.746268656716418,42,25,17,240.84402620470883,0.4492424242424242,0.6539094138984831,0.14961770660153276,1068361.6617191713,26111.704810239557,1094473.366529411,187,0,105.7909090909091,58,52,37,35.37254031156053,0.6285919540229885,41.596045197740104,8268.926553672296,142.56769920124648,0
189,32,1,0,110,0.00909090909090909,0.0,1.0,110,3050,2200,850,0.7213114754098361,39,22,17,239.04108810783123,0.44866034195162635,0.6517105214141152,0.14893785583297234,1069237.7868747753,26068.352804110866,1095306.1396788862,188,0,106.75454545454545,58,52,42,35.31066452670401,0.6296695402298851,41.49011299435026,8272.31638418075,142.62614455484052,0
190,32,1,0,111,0.009009009009009009,0.0,1.0,111,3400,2500,900,0.7352941176470589,43,25,18,233.16645308578256,0.44848143598143597,0.6463557441352539,0.14634187899051404,1071391.9419875103,24362.53179558313,1095754.4737830935,189,0,106.78378378378379,61,50,41,35.19618664242741,0.6301229508196722,41.22983870967741,8280.645161290302,135.7482813326279,0
191,32,0,0,111,0.0,0.0,1.0,111,4000,2500,1500,0.625,55,25,30,234.59622554300896,0.44748839748839747,0.6480055523664934,0.14826705056757114,1073436.296251084,24164.820692274257,1097601.1169433582,190,1,107.78378378378379,63,48,37,34.906633572116796,0.6312830687830688,40.983072916666664,8288.541666666659,131.5641534391533,0
192,32,0,0,111,0.0,0.0,1.0,111,3800,2700,1100,0.7105263157894737,49,27,22,234.8765038260256,0.4472290472290472,0.6471841704718428,0.14935526811236807,1075227.5955578503,24509.139692378296,1099736.7352502286,191,2,108.78378378378379,65,46,38,34.67827245053274,0.6322115384615384,40.76704545454545,8295.454545454539,127.62237762237751,0
193,32,0,1,110,0.0,0.009009009009009009,0.990990990990991,111,3700,2400,1300,0.6486486486486487,50,24,26,231.44787987290496,0.4465738465738465,0.6413401353160386,0.1477705694573165,1076406.2500000019,23926.388888889007,1100332.6388888909,192,3,109.78378378378379,66,45,38,34.62182061579652,0.6330492424242424,40.62500000000001,8300.000000000015,125.75757575757598,0
194,32,0,0,110,0.0,0.0,1.0,110,3550,2400,1150,0.676056338028169,47,24,23,233.39807333591375,0.4453416041145399,0.6415813143085887,0.14944443800165197,1077243.1061394357,24735.293097467784,1101978.3992369035,193,4,111.73636363636363,61,49,37,34.46807821807824,0.6372950819672132,40.52419354838709,8303.225806451594,136.11845584346875,0
195,32,0,0,110,0.0,0.0,1.0,110,3050,2000,1050,0.6557377049180327,41,20,21,220.3111333268245,0.44495239088128996,0.6279656196675718,0.13361376246187606,1061195.0725979288,21708.61782497836,1082903.6904229072,194,5,112.73636363636363,63,47,39,36.790392150666726,0.6162367724867726,42.464192708333336,8241.145833333343,130.81183862433878,8
196,32,1,0,111,0.009009009009009009,0.0,1.0,111,4400,3100,1300,0.7045454545454546,57,31,26,219.12049790837648,0.4451405951405951,0.6290290290290284,0.13390697094400805,1063476.5625000019,20005.902777777894,1083482.4652777798,195,0,112.71171171171171,65,46,42,36.53829966329964,0.6177884615384616,42.18750000000001,8250.000000000015,126.92307692307715,0
197,32,0,0,111,0.0,0.0,1.0,111,3900,2800,1100,0.717948717948718,50,28,22,219.39784124181813,0.44471744471744473,0.6298699115195476,0.13454479997805038,1064518.4842426819,20610.61148097149,1085129.0957236534,196,1,113.71171171171171,65,46,38,36.40211660445859,0.6190705128205128,42.061237373737384,8254.040404040425,126.98523698523731,0
198,32,1,0,112,0.008928571428571428,0.0,1.0,112,4350,3500,850,0.8045977011494253,52,35,17,218.25315870643016,0.4452923906048906,0.6316224313305587,0.1344796105777282,1065933.3368764224,19778.66354875314,1085712.0004251755,197,0,113.6875,69,43,40,36.25654607475736,0.6185084541062802,41.88988095238097,8259.52380952385,119.70324361628766,0
199,32,2,0,114,0.017543859649122806,0.0,1.0,114,3400,2500,900,0.7352941176470589,43,25,18,216.5432721861981,0.4461829814211044,0.634650237348978,0.13415011338516686,1067541.869956845,20033.801943245813,1087575.6719000908,198,0,112.67543859649123,72,42,43,36.10178893676574,0.6189236111111112,41.69520547945207,8265.753424657572,114.80213089802184,0
200,32,1,3,112,0.008695652173913044,0.02608695652173913,0.9739130434782609,115,3900,2900,1000,0.7435897435897436,49,29,20,211.0431841831418,0.4461066615814899,0.6209677419354829,0.13084677419354857,1067777.777777783,18169.444444444736,1085947.2222222278,199,0,112.68695652173913,70,45,46,36.214717741935516,0.6202380952380953,41.666666666666686,8266.666666666708,118.09523809523868,8
201,32,1,0,113,0.008849557522123894,0.0,1.0,113,3900,2700,1200,0.6923076923076923,51,27,24,213.21881899461653,0.4447363569321534,0.6197345516767314,0.13284792465052758,1069235.5399408278,19096.22781065085,1088331.7677514786,200,0,115.38053097345133,64,49,44,35.97847312627861,0.62548828125,41.49038461538461,8272.307692307688,129.25480769230762,0
202,32,2,0,115,0.017391304347826087,0.0,1.0,115,3250,2000,1250,0.6153846153846154,45,20,25,210.35725330652858,0.4455409356725146,0.6202442194114552,0.13216756394993623,1071707.0395100396,18838.26983612041,1090545.30934616,201,0,114.35652173913043,67,48,46,35.747570780309744,0.626710199004975,41.191789215686256,8281.862745098002,123.60989171788063,0
203,32,2,2,115,0.017094017094017096,0.017094017094017096,0.9829059829059829,117,3500,2500,1000,0.7142857142857143,45,25,20,208.42053228835607,0.44627112191767365,0.6235615089730828,0.13195665279556867,1073954.1008491565,17866.817070448666,1091820.9179196053,202,0,113.38461538461539,73,44,40,35.52086163180295,0.6262842465753424,40.9206081081081,8290.540540540514,113.569048500555,0
204,32,0,1,114,0.0,0.008695652173913044,0.991304347826087,115,2900,1800,1100,0.6206896551724138,40,18,22,209.25818779853356,0.4447654462242563,0.6196726731691189,0.13275131762132975,1074537.6922530597,19071.162040418545,1093608.8542934782,203,1,116.31304347826087,73,42,44,35.42730400144845,0.6269977168949772,40.85022522522521,8292.79279279276,113.59990127113369,0
205,32,0,2,112,0.0,0.017543859649122806,0.9824561403508771,114,2750,1700,1050,0.6181818181818182,38,17,21,209.78056978084857,0.4435808363090617,0.6159890422747873,0.13362386596343662,1075723.7924168897,19583.190020005757,1095306.9824368954,204,2,118.21052631578948,75,39,46,35.2677784825739,0.6275,40.70723684210524,8297.368421052572,110.63157894736763,0
206,32,1,2,111,0.008849557522123894,0.017699115044247787,0.9823008849557522,113,3200,2400,800,0.75,40,24,16,213.30740422561712,0.44301451222081756,0.6180269613462337,0.13631897025014575,1076685.1659151316,20132.983581916786,1096818.1494970485,205,0,118.4424778761062,61,52,47,35.05802029360965,0.6366120218579234,40.59139784946235,8301.07526881718,136.08320112815048,0
207,32,0,1,110,0.0,0.009009009009009009,0.990990990990991,111,3100,2100,1000,0.6774193548387096,41,21,20,214.47475827980563,0.44179975429975427,0.6142026779126168,0.13739372217468246,1077382.6137776028,20914.27513296325,1098296.888910566,206,1,119.74774774774775,61,50,47,34.94193104564583,0.6374658469945356,40.50739247311827,8303.763440860203,136.1272695222984,0
208,32,0,0,110,0.0,0.0,1.0,110,3750,2600,1150,0.6933333333333334,49,26,23,213.35235630820196,0.44095252988601613,0.610490387135743,0.13736172286283513,1078839.2639160156,20284.579806857644,1099123.8437228734,207,2,121.47272727272727,63,47,47,34.791953950942286,0.6378968253968254,40.33203125,8309.375,131.89484126984127,0
209,32,0,0,110,0.0,0.0,1.0,110,4100,3000,1100,0.7317073170731707,52,30,22,211.7058257645706,0.43983527939949957,0.6067228673211318,0.13710433466310742,1080539.5635318449,19651.304113759656,1100190.8676456045,208,3,122.47272727272727,66,44,42,34.625835078272985,0.6380997474747474,40.12748756218906,8315.920398009963,125.99879390924185,0
210,32,1,0,111,0.009009009009009009,0.0,1.0,111,3500,2400,1100,0.6857142857142857,46,24,22,210.4696154664992,0.4399570024570025,0.6085776816981765,0.13715838699192656,1082342.9846938772,19860.06235827662,1102203.0470521539,209,0,122.36036036036036,69,42,41,34.43662509059007,0.6385869565217391,39.910714285714285,8322.85714285714,120.62111801242231,0
211,32,0,0,111,0.0,0.0,1.0,111,3050,2300,750,0.7540983606557377,38,23,15,212.14125013809493,0.43964305214305216,0.6117226834412219,0.1387366228779224,1083358.4606228932,20715.003636844587,1104073.4642597379,210,1,123.36036036036036,70,41,43,34.268578033378425,0.6392857142857142,39.7887323943662,8326.760563380289,118.95372233400413,0
212,32,0,0,111,0.0,0.0,1.0,111,4400,3500,900,0.7954545454545454,53,35,18,214.0799999999996,0.4389332514332514,0.6150630630630622,0.14084210526315796,1085069.4444444473,19858.33333333349,1104927.7777777808,211,2,124.36036036036036,72,39,45,34.008333333333326,0.6403356481481481,39.58333333333334,8333.333333333356,115.74074074074105,0
213,32,0,1,110,0.0,0.009009009009009009,0.990990990990991,111,3450,2200,1250,0.6376811594202898,47,22,25,213.65219729959526,0.4383326508326508,0.615529107787991,0.14123987539604138,1086447.747823411,20774.389714733745,1107222.1375381446,212,3,125.36036036036036,62,49,44,33.85059750423012,0.6478494623655914,39.417989417989425,8338.624338624351,134.49394094555404,0
214,32,1,0,111,0.009009009009009009,0.0,1.0,111,2750,1800,950,0.6545454545454545,37,18,19,209.30336421900205,0.4373327873327873,0.6072445301654219,0.13892927101097285,1087608.3210059176,20578.016107823783,1108186.3371137413,213,0,126.28828828828829,64,47,47,33.821864691540135,0.64794921875,39.27884615384615,8343.076923076926,130.36057692307696,0
215,32,0,0,111,0.0,0.0,1.0,111,3000,2300,700,0.7666666666666667,37,23,14,208.47583490254624,0.43681067431067433,0.6061727002006541,0.13887465229481577,1088623.486283287,20190.338039485745,1108813.8243227727,214,1,127.28828828828829,65,46,46,33.7192548556907,0.6485576923076923,39.15719696969697,8346.969696969694,128.41491841491836,0
216,32,0,0,111,0.0,0.0,1.0,111,3400,2300,1100,0.6764705882352942,45,23,22,209.37595746851386,0.4362373737373737,0.6065346976712229,0.14015165765476134,1089998.329249278,20043.888765129657,1110042.2180144077,215,2,128.2882882882883,66,45,49,33.52766857279006,0.6496212121212122,38.99253731343284,8352.238805970164,126.54907281772977,0
217,32,0,0,111,0.0,0.0,1.0,111,3500,2500,1000,0.7142857142857143,45,25,20,211.73653083227245,0.4358961233961234,0.6087631039399519,0.14212243400468377,1090777.5952327927,20491.492784832102,1111269.0880176248,216,3,129.2882882882883,66,45,39,33.37079711007897,0.6505681818181819,38.899253731343286,8355.223880597025,126.59430122116704,0
218,32,0,1,110,0.0,0.009009009009009009,0.990990990990991,111,3500,2400,1100,0.6857142857142857,46,24,22,211.02414017250285,0.4353262353262353,0.6088262404885085,0.14230987388857416,1092101.8395869387,20391.970335928505,1112493.8099228672,217,4,130.2882882882883,67,44,42,33.22760920551154,0.6515858208955223,38.74080882352941,8360.294117647067,124.78050921861293,0
219,32,1,1,110,0.009009009009009009,0.009009009009009009,0.990990990990991,111,3500,2500,1000,0.7142857142857143,45,25,20,208.6533914337248,0.43547979797979797,0.6043037856509372,0.1411081830477665,1092896.0069444408,19907.29166666648,1112803.2986111073,218,0,130.2882882882883,69,42,44,33.192590009299856,0.6514190821256038,38.64583333333332,8363.333333333305,121.20772946859861,0
220,32,0,0,110,0.0,0.0,1.0,110,3250,2100,1150,0.6461538461538462,44,21,23,209.15818487452415,0.4352602863497359,0.6015473763530061,0.14195939080689932,1093907.934623939,20509.9596051563,1114417.8942290952,219,1,131.46363636363637,61,49,46,33.0558991411253,0.6576161202185793,38.52486559139783,8367.204301075222,137.16728362418397,0
221,32,1,1,110,0.009009009009009009,0.009009009009009009,0.990990990990991,111,4000,2800,1200,0.7,52,28,24,205.64605094324034,0.43502252252252255,0.5985360705184337,0.1404430935111735,1095645.3032544327,18863.025969756418,1114508.3292241893,220,0,131.27027027027026,64,47,45,32.93590646498049,0.65771484375,38.31730769230767,8373.846153846114,130.84134615384554,0
222,32,0,0,110,0.0,0.0,1.0,110,2650,1900,750,0.7169811320754716,34,19,15,205.5459632815811,0.4339119405059772,0.5954038424644386,0.14069252170965818,1096277.743501937,20417.092962452676,1116694.8364643897,221,1,131.46363636363637,65,45,46,32.86145864737209,0.6578525641025641,38.24179292929292,8376.262626262613,128.86557886557867,0
223,32,0,1,109,0.0,0.00909090909090909,0.990909090909091,110,3300,2100,1200,0.6363636363636364,45,21,24,204.88039386856843,0.4335887545176536,0.5943260765124088,0.1405454465637696,1096891.4793260011,19646.311663077304,1116537.7909890783,222,2,132.46363636363637,66,44,45,32.804118916137185,0.6579861111111112,38.16853233830844,8378.606965174085,126.94859038142553,0
224,32,0,0,109,0.0,0.0,1.0,109,2450,1800,650,0.7346938775510204,31,18,13,210.01366993113052,0.432544738928531,0.5988266302193326,0.14429634886820855,1097335.6074954045,21841.095615243124,1119176.7031106476,223,3,134.55963302752295,65,44,49,32.615598445127475,0.6591346153846154,38.11553030303029,8380.303030303,128.92773892773846,0
225,32,0,0,109,0.0,0.0,1.0,109,3550,2600,950,0.7323943661971831,45,26,19,210.84928934124554,0.43198196284969986,0.5991410772535517,0.14554469368914125,1098628.4049036289,20979.003684807296,1119607.4085884362,224,4,135.55963302752295,69,40,48,32.43624235712797,0.6583635265700483,37.961309523809526,8385.2380952381,121.52518978605943,0
226,32,0,0,109,0.0,0.0,1.0,109,3100,2200,900,0.7096774193548387,40,22,18,212.60474747999703,0.4317377392683203,0.6034234932380065,0.14721875910407337,1099502.0408163262,21851.870748299294,1121353.9115646256,225,5,136.55963302752295,69,40,39,32.28386126248863,0.6594202898550725,37.857142857142854,8388.571428571426,121.57349896480328,0
227,32,0,1,108,0.0,0.009174311926605505,0.9908256880733946,109,3500,2700,800,0.7714285714285715,43,27,16,213.42807226959624,0.43151829199229813,0.6054964880061713,0.14809228108017505,1100070.7840363542,21657.1973593966,1121727.9813957508,226,6,137.55963302752295,71,38,40,32.19304053556979,0.659037558685446,37.78935185185186,8390.740740740763,118.1794470526868,0
228,32,0,1,107,0.0,0.009259259259259259,0.9907407407407407,108,3100,2100,1000,0.6774193548387096,41,21,20,216.33106611519852,0.4308926820122303,0.6081268230507126,0.15063421239634392,1101042.1489197586,22937.92438271633,1123980.073302475,227,7,138.55555555555554,71,37,40,31.99867637326274,0.6602112676056338,37.67361111111113,8394.444444444487,118.23161189358433,0
229,32,0,0,107,0.0,0.0,1.0,107,3900,2700,1200,0.6923076923076923,51,27,24,260.17324251445405,0.42992858402398165,0.6580736257266908,0.17164676259395129,1085870.8744247193,31202.909270216875,1117073.7836949362,228,8,140.2710280373832,64,43,32,32.70933296423883,0.6458333333333333,39.48717948717948,8336.410256410247,130.2564102564101,8
230,32,2,1,108,0.01834862385321101,0.009174311926605505,0.9908256880733946,109,2950,2000,950,0.6779661016949152,39,20,19,252.5558786534003,0.4306228055272398,0.6568643512450851,0.1679496593045113,1088135.332564399,30212.995001922383,1118348.3275663215,229,0,138.67889908256882,67,42,37,32.62942512531331,0.6467661691542288,39.21568627450981,8345.098039215693,124.55370207784615,0
231,32,0,1,107,0.0,0.009259259259259259,0.9907407407407407,108,3400,2400,1000,0.7058823529411765,44,24,20,251.34278267718045,0.429536964924426,0.647892139277521,0.16797270705789655,1089541.976793785,29769.702458189386,1119311.6792519744,230,1,139.46296296296296,67,41,38,32.48832061442127,0.648476368159204,39.04718137254903,8350.490196078463,124.63418203102184,0
232,32,0,1,106,0.0,0.009345794392523364,0.9906542056074766,107,3100,2300,800,0.7419354838709677,39,23,16,250.3870996917842,0.4287603597249163,0.6439423887343254,0.16777274647797158,1090284.0277777826,30098.611111111375,1120382.638888894,231,2,141.37383177570092,69,38,36,32.42218675179569,0.6482487922705313,38.95833333333335,8353.333333333372,121.0628019323677,0
233,32,0,0,106,0.0,0.0,1.0,106,2650,1800,850,0.6792452830188679,35,18,17,249.8732933369639,0.4279836777478287,0.640832664690238,0.16803908177904459,1091313.7308790188,30688.031199718112,1122001.762078737,232,3,143.53773584905662,70,36,34,32.309280377506894,0.6489583333333333,38.83509389671363,8357.276995305197,119.38967136150282,0
234,32,0,0,106,0.0,0.0,1.0,106,2850,2100,750,0.7368421052631579,36,21,15,248.86893143537532,0.42743523510032944,0.6397946978260924,0.16794644941010303,1092294.8523496273,30317.650543322845,1122612.50289295,233,4,144.53773584905662,70,36,35,32.21521889681247,0.6501488095238095,38.717723004694854,8361.032863849807,119.44332662642582,0
235,32,0,1,105,0.0,0.009433962264150943,0.9905660377358491,106,2950,2000,950,0.6779661016949152,39,20,19,249.3442361065428,0.42696353698712186,0.6406194958253231,0.16879112036214608,1093170.5057234056,30365.15293676144,1123535.6586601671,234,5,145.53773584905662,72,34,38,32.09547985587949,0.6501736111111112,38.613013698630155,8364.383561643877,116.17199391172052,0
236,32,0,0,105,0.0,0.0,1.0,105,3500,2200,1300,0.6285714285714286,48,22,26,246.57241991043952,0.4259844322344322,0.6371361744014878,0.16776469292745153,1094597.545036535,29479.51310153701,1124077.058138072,235,6,146.96190476190475,62,43,36,31.99317276692585,0.6577620967741935,38.44246031746032,8369.841269841283,134.99743983614974,0
237,32,0,0,105,0.0,0.0,1.0,105,3550,2900,650,0.8169014084507042,42,29,13,245.89124152173721,0.42549603174603173,0.6369975868522564,0.1678807070027184,1095566.490999692,29328.040928305465,1124894.5319279972,236,7,147.96190476190475,62,43,37,31.89240279708495,0.6589381720430108,38.326719576719576,8373.544973544973,135.05717699266086,0
238,32,0,0,105,0.0,0.0,1.0,105,3450,2500,950,0.7246376811594203,44,25,19,247.24456877743032,0.42491987179487184,0.6402638954040827,0.16964319719061455,1096951.443128691,29793.057305226557,1126744.5004339176,237,8,148.96190476190475,62,43,38,31.687557884987793,0.6606182795698925,38.16137566137566,8378.835978835972,135.14251578767696,0
239,32,0,1,104,0.0,0.009523809523809525,0.9904761904761905,105,3500,2100,1400,0.6,49,21,28,249.12778575406765,0.42472909035409034,0.6426734123285858,0.17157516952125426,1097992.8970336893,30208.107842339286,1128201.0048760285,238,9,149.96190476190475,63,42,40,31.510885885885873,0.6612103174603174,38.03710937499999,8382.812499999984,133.06051587301562,0
240,32,0,0,104,0.0,0.0,1.0,104,2850,2100,750,0.7368421052631579,36,21,15,252.76776104105426,0.42313332399800846,0.644057049544853,0.17466536296657192,1098923.3600206662,31904.479453627486,1130827.8394742936,239,10,150.30769230769232,65,39,43,31.30175398976212,0.6610576923076923,37.92613636363638,8386.363636363674,129.0209790209796,0
241,32,0,0,104,0.0,0.0,1.0,104,2850,1600,1250,0.5614035087719298,41,16,25,252.8968321691882,0.42254986619367685,0.6478360469348958,0.17546960179327092,1100056.5024569875,31990.160935697786,1132046.6633926854,240,11,151.30769230769232,67,37,35,31.159872738602928,0.6612251243781094,37.791053921568626,8390.686274509802,125.23412350014631,0
242,32,0,1,103,0.0,0.009615384615384616,0.9903846153846154,104,3500,2400,1100,0.6857142857142857,46,24,22,253.60678979625655,0.42219395693303463,0.6497442035950745,0.17669934426569095,1101213.6107506715,31555.04974048434,1132768.660491156,241,12,152.30769230769232,67,37,35,30.99989295029001,0.6626243781094527,37.6531862745098,8395.098039215674,125.29997073456231,0
243,32,0,0,103,0.0,0.0,1.0,103,2900,2300,600,0.7931034482758621,35,23,12,251.81675175573176,0.42123548448505616,0.6447408831132342,0.1761072744727633,1102242.6620770837,32012.633362168275,1134255.295439252,242,13,153.98058252427185,67,36,37,30.92121901871524,0.6638681592039801,37.530637254901954,8399.019607843122,125.35850160959883,0
244,32,0,0,103,0.0,0.0,1.0,103,3050,2200,850,0.7213114754098361,39,22,17,253.93155304583615,0.42002189225204645,0.6461667427253011,0.1780394212798034,1102944.9601407647,32364.50533052447,1135309.4654712891,243,14,154.98058252427185,58,45,37,30.77998565440567,0.6707974137931034,37.44703389830509,8401.694915254242,144.85680888369382,0
245,32,0,1,102,0.0,0.009708737864077669,0.9902912621359223,103,3150,2200,950,0.6984126984126984,41,22,19,259.11114339362217,0.41927232057871694,0.6543959007551234,0.174900021790695,1092362.1227887622,32858.6397271361,1125220.7625158983,244,15,155.98058252427185,61,42,37,31.939353995198893,0.6557377049180328,38.70967741935484,8361.290322580648,137.0703331570598,8
246,32,0,0,102,0.0,0.0,1.0,102,3000,2200,800,0.7333333333333333,38,22,16,256.4137364358475,0.4187981298129813,0.6476312202406425,0.17360362994922124,1093214.0801279363,32663.021401976443,1125877.1015299128,245,16,156.2549019607843,62,40,38,31.905349273620523,0.6560819892473118,38.607804232804234,8364.550264550267,134.91210104113335,0
247,32,0,0,102,0.0,0.0,1.0,102,3400,2200,1200,0.6470588235294118,46,22,24,256.99668993127216,0.4183410988157639,0.647552420240024,0.1744342568162885,1093917.6296819258,32426.64197714358,1126344.2716590692,246,17,157.2549019607843,57,45,38,31.80385271424319,0.6606359649122807,38.52370689655172,8367.24137931034,146.79370840895334,0
248,32,0,0,102,0.0,0.0,1.0,102,2950,1800,1150,0.6101694915254238,41,18,23,259.4941160782713,0.41791642399534074,0.6511228135356844,0.17679098666024795,1094969.798685428,33477.64400845558,1128447.4426938836,247,18,158.2549019607843,57,45,38,31.609570232047247,0.6619152046783625,38.39798850574713,8371.264367816097,146.86428715466838,0
249,32,0,1,101,0.0,0.00980392156862745,0.9901960784313726,102,2900,2100,800,0.7241379310344828,37,21,16,260.1920106839877,0.41852512457128066,0.6528313768548868,0.177838554394328,1095872.0603778586,33727.43096842396,1129599.4913462827,248,19,159.2549019607843,57,45,39,31.480750754872354,0.6630116959064327,38.29022988505748,8374.712643678173,146.92478322242408,0
250,32,0,1,100,0.0,0.009900990099009901,0.9900990099009901,101,3250,2300,950,0.7076923076923077,42,23,19,261.3470860978405,0.41814768976897687,0.6514956535441334,0.17914154810706542,1096674.3827160506,33872.530864197615,1130546.9135802481,249,20,160.8910891089109,59,42,37,31.35223253757737,0.6624293785310734,38.19444444444445,8377.777777777788,141.99623352165742,0
251,32,0,0,100,0.0,0.0,1.0,100,2700,1900,800,0.7037037037037037,35,19,16,285.20717544961053,0.4178072390572391,0.6699557553700135,0.18896492432980588,1087085.5090082914,39308.91749929144,1126394.426507583,250,21,162.06,55,45,37,31.907350912248162,0.6539772727272728,39.34151785714286,8341.071428571435,151.65584415584428,8
252,32,0,1,99,0.0,0.01,0.99,100,2650,1600,1050,0.6037735849056604,37,16,21,286.6572362836109,0.41756944444444444,0.6692537632874371,0.19033986172370312,1087706.2130190618,39709.771382511346,1127415.9844015732,251,22,163.06,55,45,38,31.793016218401473,0.6547348484848485,39.267113095238095,8343.45238095238,151.6991341991342,0
253,32,0,0,99,0.0,0.0,1.0,99,3150,2100,1050,0.6666666666666666,42,21,21,284.76906627167983,0.41676544355115785,0.6670454455440551,0.19012164172264906,1089258.7480955939,39087.43932468832,1128346.1874202823,252,23,165.05050505050505,55,44,39,31.65093807181388,0.6566287878787879,39.0811011904762,8349.404761904774,151.80735930735952,0
254,32,0,0,99,0.0,0.0,1.0,99,3100,2300,800,0.7419354838709677,39,23,16,280.3428602736141,0.41653353260496123,0.6682640890143887,0.17076089298998917,1062496.7992288272,36672.678345474145,1099169.4775743014,253,24,166.05050505050505,56,43,39,35.08202727938917,0.6229538690476191,42.30628654970762,8246.198830409394,147.2535505430249,8
255,32,1,1,99,0.01,0.01,0.99,100,2600,2200,400,0.8461538461538461,30,22,8,275.00397976233916,0.41789562289562293,0.6634266864144329,0.16838042520155783,1064049.5563271632,35923.572530864345,1099973.1288580275,254,0,165.38,59,41,38,35.02619945244826,0.6225282485875706,42.118055555555564,8252.222222222243,139.8681732580041,0
256,32,0,0,99,0.0,0.0,1.0,99,2950,2400,550,0.8135593220338984,35,24,11,279.4125522782601,0.41722067614924757,0.6654779192507538,0.17160019674064886,1064956.3289438349,36762.43318701677,1101718.7621308516,255,1,165.8080808080808,60,39,31,34.79958189921455,0.6229166666666667,42.008196721311485,8255.737704918054,137.5956284153009,0
257,32,1,0,100,0.01,0.0,1.0,100,3250,2600,650,0.8,39,26,13,277.3264572551947,0.41880681818181814,0.6675011388039287,0.1712203964901805,1066528.143607647,35905.29432593391,1102433.437933581,256,0,165.14,61,39,33,34.65780297607427,0.624146174863388,41.81787634408604,8261.827956989282,135.4398025735948,0
258,32,1,0,101,0.009900990099009901,0.0,1.0,101,3150,2500,650,0.7936507936507936,38,25,13,272.78181860754626,0.42021864686468646,0.6660264882877109,0.16921404218397176,1067934.3491735545,34912.6147842057,1102846.9639577603,257,0,164.4950495049505,54,47,36,34.60034699313343,0.6313657407407407,41.64772727272727,8267.272727272732,153.09764309764319,0
259,32,0,0,101,0.0,0.0,1.0,101,2450,1900,550,0.7755102040816326,30,19,11,268.88375719046314,0.42002062706270626,0.6611987885254373,0.16721873765116643,1068684.4028931968,34820.37550015381,1103504.7783933505,258,1,165.4950495049505,56,45,36,34.60790552962805,0.6305803571428572,41.557017543859644,8270.175438596481,147.68170426065146,0
260,32,1,1,101,0.00980392156862745,0.00980392156862745,0.9901960784313726,102,2900,2000,900,0.6896551724137931,38,20,18,264.8120329313249,0.4213279783860739,0.660240778486243,0.16559088520382156,1070303.2156245876,33385.83407649627,1103689.049701084,259,0,164.86274509803923,57,45,37,34.51228791982037,0.6317616959064327,41.361350574712645,8276.4367816092,145.20064529138946,0
261,32,1,0,102,0.00980392156862745,0.0,1.0,102,3050,2000,1050,0.6557377049180327,41,20,21,263.5417810526551,0.4227880508639099,0.6578524997993744,0.1656742071282987,1071868.3168948905,33046.41705767828,1104914.7339525688,260,0,165.55882352941177,58,44,39,34.35112551159621,0.6329022988505747,41.172316384180796,8282.485875706221,142.8014806156245,0
262,32,0,0,102,0.0,0.0,1.0,102,2900,2200,700,0.7586206896551724,36,22,14,259.8318178645908,0.42300038827412156,0.6532835766857514,0.1638972415182468,1072865.7917525154,32452.933799157887,1105318.7255516732,261,1,166.55882352941177,60,42,40,34.32361733931239,0.6326388888888889,41.05191256830601,8286.338797814205,138.10564663023675,0
263,32,0,1,101,0.0,0.00980392156862745,0.9901960784313726,102,2500,1800,700,0.72,32,18,14,256.76694575239577,0.4224907784896137,0.6497494977238625,0.16253474152306835,1073897.6326742982,32248.28303850159,1106145.9157127999,262,2,167.55882352941177,61,41,37,34.27529182879377,0.6331967213114754,40.92741935483871,8290.322580645166,135.9069275515601,0
264,32,0,1,100,0.0,0.009900990099009901,0.9900990099009901,101,2650,2100,550,0.7924528301886793,32,21,11,254.93057705594407,0.42253712871287125,0.6434629197584529,0.1615258569990454,1074176.223407329,31918.07289860095,1106094.29630593,263,3,167.76237623762376,61,40,37,34.28840833441405,0.6335382513661203,40.89381720430107,8291.397849462355,135.92455490921893,0
265,32,0,0,100,0.0,0.0,1.0,100,3500,2500,1000,0.7142857142857143,45,25,20,256.42613408121343,0.4210248316498317,0.6427987441130292,0.16288736279391014,1074920.760260689,31627.55499945752,1106548.3152601465,264,5,170.41,63,37,37,34.15757456828885,0.6331018518518519,40.804036458333336,8294.270833333341,131.65509259259272,0
266,32,0,1,99,0.0,0.01,0.99,100,2700,2100,600,0.7777777777777778,33,21,12,259.13736190761506,0.42088173400673395,0.6470173236254078,0.16514305799648507,1075865.9532335082,33059.41297743065,1108925.366210939,265,6,171.41,63,37,38,33.970415934387816,0.6342592592592593,40.69010416666667,8297.916666666677,131.71296296296313,0
267,32,1,0,100,0.01,0.0,1.0,100,2600,1600,1000,0.6153846153846154,36,16,20,256.0439142878029,0.42034511784511785,0.6433905460585507,0.16406113159842434,1077449.9655254998,32574.90132448152,1110024.8668499812,266,0,172.04,57,43,39,33.854923639467536,0.6405336257309941,40.49928160919541,8304.022988505756,145.68461383343433,0
268,32,0,0,100,0.0,0.0,1.0,100,2650,1700,950,0.6415094339622641,36,17,19,256.70589752189494,0.4197348484848485,0.6458251487065982,0.16524727811093318,1078792.6286497565,32736.48599550805,1111529.1146452646,267,1,173.04,57,43,39,33.67195785493613,0.6421783625730995,40.33764367816092,8309.195402298858,145.7753579350677,0
269,32,0,0,100,0.0,0.0,1.0,100,2600,2200,400,0.8461538461538461,30,22,8,253.9700254677741,0.41980429292929294,0.6419317563893421,0.16387750064394274,1079485.7799482918,32231.406205113555,1111717.1861534053,268,2,174.04,58,42,38,33.657473491027744,0.6422413793103448,40.2542372881356,8311.864406779669,143.30800701344256,0
270,32,0,0,100,0.0,0.0,1.0,100,3250,2500,750,0.7692307692307693,40,25,15,257.05248939285013,0.4200883838383838,0.6433591467970925,0.16662570217314635,1080806.9250933663,32314.822129656415,1113121.7472230226,269,3,175.04,58,42,40,33.414424971129705,0.6438577586206897,40.09533898305086,8316.949152542391,143.39567504383433,0
271,32,0,0,100,0.0,0.0,1.0,100,2650,1800,850,0.6792452830188679,35,18,17,254.4199898377725,0.41984848484848486,0.6392565348745558,0.16540558348718765,1081656.8313476094,32389.024007883356,1114045.8553554928,270,4,176.04,60,40,39,33.378075878978926,0.6434027777777778,39.99316939890711,8320.218579234994,138.67030965391658,0
272,32,0,0,100,0.0,0.0,1.0,100,3000,2000,1000,0.6666666666666666,40,20,20,256.44780334595583,0.41970538720538725,0.6440747330960865,0.1675856575353804,1083141.2894375855,32553.840877914998,1115695.1303155005,271,5,177.04,62,38,39,33.142422894424705,0.6438172043010753,39.81481481481482,8325.925925925925,134.2891278375149,0
273,32,0,0,100,0.0,0.0,1.0,100,2850,2100,750,0.7368421052631579,36,21,15,255.6932964326727,0.41955176767676766,0.6434137974844354,0.16757384981028914,1083967.4316228582,32582.641163461434,1116550.0727863195,272,6,178.04,62,38,39,33.06031105746834,0.6448252688172043,39.715608465608476,8329.100529100553,134.34033111452504,0
274,32,0,0,100,0.0,0.0,1.0,100,3450,2300,1150,0.6666666666666666,46,23,23,259.35987990936394,0.41921085858585855,0.6493774610913183,0.17055070771351905,1084933.815002443,32827.66079372842,1117761.4757961715,273,7,179.04,63,37,40,32.84586797091487,0.6453373015873016,39.59960937500001,8332.812500000013,132.2668650793653,0
275,32,1,0,101,0.009900990099009901,0.0,1.0,101,3200,2300,900,0.71875,41,23,18,246.88753029703037,0.4195668316831683,0.6272894255141619,0.15174005160634763,1065182.3550922452,29196.048192939874,1094378.403285185,274,0,178.25742574257427,62,39,36,35.61064829648617,0.6218077956989247,41.980820105820115,8256.613756613775,133.1711896228028,8
276,32,2,1,102,0.019417475728155338,0.009708737864077669,0.9902912621359223,103,2500,1500,1000,0.6,35,15,20,241.66371140315542,0.42176692683545913,0.6275589820586569,0.14943089200116869,1066983.053911903,28470.216962524868,1095453.2708744279,275,0,175.7766990291262,64,39,38,35.52216499110506,0.6227213541666667,41.762820512820525,8263.589743589768,129.11858974359012,0
277,32,0,0,102,0.0,0.0,1.0,102,2600,1700,900,0.6538461538461539,35,17,18,241.72109487962987,0.4209558823529412,0.6245416111089139,0.1498011798521361,1067647.3103828726,28614.575362208147,1096261.8857450807,276,1,177.2549019607843,65,37,40,35.438369381479006,0.6229166666666667,41.68244949494951,8266.161616161644,127.1717171717176,0
278,32,1,0,103,0.009708737864077669,0.0,1.0,103,2550,1600,950,0.6274509803921569,35,16,19,241.26755249445858,0.422028682022971,0.6281126816579576,0.1500856722977242,1068766.1666890618,28421.719445190894,1097187.8861342527,277,0,176.5242718446602,60,43,41,35.31150203722054,0.6276041666666667,41.54713114754098,8270.491803278686,137.84153005464478,0
279,32,1,0,104,0.009615384615384616,0.0,1.0,104,3800,2800,1000,0.7368421052631579,48,28,20,235.16915065134046,0.4223962223052029,0.6224713824911983,0.1471594477115826,1070513.2135158575,25750.33663671216,1096263.5501525695,278,0,175.81730769230768,62,42,36,35.252999019858514,0.6283602150537635,41.33597883597883,8277.248677248665,133.50401092336557,0
280,32,1,0,105,0.009523809523809525,0.0,1.0,105,3050,2300,750,0.7540983606557377,38,23,15,257.56026827744563,0.4229967948717949,0.6600209277521507,0.16108044529079465,1070347.5481772153,31085.80033172587,1101433.3485089412,279,0,175.13333333333333,56,49,40,34.69435219859155,0.6326264880952381,41.355994152046776,8276.60818713449,147.79657477025876,8
281,32,1,0,106,0.009433962264150943,0.0,1.0,106,3150,2300,850,0.7301587301587301,40,23,17,251.72298711136835,0.42425314465408803,0.6548557736372809,0.15812241692566725,1071641.4197714329,29601.355859426378,1101242.7756308592,280,0,174.47169811320754,57,49,39,34.685114503816806,0.633406432748538,41.19971264367815,8281.609195402272,145.2913893930223,0
282,32,0,0,106,0.0,0.0,1.0,106,3450,2000,1450,0.5797101449275363,49,20,29,250.53013904361146,0.4240266546870321,0.6543516429640677,0.1579537837138576,1072724.294731104,29099.953342888628,1101824.2480739928,281,1,175.47169811320754,60,46,42,34.5819868539647,0.6324652777777777,41.068989071038246,8285.792349726762,138.0965391621127,0
283,32,0,1,105,0.0,0.009433962264150943,0.9905660377358491,106,2650,1800,850,0.6792452830188679,35,18,17,253.8274457092325,0.423884396525906,0.659348074586078,0.16049639532986018,1073573.4168308992,30650.47963510405,1104223.8964660033,282,2,176.47169811320754,60,46,37,34.39154965170194,0.6335069444444444,40.96653005464481,8289.071038251363,138.15118397085604,0
284,32,0,1,104,0.0,0.009523809523809525,0.9904761904761905,105,3400,2500,900,0.7352941176470589,43,25,18,272.3404611585453,0.42250839438339444,0.6700065008938725,0.16284847983562034,1056928.2856263495,33168.86734379832,1090097.1529701478,283,3,179.10476190476192,56,49,38,35.982828498293536,0.6160714285714286,42.98245614035089,8224.561403508797,146.86716791979993,8
285,32,3,0,107,0.028037383177570093,0.0,1.0,107,3450,2600,850,0.7536231884057971,43,26,17,260.5711072922442,0.42563040028213717,0.6619934378475822,0.15792290205828016,1060990.3528008626,30442.686211141954,1091433.0390120046,284,0,174.09345794392524,56,51,41,35.77904336101058,0.62109375,42.4890350877193,8240.350877192988,147.14912280701765,0
286,32,2,0,109,0.01834862385321101,0.0,1.0,109,3300,2500,800,0.7575757575757576,41,25,16,259.7964668425149,0.4271187280552724,0.6686250088715782,0.15911308139071761,1064132.1190031604,30191.552954131945,1094323.6719572924,285,0,171.88073394495413,58,51,43,35.4081091257616,0.6233836206896552,42.108050847457626,8252.542372881358,142.28521332554067,0
287,32,0,1,108,0.0,0.009174311926605505,0.9908256880733946,109,3500,2600,900,0.7428571428571429,44,26,18,258.98063396546326,0.42735587269226416,0.6676380159778734,0.15902695126970184,1064909.3364197535,29858.179012345747,1094767.5154320993,286,1,172.88073394495413,59,50,37,35.33254822790491,0.6235875706214689,42.01388888888889,8255.55555555556,139.92467043314508,0
288,32,1,1,108,0.009174311926605505,0.009174311926605505,0.9908256880733946,109,3050,2100,950,0.6885245901639344,40,21,19,255.68362216720348,0.42669045191980975,0.6649043283264233,0.15799722316266013,1066789.8461061872,29702.138388724863,1096491.984494912,287,0,173.86238532110093,60,49,40,35.18409827392368,0.6251736111111111,41.78620218579236,8262.84153005467,137.71402550091116,0
289,32,0,0,108,0.0,0.0,1.0,108,2750,1800,950,0.6545454545454545,37,18,19,261.9176905082423,0.4262071651090343,0.6688610575893805,0.1622319483506094,1067490.760030867,31568.94290123476,1099059.702932102,288,1,175.67592592592592,59,49,41,34.936091320517995,0.6267655367231638,41.7013888888889,8265.555555555578,140.09416195856912,0
290,32,1,1,108,0.009174311926605505,0.009174311926605505,0.9908256880733946,109,3400,2400,1000,0.7058823529411765,44,24,20,259.28323879466024,0.4268568071129233,0.6687148163389369,0.16109565164455059,1068404.132231401,30203.856749311,1098607.9889807121,289,0,175.05504587155963,54,55,39,34.8907944884198,0.6319444444444444,41.59090909090907,8269.090909090877,153.13131313131254,0
291,32,1,0,109,0.009174311926605505,0.0,1.0,109,3400,2500,900,0.7352941176470589,43,25,18,253.1787625658491,0.42829383282364936,0.6581854039556327,0.15817804278451747,1070045.061942133,28982.536934441145,1099027.598876574,290,0,174.07339449541286,56,53,44,34.84515228605754,0.6322544642857143,41.39254385964911,8275.438596491203,147.7756892230572,0
292,32,0,0,109,0.0,0.0,1.0,109,3400,2200,1200,0.6470588235294118,46,22,24,255.29831092651932,0.42781600407747195,0.6644923209419411,0.1603325896127216,1071575.876185005,29514.30224392737,1101090.1784289323,291,1,175.07339449541286,58,51,40,34.600701550916455,0.6325431034482758,41.20762711864407,8281.355932203394,142.781998831093,0
293,32,2,1,110,0.018018018018018018,0.009009009009009009,0.990990990990991,111,3500,2500,1000,0.7142857142857143,45,25,20,253.08503818215377,0.42977409227409225,0.6668746837380912,0.1600518916608875,1073619.0780726073,28643.385073418773,1102262.463146026,292,0,172.9009009009009,61,50,35,34.40513252907858,0.6328551912568305,40.96102150537634,8289.24731182794,135.88930019390065,0
294,32,0,0,110,0.0,0.0,1.0,110,2950,2000,950,0.6779661016949152,39,20,19,258.80951849578554,0.4284838059494023,0.6716838990344383,0.16398358234354932,1074176.223407326,30651.406231934026,1104827.62963926,293,1,175.47272727272727,61,49,36,34.18790256343752,0.6335382513661203,40.89381720430106,8291.397849462332,135.92455490921856,0
295,32,1,2,109,0.009009009009009009,0.018018018018018018,0.9819819819819819,111,3300,2200,1100,0.6666666666666666,44,22,22,253.8944849375011,0.42963076713076714,0.668121066743868,0.1618732155186891,1075994.5830183881,29137.81809019875,1105132.401108587,294,0,174.88288288288288,62,49,41,34.09047436878346,0.6350806451612903,40.674603174603156,8298.412698412663,133.84536610343005,0
296,32,0,0,109,0.0,0.0,1.0,109,2950,2200,750,0.7457627118644068,37,22,15,257.02079019996074,0.42791510929890136,0.6658089956341817,0.16445248972205834,1077035.1297061553,30614.08402203878,1107649.2137281941,295,1,177.36697247706422,54,55,39,33.88081855123245,0.642554012345679,40.549242424242436,8302.424242424264,153.74859708193082,0
297,32,0,0,109,0.0,0.0,1.0,109,2750,1900,850,0.6909090909090909,36,19,17,266.73338017028095,0.42784431985502325,0.6740537304843566,0.15743882654348273,1052982.6430175686,31623.123926542292,1084605.7669441109,296,2,178.36697247706422,57,52,39,36.61993605899376,0.6103801169590644,43.46264367816091,8209.195402298827,144.02097197015485,8
298,32,1,0,110,0.00909090909090909,0.0,1.0,110,3000,2200,800,0.7333333333333333,38,22,16,272.033066668704,0.4286158604392549,0.6840130995087688,0.16177403874746346,1055262.875450857,32413.279230106073,1087676.1546809631,297,0,177.73636363636365,58,52,41,36.19881181539024,0.6124281609195402,43.18502824858756,8218.079096045172,141.69101889733057,0
299,32,2,2,110,0.017857142857142856,0.017857142857142856,0.9821428571428571,112,3300,2400,900,0.7272727272727273,42,24,18,268.291082543399,0.4304181413556414,0.6842091136546122,0.16074354522627538,1057524.731905418,31044.891027864214,1088569.6229332823,298,0,175.54464285714286,61,51,35,36.01244935302574,0.6130464480874317,42.90994623655912,8226.88172043007,134.8669134496733,0
300,32,0,1,109,0.0,0.00909090909090909,0.990909090909091,110,3150,2600,550,0.8253968253968254,37,26,11,275.64208243255047,0.42882784264665,0.6879128518041016,0.16507238760471368,1057386.5159628221,33142.044239218,1090528.5602020402,299,2,179.73636363636365,61,49,35,35.84072664096024,0.6128756830601093,42.92674731182793,8226.344086021458,134.85809977084358,0
301,32,2,0,111,0.018018018018018018,0.0,1.0,111,3100,2000,1100,0.6451612903225806,42,20,22,269.9684152560191,0.4289380289380289,0.6808620605837306,0.1630461046511911,1059936.4761807062,31929.874149310952,1091866.350330017,300,0,178.96396396396398,56,55,39,35.66842989680961,0.6197916666666667,42.61695906432749,8236.257309941528,147.07602339181298,0
302,32,1,0,112,0.008928571428571428,0.0,1.0,112,2900,1900,1000,0.6551724137931034,39,19,20,267.68633446737823,0.43007795742170746,0.6820357640964336,0.16237825872513564,1061255.2021403098,31516.702999075264,1092771.905139385,301,0,178.35714285714286,57,55,40,35.56281961878197,0.6206140350877193,42.45689655172414,8241.379310344833,144.58560193587428,0
303,32,1,0,113,0.008849557522123894,0.0,1.0,113,3300,2200,1100,0.6666666666666666,44,22,22,263.483245409501,0.4306323746312684,0.68058086285421,0.16078650820365264,1063046.9184027798,30119.01041666684,1093165.9288194466,302,0,177.76991150442478,59,54,40,35.44802822118947,0.621292372881356,42.23958333333334,8248.33333333335,139.80225988700593,0
304,32,0,0,113,0.0,0.0,1.0,113,3750,2500,1250,0.6666666666666666,50,25,25,280.2236783750149,0.43068505056890016,0.6854089741491993,0.16400574866042247,1050390.99476658,32518.885657096347,1082909.8804236762,303,1,178.76991150442478,72,41,34,36.59860677953518,0.5978009259259259,43.778538812785385,8199.086757990857,113.87620497209524,8
305,32,1,1,113,0.008771929824561403,0.008771929824561403,0.9912280701754386,114,3650,2700,950,0.7397260273972602,46,27,19,283.04131016534853,0.4309275216063759,0.6903012163564541,0.16665167724085272,1052227.172851559,33114.75151909701,1085341.924370656,304,0,178.19298245614036,63,51,32,36.296225776423775,0.6051587301587302,43.554687499999986,8206.249999999973,130.25793650793608,0
306,32,0,0,113,0.0,0.0,1.0,113,2750,1900,850,0.6909090909090909,36,19,17,287.4296366517339,0.43007269279393173,0.6908591793222507,0.16973297872215418,1053123.2782708718,35189.768244575775,1088313.0465154476,305,1,180.73451327433628,64,49,36,36.071376517375626,0.6056315104166667,43.44551282051281,8209.74358974357,128.27724358974328,0
307,32,0,0,113,0.0,0.0,1.0,113,3450,2500,950,0.7246376811594203,44,25,19,284.92587126487626,0.4298126053518752,0.688619867370917,0.1687350516572982,1053992.5932302803,34011.95158657269,1088004.544816853,306,2,181.73451327433628,65,48,37,36.026728979625275,0.6060897435897437,43.33964646464646,8213.131313131296,126.3558663558661,0
308,32,2,1,114,0.017391304347826087,0.008695652173913044,0.991304347826087,115,2750,1600,1150,0.5818181818181818,39,16,23,277.789283580351,0.4311371726417493,0.6839806445349446,0.16564183699966314,1056078.9195780465,32923.48129477897,1089002.4008728254,307,0,179.55652173913043,68,47,31,35.9489462138128,0.6069240196078431,43.08574879227051,8221.25603864729,120.90082409775427,0
309,32,2,0,116,0.017241379310344827,0.0,1.0,116,2850,2000,850,0.7017543859649122,37,20,17,278.8258491705792,0.4317575587206397,0.6858762736507027,0.1673050550637704,1057976.430078907,32948.23530384172,1090924.6653827487,308,0,178.99137931034483,70,46,33,35.68518095890149,0.6081845238095238,42.8550469483568,8228.63849765257,117.55197853789385,0
310,32,2,0,118,0.01694915254237288,0.0,1.0,118,3450,2400,1050,0.6956521739130435,45,24,21,261.2486794300288,0.43364901733545796,0.7042846081046192,0.1540897899632207,1052761.5017361122,27956.510416666693,1080718.012152779,309,0,176.9406779661017,59,59,38,36.788282571911985,0.6085805084745763,43.489583333333336,8208.333333333341,139.12429378531087,8
311,32,0,1,117,0.0,0.00847457627118644,0.9915254237288136,118,3750,2500,1250,0.6666666666666666,50,25,25,259.9566081336543,0.4337244676227727,0.7030436577149932,0.15391849402518196,1053934.0530697173,27445.42432651158,1081379.4773962288,310,1,177.9406779661017,61,57,34,36.67490398882777,0.6086065573770492,43.34677419354838,8212.903225806436,134.6377578001055,0
312,32,4,1,120,0.03305785123966942,0.008264462809917356,0.9917355371900827,121,2950,2300,650,0.7796610169491526,36,23,13,250.75094689030107,0.4369662534435262,0.7019756494321703,0.1504782754211295,1058014.8430325957,25909.64474288319,1083924.487775479,311,0,173.04132231404958,65,56,37,36.402327686736626,0.6110576923076922,42.850378787878775,8228.787878787854,126.59673659673622,0
313,32,3,0,123,0.024390243902439025,0.0,1.0,123,4200,3500,700,0.8333333333333334,49,35,14,247.53784123207038,0.4385079301612688,0.6979972238746768,0.14498644986449863,1050625.000000002,23213.888888888992,1073838.888888891,312,0,171.20325203252034,71,52,40,37.406842818428196,0.5985915492957746,43.75000000000001,8200.000000000016,115.4929577464791,8
314,32,2,0,125,0.016,0.0,1.0,125,3500,2500,1000,0.7142857142857143,45,25,20,246.9843792421121,0.43986021505376344,0.7006385775028994,0.1462124917847466,1053881.4877802948,23558.453010833797,1077439.9407911287,313,0,169.448,62,63,40,37.01439891766523,0.6078629032258065,43.353174603174594,8212.698412698393,132.46287762416765,0
315,32,1,0,126,0.007936507936507936,0.0,1.0,126,3950,3000,950,0.759493670886076,49,30,19,247.22055088589616,0.4404722222222222,0.7042820773086778,0.14747172399675668,1056197.3945579499,23072.74034537274,1079270.1349033227,314,0,169.0952380952381,65,61,35,36.71953385752606,0.6088141025641025,43.07133838383837,8221.717171717146,126.4879564879561,0
316,32,0,2,124,0.0,0.015873015873015872,0.9841269841269842,126,3850,2900,950,0.7532467532467533,48,29,19,246.85994561891252,0.44049470899470905,0.7040214759448369,0.1475722229977373,1056846.3039485745,23128.60422405864,1079974.908172633,315,1,170.0952380952381,65,61,36,36.64793662490788,0.6096153846153847,42.992424242424235,8224.242424242408,126.52680652680627,0
317,32,0,1,123,0.0,0.008064516129032258,0.9919354838709677,124,2800,1600,1200,0.5714285714285714,40,16,24,270.7653128199934,0.4400133315849288,0.7222421974599966,0.1554370748227128,1044434.5489724303,28959.329474506114,1073393.8784469364,316,2,172.29032258064515,61,63,36,37.58815841388835,0.5968237704918034,44.5060483870968,8175.806451612949,134.029613960868,8
318,32,2,0,125,0.016,0.0,1.0,125,2700,1900,800,0.7037037037037037,35,19,16,260.297779581246,0.4411209677419355,0.7233330803673061,0.14441868806492966,1033768.0100689688,26117.50352461519,1059885.5135935838,317,0,171.856,53,72,38,39.19763919455616,0.589819182389937,45.814043209876544,8133.950617283956,153.4707663638482,8
319,32,1,0,126,0.007936507936507936,0.0,1.0,126,3700,2800,900,0.7567567567567568,46,28,18,258.13290979638515,0.44210185185185186,0.7225030373286823,0.14418130147426556,1035881.7019646427,24579.031586593177,1060460.7335512359,318,0,171.484126984127,55,71,39,38.98623498306407,0.590719696969697,45.55431547619049,8142.261904761926,148.04112554112592,0
320,32,5,4,127,0.03816793893129771,0.030534351145038167,0.9694656488549618,131,3750,2900,850,0.7733333333333333,46,29,17,244.48898502976567,0.4460192797024858,0.7167741133447108,0.1379012434342307,1038947.2816582866,20852.233278413834,1059799.5149367005,319,0,165.90076335877862,61,70,37,38.947976418100716,0.5899931693989071,45.17809139784947,8154.301075268836,133.67706680768583,0
321,32,2,0,129,0.015503875968992248,0.0,1.0,129,3600,2100,1500,0.5833333333333334,51,21,30,247.46719129549092,0.44482800387596905,0.7174712425269274,0.1401465867413799,1040211.1196845019,22083.62482853243,1062294.7445130344,320,0,169.45736434108528,62,67,39,38.71330761083375,0.590893817204301,45.02314814814816,8159.25925925928,131.60095579450453,0
322,32,2,2,129,0.015267175572519083,0.015267175572519083,0.9847328244274809,131,4250,3200,1050,0.7529411764705882,53,32,21,235.2097293573809,0.44605353298101386,0.704739115537357,0.13425545033079392,1042658.601518411,18598.68949505825,1061257.2910134692,321,0,167.85496183206106,60,71,39,38.71900573059516,0.5953125,44.723360655737714,8168.852459016409,136.1475409836068,8
323,32,5,1,133,0.03731343283582089,0.007462686567164179,0.9925373134328358,134,3100,2300,800,0.7419354838709677,39,23,16,222.85198309455237,0.4471755414656043,0.6946206581103973,0.1285973232972983,1046040.4600133641,16722.438182223104,1062762.898195587,322,0,165.02985074626866,66,68,43,38.611592484494736,0.5956439393939394,44.30970149253731,8182.089552238791,123.97105382179986,0
324,32,5,3,135,0.036231884057971016,0.021739130434782608,0.9782608695652174,138,4400,3300,1100,0.75,55,33,22,215.34357561214068,0.44994864945872565,0.6937903400742453,0.12578878278498612,1049794.724285187,13213.309917266382,1063008.0342024534,323,0,161.13768115942028,71,67,41,38.33527487527063,0.5975645539906103,43.851273148148124,8196.759259259206,115.44731351069305,0
325,32,4,1,138,0.02877697841726619,0.007194244604316547,0.9928057553956835,139,3600,2500,1100,0.6944444444444444,47,25,22,208.73475863471185,0.45069162061655027,0.6874678692102991,0.12312888032585266,1052793.4062585041,12550.915509516843,1065344.321768021,324,0,160.9208633093525,66,73,45,38.13135139503403,0.6040088383838385,43.48569651741292,8208.457711442752,124.37057138549625,0
326,32,0,2,136,0.0,0.014492753623188406,0.9855072463768116,138,3600,2300,1300,0.6388888888888888,49,23,26,224.8221504056667,0.45069135900419616,0.7092001556646463,0.1292163010234128,1044803.0613994548,15778.974202849791,1060582.0356023046,325,1,161.31884057971016,62,76,40,38.71589561091342,0.596606182795699,44.46097883597883,8177.248677248661,131.89110769755905,8
327,32,1,0,137,0.0072992700729927005,0.0,1.0,137,4350,2900,1450,0.6666666666666666,58,29,29,224.50775759209503,0.45013954486904256,0.7064472086199858,0.13032222395449525,1047867.1967455619,15300.862919132158,1063168.0596646941,326,0,163.3065693430657,64,73,36,38.34108272277539,0.59912109375,44.08653846153846,8189.230769230767,127.95673076923073,0
328,32,1,3,135,0.007246376811594203,0.021739130434782608,0.9782608695652174,138,3350,2200,1150,0.6567164179104478,45,22,23,222.00082892792452,0.45088640290560317,0.7049246596574728,0.12931847208968436,1048943.2240651434,15623.253048158123,1064566.4771133014,327,0,163.1159420289855,65,73,37,38.2709604676488,0.5998397435897436,43.955176767676754,8193.434343434319,126.05283605283567,0
329,32,7,2,140,0.04929577464788732,0.014084507042253521,0.9859154929577465,142,4450,3300,1150,0.7415730337078652,56,33,23,203.94662382557178,0.4529465504611594,0.6871907521947596,0.12070802866578328,1053814.6062288,10134.386215687358,1063948.9924444873,328,0,159.38028169014083,66,76,43,38.12725914258598,0.6052714646464646,43.36131840796018,8212.437810945225,124.43087592341249,0
330,32,3,2,141,0.02097902097902098,0.013986013986013986,0.986013986013986,143,4200,3200,1000,0.7619047619047619,52,32,20,200.93845871314747,0.4526248399487836,0.684653417767479,0.12021005615073914,1057072.0582744014,9681.286027678354,1066753.3443020796,329,0,159.06993006993008,68,75,41,37.80015368651865,0.6081495098039216,42.96497584541061,8225.120772946828,120.95765842568865,0
331,32,0,5,136,0.0,0.03546099290780142,0.9645390070921985,141,4200,3000,1200,0.7142857142857143,54,30,24,206.1770789481272,0.4518785883147585,0.6889029467930867,0.12353694808948276,1057545.058541184,11208.310205209393,1068753.3687463934,330,1,162.2695035460993,67,74,42,37.60681691791296,0.6092972636815921,42.90747549019607,8226.96078431371,122.79045946736879,0
332,32,0,0,136,0.0,0.0,1.0,136,3900,2700,1200,0.6923076923076923,51,27,24,211.03657358159492,0.4505174291938998,0.6857920869603709,0.1265706683414221,1057836.7382369596,13548.448129251614,1071385.1863662112,331,2,166.83823529411765,69,67,43,37.44568310280302,0.6085446859903382,42.8720238095238,8228.095238095222,119.2477570738438,0
333,32,0,4,132,0.0,0.029411764705882353,0.9705882352941176,136,4200,2700,1500,0.6428571428571429,57,27,30,214.08318939351886,0.4503562999273784,0.6888746358180184,0.12902939920404685,1059318.0380927224,13956.436835395145,1073274.4749281176,332,3,167.83823529411765,63,73,44,37.1835267885382,0.6139219576719577,42.69205729166668,8233.854166666692,130.69609788359827,0
334,32,0,1,131,0.0,0.007575757575757576,0.9924242424242424,132,4700,3400,1300,0.723404255319149,60,34,26,210.91605300649022,0.4483419596730665,0.675182081880205,0.1279452844966515,1061264.17266096,13667.530098969884,1074931.7027599297,333,4,172.83333333333334,65,67,44,37.02378763737384,0.6150641025641026,42.455808080808104,8241.414141414196,126.79098679098763,0
335,32,1,2,130,0.007575757575757576,0.015151515151515152,0.9848484848484849,132,4150,2700,1450,0.6506024096385542,56,27,29,209.22560935743098,0.4485756901071787,0.6736606372377076,0.12752687477407632,1062695.455980261,13918.620867768796,1076614.0768480299,334,0,173.74242424242425,65,67,42,36.89008053156957,0.616826923076923,42.28219696969698,8246.969696969729,126.87645687645737,0
336,32,0,0,130,0.0,0.0,1.0,130,3950,2800,1150,0.7088607594936709,51,28,23,209.85666628214818,0.44827320612204336,0.6693447432993136,0.1281341656219193,1063216.161775589,14674.599849505441,1077890.7616250943,335,1,176.8230769230769,65,65,44,36.80936090532463,0.6174679487179487,42.219065656565675,8248.989898989938,126.9075369075375,0
337,32,0,0,130,0.0,0.0,1.0,130,3700,2100,1600,0.5675675675675675,53,21,32,207.90550210956752,0.4483266249254621,0.6660499524593573,0.12718969946466951,1063797.248985178,14533.860238608198,1078331.1092237863,336,2,177.8230769230769,66,64,47,36.78776002411819,0.6175820707070707,42.148631840796035,8251.243781094563,125.01884516809945,0
338,32,2,1,131,0.015151515151515152,0.007575757575757576,0.9924242424242424,132,4400,3000,1400,0.6818181818181818,58,30,28,205.07036821425038,0.44920338885033545,0.6671484667648335,0.12647084222677052,1066201.677494553,12929.274118892234,1079130.951613445,337,0,176.11363636363637,70,62,44,36.56365444728619,0.6183035714285714,41.85739436619721,8260.563380281756,118.00804828973936,0
339,32,0,1,130,0.0,0.007633587786259542,0.9923664122137404,131,3600,2500,1100,0.6944444444444444,47,25,22,207.8132102272718,0.44800107653161086,0.6693858431644668,0.1284238939606742,1066807.7321519153,14539.347902753256,1081347.0800546685,338,1,178.45801526717557,70,61,45,36.417968749999986,0.6190476190476191,41.78403755868546,8262.910798122108,118.04158283031582,0
340,32,1,0,131,0.007633587786259542,0.0,1.0,131,4400,3200,1200,0.7272727272727273,56,32,24,213.45467801789016,0.44802309649637895,0.6746061751152497,0.1301374842774021,1062771.2224016732,14770.697816885684,1077541.920218559,339,0,179.4198473282443,66,65,41,36.77170678248983,0.6163194444444444,42.273009950248756,8247.26368159204,124.95854063018241,8
341,32,0,0,131,0.0,0.0,1.0,131,4600,3300,1300,0.717391304347826,59,33,26,217.37973267863651,0.4477490702681542,0.6794600447242274,0.13318068338346142,1064234.9697231818,15468.622645136336,1079703.5923683182,340,1,180.4198473282443,67,64,45,36.489269026688824,0.6175373134328358,42.09558823529411,8252.941176470575,123.17822651448618,0
342,32,0,1,130,0.0,0.007633587786259542,0.9923664122137404,131,3650,2700,950,0.7397260273972602,46,27,19,214.19491544531058,0.44755578391074574,0.6747025945499225,0.1318989742479023,1065752.5951557138,15805.75740099992,1081558.3525567139,341,2,181.4198473282443,67,64,41,36.38364593225705,0.6194029850746269,41.91176470588237,8258.8235294118,123.2660228270418,0
343,32,1,1,130,0.007633587786259542,0.007633587786259542,0.9923664122137404,131,4700,3300,1400,0.7021276595744681,61,33,28,212.84293255565237,0.44721814445096886,0.67334659701072,0.13202250365204665,1067912.3306274428,14559.518432617304,1082471.84906006,342,0,182.3053435114504,63,68,44,36.15160177660178,0.6245039682539683,41.65039062500001,8267.187500000011,131.22519841269857,0
344,32,0,0,130,0.0,0.0,1.0,130,3900,3200,700,0.8205128205128205,46,32,14,215.67050457581843,0.44698867024448424,0.6745995456593035,0.13426355480864632,1068989.0586005303,16209.881930881027,1085198.9405314112,343,1,184.66923076923078,63,67,42,35.94553502088452,0.6258267195767195,41.520182291666664,8271.354166666657,131.29133597883583,0
345,32,1,1,130,0.007633587786259542,0.007633587786259542,0.9923664122137404,131,4050,2900,1150,0.7160493827160493,52,29,23,213.06716777590833,0.4475631238990017,0.6721927139222994,0.13335080089456888,1070561.6411900055,15370.307363576445,1085931.948553582,344,0,184.25190839694656,64,67,42,35.818722507899096,0.6271158854166667,41.3301282051282,8277.435897435887,129.33493589743574,0
346,32,1,0,131,0.007633587786259542,0.0,1.0,131,4400,3400,1000,0.7727272727272727,54,34,20,223.601348559359,0.4481160696809552,0.6816488074560352,0.13294197125942464,1055193.311362356,16588.52948228766,1071781.8408446435,345,0,184.96946564885496,72,59,42,37.45126502565242,0.6037326388888888,43.19349315068493,8217.808219178076,114.13622526636216,8
347,32,1,2,130,0.007575757575757576,0.015151515151515152,0.9848484848484849,132,3750,2800,950,0.7466666666666667,47,28,19,223.38122621256116,0.4484503913177577,0.6849273503643551,0.13335837580376217,1056441.3611111096,17047.833333333263,1073489.1944444429,346,0,184.56060606060606,74,58,35,37.30169990811311,0.6043074324324325,43.041666666666664,8222.666666666655,111.11711711711696,0
348,32,0,0,130,0.0,0.0,1.0,130,4000,2600,1400,0.65,54,26,28,224.99850486768523,0.44754149274498106,0.6845128587891289,0.13479070443318958,1057491.995734263,17586.823589950673,1075078.8193242135,347,2,188.23076923076923,75,55,37,37.129527198734685,0.6051388888888889,42.913925438596486,8226.754385964901,109.69005847953201,0
349,32,1,0,131,0.007633587786259542,0.0,1.0,131,4250,3600,650,0.8470588235294118,49,36,13,221.53365878902994,0.4479570366020748,0.681099403635991,0.13331278656747417,1058849.9091096467,16464.17889469824,1075314.0880043448,348,0,187.78625954198472,76,55,39,37.04994040106578,0.606359649122807,42.74891774891774,8232.03463203461,108.31624515835014,0
350,32,0,2,129,0.0,0.015267175572519083,0.9847328244274809,131,3300,2300,1000,0.696969696969697,43,23,20,225.15898271141123,0.4478616167547465,0.6846582624963784,0.13605475542943343,1060093.8400737173,18237.93012192635,1078331.7701956437,349,1,188.78625954198472,65,66,37,36.80221299078218,0.6136217948717948,42.597853535353536,8236.86868686869,126.72105672105675,0
351,32,0,0,129,0.0,0.0,1.0,129,4100,2900,1200,0.7073170731707317,53,29,24,225.12193986010126,0.44732618701550386,0.6809107755215655,0.1366219760720341,1061394.2494707191,17888.62647944104,1079282.8759501602,350,2,188.95348837209303,65,64,38,36.64178513797824,0.6152243589743589,42.44002525252526,8241.919191919207,126.79875679875704,0
352,32,0,0,129,0.0,0.0,1.0,129,3850,3000,850,0.7792207792207793,47,30,17,226.05909576361688,0.4469905725129199,0.6830481205206955,0.13748840086606856,1062044.7530864193,18366.975308641922,1080411.7283950613,351,3,189.95348837209303,65,64,38,36.53694968553457,0.6160256410256411,42.36111111111111,8244.44444444444,126.83760683760677,0
353,32,2,1,130,0.015267175572519083,0.007633587786259542,0.9923664122137404,131,3750,2400,1350,0.64,51,24,27,214.2016156200719,0.4482359561558035,0.6693547627508312,0.1314251481935957,1064670.4737868684,15660.827117627028,1080331.3009044954,352,0,188.0381679389313,71,60,36,36.51733968966163,0.6159037558685446,42.04282407407408,8254.629629629651,116.2623891497134,0
354,32,0,0,130,0.0,0.0,1.0,130,4150,3000,1150,0.7228915662650602,53,30,23,215.80170661223053,0.44725327966607037,0.6657512803498202,0.13274007014882933,1065419.8723963224,15833.885344342325,1081253.7577406648,353,1,190.48461538461538,72,58,36,36.38333609820838,0.6163194444444444,41.95205479452055,8257.534246575346,114.6879756468798,0
355,32,0,2,128,0.0,0.015384615384615385,0.9846153846153847,130,4300,3100,1200,0.7209302325581395,55,31,24,213.50990543190696,0.44680481017690316,0.6626307427512244,0.13196729261270013,1066859.4567901257,15257.012345679137,1082116.4691358048,354,2,191.48461538461538,74,56,37,36.264477553069426,0.6171171171171171,41.777777777777786,8263.111111111128,111.66366366366388,0
356,32,0,0,128,0.0,0.0,1.0,128,4650,3200,1450,0.6881720430107527,61,32,29,212.80623958718246,0.44574311023622043,0.655366728746714,0.13210659378072595,1068152.206731775,15211.890884267803,1083364.097616043,355,3,193.796875,68,60,39,36.122918492550404,0.6217830882352942,41.62137681159419,8268.115942028955,121.58994032395522,0
357,32,0,0,128,0.0,0.0,1.0,128,3950,2900,1050,0.7341772151898734,50,29,21,212.90027567663324,0.44563161294291337,0.6563102436032267,0.13233213213625988,1068526.7013232475,15947.925855912457,1084474.62717916,356,4,194.796875,68,60,38,36.07423472368269,0.6222426470588236,41.57608695652173,8269.565217391275,121.61125319693052,0
358,32,1,0,129,0.007751937984496124,0.0,1.0,129,4050,3100,950,0.7654320987654321,50,31,19,208.820199869059,0.4464051396963824,0.6519585474940583,0.1304957300799844,1070116.3584183643,14842.38236961437,1084958.7407879787,357,0,194.27906976744185,69,60,42,35.983502598922065,0.6236413043478262,41.38392857142856,8275.714285714263,119.93788819875743,0
359,32,3,1,131,0.022727272727272728,0.007575757575757576,0.9924242424242424,132,4250,2800,1450,0.6588235294117647,57,28,29,201.1796524625845,0.4476937793970237,0.6460415355876481,0.12663922803951794,1072260.2500000042,12493.388888889142,1084753.6388888934,358,0,190.8409090909091,74,58,43,35.916961746874854,0.6237331081081081,41.125000000000014,8284.000000000033,111.94594594594639,0
360,32,2,4,129,0.015037593984962405,0.03007518796992481,0.9699248120300752,133,3650,2700,950,0.7397260273972602,46,27,19,197.04851173558157,0.4484744057112478,0.6416068891355315,0.12474962142969057,1073937.4291383275,12073.554421768982,1086010.9835600965,359,0,188.5187969924812,76,57,38,35.817537813517156,0.6248629385964912,40.922619047619065,8290.476190476233,109.085213032582,0
361,32,1,0,130,0.007692307692307693,0.0,1.0,130,3650,2300,1350,0.6301369863013698,50,23,27,203.68904730557625,0.44665200755317036,0.6476408717728912,0.12948407285120142,1075138.5679012344,14148.790123456805,1089287.3580246912,360,0,193.6076923076923,74,56,42,35.4977050292899,0.6272522522522522,40.77777777777778,8295.11111111111,112.09609609609608,0
362,32,1,1,130,0.007633587786259542,0.007633587786259542,0.9923664122137404,131,3500,2500,1000,0.7142857142857143,45,25,20,203.03369607501878,0.44714963789391265,0.6503160512590236,0.12968337234849472,1076528.025744452,14014.292799047813,1090542.3185434998,361,0,193.12213740458014,70,61,46,35.343844268476644,0.6309523809523809,40.610328638497656,8300.469483568082,118.57813547954403,0
363,32,2,1,131,0.015151515151515152,0.007575757575757576,0.9924242424242424,132,4950,3800,1150,0.7676767676767676,61,38,23,200.9477267673368,0.4466106677461639,0.6501922125215154,0.12898759090993836,1077967.869218317,11973.038569529974,1089940.907787847,362,0,192.61363636363637,71,61,47,35.22106023447227,0.6321889671361502,40.43692129629628,8306.018518518486,116.98617631716176,0
364,32,1,0,132,0.007575757575757576,0.0,1.0,132,4500,3600,900,0.8,54,36,18,199.87881447397334,0.44637452771994757,0.648766003849464,0.12895677918439669,1079446.1184157098,12251.682087492718,1091697.8005032025,363,0,191.99242424242425,73,59,45,35.0673368740516,0.6329908675799087,40.259009009009,8311.711711711687,113.85906454399571,0
365,32,1,0,133,0.007518796992481203,0.0,1.0,133,4050,2600,1450,0.6419753086419753,55,26,29,197.76694297724043,0.44630278347383606,0.6480726478195165,0.12818887440017634,1080791.2623456768,12098.956790123313,1092890.2191358001,364,0,191.54135338345864,74,59,48,34.957204438981805,0.6341497747747749,40.097222222222214,8316.888888888872,112.39039039039017,0
366,32,0,1,132,0.0,0.007518796992481203,0.9924812030075187,133,3850,2600,1250,0.6753246753246753,51,26,25,200.45487243727095,0.44621496924128506,0.652624028422107,0.1303478870058401,1081715.5586419713,12917.030864197332,1094632.5895061686,365,1,192.54135338345864,74,59,37,34.774006018197056,0.6352759009009009,39.9861111111111,8320.444444444413,112.43843843843801,0
367,32,0,3,129,0.0,0.022727272727272728,0.9772727272727273,132,4350,3100,1250,0.7126436781609196,56,31,25,202.24771321788558,0.4451805748322924,0.6541455554908457,0.13209568214774883,1082987.1111111124,13056.333333333376,1096043.444444446,366,2,194.8030303030303,74,58,39,34.57152199444798,0.6368243243243243,39.833333333333336,8325.333333333343,112.50450450450464,0
368,32,0,1,128,0.0,0.007751937984496124,0.9922480620155039,129,3850,2700,1150,0.7012987012987013,50,27,23,206.43304962826,0.44341489018087854,0.6537580537783663,0.1350661953282041,1083491.7355371874,15083.700642791424,1098575.4361799788,367,4,199.4496124031008,76,53,41,34.4007763221737,0.6365131578947368,39.772727272727266,8327.272727272706,109.56937799043034,0
369,32,1,1,128,0.007751937984496124,0.007751937984496124,0.9922480620155039,129,3350,2200,1150,0.6567164179104478,45,22,23,204.93599527923047,0.4433921794250646,0.6518868598721981,0.13441350228579907,1084190.5788780241,15287.935070946394,1099478.5139489705,368,0,200.4108527131783,78,51,44,34.35410546043966,0.6364850427350428,39.68881856540083,8329.957805907135,106.79433084496327,0
370,32,1,1,128,0.007751937984496124,0.007751937984496124,0.9922480620155039,129,3550,2100,1450,0.5915492957746479,50,21,29,204.93276619261093,0.4433795623385013,0.6533572316976479,0.13507229925091244,1085595.6024895401,15144.82195694308,1100740.4244464831,369,0,201.35658914728683,65,64,47,34.18211746647276,0.6448717948717948,39.520202020202014,8335.353535353523,128.23620823620803,0
371,32,0,1,127,0.0,0.0078125,0.9921875,128,3250,2000,1250,0.6153846153846154,45,20,25,203.21847874079702,0.442503280839895,0.6476095372359474,0.13418184660119273,1086106.1762085087,15293.368976015401,1101399.545184524,370,1,203.5234375,66,62,46,34.1642797469865,0.6448863636363636,39.458955223880594,8337.313432835814,126.32293080054264,0
372,32,0,1,126,0.0,0.007874015748031496,0.9921259842519685,127,3700,2500,1200,0.6756756756756757,49,25,24,200.50176120722503,0.4414578386035079,0.6403557768620096,0.13279632023903998,1086985.1176530672,14488.486099096575,1101473.6037521637,371,2,205.79527559055117,67,60,46,34.127546772455695,0.6453669154228856,39.35355392156863,8340.686274509811,124.48785484343003,0
373,32,0,0,126,0.0,0.0,1.0,126,4500,3400,1100,0.7555555555555555,56,34,22,200.8619410368025,0.44076984126984126,0.6387434359708797,0.13357319078947372,1088135.332564399,14012.995001922383,1102148.3275663215,372,3,208.0952380952381,67,59,42,33.9775219298246,0.6467661691542288,39.21568627450981,8345.098039215693,124.55370207784615,0
374,32,0,0,126,0.0,0.0,1.0,126,3550,2100,1450,0.5915492957746479,50,21,29,201.15701154393483,0.4403981481481481,0.6393726481445765,0.134285896895546,1089230.3114461442,15071.262866715246,1104301.5743128594,373,4,209.0952380952381,70,56,42,33.8360089593642,0.6464285714285714,39.08450704225353,8349.295774647906,119.27565392354151,0
375,32,0,0,126,0.0,0.0,1.0,126,3650,2500,1150,0.684931506849315,48,25,23,199.85089282234827,0.43918915343915343,0.63773034522314,0.133956519691176,1090380.7120198926,14732.711762688727,1105113.4237825815,374,5,210.0952380952381,71,55,38,33.72958693563883,0.647300469483568,38.94675925925927,8353.70370370372,117.65779864371437,0
376,32,0,0,126,0.0,0.0,1.0,126,3800,2700,1100,0.7105263157894737,49,27,22,197.94975120212968,0.4385436507936508,0.6346133046315869,0.1330797377634878,1091226.8819926719,14201.6179591051,1105428.499951777,375,6,211.0952380952381,71,55,41,33.67593900614927,0.6483274647887324,38.84548611111112,8356.944444444462,117.70344287949946,0
377,32,0,0,126,0.0,0.0,1.0,126,3000,2000,1000,0.6666666666666666,40,20,20,201.08370884228503,0.4381230158730159,0.6417119624110337,0.13566111676132048,1092215.875920018,15725.363837284414,1107941.2397573025,376,7,212.0952380952381,72,54,41,33.47339796104135,0.6490162037037037,38.72716894977169,8360.730593607303,116.12125824454587,0
378,32,0,1,125,0.0,0.007936507936507936,0.9920634920634921,126,3950,2900,1050,0.7341772151898734,50,29,21,205.07285945121217,0.4374021164021164,0.6472747123540779,0.13918443122449184,1093903.5415649412,15715.985446506078,1109619.5270114474,377,8,213.0952380952381,63,63,46,33.16325604315801,0.65625,38.525390625,8367.187499999998,132.81249999999997,0
379,32,0,1,124,0.0,0.008,0.992,125,4100,2900,1200,0.7073170731707317,53,29,24,202.61861788932356,0.4368548387096774,0.6401930152602693,0.13829617398053062,1095484.6802941,15293.118368023512,1110777.7986621235,378,9,212.864,65,60,44,33.034700022116304,0.6568910256410256,38.33648989898989,8373.232323232303,128.81895881895852,0
380,32,1,0,125,0.008,0.0,1.0,125,4900,3600,1300,0.7346938775510204,62,36,26,205.54330562690637,0.4368548387096774,0.6450200267022705,0.13387124862135033,1082177.8549382715,14586.882716049438,1096764.737654321,379,0,213.784,74,51,36,34.585002225189164,0.6358389639639639,39.93055555555556,8322.22222222222,112.46246246246244,8
381,32,1,0,126,0.007936507936507936,0.0,1.0,126,3600,2300,1300,0.6388888888888888,49,23,26,204.67778545237408,0.43710582010582005,0.6475056151974361,0.1340678326303943,1083813.41193925,15566.505799861447,1099379.9177391115,380,0,213.0793650793651,75,51,42,34.407036091070246,0.637361111111111,39.73410087719298,8328.50877192982,111.04678362573094,0
382,32,0,0,126,0.0,0.0,1.0,126,3300,2400,900,0.7272727272727273,42,24,18,202.08250855188993,0.437191798941799,0.6432757553197614,0.13279008699274492,1084726.817987266,15340.863294475243,1100067.6812817412,381,1,214.0793650793651,75,51,43,34.36271735888122,0.6384722222222222,39.624451754385966,8332.017543859654,111.09356725146206,0
383,32,0,2,124,0.0,0.015873015873015872,0.9841269841269842,126,3950,2700,1250,0.6835443037974683,52,27,25,200.40959281074413,0.43673280423280425,0.640681057064227,0.1321472934885486,1085717.343784808,14367.634155095255,1100084.9779399033,382,2,215.0793650793651,66,60,42,34.28503929175372,0.6444128787878788,39.50559701492538,8335.820895522394,126.30031659882415,0
384,32,0,0,124,0.0,0.0,1.0,124,3150,2300,850,0.7301587301587301,40,23,17,197.30977807681882,0.4357433997727074,0.6283682731234372,0.13060028167941856,1086806.2500000035,14937.500000000222,1101743.7500000037,383,3,216.07258064516128,69,55,45,34.23261390887295,0.6440217391304348,39.375000000000014,8340.000000000027,120.8695652173917,0
385,32,0,0,124,0.0,0.0,1.0,124,3450,2400,1050,0.6956521739130435,45,24,21,207.38846974602515,0.43543606302998517,0.6402087665486762,0.13794776958088,1088206.353416495,16886.290080589813,1105092.6434970847,384,4,217.07258064516128,71,53,39,33.79863345537926,0.6446596244131455,39.207175925925924,8345.370370370369,117.54042775169533,8
386,32,0,0,124,0.0,0.0,1.0,124,3650,2800,850,0.7671232876712328,45,28,17,204.54073451695325,0.43496754523996856,0.6358954320774217,0.13660452415547886,1089354.4885427752,16113.473447175897,1105467.961989951,385,5,218.07258064516128,72,52,44,33.73254584563782,0.6455439814814814,39.06963470319635,8349.771689497724,115.96905124302394,0
387,32,0,1,123,0.0,0.008064516129032258,0.9919354838709677,124,4000,2800,1200,0.7,52,28,24,204.92179797388053,0.43491154165573914,0.6353942015542706,0.1372623379837494,1090188.6721763513,15880.684566627016,1106069.3567429783,386,6,219.07258064516128,72,52,47,33.620670019497425,0.646556712962963,38.96974885844749,8352.968036529677,116.01344495180108,0
388,32,0,0,123,0.0,0.0,1.0,123,3300,2300,1000,0.696969696969697,43,23,20,206.0275823938088,0.4340013994402239,0.6326773083913262,0.13842874614225104,1091060.235700228,17057.700521467472,1108117.9362216955,387,7,221.65040650406505,73,50,40,33.48533547158286,0.6471175799086758,38.86542792792793,8356.306306306313,114.46994940145633,0
389,32,0,0,123,0.0,0.0,1.0,123,2850,1900,950,0.6666666666666666,38,19,19,206.74485245757734,0.4337598294015727,0.6343164462252096,0.13924089138832826,1091730.9721753742,17691.95175315313,1109422.9239285274,388,8,222.65040650406505,76,47,40,33.38469107669995,0.6465186403508771,38.785173160173166,8358.87445887448,109.98519024834842,0
390,32,0,1,122,0.0,0.008130081300813009,0.991869918699187,123,4350,3400,950,0.7816091954022989,53,34,19,209.00176482153736,0.4328935092629615,0.6369746293272847,0.14133256867855865,1092873.669095624,16732.505113594845,1109606.174209219,389,9,223.65040650406505,77,46,42,33.18621188894567,0.6474567099567099,38.64850427350427,8363.247863247861,108.61360861360859,0
391,32,0,0,122,0.0,0.0,1.0,122,4350,2900,1450,0.6666666666666666,58,29,29,213.13218052534137,0.4318407623176625,0.6473051259435427,0.135695873940417,1075588.5562505072,17098.50686835487,1092687.0631188622,390,11,226.40983606557376,73,49,41,35.19752022368209,0.6282819634703196,40.72353603603604,8296.846846846845,113.65543625817597,8
392,32,0,0,122,0.0,0.0,1.0,122,3200,2500,700,0.78125,39,25,14,214.8288237736268,0.43159943322946304,0.6510066445384215,0.13699953402833806,1076064.9941568556,18633.95539973837,1094698.949556594,391,12,227.40983606557376,75,47,42,35.0948791466272,0.6279166666666667,40.66611842105263,8298.684210526313,110.6491228070175,0
393,32,0,0,122,0.0,0.0,1.0,122,3500,2500,1000,0.7142857142857143,45,25,20,211.34965062419184,0.43104338842975204,0.6447773497470293,0.13512354440380828,1076805.3254437898,17616.485864562957,1094421.8113083527,392,13,228.40983606557376,64,58,42,35.09402540976857,0.634765625,40.57692307692309,8301.538461538485,129.71153846153882,0
394,32,0,0,122,0.0,0.0,1.0,122,3300,2400,900,0.7272727272727273,42,24,18,210.86565027236776,0.43080770446642275,0.6441965020012053,0.13529791723484585,1077847.7044753123,17756.211419753272,1095603.9158950655,393,14,229.40983606557376,65,57,42,34.97840022296542,0.6354166666666667,40.4513888888889,8305.555555555584,127.77777777777821,0
395,32,0,0,122,0.0,0.0,1.0,122,3700,2500,1200,0.6756756756756757,49,25,24,210.97360521947246,0.4304944000361288,0.6456887129060118,0.13585709302058663,1078896.64080834,17423.742794102913,1096320.383602443,394,15,230.40983606557376,65,57,43,34.84667183289775,0.636698717948718,40.32512626262628,8309.59595959599,127.83993783993832,0
396,32,0,0,122,0.0,0.0,1.0,122,3200,2200,1000,0.6875,42,22,20,215.92403426304656,0.4305437948787427,0.642989704387787,0.1313242896911318,1062044.7530864216,18264.197530864374,1080308.950617286,395,16,231.40983606557376,65,57,41,36.798068283917374,0.6160256410256411,42.36111111111112,8244.44444444446,126.83760683760707,8
397,32,0,0,122,0.0,0.0,1.0,122,3750,2800,950,0.7466666666666667,47,28,19,219.88460310020315,0.43093048593234884,0.6569897499248785,0.12701569426141132,1046358.5069444427,17865.624999999913,1064224.1319444426,396,17,232.40983606557376,69,53,41,38.64774270196878,0.5943538647342995,44.27083333333333,8183.333333333319,118.59903381642492,8
398,32,4,0,126,0.031746031746031744,0.0,1.0,126,3700,2600,1100,0.7027027027027027,48,26,22,215.18914129363134,0.43487830687830686,0.663044032078913,0.12585467550252075,1050175.4866882132,16297.272237611667,1066472.758925825,397,0,226.0,75,51,42,38.29178258078322,0.596111111111111,43.804824561403514,8198.245614035099,109.30994152046799,0
399,32,0,0,126,0.0,0.0,1.0,126,3450,2500,950,0.7246376811594203,44,25,19,215.336619336377,0.434452380952381,0.6634300634618193,0.1261806874377095,1050758.467780218,16603.35523817266,1067361.8230183907,398,1,227.0,63,63,43,38.215372605059784,0.6033399470899471,43.73372395833333,8200.520833333323,130.1669973544972,0
400,32,1,1,126,0.007874015748031496,0.007874015748031496,0.9921259842519685,127,3800,2500,1300,0.6578947368421053,51,25,26,217.02668174477702,0.4348440819897513,0.6680811817954047,0.12770852945698577,1052049.0933641926,16464.544753086127,1068513.6381172787,399,0,226.20472440944883,65,62,43,38.01131234484315,0.6036858974358974,43.57638888888887,8205.555555555517,126.23931623931564,0
401,32,1,2,125,0.007874015748031496,0.015748031496062992,0.984251968503937,127,3300,2500,800,0.7575757575757576,41,25,16,216.55326474665844,0.4358387493230013,0.666717301438368,0.1282870594851108,1054094.0424513966,16953.501248570457,1071047.543699967,400,0,224.82677165354332,68,59,43,37.768963455279795,0.6044730392156863,43.32729468599033,8213.52657004829,120.78715544188663,0
402,32,1,1,125,0.007936507936507936,0.007936507936507936,0.9920634920634921,126,3800,2600,1200,0.6842105263157895,50,26,24,220.8168930402414,0.43641137566137567,0.6709104744000769,0.1318857948537188,1056575.4305818095,17661.940768746055,1074237.3713505554,401,0,224.84126984126985,68,58,39,37.35092821055109,0.6075367647058824,43.02536231884058,8223.188405797093,120.92924126172196,0
403,32,2,2,125,0.015748031496062992,0.015748031496062992,0.984251968503937,127,3900,2500,1400,0.6410256410256411,53,25,28,214.35384216571836,0.4373385618464359,0.6635227483775183,0.12888738920349332,1058604.6213020429,16083.193582095479,1074687.8148841383,402,0,223.0551181102362,73,54,44,37.26507916963097,0.6074486301369864,42.77871621621621,8231.081081081062,112.75453535727482,0
404,32,2,2,125,0.015748031496062992,0.015748031496062992,0.984251968503937,127,3850,2900,950,0.7532467532467533,48,29,19,211.54116561639353,0.43624755238928464,0.6597093394533546,0.12813421128526245,1060818.2555429586,15631.346056941387,1076449.6015999,403,0,223.31496062992127,62,65,46,37.06294548256598,0.6164314516129032,42.50992063492064,8239.682539682546,132.89810547875075,0
405,32,1,0,126,0.007936507936507936,0.0,1.0,126,4600,3500,1100,0.7608695652173914,57,35,22,209.9814809806728,0.4362883597883598,0.6560900804659098,0.12829450691309943,1063412.4310041838,14859.383431103266,1078271.8144352871,404,0,224.0952380952381,66,60,45,36.781851807180516,0.6171085858585859,42.1952736318408,8249.7512437811,124.99623096638031,0
406,32,2,0,128,0.015625,0.0,1.0,128,3500,2400,1100,0.6857142857142857,46,24,22,206.73108254450239,0.43700402928149606,0.6561526579409176,0.1272620762008742,1065657.2535240056,14960.895528483887,1080618.1490524895,405,0,221.578125,68,60,43,36.58806181144585,0.618719362745098,41.92330917874397,8258.454106280215,121.4478545041208,0
407,32,2,0,130,0.015384615384615385,0.0,1.0,130,3900,2400,1500,0.6153846153846154,54,24,30,200.63947410457646,0.43803418803418803,0.6508795209271274,0.12434633148688735,1067658.1823613287,12942.875246485137,1080601.057607814,406,0,219.15384615384616,71,59,46,36.498238121907995,0.6195715962441315,41.681134259259274,8266.20370370373,116.42540427751732,0
408,32,0,1,129,0.0,0.007692307692307693,0.9923076923076923,130,3200,2000,1200,0.625,44,20,24,200.35879568671257,0.4379435002981515,0.6506363666261075,0.12449618830279081,1068430.2343191993,13613.879004693306,1082044.1133238927,407,1,220.15384615384616,65,65,45,36.41023585577886,0.6238782051282051,41.58775252525252,8269.191919191899,127.2183372183369,0
409,32,1,0,130,0.007692307692307693,0.0,1.0,130,3000,1900,1100,0.6333333333333333,41,19,22,198.5591658044791,0.43838327370304114,0.6478405284876305,0.12374969299088713,1069320.623251896,13464.682186084245,1082785.3054379802,408,0,218.34615384615384,66,64,47,36.346949923823296,0.6243686868686869,41.48009950248755,8272.636815920367,125.34298205939949,0
410,32,1,1,130,0.007633587786259542,0.007633587786259542,0.9923664122137404,131,3500,3000,500,0.8571428571428571,40,30,10,198.2795384387859,0.4384517518105304,0.649335291486135,0.12397536688077604,1070275.2106233467,12742.7349529741,1083017.9455763209,409,0,217.67175572519085,68,63,45,36.236526188808455,0.6243872549019608,41.36473429951689,8276.32850241542,121.71071327081499,0
411,32,2,0,132,0.015151515151515152,0.0,1.0,132,4050,2900,1150,0.7160493827160493,52,29,23,199.25934199724966,0.43922165355848564,0.6533559624907108,0.12558390970962457,1072619.6317059672,12295.89640541259,1084915.5281113798,410,0,215.56060606060606,72,60,49,35.92243042160373,0.6251446759259259,41.0816210045662,8285.388127853865,115.07483510908145,0
412,32,0,1,131,0.0,0.007575757575757576,0.9924242424242424,132,4050,2600,1450,0.6419753086419753,55,26,29,201.3076688216126,0.4392421350913717,0.6571398582401038,0.12745330734990634,1073954.1008491586,12789.03929267098,1086743.1401418296,411,1,216.56060606060606,73,59,40,35.70514126596033,0.6262842465753424,40.920608108108105,8290.54054054053,113.56904850055521,0
413,32,0,0,131,0.0,0.0,1.0,131,3200,2200,1000,0.6875,42,22,20,201.51470972550362,0.4383171853591701,0.6549099299653358,0.12804319754608043,1075004.6795105876,13925.851189026653,1088930.5306996142,412,2,218.5801526717557,73,58,40,35.57053510010498,0.6275684931506849,40.793918918918905,8294.594594594562,113.62458348759674,0
414,32,0,2,129,0.0,0.015267175572519083,0.9847328244274809,131,3250,1800,1450,0.5538461538461539,47,18,29,205.42938847948903,0.4382560187903699,0.6615234522771349,0.13100736450937447,1076069.425704163,14761.256816776138,1090830.6825209393,413,3,219.5801526717557,76,55,41,35.3380933750652,0.627467105263158,40.665584415584405,8298.701298701277,109.19343814080628,0
415,32,0,0,129,0.0,0.0,1.0,129,3200,2100,1100,0.65625,43,21,22,207.6064210437465,0.4367909197351421,0.6603908730677779,0.13223487800974723,1075714.6944444405,15665.055555555395,1091379.749999996,414,4,223.91472868217053,74,55,41,35.325271841019884,0.6279560810810811,40.70833333333332,8297.333333333303,112.12612612612571,0
416,32,1,1,129,0.007692307692307693,0.007692307692307693,0.9923076923076923,130,3800,2700,1100,0.7105263157894737,49,27,22,204.83431119746618,0.43708631484794275,0.658397761444887,0.13089298965350488,1076660.554233944,14307.40460399823,1090967.9588379422,415,0,223.1846153846154,67,63,43,35.280845242313305,0.632773631840796,40.594362745098024,8300.980392156827,123.89522973368399,0
417,32,1,1,129,0.007692307692307693,0.007692307692307693,0.9923076923076923,130,3450,2300,1150,0.6666666666666666,46,23,23,202.54319099197556,0.436814251639833,0.6555954223745326,0.1300421070170282,1078035.791383692,14219.76183808234,1092255.5532217743,416,0,224.1,68,62,44,35.171304912566406,0.6338848039215687,40.428743961352644,8306.280193236684,122.15117931230418,0
418,32,1,2,128,0.007692307692307693,0.015384615384615385,0.9846153846153847,130,3600,2300,1300,0.6388888888888888,49,23,26,201.1988989565339,0.4367508944543828,0.6534803706487224,0.12997551637443808,1079818.574494699,13851.6616522295,1093670.2361469285,417,0,225.01538461538462,70,60,46,34.98734022326385,0.6349702380952381,40.21420187793427,8313.145539906103,118.75922199865862,0
419,32,0,1,127,0.0,0.0078125,0.9921875,128,3550,2400,1150,0.676056338028169,47,24,23,203.26819472099422,0.43550586450131235,0.6508622021031243,0.13159321343988714,1080436.8425647917,14773.689299639243,1095210.531864431,418,1,226.3359375,72,56,45,34.85770962605018,0.634693287037037,40.1398401826484,8315.525114155247,115.49340436326732,0
420,32,0,0,127,0.0,0.0,1.0,127,4500,2800,1700,0.6222222222222222,62,28,34,204.24205951265287,0.4348388743073783,0.6508856669039811,0.13273577900065806,1081553.1536604178,14279.728715201723,1095832.8823756194,419,2,228.6771653543307,73,54,43,34.6954520844613,0.6355593607305936,40.005630630630634,8319.819819819826,113.9701345180798,0
421,32,0,1,126,0.0,0.007874015748031496,0.9921259842519685,127,4000,3100,900,0.775,49,31,18,201.66191547971536,0.43441965587634884,0.6462074685397743,0.13137751016935037,1082252.9123564037,14249.839067858586,1096502.7514242623,420,3,229.6771653543307,76,51,39,34.67674469007368,0.6350054824561404,39.9215367965368,8322.510822510829,109.5067213488267,0
422,32,1,0,127,0.007874015748031496,0.0,1.0,127,3500,2100,1400,0.6,49,21,28,200.76215333936437,0.4351851851851852,0.6444852168216779,0.13142429918603782,1083641.4687149508,14610.838941409038,1098252.3076563599,421,0,230.53543307086613,78,49,41,34.53000709327658,0.6358173076923077,39.75474683544304,8327.848101265832,106.76728334956195,0
423,32,0,1,126,0.0,0.007874015748031496,0.9921259842519685,127,3600,2800,800,0.7777777777777778,44,28,16,200.08940719801063,0.43464098237720283,0.6440350245041571,0.13138875851967935,1084526.9775390665,14400.472005208572,1098927.449544275,422,1,231.53543307086613,79,48,42,34.43907851962992,0.6364715189873418,39.648437500000014,8331.250000000031,105.45886075949406,0
424,32,0,0,126,0.0,0.0,1.0,126,3750,2700,1050,0.72,48,27,21,201.4045839236179,0.43383994708994705,0.6428970339182811,0.13296347870794506,1086061.7346938779,14797.562358276633,1100859.2970521546,423,2,234.33333333333334,69,57,42,34.21697700099003,0.6431159420289856,39.464285714285715,8337.14285714286,120.82815734989653,0
425,32,0,0,126,0.0,0.0,1.0,126,3650,2500,1150,0.684931506849315,48,25,23,206.41258186367182,0.43321560846560847,0.6523023031186073,0.1368635733946932,1087302.7352607683,16036.592970521428,1103339.3282312897,424,3,235.33333333333334,69,57,45,33.93461962933366,0.6446256038647342,39.31547619047618,8341.904761904741,120.89717046238756,0
426,32,0,0,126,0.0,0.0,1.0,126,3550,2200,1350,0.6197183098591549,49,22,27,207.05865368059378,0.4329378306878307,0.6519533374594426,0.1375720916585117,1087883.2772653117,16301.129350437439,1104184.4066157492,425,4,236.33333333333334,70,56,41,33.84675256475177,0.6447916666666667,39.24589201877934,8344.131455399049,119.20187793427212,0
427,32,0,0,126,0.0,0.0,1.0,126,3800,2300,1500,0.6052631578947368,53,23,30,206.12258538211944,0.43278042328042327,0.6510775315741406,0.13754545077104618,1089116.2090031463,15898.28975626016,1105014.4987594064,426,5,237.33333333333334,72,54,41,33.72039761540147,0.6452546296296297,39.09817351598173,8348.858447488568,115.95636732623012,0
428,32,0,0,126,0.0,0.0,1.0,126,3250,2400,850,0.7384615384615385,41,24,17,209.18949649917715,0.432462962962963,0.6570998210880139,0.14017995051120663,1090307.8673297039,17166.19075915837,1107474.0580888623,427,6,238.33333333333334,72,54,38,33.494702270325426,0.6467013888888888,38.95547945205479,8353.424657534233,116.01978691019768,0
429,32,0,0,126,0.0,0.0,1.0,126,3500,3000,500,0.8571428571428571,40,30,10,211.11527638850905,0.43202777777777773,0.6594426800255979,0.1418652404094616,1091096.308641972,17369.41975308624,1108465.7283950583,428,7,239.33333333333334,74,52,38,33.34807024075453,0.646677927927928,38.8611111111111,8356.444444444418,112.92492492492457,0
430,32,0,1,125,0.0,0.007936507936507936,0.9920634920634921,126,2600,1800,800,0.6923076923076923,34,18,16,230.44170831516712,0.4320661375661376,0.6865011073373635,0.1472668008862175,1076680.7383961757,21822.42973320978,1098503.1681293854,429,8,240.33333333333334,62,64,36,34.61408736482035,0.6359206989247312,40.591931216931194,8301.058201058155,133.88803550093797,8
431,32,0,1,124,0.0,0.008,0.992,125,4150,3200,950,0.7710843373493976,51,32,19,228.23575986007967,0.43083870967741933,0.681662213860146,0.14632968198508048,1077622.413635248,20040.394083658513,1097662.8077189066,430,14,243.192,63,62,37,34.55530730636565,0.6364087301587302,40.47851562499998,8304.687499999955,131.8204365079358,0
432,32,0,0,124,0.0,0.0,1.0,124,4550,3300,1250,0.7252747252747253,58,33,25,226.06435153001672,0.43073176195471635,0.6759067525156124,0.14541042482285554,1078568.793402775,19415.190972222044,1097983.984374997,431,15,244.90322580645162,63,61,38,34.49515212303577,0.6375661375661376,40.36458333333332,8308.33333333331,131.87830687830652,0
433,32,1,0,125,0.008,0.0,1.0,125,3700,2600,1100,0.7027027027027027,48,26,22,222.16146132241045,0.43034408602150537,0.6720258481421661,0.14374698037481343,1080280.999387386,19299.361092546886,1099580.360479933,432,0,243.936,66,59,39,34.38590717804503,0.6377840909090908,40.15858208955222,8314.925373134287,125.98371777476193,0
434,32,1,1,125,0.007936507936507936,0.007936507936507936,0.9920634920634921,126,4050,2800,1250,0.691358024691358,53,28,25,222.3217701386919,0.43059391534391533,0.6719522985602888,0.1446560592488312,1081892.9775838088,18855.672375410304,1100748.6499592192,433,0,242.9920634920635,70,56,33,34.183639885654124,0.6375,39.964788732394354,8321.126760563351,118.8732394366193,0
435,32,1,1,125,0.007936507936507936,0.007936507936507936,0.9920634920634921,126,3900,3000,900,0.7692307692307693,48,30,18,222.905997816646,0.43035317460317457,0.6736819255164825,0.14591095664941098,1083623.1674382673,19209.220679012098,1102832.3881172794,434,0,243.984126984127,71,55,37,33.955970647098034,0.6390845070422535,39.75694444444443,8327.777777777745,117.29264475743302,0
436,32,0,0,125,0.0,0.0,1.0,125,3400,2100,1300,0.6176470588235294,47,21,26,228.37752453975307,0.42989516129032257,0.6795540207202784,0.1498126997547176,1084237.2220397773,21123.082556660367,1105360.3045964376,435,1,246.92,72,53,39,33.73816897805551,0.6393229166666667,39.683219178082176,8330.136986301331,115.69634703196294,0
437,32,0,0,125,0.0,0.0,1.0,125,3900,2700,1200,0.6923076923076923,51,27,24,226.1216988374647,0.42954301075268814,0.677437027010398,0.14897267820045895,1085470.122452337,20189.66962524675,1105659.7920775837,436,2,247.92,64,61,41,33.6455833794787,0.6453450520833333,39.53525641025642,8334.871794871819,130.23237179487217,0
438,32,0,0,125,0.0,0.0,1.0,125,3500,2500,1000,0.7142857142857143,45,25,20,227.2101143813046,0.42899193548387093,0.6781144052158918,0.1500398878802304,1086138.0834977068,20856.311637081337,1106994.3951347882,437,3,248.92,64,61,40,33.53528519293066,0.6461588541666667,39.45512820512823,8337.435897435958,130.27243589743685,0
439,32,0,0,125,0.0,0.0,1.0,125,3750,2800,950,0.7466666666666667,47,28,19,227.97382437742033,0.42880645161290326,0.6779940059940055,0.1511270186766877,1087240.6684027812,20822.4826388891,1108063.1510416702,438,4,249.92,67,58,42,33.3801615051615,0.6456778606965174,39.32291666666668,8341.666666666693,124.50248756218946,0
440,32,0,0,125,0.0,0.0,1.0,125,3850,2800,1050,0.7272727272727273,49,28,21,228.05682457280307,0.4285698924731183,0.6764677008566795,0.15176847847918923,1088342.843473595,20790.80258582477,1109133.64605942,439,5,250.92,68,57,41,33.242889943659804,0.6464460784313726,39.19082125603865,8345.893719806776,122.73373117362905,0
441,32,1,1,125,0.007936507936507936,0.007936507936507936,0.9920634920634921,126,3400,2500,900,0.7352941176470589,43,25,18,230.80003484460957,0.4288452380952381,0.6834717923657485,0.15451269508299464,1090035.4308390052,21716.043083900393,1111751.4739229055,440,0,249.9206349206349,69,57,45,32.96393956670468,0.6479468599033816,38.98809523809525,8352.380952380974,121.04899930986919,0
442,32,0,1,124,0.0,0.008,0.992,125,4050,2600,1450,0.6419753086419753,55,26,29,230.5425531314611,0.42821236559139786,0.6803567274137261,0.15512429040932801,1091468.7051236725,21275.996388460306,1112744.7015121328,441,1,250.576,71,54,40,32.795161007404154,0.6486208920187793,38.81655092592593,8357.870370370381,117.71648408972368,0
443,32,0,0,124,0.0,0.0,1.0,124,3250,2300,950,0.7076923076923077,42,23,19,235.36409568034676,0.42725680785033654,0.6860732162395025,0.1587212238604589,1092096.5765152904,23358.064625424682,1115454.6411407152,442,8,253.58870967741936,72,52,40,32.59234984615943,0.6488715277777778,38.74143835616437,8360.273972602716,116.11491628614883,0
444,32,0,0,124,0.0,0.0,1.0,124,3250,2200,1050,0.676923076923077,43,22,21,236.40699012190944,0.4269330798146691,0.687159761257309,0.1597705049731799,1092707.651697306,23614.74540418801,1116322.397101494,443,9,254.58870967741936,73,51,41,32.49029311428315,0.649115296803653,38.66835585585586,8362.612612612616,114.55633715907693,0
445,32,0,0,124,0.0,0.0,1.0,124,2400,1800,600,0.75,30,18,12,236.80914666717837,0.42684019582131305,0.6861694833910392,0.160314681304903,1093186.4197530877,24575.30864197538,1117761.728395063,444,10,255.58870967741936,74,50,42,32.42118313850513,0.6492117117117118,38.611111111111114,8364.444444444453,113.03303303303315,0
446,32,0,1,123,0.0,0.008064516129032258,0.9919354838709677,124,3500,2700,800,0.7714285714285715,43,27,16,238.00517636944937,0.42636758020806015,0.6897646568210352,0.16186888460366272,1094481.8447848542,23798.468900235872,1118280.31368509,445,11,256.58870967741933,60,64,39,32.231408331156956,0.6590277777777778,38.45628415300546,8369.398907103821,139.4899817850637,0
447,32,0,0,123,0.0,0.0,1.0,123,3450,2600,850,0.7536231884057971,43,26,17,235.56521736655793,0.42620729485983383,0.6837298647214205,0.16052455140545582,1095032.847908716,23540.33016822741,1118573.1780769434,446,12,256.8617886178862,61,62,42,32.227846102797926,0.6589822404371585,38.390456989247305,8371.505376344072,137.23779305482086,0
448,32,0,0,123,0.0,0.0,1.0,123,3650,2400,1250,0.6575342465753424,49,24,25,232.30187962430554,0.42613787818206056,0.6788734189120729,0.15866396009343986,1095674.6588812901,22655.456542968557,1118330.1154242586,447,13,257.8617886178862,63,60,40,32.23478251855538,0.6583994708994709,38.31380208333332,8373.958333333308,132.91997354497315,0
449,32,0,0,123,0.0,0.0,1.0,123,4200,3100,1100,0.7380952380952381,53,31,22,232.3108832812193,0.42590186147763115,0.6800653511829855,0.15926407470269685,1096719.1362590357,22155.95825115028,1118875.094510186,448,14,258.8617886178862,64,59,42,32.10695048050437,0.6590169270833333,38.18910256410255,8377.948717948684,130.9054487179482,0
450,32,0,0,123,0.0,0.0,1.0,123,3750,2800,950,0.7466666666666667,47,28,19,238.25077076363138,0.4256741747745347,0.6864465449199126,0.1499515744929098,1072214.5666630685,22741.1893862941,1094955.7560493625,449,15,259.8617886178862,67,56,40,34.96292926603154,0.6273320895522387,41.130514705882376,8283.823529411813,123.6391571554002,8
451,32,0,0,123,0.0,0.0,1.0,123,3550,2400,1150,0.676056338028169,47,24,23,241.22108311039284,0.42559087476120666,0.6893196246021656,0.1523707253991872,1073275.9807696864,23629.35891152692,1096905.3396812133,450,16,260.8617886178862,68,55,35,34.754847672340105,0.6280637254901961,41.00241545893722,8287.922705314062,121.88121625461856,0
452,32,0,0,123,0.0,0.0,1.0,123,2950,1900,1050,0.6440677966101694,40,19,21,243.37521828021028,0.4253715180594429,0.6916406326613516,0.15407863819121714,1073937.4291383252,24723.95124716572,1098661.3803854908,451,17,261.8617886178862,69,54,37,34.61731763354393,0.6283212560386473,40.92261904761906,8290.476190476214,120.15182884748137,0
453,32,0,0,123,0.0,0.0,1.0,123,2800,1600,1200,0.5714285714285714,40,16,24,243.6347549589101,0.4253215380514461,0.6923235536703183,0.15458205142220566,1074580.4403888166,24961.028455553664,1099541.4688443702,452,18,262.8617886178862,70,53,37,34.53115564613528,0.6285714285714286,40.84507042253523,8292.95774647891,118.47082494969872,0
454,32,0,0,123,0.0,0.0,1.0,123,4000,2700,1300,0.675,53,27,26,246.62248550961723,0.4247384379581501,0.6963247024647894,0.15713525800884737,1075805.928631903,24463.586409036485,1100269.5150409394,453,19,263.8617886178862,71,52,37,34.30235126187952,0.6295481220657277,40.69733796296297,8297.685185185197,116.86880542514362,0
455,32,0,0,123,0.0,0.0,1.0,123,3600,2600,1000,0.7222222222222222,46,26,20,245.76280113869046,0.42429972455462256,0.6950606030446613,0.1569851835655867,1076545.7034411458,24714.9775263034,1101260.6809674492,454,20,264.8617886178862,61,62,38,34.2333133622644,0.636441256830601,40.60819892473117,8300.537634408574,136.07438744932088,0
456,32,3,0,126,0.023809523809523808,0.0,1.0,126,3500,2600,900,0.7428571428571429,44,26,18,232.7831445361052,0.42529894179894184,0.6845532168112818,0.15017000381491094,1079415.5967758836,21553.951375761142,1100969.5481516446,455,0,259.531746031746,68,58,39,34.216434176111584,0.6355698529411764,40.262681159420275,8311.59420289852,122.22932651321352,0
457,32,0,1,125,0.0,0.007936507936507936,0.9920634920634921,126,3500,2700,800,0.7714285714285715,43,27,16,233.87519614984546,0.4244828042328042,0.6831238081098912,0.15143714034763928,1080492.8760502366,21840.096664951783,1102332.9727151885,456,1,260.531746031746,71,55,42,34.05545967412685,0.6352699530516432,40.13310185185184,8315.740740740714,117.12310902451709,0
458,32,0,0,125,0.0,0.0,1.0,125,4000,2700,1300,0.675,53,27,26,233.9410421588378,0.42374731182795694,0.6791294517916924,0.15219948629991054,1081861.20298263,21618.34745939396,1103479.5504420241,457,2,262.472,72,53,32,33.88540580584975,0.6364293981481481,39.96860730593607,8321.004566210033,115.56950786402824,0
459,32,0,0,125,0.0,0.0,1.0,125,4150,2900,1250,0.6987951807228916,54,29,25,232.3855500896497,0.4238413978494624,0.6784035874439467,0.15177985091629384,1082987.1111111077,21184.1111111109,1104171.2222222188,458,3,263.472,74,51,34,33.787435938500934,0.6368243243243243,39.83333333333332,8325.333333333307,112.50450450450414,0
460,32,0,1,124,0.0,0.008,0.992,125,3450,2300,1150,0.6666666666666666,46,23,23,232.6263704704406,0.4234005376344086,0.679085494716618,0.15230443500611876,1083681.0000000005,21968.555555555577,1105649.555555556,459,4,264.472,74,51,35,33.69589870850677,0.6376689189189189,39.75,8328.000000000004,112.54054054054059,0
461,32,0,0,124,0.0,0.0,1.0,124,3800,2900,900,0.7631578947368421,47,29,18,233.33262428060362,0.42244459742984525,0.6797523117288942,0.15320266844832545,1084498.4304064687,22009.77295898726,1106508.2033654558,460,5,267.5725806451613,75,49,37,33.5770926559621,0.6381944444444445,39.65186403508771,8331.140350877175,111.081871345029,0
462,32,0,0,124,0.0,0.0,1.0,124,3700,2700,1000,0.7297297297297297,47,27,20,236.09562684327602,0.4214433626191101,0.6837686403058685,0.15554036446285754,1085464.0510215785,22754.663108356224,1108218.7141299348,461,6,268.5725806451613,65,59,38,33.38654335575349,0.6447115384615385,39.535984848484844,8334.848484848479,128.22843822843814,0
463,32,2,1,125,0.015873015873015872,0.007936507936507936,0.9920634920634921,126,3000,1800,1200,0.6,42,18,24,234.23979900335758,0.4221706349206349,0.6844966297021098,0.15545004842950036,1087551.0204081591,22749.54648526051,1110300.5668934197,462,0,265.2936507936508,69,57,40,33.17874809741247,0.644927536231884,39.28571428571427,8342.85714285711,120.91097308488565,0
464,32,0,0,125,0.0,0.0,1.0,125,3950,2800,1150,0.7088607594936709,51,28,23,232.30215666484534,0.4223010752688172,0.6790385242674772,0.15487681468532477,1088862.8558321751,21639.037944411335,1110501.8937765865,463,1,266.328,70,55,41,33.068420411300444,0.6459821428571428,39.12852112676056,8347.887323943654,119.25553319919506,0
465,32,1,0,126,0.007936507936507936,0.0,1.0,126,3100,2000,1100,0.6451612903225806,42,20,22,228.70075211366793,0.4226018518518519,0.675394086308668,0.15321628421950348,1090236.993750507,21567.60409057705,1111804.597841084,464,0,265.2063492063492,73,53,41,32.99405018694276,0.6461187214611872,38.96396396396396,8353.153153153151,114.4267555226459,0
466,32,0,1,125,0.0,0.007936507936507936,0.9920634920634921,126,3400,2300,1100,0.6764705882352942,45,23,22,231.28485453498402,0.4222566137566138,0.6778220125292398,0.15548262852417963,1091212.37345679,21876.179012345707,1113088.5524691357,465,1,266.2063492063492,74,52,34,32.80715400024818,0.6468186936936937,38.84722222222222,8356.888888888889,112.93093093093093,0
467,32,0,1,124,0.0,0.008,0.992,125,3850,2700,1150,0.7012987012987013,50,27,23,235.5076059091333,0.4211666666666667,0.6886072445163807,0.14968392249286808,1075085.7640228507,21788.174886402732,1096873.9389092533,466,4,269.328,71,54,36,34.679412941154574,0.6286678403755869,40.784143518518526,8294.907407407427,116.8296817944708,8
468,32,2,0,126,0.015873015873015872,0.0,1.0,126,3800,2700,1100,0.7105263157894737,49,27,22,232.55878545036938,0.4224074074074074,0.6881123825302757,0.14890024561699874,1077229.8201688055,21103.85172587533,1098333.671894681,467,0,268.14285714285717,62,64,36,34.49149302236663,0.6365927419354839,40.52579365079364,8303.17460317458,133.92217101894485,0
469,32,2,1,127,0.015625,0.0078125,0.9921875,128,3450,2300,1150,0.6666666666666666,46,23,23,223.92102028210206,0.4232424438156168,0.6794750014529811,0.1445155692038202,1079541.0773880365,19296.38789703372,1098837.4652850702,468,0,264.9375,68,60,40,34.431181952032226,0.6357230392156863,40.2475845410628,8312.077294685985,122.23643080420567,0
470,32,1,1,127,0.0078125,0.0078125,0.9921875,128,3700,2800,900,0.7567567567567568,46,28,18,224.258516943847,0.42333984375,0.6814652428031822,0.14583063143132993,1081723.8130668923,19217.155612244864,1100940.9686791373,469,0,265.8828125,69,59,38,34.154063889047855,0.6378321256038647,39.985119047619044,8320.476190476182,120.58661145617654,0
471,32,0,0,127,0.0,0.0,1.0,127,3600,2700,900,0.75,45,27,18,224.84994370305589,0.42272320126650836,0.6806723256978018,0.146466733734562,1082219.136196142,19667.382369614323,1101886.5185657563,470,1,266.6456692913386,69,58,38,34.07782371116321,0.6384359903381642,39.92559523809523,8322.380952380929,120.61421670117288,0
472,32,0,0,127,0.0,0.0,1.0,127,2800,1800,1000,0.6428571428571429,38,18,20,222.8730606622227,0.42303045452651755,0.6780277126987821,0.14550755197579276,1082869.8560691215,20068.503824197112,1102938.3598933187,471,2,267.6456692913386,70,57,38,34.04931761786601,0.6386904761904761,39.847417840375584,8324.882629107975,118.9268947015425,0
473,32,0,1,126,0.0,0.007874015748031496,0.9921259842519685,127,3850,2500,1350,0.6493506493506493,52,25,27,221.70683407562893,0.4227440319960005,0.6764253168798067,0.14507597893926197,1083524.1426627846,18794.941462855022,1102319.0841256396,472,3,268.6456692913386,72,55,39,33.99933285810898,0.6384548611111112,39.768835616438345,8327.397260273943,115.65829528158254,0
474,32,0,0,126,0.0,0.0,1.0,126,3550,2600,950,0.7323943661971831,45,26,19,227.65866878014447,0.4221759259259259,0.6828777815064389,0.14984754249711948,1085207.2354147467,20661.366913020633,1105868.6023277673,473,4,271.74603174603175,62,64,39,33.637811355892744,0.6463373655913979,39.56679894179896,8333.862433862469,134.4171360300398,0
475,32,0,0,126,0.0,0.0,1.0,126,4000,3000,1000,0.75,50,30,20,228.38164034307408,0.42209259259259263,0.6839535162502721,0.15075867226166031,1086034.1649519936,20406.05281207161,1106440.2177640651,474,5,272.74603174603175,62,64,37,33.5175107359692,0.6473454301075269,39.46759259259261,8337.037037037073,134.46833930704958,0
476,32,0,1,125,0.0,0.007936507936507936,0.9920634920634921,126,3100,2100,1000,0.6774193548387096,41,21,20,224.41906707188392,0.42181613756613756,0.6780964867685211,0.1488414160368689,1087376.4419555725,20505.60133192312,1107882.0432874956,475,6,273.74603174603175,63,63,41,33.456184574722684,0.6483134920634921,39.30664062500002,8342.187500000047,132.41567460317535,0
477,32,0,0,125,0.0,0.0,1.0,125,3800,3000,800,0.7894736842105263,46,30,16,221.27931562757226,0.42154301075268813,0.6701965460020887,0.14701656776546537,1087875.7437541157,19344.880013149686,1107220.6237672654,476,7,275.264,64,61,42,33.47686579394835,0.6482747395833333,39.2467948717949,8344.102564102615,130.37660256410337,0
478,32,0,0,125,0.0,0.0,1.0,125,3350,2500,850,0.746268656716418,42,25,17,222.12066232564408,0.4214623655913978,0.6714423332929915,0.14789549015284523,1088491.7514794488,20005.301754923494,1108497.0532343723,477,8,276.264,65,60,43,33.37947275001011,0.6483974358974358,39.17297979797983,8346.464646464708,128.40714840714935,0
479,32,0,1,124,0.0,0.008,0.992,125,3550,2400,1150,0.676056338028169,47,24,23,222.75518286914047,0.42114247311827957,0.6732713843221334,0.14910741666695207,1089998.329249285,20010.555431796798,1110008.8846810816,478,9,277.264,66,59,43,33.178460805337174,0.6496212121212122,38.99253731343287,8352.238805970219,126.54907281773059,0
480,32,0,0,124,0.0,0.0,1.0,124,3700,2300,1400,0.6216216216216216,51,23,28,219.06202857231156,0.4209284028324154,0.6649862190167952,0.14710702798368627,1090907.499969067,19295.28198559487,1110202.781954662,479,10,278.69354838709677,66,58,38,33.163639972213964,0.6507260101010102,38.88370646766172,8355.72139303488,126.60183928840729,0
481,32,0,0,124,0.0,0.0,1.0,124,3250,2600,650,0.8,39,26,13,229.34901716499562,0.42086420360171345,0.6778814339283943,0.14849911172469404,1080478.7221261049,21511.3465974625,1101990.0687235673,480,11,279.69354838709677,67,57,43,34.17482118997093,0.6374378109452736,40.134803921568626,8315.6862745098,124.11472051507165,8
482,32,0,0,124,0.0,0.0,1.0,124,4450,3300,1150,0.7415730337078652,56,33,23,228.37921454728522,0.42040524739924817,0.6769519202195695,0.14876569260689157,1082219.1361961442,20181.27125850333,1102400.4074546476,481,12,280.69354838709677,69,55,37,33.98603640975757,0.6384359903381642,39.925595238095234,8322.380952380945,120.61421670117312,0
483,32,1,1,124,0.008,0.008,0.992,125,3550,2600,950,0.7323943661971831,45,26,19,225.4694145663483,0.42081182795698924,0.6756184122748492,0.14758893119430425,1083623.1674382733,20314.77623456799,1103937.9436728414,482,0,279.44,71,54,39,33.88925950633757,0.6390845070422535,39.75694444444445,8327.777777777792,117.29264475743369,0
484,32,0,1,123,0.0,0.008064516129032258,0.9919354838709677,124,4150,3100,1050,0.7469879518072289,52,31,21,225.3085210558511,0.42004737083661164,0.6725060766191775,0.14798000528909103,1084587.2449417005,19923.349622770875,1104510.5945644714,483,1,281.86290322580646,71,53,40,33.7750981699637,0.6402582159624413,39.6412037037037,8331.481481481478,117.34480959833068,0
485,32,0,0,123,0.0,0.0,1.0,123,4100,3300,800,0.8048780487804879,49,33,16,224.075461824933,0.41938780043538143,0.6672887355552157,0.14775223781490562,1085717.343784807,19956.523043984023,1105673.866828791,484,2,284.9268292682927,66,57,40,33.66855664975629,0.6444128787878788,39.50559701492537,8335.820895522385,126.30031659882403,0
486,32,1,2,122,0.008064516129032258,0.016129032258064516,0.9838709677419355,124,3100,2200,900,0.7096774193548387,40,22,18,223.33676656660492,0.42081366378179913,0.6684241353557328,0.14811945025060352,1087368.4550413317,20669.870963091205,1108038.326004423,485,0,283.6209677419355,67,57,43,33.48537822697535,0.6458333333333333,39.30759803921569,8342.156862745109,124.50980392156879,0
487,32,0,0,122,0.0,0.0,1.0,122,3000,2100,900,0.7,39,21,18,220.64604061846336,0.42043902136115247,0.6591812523111058,0.14672961701127823,1088135.332564399,20618.550557477938,1108753.883121877,486,1,282.1803278688525,67,55,43,33.461583646616575,0.6467661691542288,39.21568627450981,8345.098039215693,124.55370207784615,0
488,32,0,1,121,0.0,0.00819672131147541,0.9918032786885246,122,3200,2300,900,0.71875,41,23,18,228.65131532922456,0.41983922684369773,0.6695371615095822,0.14834386266935548,1081056.7846402274,21837.011150713868,1102893.7957909412,487,2,283.1803278688525,66,56,42,34.1218573678649,0.6387310606060606,40.06529850746267,8317.910447761162,126.02894617819942,8
489,32,0,0,121,0.0,0.0,1.0,121,3300,2400,900,0.7272727272727273,42,24,18,229.6762579615494,0.4181215564738292,0.6681078596628591,0.14936876638464863,1081752.9465830417,22190.593762014447,1103943.5403450562,488,6,286.504132231405,67,54,33,34.00961274105495,0.6389925373134329,39.98161764705881,8320.588235294092,124.18788410886704,0
490,32,0,1,120,0.0,0.008264462809917356,0.9917355371900827,121,3350,2500,850,0.746268656716418,42,25,17,230.75188566968737,0.41787190082644626,0.6690746766095426,0.15042089437014863,1082429.144349922,22404.5132325139,1104833.6575824358,489,7,287.504132231405,68,53,34,33.8985141331476,0.6392463235294117,39.900362318840564,8323.188405797066,122.39982949701567,0
491,32,0,0,120,0.0,0.0,1.0,120,3200,2300,900,0.71875,41,23,18,230.27309054954034,0.41638947245564895,0.6678220086936635,0.1504519699240715,1083086.2244897932,22681.122448979466,1105767.3469387726,490,21,290.84166666666664,69,51,36,33.83021619766643,0.6394927536231885,39.82142857142856,8325.714285714264,120.66252587991687,0
492,32,0,1,119,0.0,0.008333333333333333,0.9916666666666667,120,3000,2400,600,0.8,36,24,12,229.3805990048827,0.41641865079365076,0.6678775245506772,0.15027519942089707,1083864.1466263696,22723.481438614435,1106587.628064984,491,22,291.84166666666664,71,49,40,33.75787474522883,0.6393779342723005,39.72800925925925,8328.703703703686,117.30568596765755,0
493,32,0,2,117,0.0,0.01680672268907563,0.9831932773109243,119,3050,2000,1050,0.6557377049180327,41,20,21,229.51729109572256,0.41523940084508376,0.6664968348301736,0.15080501166515317,1084702.69140272,22941.604674998354,1107644.2960777185,492,23,295.0924369747899,70,49,42,33.651344828233874,0.640922619047619,39.627347417840376,8331.92488262911,119.027498323273,0
494,32,0,0,117,0.0,0.0,1.0,117,3200,2200,1000,0.6875,42,22,20,229.80446304632378,0.4140755476962374,0.6591955762943453,0.15168989855597972,1086019.087897408,23314.406670464494,1109333.4945678725,493,24,299.1794871794872,63,54,42,33.482291601590966,0.6466600529100529,39.46940104166667,8336.979166666677,132.3330026455028,0
495,32,0,0,117,0.0,0.0,1.0,117,3300,2600,700,0.7878787878787878,40,26,14,234.43669047511202,0.4134676785538855,0.6644495301982383,0.15553899186986647,1087474.6219592378,24288.79026955952,1111763.4122287973,494,25,300.1794871794872,64,53,41,33.18298705024177,0.6477864583333333,39.294871794871796,8342.564102564107,130.35256410256417,0
496,32,0,0,117,0.0,0.0,1.0,117,3250,2400,850,0.7384615384615385,41,24,17,237.08753575683713,0.4130777826898517,0.6683656243876439,0.15822745472734256,1089150.5052099284,24994.801869707255,1114145.3070796356,495,26,301.1794871794872,65,52,43,32.908311152783675,0.649198717948718,39.09406565656566,8348.989898989905,128.44599844599853,0
497,32,1,1,117,0.00847457627118644,0.00847457627118644,0.9915254237288136,118,3900,2600,1300,0.6666666666666666,52,26,26,235.38881434013712,0.4127704138297359,0.6667022755026235,0.1579059020635507,1090611.9308501966,23843.56986160718,1114455.5007118038,496,0,299.6186440677966,68,50,36,32.773529355075,0.649203431372549,38.91908212560387,8354.58937198069,122.86160841148073,0
498,32,0,0,117,0.0,0.0,1.0,117,3550,2500,1050,0.704225352112676,46,25,21,238.48318609882364,0.4116502112191767,0.6678158770228035,0.16050064733154001,1091527.4376417263,25112.18820861689,1116639.6258503431,497,28,303.1794871794872,69,48,37,32.580570115466415,0.6497584541062802,38.80952380952382,8358.09523809526,121.13181504485884,0
499,32,0,0,117,0.0,0.0,1.0,117,3800,2600,1200,0.6842105263157895,50,26,24,242.8119871629356,0.4114567983102466,0.6744917103563342,0.1644310594938061,1093276.4146498747,25892.123751901316,1119168.538401776,498,29,304.1794871794872,70,47,39,32.253255317954775,0.6513392857142857,38.60035211267607,8364.788732394394,119.49698189134848,0
500,32,0,0,117,0.0,0.0,1.0,117,2900,2300,600,0.7931034482758621,35,23,12,239.6191150331506,0.4107322674133019,0.6714709967118442,0.16320514527848423,1094892.2021331931,26171.420106370555,1121063.6222395636,499,30,305.1794871794872,61,56,40,32.138995932348536,0.6588114754098361,38.40725806451612,8370.967741935472,137.22897937599134,0
501,32,1,0,118,0.00847457627118644,0.0,1.0,118,3050,2200,850,0.7213114754098361,39,22,17,239.57786134393365,0.41127046211791973,0.6747080491614277,0.16413830716826028,1096535.8656322593,25891.143515019034,1122427.0091472783,500,0,303.58474576271186,62,56,39,31.939093454599025,0.660114247311828,38.21097883597883,8377.248677248663,135.11691414917198,0
502,32,1,0,119,0.008403361344537815,0.0,1.0,119,3250,2300,950,0.7076923076923077,42,23,19,238.9702226889374,0.4121504534016997,0.6755389380421764,0.16438254712239045,1097659.1715976344,25411.571334648295,1123070.7429322829,501,0,302.02521008403363,64,55,43,31.817741474955117,0.66015625,38.07692307692308,8381.538461538472,130.96153846153862,0
503,32,0,1,118,0.0,0.008403361344537815,0.9915966386554622,119,3200,1900,1300,0.59375,45,19,26,237.21410944984743,0.41191900489009164,0.6729573757213723,0.16352799903934673,1098261.6569737785,25104.632180389774,1123366.2891541682,502,1,303.02521008403363,65,54,39,31.79016064257028,0.6602564102564102,38.005050505050505,8383.838383838387,128.98212898212904,0
504,32,0,0,118,0.0,0.0,1.0,118,3300,2400,900,0.7272727272727273,42,24,18,237.46263461366976,0.41196158674972233,0.671461117892024,0.16419791199004252,1099107.092027423,25299.373159080104,1124406.465186503,503,2,302.52542372881356,66,52,34,31.680433622019233,0.6606691919191919,37.904228855721385,8387.0646766169,127.07673752449847,0
505,32,0,0,118,0.0,0.0,1.0,118,3800,2600,1200,0.6842105263157895,50,26,24,239.00607403185603,0.41142890772128066,0.6742945280430981,0.1656779650488139,1099799.449881055,25171.74974769319,1124971.199628748,504,3,303.52542372881356,67,51,36,31.555470347648264,0.6609141791044777,37.82169117647059,8389.705882352939,125.21949078138715,0
506,32,0,1,117,0.0,0.00847457627118644,0.9915254237288136,118,4400,3600,800,0.8181818181818182,52,36,16,241.10166319577075,0.41096413395142206,0.6767161739793195,0.1677951201353522,1100898.469356833,25085.690394322293,1125984.1597511554,505,4,304.52542372881356,70,48,36,31.366407517198958,0.6605654761904762,37.69072769953053,8393.89671361505,119.91281019450071,0
507,32,0,1,116,0.0,0.008547008547008548,0.9914529914529915,117,3300,2500,800,0.7575757575757576,41,25,16,239.54086810485538,0.40912049317221727,0.6722330941509005,0.16715522536306496,1101637.4926987635,26077.44026758385,1127714.9329663473,506,6,308.0940170940171,70,47,38,31.317211816233332,0.6614583333333333,37.602699530516446,8396.71361502351,119.95305164319299,0
508,32,0,1,115,0.0,0.008620689655172414,0.9913793103448276,116,3100,2100,1000,0.6774193548387096,41,21,20,244.37348630369118,0.40784920039980005,0.6771640816182427,0.1713245612592095,1102923.427744536,27605.04863278987,1130528.4763773258,507,38,311.69827586206895,61,55,38,31.033561037520517,0.6685450819672132,37.449596774193544,8401.6129032258,137.7313590692754,0
509,32,0,0,115,0.0,0.0,1.0,115,3050,2600,450,0.8524590163934426,35,26,9,243.98559158532984,0.4080186880244088,0.6740126788783898,0.17148084675846784,1103611.3910584792,27803.05562554226,1131414.4466840215,508,39,313.7739130434783,62,53,38,30.95987576596994,0.6686827956989247,37.36772486772486,8404.23280423279,135.55214200375468,0
510,32,1,0,116,0.008620689655172414,0.0,1.0,116,3600,2800,800,0.7777777777777778,44,28,16,240.52915479739877,0.40868315842078956,0.6712585710026833,0.17033391166264783,1105684.113865933,26389.853076216783,1132073.9669421497,509,0,312.0603448275862,65,51,39,30.798210854947172,0.6692307692307693,37.121212121212125,8412.12121212122,129.41724941724954,0
511,32,0,0,116,0.0,0.0,1.0,116,3650,3100,550,0.8493150684931506,42,31,11,242.18354053307166,0.4085098075962019,0.6749031569188997,0.1721734863243649,1106746.5054586288,26757.157432915148,1133503.662891544,510,1,313.0603448275862,65,51,39,30.625400064010247,0.6705128205128206,36.9949494949495,8416.161616161631,129.4794094794097,0
512,32,0,2,114,0.0,0.017241379310344827,0.9827586206896551,116,3850,3200,650,0.8311688311688312,45,32,13,241.0399313261952,0.40845358570714646,0.6735916913755959,0.1720125841458271,1107782.0467188107,26353.941693098885,1134135.9884119097,511,2,314.0603448275862,67,49,34,30.52949923347112,0.6705534825870647,36.87193627450981,8420.098039215693,125.67310506292078,0
513,32,0,0,114,0.0,0.0,1.0,114,3400,2600,800,0.7647058823529411,42,26,16,243.38930999518928,0.407870478186617,0.6724006622864864,0.17421660566951816,1108606.9182991546,27764.614580144967,1136371.5328792995,512,3,317.79824561403507,65,49,35,30.367350201862713,0.6727564102564103,36.7739898989899,8423.232323232334,129.58818958818975,0
514,32,0,0,114,0.0,0.0,1.0,114,3050,2200,850,0.7213114754098361,39,22,17,242.29159426065848,0.40731252911038657,0.6710285456777463,0.1737911117663809,1109170.5070728448,27898.5380931165,1137069.0451659614,513,4,318.79824561403507,66,48,36,30.327723649247122,0.6728219696969697,36.707089552238806,8425.373134328358,127.65716870194481,0
515,32,0,0,114,0.0,0.0,1.0,114,3200,2400,800,0.75,40,24,16,241.90143903577015,0.40712169435387885,0.669641729160583,0.1740991580350052,1110087.6370634406,27706.35937229288,1137793.9964357335,514,5,319.79824561403507,66,48,37,30.226532680124347,0.6739267676767677,36.59825870646767,8428.855721393047,127.70993517262193,0
516,32,0,0,114,0.0,0.0,1.0,114,3500,2600,900,0.7428571428571429,44,26,18,238.56804297542757,0.40602843761320706,0.6657885770644671,0.17254736474442545,1111418.8269999314,26729.802896683643,1138148.629896615,515,6,320.79824561403507,57,57,40,30.15268313458261,0.6818347953216375,36.44037356321838,8433.908045976992,147.96329905222794,0
517,32,0,0,114,0.0,0.0,1.0,114,3200,2100,1100,0.65625,43,21,22,238.63306380426596,0.4057066061170626,0.6656137062210996,0.1734531422892613,1112756.7958201664,27108.112691116854,1139864.908511283,516,7,321.79824561403507,58,56,40,29.988590970966946,0.6826508620689655,36.28177966101695,8438.983050847457,145.49970777323202,0
518,32,0,0,114,0.0,0.0,1.0,114,3300,2300,1000,0.696969696969697,43,23,20,244.90903273529057,0.4056548543186876,0.6733820644409423,0.15571521614271291,1075190.7730102502,26564.786444769725,1101755.55945502,517,8,322.79824561403507,63,51,40,34.422743873087626,0.6334325396825398,40.771484374999986,8295.31249999997,131.67162698412653,8
519,32,0,0,114,0.0,0.0,1.0,114,2950,1900,1050,0.6440677966101694,40,19,21,248.87683248843655,0.4054057987890079,0.6790774178462411,0.1586843319603216,1076013.2934458181,27808.956037649,1103822.249483467,518,9,323.79824561403507,65,49,40,34.218284036272884,0.633173076923077,40.67234848484847,8298.48484848482,127.66899766899724,0
520,32,0,1,113,0.0,0.008771929824561403,0.9912280701754386,114,2750,2100,650,0.7636363636363637,34,21,13,250.25444816777403,0.4048559359312736,0.6820664506940861,0.16030584936918596,1077367.112482856,28373.182441701218,1105740.2949245572,519,10,324.79824561403507,53,61,40,34.01538804638717,0.6438679245283019,40.509259259259274,8303.703703703726,156.67365478686276,0
521,32,0,0,113,0.0,0.0,1.0,113,3050,2300,750,0.7540983606557377,38,23,15,249.18484807970958,0.4042384376316899,0.6774059633634641,0.16013017874489402,1078293.4400826476,28088.877410468573,1106382.3174931163,520,11,326.646017699115,54,59,41,33.928831983658,0.6440972222222222,40.39772727272729,8307.272727272752,153.8383838383843,0
522,32,0,0,113,0.0,0.0,1.0,113,3050,2100,950,0.6885245901639344,40,21,19,249.58150356102462,0.4039157975136958,0.6783004590818866,0.16105157651229926,1079496.2620464885,28234.460034013842,1107730.7220805022,521,12,327.646017699115,55,58,42,33.77017091568795,0.6446969696969698,40.252976190476204,8311.904761904787,151.1255411255416,0
523,32,1,0,114,0.008771929824561403,0.0,1.0,114,3000,1900,1100,0.6333333333333333,41,19,22,246.2327389267522,0.4047750737463127,0.6754847038753247,0.15961082991759712,1080804.517901404,27425.89133745432,1108230.4092388584,522,0,325.7631578947368,60,54,43,33.69593188786683,0.6423611111111112,40.09562841530056,8316.93989071041,138.61566484517348,0
524,32,1,0,115,0.008695652173913044,0.0,1.0,115,2850,2100,750,0.7368421052631579,36,21,15,245.26888833030623,0.4051264937706585,0.6776797810580375,0.1599954029916309,1082629.411485461,27257.062445746564,1109886.4739312076,523,0,323.9217391304348,63,52,40,33.4962770616944,0.642526455026455,39.876302083333336,8323.95833333334,132.12632275132285,0
525,32,0,0,115,0.0,0.0,1.0,115,3100,2100,1000,0.6774193548387096,41,21,20,248.37601279562404,0.4049199084668192,0.6805228744169609,0.1624951529321251,1083467.472057857,27721.46614069698,1111188.938198554,524,1,324.9217391304348,64,51,40,33.31229215420619,0.6429036458333333,39.77564102564103,8327.179487179492,130.11217948717956,0
526,32,0,1,114,0.0,0.008695652173913044,0.991304347826087,115,3500,2600,900,0.7428571428571429,44,26,18,245.95709740859147,0.40418255784388507,0.6781518364295283,0.16166756151487816,1084810.338853,26863.360436622967,1111673.699289623,525,2,325.9217391304348,66,49,40,33.21005990765069,0.6433080808080809,39.61442786069652,8332.338308457722,126.2475501281473,0
527,32,0,0,114,0.0,0.0,1.0,114,3550,2600,950,0.7323943661971831,45,26,19,245.07605747188342,0.4037254825855199,0.6748147503345916,0.16216592202346108,1086716.3811682528,26915.633257365625,1113632.0144256183,526,3,325.2280701754386,57,57,40,32.99874520478718,0.6518640350877193,39.38577586206897,8339.655172413799,146.30973986690876,0
528,32,0,0,114,0.0,0.0,1.0,114,3100,2400,700,0.7741935483870968,38,24,14,243.86412702819112,0.4036753480308441,0.6729011043317936,0.16193279801943933,1087719.3654441584,27151.146701139638,1114870.512145298,527,4,326.2280701754386,58,56,41,32.90715849584689,0.6522988505747127,39.26553672316385,8343.502824858768,143.85349698032357,0
529,32,0,0,114,0.0,0.0,1.0,114,3100,2300,800,0.7419354838709677,39,23,16,244.20016091711676,0.403216050820266,0.6724357828864156,0.16237851337476808,1088109.7656249998,27243.315972222215,1115353.081597222,528,5,327.2280701754386,59,55,40,32.85046767858331,0.6520127118644068,39.21875,8344.999999999998,141.44067796610167,0
530,32,0,1,113,0.0,0.008771929824561403,0.9912280701754386,114,3400,2400,1000,0.7058823529411765,44,24,20,227.81664743705434,0.4030446229881488,0.6534418128085115,0.1423784674786263,1070140.1941337117,22559.150263035957,1092699.3443967476,529,6,328.2280701754386,61,53,40,35.48927813508306,0.6285860655737705,41.38104838709676,8275.806451612878,135.66895822316192,8
531,32,0,1,112,0.0,0.008849557522123894,0.9911504424778761,113,2750,2000,750,0.7272727272727273,35,20,15,227.32468861886295,0.4025758533501896,0.6501802027992485,0.14274285278419624,1071531.0702465563,23367.093377846875,1094898.163624403,530,7,328.05309734513276,61,52,42,35.33017107057066,0.6302937158469946,41.213037634408586,8281.182795698893,135.75709501145727,0
532,32,0,0,112,0.0,0.0,1.0,112,3850,2900,950,0.7532467532467533,48,29,19,225.29262239534756,0.4023839687902188,0.6432927941901005,0.14189991478142958,1072430.1006410755,22072.1179418267,1094502.218582902,531,8,327.26785714285717,62,50,42,35.27177268276069,0.6307123655913979,41.10449735449734,8284.656084656053,133.62348523638795,0
533,32,1,0,113,0.008849557522123894,0.0,1.0,113,3250,2300,950,0.7076923076923077,42,23,19,225.5880149817317,0.4031289506953224,0.6471660397682739,0.14291955431914746,1074146.2195923752,22612.902695595105,1096759.1222879703,532,0,325.3628318584071,64,49,41,35.05239258617847,0.6315104166666667,40.897435897435905,8291.282051282065,129.55128205128227,0
534,32,0,0,113,0.0,0.0,1.0,113,3850,3200,650,0.8311688311688312,45,32,13,224.22034147042717,0.4030663980193847,0.6460494797403895,0.1428350519588078,1075751.3622653312,21791.067556882,1097542.4298222132,533,1,326.3628318584071,65,48,41,34.88996845009839,0.6328525641025642,40.703914141414145,8297.474747474756,127.65345765345779,0
535,32,0,0,113,0.0,0.0,1.0,113,2250,1300,950,0.5777777777777777,32,13,19,227.34902137246297,0.4027075431942688,0.6512917850091193,0.14508937928597654,1076277.211578921,24088.11415559018,1100365.325734511,534,2,327.3628318584071,66,47,41,34.74403548735162,0.6328914141414141,40.64054726368159,8299.502487562186,125.75003769033614,0
536,32,0,0,113,0.0,0.0,1.0,113,2700,1500,1200,0.5555555555555556,39,15,24,229.76589978466285,0.40271741993257476,0.6548696651715677,0.14714028013660996,1077285.6668342461,24204.702113058374,1101490.3689473046,535,3,328.3628318584071,58,55,41,34.55708081014265,0.6395474137931034,40.51906779661018,8303.389830508499,143.16189362945687,0
537,32,0,1,112,0.0,0.008849557522123894,0.9911504424778761,113,3750,2500,1250,0.6666666666666666,50,25,25,228.54339277503541,0.4019272808680994,0.6527311164039262,0.14698704499795456,1078533.3243751705,22948.333034727977,1101481.6574098985,536,4,329.3628318584071,60,53,42,34.43515412610716,0.6395833333333334,40.3688524590164,8308.196721311495,138.46994535519158,0
538,32,0,0,112,0.0,0.0,1.0,112,3650,2700,950,0.7397260273972602,46,27,19,213.1727097129377,0.4018829096954097,0.6206645680030451,0.12767684634934412,1057422.4891057278,19032.72346281333,1076455.212568541,537,5,332.2232142857143,72,40,39,37.44218102427471,0.6064814814814814,42.92237442922373,8226.48401826481,114.25672247590013,8
539,32,1,0,113,0.008849557522123894,0.0,1.0,113,3250,2500,750,0.7692307692307693,40,25,15,212.0807337943295,0.40291495469869365,0.623226780936702,0.12767260174418596,1058964.1317846416,19067.17802615225,1078031.309810794,538,0,330.27433628318585,77,36,41,37.27894864341083,0.6060606060606061,42.735042735042725,8232.47863247861,106.91530691530662,0
540,32,0,0,113,0.0,0.0,1.0,113,3500,2300,1200,0.6571428571428571,47,23,24,209.0098264974828,0.40269437420986093,0.6178976620917287,0.12625215417231428,1059988.216824,18209.590657552,1078197.807481552,539,1,331.27433628318585,63,50,39,37.23098731082164,0.6147486772486772,42.61067708333333,8236.45833333332,130.73743386243365,0
541,32,1,0,114,0.008771929824561403,0.0,1.0,114,3150,2400,750,0.7619047619047619,39,24,15,203.036768631019,0.4045729182839104,0.6106145670991601,0.12345164044961995,1061960.5590397953,17173.408064206244,1079133.9671040014,540,0,329.359649122807,67,47,43,37.14051413168429,0.6147388059701493,42.371323529411775,8244.117647058847,123.04653204565443,0
542,32,1,0,115,0.008695652173913044,0.0,1.0,115,3600,2700,900,0.75,45,27,18,199.54485029574974,0.40561276379354183,0.6064194158180387,0.12218780338446392,1064073.43441894,15866.074834962423,1079939.5092539024,541,0,327.4869565217391,71,44,43,36.969202898550776,0.6151701877934272,42.115162037037045,8252.314814814827,116.22978612415248,0
543,32,0,1,114,0.0,0.008695652173913044,0.991304347826087,115,2750,1800,950,0.6545454545454545,37,18,19,201.13640918162218,0.40545067378591404,0.6102230782733733,0.12357279695592666,1065066.4113811255,17094.72670503136,1082161.138086157,542,1,328.4869565217391,72,43,40,36.805440333314884,0.6158854166666667,41.99486301369864,8256.16438356167,114.66894977168987,0
544,32,0,0,114,0.0,0.0,1.0,114,3100,2000,1100,0.6451612903225806,42,20,22,204.1022022159798,0.4046796563680588,0.6111966037721397,0.1255570996987701,1065451.7186105049,17592.208424641,1083043.927035146,543,3,332.359649122807,73,41,41,36.68130409484327,0.6158675799086758,41.948198198198206,8257.657657657677,113.11859805010516,0
545,32,1,0,115,0.008695652173913044,0.0,1.0,115,2550,1400,1150,0.5490196078431373,37,14,23,203.62800659136195,0.4066615814899568,0.6134276142329571,0.12239856411574264,1058507.0526508112,17558.33621883632,1076065.3888696474,544,0,330.46086956521737,75,40,43,37.55306582827098,0.6063888888888889,42.79057017543858,8230.70175438593,109.74269005847906,8
546,32,1,0,116,0.008620689655172414,0.0,1.0,116,3200,2000,1200,0.625,44,20,24,199.8735059019412,0.4075540354822589,0.6094446975013021,0.12091699568711411,1060445.6368944657,15990.997452902844,1076436.6343473685,545,0,328.6034482758621,67,49,44,37.40950652544726,0.6128731343283582,42.555147058823536,8238.235294117663,122.95873573309945,0
547,32,0,0,116,0.0,0.0,1.0,116,3200,2300,900,0.71875,41,23,18,198.5094631346239,0.40738380809595204,0.6063285754415175,0.12058266178234606,1061671.3962111175,15750.363777451275,1077421.7599885687,546,1,329.6034482758621,68,48,47,37.29292426107172,0.6138174019607843,42.40640096618359,8242.995169082158,121.22051719238468,0
548,32,1,0,117,0.008547008547008548,0.0,1.0,117,2950,1800,1150,0.6101694915254238,41,18,23,198.677400992962,0.4078157235484822,0.6100781460522766,0.12106598277255877,1062617.3611111126,15873.611111111186,1078490.9722222239,547,0,327.77777777777777,69,48,45,37.17158447857722,0.6144323671497585,42.29166666666667,8246.666666666679,119.51690821256057,0
549,32,1,0,118,0.00847457627118644,0.0,1.0,118,3450,2800,650,0.8115942028985508,41,28,13,198.130187294219,0.40815134724033025,0.6121485727980451,0.12117625936710985,1063715.2911736998,15100.821973594097,1078816.113147294,548,0,325.99152542372883,71,47,49,37.04994763026971,0.6147300469483568,42.158564814814824,8250.925925925949,116.21022430881618,0
550,32,1,1,118,0.008403361344537815,0.008403361344537815,0.9915966386554622,119,3300,2700,600,0.8181818181818182,39,27,12,195.3035916033294,0.40910898257608125,0.6096814432443936,0.11983394802935766,1064680.0277777836,14487.166666667003,1079167.1944444505,549,0,324.2436974789916,74,45,39,37.00364776826578,0.6144425675675675,42.041666666666686,8254.666666666712,111.54954954955015,0
551,32,3,2,119,0.024793388429752067,0.01652892561983471,0.9834710743801653,121,2950,2100,850,0.711864406779661,38,21,17,196.00958531277234,0.4120408631772268,0.6169664710906217,0.12107505822482954,1066674.074530652,14665.66860252793,1081339.7431331798,550,0,319.8595041322314,77,44,44,36.73925037067689,0.615530303030303,41.8002136752137,8262.393162393217,107.30380730380801,0
552,32,2,0,121,0.01652892561983471,0.0,1.0,121,4150,3100,1050,0.7469879518072289,52,31,21,193.33214456276892,0.41230486685032136,0.6126835444774714,0.11996835725517507,1068031.0607698956,12946.94708765854,1080978.0078575541,551,0,320.801652892562,67,54,46,36.64102336060711,0.6222014925373134,41.6360294117647,8267.647058823524,123.39771729587349,0
553,32,1,0,122,0.00819672131147541,0.0,1.0,122,3800,2800,1000,0.7368421052631579,48,28,20,191.0971445463297,0.41288302172244046,0.6125202583254887,0.11937045930719299,1069993.2114512436,12694.529478457875,1082687.7409297016,552,0,319.1639344262295,69,53,48,36.45701461618139,0.6234903381642511,41.39880952380951,8275.238095238068,119.93098688750824,0
554,32,1,0,123,0.008130081300813009,0.0,1.0,123,3350,2200,1150,0.6567164179104478,45,22,23,186.7618655710378,0.41366786618685863,0.6063150016123926,0.11703021913842868,1070921.9808913677,12051.477406460772,1082973.4582978284,553,0,317.5609756097561,73,50,49,36.454819359051115,0.622574200913242,41.286599099099114,8278.828828828855,113.40861409354596,0
555,32,3,2,124,0.023809523809523808,0.015873015873015872,0.9841269841269842,126,3350,2400,950,0.7164179104477612,43,24,19,183.26007406468233,0.4170939153439153,0.6089555777741302,0.11579859333473327,1073376.7287906925,10791.419763497866,1084168.1485541903,554,0,310.9761904761905,76,50,42,36.24364532191236,0.6241776315789473,40.99025974025975,8288.31168831171,109.05673274094356,0
556,32,1,1,124,0.008,0.008,0.992,125,4000,3100,900,0.775,49,31,18,180.44737722566077,0.41689247311827954,0.5998809051210776,0.11449545169557715,1074592.4571118949,9781.478094464137,1084373.935206359,555,0,312.072,80,45,43,36.16721251819502,0.6239583333333334,40.84362139917697,8293.004115226375,103.66255144032968,0
557,32,0,1,123,0.0,0.008064516129032258,0.9919354838709677,124,4150,3000,1150,0.7228915662650602,53,30,23,181.39222434268345,0.4166311521986188,0.5987313471760556,0.11543604323697636,1075457.526212079,10065.926573137825,1085523.4527852167,556,1,313.7016129032258,81,43,46,36.03654229343266,0.6246141975308642,40.73932926829269,8296.341463414656,102.42396868413155,0
558,32,0,1,122,0.0,0.008130081300813009,0.991869918699187,123,3050,2200,850,0.7213114754098361,39,22,17,183.4602475586601,0.4156226398329557,0.6001489191269169,0.11704659324629858,1076192.7832181745,11837.718886009941,1088030.5021041844,557,2,317.2276422764228,80,43,47,35.89269185633298,0.6259114583333334,40.650720164609055,8299.17695473251,103.73971193415636,0
559,32,0,1,121,0.0,0.00819672131147541,0.9918032786885246,122,3300,2100,1200,0.6363636363636364,45,21,24,182.5968761431472,0.4147670821478571,0.5946002605953842,0.11697738156444472,1077394.5719954586,11645.77664399056,1089040.348639449,558,3,320.78688524590166,69,53,48,35.76767213365445,0.6325483091787439,40.50595238095236,8303.809523809474,120.34506556245614,0
560,32,1,0,122,0.00819672131147541,0.0,1.0,122,3250,2400,850,0.7384615384615385,41,24,17,183.29259910854458,0.4152045793252947,0.5957329255427048,0.11801002952426765,1078843.0736020142,11898.790198152616,1090741.8638001669,559,0,320.0327868852459,70,52,51,35.57204267661072,0.6337797619047619,40.331572769953034,8309.389671361465,118.70556673373521,0
561,32,1,0,123,0.008130081300813009,0.0,1.0,123,3350,2300,1050,0.6865671641791045,44,23,21,183.02175444960224,0.4155837664934026,0.5965839461810141,0.1184859285560502,1080436.842564787,11598.68929963901,1092035.531864426,560,0,318.4227642276423,72,51,49,35.38383394651584,0.634693287037037,40.139840182648385,8315.52511415521,115.49340436326682,0
562,32,0,0,123,0.0,0.0,1.0,123,3500,2600,900,0.7428571428571429,44,26,18,184.06741253295485,0.41517559642809543,0.6007408180766036,0.11970294044166668,1081742.4704447342,11722.707512353658,1093465.1779570878,561,1,319.4227642276423,72,51,44,35.19680880254634,0.6362847222222222,39.98287671232876,8320.547945205464,115.56316590563145,0
563,32,0,1,122,0.0,0.008130081300813009,0.991869918699187,123,3900,2800,1100,0.717948717948718,50,28,22,183.1204875063875,0.4150506464081034,0.5994994269058678,0.11965106705466219,1083102.7438271623,11167.660493827236,1094270.4043209895,562,2,320.4227642276423,74,49,44,35.05500542714281,0.6369650900900901,39.81944444444445,8325.777777777792,112.5105105105107,0
564,32,0,0,122,0.0,0.0,1.0,122,4000,3200,800,0.8,48,32,16,214.09700008529768,0.4139273698234205,0.6506626231055479,0.13789408607317485,1078950.6439830824,17800.019223375544,1096750.6632064579,563,4,324.0327868852459,67,55,42,34.75892716690262,0.6355721393034826,40.31862745098039,8309.803921568619,124.0269242025167,8
565,32,1,0,123,0.008130081300813009,0.0,1.0,123,3150,2100,1050,0.6666666666666666,42,21,21,212.154718705513,0.41412046292594074,0.6478567609287538,0.1372784593368152,1080294.1142150327,18087.898784102246,1098382.0129991348,564,0,322.390243902439,68,55,45,34.644313076148414,0.6366421568627452,40.15700483091787,8314.975845410616,122.27905655015611,0
566,32,0,1,122,0.0,0.008130081300813009,0.991869918699187,123,3600,2700,900,0.75,45,27,18,211.3194703674104,0.41414822959705005,0.6470034063099568,0.13709070144633503,1081038.5705272323,17488.89963411142,1098527.4701613437,565,1,323.390243902439,70,53,44,34.57460819175559,0.6364583333333333,40.0674882629108,8317.840375586855,118.82629107981221,0
567,32,1,2,121,0.008130081300813009,0.016260162601626018,0.983739837398374,123,2450,1500,950,0.6122448979591837,34,15,19,211.48029689550583,0.41369563285796795,0.647259548463607,0.13792752529904048,1082573.7350399296,18738.602979504238,1101312.338019434,566,0,324.1788617886179,72,51,39,34.382028635690396,0.6372974537037037,39.88299086757991,8323.744292237454,115.60755961440908,0
568,32,0,1,120,0.0,0.008264462809917356,0.9917355371900827,121,3650,2600,1050,0.7123287671232876,47,26,21,216.23249296618803,0.4128529614325069,0.6496297491650318,0.14120167663895225,1082930.0890306733,18982.934571839793,1101913.0236025131,567,3,327.5289256198347,72,49,39,34.21468206084542,0.6377314814814814,39.840182648401836,8325.11415525116,115.62658548959945,0
569,32,1,0,121,0.008264462809917356,0.0,1.0,121,2750,2100,650,0.7636363636363637,34,21,13,218.33593028624162,0.4131600091827365,0.6542853777004491,0.14304767846339997,1083880.6530305897,20380.018139738666,1104260.6711703283,568,0,328.495867768595,72,49,41,34.04331140350878,0.6388888888888888,39.72602739726028,8328.76712328769,115.67732115677346,0
570,32,0,1,120,0.0,0.008264462809917356,0.9917355371900827,121,3700,2900,800,0.7837837837837838,45,29,16,218.5134994306497,0.41308539944903583,0.6542954196371342,0.14370155679068647,1084955.2296139249,19515.47278970479,1104470.7024036297,569,1,329.495867768595,75,46,41,33.90688325701354,0.6387499999999999,39.59703947368423,8332.894736842145,111.10526315789527,0
571,32,0,0,120,0.0,0.0,1.0,120,3500,2200,1300,0.6285714285714286,48,22,26,221.8114584552514,0.4120579481792717,0.6551878344890767,0.14641385630899914,1086019.0878974136,20678.295559353737,1106697.3834567673,570,2,333.15833333333336,63,57,41,33.690533828949825,0.6466600529100529,39.46940104166669,8336.97916666672,132.3330026455035,0
572,32,0,0,120,0.0,0.0,1.0,120,3600,2300,1300,0.6388888888888888,49,23,26,220.58037708862489,0.41185807656395895,0.6535068568968689,0.14586651125815972,1086538.9587442533,20333.834648258122,1106872.7933925113,571,3,334.15833333333336,64,56,41,33.65888219256709,0.6466471354166667,39.407051282051306,8338.974358974407,130.2964743589751,0
573,32,0,1,119,0.0,0.008333333333333333,0.9916666666666667,120,2250,1000,1250,0.4444444444444444,35,10,25,220.70255649321186,0.41180701447245566,0.6530242496521561,0.14652343121105227,1087662.2020494598,21759.96571867066,1109422.1677681305,572,4,335.15833333333336,66,54,43,33.51806300934209,0.646780303030303,39.27238805970151,8343.283582089594,126.4133876074181,0
574,32,0,0,119,0.0,0.0,1.0,119,3150,2200,950,0.6984126984126984,41,22,19,243.12085778689232,0.411013981863932,0.6840046943147009,0.1594643106586467,1084201.5625,25768.40277777779,1109969.9652777778,573,5,335.3193277310924,69,50,40,33.358760170734946,0.6408514492753623,39.6875,8330.0,120.72463768115942,8
575,32,0,0,119,0.0,0.0,1.0,119,3700,2500,1200,0.6756756756756757,49,25,24,242.82184186514428,0.41102585101837347,0.6832733379025098,0.15992433818418356,1085379.4864299858,25210.76920351456,1110590.2556335004,574,6,336.3193277310924,55,64,42,33.2217421320764,0.6518939393939394,39.54613095238094,8334.523809523787,151.53679653679615,0
576,32,2,0,121,0.01652892561983471,0.0,1.0,121,4100,3000,1100,0.7317073170731707,52,30,22,233.66864000456326,0.4127496556473829,0.6747527980729557,0.15562872741616712,1088572.491220087,22573.050713955607,1111145.5419340427,575,0,331.74380165289256,61,60,42,33.06837090713905,0.6511270491803278,39.16330645161292,8346.774193548417,136.83236382866258,0
577,32,0,0,121,0.0,0.0,1.0,121,2750,1900,850,0.6909090909090909,36,19,17,230.39631034874853,0.4120867768595042,0.6697797810131292,0.15383103920036667,1089278.161790641,23243.133884006387,1112521.2956746474,576,1,332.74380165289256,63,58,46,33.067247312498694,0.6506283068783069,39.078776041666686,8349.479166666706,132.53141534391597,0
578,32,0,1,120,0.0,0.008264462809917356,0.9917355371900827,121,3700,2600,1100,0.7027027027027027,48,26,22,213.07811874300214,0.41185146923783283,0.6385560363907159,0.12956129289086002,1061970.3997301408,17356.530987050508,1079326.9307171914,577,2,333.74380165289256,76,45,37,36.88060106420222,0.6101973684210527,42.37012987012987,8244.15584415585,108.47573479152435,8
579,32,0,0,120,0.0,0.0,1.0,120,3000,2100,900,0.7,39,21,18,209.88201357309455,0.41097251400560225,0.6306738691123888,0.12797829320528098,1062815.6075361585,17613.17595332009,1080428.7834894785,578,3,337.5083333333333,77,43,38,36.85828928960048,0.6107954545454546,42.2676282051282,8247.435897435882,107.1095571095569,0
580,32,1,0,121,0.008264462809917356,0.0,1.0,121,3000,2100,900,0.7,39,21,18,206.89934095949081,0.41235651974288334,0.6298611659826445,0.12673799592316554,1064183.7607265562,16835.78375082333,1081019.5444773794,579,0,335.7107438016529,78,43,42,36.765896347802354,0.6120459401709402,42.10179324894514,8252.742616033745,105.80439251325315,0
581,32,1,0,122,0.00819672131147541,0.0,1.0,122,3400,2300,1100,0.6764705882352942,45,23,22,206.64012056312401,0.41364793614234746,0.632974364105944,0.12733065309054456,1065948.7006293433,16253.553602430742,1082202.254231774,580,0,333.95081967213116,79,43,39,36.55439178395469,0.613792194092827,41.88802083333334,8259.583333333358,104.55168776371339,0
582,32,1,0,123,0.008130081300813009,0.0,1.0,123,3300,2200,1100,0.6666666666666666,44,22,22,204.21436004162248,0.4138150295437381,0.6325072121688944,0.12661290322580643,1067777.7777777822,15711.111111111299,1083488.8888888934,581,0,332.2276422764228,83,40,42,36.391129032258085,0.6144578313253012,41.66666666666668,8266.6666666667,99.5983935742976,0
583,32,0,0,123,0.0,0.0,1.0,123,3400,2300,1100,0.6764705882352942,45,23,22,209.32689901126125,0.4134124128126527,0.639247111291849,0.13024864726179938,1068839.6854996781,16747.37938116397,1085587.064880842,582,1,333.2276422764228,72,51,40,36.12794217780967,0.6205150462962963,41.538242009132425,8270.776255707773,114.87189244038574,0
584,32,1,0,124,0.008064516129032258,0.0,1.0,124,3400,2400,1000,0.7058823529411765,44,24,20,208.09868042135932,0.4141383097298715,0.6396078246966979,0.12986376467578417,1069704.8160251272,16320.832131040548,1086025.6481561677,583,0,331.53225806451616,75,49,42,36.0529309126248,0.6201388888888889,41.43366228070177,8274.122807017575,110.32163742690099,0
585,32,1,2,123,0.008,0.016,0.984,125,3800,2800,1000,0.7368421052631579,48,28,20,209.93384740115616,0.4154274193548387,0.6479958180867758,0.13184617533762674,1071583.4715428846,16192.328198496947,1087775.7997413815,584,0,329.872,76,49,40,35.77376285067086,0.621984649122807,41.20670995670995,8281.385281385263,108.96559580770082,0
586,32,1,0,124,0.008064516129032258,0.0,1.0,124,2750,1600,1150,0.5818181818181818,39,16,23,211.0157642016521,0.41577334120115395,0.6488121579131239,0.1331033073477565,1072862.1635071957,17728.165863101738,1090590.3293702975,585,0,327.0725806451613,77,47,44,35.58814681107099,0.6231060606060606,41.052350427350426,8286.324786324787,107.61460761460762,0
587,32,0,1,123,0.0,0.008064516129032258,0.9919354838709677,124,2850,1700,1150,0.5964912280701754,40,17,23,211.12537226571646,0.4152857002360346,0.6481426683637477,0.13355609797222392,1073706.122504343,17687.320963541802,1091393.4434678848,586,1,328.0725806451613,79,45,37,35.48132906090308,0.6232858649789029,40.95052083333334,8289.583333333356,104.9314345991564,0
588,32,0,0,123,0.0,0.0,1.0,123,4150,3100,1050,0.7469879518072289,52,31,21,215.5717703997117,0.41585032653605225,0.6521062309373384,0.13698978433528894,1075036.0054572367,17599.482987970216,1092635.4884452068,587,2,329.650406504065,81,42,39,35.20230948296985,0.6240997942386831,40.79014227642277,8294.715447154489,102.40389440931467,0
589,32,0,1,122,0.0,0.008130081300813009,0.991869918699187,123,3300,2400,900,0.7272727272727273,42,24,18,216.85190273895967,0.41578368652538983,0.6556768198100784,0.13830151810108943,1076089.962262049,18770.43116696423,1094860.3934290132,588,3,330.650406504065,81,42,39,35.039339946118055,0.6253858024691358,40.66310975609757,8298.7804878049,102.45408009635678,0
590,32,0,0,122,0.0,0.0,1.0,122,4200,3200,1000,0.7619047619047619,52,32,20,216.04837181688245,0.4145638576525313,0.652324565428148,0.1380626376042879,1076668.2608917484,17922.48495051541,1094590.7458422638,589,4,334.3196721311475,65,57,40,34.988997728563334,0.6339743589743589,40.59343434343435,8301.01010101012,127.70784770784802,0
591,32,1,0,123,0.008130081300813009,0.0,1.0,123,2050,1400,650,0.6829268292682927,27,14,13,213.33682544880315,0.41617797325514244,0.6508134400196552,0.13680365241308223,1077678.0715349899,19331.68372741272,1097009.7552624026,590,0,332.5934959349593,67,56,41,34.93512178806122,0.6340174129353233,40.47181372549021,8304.90196078434,123.9537606087215,0
592,32,0,1,122,0.0,0.008130081300813009,0.991869918699187,123,3950,2600,1350,0.6582278481012658,53,26,27,209.33282643376182,0.41565873650539786,0.64288397021613,0.13459253208003802,1078448.595169969,16600.938518089944,1095049.5336880588,591,1,333.5934959349593,71,52,40,34.94433221881675,0.6327758215962441,40.37905092592593,8307.870370370381,117.012258737611,0
593,32,0,0,122,0.0,0.0,1.0,122,4100,3100,1000,0.7560975609756098,51,31,20,210.64464008558684,0.41462877658853814,0.6424469562046866,0.13604617914919967,1079751.9012345697,16988.790123456878,1096740.6913580266,592,2,337.0,74,48,39,34.75014257199888,0.6328828828828829,40.22222222222223,8312.888888888903,112.33633633633653,0
594,32,1,0,123,0.008130081300813009,0.0,1.0,123,3650,2600,1050,0.7123287671232876,47,26,21,257.82918508908614,0.41516171309254074,0.706789243442266,0.16084844216867974,1069613.721109918,26905.526814775134,1096519.2479246932,593,0,335.2520325203252,60,63,36,34.77836118266077,0.6286458333333333,41.44467213114755,8273.77049180329,137.89617486338818,8
595,32,2,1,124,0.016,0.008,0.992,125,3650,2900,750,0.7945205479452054,44,29,15,250.36776777307435,0.41712096774193547,0.7023676097319378,0.15754540525276536,1072154.0475016483,25036.563116371144,1097190.6106180195,594,0,330.872,64,61,39,34.65674590891271,0.6290690104166667,41.13782051282053,8283.58974358978,129.43108974359032,0
596,32,1,1,124,0.008,0.008,0.992,125,3550,2300,1250,0.647887323943662,48,23,25,243.0515103952895,0.4169569892473118,0.6918818298105622,0.1540014143635457,1074180.444756913,23666.23590705032,1097846.6806639633,595,0,331.712,65,60,38,34.595680798359425,0.6309294871794872,40.89330808080808,8291.414141414145,127.56021756021761,0
597,32,0,0,124,0.0,0.0,1.0,124,3750,2800,950,0.7466666666666667,47,28,19,247.72511783187187,0.41576924337791765,0.6966703729095896,0.15724368611972095,1074703.9563883825,24696.232846138413,1099400.1892345208,596,1,335.3790322580645,65,59,38,34.40988926780749,0.6315705128205128,40.83017676767678,8293.434343434374,127.59129759129806,0
598,32,1,0,125,0.008,0.0,1.0,125,4350,3400,950,0.7816091954022989,53,34,19,243.36116144450125,0.4171962365591398,0.6950825595984951,0.15566520519363342,1076946.682400172,23067.399088541606,1100014.0814887136,597,0,333.688,63,62,37,34.24613132580511,0.6355820105820106,40.55989583333333,8302.083333333321,131.77910052910033,0
599,32,0,0,125,0.0,0.0,1.0,125,3100,2300,800,0.7419354838709677,39,23,16,242.6128177170022,0.4170779569892473,0.6947757150025091,0.15547503077491484,1077487.2504340268,24182.44357638885,1101669.6940104156,598,1,334.688,63,62,38,34.19886268606792,0.6362433862433863,40.494791666666664,8304.16666666666,131.8121693121692,0
600,32,0,1,124,0.0,0.008,0.992,125,2850,1800,1050,0.631578947368421,39,18,21,242.99240464410795,0.41707258064516134,0.6955569549916647,0.1559947672620144,1078002.9955621317,24539.30802103888,1102542.3035831705,599,2,335.688,64,61,40,34.12540388137723,0.63623046875,40.432692307692314,8306.153846153858,129.78365384615404,0
601,32,0,0,124,0.0,0.0,1.0,124,3200,2200,1000,0.6875,42,22,20,242.30539212306476,0.4161161924119241,0.6930826097861003,0.1561973422731261,1079201.3313609473,24299.260355029655,1103500.591715977,600,3,339.0,64,60,39,33.99551092188077,0.6376953125,40.28846153846154,8310.769230769236,129.8557692307693,0
602,32,0,0,124,0.0,0.0,1.0,124,3250,2100,1150,0.6461538461538462,44,21,23,240.53540616579818,0.4157842687297841,0.6917614972256181,0.15566725342428075,1080339.761248852,23921.9926538108,1104261.7539026628,601,4,340.0,65,59,39,33.901239067055386,0.6384615384615384,40.15151515151515,8315.151515151512,127.92540792540788,0
603,32,1,0,125,0.008,0.0,1.0,125,3750,2900,850,0.7733333333333333,46,29,17,242.97289097963542,0.4164704301075269,0.6979530007656525,0.15836609274254224,1082390.3404039296,23848.302035274835,1106238.6424392045,602,0,338.272,67,58,35,33.58542169739089,0.6397699004975124,39.905024509803916,8323.039215686262,124.2244659057651,0
604,32,0,0,125,0.0,0.0,1.0,125,3200,2200,1000,0.6875,42,22,20,253.1881509592714,0.4164327956989247,0.7010137769690659,0.1578630172998892,1069445.0948086479,25954.16522141282,1095399.2600300608,603,1,339.272,61,64,39,34.919255263841954,0.6277322404371585,41.46505376344086,8273.118279569888,135.62488982901456,8
605,32,1,0,126,0.007936507936507936,0.0,1.0,126,3500,2500,1000,0.7142857142857143,45,25,20,254.19731492693504,0.4173452380952381,0.7060976125120764,0.15981085377130919,1071888.564266931,25794.23898750833,1097682.8032544393,604,0,337.57142857142856,64,62,41,34.590479433678006,0.6287434895833333,41.1698717948718,8282.564102564114,129.4150641025643,0
606,32,1,0,127,0.007874015748031496,0.0,1.0,127,4100,3100,1000,0.7560975609756098,51,31,20,253.07708175021327,0.41798421030704497,0.7061685144599081,0.1601117294978622,1073737.8689987017,24847.68929017685,1098585.5582888785,605,0,335.90551181102364,67,60,37,34.39064563499106,0.6291977611940298,40.94669117647059,8289.705882352937,123.72695346795429,0
607,32,1,0,128,0.0078125,0.0,1.0,128,3600,2500,1100,0.6944444444444444,47,25,22,248.30840450707845,0.4187146284448819,0.7032523344651957,0.1579413069704848,1075310.57825828,24201.730807379383,1099512.3090656593,606,0,334.2734375,70,58,39,34.31982173174872,0.6294642857142857,40.75704225352112,8295.774647887309,118.51106639839013,0
608,32,0,0,128,0.0,0.0,1.0,128,4350,2900,1450,0.6666666666666666,58,29,29,247.57665198948445,0.4187248810695538,0.7025288654618476,0.15806817011636276,1076406.2499999967,23348.611111110866,1099754.8611111075,607,1,335.2734375,60,68,41,34.20348058902273,0.6369791666666667,40.624999999999986,8299.999999999975,138.33333333333292,0
609,32,0,0,128,0.0,0.0,1.0,128,3200,2000,1200,0.625,44,20,24,247.99220198951608,0.41900554666994755,0.7037021487536421,0.158865182900376,1077382.613777601,24636.497355185325,1102019.1111327861,608,2,336.2734375,61,67,39,34.072178159059,0.6374658469945356,40.507392473118266,8303.763440860188,136.12726952229815,0
610,32,0,0,128,0.0,0.0,1.0,128,3150,2200,950,0.6984126984126984,41,22,19,244.1398092226871,0.41922854125656167,0.6984827614583995,0.15681779368878845,1078163.1512112035,23894.509209526597,1102057.6604207302,609,3,337.2734375,63,65,41,34.07586943800029,0.6370701058201058,40.413411458333314,8306.770833333292,131.85350529100464,0
611,32,0,0,128,0.0,0.0,1.0,128,2950,2200,750,0.7457627118644068,37,22,15,254.11536294801334,0.4191990649606299,0.7094619519392917,0.15673593931607813,1066236.0461374745,25639.391970495955,1091875.4381079704,610,4,338.2734375,66,62,37,35.29332791295269,0.6205808080808081,41.85323383084578,8260.696517412956,125.16206844565086,8
612,32,1,0,129,0.007751937984496124,0.0,1.0,129,3300,2100,1200,0.6363636363636364,45,21,24,252.12135469277914,0.4196670098514212,0.7116974894460595,0.15638966687769862,1067918.948199413,24749.034384425013,1092667.982583838,611,0,336.6434108527132,60,69,39,35.13602463260404,0.6265625,41.64959016393444,8267.213114754131,137.7868852459022,0
613,32,0,0,129,0.0,0.0,1.0,129,3500,2500,1000,0.7142857142857143,45,25,20,249.96642914504497,0.419780563630491,0.7093581575650292,0.15542284053743305,1068624.9402789008,24124.072083370913,1092749.0123622718,612,1,337.6434108527132,60,69,38,35.104180432580065,0.6274305555555555,41.56420765027324,8269.945355191283,137.83242258652137,0
614,32,1,0,130,0.007692307692307693,0.0,1.0,130,4500,2900,1600,0.6444444444444445,61,29,32,254.26308878026467,0.4203786523553965,0.7145996563989645,0.15930279054640595,1070874.6380276186,23956.778632270198,1094831.4166598888,613,0,336.03846153846155,63,67,37,34.71433626926709,0.6281415343915344,41.29231770833335,8278.645833333363,131.4070767195772,0
615,32,0,0,130,0.0,0.0,1.0,130,4200,3200,1000,0.7619047619047619,52,32,20,249.36261144918535,0.42052524349035975,0.708330869034856,0.15677449982651265,1071894.507561699,23258.082720725033,1095152.5902824241,614,1,337.03846153846155,66,64,41,34.714880666346296,0.6275252525252526,41.16915422885574,8282.587064676656,125.49374340419176,0
616,32,0,1,129,0.0,0.007692307692307693,0.9923076923076923,130,4050,3000,1050,0.7407407407407407,51,30,21,251.51679515069935,0.4202606340687736,0.7119095128130386,0.1588064269713014,1073150.8648101508,23933.093246050266,1097083.958056201,615,2,338.03846153846155,68,62,34,34.5036675410473,0.6279105392156863,41.0175120772947,8287.439613526596,121.87411196362642,0
617,32,0,0,129,0.0,0.0,1.0,129,4700,3500,1200,0.7446808510638298,59,35,24,249.71309229639866,0.41948280038759694,0.7095765098830973,0.15849137082485723,1074677.777777779,23172.222222222237,1097850.0000000012,616,3,341.38759689922483,69,60,38,34.36160235798499,0.6292270531400966,40.833333333333336,8293.333333333341,120.19323671497595,0
618,32,0,0,129,0.0,0.0,1.0,129,3450,2600,850,0.7536231884057971,43,26,17,251.33029369475435,0.4190361555232558,0.7129402328567831,0.16000951073698952,1075577.357123495,24815.03461145508,1100392.3917349502,617,4,342.38759689922483,72,57,39,34.20851678591083,0.6287615740740741,40.724885844748854,8296.803652968028,115.2333840690004,0
619,32,0,1,128,0.0,0.007751937984496124,0.9922480620155039,129,4500,3500,1000,0.7777777777777778,55,35,20,251.7368490316809,0.418804001130491,0.7144701458646232,0.16066076277572136,1076290.975308641,23888.41975308636,1100179.3950617274,618,5,343.38759689922483,74,55,39,34.109814001642214,0.6286599099099099,40.638888888888886,8299.55555555555,112.15615615615607,0
620,32,1,1,128,0.007751937984496124,0.007751937984496124,0.9922480620155039,129,4350,3300,1050,0.7586206896551724,54,33,21,241.9265425357637,0.418475956879845,0.7045343891350384,0.1499348236742533,1067659.8206094552,21509.049800879926,1089168.8704103353,619,0,344.27906976744185,72,57,40,35.431512272367364,0.619068287037037,41.680936073059364,8266.210045662114,114.80847285641825,8
621,32,2,0,130,0.015384615384615385,0.0,1.0,130,4600,3400,1200,0.7391304347826086,58,34,24,230.53275968324772,0.41931648777579006,0.6907089243348488,0.14398991332374989,1069963.804268459,18732.341711838886,1088696.145980298,620,0,342.3076923076923,66,64,42,35.440840497805574,0.6251578282828283,41.402363184079604,8275.124378109456,125.38067239559783,0
622,32,1,0,131,0.007633587786259542,0.0,1.0,131,4150,3100,1050,0.7469879518072289,52,31,21,244.1234627099784,0.42010667449598743,0.7119158499253553,0.14107446209564198,1046483.868133653,20744.25311178409,1067228.121245437,621,0,340.68702290076334,67,64,40,38.01219177398422,0.5956156716417911,44.25551470588236,8183.823529411785,122.14661984196694,7
623,32,4,2,133,0.02962962962962963,0.014814814814814815,0.9851851851851852,135,3200,1900,1300,0.59375,45,19,26,238.65139077542304,0.4238506541367238,0.7153007567012943,0.13920438449430225,1049355.6764112124,19886.03831872433,1069241.7147299368,622,0,331.56296296296296,73,62,36,37.79309578775718,0.5960331050228311,43.904842342342356,8195.045045045077,112.26089102801475,0
624,32,2,1,134,0.014814814814814815,0.007407407407407408,0.9925925925925926,135,3750,2700,1050,0.72,48,27,21,236.0506374695831,0.42389441680486456,0.7122832829551939,0.13844492405222963,1051038.3470993764,18869.654367556956,1069908.0014669334,623,0,332.26666666666665,61,74,38,37.649609417677276,0.6050204918032787,43.69959677419355,8201.612903225812,134.45267054468545,0
625,32,3,0,137,0.021897810218978103,0.0,1.0,137,4050,3000,1050,0.7407407407407407,51,30,21,235.83405374698572,0.42580193573779873,0.7176341233471377,0.1398676677887068,1054439.3532215664,18284.54142011843,1072723.8946416848,624,0,328.37226277372264,64,73,40,37.23104854651766,0.6072591145833333,43.285256410256416,8214.871794871808,128.357371794872,0
626,32,1,1,137,0.007246376811594203,0.007246376811594203,0.9927536231884058,138,3550,2500,1050,0.704225352112676,46,25,21,233.89033428206804,0.4267935223385874,0.7178167104791127,0.1393642262294487,1055858.491281157,18241.019096061966,1074099.510377219,625,0,326.9855072463768,66,72,39,37.10421331880814,0.6077967171717171,43.11256218905473,8220.398009950253,124.55148499924626,0
627,32,1,1,137,0.007246376811594203,0.007246376811594203,0.9927536231884058,138,4300,3300,1000,0.7674418604651163,53,33,20,235.68717435470722,0.42759132903134806,0.7200958243699582,0.1411947472211126,1057493.5838623317,17947.534935749252,1075441.1187980808,626,0,323.82608695652175,70,68,40,36.854538796629186,0.6075892857142857,42.91373239436621,8226.760563380303,117.52515090543291,0
628,32,3,0,140,0.02142857142857143,0.0,1.0,140,3950,2600,1350,0.6582278481012658,53,26,27,229.82852865340448,0.42865065090784515,0.7182855626326956,0.13878107307147922,1059887.127116369,16768.459792767942,1076655.586909137,627,0,319.9428571428571,60,80,41,36.70769196744514,0.6166666666666667,42.62295081967214,8236.065573770513,137.2677595628419,0
629,32,1,1,140,0.0070921985815602835,0.0070921985815602835,0.9929078014184397,141,3600,2500,1100,0.6944444444444444,47,25,22,224.7754862147443,0.42989488348530897,0.7134332638452281,0.13660740797361134,1061824.5603221587,15934.426364234103,1077758.986686393,628,0,318.6666666666667,64,77,45,36.5973302229134,0.6163736979166667,42.38782051282052,8243.58974358976,128.80608974359,0
630,32,0,0,140,0.0,0.0,1.0,140,4150,3000,1150,0.7228915662650602,53,30,23,222.71642705859193,0.4290349862966769,0.7090633543325802,0.13587478613806606,1062971.107867165,15198.225442137544,1078169.3333093026,629,1,321.90714285714284,67,73,44,36.508231308688934,0.6159825870646767,42.248774509803916,8248.039215686264,123.1050629206905,0
631,32,1,0,141,0.0070921985815602835,0.0,1.0,141,3500,2000,1500,0.5714285714285714,50,20,30,228.32403581268565,0.42956982438365415,0.7173226930190288,0.14029722200565653,1065111.2130529657,16938.09815071969,1082049.3112036854,630,0,320.6170212765957,70,71,39,36.09843530838928,0.6169642857142856,41.98943661971831,8256.338028169015,117.94768611670021,0
632,32,0,1,140,0.0,0.0070921985815602835,0.9929078014184397,141,4350,2800,1550,0.6436781609195402,59,28,31,229.1003047741973,0.42916877744005405,0.7185526605481245,0.14147142003461372,1066582.1250214367,16320.857981824556,1082902.9830032613,631,1,321.6170212765957,71,70,42,35.896232582464776,0.6182511737089202,41.8113425925926,8262.037037037062,116.36671883150791,0
633,32,2,3,139,0.014084507042253521,0.02112676056338028,0.9788732394366197,142,3400,2400,1000,0.7058823529411765,44,24,20,225.51552843275954,0.42990314820364267,0.716304634122052,0.14015303867650694,1068483.723200153,16391.934291856905,1084875.65749201,632,0,319.4788732394366,60,82,42,35.75354082689046,0.6272569444444445,41.581284153005456,8269.398907103809,137.8233151183968,0
634,32,2,0,141,0.014184397163120567,0.0,1.0,141,3550,2300,1250,0.647887323943662,48,23,25,223.88171478493217,0.4293925194191152,0.7124302182164526,0.14000464294519288,1070320.2730747377,16175.027621009684,1086495.3006957474,633,0,322.40425531914894,60,81,45,35.56879704212331,0.6295138888888889,41.359289617486326,8276.502732240411,137.94171220400685,0
635,32,0,0,141,0.0,0.0,1.0,141,4300,3000,1300,0.6976744186046512,56,30,26,225.05638709868765,0.42925954069571093,0.7145094236500862,0.14131852957525742,1071531.070246553,15730.982266735564,1087262.0525132886,634,1,323.40425531914894,61,80,45,35.388871756584216,0.6302937158469946,41.21303763440857,8281.182795698867,135.75709501145684,0
636,32,1,0,142,0.007042253521126761,0.0,1.0,142,4450,2800,1650,0.6292134831460674,61,28,33,223.42777122345908,0.4295337628608531,0.7152534953781184,0.14112585549564924,1073264.6062901753,15109.423783287459,1088374.0300734628,635,0,322.11971830985914,65,77,40,35.21709323583181,0.6298076923076923,41.00378787878788,8287.878787878795,127.50582750582763,0
637,32,1,0,143,0.006993006993006993,0.0,1.0,143,3750,2600,1150,0.6933333333333334,49,26,23,224.82703968709453,0.43019099445155784,0.7192731636125642,0.14304409096482637,1075389.3334294485,16005.320069204081,1091394.6534986526,636,0,320.86013986013984,67,76,43,34.91885291105335,0.6312189054726368,40.74754901960784,8296.078431372536,123.8220661398886,0
638,32,0,1,142,0.0,0.006993006993006993,0.993006993006993,143,3750,2200,1550,0.5866666666666667,53,22,31,228.94733196270096,0.4300309432351686,0.724431868338226,0.14605029653901727,1076159.2403628114,16926.757369614526,1093085.9977324258,637,1,321.86013986013984,69,74,43,34.71712187284828,0.6310386473429952,40.654761904761905,8299.047619047617,120.27605244996546,0
639,32,0,0,142,0.0,0.0,1.0,142,3750,2500,1250,0.6666666666666666,50,25,25,232.18609450340435,0.42938496820164485,0.7267307291067464,0.14854562981382546,1077002.5969414723,17863.00535077295,1094865.6022922453,638,2,325.09859154929575,57,85,43,34.52916608980572,0.639985380116959,40.55316091954023,8302.298850574716,145.65436579955642,0
640,32,0,1,141,0.0,0.007042253521126761,0.9929577464788732,142,3900,2600,1300,0.6666666666666666,52,26,26,229.44873424556724,0.4294141028202311,0.7233226641229129,0.14760599675482589,1078605.4653835138,17196.931756519803,1095802.3971400335,639,3,326.09859154929575,58,84,41,34.40276644453513,0.6411637931034483,40.36016949152544,8308.474576271212,143.24956165984847,0
641,32,0,0,141,0.0,0.0,1.0,141,4600,3100,1500,0.6739130434782609,61,31,30,233.76713575291174,0.42900835866261394,0.7245417370483485,0.15104021672739987,1079867.3611111147,17687.500000000273,1097554.861111115,640,4,325.34751773049646,59,82,42,34.13525795241915,0.6419491525423728,40.20833333333335,8313.333333333363,140.9039548022604,0
642,32,0,0,141,0.0,0.0,1.0,141,2650,1800,850,0.6792452830188679,35,18,17,231.56808740698824,0.42892392772711924,0.7219548705387144,0.1499575810280662,1080520.4880707127,19192.812565320182,1099713.3006360328,641,5,326.34751773049646,60,81,43,34.112016471722114,0.6420138888888889,40.12978142076504,8315.846994535541,138.59744990892568,0
643,32,0,0,141,0.0,0.0,1.0,141,4150,2900,1250,0.6987951807228916,54,29,25,233.27349794384253,0.42848488686254643,0.7223849631859636,0.15164223874191543,1081627.513402484,18113.00670473972,1099740.5201072237,642,6,327.34751773049646,62,79,41,33.931505034446204,0.6419690860215054,39.996693121693134,8320.105820105848,134.19525516299754,0
644,32,0,0,141,0.0,0.0,1.0,141,4150,2800,1350,0.6746987951807228,55,28,27,231.1826246202143,0.428161938534279,0.7196071260188122,0.15075633508279274,1082533.5346811344,17702.58875739667,1100236.123438531,643,7,328.34751773049646,64,77,42,33.87447887786747,0.6417643229166667,39.887820512820525,8323.589743589771,130.05608974359018,0
645,32,0,0,141,0.0,0.0,1.0,141,4400,3300,1100,0.75,55,33,22,231.40440012980562,0.42803107058426204,0.7190705282763168,0.1513618230652677,1083410.5609921643,17541.194192137504,1100951.7551843019,644,8,329.34751773049646,67,74,42,33.76092747395066,0.6410136815920398,39.78247549019607,8326.96078431371,124.28299678080162,0
646,32,0,1,140,0.0,0.0070921985815602835,0.9929078014184397,141,3950,2800,1150,0.7088607594936709,51,28,23,237.9562514673011,0.4278579871664978,0.7224480547436158,0.14931897896805352,1071334.5266089947,18836.149603874255,1090170.676212869,645,9,330.34751773049646,62,79,42,35.07933972310967,0.6293682795698925,41.23677248677247,8280.423280423258,133.55521420037513,8
647,32,0,1,139,0.0,0.007142857142857143,0.9928571428571429,140,3250,2300,950,0.7076923076923077,42,23,19,237.29492820699795,0.42719788454950325,0.7207086743492186,0.14938989509195646,1072293.1232678227,19639.943940538964,1091933.0672083616,646,11,333.64285714285717,62,78,42,34.97796512741905,0.6305443548387097,41.12103174603173,8284.12698412696,133.61495135688645,0
648,32,2,1,140,0.014184397163120567,0.0070921985815602835,0.9929078014184397,141,3950,2300,1650,0.5822784810126582,56,23,33,232.42365593493497,0.42813027693346845,0.7174425445055526,0.1471834408734857,1074013.350591715,17775.221893491016,1091788.572485206,647,0,332.0921985815603,64,77,38,34.89167749118572,0.63134765625,40.91346153846153,8290.769230769223,129.5432692307691,0
649,32,1,0,141,0.0070921985815602835,0.0,1.0,141,3900,2300,1600,0.5897435897435898,55,23,32,232.61493678387575,0.42786854103343464,0.7192921798903089,0.14793470782388296,1075262.25264922,17924.41218521715,1093186.6648344372,648,0,333.0851063829787,67,74,40,34.73262473162759,0.6310634328358209,40.76286764705882,8295.588235294106,123.81474978050905,0
650,32,0,0,141,0.0,0.0,1.0,141,4400,2700,1700,0.6136363636363636,61,27,34,238.32637275913572,0.4278748733535968,0.7251516015973256,0.1523153281839919,1076699.34904561,18721.17008203243,1095420.5191276425,649,1,334.0851063829787,58,83,42,34.407257424170226,0.6388290229885057,40.58968926553671,8301.129943502805,143.1229300603932,0
651,32,1,0,142,0.007042253521126761,0.0,1.0,142,4200,2600,1600,0.6190476190476191,58,26,32,235.56906361952767,0.42785748177005295,0.7238975227499713,0.15135760376771176,1078249.59314999,18200.449401295955,1096450.042551286,650,0,332.72535211267603,60,82,43,34.28770337236329,0.6392361111111111,40.40300546448088,8307.103825136617,138.4517304189436,0
652,32,0,0,142,0.0,0.0,1.0,142,2950,1600,1350,0.5423728813559322,43,16,27,232.9780459610184,0.42745688076449234,0.7208907334238466,0.15008831787792212,1079015.3026231022,18927.375353433225,1097942.6779765354,651,1,333.72535211267603,62,80,45,34.26065940829406,0.6387768817204301,40.31084656084654,8310.052910052873,134.0331114524657,0
653,32,0,0,142,0.0,0.0,1.0,142,3400,2400,1000,0.7058823529411765,44,24,20,232.03081139723338,0.4275182715679419,0.7188576527327561,0.14991835327064734,1079867.3611111082,18312.49999999978,1098179.861111108,652,2,334.72535211267603,64,78,42,34.180366212242696,0.6385091145833333,40.20833333333332,8313.33333333331,129.89583333333297,0
654,32,0,0,142,0.0,0.0,1.0,142,4450,3100,1350,0.6966292134831461,58,31,27,228.22753882664827,0.42753387939932735,0.7145772809178836,0.1480377840463197,1080996.0439304628,16492.613317518353,1097488.657247981,653,3,335.72535211267603,65,77,45,34.14034195559332,0.6392628205128206,40.072601010100996,8317.67676767674,127.96425796425753,0
655,32,1,1,142,0.006993006993006993,0.006993006993006993,0.993006993006993,143,4350,2900,1450,0.6666666666666666,58,29,29,227.28015153521315,0.42789487507797364,0.7148110435209276,0.14828717497551086,1082680.4629337853,16264.355935960848,1098944.818869746,654,0,334.3706293706294,68,75,42,33.95793434314124,0.6395526960784313,39.870169082125585,8324.154589371938,122.41403807899908,0
656,32,0,0,142,0.0,0.0,1.0,142,4550,3300,1250,0.7252747252747253,58,33,25,226.9610014942175,0.42771180867712183,0.7129169658633911,0.1487280359848645,1083937.4934362473,16252.307813484242,1100189.8012497316,655,1,336.4225352112676,68,74,43,33.81184386056493,0.6410845588235294,39.719202898550705,8328.985507246332,122.48508098891665,0
657,32,0,2,140,0.0,0.014084507042253521,0.9859154929577465,142,3650,2400,1250,0.6575342465753424,49,24,25,226.64824316874828,0.42768163353644323,0.7133748887196778,0.14898162881167293,1084821.442743757,17124.574829931506,1101946.0175736886,656,2,337.4225352112676,69,73,44,33.71147178725185,0.6416062801932367,39.61309523809521,8332.380952380896,120.75914423740429,0
658,32,0,0,140,0.0,0.0,1.0,140,3500,2500,1000,0.7142857142857143,45,25,20,226.83232593683763,0.4271518499486125,0.7106297590169615,0.14945457743043594,1085496.399004153,17745.13459643483,1103241.5336005879,657,3,343.0285714285714,60,80,46,33.62384995301472,0.6480902777777777,39.53210382513662,8334.972677595648,138.9162112932608,0
659,32,1,0,141,0.0070921985815602835,0.0,1.0,141,3450,2200,1250,0.6376811594202898,47,22,25,224.11137688142222,0.4276110266801756,0.7094502906009146,0.14831124906931026,1086750.2023355346,17060.616834316377,1103810.819169851,658,0,341.5886524822695,61,80,43,33.54096828261988,0.6489071038251366,39.38172043010754,8339.784946236594,136.7177860038786,0
660,32,0,0,141,0.0,0.0,1.0,141,3750,2400,1350,0.64,51,24,27,223.16748883050897,0.42768912529550823,0.7080482483668773,0.14774418842651546,1086861.4094300333,16560.426289857933,1103421.8357198911,659,1,342.5886524822695,62,79,45,33.55193596819557,0.648353494623656,39.36838624338627,8340.211640211688,134.51954258405948,0
661,32,0,0,141,0.0,0.0,1.0,141,3400,2600,800,0.7647058823529411,42,26,16,220.93209436587,0.4273936170212766,0.7047701760558625,0.14651049241947056,1087340.931130837,16445.70184089427,1103786.6329717312,660,2,343.5886524822695,64,77,43,33.55143849511283,0.6476236979166667,39.310897435897445,8342.051282051298,130.34455128205153,0
662,32,1,0,142,0.007042253521126761,0.0,1.0,142,3850,2500,1350,0.6493506493506493,52,25,27,217.06067955270825,0.42777736156894086,0.7023684603748372,0.14463240991006132,1088700.1714066505,15012.799806935602,1103712.9712135862,661,0,342.1619718309859,66,76,45,33.48593892796123,0.6480429292929293,39.14800995024876,8347.263681592056,126.47369214533418,0
663,32,0,0,142,0.0,0.0,1.0,142,4350,2800,1550,0.6436781609195402,59,28,31,220.58607874096143,0.42738092265174976,0.7057898313046829,0.14779091229292718,1090258.0536372904,15349.149773520734,1105607.203410811,662,1,343.1619718309859,66,76,46,33.203295612467755,0.6499368686868687,38.96144278606967,8353.233830845804,126.56414895220915,0
664,32,0,1,141,0.0,0.007042253521126761,0.9929577464788732,142,3900,2800,1100,0.717948717948718,50,28,22,221.92910427434163,0.42692205240901676,0.7081685582225288,0.14940923588150457,1091621.172606131,16152.501808677112,1107773.6744148082,663,2,344.1619718309859,68,74,41,33.00148345085349,0.6504289215686274,38.79830917874397,8358.454106280213,122.9184427394149,0
665,32,0,0,141,0.0,0.0,1.0,141,4450,3300,1150,0.7415730337078652,56,33,23,218.2272362713153,0.4267561634582911,0.7005794850108189,0.14732226227174258,1092398.2461734698,15028.21003401366,1107426.4562074835,664,3,346.82978723404256,69,72,43,33.00319636653571,0.6508152173913043,38.705357142857146,8361.428571428576,121.18012422360255,0
666,32,0,0,141,0.0,0.0,1.0,141,3350,2400,950,0.7164179104477612,43,24,19,229.8623499878274,0.42673505572441744,0.7164920202540763,0.1413408918010258,1065318.8775510206,17425.340136054412,1082744.217687075,665,4,347.82978723404256,62,79,38,36.03301614763553,0.6219758064516129,41.964285714285715,8257.142857142859,133.17972350230417,8
667,32,2,0,143,0.013986013986013986,0.0,1.0,143,4150,2700,1450,0.6506024096385542,56,27,29,229.68675572463874,0.42811443251584097,0.7210881523790513,0.14247359275760768,1067918.9481994067,16307.367717757976,1084226.3159171648,666,0,343.95104895104896,60,83,40,35.71562341639678,0.6265625,41.64959016393442,8267.213114754082,137.78688524590137,0
668,32,1,0,144,0.006944444444444444,0.0,1.0,144,4050,3000,1050,0.7407407407407407,51,30,21,229.93809216806616,0.42880022176897176,0.7243836185112997,0.14350151007569084,1069723.1074401657,16344.018094577397,1086067.125534743,667,0,342.55555555555554,61,83,39,35.48597574182371,0.6280737704918034,41.431451612903224,8274.193548387091,135.64251718667362,0
669,32,0,0,144,0.0,0.0,1.0,144,3650,2700,950,0.7397260273972602,46,27,19,228.26724506256812,0.428741542022792,0.7228063006501995,0.14292927093242597,1070696.4361848168,16430.98515724343,1087127.4213420602,668,1,343.55555555555554,61,83,41,35.40888647139054,0.62926912568306,41.3138440860215,8277.956989247294,135.70421293848023,0
670,32,2,0,146,0.0136986301369863,0.0,1.0,146,4400,3100,1300,0.7045454545454546,57,31,26,226.67233659191487,0.4301960321209259,0.726478253887868,0.1344276049627982,1054424.7256515739,14201.78326474603,1068626.5089163198,669,0,339.83561643835617,62,84,44,37.468064322212214,0.6085349462365591,43.287037037037024,8214.814814814785,132.49701314217396,8
671,32,0,1,145,0.0,0.00684931506849315,0.9931506849315068,146,4700,3300,1400,0.7021276595744681,61,33,28,226.55061932087898,0.43033085340891203,0.7268433901927447,0.1350179122511887,1055919.3515369084,13943.836608717407,1069863.1881456259,670,1,340.83561643835617,62,84,39,37.28519019115659,0.610383064516129,43.10515873015872,8220.6349206349,132.59088581669195,0
672,32,0,0,145,0.0,0.0,1.0,145,4300,2800,1500,0.6511627906976745,58,28,30,228.3028336803846,0.43009259259259264,0.726496461767216,0.13662700463487365,1057174.8903062618,14971.204630533899,1072146.0949367958,671,2,343.3586206896552,63,82,40,37.08400609974882,0.611276455026455,42.952473958333336,8225.520833333341,130.56382275132287,0
673,32,0,0,145,0.0,0.0,1.0,145,5600,3900,1700,0.6964285714285714,73,39,34,229.86567355180972,0.43003272669220943,0.7273018130110196,0.1381228250811318,1058404.4995408638,14058.172635445368,1072462.6721763092,672,3,344.3586206896552,65,80,40,36.89095483554247,0.6115384615384616,42.803030303030305,8230.303030303035,126.6200466200467,0
674,32,0,0,145,0.0,0.0,1.0,145,4600,3400,1200,0.7391304347826086,58,34,24,221.33892900598335,0.4305136494252873,0.7188857588922073,0.13074439062213872,1053214.9780634607,13023.495051525224,1066238.473114986,673,4,345.3586206896552,65,80,40,37.75554666994751,0.6051282051282052,43.434343434343425,8210.101010100992,126.30924630924603,8
675,32,2,0,147,0.013605442176870748,0.0,1.0,147,4150,3300,850,0.7951807228915663,50,33,17,219.28027546693338,0.4319980275215109,0.7194427318358876,0.13054004922303722,1055582.5252631328,12743.685383556141,1068326.210646689,674,0,341.6462585034014,68,79,42,37.51383664433207,0.6063112745098039,43.14613526570048,8219.32367149758,120.87240693378793,0
676,32,3,1,149,0.02,0.006666666666666667,0.9933333333333333,150,4400,3200,1200,0.7272727272727273,56,32,24,214.81156561479526,0.434382923191648,0.7200382495218807,0.12910480099728971,1058469.4492669746,11074.295910493774,1069543.7451774683,675,0,335.79333333333335,71,79,41,37.27008099898749,0.608274647887324,42.795138888888886,8230.555555555551,115.923317683881,0
677,32,1,2,148,0.006666666666666667,0.013333333333333334,0.9866666666666667,150,4950,3000,1950,0.6060606060606061,69,30,39,212.61311602827425,0.43465697240865026,0.7173297921672781,0.1284287172219682,1059988.2168240005,10123.47954644087,1070111.6963704412,676,0,336.78,63,87,42,37.1382424855613,0.6147486772486772,42.61067708333333,8236.458333333323,130.7374338624337,0
678,32,0,1,147,0.0,0.006756756756756757,0.9932432432432432,148,3450,2300,1150,0.6666666666666666,46,23,23,210.53926959290325,0.4345132760311332,0.7102466544214117,0.12756202804746505,1060900.0000000019,11622.222222222324,1072522.222222224,677,1,337.31081081081084,64,84,44,37.078613807982734,0.615234375,42.50000000000001,8240.000000000015,128.75000000000023,0
679,32,1,0,148,0.006756756756756757,0.0,1.0,148,3800,2600,1200,0.6842105263157895,50,26,24,207.6863837076773,0.4343983652019366,0.7058289511230686,0.12651237816812766,1062514.7931053694,10733.971003193064,1073248.7641085626,678,0,338.1756756756757,66,82,45,36.95211161387632,0.6160037878787878,42.30410447761194,8246.268656716424,124.9434644957034,0
680,32,4,0,152,0.02631578947368421,0.0,1.0,152,3700,2900,800,0.7837837837837838,45,29,16,198.96768376181845,0.436424385674451,0.7006044103179068,0.12228870352757384,1065184.225203818,8287.44761368643,1073471.6728175043,679,0,330.25,72,80,44,36.84684124175053,0.6160300925925926,41.980593607305956,8256.621004566261,114.67529173008695,0
681,32,1,1,152,0.006535947712418301,0.006535947712418301,0.9934640522875817,153,3750,2700,1050,0.72,48,27,21,199.21140528198163,0.43703237874097006,0.700501767044361,0.12304080172793413,1066645.0374153652,8147.5713681136685,1074792.6087834788,680,0,329.08496732026146,75,78,46,36.6601638532045,0.6163888888888889,41.80372807017546,8262.280701754438,110.16374269005918,0
682,32,1,0,153,0.006535947712418301,0.0,1.0,153,4550,3600,950,0.7912087912087912,55,36,19,206.01119095430082,0.43726529354431837,0.7048109772238862,0.12608635480202426,1063928.9132233022,8686.252500769591,1072615.165724072,681,0,329.640522875817,75,78,45,36.8203199744871,0.6130555555555556,42.1326754385965,8251.754385964934,110.02339181286578,8
683,32,1,2,152,0.006493506493506494,0.012987012987012988,0.987012987012987,154,4750,3700,1050,0.7789473684210526,58,37,21,206.8608161087882,0.4372241320770733,0.7056651537620371,0.12719739543710704,1065318.8775510301,8524.546485261226,1073843.4240362914,682,0,328.4935064935065,76,78,41,36.62653787004997,0.6143092105263157,41.964285714285744,8257.142857142933,108.64661654135439,0
684,32,0,0,152,0.0,0.0,1.0,152,4550,2700,1850,0.5934065934065934,64,27,37,208.03178436070223,0.4356519402811665,0.7062738927288861,0.12830195569395453,1066212.6951331594,9411.225895317311,1075623.9210284767,683,2,333.7763157894737,76,76,43,36.485846172658405,0.6154057017543859,41.85606060606064,8260.606060606136,108.69218500797548,0
685,32,0,0,152,0.0,0.0,1.0,152,3600,2100,1500,0.5833333333333334,51,21,30,192.10319747302003,0.435324263680725,0.6778762755720094,0.11528314535646102,1058014.8430325985,6649.606864095503,1064664.449896694,684,3,334.7763157894737,87,65,40,37.910452341496345,0.6010536398467433,42.85037878787879,8228.787878787878,94.58376872169974,8
686,32,0,0,152,0.0,0.0,1.0,152,3900,2500,1400,0.6410256410256411,53,25,28,196.64511435915128,0.43565557104682234,0.6855631278638341,0.11831372162937666,1058794.227789259,7341.342401285719,1066135.5701905447,685,4,335.7763157894737,87,65,40,37.69709798147129,0.6020114942528736,42.75568181818183,8231.818181818204,94.61859979101384,0
687,32,3,0,155,0.01935483870967742,0.0,1.0,155,3600,2300,1300,0.6388888888888888,49,23,26,192.54059849728165,0.43770248568635667,0.6843302631035488,0.11649690689988854,1060487.1709706355,6237.366919474815,1066724.5378901104,686,0,330.258064516129,78,77,42,37.59314980793854,0.6075053418803419,42.550105485232045,8238.396624472522,105.62046954451951,0
688,32,0,0,155,0.0,0.0,1.0,155,3650,2600,1050,0.7123287671232876,47,26,21,190.45939040645771,0.4371892892054183,0.6814955836023124,0.11559153548668198,1061408.7029416163,5781.050906873498,1067189.7538484898,687,1,331.258064516129,80,75,42,37.53276662672258,0.6078125,42.438271604938244,8241.975308641908,103.02469135802384,0
689,32,1,0,156,0.00641025641025641,0.0,1.0,156,4850,3700,1150,0.7628865979381443,60,37,23,187.9963123822334,0.43767748828232694,0.6793248787113815,0.11470791038937295,1063010.6873276187,3918.4178480989585,1066929.1051757177,688,0,330.12820512820514,82,74,45,37.39825770117178,0.6089939024390244,42.24397590361444,8248.192771084297,100.58771672054021,0
690,32,1,1,156,0.006369426751592357,0.006369426751592357,0.9936305732484076,157,5150,3600,1550,0.6990291262135923,67,36,31,189.48643357160157,0.43848671675104794,0.6861219961107505,0.11632776066246026,1064841.8901384016,3804.6184159934965,1068646.508554395,689,0,329.0191082802548,84,73,37,37.13372682216204,0.6104910714285714,42.02205882352939,8255.294117647007,98.27731092436913,0
691,32,0,1,155,0.0,0.00641025641025641,0.9935897435897436,156,4500,3500,1000,0.7777777777777778,55,35,20,190.4230530242837,0.4377645092362834,0.6864513560696268,0.11734026748968553,1065955.0269127223,4896.48212226054,1070851.5090349829,690,1,331.9807692307692,84,72,39,36.972193207356064,0.6118551587301587,41.88725490196077,8259.607843137226,98.32866479925269,0
692,32,0,0,155,0.0,0.0,1.0,155,4150,2600,1550,0.6265060240963856,57,26,31,190.4872825496336,0.43743715961457896,0.6842573348445125,0.11802333813112516,1067579.830375357,5522.076158599978,1073101.906533957,691,2,334.4451612903226,86,69,40,36.77014770866164,0.6131298449612403,41.69061302681991,8265.900383141727,96.11512073420613,0
693,32,0,4,151,0.0,0.025806451612903226,0.9741935483870968,155,4450,3100,1350,0.6966292134831461,58,31,27,187.5035836573944,0.4372207093981288,0.6801047412112085,0.11673610208347554,1069008.2908163362,4638.577097506162,1073646.8679138424,692,3,335.4451612903226,76,79,40,36.67122433314143,0.6188322368421053,41.517857142857174,8271.428571428647,108.83458646616641,0
694,32,1,0,152,0.006578947368421052,0.0,1.0,152,4650,3100,1550,0.6666666666666666,62,31,31,192.99942803743434,0.4356301556872313,0.6850752626899099,0.12070513786875184,1070351.4768510824,6265.444566256916,1076616.9214173392,693,0,340.125,76,76,44,36.363695799989564,0.6204769736842105,41.35551948051952,8276.623376623467,108.90293916609825,0
695,32,0,0,152,0.0,0.0,1.0,152,3900,2600,1300,0.6666666666666666,52,26,26,194.711229136315,0.43554029423724877,0.68814295415959,0.1221278751866668,1071202.8847295376,7415.046068011386,1078617.930797549,694,1,341.125,77,75,40,36.21456989247312,0.6210768398268398,41.25267094017097,8279.91452991461,107.53135753135857,0
696,32,1,0,153,0.006535947712418301,0.0,1.0,153,4100,2800,1300,0.6829268292682927,54,28,26,193.25418424977727,0.43595380403623435,0.6885374909870214,0.12169187471328292,1072360.743915693,6747.640157382724,1079108.3840730756,695,0,339.8888888888889,78,75,44,36.10976707072766,0.6220619658119658,41.11286919831227,8284.388185654087,106.21010494428316,0
697,32,0,0,153,0.0,0.0,1.0,153,5100,3700,1400,0.7254901960784313,65,37,28,189.32604472955734,0.4356617647058823,0.6806107228140206,0.11954070221899532,1073153.8086313077,4935.193194925596,1078089.0018262332,696,1,340.8888888888889,84,69,33,36.11393712834589,0.6206597222222222,41.01715686274513,8287.45098039225,98.66013071895536,0
698,32,3,1,155,0.019230769230769232,0.00641025641025641,0.9935897435897436,156,4500,3400,1100,0.7555555555555555,56,34,22,187.55634131439783,0.43755858836503997,0.6836407802391278,0.11934962701681255,1075435.0272307135,4640.931805748649,1080075.9590364622,697,0,335.31410256410254,88,68,39,35.87949377755709,0.6220407196969697,40.74204119850189,8296.254681647977,94.27562138236338,0
699,32,0,1,154,0.0,0.0064516129032258064,0.9935483870967742,155,5300,4200,1100,0.7924528301886793,64,42,22,195.95958026615565,0.437093283061025,0.695825928238631,0.12095115628701669,1066445.5216403625,5496.043359473087,1071941.5649998356,698,1,338.46451612903223,83,72,39,36.76874689786574,0.6128263052208835,41.827876984126966,8261.507936507885,99.53624019889018,8
700,32,0,1,153,0.0,0.006493506493506494,0.9935064935064936,154,3650,2400,1250,0.6575342465753424,49,24,25,196.0953214342743,0.43620642701525053,0.6952778868263154,0.12128901404709252,1067068.7451941504,7399.437716262752,1074468.182910413,699,2,341.65584415584414,84,70,42,36.68833736693081,0.613219246031746,41.75245098039214,8263.921568627407,98.3800186741358,0
701,32,0,1,152,0.0,0.006535947712418301,0.9934640522875817,153,4650,3500,1150,0.7526881720430108,58,35,23,212.05195265599662,0.4357334307992203,0.7164135769887146,0.12890188394785707,1061887.9011071466,9785.080586309496,1071672.9816934562,700,3,344.7516339869281,72,81,41,36.91725748679886,0.6119791666666667,42.38013698630136,8243.835616438333,114.49771689497685,8
702,32,1,1,152,0.006535947712418301,0.006535947712418301,0.9934640522875817,153,3950,2500,1450,0.6329113924050633,54,25,29,208.80565873735827,0.43545393303520236,0.7120721245434583,0.1275539304241486,1063360.4339136418,9857.135175716143,1073217.569089358,701,0,345.72549019607845,73,80,42,36.81859961413855,0.6132990867579908,42.20157657657657,8249.549549549538,113.00752807602106,0
703,32,4,0,156,0.02564102564102564,0.0,1.0,156,5100,3800,1300,0.7450980392156863,64,38,26,205.56559710925376,0.438656258615936,0.709725474271133,0.12492494956066119,1061806.2119555902,7354.16559499317,1069160.3775505833,702,0,337.75,71,85,43,37.094471900857386,0.6123826291079812,42.3900462962963,8243.518518518522,116.10589462702144,8
704,32,2,2,156,0.012658227848101266,0.012658227848101266,0.9873417721518988,158,5150,3500,1650,0.6796116504854369,68,35,33,202.74760616111894,0.43997671934209465,0.7076073163937975,0.12408892200114821,1063928.9132233006,6391.808056325061,1070320.7212796255,703,0,334.4620253164557,75,83,43,36.904477162396766,0.6130555555555556,42.13267543859649,8251.754385964921,110.02339181286561,0
705,32,0,2,154,0.0,0.01282051282051282,0.9871794871794872,156,4100,2800,1300,0.6829268292682927,54,28,26,203.55077176120247,0.4392757444168735,0.7057580149773963,0.12499026728807724,1064909.3364197535,8052.623456790212,1072961.9598765436,704,1,335.10897435897436,77,79,38,36.76256168685512,0.613365800865801,42.01388888888889,8255.55555555556,107.21500721500728,0
706,32,1,0,155,0.0064516129032258064,0.0,1.0,155,4850,3600,1250,0.7422680412371134,61,36,25,201.44551401212195,0.43885805055159893,0.7007805752787066,0.12398401258632857,1065598.8623618004,7082.022111841021,1072680.8844736414,705,0,337.9741935483871,78,77,39,36.731683016554264,0.6137820512820513,41.93037974683544,8258.227848101262,105.87471600129822,0
707,32,0,1,154,0.0,0.0064516129032258064,0.9935483870967742,155,4500,3000,1500,0.6666666666666666,60,30,30,202.40549943527458,0.4388493227202905,0.7033042425465368,0.12472129982298577,1065948.7006293416,7650.775824652806,1073599.4764539944,706,1,338.9741935483871,79,76,39,36.66369242798769,0.613792194092827,41.888020833333336,8259.583333333343,104.5516877637132,0
708,32,0,1,153,0.0,0.006493506493506494,0.9935064935064936,154,3950,3000,950,0.759493670886076,49,30,19,205.1890372159588,0.4377608366578955,0.7063981216523585,0.12648219756744922,1066056.2500000005,8998.611111111106,1075054.8611111115,707,2,342.14935064935065,79,75,40,36.57855797686304,0.6139240506329113,41.875,8260.000000000004,104.55696202531651,0
709,32,0,0,153,0.0,0.0,1.0,153,3600,2600,1000,0.7222222222222222,46,26,20,204.76799365779638,0.4372222938883155,0.704796726398637,0.12646336891810125,1066622.941143664,9482.047929473229,1076104.9890731373,708,3,345.03921568627453,81,72,42,36.51942394423944,0.6138117283950617,41.80640243902439,8262.195121951216,102.00240891297797,0
710,32,1,2,152,0.006493506493506494,0.012987012987012988,0.987012987012987,154,4550,3000,1550,0.6593406593406593,61,30,31,205.91823941658802,0.4377405002405002,0.7099984668369355,0.12793453407760463,1068392.9457199543,8650.318877551057,1077043.2645975053,709,0,343.7922077922078,69,85,41,36.271175256742495,0.6215277777777778,41.592261904761905,8269.047619047617,119.8412698412698,0
711,32,0,1,151,0.0,0.006578947368421052,0.993421052631579,152,4400,3200,1200,0.7272727272727273,56,32,24,194.37713142179274,0.4373193694086209,0.6902515580780562,0.1201308589361748,1066832.8649654654,6673.582399696078,1073506.4473651615,710,1,348.9407894736842,81,71,40,36.76180900608388,0.6140689300411523,41.78099593495936,8263.008130081314,102.0124460503866,8
712,32,0,1,150,0.0,0.006622516556291391,0.9933774834437086,151,5400,3900,1500,0.7222222222222222,69,39,30,190.27782275070666,0.4366795437821928,0.681780754795136,0.1180648802828427,1068010.523192116,5043.743405567993,1073054.266597684,711,2,352.0198675496689,73,78,42,36.72246740038504,0.6190068493150684,41.63851351351353,8267.567567567607,113.25435024065214,0
713,32,1,0,151,0.006622516556291391,0.0,1.0,151,4400,3100,1300,0.7045454545454546,57,31,26,189.62757826262748,0.43658756438557766,0.6800118813466354,0.1182007726764607,1069364.6242113018,5956.204793783014,1075320.8290050847,712,0,352.682119205298,75,76,43,36.57242957622029,0.6197222222222223,41.474780701754405,8272.807017543906,110.30409356725208,0
714,32,0,0,151,0.0,0.0,1.0,151,4050,2600,1450,0.6419753086419753,55,26,29,188.7527682463538,0.436359455481972,0.6780992823297962,0.1180940094525623,1070463.4470868302,6160.587788834923,1076624.034875665,713,1,353.682119205298,76,75,42,36.459749825662534,0.6206140350877193,41.34199134199137,8277.056277056328,108.90863522442537,0
715,32,1,0,152,0.006578947368421052,0.0,1.0,152,4800,3300,1500,0.6875,63,33,30,191.87988272606012,0.4366785392703613,0.6853400211759326,0.12087139869509794,1072469.9817737583,5957.0828659938015,1078427.064639752,714,0,352.3486842105263,78,74,42,36.13190730837788,0.6221955128205128,41.09968354430381,8284.81012658231,106.21551444336295,0
716,32,1,0,153,0.006535947712418301,0.0,1.0,153,4300,2900,1400,0.6744186046511628,57,29,28,195.50204724674347,0.4375859993120055,0.6820956514350773,0.11684496064546065,1056779.821142335,6420.523704474515,1063200.3448468095,715,0,351.03921568627453,81,72,36,37.97611544988714,0.6017232510288066,43.00050813008128,8223.98373983734,101.53066345478197,7
717,32,1,1,153,0.006493506493506494,0.006493506493506494,0.9935064935064936,154,4000,2900,1100,0.725,51,29,22,195.08503592720413,0.43825863678804855,0.6849541008653859,0.11720925970829028,1058367.386306365,6494.327916351274,1064861.7142227164,716,0,349.75324675324674,83,71,41,37.790099646415946,0.6029116465863453,42.807539682539655,8230.158730158655,99.15853891757416,0
718,32,4,2,155,0.025477707006369428,0.012738853503184714,0.9872611464968153,157,5450,4100,1350,0.7522935779816514,68,41,27,195.67552667577942,0.44020836735804886,0.6931391716066564,0.119068245401498,1062193.467607426,4719.053241131022,1066912.5208485571,717,0,343.9490445859873,76,81,39,37.30135811543982,0.6104714912280702,42.34307359307358,8245.021645021625,108.48712690817928,0
719,32,0,0,155,0.0,0.0,1.0,155,4400,3200,1200,0.7272727272727273,56,32,24,199.505122626646,0.4393625192012289,0.6950963832074926,0.12196590385862346,1063589.641163629,7038.316356956073,1070627.957520585,718,1,348.458064516129,75,80,46,37.03002897240981,0.612638888888889,42.17379385964913,8250.438596491242,110.00584795321656,0
720,32,0,0,155,0.0,0.0,1.0,155,4800,3700,1100,0.7708333333333334,59,37,22,201.78854303899902,0.4391931992738444,0.6990786102900233,0.12401793414003165,1065173.3736582447,7187.95663088662,1072361.3302891313,719,2,349.458064516129,75,80,40,36.77539840637451,0.6145833333333333,41.98190789473686,8256.57894736845,110.08771929824601,0
721,32,0,0,155,0.0,0.0,1.0,155,4350,3200,1150,0.735632183908046,55,32,23,203.1412463343042,0.4392926965507611,0.7037975697556231,0.1252477559934859,1066122.4369247258,7964.688116371051,1074087.125041097,720,3,350.458064516129,77,78,42,36.62324098504836,0.6148538961038961,41.8669871794872,8260.25641025645,107.2760572760578,0
722,32,2,1,156,0.012738853503184714,0.006369426751592357,0.9936305732484076,157,4200,2900,1300,0.6904761904761905,55,29,26,223.22844082917663,0.44016073275627415,0.7302937144548882,0.1360914252200874,1062760.5372299387,11847.675540123488,1074608.2127700623,721,0,346.9808917197452,71,86,41,36.52113506231057,0.613556338028169,42.27430555555556,8247.222222222224,116.15805946791865,8
723,32,2,0,158,0.012658227848101266,0.0,1.0,158,4500,3100,1400,0.6888888888888889,59,31,28,222.44787010074106,0.4405066650541536,0.7300625175733979,0.13635257392689717,1064381.3601300393,11253.873307171389,1075635.2334372106,722,0,342.0759493670886,75,83,37,36.34042760477556,0.6136111111111111,42.07785087719298,8253.508771929819,110.04678362573092,0
724,32,0,2,156,0.0,0.012658227848101266,0.9873417721518988,158,3750,2700,1050,0.72,48,27,21,222.99133069606935,0.4406007283184176,0.7314760190454075,0.13716735353200657,1065430.5842516073,12166.356749311315,1077596.9410009186,723,1,343.0759493670886,76,82,37,36.19648318042814,0.6144462719298245,41.95075757575758,8257.57575757576,108.65231259968105,0
725,32,0,1,155,0.0,0.00641025641025641,0.9935897435897436,156,5550,4400,1150,0.7927927927927928,67,44,23,225.2359089538263,0.43901209677419356,0.7321591837777099,0.13924683041234073,1066927.4670189156,11312.075564361694,1078239.5425832772,724,2,348.37820512820514,80,76,41,35.95327025232403,0.6145833333333333,41.76954732510288,8263.3744855967,103.29218106995874,0
726,32,1,1,155,0.00641025641025641,0.00641025641025641,0.9935897435897436,156,4500,3100,1400,0.6888888888888889,59,31,28,224.86622861853044,0.43859594706368904,0.7325421138028014,0.13966274260024975,1068299.7270686678,12344.906132027427,1080644.6332006953,725,0,349.2371794871795,65,91,42,35.79307150419413,0.6237179487179487,41.60353535353536,8268.686868686878,127.21056721056736,0
727,32,0,1,154,0.0,0.0064516129032258064,0.9935483870967742,155,4500,3200,1300,0.7111111111111111,58,32,26,227.46986244060423,0.4380114509146767,0.7333206602913511,0.14189136580597358,1069577.8724536544,13159.34630330947,1082737.218756964,726,1,352.43870967741935,66,89,40,35.56774904790541,0.6246843434343434,41.44900497512439,8273.631840796039,125.35805819387937,0
728,32,1,1,154,0.0064516129032258064,0.0064516129032258064,0.9935483870967742,155,4350,3100,1250,0.7126436781609196,56,31,25,223.85768794638008,0.4376152073732719,0.7287454546784802,0.14039666374901721,1071176.4090017425,12608.214860367229,1083784.6238621096,727,0,353.1290322580645,70,85,40,35.463682240870945,0.6244047619047619,41.25586854460094,8279.81220657278,118.28303152246829,0
729,32,1,0,155,0.0064516129032258064,0.0,1.0,155,4650,3300,1350,0.7096774193548387,60,33,27,219.68013247983464,0.4379398826979472,0.7250350288034084,0.13853328889155186,1072787.3936013745,11484.015349809397,1084271.4089511838,728,0,353.4258064516129,73,82,42,35.373006704720495,0.6248573059360731,41.06137387387388,8286.03603603606,113.50734295939807,0
730,32,1,2,154,0.00641025641025641,0.01282051282051282,0.9871794871794872,156,4700,3400,1300,0.723404255319149,60,34,26,223.0404914562394,0.4382426936862421,0.7291300203746691,0.1413672261202128,1074273.9196229514,12021.316598265004,1086295.2362212164,729,0,352.15384615384613,76,80,37,35.10265479795348,0.6252741228070176,40.88203463203465,8291.774891774938,109.10230120756496,0
731,32,1,3,152,0.0064516129032258064,0.01935483870967742,0.9806451612903225,155,4100,3000,1100,0.7317073170731707,52,30,22,220.07216145814306,0.4371613601452311,0.7244494606157634,0.140139215767906,1075640.2998095073,12243.697146112858,1087883.9969556201,730,0,351.3290322580645,78,77,39,35.011209147003,0.6260683760683761,40.717299578059084,8297.04641350214,106.37238991669409,0
732,32,0,0,152,0.0,0.0,1.0,152,3950,2800,1150,0.7088607594936709,51,28,23,222.7221243129219,0.435769940164982,0.7246565855879776,0.14198352626094324,1075962.9195887246,13578.149426547057,1089541.0690152717,731,1,358.8092105263158,77,75,40,34.902753458989935,0.6268939393939394,40.678418803418815,8298.290598290629,107.77000777000816,0
733,32,1,0,153,0.006535947712418301,0.0,1.0,153,4750,3600,1150,0.7578947368421053,59,36,23,222.7583050410945,0.4360810113519092,0.7280204070035226,0.14305762760682877,1078109.8907318148,12681.5863814918,1090791.4771133065,732,0,357.4575163398693,65,88,39,34.63745921241971,0.6357371794871796,40.41982323232324,8306.565656565668,127.79331779331797,0
734,32,0,0,153,0.0,0.0,1.0,153,4550,3300,1250,0.7252747252747253,58,33,25,222.64983816641842,0.4359036377708978,0.7277702517275164,0.1436357658449526,1079421.3002818574,12916.595564227971,1092337.8958460854,733,1,358.4575163398693,65,88,40,34.47893247047859,0.6373397435897437,40.26199494949494,8311.616161616148,127.87101787101766,0
735,32,0,0,153,0.0,0.0,1.0,153,3750,2400,1350,0.64,51,24,27,221.11544010535516,0.43550768260520584,0.7261613118200856,0.14300623974615667,1080151.728917599,13417.644984034929,1093569.3739016338,734,2,359.4575163398693,66,87,43,34.42897817935217,0.6376262626262627,40.17412935323382,8314.4278606965,125.97617970752273,0
736,32,0,1,152,0.0,0.006535947712418301,0.9934640522875817,153,4200,2600,1600,0.6190476190476191,58,26,32,218.77502255240069,0.43550409930053896,0.7242843251369275,0.14202084239940105,1081228.603316326,12509.162414965936,1093737.7657312918,735,3,360.4575163398693,69,84,45,34.35746894498823,0.6372282608695652,40.044642857142854,8318.571428571424,120.55900621118006,0
737,32,0,0,152,0.0,0.0,1.0,152,3800,2900,900,0.7631578947368421,47,29,18,220.14021510389915,0.43522895608225864,0.722515237432547,0.14357552705291482,1082573.7350399254,13463.602979504049,1096037.3380194295,736,4,361.73026315789474,72,80,36,34.15676943332051,0.6372974537037037,39.8829908675799,8323.744292237421,115.60755961440863,0
738,32,0,0,152,0.0,0.0,1.0,152,4650,3500,1150,0.7526881720430108,58,35,23,210.28652313211276,0.4350074793772511,0.7141875714207964,0.13166730615328273,1070688.918437021,9980.290002840891,1080669.208439862,737,5,362.73026315789474,73,79,41,35.874950118807924,0.6222888127853881,41.31475225225226,8277.927927927953,113.39627298531443,8
739,32,0,0,152,0.0,0.0,1.0,152,3650,2500,1150,0.684931506849315,48,25,23,210.6542213891751,0.4351427253979319,0.7148526906810968,0.13216819692941928,1071293.0931873245,11084.482484995251,1082377.5756723196,738,6,363.73026315789474,75,77,43,35.790925101965136,0.6220833333333333,41.241776315789465,8280.263157894718,110.40350877192958,0
740,32,0,2,150,0.0,0.013157894736842105,0.9868421052631579,152,5050,3700,1350,0.7326732673267327,64,37,27,209.21055743004186,0.4343239877425351,0.7111733610800297,0.13178432234610768,1072460.5412454063,9424.013531135191,1081884.5547765414,739,7,364.73026315789474,80,72,42,35.68437893237962,0.6213541666666667,41.10082304526749,8284.773662551439,103.55967078189299,0
741,32,0,0,150,0.0,0.0,1.0,150,4050,3300,750,0.8148148148148148,48,33,15,221.56031975502742,0.43417505592841166,0.7096358966068534,0.13511320583943554,1062846.4475308587,13046.919753086186,1075893.367283945,740,8,369.7866666666667,74,76,41,36.55347936986941,0.6121903153153153,42.26388888888887,8247.555555555511,111.45345345345285,8
742,32,2,0,152,0.013157894736842105,0.0,1.0,152,4400,3300,1100,0.75,55,33,22,212.61911814190393,0.43585526315789475,0.7016262966937514,0.13071767272758092,1065272.216992464,10499.447871601507,1075771.6648640654,741,0,365.9078947368421,78,74,39,36.4837242577546,0.6133814102564102,41.96993670886074,8256.962025316416,105.85848750405661,0
743,32,0,1,151,0.0,0.006578947368421052,0.993421052631579,152,3800,2500,1300,0.6578947368421053,51,25,26,215.95527357713726,0.4357871863018474,0.7089011601232225,0.13327089200925366,1066396.1947916115,11858.77639756798,1078254.9711891795,742,1,366.9078947368421,80,72,40,36.25861353258615,0.6139322916666667,41.83384773662551,8261.316872427966,103.26646090534958,0
744,32,1,0,152,0.006578947368421052,0.0,1.0,152,3450,2400,1050,0.6956521739130435,45,24,21,216.41202173819806,0.4354077712908098,0.712501800201625,0.13412909327070466,1067675.2670107344,12361.552618732476,1080036.8196294669,743,0,367.6381578947368,83,69,41,36.088691933496584,0.6143323293172691,41.67906746031745,8266.269841269803,99.5936125454193,0
745,32,0,0,152,0.0,0.0,1.0,152,4600,2800,1800,0.6086956521739131,64,28,36,215.84297834894832,0.4351853868943883,0.70886942844014,0.13447288483748354,1069213.445216055,11156.442901234914,1080369.8881172899,744,1,368.6381578947368,71,81,42,35.9133646742781,0.6214788732394366,41.49305555555558,8272.222222222268,116.51017214397561,0
746,32,2,1,153,0.012987012987012988,0.006493506493506494,0.9935064935064936,154,5000,3800,1200,0.76,62,38,24,215.636838301497,0.43633109809580395,0.71324644238364,0.1352845174627355,1071271.6221288953,10401.125111598616,1081672.7472404938,745,0,364.8376623376623,73,81,40,35.664644761179424,0.6230022831050228,41.2443693693694,8280.180180180256,113.42712575589391,0
747,32,3,2,154,0.019230769230769232,0.01282051282051282,0.9871794871794872,156,4100,2800,1300,0.6829268292682927,54,28,26,214.61196555430416,0.438003170664461,0.7147113649433816,0.13562720990308755,1073415.5417899487,10773.56385601619,1084189.1056459649,746,0,357.40384615384613,77,79,36,35.42681747873164,0.6237824675324675,40.98557692307695,8288.4615384616,107.64235764235845,0
748,32,0,0,154,0.0,0.0,1.0,154,3850,2500,1350,0.6493506493506493,52,25,27,218.38743339422282,0.43628158334040684,0.7176835226806484,0.13825909874158032,1073937.4291383338,12256.887755102649,1086194.3168934365,747,1,363.04545454545456,76,78,38,35.264694619950255,0.6248629385964912,40.92261904761909,8290.476190476284,109.08521303258267,0
749,32,0,0,154,0.0,0.0,1.0,154,4050,2900,1150,0.7160493827160493,52,29,23,221.30118269164151,0.4362594785388903,0.7203348542625034,0.14043723843407557,1074633.4762400566,12713.531850391328,1087347.0080904479,748,2,364.04545454545456,77,77,38,35.10340444536055,0.6252705627705628,40.838675213675245,8293.162393162469,107.70340770340869,0
750,32,1,0,155,0.0064516129032258064,0.0,1.0,155,4600,3300,1300,0.717391304347826,59,33,26,217.47193055414567,0.43638807429130005,0.7174618495228238,0.13879600719987414,1076298.1797960189,11212.92860243122,1087511.10839845,749,0,362.69032258064516,79,76,41,34.997625801161405,0.6264504219409283,40.63802083333337,8299.583333333427,105.05801687763831,0
751,32,0,0,155,0.0,0.0,1.0,155,3700,2600,1100,0.7027027027027027,48,26,22,218.35710825473353,0.4361978075687753,0.7194021421441226,0.1398155921652499,1077246.981229639,12344.907139489038,1089591.8883691279,750,1,363.69032258064516,71,84,39,34.85787798531733,0.6313086854460094,40.523726851851855,8303.240740740746,116.94705268648939,0
752,32,0,1,154,0.0,0.0064516129032258064,0.9935483870967742,155,3600,2200,1400,0.6111111111111112,50,22,28,221.56264754260644,0.4359639016897081,0.7229675765187333,0.1422202311113379,1077967.8692183197,13167.483013974474,1091135.3522322942,751,2,364.69032258064516,71,84,42,34.68597300410604,0.6321889671361502,40.43692129629629,8306.018518518506,116.98617631716205,0
753,32,0,1,153,0.0,0.006493506493506494,0.9935064935064936,154,4850,3700,1150,0.7628865979381443,60,37,23,226.50647718080862,0.43536290778937836,0.728234473708768,0.14611824595138512,1079410.3685753145,13248.688003686431,1092659.056579001,752,3,367.8376623376623,71,83,40,34.38010592472938,0.633949530516432,40.263310185185176,8311.574074074053,117.06442357850779,0
754,32,0,0,153,0.0,0.0,1.0,153,4400,2900,1500,0.6590909090909091,59,29,30,227.9798494594536,0.43520131005618623,0.728420945327259,0.1474701626574488,1080199.5403817664,14252.745720481093,1094452.2861022474,753,4,371.01307189542484,72,81,41,34.244741611291104,0.6344039351851851,40.168378995433784,8314.611872146103,115.48072044647364,0
755,32,0,0,153,0.0,0.0,1.0,153,4550,3200,1350,0.7032967032967034,59,32,27,230.0790685511048,0.43521385162252035,0.7334014075093813,0.14969341867460728,1081873.7015235424,14633.298707294372,1096507.0002308367,754,5,372.01307189542484,75,78,35,33.98429264178788,0.635,39.96710526315788,8321.052631578921,110.94736842105227,0
756,32,0,0,153,0.0,0.0,1.0,153,4250,2700,1550,0.6352941176470588,58,27,31,230.54622360158385,0.43545393303520236,0.7352912658655515,0.15056221863836552,1082955.980280697,15084.282316093111,1098040.2625967902,755,6,373.01307189542484,77,76,37,33.83911460739522,0.6354166666666667,39.83707264957264,8325.213675213654,108.11965811965784,0
757,32,0,1,152,0.0,0.006535947712418301,0.9934640522875817,153,4200,2400,1800,0.5714285714285714,60,24,36,232.91318463786345,0.43520668501318654,0.7383101613908667,0.15282170170506224,1084300.417601342,15709.572673538525,1100009.9902748805,756,7,374.01307189542484,78,75,38,33.61233517364803,0.6366185897435898,39.67563291139239,8330.379746835411,106.79974034404374,0
758,32,0,0,152,0.0,0.0,1.0,152,4800,3600,1200,0.75,60,36,24,231.58113253430122,0.43469704891367494,0.7346442980043739,0.15229829232336328,1084960.940212671,15051.296657985968,1100012.236870657,757,8,376.9013157894737,79,73,38,33.56589704485222,0.6369989451476794,39.59635416666666,8332.916666666644,105.47995780590689,0
759,32,1,1,152,0.006535947712418301,0.006535947712418301,0.9934640522875817,153,4350,3100,1250,0.7126436781609196,56,31,25,232.52290297819118,0.4348429795894966,0.7368383841876951,0.15366024007999315,1086346.3721885788,15570.082420222814,1101916.4546088018,758,0,375.4313725490196,67,86,39,33.37130119537528,0.644589552238806,39.43014705882352,8338.235294117629,124.45127304653177,0
760,32,0,0,152,0.0,0.0,1.0,152,3900,2500,1400,0.6410256410256411,53,25,28,233.88479859880252,0.43490309486464507,0.7375689753297212,0.15497600206219686,1087112.889273354,16551.83583237204,1103664.7251057262,759,1,375.86842105263156,67,85,39,33.241752860053296,0.6455223880597014,39.33823529411764,8341.176470588216,124.49517120280919,0
761,32,0,1,151,0.0,0.006578947368421052,0.993421052631579,152,4150,3000,1150,0.7228915662650602,53,30,23,231.36145107125765,0.43459811054955266,0.7351710946695817,0.1540768812453266,1088544.444444442,15819.444444444274,1104363.8888888862,760,2,376.86842105263156,69,83,39,33.13198881789137,0.6461352657004831,39.16666666666666,8346.666666666646,120.96618357487893,0
762,32,0,0,151,0.0,0.0,1.0,151,4300,3100,1200,0.7209302325581395,55,31,24,232.51606432613457,0.43440765268579834,0.7342740928914411,0.15558567509063267,1089897.3336762658,16183.72770919048,1106081.0613854562,761,3,379.0927152317881,71,80,40,32.9360679970436,0.6467136150234742,39.00462962962962,8351.851851851829,117.63171622326519,0
763,32,0,0,151,0.0,0.0,1.0,151,4750,3300,1450,0.6947368421052632,62,33,29,230.42029627799877,0.43433958793230315,0.7317627318327065,0.15475367472689625,1090942.6106850086,15325.063915266594,1106267.6746002752,762,4,380.0927152317881,73,78,34,32.86275831087152,0.6469748858447488,38.8795045045045,8355.85585585585,114.46377884734042,0
764,32,0,1,150,0.0,0.006622516556291391,0.9933774834437086,151,3650,2400,1250,0.6575342465753424,49,24,25,229.25127089567474,0.43392568064753495,0.7309239470684117,0.1542250935532393,1091413.14879068,16191.570286502627,1107604.7190771827,763,5,381.0927152317881,73,78,35,32.83568682404513,0.6475456621004566,38.82319819819819,8357.657657657639,114.48846106380327,0
765,32,0,0,150,0.0,0.0,1.0,150,4500,3400,1100,0.7555555555555555,56,34,22,228.19819980979193,0.43335011185682326,0.729054250380921,0.1541034074379552,1092489.4938271623,15360.827160493884,1107850.3209876562,764,6,383.99333333333334,74,76,37,32.73149870663691,0.6483671171171171,38.69444444444445,8361.777777777792,112.99699699699718,0
766,32,0,0,150,0.0,0.0,1.0,150,4550,3400,1150,0.7472527472527473,57,34,23,229.86262988179163,0.4330266592095451,0.7319761408669359,0.15615730201544886,1094169.6416831054,15751.74227481932,1109921.3839579248,765,7,384.99333333333334,64,86,39,32.48253462434122,0.6559244791666667,38.49358974358975,8368.205128205143,130.75320512820537,0
767,32,0,0,150,0.0,0.0,1.0,150,4100,2700,1400,0.6585365853658537,55,27,28,230.22309566636685,0.4326565995525727,0.7325717202654407,0.15692659861183483,1095108.5839907974,16323.85765943469,1111432.441650232,766,8,385.99333333333334,64,86,39,32.35834609494639,0.6570638020833333,38.38141025641026,8371.794871794888,130.80929487179512,0
768,32,0,1,149,0.0,0.006666666666666667,0.9933333333333333,150,3500,2000,1500,0.5714285714285714,50,20,30,230.68203245484543,0.432337807606264,0.7332226917345415,0.15754106683208582,1095645.3032544383,17049.13708086783,1112694.440335306,767,9,386.99333333333334,64,86,38,32.28075816032823,0.65771484375,38.31730769230769,8373.846153846156,130.8413461538462,0
769,32,0,0,149,0.0,0.0,1.0,149,4750,3500,1250,0.7368421052631579,60,35,25,232.77410781798244,0.4317106536066268,0.7323626249800732,0.15980082727070669,1097102.2112889292,16525.39768358333,1113627.6089725127,768,10,389.61073825503354,67,82,37,32.04803829803827,0.6576492537313433,38.14338235294118,8379.411764705896,125.06584723441635,0
770,32,0,0,149,0.0,0.0,1.0,149,3400,2400,1000,0.7058823529411765,44,24,20,237.85379380930206,0.4313214220932342,0.7369780856683363,0.1640380629690711,1098378.8584183683,19050.715702947855,1117429.5741213162,769,11,390.61073825503354,69,80,40,31.759089661308952,0.6580615942028986,37.99107142857143,8384.285714285721,121.51138716356118,0
771,32,0,1,148,0.0,0.006711409395973154,0.9932885906040269,149,4000,2700,1300,0.675,53,27,26,238.93215572039168,0.43113058528326986,0.7382377535373319,0.16532772634006684,1099298.102779433,18731.53309528544,1118029.6358747184,770,12,391.61073825503354,70,79,36,31.61860050748162,0.6586309523809524,37.88145539906104,8387.793427230063,119.82562038900089,0
772,32,0,0,148,0.0,0.0,1.0,148,3950,2300,1650,0.5822784810126582,56,23,33,224.57312415287558,0.4310956364527793,0.7233672328036871,0.15008250960942446,1089541.9767937795,15386.369124855697,1104928.3459186351,771,13,393.77027027027026,67,81,43,33.18688239898247,0.648476368159204,39.04718137254901,8350.490196078417,124.63418203102115,8
773,32,0,1,147,0.0,0.006756756756756757,0.9932432432432432,148,3850,2500,1350,0.6493506493506493,52,25,27,227.40968502722117,0.4310621207942637,0.7262276360867912,0.15232158148049724,1090181.6608996536,16133.57362552864,1106315.2345251823,772,14,394.77027027027026,67,81,45,33.03452660406886,0.6492537313432836,38.970588235294116,8352.941176470586,124.67076382791919,0
774,32,0,0,147,0.0,0.0,1.0,147,4850,3500,1350,0.7216494845360825,62,35,27,227.55749398294316,0.43064291926816384,0.7245725573835438,0.15294547919979531,1091154.3402777738,15410.06944444415,1106564.409722218,773,15,398.04761904761904,69,78,37,32.91159752692459,0.6493055555555556,38.85416666666665,8356.666666666635,121.11111111111066,0
775,32,0,1,146,0.0,0.006802721088435374,0.9931972789115646,147,3900,2300,1600,0.5897435897435898,55,23,32,232.35392868954,0.4302798745068804,0.7304579327519893,0.15686972971799445,1092417.5235292783,17465.500672264985,1109883.0242015433,774,16,399.04761904761904,70,77,38,32.63171439266329,0.6502976190476191,38.703051643192474,8361.50234741781,119.45003353454015,0
776,32,0,1,145,0.0,0.00684931506849315,0.9931506849315068,146,3650,2600,1050,0.7123287671232876,47,26,21,237.341261362907,0.4304814202487797,0.733343823104543,0.16052302083567557,1092920.2065382744,19029.01207776031,1111949.2186160348,775,17,401.05479452054794,71,75,38,32.439858381769525,0.650381455399061,38.642939814814795,8363.425925925882,117.79473135106875,0
777,32,0,0,145,0.0,0.0,1.0,145,4250,2700,1550,0.6352941176470588,58,27,31,235.39308899858696,0.4302662037037037,0.7297156202775101,0.159685581996339,1093767.3611111126,18243.05555555565,1112010.4166666684,776,18,402.6965517241379,70,75,40,32.387118193891105,0.6519345238095238,38.54166666666667,8366.666666666679,119.5238095238097,0
778,32,0,0,145,0.0,0.0,1.0,145,4400,3000,1400,0.6818181818181818,58,30,28,230.8560339878488,0.42981521392081734,0.723992072140093,0.1575229882168359,1095402.086046006,17176.036241319438,1112578.1222873256,777,19,403.6965517241379,63,82,40,32.30592187111222,0.658068783068783,38.346354166666664,8372.91666666666,132.90343915343905,0
779,32,0,1,144,0.0,0.006896551724137931,0.993103448275862,145,3600,2800,800,0.7777777777777778,44,28,16,233.29171893692103,0.4294859514687101,0.7270516951932537,0.15972885124148584,1096356.2393188477,18554.166327582494,1114910.40564643,778,20,404.6965517241379,63,82,42,32.1256010487264,0.6592261904761905,38.232421875,8376.5625,132.96130952380952,0
780,32,0,0,144,0.0,0.0,1.0,144,4250,3100,1150,0.7294117647058823,54,31,23,232.96649365215268,0.4288305733618234,0.7257934904950318,0.16013087780251092,1097447.208828394,18083.685641818443,1115530.8944702125,779,21,403.1111111111111,63,81,44,32.00087264102086,0.6605489417989419,38.10221354166666,8380.729166666648,133.0274470899468,0
781,32,0,0,144,0.0,0.0,1.0,144,4000,2600,1400,0.65,54,26,28,235.57832338559993,0.42847444800569806,0.7290052766055759,0.16259776976268198,1098599.6096318183,18961.25082182753,1117560.8604536457,780,22,404.1111111111111,64,80,42,31.791760952439176,0.6612955729166667,37.96474358974358,8385.128205128183,131.01762820512786,0
782,32,0,0,144,0.0,0.0,1.0,144,4100,3100,1000,0.7560975609756098,51,31,20,237.17812129998697,0.42776927933177933,0.7320996237665447,0.16449644945269515,1099943.7910913848,19276.52038132787,1119220.3114727128,781,23,405.1111111111111,64,80,35,31.58578326508157,0.6629231770833333,37.80448717948717,8390.256410256392,131.09775641025612,0
783,32,0,0,144,0.0,0.0,1.0,144,4300,3000,1300,0.6976744186046512,56,30,26,235.486883043954,0.4275841346153846,0.7298334890874765,0.1636935007955958,1100570.6977184226,18733.99263504403,1119304.6903534667,782,24,406.1111111111111,67,77,36,31.553659735607354,0.6618470149253731,37.729779411764696,8392.647058823506,125.26338893766427,0
784,32,1,0,145,0.006896551724137931,0.0,1.0,145,4650,3700,950,0.7956989247311828,56,37,19,235.24301761484577,0.42778176883780333,0.731333335799117,0.16452893122454695,1102263.526195117,18209.95962178413,1120473.485816901,783,0,404.3034482758621,73,72,39,31.353686224033762,0.6606735159817352,37.52815315315316,8399.099099099121,115.05615204245372,0
785,32,0,0,145,0.0,0.0,1.0,145,3600,2600,1000,0.7222222222222222,46,26,20,232.7251507084504,0.42749441251596426,0.7285974981409282,0.16315818439304355,1102923.4277445322,18735.604188345165,1121659.0319328774,784,1,405.3034482758621,61,84,40,31.339388558264535,0.6685450819672132,37.44959677419353,8401.61290322577,137.73135906927493,0
786,32,0,0,145,0.0,0.0,1.0,145,3600,2400,1200,0.6666666666666666,48,24,24,201.58179181641816,0.4270154853128991,0.6859185329718722,0.13112665741282928,1081816.6775173575,11014.908854166437,1092831.586371524,785,2,406.3034482758621,79,66,36,34.732306793523605,0.6331751054852321,39.97395833333332,8320.833333333305,105.32700421940892,8
787,32,1,0,146,0.00684931506849315,0.0,1.0,146,3350,2200,1150,0.6567164179104478,45,22,23,211.55217693308052,0.4275301133679736,0.7021872140941032,0.13278851589842197,1071419.3750137712,12782.220238488546,1084201.5952522599,786,0,404.513698630137,70,76,44,35.75211664209851,0.624702380952381,41.226525821596226,8280.751173708883,118.29644533869832,8
788,32,0,1,145,0.0,0.00684931506849315,0.9931506849315068,146,4150,3200,950,0.7710843373493976,51,32,19,222.31083504787,0.4277082349236341,0.7158750338271598,0.13092891477683372,1052308.1230550455,13437.899512804805,1065746.0225678503,787,1,405.513698630137,65,81,43,37.84354678236608,0.6040064102564102,43.54482323232323,8206.565656565657,126.25485625485626,8
789,32,3,0,148,0.02027027027027027,0.0,1.0,148,3850,2500,1350,0.6493506493506493,52,25,27,212.76617604195494,0.4295338067659496,0.7062086613881644,0.1265705536969496,1055362.8744876566,11459.10462827658,1066821.9791159332,788,0,400.9864864864865,73,75,49,37.708447519868436,0.603453196347032,43.17286036036034,8218.468468468416,112.5817598420331,0
790,32,3,2,149,0.019867549668874173,0.013245033112582781,0.9867549668874173,151,4850,3300,1550,0.6804123711340206,64,33,31,212.49911042416505,0.4321247240618102,0.7103226235813769,0.12760414561923872,1058207.1961402085,9923.617564848362,1068130.813705057,789,0,394.0,78,73,41,37.362100936560005,0.6047008547008548,42.82700421940925,8229.535864978814,105.50687006383095,0
791,32,0,0,149,0.0,0.0,1.0,149,3800,3200,600,0.8421052631578947,44,32,12,216.10864195601715,0.43087550637886207,0.7112038557944065,0.1301448261107418,1059074.0769276319,12175.012099130105,1071249.089026762,790,1,400.2684563758389,77,72,41,37.16168137382124,0.6061958874458875,42.721688034188,8232.905982905897,106.92085692085581,0
792,32,0,0,149,0.0,0.0,1.0,149,3900,2800,1100,0.717948717948718,50,28,22,216.44813613614525,0.43062042747445434,0.7104478434793615,0.1307852314551102,1060080.2579144079,12190.479196059565,1072270.7371104674,791,2,401.2684563758389,66,83,41,37.02811669485386,0.6130050505050505,42.59950248756219,8236.815920398009,124.80024121815164,0
793,32,0,0,149,0.0,0.0,1.0,149,4150,3100,1050,0.7469879518072289,52,31,21,215.21772576802394,0.43075269061007315,0.7107735374284181,0.13071645028226248,1061635.8418367303,11746.570294784296,1073382.4121315146,792,3,402.2684563758389,69,80,43,36.86693626035045,0.6132246376811594,42.41071428571427,8242.857142857109,119.4616977225668,0
794,32,1,0,150,0.006666666666666667,0.0,1.0,150,4050,2700,1350,0.6666666666666666,54,27,27,210.6009652914042,0.4318456375838926,0.7064873043991737,0.12852350800756449,1063064.5732991346,10726.48506077825,1073791.0583599128,793,0,400.58,72,78,44,36.80893858872157,0.6134259259259259,42.23744292237441,8248.401826483983,114.5611364789442,0
795,32,0,0,150,0.0,0.0,1.0,150,3950,2600,1350,0.6582278481012658,53,26,27,212.667544447291,0.43182233407904547,0.7085881133002239,0.13036826419898667,1064405.8194596618,11322.914383978532,1075728.7338436404,794,1,401.58,73,77,36,36.589657352325844,0.6145833333333333,42.074887387387385,8253.603603603598,113.063063063063,0
796,32,0,0,150,0.0,0.0,1.0,150,3800,2800,1000,0.7368421052631579,48,28,20,212.4160277669077,0.43214392244593586,0.7069519042749743,0.13073541609595646,1065597.4104938307,11469.993827160673,1077067.4043209914,795,2,402.58,74,76,38,36.448746927865386,0.6155686936936937,41.930555555555564,8258.22222222225,111.59759759759797,0
797,32,1,2,149,0.006622516556291391,0.013245033112582781,0.9867549668874173,151,3650,2900,750,0.7945205479452054,44,29,15,209.2521405456934,0.43205298013245036,0.7045622166176952,0.12944340126433213,1067106.8875208495,10808.880080958033,1077915.7676018076,796,0,400.9072847682119,76,75,41,36.34385367557188,0.6165021929824561,41.7478354978355,8264.069264069272,108.73775347459569,0
798,32,0,1,148,0.0,0.006711409395973154,0.9932885906040269,149,4500,3400,1100,0.7555555555555555,56,34,22,211.03209518000983,0.4301593959731544,0.7053813999426746,0.1311156578292645,1068401.8624997106,10793.416707507782,1079195.2792072184,797,1,407.0134228187919,68,81,37,36.13792818056122,0.6220894607843137,41.59118357487923,8269.082125603882,121.60414890593944,0
799,32,0,0,148,0.0,0.0,1.0,148,3950,2800,1150,0.7088607594936709,51,28,23,207.99337508410542,0.42977416191701906,0.6994536262881585,0.1297624736835307,1069623.8130668933,10944.93339002267,1080568.746456916,798,2,406.02027027027026,69,79,43,36.06564748201438,0.6230374396135265,41.44345238095238,8273.809523809523,119.9102829537612,0
800,32,1,0,149,0.006711409395973154,0.0,1.0,149,4450,2900,1550,0.651685393258427,60,29,31,203.2830094980504,0.4300743696716851,0.695292094172181,0.1275036600217277,1071201.3699933283,9301.407654135675,1080502.777647464,799,0,404.28859060402687,72,77,43,35.99296402507398,0.6234085648148149,41.25285388127854,8279.90867579909,114.9987316083207,0
801,32,1,1,149,0.006666666666666667,0.006666666666666667,0.9933333333333333,150,3800,2500,1300,0.6578947368421053,51,25,26,206.2744621119348,0.43050988068605517,0.7012273361227332,0.12999893585837405,1072605.4444444492,10450.222222222488,1083055.6666666716,800,0,402.58666666666664,74,76,46,35.742543718485166,0.6241554054054055,41.08333333333335,8285.33333333337,111.96396396396446,0
802,32,1,0,150,0.006666666666666667,0.0,1.0,150,3800,2500,1300,0.6578947368421053,51,25,26,210.4215309259821,0.43102535421327365,0.7097087652492773,0.1335117552600157,1074586.8440289316,11423.241766697449,1086010.085795629,801,0,400.5933333333333,75,75,39,35.391104294478524,0.6261111111111111,40.844298245614034,8292.982456140347,110.57309941520464,0
803,32,1,0,151,0.006622516556291391,0.0,1.0,151,4250,2700,1550,0.6352941176470588,58,27,31,211.43442010248037,0.43117181751287714,0.7149643319012127,0.13535209194822784,1077180.6429605717,11100.612917997141,1088281.2558785689,802,0,398.9337748344371,66,85,42,35.045663810493906,0.6339962121212122,40.53171641791045,8302.985074626877,125.80280416101328,0
804,32,0,0,151,0.0,0.0,1.0,151,4550,3200,1350,0.7032967032967034,59,32,27,215.39625657490208,0.4309234731420162,0.7192800103784549,0.13848769940938682,1078441.5248942699,11708.45347943092,1090149.9783737008,803,1,399.9337748344371,67,84,38,34.7877822358587,0.6349502487562189,40.37990196078431,8307.84313725489,123.99765876499835,0
805,32,0,1,150,0.0,0.006622516556291391,0.9933774834437086,151,5550,4000,1550,0.7207207207207207,71,40,31,212.5175489070082,0.43070640176600444,0.7156913803356875,0.13709652901931288,1079415.5967758868,10128.951375761359,1089544.5481516481,804,2,400.9337748344371,68,83,43,34.742807323452475,0.6355698529411764,40.26268115942029,8311.594202898546,122.22932651321392,0
806,32,0,0,150,0.0,0.0,1.0,150,5150,4100,1050,0.7961165048543689,62,41,21,210.42620683161275,0.43033090976882926,0.711097186941388,0.1363959112338827,1080794.5162170187,10335.498082390994,1091130.0142994097,805,3,399.6666666666667,70,80,46,34.62778718600055,0.6361607142857143,40.09683098591549,8316.901408450693,118.81287726358133,0
807,32,1,0,151,0.006622516556291391,0.0,1.0,151,5300,3900,1400,0.7358490566037735,67,39,28,212.5866026193087,0.4301471670345842,0.7151507426524031,0.13851646811479923,1082298.2608078273,10516.422057184489,1092814.6828650117,806,0,398.0132450331126,71,80,41,34.38705243737368,0.6374706572769953,39.91608796296296,8322.685185185182,117.22091810119976,0
808,32,0,0,151,0.0,0.0,1.0,151,4900,3500,1400,0.7142857142857143,63,35,28,207.86439793005536,0.43003311258278143,0.7093672512474856,0.1362569668278129,1084028.027777779,9966.166666666686,1093994.1944444457,807,1,399.0132450331126,74,77,45,34.29779627554561,0.6380912162162162,39.708333333333336,8329.333333333341,112.55855855855866,0
809,32,0,0,151,0.0,0.0,1.0,151,3950,2700,1250,0.6835443037974683,52,27,25,210.87712117475115,0.4297406181015453,0.7121957437439523,0.13886648942544746,1085340.7287597675,11624.705674913286,1096965.4344346807,808,2,400.0132450331126,63,88,47,34.05850310377868,0.6458333333333333,39.55078125000001,8334.375000000015,132.29166666666688,0
810,32,0,0,151,0.0,0.0,1.0,151,4200,2900,1300,0.6904761904761905,55,29,26,211.37639908415895,0.4297479764532745,0.7122313989915807,0.13970473774537498,1086385.0786909503,11527.233190490788,1097912.3118814412,809,3,401.0132450331126,65,86,44,33.9175752069453,0.6458333333333333,39.42550505050505,8338.383838383843,128.28282828282835,0
811,32,0,0,151,0.0,0.0,1.0,151,4650,3300,1350,0.7096774193548387,60,33,27,220.14476108648927,0.42973693892568066,0.7233664142420151,0.14301278904348788,1081436.0422500174,12764.495830289661,1094200.538080307,810,4,402.0132450331126,73,78,41,34.29637726280072,0.6354166666666667,40.0197072072072,8319.369369369348,113.96396396396366,8
812,32,0,0,151,0.0,0.0,1.0,151,4300,2500,1800,0.5813953488372093,61,25,36,216.73342890875352,0.4293892568064754,0.719424615119979,0.14142774598283067,1082724.6165084003,12432.523739956174,1095157.1402483564,811,5,403.0132450331126,73,78,36,34.22686688311687,0.636986301369863,39.86486486486486,8324.324324324323,114.03184005923731,0
813,32,0,0,151,0.0,0.0,1.0,151,4500,3300,1200,0.7333333333333333,57,33,24,217.19874560029214,0.4290710080941869,0.7202658215220292,0.14209977201816446,1083470.9838604147,12365.707717759125,1095836.6915781738,812,6,404.0132450331126,75,76,37,34.1231697039924,0.6369444444444444,39.7752192982456,8327.19298245611,111.02923976608147,0
814,32,1,0,152,0.006578947368421052,0.0,1.0,152,4050,2800,1250,0.691358024691358,53,28,25,214.24325311169048,0.4297537614732195,0.7182588373531893,0.14073877036013163,1084640.8173720054,12025.395434299908,1096666.2128063054,813,0,402.3486842105263,80,72,38,34.056624353781785,0.6361979166666667,39.63477366255142,8331.687242798294,104.14609053497868,0
815,32,0,0,152,0.0,0.0,1.0,152,4250,2800,1450,0.6588235294117647,57,28,29,211.2267081189746,0.4294959771116533,0.7136468736463863,0.13920953483135134,1085572.7234007763,11210.390557539129,1096783.1139583155,814,1,403.3486842105263,68,84,39,34.02097581237203,0.6430759803921569,39.52294685990337,8335.265700483067,122.57743677180981,0
816,32,1,0,153,0.006535947712418301,0.0,1.0,153,4750,3400,1350,0.7157894736842105,61,34,27,210.19257683489238,0.4291061088177961,0.7142281818472704,0.13953426533182162,1087638.451503226,10372.70575723497,1098011.157260461,815,0,401.70588235294116,70,83,41,33.794993716354334,0.6444940476190476,39.275234741784026,8343.192488262886,119.18846411804124,0
817,32,0,1,152,0.0,0.006535947712418301,0.9934640522875817,153,4900,3500,1400,0.7142857142857143,63,35,28,210.0298473619615,0.4291491084737989,0.7160719360207857,0.14006132424670387,1088930.8984910788,10241.598079560765,1099172.4965706395,816,1,402.70588235294116,71,82,38,33.641119491274765,0.6455399061032864,39.12037037037035,8348.14814814811,117.57955138236774,0
818,32,0,1,151,0.0,0.006578947368421052,0.993421052631579,152,4100,2600,1500,0.6341463414634146,56,26,30,208.59821160371487,0.42875076246078775,0.7086275637424913,0.13486913944104387,1080062.5185975025,10559.821959928695,1090622.340557431,817,2,403.14473684210526,70,82,43,34.76516178214468,0.6352678571428572,40.18485915492958,8314.08450704227,118.77263581488955,8
819,32,1,1,151,0.006578947368421052,0.006578947368421052,0.993421052631579,152,4750,3600,1150,0.7578947368421053,59,36,23,208.12662291806876,0.42879070088300225,0.7089384959561464,0.1354405474413238,1081937.0632930363,9885.981438614399,1091823.0447316507,818,0,404.01973684210526,71,81,39,34.54735543933828,0.6370305164319249,39.95949074074073,8321.296296296281,117.20135628586311,0
820,32,0,0,151,0.0,0.0,1.0,151,3950,2700,1250,0.6835443037974683,52,27,25,195.355689042068,0.4290710080941869,0.691936941709028,0.12552056321365734,1078251.4845679016,7978.512345679035,1086229.9969135807,819,1,403.04635761589407,74,77,38,35.33139835571487,0.631052927927928,40.40277777777778,8307.111111111113,112.25825825825828,8
821,32,0,3,148,0.0,0.019867549668874173,0.9801324503311258,151,3750,2400,1350,0.64,51,24,27,206.73724658093855,0.4286534216335541,0.7083472891456397,0.13448022196160683,1081816.6775173575,10780.36024305533,1092597.0377604128,820,2,404.04635761589407,71,80,37,34.59825154398265,0.6368838028169015,39.97395833333332,8320.833333333305,117.19483568075077,8
822,32,0,0,148,0.0,0.0,1.0,148,4500,3000,1500,0.6666666666666666,60,30,30,208.77432802838874,0.42693969479683763,0.7056324466642057,0.1362751440846959,1082811.2978513795,11112.640218093904,1093923.9380694735,821,6,410.19594594594594,72,76,39,34.42328085861079,0.6375868055555556,39.85445205479452,8324.657534246579,115.62024353120248,0
823,32,0,0,148,0.0,0.0,1.0,148,5100,3600,1500,0.7058823529411765,66,36,30,213.40573750580518,0.4268477661334804,0.7050211225290628,0.13362109246102138,1070690.5596332313,10998.30170380668,1081688.861337038,822,7,411.19594594594594,70,78,43,35.794058151845135,0.6238095238095238,41.314553990610335,8277.934272300481,118.25620389000687,8
824,32,1,1,148,0.006711409395973154,0.006711409395973154,0.9932885906040269,149,4450,3200,1250,0.7191011235955056,57,32,25,209.9823391437685,0.4272137069955862,0.7008124732516976,0.13215666529368436,1072207.5168520655,10778.928487225607,1082986.4453392911,823,0,409.4295302013423,71,78,42,35.69558160546959,0.6251467136150235,41.13136574074074,8283.796296296292,116.67318727177876,0
825,32,1,0,149,0.006711409395973154,0.0,1.0,149,3050,2000,1050,0.6557377049180327,41,20,21,208.04355603020628,0.4278296753128968,0.6989387185817626,0.13157749621971468,1073641.3611111133,11822.83333333346,1085464.1944444468,824,0,409.4563758389262,74,75,39,35.569138384000894,0.6254222972972974,40.95833333333334,8289.333333333352,112.01801801801827,0
826,32,0,1,148,0.0,0.006711409395973154,0.9932885906040269,149,4100,2800,1300,0.6829268292682927,54,28,26,209.6879743801361,0.42783345425962876,0.7008739055161906,0.1331080918878281,1074722.6555911636,11171.283334270374,1085893.938925434,825,1,410.4563758389262,76,73,40,35.39339527438492,0.6258223684210527,40.82792207792208,8293.506493506506,109.12508544087507,0
827,32,0,1,147,0.0,0.006756756756756757,0.9932432432432432,148,4600,3400,1200,0.7391304347826086,58,34,24,211.10841991739534,0.4266629512165226,0.7024820823264517,0.13433054214937948,1075421.5069700363,11206.107016325688,1086627.613986362,826,2,414.14864864864865,78,70,41,35.270551486793465,0.625801282051282,40.74367088607595,8296.202531645566,106.36157091853289,0
828,32,0,2,145,0.0,0.013605442176870748,0.9863945578231292,147,4550,3500,1050,0.7692307692307693,56,35,21,215.3871473527757,0.4266979622899388,0.7044493853047573,0.13769653984217625,1076787.717614617,12435.246960303577,1089222.9645749205,827,3,417.4149659863946,67,80,42,34.99145015254404,0.632929104477612,40.57904411764705,8301.470588235275,123.90254609306382,0
829,32,1,0,146,0.00684931506849315,0.0,1.0,146,4100,3000,1100,0.7317073170731707,52,30,22,216.62703453141214,0.42727326405290506,0.7024284949355237,0.1389646260322398,1077785.0124857028,13395.474223435645,1091180.4867091384,828,0,419.2054794520548,68,78,41,34.836576120676305,0.633578431372549,40.45893719806762,8305.314009661814,122.13697073032078,0
830,32,0,0,146,0.0,0.0,1.0,146,4300,3100,1200,0.7209302325581395,55,31,24,217.21842206457555,0.4268441977641317,0.6999545003981207,0.14008807744295754,1079330.7689446546,13390.105303180648,1092720.8742478353,829,1,420.2054794520548,70,76,41,34.63113596565554,0.634375,40.272887323943664,8311.26760563381,118.73239436619728,0
831,32,1,0,147,0.006802721088435374,0.0,1.0,147,4050,2800,1250,0.691358024691358,53,28,25,215.3806611218436,0.4276104277327369,0.6964132346325307,0.1395778570127266,1080733.5069444398,13103.819444444205,1093837.326388884,830,0,418.34013605442175,75,72,43,34.50651302605208,0.6336111111111111,40.10416666666665,8316.66666666663,110.8888888888884,0
832,32,1,0,148,0.006756756756756757,0.0,1.0,148,4350,3400,950,0.7816091954022989,53,34,19,234.45441471934345,0.4279231399767114,0.7344108620130214,0.1485423329544258,1074157.1406976513,16418.17674777431,1090575.3174454255,831,0,416.5067567567568,72,76,35,34.8213138377942,0.627025462962963,40.89611872146119,8291.324200913252,115.15728056823961,8
833,32,0,1,147,0.0,0.006756756756756757,0.9932432432432432,148,4800,3600,1200,0.75,60,36,24,232.5706785037154,0.4276195838695838,0.7327916395855969,0.14825288966687897,1075945.1882716096,15646.660493827454,1091591.848765437,832,1,417.5067567567568,74,74,39,34.64954564119044,0.6282376126126126,40.68055555555557,8298.222222222257,112.13813813813861,0
834,32,0,0,147,0.0,0.0,1.0,147,3700,2600,1100,0.7027027027027027,48,26,22,228.72822206830486,0.4265970086664803,0.7261631659963264,0.1464288150624188,1077192.3783287366,16176.85950413188,1093369.2378328685,833,2,421.3333333333333,65,82,38,34.595498783454985,0.6346153846153846,40.53030303030301,8303.03030303026,127.73892773892707,0
835,32,0,0,147,0.0,0.0,1.0,147,3950,2600,1350,0.6582278481012658,53,26,27,233.30217523789773,0.42617572143012455,0.7299159213332003,0.14994918099008503,1078342.7545110248,16965.942055889594,1095308.6965669144,834,3,422.3333333333333,66,81,41,34.335075058889295,0.6354166666666667,40.39179104477611,8307.462686567149,125.87064676616892,0
836,32,0,0,147,0.0,0.0,1.0,147,4000,3000,1000,0.75,50,30,20,231.42235073919795,0.4261097132917094,0.7272154865658178,0.149072407419854,1078988.6427625522,16540.417625801176,1095529.0603883534,835,4,423.3333333333333,66,81,39,34.30434153545272,0.6362058080808081,40.31405472636815,8309.950248756195,125.90833710236659,0
837,32,0,0,147,0.0,0.0,1.0,147,4200,2900,1300,0.6904761904761905,55,29,26,234.3753616427221,0.4258631534805703,0.7314189003549731,0.15164984201063889,1080280.999387388,17038.24998143592,1097319.2493688238,836,5,424.3333333333333,66,81,38,34.06853946030035,0.6377840909090908,40.158582089552226,8314.925373134301,125.98371777476214,0
838,32,0,0,147,0.0,0.0,1.0,147,4500,3100,1400,0.6888888888888889,59,31,28,237.82396679779882,0.4261077718758736,0.7354667500471028,0.15439451861356657,1081243.1666906911,17529.107795078497,1098772.2744857697,837,6,425.3333333333333,67,80,44,33.860489098408955,0.6383706467661692,40.04289215686273,8318.627450980355,124.15861867134859,0
839,32,1,1,147,0.006756756756756757,0.006756756756756757,0.9932432432432432,148,4250,3000,1250,0.7058823529411765,55,30,25,234.245977334534,0.42650016087516085,0.7315979002529982,0.1527569251540653,1082539.092640816,16866.085551697477,1099405.1781925135,838,0,423.4527027027027,71,77,36,33.794113966294,0.6377640845070423,39.88715277777777,8323.611111111097,117.2339593114239,0
840,32,0,1,146,0.0,0.006802721088435374,0.9931972789115646,147,3850,2000,1850,0.5194805194805194,57,20,37,234.20067109464983,0.42557194110520924,0.7304410419338316,0.15290389579204866,1082871.4845678988,17471.84567901221,1100343.330246911,839,8,427.3333333333333,74,73,37,33.75442670795293,0.6366835585585586,39.847222222222214,8324.88888888887,112.49849849849825,0
841,32,0,0,146,0.0,0.0,1.0,146,4700,3300,1400,0.7021276595744681,61,33,28,233.14128137413047,0.4254202094158401,0.7271423689231915,0.15278059446996772,1083942.3923839459,16642.34365922651,1100584.7360431724,840,9,426.26027397260276,76,70,39,33.650381150381136,0.6370614035087719,39.7186147186147,8329.004329004292,109.59216222374069,0
842,32,0,0,146,0.0,0.0,1.0,146,4000,2800,1200,0.7,52,28,24,233.4382802406012,0.4253621476932767,0.7278256581566387,0.15365059325914726,1085205.0823635557,17465.6816270618,1102670.7639906174,841,10,427.26027397260276,63,83,40,33.487555465283414,0.6456679894179894,39.56705729166668,8333.854166666692,132.28339947089987,0
843,32,1,0,147,0.006802721088435374,0.0,1.0,147,3100,2200,900,0.7096774193548387,40,22,18,230.24220871037278,0.42588256763892773,0.7254697372043071,0.15203353525563376,1086121.888072649,17514.22048770558,1103636.1085603547,842,0,425.3469387755102,65,82,40,33.45827275664326,0.6455128205128204,39.45707070707072,8337.373737373764,128.26728826728868,0
844,32,0,0,147,0.0,0.0,1.0,147,4200,2700,1500,0.6428571428571429,57,27,30,226.53522613621035,0.4253370297890846,0.7209513409255288,0.15022312922120135,1087335.1186725488,15663.941398865829,1102999.0600714146,843,1,426.3469387755102,68,79,42,33.40608350706511,0.6452205882352942,39.311594202898554,8342.028985507255,122.67689684569493,0
845,32,0,0,147,0.0,0.0,1.0,147,4450,3600,850,0.8089887640449438,53,36,17,227.38112246765974,0.4249681607802938,0.7215927658047119,0.15140005974644413,1088495.4622098804,15650.663999647331,1104146.1262095277,844,2,427.3469387755102,70,77,45,33.241811039862,0.6455357142857143,39.17253521126761,8346.478873239446,119.23541247484923,0
846,32,0,0,147,0.0,0.0,1.0,147,4100,3100,1000,0.7560975609756098,51,31,20,228.12013042011364,0.4246594756624111,0.7213101894488803,0.1525141183290593,1089655.684692218,16214.479381001503,1105870.1640732195,845,3,428.3469387755102,71,76,42,33.08039509184316,0.6464201877934272,39.033564814814824,8350.925925925947,117.61867501304151,0
847,32,0,1,146,0.0,0.006802721088435374,0.9931972789115646,147,3200,2500,700,0.78125,39,25,14,226.36300296966206,0.4246536514149039,0.719710873350849,0.15190235090742774,1090707.3796769774,16779.159564970498,1107486.539241948,846,4,429.3469387755102,73,74,37,32.99749299115807,0.646689497716895,38.907657657657666,8354.954954954977,114.45143773910928,0
848,32,0,0,146,0.0,0.0,1.0,146,4050,2800,1250,0.691358024691358,53,28,25,229.69370485821,0.42468410486537556,0.7221561085956372,0.15479429934353567,1091908.8919753118,16910.91975308662,1108819.8117283983,847,5,427.6506849315069,74,72,38,32.763459868502686,0.6476632882882882,38.7638888888889,8359.55555555558,112.9669669669673,0
849,32,0,0,146,0.0,0.0,1.0,146,3750,2600,1150,0.6933333333333334,49,26,23,227.0375107294648,0.4248228625413321,0.7189745564450631,0.15339921632602624,1092635.7996711135,16663.86241824578,1109299.6620893592,848,6,428.6506849315069,76,70,40,32.7439345308968,0.6476151315789473,38.67694805194807,8362.337662337703,110.03075871496976,0
850,32,0,1,145,0.0,0.00684931506849315,0.9931506849315068,146,4550,3100,1450,0.6813186813186813,60,31,29,226.65713101992168,0.4245227129585892,0.7193869937624973,0.15383383227017527,1093903.541564943,15838.207668728423,1109741.7492336715,849,7,429.6506849315069,63,83,42,32.59888214545077,0.65625,38.52539062500001,8367.187500000013,132.8125000000002,0
851,32,0,0,145,0.0,0.0,1.0,145,4450,3300,1150,0.7415730337078652,56,33,23,220.98302967779102,0.42347741060025546,0.7137418526267563,0.15621779316777273,1105203.8616457556,15396.259551614396,1120600.1211973699,850,19,433.5655172413793,67,78,41,31.370395465407707,0.6674440298507462,37.17830882352939,8410.294117647016,125.52677787532859,8
852,32,0,0,145,0.0,0.0,1.0,145,4250,2900,1350,0.6823529411764706,56,29,27,217.89769659123266,0.42312420178799487,0.7089695758729961,0.1547704217910067,1106503.6281179087,14970.918367346625,1121474.5464852552,851,20,434.5655172413793,69,76,41,31.293618907499607,0.6678743961352658,37.023809523809504,8415.238095238055,121.95997239475443,0
853,32,0,0,145,0.0,0.0,1.0,145,3050,1800,1250,0.5901639344262295,43,18,25,216.01803744730995,0.4226712164750958,0.7064254011608071,0.15364663226886044,1106879.340277771,15771.1805555551,1122650.520833326,852,21,435.5655172413793,69,76,39,31.297442244224417,0.6683272946859904,36.97916666666664,8416.666666666613,121.98067632850164,0
854,32,0,0,145,0.0,0.0,1.0,145,4250,3200,1050,0.7529411764705882,53,32,21,217.81286630390144,0.422198275862069,0.7091613091759215,0.1555211612271798,1107929.202759587,15014.247062972136,1122943.449822559,853,22,436.5655172413793,70,75,35,31.122811663693117,0.6690476190476191,36.85446009389669,8420.657276995255,120.29510395707507,0
855,32,0,0,145,0.0,0.0,1.0,145,3800,2800,1000,0.7368421052631579,48,28,20,219.80554577690174,0.4218350893997446,0.711842674215476,0.15744394841816095,1108794.1690636736,15943.82149705721,1124737.9905607307,854,23,437.5655172413793,70,75,38,30.96541826896283,0.6700892857142857,36.751760563380266,8423.943661971798,120.34205231388283,0
856,32,0,0,145,0.0,0.0,1.0,145,3850,2800,1050,0.7272727272727273,49,28,21,220.55118718821038,0.421429996807152,0.7130802551246638,0.1581398937923969,1109072.265624994,16071.4409722218,1125143.7065972157,855,24,438.5655172413793,71,74,38,30.912050774810385,0.6698943661971831,36.71874999999998,8424.999999999955,118.66197183098528,0
857,32,0,1,144,0.0,0.006896551724137931,0.993103448275862,145,4450,3500,950,0.7865168539325843,54,35,19,217.43331858010154,0.42078544061302686,0.7086749576635836,0.15655366258520298,1110199.205751355,14828.859518301793,1125028.065269657,856,25,439.5655172413793,73,72,39,30.85750325085946,0.6702340182648402,36.58502252252251,8429.279279279246,115.46957916820885,0
858,32,0,0,144,0.0,0.0,1.0,144,3750,2500,1250,0.6666666666666666,50,25,25,220.65114124665934,0.4201904865967366,0.7096156267753702,0.15922300496730213,1110798.8919753078,16469.808641975258,1127268.7006172831,857,29,443.44444444444446,74,70,40,30.70003777695781,0.6704673423423424,36.513888888888886,8431.555555555551,113.93993993993988,0
859,32,0,0,144,0.0,0.0,1.0,144,4350,3100,1250,0.7126436781609196,56,31,25,217.47684710099503,0.4200852677415177,0.7047233197115541,0.15773257545112673,1112171.85472535,15224.325680027165,1127396.1804053772,858,30,444.44444444444446,67,77,40,30.61734985377571,0.675839552238806,36.351102941176485,8436.764705882382,125.9218612818266,0
860,32,0,1,143,0.0,0.006944444444444444,0.9930555555555556,144,4050,2900,1150,0.7160493827160493,52,29,23,219.53113297727023,0.4192627395752396,0.7059671105768921,0.15974295811103276,1113050.4832376512,16019.846729212053,1129070.3299668632,859,31,445.44444444444446,68,76,40,30.456780760498354,0.6763174019607843,36.24698067632851,8440.09661835751,124.11906791702219,0
861,32,0,1,142,0.0,0.006993006993006993,0.993006993006993,143,3350,2500,850,0.746268656716418,42,25,17,219.55238770543062,0.41921107061952134,0.7034236070788413,0.1600421352484325,1113527.4376417252,16945.52154195028,1130472.9591836755,860,32,447.8251748251748,69,74,42,30.398475105294825,0.6763285024154589,36.1904761904762,8441.904761904776,122.3464458247069,0
862,32,0,0,142,0.0,0.0,1.0,142,3600,2500,1100,0.6944444444444444,47,25,22,218.35451836386954,0.4184407568341491,0.7001928792203904,0.15963946971845136,1114319.704995075,16663.34849751394,1130983.053492589,861,33,451.4718309859155,71,71,39,30.33419448860625,0.6762030516431925,36.09664351851853,8444.907407407443,118.94235785080906,0
863,32,0,0,142,0.0,0.0,1.0,142,3150,2100,1050,0.6666666666666666,42,21,21,216.61704217362848,0.4183398261911897,0.6979228074391419,0.15888355987353964,1115188.324938116,16763.75928293171,1131952.0842210476,862,34,452.4718309859155,73,69,41,30.274982226961693,0.6762271689497716,35.99380630630631,8448.198198198214,115.72874244107142,0
864,32,0,0,142,0.0,0.0,1.0,142,3750,2600,1150,0.6933333333333334,49,26,23,218.1931377142008,0.41793922518562915,0.7001287277726091,0.1605712347822462,1116074.8641975303,16553.975308641973,1132628.8395061723,863,35,453.4718309859155,74,68,42,30.126165685037154,0.6768018018018018,35.888888888888886,8451.555555555553,114.21021021021018,0
865,32,0,0,142,0.0,0.0,1.0,142,3800,2900,900,0.7631578947368421,47,29,18,213.79892606867907,0.4174605850231412,0.6927012384068387,0.15787171361237656,1116979.0466117538,15561.78412136183,1132540.8307331156,864,36,454.4718309859155,76,66,35,30.132972368712977,0.6769462719298245,35.781926406926395,8454.978354978326,111.24971519708323,0
866,32,0,0,142,0.0,0.0,1.0,142,3900,2700,1200,0.6923076923076923,51,27,24,210.15298000879613,0.4171442663070622,0.6879862292408805,0.15599544601552778,1118374.0394888192,14705.92743260993,1133079.9669214291,865,37,455.4718309859155,77,65,37,30.060899378693723,0.6781655844155844,35.61698717948717,8460.256410256381,109.8734598734595,0
867,32,0,0,142,0.0,0.0,1.0,142,3700,2600,1100,0.7027027027027027,48,26,22,207.99750764973408,0.4166011137748477,0.6851522118016331,0.15505482250727415,1119504.1667808068,14470.81529877994,1133974.9820795867,866,38,456.4718309859155,77,65,39,29.981561653287567,0.6795183982683983,35.48344017094016,8464.529914529896,109.92895992895969,0
868,32,0,0,142,0.0,0.0,1.0,142,4750,3500,1250,0.7368421052631579,60,35,25,207.55725816144337,0.4162712682715679,0.6848963598175981,0.15492666769907726,1119846.1784970346,13336.44047428295,1133182.6189713175,867,39,457.4718309859155,78,64,39,29.95196620813396,0.6794871794871795,35.44303797468354,8465.822784810118,108.53618954884766,0
869,32,0,0,142,0.0,0.0,1.0,142,3950,2800,1150,0.7088607594936709,51,28,23,233.35159236803298,0.4156094962208237,0.7228569973693701,0.16434277032933833,1104173.4286392224,19182.125564686492,1123355.554203909,868,40,458.4718309859155,67,75,37,31.170731529535235,0.6662002487562189,37.300857843137244,8406.372549019585,125.46824700029231,8
870,32,1,0,143,0.006993006993006993,0.0,1.0,143,4400,3000,1400,0.6818181818181818,58,30,28,231.31152045542905,0.4158171640566007,0.7208031465759932,0.16354780121232065,1105251.7148526025,18131.490929704953,1123383.2057823073,869,0,456.2587412587413,69,74,39,31.093118937077723,0.6663647342995169,37.17261904761903,8410.47619047615,121.89095928226305,0
871,32,0,0,143,0.0,0.0,1.0,143,4300,3400,900,0.7906976744186046,52,34,18,230.6256911572795,0.4155442562132703,0.7214328681471385,0.16392530292170374,1106694.1220877622,18146.419361237422,1124840.5414489997,870,1,457.2587412587413,70,73,39,30.935745100226825,0.6675595238095238,37.00117370892016,8415.962441314501,120.22803487592144,0
872,32,0,2,141,0.0,0.013986013986013986,0.986013986013986,143,4450,3000,1450,0.6741573033707865,59,30,29,229.7277204304171,0.414906103286385,0.7195484849243399,0.16379426563403005,1107539.9934321602,17836.52759533772,1125376.521027498,871,2,458.2587412587413,72,71,40,30.85656434175796,0.6675347222222222,36.90068493150684,8419.178082191755,116.93302891932993,0
873,32,1,0,142,0.007042253521126761,0.0,1.0,142,2750,2100,650,0.7636363636363637,34,21,13,226.33146664881534,0.41370430026970334,0.7134062445910623,0.1619399957348677,1108494.969606032,19027.458448753438,1127522.4280547854,872,0,461.8380281690141,75,67,36,30.829948621814896,0.6672222222222222,36.78728070175438,8422.807017543855,112.3040935672514,0
874,32,0,1,141,0.0,0.007042253521126761,0.9929577464788732,142,4650,3300,1350,0.7096774193548387,60,33,27,234.32672721070452,0.4136210585023141,0.7229506463672994,0.16826126755792734,1109466.0973226717,18945.511907371114,1128411.609230043,873,1,462.8380281690141,77,65,37,30.50152990499376,0.667478354978355,36.67200854700856,8426.495726495756,109.43500943500982,0
875,32,0,1,140,0.0,0.0070921985815602835,0.9929078014184397,141,3600,2300,1300,0.6388888888888888,49,23,26,234.46718637617744,0.4131585612968592,0.7204266970463908,0.1686419347086427,1109916.2762984906,20247.789283366357,1130164.065581857,874,2,466.60283687943263,77,64,38,30.4431599229287,0.6680194805194806,36.61858974358975,8428.205128205149,109.45720945720973,0
876,32,0,0,140,0.0,0.0,1.0,140,3500,1900,1600,0.5428571428571428,51,19,32,227.31537998538548,0.41250642343268246,0.7132386629763678,0.15125805233061657,1088310.8748855232,17977.960013366057,1106288.8348988893,875,3,470.9,66,74,38,33.26614505712867,0.6475694444444444,39.194651741293534,8345.771144278611,126.45107794361532,8
877,32,0,0,140,0.0,0.0,1.0,140,3550,2700,850,0.7605633802816901,44,27,17,223.63013707226997,0.41215206406303534,0.7084916732096371,0.14941812598740573,1089477.0917932738,17177.982274965554,1106655.0740682394,876,4,471.9,68,72,41,33.21943399865007,0.6478247549019608,39.054951690821255,8350.241545893718,122.79766979255467,0
878,32,0,0,140,0.0,0.0,1.0,140,3350,2400,950,0.7164179104477612,43,24,19,229.4415550115021,0.41236296676944156,0.7153740604718204,0.15380562474462267,1090408.3368764154,18686.996882086052,1109095.3337585016,877,5,472.9,69,71,38,32.95373035778755,0.6483997584541064,38.94345238095237,8353.809523809508,121.06970324361606,0
879,32,0,0,140,0.0,0.0,1.0,140,4050,3400,650,0.8395061728395061,47,34,13,215.46390297144922,0.41252355258650225,0.6998462520049262,0.13364730972692368,1067910.2605193998,13969.222550953578,1081879.4830703533,878,6,473.9,64,76,41,36.08414490416227,0.6238606770833333,41.65064102564104,8267.179487179525,129.17467948718007,8
880,32,0,0,140,0.0,0.0,1.0,140,2950,1600,1350,0.5423728813559322,43,16,27,214.14046220391748,0.4123351318944844,0.6980594045583062,0.13300104883165964,1068299.72706867,14803.239465360968,1083102.966534031,879,7,474.9,65,75,42,36.070221516410164,0.6237179487179487,41.60353535353537,8268.686868686898,127.21056721056766,0
881,32,0,0,140,0.0,0.0,1.0,140,4050,3100,950,0.7654320987654321,50,31,19,214.41972876004738,0.41203751284686535,0.6965136356711177,0.1337389572066551,1069551.389489622,13816.583765859417,1083367.9732554816,880,8,475.9,67,73,43,35.90843109373147,0.6240671641791045,41.45220588235295,8273.529411764726,123.48551360842875,0
882,32,2,0,142,0.014084507042253521,0.0,1.0,142,5350,4100,1250,0.7663551401869159,66,41,25,205.62732604142394,0.4134816285419372,0.686940667994733,0.1290775893998352,1071437.6817883335,10313.373105231649,1081751.0548935651,881,0,470.1830985915493,72,70,41,35.90317985479276,0.6236979166666667,41.22431506849317,8280.821917808262,115.01141552511474,0
883,32,0,0,142,0.0,0.0,1.0,142,4750,3700,1050,0.7789473684210526,58,37,21,204.76248365464164,0.41349515532913794,0.6863237845369268,0.1290522843318332,1072619.631705971,10776.451960968396,1083396.0836669393,882,1,471.1830985915493,72,70,46,35.779943969872356,0.6251446759259259,41.081621004566216,8285.388127853894,115.07483510908186,0
884,32,1,1,142,0.006993006993006993,0.006993006993006993,0.993006993006993,143,4050,3100,950,0.7654320987654321,50,31,19,205.7499075725417,0.4141427821005286,0.6884267991029156,0.13024396359464824,1073904.9635464798,11541.169398276526,1085446.1329447564,883,0,468.8811188811189,75,68,38,35.596100941699255,0.6252777777777778,40.92653508771931,8290.350877193014,110.53801169590685,0
885,32,2,1,143,0.013888888888888888,0.006944444444444444,0.9930555555555556,144,3350,2000,1350,0.5970149253731343,47,20,27,203.12289988730345,0.4149629305879306,0.6866849767774186,0.12892086094888128,1074677.7777777857,11508.33333333373,1086186.1111111194,884,0,466.6111111111111,79,65,41,35.56906484458735,0.6244725738396624,40.83333333333336,8293.333333333396,104.9789029535873,0
886,32,1,1,143,0.006944444444444444,0.006944444444444444,0.9930555555555556,144,4200,3200,1000,0.7619047619047619,52,32,20,206.49902232803066,0.41466447325822325,0.6938387969326396,0.13160650213885838,1075885.4796696878,11433.859937743204,1087319.339607431,885,0,467.5833333333333,82,62,44,35.3329784144807,0.6247459349593496,40.68775100401608,8297.991967871525,101.19502399843323,0
887,32,0,0,143,0.0,0.0,1.0,143,3950,2900,1050,0.7341772151898734,50,29,21,207.30258655433502,0.4141037952657671,0.6935540520516124,0.13247560081148863,1076672.292077576,12089.390203812993,1088761.6822813891,886,1,471.1748251748252,64,79,45,35.21537344782851,0.6346028645833333,40.5929487179487,8301.025641025606,129.7035256410251,0
888,32,0,0,143,0.0,0.0,1.0,143,4100,2800,1300,0.6829268292682927,54,28,26,206.89293034889394,0.41390270527594475,0.6921285537741673,0.13267146199738664,1077678.0715349847,11892.794838523454,1089570.8663735082,887,2,472.1748251748252,67,76,44,35.102359028843466,0.6340174129353233,40.471813725490186,8304.901960784298,123.95376060872087,0
889,32,0,0,143,0.0,0.0,1.0,143,4050,3000,1050,0.7407407407407407,51,30,21,204.96857397973216,0.4137652253849437,0.6892277875142221,0.13192536508197478,1078754.255243761,11572.144274376209,1090326.399518137,888,3,473.1748251748252,69,74,42,35.020094274743506,0.6342089371980677,40.34226190476189,8309.047619047593,120.420979986197,0
890,32,0,0,143,0.0,0.0,1.0,143,4100,2900,1200,0.7073170731707317,53,29,24,206.8172765330608,0.4139540037427361,0.6909648580268721,0.1335487490260525,1079696.612775238,11959.982587228915,1091656.595362467,889,4,474.1748251748252,70,73,41,34.856357543582206,0.6348214285714286,40.2288732394366,8312.676056337988,118.75251509054269,0
891,32,0,0,143,0.0,0.0,1.0,143,3500,2300,1200,0.6571428571428571,47,23,24,205.53886690047838,0.4133917725467022,0.688529172469216,0.1331725145093701,1080674.1708106524,12324.108911406876,1092998.2797220594,890,5,475.1748251748252,72,71,43,34.76957850619521,0.6349826388888888,40.11130136986299,8316.438356164335,115.50608828006021,0
892,32,0,1,142,0.0,0.006993006993006993,0.993006993006993,143,4250,3200,1050,0.7529411764705882,53,32,21,205.03069541377474,0.4131865786795364,0.6883676661165705,0.13330242784188004,1081670.2714116087,11505.121591185492,1093175.3930027941,891,6,476.1748251748252,73,70,38,34.66058280547883,0.6357020547945205,39.991554054054035,8320.270270270226,113.97630507219488,0
893,32,0,0,142,0.0,0.0,1.0,142,4600,3000,1600,0.6521739130434783,62,30,32,204.25501441056812,0.4131403372956415,0.6859124564129315,0.13339228748683354,1082955.9802806904,11239.837871648258,1094195.8181523387,892,7,478.63380281690144,77,65,41,34.52311440206694,0.6354166666666667,39.83707264957262,8325.213675213601,108.11965811965716,0
894,32,0,0,142,0.0,0.0,1.0,142,4550,3200,1350,0.7032967032967034,59,32,27,205.02045189006037,0.4130695817933607,0.6882227283967945,0.134423215930934,1084093.101671001,11502.251519096953,1095595.353190098,893,8,479.63380281690144,79,63,43,34.363849148783615,0.6359440928270041,39.700520833333314,8329.583333333287,105.43776371307958,0
895,32,0,1,141,0.0,0.007042253521126761,0.9929577464788732,142,3150,2000,1150,0.6349206349206349,43,20,23,207.89411745467075,0.4131632287816735,0.6933067533266333,0.13662271950687435,1084755.7121054416,13552.866284414395,1098308.578389856,894,9,480.63380281690144,82,60,43,34.20785736090358,0.6355436991869918,39.62098393574295,8332.128514056161,101.61132334214831,0
896,32,0,0,141,0.0,0.0,1.0,141,3850,2500,1350,0.6493506493506493,52,25,27,208.01802623711953,0.41298336710570754,0.690545639997129,0.13729522427413615,1085990.304720186,13131.111940108403,1099121.4166602944,895,10,484.4822695035461,65,76,42,34.05341925647705,0.6453525641025641,39.47285353535355,8336.868686868722,128.25951825951879,0
897,32,1,0,142,0.007042253521126761,0.0,1.0,142,5250,3700,1550,0.7047619047619048,68,37,31,207.30686343739612,0.41412675223920353,0.6901709831026106,0.13787676591045064,1088171.8572845827,11467.098922902633,1099638.9562074854,896,0,482.0633802816901,69,73,41,33.804980979553044,0.6456823671497585,39.21130952380953,8345.238095238112,120.94547964113205,0
898,32,0,0,142,0.0,0.0,1.0,142,4050,2700,1350,0.6666666666666666,54,27,27,204.16568796173317,0.41378129890453835,0.6844024874321448,0.13632619567934795,1089296.5262559906,12029.394935476286,1101325.921191467,897,1,483.0633802816901,73,69,43,33.74941555171919,0.6449771689497716,39.07657657657659,8349.549549549587,114.37739108972038,0
899,32,0,0,142,0.0,0.0,1.0,142,4150,2900,1250,0.6987951807228916,54,29,25,201.98573573352445,0.41381459561149403,0.679207246549133,0.13524533076093678,1090083.235741291,11486.252876397242,1101569.4886176882,898,2,484.0633802816901,77,65,46,33.710188027628575,0.6440746753246753,38.9823717948718,8352.564102564122,108.47485847485872,0
900,32,0,0,142,0.0,0.0,1.0,142,4450,3100,1350,0.6966292134831461,58,31,27,205.41024586769876,0.4135763160523424,0.6832613349713288,0.1383001376566722,1091645.4389701607,11997.031603842635,1103642.4705740034,899,3,485.0633802816901,77,65,37,33.42999599502363,0.6459686147186148,38.79540598290599,8358.547008547026,108.55255855255878,0
901,32,1,0,143,0.006993006993006993,0.0,1.0,143,3350,2200,1150,0.6567164179104478,45,22,23,206.6285688183038,0.41454496208017333,0.6861021390169371,0.13963082074691444,1092678.22265625,13205.707465277806,1105883.9301215278,900,0,482.6643356643357,79,64,38,33.27208935392793,0.6463607594936709,38.671875,8362.5,105.85443037974683,0
902,32,0,0,143,0.0,0.0,1.0,143,3050,2300,750,0.7540983606557377,38,23,15,208.68053187803764,0.41412636659115537,0.689640336425773,0.14168639869134725,1094009.465556417,14009.695430384289,1108019.1609868011,901,1,483.6643356643357,71,72,42,33.05600125410352,0.6517018779342723,38.512731481481495,8367.592592592624,117.8534167970792,0
903,32,1,0,144,0.006944444444444444,0.0,1.0,144,3400,2400,1000,0.7058823529411765,44,24,20,205.33103139397355,0.4145703833203833,0.6875401412973663,0.14018467809764332,1095558.9046308498,12790.447968141021,1108349.3525989908,902,0,481.2986111111111,72,72,42,32.95467971789,0.6530671296296297,38.32762557077627,8373.51598173519,116.29883307965542,0
904,32,0,0,144,0.0,0.0,1.0,144,4100,2800,1300,0.6829268292682927,54,28,26,203.73695896494,0.4142000938875939,0.6838670738801615,0.13957589369549386,1096521.2853955114,11780.382425361911,1108301.6678208734,903,1,482.2986111111111,75,69,42,32.87914485165794,0.6527777777777778,38.21271929824563,8377.192982456181,111.69590643274908,0
905,32,1,0,145,0.006896551724137931,0.0,1.0,145,3700,2700,1000,0.7297297297297297,47,27,20,200.0966122674586,0.4146791187739463,0.6793856771402873,0.13773802145895184,1097853.0083320031,11235.333546974567,1109088.3418789776,904,0,479.9655172413793,78,67,45,32.81234269606365,0.6530448717948718,38.053797468354446,8382.278481012698,107.46510873093202,0
906,32,1,1,145,0.00684931506849315,0.00684931506849315,0.9931506849315068,146,3650,2400,1250,0.6575342465753424,49,24,25,197.48357466377638,0.41501239962210673,0.6778799597091483,0.13648194463519497,1098961.1776423568,10555.356355505312,1109516.5339978621,905,0,477.67123287671234,83,63,44,32.746009589602856,0.652359437751004,37.921626984126995,8386.507936507964,101.04226429527667,0
907,32,0,0,145,0.0,0.0,1.0,145,3500,2200,1300,0.6285714285714286,48,22,26,194.91878685457834,0.41466914112388253,0.6729082781736224,0.13176414501455533,1092777.2128242645,10100.561725206553,1102877.774549471,906,1,480.8344827586207,87,58,41,33.56603104145908,0.6434386973180077,38.660037878787875,8362.87878787878,96.12504353883656,8
908,32,0,1,144,0.0,0.006896551724137931,0.993103448275862,145,4000,3000,1000,0.75,50,30,20,196.94534609726708,0.4143658205619412,0.6778520976835363,0.13346699745309698,1093480.0631297836,10071.16189671117,1103551.2250264948,907,2,481.8344827586207,90,55,42,33.42738345447647,0.643287037037037,38.576007326007314,8365.567765567728,92.95075295075253,0
909,32,1,0,145,0.006896551724137931,0.0,1.0,145,3250,2100,1150,0.6461538461538462,44,21,23,197.52459397941578,0.41432391443167305,0.6781678177224324,0.13433871180143692,1094483.8025948207,10987.493744917985,1105471.2963397386,908,0,482.80689655172415,72,73,40,33.289913979667936,0.6517650462962963,38.45605022831052,8369.406392694096,116.24175545408467,0
910,32,1,0,146,0.00684931506849315,0.0,1.0,146,3350,2000,1350,0.5970149253731343,47,20,27,196.7386860303878,0.4142241379310345,0.6785479511011658,0.13425031923395245,1095416.818845878,10552.173119065275,1105968.9919649432,909,0,480.4931506849315,73,73,43,33.196820529373795,0.6523972602739726,38.34459459459461,8372.972972973012,114.69825990373988,0
911,32,0,0,146,0.0,0.0,1.0,146,3900,2600,1300,0.6666666666666666,52,26,26,193.66088553539223,0.41357857030388917,0.6732723580880298,0.13261847446541652,1096406.4694184777,9366.209554863171,1105772.678973341,910,1,481.4931506849315,75,71,45,33.15689521266387,0.6526388888888889,38.2264254385965,8376.754385964934,111.69005847953245,0
912,32,0,0,146,0.0,0.0,1.0,146,3650,2400,1250,0.6575342465753424,49,24,25,192.24427774354075,0.41352444496929613,0.6692226590993744,0.1321014403230564,1097365.3672960154,9342.442491319913,1106707.8097873353,911,2,482.4931506849315,79,67,47,33.07733182518769,0.6520305907172996,38.11197916666669,8380.416666666732,106.08122362869281,0
913,32,0,0,146,0.0,0.0,1.0,146,4400,3000,1400,0.6818181818181818,58,30,28,188.88656134761902,0.4132518501023461,0.6626678286445684,0.1301506032299356,1098129.3402777861,7884.375000000416,1106013.7152777866,912,3,483.4931506849315,83,63,44,33.072398939695155,0.651355421686747,38.02083333333336,8383.333333333398,101.0040160642578,0
914,32,1,0,147,0.006802721088435374,0.0,1.0,147,3650,2600,1050,0.7123287671232876,47,26,21,187.1965039834291,0.41335849408256453,0.6632113951870418,0.12956980909608679,1099384.3881659142,8110.182799724258,1107494.5709656384,913,0,481.19727891156464,86,61,39,32.96420849891136,0.6517684108527132,37.87116858237549,8388.122605364013,97.53630936469783,0
915,32,0,1,146,0.0,0.006802721088435374,0.9931972789115646,147,3950,3000,950,0.759493670886076,49,30,19,188.2446848132837,0.41322065355822696,0.6641169366077233,0.13074427798904067,1100338.139474538,8076.561250684061,1108414.700725222,914,1,482.19727891156464,88,59,40,32.82091478473033,0.6522253787878788,37.757490636704134,8391.760299625505,95.36091249574437,0
916,32,0,2,144,0.0,0.0136986301369863,0.9863013698630136,146,4200,3100,1100,0.7380952380952381,53,31,22,185.71523160968127,0.4139210360573138,0.6643629415282266,0.11901300855244118,1077487.250434019,6621.158854166178,1084108.4092881852,915,2,480.67808219178085,71,75,46,35.6753846797123,0.6316021126760563,40.494791666666636,8304.166666666597,116.96009389671264,8
917,32,0,1,143,0.0,0.006944444444444444,0.9930555555555556,144,3900,2700,1200,0.6923076923076923,51,27,24,188.02016039085893,0.4139593045843046,0.6649789198420326,0.12095211844554768,1078599.267258476,7859.681445480112,1086458.948703956,916,3,484.7638888888889,70,74,47,35.47917726168274,0.6334821428571429,40.36091549295773,8308.450704225317,118.69215291750453,0
918,32,0,0,143,0.0,0.0,1.0,143,3950,3000,950,0.759493670886076,49,30,19,187.13884550108955,0.41335483765061226,0.6601485848450337,0.12077249576299562,1079530.6203917959,7854.422796638834,1087385.0431884348,917,4,488.9300699300699,71,72,46,35.38788942111324,0.6340962441314554,40.24884259259257,8312.037037036975,117.07094418361936,0
919,32,0,0,143,0.0,0.0,1.0,143,3600,2700,900,0.75,45,27,18,190.11639533889345,0.4130429429725204,0.6626865694564601,0.12318000385297913,1080674.1708106506,8890.775578073393,1089564.946388724,918,5,489.9300699300699,72,71,47,35.17039111257525,0.6349826388888888,40.111301369862986,8316.43835616432,115.50608828006001,0
920,32,1,0,144,0.006944444444444444,0.0,1.0,144,4900,3400,1500,0.6938775510204082,64,34,30,187.7071671318389,0.41382575757575757,0.6593805619120283,0.12242989856210917,1082590.7029478387,6942.006802720731,1089532.7097505594,919,0,487.5208333333333,76,68,45,34.998331426392035,0.6354166666666667,39.88095238095236,8323.809523809468,109.5238095238088,0
921,32,0,0,144,0.0,0.0,1.0,144,3750,2500,1250,0.6666666666666666,50,25,25,189.76323125276997,0.4133107922170422,0.6638796248788568,0.12436063810075536,1083956.8380634014,8589.030425889043,1092545.8684892904,920,1,488.5208333333333,77,67,46,34.777663759192755,0.636634199134199,39.71688034188032,8329.059829059774,108.16960816960744,0
922,32,0,2,142,0.0,0.013888888888888888,0.9861111111111112,144,4300,3200,1100,0.7441860465116279,54,32,22,191.64935927346556,0.4127887448199948,0.6675746749791864,0.12613896093671872,1085191.7092342847,8495.259152725786,1093686.9683870105,921,2,489.5208333333333,70,74,50,34.57751206504799,0.6415178571428571,39.568661971831006,8333.802816901454,119.05432595573507,0
923,32,0,0,142,0.0,0.0,1.0,142,4050,2900,1150,0.7160493827160493,52,29,23,193.87795372538986,0.4112445060433523,0.6690382155870691,0.12810577244270158,1086309.8781179194,9672.307256236165,1095982.1853741556,922,3,495.88732394366195,69,73,49,34.3827336759947,0.6434178743961353,39.43452380952383,8338.095238095282,120.8419599723954,0
924,32,0,0,142,0.0,0.0,1.0,142,4500,3400,1100,0.7555555555555555,56,34,22,216.55081393795192,0.41124346552125995,0.6889364355144931,0.1362351323128646,1072087.6736111213,13532.291666667192,1085619.9652777885,923,4,496.88732394366195,77,65,43,35.5403252850436,0.6221590909090908,41.145833333333364,8283.333333333412,107.5757575757586,8
925,32,0,0,142,0.0,0.0,1.0,142,3800,2600,1200,0.6842105263157895,50,26,24,218.4595080326423,0.4112590733526454,0.6925923773689042,0.137798629172185,1072862.1635072045,14675.388085324419,1087537.5515925288,924,5,497.88732394366195,77,65,48,35.39539281416538,0.6231060606060606,41.052350427350454,8286.324786324856,107.61460761460852,0
926,32,1,0,143,0.006993006993006993,0.0,1.0,143,4600,3200,1400,0.6956521739130435,60,32,28,222.50271683741437,0.4126017761581142,0.7029370067344731,0.1414298878288403,1075109.765625009,14642.96875000047,1089752.7343750095,925,0,495.3986013986014,79,64,37,35.01356238698014,0.625,40.78125000000003,8295.000000000071,105.0000000000009,0
927,32,0,0,143,0.0,0.0,1.0,143,4050,2800,1250,0.691358024691358,53,28,25,225.45056453940748,0.412638711054204,0.7071323737990396,0.14362974167847706,1075773.7209994101,15856.758543195454,1091630.4795426056,926,1,496.3986013986014,81,62,38,34.85531386765957,0.625,40.70121951219514,8297.560975609797,102.4390243902444,0
928,32,0,0,143,0.0,0.0,1.0,143,4050,2700,1350,0.6666666666666666,54,27,27,227.87394066856092,0.4124560885124265,0.7103041365130165,0.14587603359484458,1077180.642960566,16442.279584663476,1093622.9225452296,927,2,497.3986013986014,66,77,40,34.619110392074596,0.6339962121212122,40.53171641791043,8302.985074626833,125.80280416101262,0
929,32,0,0,143,0.0,0.0,1.0,143,3850,2900,950,0.7532467532467533,48,29,19,230.89376989934777,0.41260382809678586,0.7141152348699527,0.1482034405409304,1077955.314379591,17328.63326402788,1095283.9476436188,928,3,498.3986013986014,66,77,39,34.4453179594689,0.6349431818181819,40.43843283582088,8305.970149253704,125.84803256445007,0
930,32,0,0,143,0.0,0.0,1.0,143,4750,3600,1150,0.7578947368421053,59,36,23,230.05165123213692,0.41285006073738467,0.7045749345187249,0.14292415284485555,1068384.280152755,15806.713559920256,1084190.9937126753,929,4,499.3986013986014,70,73,32,35.648621283521656,0.6209821428571429,41.59330985915496,8269.014084507102,118.12877263581574,8
931,32,0,0,143,0.0,0.0,1.0,143,4500,3300,1200,0.7333333333333333,57,33,24,237.2268046910939,0.4125155947339046,0.7128054623158959,0.14809481942870925,1069811.924645283,17657.612900806325,1087469.5375460894,930,5,500.3986013986014,71,72,35,35.28652390011005,0.622212441314554,41.42071759259262,8274.537037037091,116.5427751695365,0
932,32,0,0,143,0.0,0.0,1.0,143,3800,2700,1100,0.7105263157894737,49,27,22,236.62764054608965,0.41232476443744054,0.7118340577706299,0.14808069952130093,1070530.3209930211,18263.412797925743,1088793.733790947,931,6,501.3986013986014,71,72,37,35.21315742864069,0.6230927230046948,41.33391203703707,8277.314814814881,116.5818988002096,0
933,32,1,0,144,0.006944444444444444,0.0,1.0,144,4800,3600,1200,0.75,60,36,24,232.14042368706228,0.4132227725977726,0.7096294356863748,0.14613086629183575,1072264.978315721,16183.209274202301,1088448.1875899234,932,0,498.90972222222223,72,72,38,35.11488075552129,0.6247106481481481,41.124429223744315,8284.018264840231,115.0558092338921,0
934,32,2,1,145,0.0136986301369863,0.00684931506849315,0.9931506849315068,146,4450,3400,1050,0.7640449438202247,55,34,21,230.01292603548936,0.4146974885844749,0.711733568273256,0.14588575620775002,1074473.1822532013,15778.544119344831,1090251.726372546,933,0,493.06164383561645,75,71,32,34.89740351897889,0.6259722222222222,40.85800438596494,8292.543859649186,110.56725146198914,0
935,32,0,0,145,0.0,0.0,1.0,145,3750,2200,1550,0.5866666666666667,53,22,31,232.6183673338111,0.4136853448275862,0.7144214883568241,0.14771031988859598,1074814.1856148099,17254.30420898762,1092068.4898237975,934,1,497.46206896551723,75,70,33,34.78781068217874,0.6263888888888889,40.816885964912295,8293.859649122847,110.58479532163797,0
936,32,0,0,145,0.0,0.0,1.0,145,4150,3100,1050,0.7469879518072289,52,31,21,237.54081736812236,0.4134758141762452,0.7193821599217074,0.1513690953228786,1075844.9054553001,17961.41564063667,1093806.3210959367,935,2,498.46206896551723,76,69,33,34.53303248469672,0.6271929824561404,40.69264069264071,8297.835497835536,109.1820460241518,0
937,32,1,0,146,0.00684931506849315,0.0,1.0,146,3650,2300,1350,0.6301369863013698,50,23,27,234.9902036886873,0.4140863643520705,0.719971836081853,0.150549631427687,1077408.8988366108,17786.107318723818,1095195.0061553346,936,0,496.041095890411,68,78,34,34.406330599026504,0.6331188725490196,40.50422705314009,8303.864734299505,122.11565785734565,0
938,32,0,1,145,0.0,0.00684931506849315,0.9931506849315068,146,3650,1900,1750,0.5205479452054794,54,19,35,236.4520678696108,0.414397339001732,0.7306093405741994,0.14701316523728206,1068611.2737021628,17685.069083131068,1086296.342785294,937,1,497.041095890411,61,85,38,35.455131539028315,0.6267076502732241,41.56586021505377,8269.892473118285,135.57200775603746,8
939,32,2,0,147,0.013605442176870748,0.0,1.0,147,4050,2600,1450,0.6419753086419753,55,26,29,238.46139953570437,0.4147621377318051,0.7303579678256071,0.1492227520805905,1070519.4344008286,17605.512511478588,1088124.946912307,938,0,494.63945578231295,65,82,38,35.16707090121423,0.6264423076923077,41.33522727272728,8277.272727272742,127.34265734265757,0
940,32,1,2,146,0.006756756756756757,0.013513513513513514,0.9864864864864865,148,4000,2900,1100,0.725,51,29,22,237.08081984065205,0.41511824324324326,0.7295015487928875,0.14905576296912287,1071900.1063327042,17225.391199327907,1089125.4975320322,939,0,492.2905405405405,68,80,37,35.03207932341792,0.6263786764705883,41.16847826086957,8282.608695652181,121.80306905370855,0
941,32,0,0,146,0.0,0.0,1.0,146,3850,2800,1050,0.7272727272727273,49,28,21,226.9970577902183,0.4142477562588569,0.7149301629000175,0.13290602091944695,1050511.1141975406,14642.58641975362,1065153.7006172943,940,1,493.7191780821918,74,72,42,37.94740455670589,0.5969876126126126,43.76388888888892,8199.555555555633,110.80480480480585,8
942,32,1,0,147,0.006802721088435374,0.0,1.0,147,4500,2900,1600,0.6444444444444445,61,29,32,222.92578125000006,0.41522031186903985,0.711318027210885,0.13113281250000003,1051939.513477975,13000.887573964515,1064940.4010519395,941,0,491.3537414965986,64,83,40,37.87369791666667,0.6041666666666667,43.58974358974359,8205.128205128205,128.2051282051282,0
943,32,1,0,148,0.006756756756756757,0.0,1.0,148,3850,2800,1050,0.7272727272727273,49,28,21,207.90046451538643,0.415645875467304,0.7011539937503433,0.12348786627239165,1054900.1736111064,10412.847222221983,1065313.0208333284,942,0,489.02702702702703,77,71,43,37.890889114266365,0.6010551948051948,43.22916666666665,8216.666666666628,106.7099567099562,8
944,32,2,1,149,0.013333333333333334,0.006666666666666667,0.9933333333333333,150,4800,3600,1200,0.75,60,36,24,210.2869027360667,0.41684656972408646,0.7096362098138742,0.12612289412343503,1057841.1638521978,9690.028386639016,1067531.1922388368,943,0,483.49333333333334,82,68,39,37.46441006117401,0.6026422764227642,42.871485943775106,8228.112449799211,100.34283475364892,0
945,32,1,0,150,0.006666666666666667,0.0,1.0,150,4700,3400,1300,0.723404255319149,60,34,26,210.64196575836775,0.4173228933631618,0.7110372863716918,0.12681203101558833,1058977.3778850343,9913.015314269123,1068890.3931993034,944,0,484.48,82,68,41,37.31432021074197,0.6040396341463414,42.73343373493976,8232.53012048193,100.396708786365,0
946,32,1,3,148,0.006622516556291391,0.019867549668874173,0.9801324503311258,151,5050,3800,1250,0.7524752475247525,63,38,25,206.07911542282287,0.41820272259013985,0.7052029273793323,0.12469152869599277,1060494.7146401368,8459.162540723886,1068953.8771808606,945,0,482.26490066225165,71,80,40,37.2436662920296,0.610768779342723,42.54918981481483,8238.425925925963,116.03416797078822,0
947,32,1,0,149,0.006711409395973154,0.0,1.0,149,4350,2900,1450,0.6666666666666666,58,29,29,201.8657231493522,0.4174470191668178,0.6954720599142539,0.1227740709646062,1062044.753086422,8728.086419753192,1070772.8395061754,946,0,489.5838926174497,74,75,39,37.160265049416026,0.611204954954955,42.36111111111112,8244.444444444463,111.41141141141166,0
948,32,1,1,149,0.006666666666666667,0.006666666666666667,0.9933333333333333,150,3750,2700,1050,0.72,48,27,21,199.5310664147558,0.4179828486204325,0.6942141882909478,0.12202554004655361,1063696.9264783785,8698.116416465855,1072395.0428948444,947,0,487.31333333333333,77,73,42,37.016097356744545,0.6118777056277056,42.1607905982906,8250.854700854714,107.15395715395732,0
949,32,1,1,149,0.006666666666666667,0.006666666666666667,0.9933333333333333,150,3900,2700,1200,0.6923076923076923,51,27,24,198.46374596331745,0.41706748695003726,0.6931376507739284,0.12182155007224071,1064799.0887984908,8364.803172255255,1073163.891970746,948,0,488.24666666666667,77,73,40,36.90741963037738,0.6132305194805194,42.0272435897436,8255.128205128229,107.20945720945751,0
950,32,1,0,150,0.006666666666666667,0.0,1.0,150,3100,1800,1300,0.5806451612903226,44,18,26,198.93006541332232,0.41734712900820287,0.6953984926096473,0.12256045184071687,1065901.8218323125,9307.983828256332,1075209.8056605689,949,0,489.24,77,73,42,36.75918619892724,0.6145833333333333,41.893696581196586,8259.401709401724,107.26495726495745,0
951,32,1,1,150,0.006622516556291391,0.006622516556291391,0.9933774834437086,151,4400,3200,1200,0.7272727272727273,56,32,24,197.62607844158586,0.4182229580573951,0.696018009077995,0.12226187273270206,1067132.0421006985,7578.624131944642,1074710.6662326432,950,0,486.9933774834437,79,72,43,36.64099526066353,0.6152426160337553,41.74479166666668,8264.166666666699,104.60970464135062,0
952,32,0,0,150,0.0,0.0,1.0,150,3600,2700,900,0.75,45,27,18,194.87462251141557,0.4181208053691275,0.6898144305448515,0.12097719020611106,1068157.7135296492,8031.366241349302,1076189.0797709986,951,1,485.3333333333333,67,83,47,36.585554139246256,0.6223569651741294,41.620710784313715,8268.137254901938,123.40503365525281,0
953,32,2,0,152,0.013157894736842105,0.0,1.0,152,4150,2900,1250,0.6987951807228916,54,29,25,190.57050924520496,0.41973194057162777,0.6859234297220211,0.119258317633707,1070530.3209930088,6252.301686813931,1076782.6226798226,952,0,479.9342105263158,71,81,43,36.40449922628038,0.6230927230046948,41.333912037037024,8277.314814814783,116.58189880020821,0
954,32,2,0,154,0.012987012987012988,0.0,1.0,154,4100,2800,1300,0.6829268292682927,54,28,26,187.7050787793497,0.4209364301276066,0.6855634975604945,0.11811098103610804,1072145.1975308647,5349.4197530864585,1077494.6172839513,953,0,474.68831168831167,74,80,47,36.2799343634868,0.6235923423423424,41.13888888888889,8283.55555555556,111.93993993994,0
955,32,1,0,155,0.0064516129032258064,0.0,1.0,155,4100,2800,1300,0.6829268292682927,54,28,26,184.3972140962705,0.4216834241027789,0.6822969817521412,0.11657654382696418,1073526.2345679007,4491.049382716032,1078017.2839506166,954,0,472.6193548387097,77,78,42,36.19582216264521,0.623917748917749,40.97222222222222,8288.888888888885,107.6479076479076,0
956,32,1,0,156,0.00641025641025641,0.0,1.0,156,4700,3300,1400,0.7021276595744681,61,33,28,185.98762235181343,0.42231182795698924,0.6872818709835273,0.11830714252474785,1075325.7921006961,4099.457465277827,1079425.2495659739,955,0,470.5833333333333,79,77,44,35.933576092415855,0.6252637130801688,40.755208333333336,8295.833333333345,105.0105485232069,0
957,32,1,0,157,0.006369426751592357,0.0,1.0,157,4450,3400,1050,0.7640449438202247,55,34,21,185.9647425041526,0.42239813000163323,0.6896375310157823,0.11873133559880558,1076406.2500000047,4184.722222222457,1080590.9722222271,956,0,468.5796178343949,82,75,46,35.80153949129853,0.6253810975609756,40.625000000000014,8300.000000000036,101.21951219512239,0
958,32,0,0,157,0.0,0.0,1.0,157,4400,3200,1200,0.7272727272727273,56,32,24,233.15590779961525,0.42224672001742064,0.7477534594269581,0.13901236300575662,1056045.7064570547,13444.65907337624,1069490.365530431,957,1,469.5796178343949,70,87,32,37.099775379285425,0.6058035714285714,43.089788732394375,8221.1267605634,117.44466800804858,8
959,32,1,1,157,0.006329113924050633,0.006329113924050633,0.9936708860759493,158,4250,2800,1450,0.6588235294117647,57,28,29,230.6811268761473,0.4231855868203929,0.7465197324326625,0.1381741364427379,1057446.2839105998,12936.58007669832,1070382.863987298,958,0,467.6012658227848,73,85,33,36.98911962255198,0.6060216894977168,42.91948198198198,8226.576576576575,112.69282981611747,0
960,32,1,1,157,0.006329113924050633,0.006329113924050633,0.9936708860759493,158,4550,3100,1450,0.6813186813186813,60,31,29,233.49357961739983,0.42346441721088984,0.7486598738688739,0.1402931248330631,1058383.7160493813,13275.16049382709,1071658.8765432085,959,0,468.5759493670886,74,84,35,36.800230406451384,0.6067004504504505,42.80555555555555,8230.22222222221,111.21921921921906,0
961,32,1,1,157,0.006329113924050633,0.006329113924050633,0.9936708860759493,158,4950,4000,950,0.8080808080808081,59,40,19,235.06655210192406,0.42379111908409256,0.7508738788320521,0.14187350059484916,1059737.415452653,13271.764076771851,1073009.179529425,960,0,469.53164556962025,61,97,37,36.59148278713498,0.6157786885245902,42.641129032258064,8235.483870967739,135.00793231094653,0
962,32,1,1,157,0.006329113924050633,0.006329113924050633,0.9936708860759493,158,4650,3400,1250,0.7311827956989247,59,34,25,234.03146250662843,0.42411026230213117,0.7504577384200988,0.13906497648121108,1055022.4489795899,13131.689342403526,1068154.1383219934,961,0,470.4240506329114,69,89,41,37.204692087776216,0.605072463768116,43.21428571428571,8217.142857142842,119.08902691511366,8
963,32,4,3,158,0.024844720496894408,0.018633540372670808,0.9813664596273292,161,4900,3500,1400,0.7142857142857143,63,35,28,225.59405242316927,0.4263117883022774,0.7468484270098794,0.13543798040482632,1058141.2102558597,10642.072731515033,1068783.2829873746,962,0,462.6024844720497,73,88,39,37.03353358147678,0.6068778538812785,42.83502252252251,8229.279279279246,112.72985314081158,0
964,32,1,0,159,0.006289308176100629,0.0,1.0,159,5000,3600,1400,0.72,64,36,28,226.78706805085164,0.42494957938593,0.744703163933899,0.1368805727911248,1059746.4885858046,11267.359804711989,1071013.8483905166,963,0,469.29559748427675,60,99,41,36.80343595868443,0.6164930555555556,42.64002732240437,8235.519125683062,137.2586520947177,0
965,32,1,1,159,0.00625,0.00625,0.99375,160,3950,2600,1350,0.6582278481012658,53,26,27,221.60204628908497,0.4257386661425577,0.7409088081612349,0.13473806717637346,1061956.673241284,11116.354372123315,1073073.0276134072,964,0,467.35625,64,96,42,36.66270112797543,0.6165364583333333,42.371794871794854,8244.102564102528,128.814102564102,0
966,32,1,0,160,0.00625,0.0,1.0,160,4150,3200,950,0.7710843373493976,51,32,19,223.4465870829507,0.42611127489517825,0.7414520202020203,0.13655069210624768,1063476.5625,11376.041666666639,1074852.6041666667,965,0,468.06875,67,93,45,36.426767676767675,0.6166044776119404,42.1875,8250.0,123.13432835820896,0
967,32,0,0,160,0.0,0.0,1.0,160,4800,3300,1500,0.6875,63,33,30,222.13445198764703,0.4263716915618449,0.740240136970264,0.1361171082409242,1064286.2727251526,10482.92958995547,1074769.202315108,966,1,469.06875,68,92,43,36.360288378990084,0.6170343137254901,42.08937198067633,8253.140096618368,121.3697073032113,0
968,32,2,0,162,0.012345679012345678,0.0,1.0,162,4200,2900,1300,0.6904761904761905,55,29,26,216.13167455365624,0.42764566239807783,0.735782543542878,0.13336474270207246,1066362.7217947962,9494.952148621001,1075857.6739434171,967,0,464.2654320987654,72,90,44,36.258198835581105,0.6174768518518519,41.83789954337901,8261.187214611908,114.73871131405427,0
969,32,1,2,161,0.006134969325153374,0.012269938650306749,0.9877300613496932,163,6200,4600,1600,0.7419354838709677,78,46,32,215.51016229669813,0.42824074074074076,0.7371369407495818,0.13379554665805424,1068175.2506574632,7240.524326101302,1075415.7749835646,968,0,462.41104294478527,64,99,45,36.050207777708835,0.6241861979166667,41.618589743589745,8268.205128205136,129.19070512820525,0
970,32,0,0,161,0.0,0.0,1.0,161,4800,3300,1500,0.6875,63,33,30,216.3675859212895,0.4275734342650104,0.7338466260242491,0.134953884522525,1069551.3894896195,9283.25043252596,1078834.6399221455,969,1,463.99378881987576,67,94,43,35.858069676501955,0.6240671641791045,41.45220588235294,8273.529411764706,123.48551360842845,0
971,32,1,2,160,0.006172839506172839,0.012345679012345678,0.9876543209876543,162,5350,3800,1550,0.7102803738317757,69,38,31,214.70292732072664,0.42839410321294374,0.7330982108848114,0.13443331017468246,1070690.5596332315,8226.07948158446,1078916.639114816,970,0,462.12345679012344,70,92,41,35.76050173926195,0.6238095238095238,41.314553990610335,8277.934272300483,118.2562038900069,0
972,32,2,2,160,0.012345679012345678,0.012345679012345678,0.9876543209876543,162,4650,3500,1150,0.7526881720430108,58,35,23,234.64810429779158,0.4298446565958643,0.7413170452005426,0.143262403953681,1063197.5629439014,12845.458527763272,1076043.0214716648,971,0,461.3641975308642,76,86,40,36.17259249540805,0.6117050438596492,42.22132034632032,8248.91774891768,108.53839143312737,7
973,32,0,0,160,0.0,0.0,1.0,160,4550,3500,1050,0.7692307692307693,56,35,21,233.21731162463985,0.4284230870020964,0.7363858223448849,0.1432244167999897,1064945.6216952335,13122.750983638265,1078068.3726788717,972,1,466.98125,78,82,34,35.99270843981054,0.6129807692307692,42.00949367088605,8255.696202531586,105.84225900681521,0
974,32,1,1,160,0.006211180124223602,0.006211180124223602,0.9937888198757764,161,4200,2800,1400,0.6666666666666666,56,28,28,229.36478381904243,0.42870891563147,0.7340601452899169,0.14141411491576866,1066118.4497024184,12506.00554829728,1078624.4552507156,973,0,465.0745341614907,82,79,39,35.94681868274342,0.6128048780487805,41.867469879518055,8260.240963855376,100.73464590067532,0
975,32,0,0,160,0.0,0.0,1.0,160,4500,3200,1300,0.7111111111111111,58,32,26,231.91976350943023,0.4279022536687631,0.7351903544157923,0.14334417440061842,1066855.3580286212,12984.96846655296,1079840.326495174,974,1,468.93125,83,77,39,35.78960164241462,0.6133283132530121,41.77827380952379,8263.095238095184,99.55536431439981,0
976,32,1,0,161,0.006211180124223602,0.0,1.0,161,4100,2900,1200,0.7073170731707317,53,29,24,232.34474278873273,0.428027950310559,0.7362071365597878,0.14417683708148554,1068031.0607698997,13330.2804209921,1081361.3411908918,975,0,467.0124223602484,67,94,41,35.63307838254474,0.6222014925373134,41.63602941176472,8267.647058823557,123.39771729587399,0
977,32,0,1,160,0.0,0.006211180124223602,0.9937888198757764,161,6050,4500,1550,0.743801652892562,76,45,31,226.9574971836524,0.4278128234989648,0.7292802197032318,0.14170002288951247,1069845.44444445,10311.888888889169,1080157.3333333393,976,1,468.0124223602484,74,87,41,35.547924051992695,0.620777027027027,41.416666666666686,8274.666666666712,111.81981981982042,0
978,32,0,2,158,0.0,0.0125,0.9875,160,4300,3400,900,0.7906976744186046,52,34,18,226.8261216613301,0.427530463836478,0.7279943708609267,0.14209568690201188,1070839.1794831133,12278.859601031289,1083118.0390841446,977,2,471.49375,75,85,40,35.42853200883003,0.6215277777777778,41.29660087719299,8278.50877192985,110.38011695906467,0
979,32,0,2,156,0.0,0.012658227848101266,0.9873417721518988,158,4300,3200,1100,0.7441860465116279,54,32,22,211.91458361752473,0.42580508076003115,0.7230370780930329,0.13324022200729432,1071915.1111111147,9530.888888889112,1081446.000000004,978,3,478.19620253164555,74,84,45,35.6816108606997,0.6233108108108107,41.16666666666668,8282.666666666695,111.92792792792831,8
980,32,0,1,155,0.0,0.00641025641025641,0.9935897435897436,156,4350,3100,1250,0.7126436781609196,56,31,25,211.30999957937988,0.4245045836779708,0.7193221318292211,0.13343975323487256,1073194.1733554373,9805.33206406639,1082999.5054195037,979,6,485.1794871794872,77,79,38,35.539616958008914,0.6235119047619048,41.012286324786345,8287.606837606885,107.63125763125825,0
981,32,1,1,155,0.00641025641025641,0.00641025641025641,0.9935897435897436,156,3850,2500,1350,0.6493506493506493,52,25,27,215.79571885632276,0.4249784601599118,0.7242409941796455,0.13286666825010546,1065712.1111111098,10945.22222222223,1076657.333333332,980,0,486.0,74,82,36,36.347338822516434,0.6157094594594594,41.916666666666664,8258.666666666657,111.60360360360347,8
982,32,3,0,158,0.0189873417721519,0.0,1.0,158,4250,2700,1550,0.6352941176470588,58,27,31,212.6498427018632,0.42621324813889117,0.7244112300055572,0.13169949827277133,1067454.8855251754,9548.822699652854,1077003.7082248281,981,0,480.7721518987342,79,79,39,36.21310556031657,0.6156381856540085,41.70572916666667,8265.41666666668,104.62552742616052,0
983,32,1,0,159,0.006289308176100629,0.0,1.0,159,4850,3500,1350,0.7216494845360825,62,35,27,210.90159557851746,0.42667615370326145,0.7223712330085461,0.13131116798165063,1069026.1295479524,8441.863287358226,1077467.9928353108,982,0,478.74213836477986,68,91,39,36.06422536308065,0.6228553921568627,41.515700483091805,8271.4975845411,121.63967036089855,0
984,32,0,1,158,0.0,0.006289308176100629,0.9937106918238994,159,3950,2700,1250,0.6835443037974683,52,27,25,210.52275353570474,0.42648375925483645,0.7234841474770799,0.1314079344956105,1069775.4906765623,9292.416392447953,1079067.9070690102,983,1,479.74213836477986,68,91,42,35.98153121594271,0.6237745098039216,41.42512077294686,8274.396135265704,121.6822961068486,0
985,32,0,0,158,0.0,0.0,1.0,158,4550,3400,1150,0.7472527472527473,57,34,23,211.61050425008634,0.4263333467709425,0.7231722771700326,0.13229462459951497,1070239.51247166,9144.784580499134,1079384.2970521592,984,2,482.25949367088606,69,89,42,35.89614499424624,0.623792270531401,41.369047619047635,8276.190476190513,119.94478951000744,0
986,32,2,0,160,0.0125,0.0,1.0,160,4550,3300,1250,0.7252747252747253,58,33,25,209.98233914376792,0.42734538784067083,0.723896565696081,0.13215666529368444,1072207.5168520685,8478.928487225723,1080686.4453392942,985,0,477.21875,71,89,41,35.69558160546953,0.6251467136150235,41.13136574074075,8283.796296296314,116.67318727177907,0
987,32,0,0,160,0.0,0.0,1.0,160,4750,3500,1250,0.7368421052631579,60,35,25,209.9207669964098,0.42742891771488467,0.7234812353932281,0.13258950195561142,1073254.0004108888,8309.66058964403,1081563.6610005328,986,1,478.21875,73,87,35,35.568226081127605,0.6254280821917808,41.005067567567586,8287.837837837877,113.53202517586132,0
988,32,1,0,161,0.006211180124223602,0.0,1.0,161,4300,2600,1700,0.6046511627906976,60,26,34,206.19217423376622,0.4282026397515528,0.72044307023471,0.13078865197424014,1074498.2758943879,7810.6271434197115,1082308.9030378077,987,0,476.2422360248447,76,85,36,35.51161080949398,0.6255482456140351,40.85497835497838,8292.640692640754,109.11369332422045,0
989,32,0,1,160,0.0,0.006211180124223602,0.9937888198757764,161,3750,2300,1450,0.6133333333333333,52,23,29,226.85514259300635,0.42778209109730847,0.7398184357671473,0.14059979170829048,1067671.4704101624,12491.352732476178,1080162.8231426384,988,1,477.2422360248447,80,81,35,35.81939396956572,0.6154947916666667,41.67952674897118,8266.255144032879,103.32818930041098,8
990,32,0,0,160,0.0,0.0,1.0,160,4050,2600,1450,0.6419753086419753,55,26,29,230.28565622170038,0.4269719601677149,0.7415437310119184,0.1430177536970475,1068277.030969219,13151.775420663336,1081428.8063898825,989,2,481.1875,68,92,35,35.65584346031004,0.6219362745098039,41.60628019323672,8268.599033816437,121.5970446149476,0
991,32,0,1,159,0.0,0.00625,0.99375,160,4000,2600,1400,0.65,54,26,28,230.16970735082595,0.42652564858490566,0.7411133496846531,0.1434288962400125,1069275.8874186096,13222.983616887232,1082498.8710354967,990,3,482.1875,68,92,34,35.53528673207196,0.6231617647058824,41.48550724637681,8272.463768115942,121.6538789428815,0
992,32,1,3,157,0.00625,0.01875,0.98125,160,5000,3700,1300,0.74,63,37,26,213.80241767435302,0.42615713443396225,0.7272491450334213,0.1303688107013378,1062815.6075361606,8446.50928665353,1071262.116822814,991,0,483.15,77,83,43,36.75724778485932,0.6107954545454546,42.267628205128204,8247.435897435898,107.10955710955712,8
993,32,1,2,156,0.006329113924050633,0.012658227848101266,0.9873417721518988,158,5100,3600,1500,0.7058823529411765,66,36,30,213.08692039289875,0.42556740304764973,0.724359261081539,0.1306889130954595,1064551.0525173654,8668.38107638908,1073219.4335937544,992,0,487.5189873417722,79,79,38,36.56086993101125,0.61207805907173,42.05729166666668,8254.1666666667,104.48312236286962,0
994,32,0,0,156,0.0,0.0,1.0,156,4100,2700,1400,0.6585365853658537,55,27,28,216.24393451888733,0.42414874551971327,0.7250926102038788,0.13296016290291052,1065303.518337678,10773.084852430842,1076076.6031901087,993,1,494.6666666666667,79,77,38,36.38632024692608,0.6130010548523206,41.96614583333335,8257.083333333369,104.52004219409328,0
995,32,2,0,158,0.012658227848101266,0.0,1.0,158,3900,2600,1300,0.6666666666666666,52,26,26,214.90264943013676,0.425707658093472,0.7280238605041698,0.1327911501609174,1066776.7205246065,10350.62871822607,1077127.3492428325,994,0,489.39240506329116,85,73,41,36.23874190824659,0.6125,41.78779069767442,8262.790697674409,97.20930232558128,0
996,32,0,0,158,0.0,0.0,1.0,158,4400,2800,1600,0.6363636363636364,60,28,32,213.77656696237304,0.4251861108871509,0.7271205831878773,0.1324972545881416,1067678.8017828593,9648.941772728005,1077327.7435555873,995,1,490.39240506329116,86,72,41,36.1563344920819,0.6132509689922481,41.6786398467433,8266.283524904233,96.11957587097945,0
997,32,2,0,160,0.0125,0.0,1.0,160,5000,3700,1300,0.74,63,37,26,212.1169299240378,0.4259401205450734,0.7289551374020506,0.13245978649494958,1069902.1209941492,8388.870644899405,1078290.9916390486,996,0,485.25,72,88,41,35.92468178641064,0.6218171296296297,41.4098173515982,8274.885844748922,114.92897006595724,0
998,32,2,1,161,0.012345679012345678,0.006172839506172839,0.9938271604938271,162,3550,2500,1050,0.704225352112676,46,25,21,214.78020637039984,0.4274363865245508,0.7373716599801683,0.13520054935960518,1072260.2500000081,10110.055555556042,1082370.3055555641,997,0,480.24691358024694,74,88,45,35.564877407586266,0.6237331081081081,41.12500000000003,8284.000000000064,111.9459459459468,0
999,32,3,1,163,0.018292682926829267,0.006097560975609756,0.9939024390243902,164,4950,3700,1250,0.7474747474747475,62,37,25,212.56404362441828,0.4288454224649609,0.737547995667839,0.13494190177952364,1074740.228484229,7940.225762488308,1082680.4542467173,998,0,474.6646341463415,82,82,40,35.3166916856327,0.6233485772357723,40.82580321285144,8293.574297188841,101.14114996571757,0
1000,32,1,3,161,0.006097560975609756,0.018292682926829267,0.9817073170731707,164,5400,3400,2000,0.6296296296296297,74,34,40,213.81276314805464,0.4284160057858248,0.7395431770497218,0.1362325098998952,1075810.068205844,7804.384661117952,1083614.452866962,999,0,475.6524390243902,86,78,43,35.152606547536585,0.6231831395348837,40.69683908045978,8297.70114942532,96.48489708634094,0
1001,32,0,0,161,0.0,0.0,1.0,161,4450,3200,1250,0.7191011235955056,57,32,25,213.34208055373244,0.42652853260869567,0.7357374685274902,0.13639454601562379,1076799.2782943025,9295.319674012666,1086094.5979683152,1000,1,481.60869565217394,65,96,45,35.04308115836225,0.6341346153846155,40.5776515151515,8301.51515151512,127.71561771561721,0
1002,32,1,1,161,0.006172839506172839,0.006172839506172839,0.9938271604938271,162,5450,3900,1550,0.7155963302752294,70,39,31,207.76346510403587,0.4270481877667868,0.7296278157301366,0.1335967397703856,1078477.374418654,6963.639269104359,1085441.0136877585,1001,0,479.6296296296296,70,92,44,34.98154008438817,0.6333333333333333,40.37558685446009,8307.981220657262,118.68544600938947,0
1003,32,1,0,162,0.006172839506172839,0.0,1.0,162,4700,3400,1300,0.723404255319149,60,34,26,208.0406075662667,0.42680216880096106,0.7293070914912683,0.13449406283189377,1080031.1999076728,7838.069403863057,1087869.2693115359,1002,0,480.38271604938274,73,89,46,34.7834945187914,0.6337043378995434,40.18862612612611,8313.963963963924,113.8899173145743,0
1004,32,0,0,162,0.0,0.0,1.0,162,4400,3400,1000,0.7727272727272727,54,34,20,205.85260514963943,0.4266911407611891,0.726363926995049,0.1333505721299037,1080619.520549582,7689.66869613674,1088309.1892457188,1003,1,481.38271604938274,75,87,45,34.76813151556704,0.6334722222222222,40.11787280701751,8316.22807017536,110.88304093567147,0
1005,32,1,0,163,0.006134969325153374,0.0,1.0,163,4800,3100,1700,0.6458333333333334,65,31,34,206.3167693883101,0.4271283041732939,0.7304046986474735,0.13446258333083552,1082365.5033638787,7262.030790277515,1089627.5341541562,1004,0,479.4233128834356,76,87,41,34.54187471826346,0.6351425438596492,39.908008658008654,8322.943722943714,109.51241740715413,0
1006,32,0,1,162,0.0,0.006134969325153374,0.9938650306748467,163,4350,3100,1250,0.7126436781609196,56,31,25,206.18220534349345,0.4271929990658689,0.7314137628819259,0.1350160893055777,1083734.3852728442,7739.349112425958,1091473.7343852702,1005,1,480.4233128834356,77,86,43,34.37756568144503,0.6363636363636364,39.74358974358974,8328.205128205107,108.15850815850789,0
1007,32,0,0,162,0.0,0.0,1.0,162,4050,2900,1150,0.7160493827160493,52,29,23,207.33148022830443,0.4264051836515605,0.7318683259298795,0.13609276479595234,1084418.5004340254,8516.818576388798,1092935.3190104142,1006,2,484.15432098765433,79,83,43,34.26382081291057,0.6363396624472574,39.66145833333333,8330.833333333314,105.45358649789004,0
1008,32,0,1,161,0.0,0.006172839506172839,0.9938271604938271,162,4050,2200,1850,0.5432098765432098,59,22,37,203.92749225879916,0.426149579531222,0.7272437562400755,0.13446694737489878,1085717.343784807,7831.523043984023,1093548.866828791,1007,3,485.15432098765433,66,96,41,34.19339998010545,0.6444128787878788,39.50559701492537,8335.820895522385,126.30031659882403,0
1009,32,2,0,163,0.012269938650306749,0.0,1.0,163,4200,3100,1100,0.7380952380952381,53,31,22,199.8017279570828,0.42589910121437047,0.7220879959088684,0.13240870199975738,1087148.8826346204,6642.8450594018705,1093791.7276940222,1008,0,483.0858895705521,70,93,43,34.1257668711656,0.6438988095238095,39.33392018779343,8341.314553990625,119.16163648558036,0
1010,32,0,1,162,0.0,0.006134969325153374,0.9938650306748467,163,3850,2900,950,0.7532467532467533,48,29,19,199.78022179864055,0.425621386553561,0.7224791214254387,0.13256514344144316,1087516.0489541336,7002.839493927668,1094518.8884480614,1009,1,484.0858895705521,70,93,46,34.081434064903405,0.6443452380952381,39.28990610328639,8342.723004694852,119.18175720992645,0
1011,32,0,1,161,0.0,0.006172839506172839,0.9938271604938271,162,3500,2800,700,0.8,42,28,14,201.6327243542263,0.42502572016460904,0.7225896820881712,0.13396704336252988,1087883.2772653166,7970.57379488214,1095853.8510601986,1010,2,488.0061728395062,70,92,46,33.988235900898346,0.6447916666666667,39.24589201877935,8344.131455399085,119.20187793427264,0
1012,32,0,1,160,0.0,0.006211180124223602,0.9937888198757764,161,4550,3000,1550,0.6593406593406593,61,30,31,204.7644324529715,0.4246797360248447,0.724237174693273,0.13649195865284805,1088810.1242337571,7839.917427555133,1096650.0416613123,1011,3,490.6645962732919,71,90,45,33.79324727783632,0.645393192488263,39.134837962962976,8347.685185185215,117.57303077725655,0
1013,32,0,0,160,0.0,0.0,1.0,160,4250,2900,1350,0.6823529411764706,56,29,27,201.82908729907618,0.4240017361111111,0.7186289314033287,0.13501496544809444,1089820.00308643,7741.475308642541,1097561.4783950725,1012,4,494.5375,74,86,47,33.746430028559786,0.6451295045045045,39.01388888888892,8351.555555555635,112.85885885885993,0
1014,32,1,0,161,0.006211180124223602,0.0,1.0,161,4000,2800,1200,0.7,52,28,24,228.1051456494515,0.4242963897515528,0.7475129969378533,0.14616152785534978,1077454.4848739912,12954.58244056725,1090409.0673145584,1013,0,492.45962732919253,65,96,38,34.57938004297938,0.6349358974358974,40.49873737373737,8304.040404040394,127.7544677544676,8
1015,32,1,2,160,0.006172839506172839,0.012345679012345678,0.9876543209876543,162,4850,3500,1350,0.7216494845360825,62,35,27,224.74124150868565,0.4247173976944509,0.7434628176563667,0.14498211699126098,1079415.5967758852,11267.840264650162,1090683.4370405353,1014,0,490.41358024691357,68,94,39,34.42531240918337,0.6355698529411764,40.26268115942028,8311.594202898532,122.2293265132137,0
1016,32,0,0,160,0.0,0.0,1.0,160,4500,3200,1300,0.7111111111111111,58,32,26,224.46987321044054,0.4239108359538784,0.74029209621993,0.145157184676085,1080114.7959183683,11990.646258503404,1092105.4421768717,1015,1,493.19375,69,91,40,34.346363115693,0.6358695652173914,40.17857142857143,8314.285714285721,120.49689440993798,0
1017,32,1,0,161,0.006211180124223602,0.0,1.0,161,4750,2800,1950,0.5894736842105263,67,28,39,225.93546053549665,0.4243368271221532,0.7440527592484432,0.14717297011150685,1082217.4396905818,11952.259127207528,1094169.6988177893,1016,0,491.12422360248445,72,89,37,34.04980065108452,0.6368634259259259,39.92579908675799,8322.374429223742,115.58853373921865,0
1018,32,0,0,161,0.0,0.0,1.0,161,4250,3100,1150,0.7294117647058823,54,31,23,230.25440954074236,0.42439829192546585,0.7485473419348065,0.150495845330661,1083193.3791900033,13432.010388767269,1096625.3895787706,1017,1,492.12422360248445,73,88,39,33.817535886893154,0.6375570776255708,39.808558558558566,8326.126126126144,114.0565222757006,0
1019,32,0,1,160,0.0,0.006211180124223602,0.9937888198757764,161,4150,3000,1150,0.7228915662650602,53,30,23,231.8599504670187,0.42396480331262937,0.7502769850595936,0.15194092121885036,1083942.3923839524,13914.565881449103,1097856.9582654014,1018,2,493.12422360248445,76,85,40,33.6837318087318,0.6370614035087719,39.718614718614724,8329.004329004341,109.59216222374134,0
1020,32,1,1,160,0.006211180124223602,0.006211180124223602,0.9937888198757764,161,4550,3900,650,0.8571428571428571,52,39,13,234.1894310533886,0.4238483436853002,0.7538384669668894,0.15430200396791985,1085496.399004153,14092.356818657043,1099588.75582281,1019,0,493.7826086956522,60,101,43,33.432220983850186,0.6480902777777777,39.53210382513662,8334.972677595648,138.9162112932608,0
1021,32,0,1,159,0.0,0.00625,0.99375,160,4000,2400,1600,0.6,56,24,32,231.68073218613128,0.42336952961215935,0.749030651097855,0.15301026730046363,1086172.0171607756,14329.025643179277,1100501.0428039548,1020,1,497.8,62,98,42,33.41464124042817,0.647513440860215,39.45105820105821,8337.566137566153,134.47687318655085,0
1022,32,0,1,158,0.0,0.006289308176100629,0.9937106918238994,159,4850,3800,1050,0.7835051546391752,59,38,21,229.96648362101612,0.4227635803943423,0.7446907405806333,0.1527903779936346,1087879.676686846,13385.172770088131,1101264.849456934,1021,2,499.314465408805,67,92,41,33.24986292249246,0.646455223880597,39.24632352941175,8344.117647058783,124.53906935908633,0
1023,32,0,1,157,0.0,0.006329113924050633,0.9936708860759493,158,4950,3700,1250,0.7474747474747475,62,37,25,228.9480585763916,0.42203919078717517,0.7427569412188777,0.15249670609417412,1088594.8476043728,13296.335387056537,1101891.1829914292,1022,3,503.10759493670884,68,90,45,33.188761237797586,0.6467524509803921,39.16062801932365,8346.8599033816,122.74793975561178,0
1024,32,0,0,157,0.0,0.0,1.0,157,3550,2800,750,0.7887323943661971,43,28,15,228.8906625596033,0.42160875660079483,0.7410941202426307,0.15279998284384244,1089230.311446135,14912.929533381435,1104143.2409795164,1023,4,506.7770700636943,70,87,43,33.11239503673713,0.6464285714285714,39.0845070422535,8349.295774647835,119.2756539235405,0
1025,32,0,2,155,0.0,0.012738853503184714,0.9872611464968153,157,4400,3300,1100,0.75,55,33,22,229.51348335297274,0.4215934454787958,0.7416852755052734,0.15369694914460666,1090119.4131208868,14239.420755214453,1104358.8338761013,1024,5,507.7770700636943,73,84,44,32.98723462582465,0.6459760273972603,38.978040540540526,8352.702702702669,114.42058496852971,0
1026,32,0,0,155,0.0,0.0,1.0,155,4350,3100,1250,0.7126436781609196,56,31,25,228.22847205274186,0.42119291998324254,0.737425635200226,0.15317626012565058,1090748.1512345616,14437.956790123131,1105186.1080246847,1025,6,510.4516129032258,74,81,33,32.94379576927849,0.6462556306306306,38.90277777777776,8355.111111111062,112.90690690690624,0
1027,32,0,0,155,0.0,0.0,1.0,155,3950,2600,1350,0.6582278481012658,53,26,27,225.24856288520184,0.42117720988688734,0.7355070587462369,0.14451573823234282,1077826.1831390313,13605.759758421837,1091431.9428974532,1026,7,511.4516129032258,66,89,39,34.607743300986385,0.6347853535353536,40.45398009950249,8305.47263681592,125.84049449721093,8
1028,32,1,0,156,0.00641025641025641,0.0,1.0,156,3950,3000,950,0.759493670886076,49,30,19,225.4584250415323,0.4222653019023987,0.738598779574893,0.14540310371164628,1079332.5621455691,13518.923911476342,1092851.4860570454,1027,0,509.1666666666667,67,89,40,34.41690012778923,0.6360385572139303,40.27267156862745,8311.274509803923,124.04887328065557,0
1029,32,2,0,158,0.012658227848101266,0.0,1.0,158,3750,2800,950,0.7466666666666667,47,28,19,219.62860262510813,0.42372057163589455,0.7355692820992592,0.14256816228207891,1081214.849108368,12143.14128943757,1093357.9903978056,1028,0,503.7088607594937,71,87,41,34.336969427129716,0.636150234741784,40.0462962962963,8318.518518518522,117.16223265519045,0
1030,32,0,0,158,0.0,0.0,1.0,158,4000,2500,1500,0.625,55,25,30,219.69077182529105,0.4231914657744094,0.7357609496240214,0.14306616177202203,1082138.8058244085,11947.181894732814,1094085.9877191414,1029,1,504.7088607594937,73,85,39,34.22186513306271,0.6362728310502284,39.93524774774776,8322.072072072096,114.00098728865886,0
1031,32,0,0,158,0.0,0.0,1.0,158,4300,3000,1300,0.6976744186046512,56,30,26,221.91079537730272,0.42336111559031414,0.7395555936960905,0.14499668398336327,1083102.743827164,12170.438271605191,1095273.1820987691,1030,2,505.7088607594937,74,84,40,34.045757041940256,0.6369650900900901,39.81944444444446,8325.777777777805,112.51051051051087,0
1032,32,0,1,157,0.0,0.006329113924050633,0.9936708860759493,158,3650,2600,1050,0.7123287671232876,47,26,21,222.52542812066866,0.42352824585449755,0.7407943191302704,0.145700442384664,1083699.263234842,12980.12850107731,1096679.3917359195,1031,3,506.7088607594937,75,83,40,33.95653395126748,0.6372222222222222,39.74780701754386,8328.070175438603,111.0409356725147,0
1033,32,1,1,157,0.006329113924050633,0.006329113924050633,0.9936708860759493,158,3600,2300,1300,0.6388888888888888,49,23,26,223.7351368023073,0.42253302292456124,0.7439454787251514,0.1469626772319873,1084618.5533442087,13333.456082157674,1097952.0094263665,1032,0,507.67721518987344,76,82,42,33.81222072118883,0.6378837719298245,39.63744588744591,8331.601731601779,109.62633857370761,0
1034,32,1,0,158,0.006329113924050633,0.0,1.0,158,4550,3300,1250,0.7252747252747253,58,33,25,222.36859822472672,0.42207950361471686,0.7421878649166231,0.14698021980219825,1086405.3254437938,12166.485864563201,1098571.811308357,1033,0,508.3481012658228,64,94,41,33.62866441164413,0.646484375,39.42307692307695,8338.461538461592,130.28846153846237,0
1035,32,0,0,158,0.0,0.0,1.0,158,4800,3100,1700,0.6458333333333334,65,31,34,224.4447409839567,0.4218157905345481,0.7447293697810191,0.14883989407199497,1087340.9311308393,12409.590729783346,1099750.5218606226,1034,1,509.3481012658228,64,94,44,33.45986762566343,0.6476236979166667,39.31089743589745,8342.051282051316,130.3445512820518,0
1036,32,0,1,157,0.0,0.006329113924050633,0.9936708860759493,158,6000,4400,1600,0.7333333333333333,76,44,32,218.54297486747532,0.4217301257760219,0.7373635663690683,0.14563070045256896,1088720.8606093514,9986.45913556926,1098707.3197449206,1035,2,510.3481012658228,68,90,40,33.44474024345544,0.646905637254902,39.14553140096619,8347.342995169101,122.75504404660444,0
1037,32,0,0,157,0.0,0.0,1.0,157,4300,3300,1000,0.7674418604651163,53,33,20,222.76105008871622,0.4211341118188252,0.7402494742160204,0.1491217849592028,1090018.168215231,12862.71835348054,1102880.8865687116,1036,3,514.4585987261147,71,86,44,33.17587947822551,0.6468603286384976,38.990162037037024,8352.314814814785,117.63823682837725,0
1038,32,0,0,157,0.0,0.0,1.0,157,3350,2000,1350,0.5970149253731343,47,20,27,222.2245062720186,0.4210745685666068,0.7399015671509548,0.14912518604679462,1090707.379676975,13726.38178719258,1104433.7614641676,1037,4,515.4585987261147,73,84,38,33.10554597081444,0.646689497716895,38.90765765765766,8354.954954954961,114.45143773910905,0
1039,32,0,1,156,0.0,0.006369426751592357,0.9936305732484076,157,4500,3000,1500,0.6666666666666666,60,30,30,229.32621948489177,0.4204059829059829,0.7462748799032046,0.15444924911174626,1091730.9721753688,14172.507308708464,1105903.4794840773,1038,5,516.4585987261147,76,81,38,32.79483228891536,0.6465186403508771,38.78517316017315,8358.874458874438,109.98519024834786,0
1040,32,0,0,156,0.0,0.0,1.0,156,4350,3000,1350,0.6896551724137931,57,30,27,232.71975182528033,0.42008977805348774,0.7476450514628994,0.1571219690894904,1092426.9600591704,15295.866206443075,1107722.8262656135,1039,6,515.3076923076923,77,79,39,32.62100071552695,0.6469155844155844,38.70192307692307,8361.538461538452,108.59140859140847,0
1041,32,1,0,157,0.006369426751592357,0.0,1.0,157,4000,2500,1500,0.625,55,25,30,235.45606384136687,0.420724113996407,0.7514522845571754,0.15954039377029927,1093436.4262315547,16091.247396250808,1109527.6736278054,1040,0,513.0191082802547,78,79,40,32.42596001883052,0.6477029914529915,38.581223628691994,8365.400843881884,107.24872876771646,0
1042,32,3,0,160,0.01875,0.0,1.0,160,4050,2600,1450,0.6419753086419753,55,26,29,226.61276599532707,0.42199783805031443,0.743491076653013,0.15528517124539523,1096588.827013654,13650.205449827308,1110239.0324634812,1041,0,504.38125,67,93,39,32.272040179442186,0.6570273631840796,38.20465686274512,8377.4509803922,125.03658179689849,0
1043,32,0,1,159,0.0,0.00625,0.99375,160,3800,2700,1100,0.7105263157894737,49,27,22,225.44396582162187,0.42196098663522014,0.7405469187675062,0.15489510353795116,1097330.0188454734,13677.286252728005,1111007.3050982014,1042,1,505.38125,70,90,43,32.2121848739496,0.65625,38.11619718309861,8380.281690140893,119.71830985915562,0
1044,32,0,0,159,0.0,0.0,1.0,159,3950,2500,1450,0.6329113924050633,54,25,29,222.63212645754734,0.42119291192314834,0.7369814862853064,0.15360344541991047,1098493.2303723027,13161.976755401396,1111655.207127704,1043,2,509.3018867924528,71,88,44,32.14396637402682,0.6571302816901409,37.977430555555564,8384.722222222246,118.09467918622882,0
1045,32,0,3,156,0.0,0.018867924528301886,0.9811320754716981,159,3900,2700,1200,0.6923076923076923,51,27,24,189.1923861089796,0.4211232518642358,0.6997862795551215,0.1271106634310089,1091045.5322265718,5583.501519097692,1096629.0337456695,1044,3,510.3018867924528,79,80,42,33.926753511177616,0.6443829113924051,38.86718750000003,8356.250000000071,105.7753164556971,8
1046,32,0,1,155,0.0,0.00641025641025641,0.9935897435897436,156,3850,2600,1250,0.6753246753246753,51,26,25,190.81572113889152,0.41930228149986215,0.6969287990948079,0.12828568136038407,1091231.4733215915,6594.824102263277,1097826.2974238547,1045,4,521.0512820512821,78,78,43,33.8616875357636,0.6450320512820513,38.844936708860786,8356.962025316521,107.14053878610925,0
1047,32,0,0,155,0.0,0.0,1.0,155,4700,3400,1300,0.723404255319149,60,34,26,189.4004866622421,0.41853267700041896,0.6925596935359868,0.12767359230444508,1091983.0325317425,5664.423557684944,1097647.4560894275,1046,5,524.8,82,73,45,33.807027446835754,0.6443089430894309,38.75502008032131,8359.839357429788,101.94926045646083,0
1048,32,0,0,155,0.0,0.0,1.0,155,4300,3400,900,0.7906976744186046,52,34,18,186.98515054012557,0.4179025275799469,0.6889834049345933,0.12651961534299336,1093041.2085262395,5576.4949845680985,1098617.7035108076,1047,6,525.8,83,72,46,33.741212775379175,0.6452058232931727,38.628472222222236,8363.888888888927,100.76974564926418,0
1049,32,0,0,155,0.0,0.0,1.0,155,4650,3200,1450,0.6881720430107527,61,32,29,189.92787761692477,0.41769480519480523,0.6942939498439611,0.12913306718350087,1094398.9941422197,5921.375644705781,1100320.3697869254,1048,7,526.8,68,87,45,33.49892730701147,0.6537990196078431,38.466183574879224,8369.082125603858,123.0747371412332,0
1050,32,1,1,155,0.00641025641025641,0.00641025641025641,0.9935897435897436,156,4550,2800,1750,0.6153846153846154,63,28,35,189.61530242203818,0.41809518886131786,0.6959374428699574,0.1298036196262556,1096310.7940297066,5825.4605516975225,1102136.2545814042,1049,0,524.4166666666666,71,85,48,33.27443624606199,0.6544894366197183,38.23784722222222,8376.388888888889,117.9773082942097,0
1051,32,1,0,156,0.00641025641025641,0.0,1.0,156,3850,2700,1150,0.7012987012987013,50,27,23,188.1442973703393,0.4183416046319272,0.6933496518531996,0.12925541020228185,1097303.4351919475,6240.276763249727,1103543.7119551972,1050,0,522.6730769230769,73,83,47,33.192234644879235,0.6546803652968036,38.119369369369366,8380.18018018017,114.79698876959138,0
1052,32,0,1,155,0.0,0.00641025641025641,0.9935897435897436,156,4900,3700,1200,0.7551020408163265,61,37,24,188.85044664924072,0.41844413427074717,0.6918182465382836,0.12182263140567383,1079401.1187130127,4669.076676528299,1084070.1953895409,1051,1,523.6730769230769,77,79,43,35.35930510566092,0.6310876623376623,40.26442307692306,8311.538461538421,107.94205794205742,8
1053,32,0,0,155,0.0,0.0,1.0,155,4600,3300,1300,0.717391304347826,59,33,26,191.6001195415728,0.417621491411814,0.6940253023682124,0.12414327272072254,1080678.6772952995,5811.632751161367,1086490.310046461,1052,3,528.0451612903225,78,77,45,35.13127853881279,0.6322115384615384,40.11075949367087,8316.455696202487,106.62122687439086,0
1054,32,1,0,156,0.00641025641025641,0.0,1.0,156,4250,3000,1250,0.7058823529411765,55,30,25,188.31174033946877,0.41825286049076377,0.690655796856326,0.12234882786627123,1081473.1744497253,5280.819122215254,1086753.9935719406,1053,0,525.6538461538462,81,75,44,35.11942571419262,0.6319444444444444,40.015243902439,8319.512195121897,102.71002710027034,0
1055,32,0,1,155,0.0,0.00641025641025641,0.9935897435897436,156,4750,3300,1450,0.6947368421052632,62,33,29,187.37073052231779,0.4179314860766474,0.6898539164450965,0.12216664820346891,1082487.4835640218,4615.294115330977,1087102.7776793528,1054,1,526.6538461538462,83,73,40,35.01971593166466,0.6324046184738956,39.893353174603156,8323.412698412654,100.28208070376692,0
1056,32,0,1,154,0.0,0.0064516129032258064,0.9935483870967742,155,3500,2500,1000,0.7142857142857143,45,25,20,215.59981162576335,0.4170192710515291,0.716502513959838,0.13527335032527868,1071297.8885637764,11694.324593885638,1082992.213157662,1055,6,531.0451612903225,70,85,45,35.66236226871538,0.6245535714285715,41.241197183098585,8280.281690140839,118.28973843058341,8
1057,32,1,1,154,0.0064516129032258064,0.0064516129032258064,0.9935483870967742,155,3300,2000,1300,0.6060606060606061,46,20,26,209.3499612897348,0.41761800027929064,0.718773692051272,0.12407814778879386,1054237.2545129925,9840.905684498155,1064078.1601974906,1056,0,526.1483870967742,70,85,40,37.93605204999239,0.6035714285714286,43.309859154929576,8214.084507042246,117.3440643863178,8
1058,32,0,0,154,0.0,0.0,1.0,154,4850,3500,1350,0.7216494845360825,62,35,27,204.833875850727,0.4171308674985146,0.7105070641818594,0.121972034376081,1055662.4164685868,7597.084871040917,1063259.5013396277,1057,1,530.4155844155844,72,82,42,37.87497916782401,0.6043113425925926,43.136415525114145,8219.634703196329,114.16159309994902,0
1059,32,0,0,154,0.0,0.0,1.0,154,5150,3500,1650,0.6796116504854369,68,35,33,205.47252474698962,0.4171803822539117,0.7110924997494312,0.12282660614729608,1056835.6353339173,7480.137246929818,1064315.7725808471,1058,2,531.4155844155844,72,82,40,37.71294856846738,0.6057581018518519,42.993721461187214,8224.20091324201,114.2250126839168,0
1060,32,1,0,155,0.0064516129032258064,0.0,1.0,155,4250,2800,1450,0.6588235294117647,57,28,29,207.3677563936772,0.4185902806870549,0.7147390056736813,0.12451764530318145,1058194.6755834937,8637.091140696653,1066831.7667241902,1059,0,528.9806451612903,77,78,42,37.495618476398185,0.6051136363636364,42.82852564102563,8229.487179487149,106.87645687645647,0
1061,32,0,1,154,0.0,0.0064516129032258064,0.9935483870967742,155,4050,2900,1150,0.7160493827160493,52,29,23,222.41923179043016,0.41865312107247593,0.7353355041737921,0.13258497063871041,1055986.299844059,11924.332318506702,1067910.6321625656,1060,1,529.9806451612903,66,89,36,37.38299846687644,0.6079545454545454,43.09701492537312,8220.895522388026,124.55902306648524,8
1062,32,1,0,155,0.0064516129032258064,0.0,1.0,155,4850,3500,1350,0.7216494845360825,62,35,27,221.13851464056097,0.4182813154587348,0.7342709259162454,0.13246841119730593,1057469.4444444356,10919.444444443914,1068388.8888888797,1061,0,530.9677419354839,69,86,39,37.231564019448946,0.6080917874396135,42.916666666666636,8226.666666666597,119.2270531400956,0
1063,32,2,0,157,0.012738853503184714,0.0,1.0,157,3450,2300,1150,0.6666666666666666,46,23,23,218.78326012256414,0.42045021503620233,0.7349553249842018,0.13170094813855351,1058949.0712505905,11486.066022392737,1070435.1372729833,1062,0,525.1910828025477,72,85,41,37.10838556399875,0.6083622685185186,42.73687214611869,8232.42009132413,114.33916793505735,0
1064,32,0,0,157,0.0,0.0,1.0,157,4300,3000,1300,0.6976744186046512,56,30,26,218.80634986192172,0.42032432358865485,0.7350611453248894,0.13198807008873914,1059573.8995064225,10668.299471992399,1070242.1989784148,1063,1,526.1910828025477,65,92,41,37.0302437902484,0.6129807692307692,42.66098484848483,8234.848484848442,126.68997668997604,0
1065,32,2,0,159,0.012578616352201259,0.0,1.0,159,4400,3000,1400,0.6818181818181818,58,30,28,225.09386515756,0.4229045590849985,0.7420724983898441,0.12446258160023302,1032692.6405420984,10290.555595878046,1042983.1961379765,1064,0,520.559748427673,82,77,34,40.22769187702749,0.5715193089430894,45.94628514056228,8129.718875502091,99.14291311587915,8
1066,32,2,1,160,0.012422360248447204,0.006211180124223602,0.9937888198757764,161,4200,2900,1300,0.6904761904761905,55,29,26,222.28393235764233,0.4255483307453416,0.7438257003474398,0.12393090475282255,1035306.25,9626.388888888903,1044932.6388888889,1065,0,515.0807453416149,69,92,36,39.970652470652475,0.5806159420289856,45.625,8140.0,117.97101449275362,0
1067,32,7,2,165,0.041916167664670656,0.011976047904191617,0.9880239520958084,167,4850,3400,1450,0.7010309278350515,63,34,29,227.44837572871475,0.4310219921602578,0.7627955104317936,0.12913854284087142,1041007.2314342429,9105.080782313056,1050112.312216556,1066,0,497.5149700598802,69,98,40,39.12396933278886,0.5877113526570048,44.92559523809525,8162.380952380972,118.29537612146336,8
1068,32,3,0,168,0.017857142857142856,0.0,1.0,168,4850,3100,1750,0.6391752577319587,66,31,35,205.69371602035608,0.4314689074232487,0.7368022139833283,0.11633707673730989,1039802.7884303265,4326.179896112566,1044128.968326439,1067,0,495.1309523809524,73,95,38,39.829514080618466,0.584189497716895,45.07319819819821,8157.657657657692,111.74873503640674,8
1069,32,1,0,169,0.005917159763313609,0.0,1.0,169,4800,3200,1600,0.6666666666666666,64,32,32,202.55320655348334,0.43192918192918195,0.7344873060697479,0.11495900530883198,1040885.7709750632,3566.950113379034,1044452.7210884423,1068,0,493.1952662721894,76,93,40,39.77416374951381,0.5841557017543859,44.94047619047621,8161.904761904813,107.39348370927387,0
1070,32,4,0,173,0.023121387283236993,0.0,1.0,173,3850,2200,1650,0.5714285714285714,55,22,33,204.10748126246125,0.43532256799749075,0.7426708541020806,0.11728604424771719,1044738.3159481206,4197.78124931152,1048936.097197432,1069,0,482.76878612716763,70,103,43,39.253315726014804,0.5918154761904761,44.468896713615045,8176.995305164368,116.81421864520526,0
1071,32,4,2,175,0.022598870056497175,0.011299435028248588,0.9887005649717514,177,4700,2800,1900,0.5957446808510638,66,28,38,201.28492038435226,0.43821825243965074,0.7448580643947749,0.11708928830104913,1048518.3730861581,2110.1874496359046,1050628.560535794,1070,0,472.8361581920904,76,101,36,38.854282266730074,0.5936129385964912,44.00703463203466,8191.774891774963,107.7865117338811,0
1072,32,2,1,176,0.011299435028248588,0.005649717514124294,0.9943502824858758,177,4750,3600,1150,0.7578947368421053,59,36,23,203.25203252032404,0.4384188816127375,0.7477837490239287,0.1190476190476191,1050625.0000000072,2558.3333333336427,1053183.333333341,1071,0,473.8022598870057,78,99,38,38.54166666666667,0.5953525641025641,43.75000000000002,8200.000000000056,105.12820512820585,0
1073,32,1,2,175,0.005649717514124294,0.011299435028248588,0.9887005649717514,177,4700,3100,1600,0.6595744680851063,63,31,32,213.1199289406468,0.4381527135764424,0.758902378600905,0.12563870897646032,1052606.6098392024,4766.289178277153,1057372.8990174795,1072,0,474.76271186440675,68,109,39,38.04210810280558,0.6026348039215687,43.50845410628019,8207.72946859903,120.70190394998572,0
1074,32,1,3,173,0.005681818181818182,0.017045454545454544,0.9829545454545454,176,5200,3900,1300,0.75,65,39,26,212.95501730103774,0.43810741341991344,0.7573094919786085,0.12605276093724394,1053846.0640855108,4484.361361992199,1058330.425447503,1073,0,478.40340909090907,68,108,39,37.8921568627451,0.6041666666666667,43.35748792270532,8212.56038647344,120.77294685990353,0
1075,32,1,2,172,0.005747126436781609,0.011494252873563218,0.9885057471264368,174,5000,3900,1100,0.78,61,39,22,215.90333355138705,0.4370106914269262,0.7584520195163691,0.1283476412643777,1055151.9247404838,5762.163590926528,1060914.0883314102,1074,0,483.9712643678161,67,107,43,37.654100055674846,0.6063432835820896,43.1985294117647,8217.647058823524,122.65144863915708,0
1076,32,0,2,170,0.0,0.011627906976744186,0.9883720930232558,172,5450,3900,1550,0.7155963302752294,70,39,31,217.87907587229336,0.43660963212294307,0.7581901682448877,0.12986508700941582,1055954.8100597467,6164.091635744255,1062118.901695491,1075,1,485.06976744186045,68,104,38,37.503550371197434,0.6067708333333333,43.100845410628025,8220.77294685992,120.89371980676351,0
1077,32,2,1,171,0.011627906976744186,0.005813953488372093,0.9941860465116279,172,4750,3200,1550,0.6736842105263158,63,32,31,214.827889094773,0.43725633528265107,0.7540462489103195,0.1289040880576547,1057976.4300789104,6306.568637175345,1064282.9987160857,1076,0,485.4186046511628,70,102,42,37.33085620281089,0.6081845238095238,42.855046948356815,8228.638497652597,117.55197853789424,0
1078,32,2,2,171,0.011560693641618497,0.011560693641618497,0.9884393063583815,173,4650,2700,1950,0.5806451612903226,66,27,39,212.23145148408219,0.4388372653134382,0.7526472260813846,0.1281367334900141,1059843.852728473,5736.43984220936,1065580.2925706825,1077,0,481.5202312138728,64,109,43,37.16596616853466,0.6139322916666667,42.628205128205146,8235.897435897474,128.68589743589803,0
1079,32,2,1,172,0.011560693641618497,0.005780346820809248,0.9942196531791907,173,4750,3400,1350,0.7157894736842105,61,34,27,210.63830582689047,0.4391075189317561,0.7501201487100655,0.1281627082191641,1062169.2199642975,5396.704998950132,1067565.9249632477,1078,0,481.9942196531792,68,105,46,36.91883459307437,0.6144301470588236,42.34601449275364,8244.927536231917,121.24893435635171,0
1080,32,1,2,171,0.005780346820809248,0.011560693641618497,0.9884393063583815,173,4300,2700,1600,0.627906976744186,59,27,32,211.3407631259969,0.4392713514361249,0.7522295623451687,0.1292872576716348,1063787.9530444166,6064.351560130053,1069852.3046045466,1079,0,482.91907514450867,68,105,46,36.70033177205309,0.616421568627451,42.1497584541063,8251.207729468637,121.34129013924466,0
1081,32,1,2,170,0.005813953488372093,0.011627906976744186,0.9883720930232558,172,5400,4000,1400,0.7407407407407407,68,40,28,214.20035659811342,0.4381679529897094,0.7547459630556621,0.13177929598475757,1065474.6392084917,5845.009532941059,1071319.6487414327,1080,0,486.50581395348837,70,102,41,36.41788428373794,0.6174107142857144,41.94542253521127,8257.746478873249,117.96780684104641,0
1082,32,2,1,171,0.011627906976744186,0.005813953488372093,0.9941860465116279,172,4550,3200,1350,0.7032967032967034,59,32,27,212.3437423047337,0.43907036243710046,0.7529548533369665,0.13113131990654797,1066598.499301517,6347.103375659474,1072945.6026771765,1081,0,485.8779069767442,72,100,43,36.326844073541906,0.6177662037037037,41.80936073059361,8262.100456621012,114.7513952308474,0
1083,32,0,1,170,0.0,0.005847953216374269,0.9941520467836258,171,5450,4000,1450,0.7339449541284404,69,40,29,211.04646699300972,0.43810629514963884,0.7504808881159313,0.13079606623256426,1067658.1823613215,5415.097468706903,1073073.2798300285,1082,1,489.69590643274853,71,100,43,36.22940586203675,0.6195715962441315,41.681134259259245,8266.203703703673,116.42540427751653,0
1084,32,0,1,169,0.0,0.0058823529411764705,0.9941176470588236,170,4500,3000,1500,0.6666666666666666,60,30,30,208.04233147745956,0.43808591483930853,0.7439983714583003,0.12497276487427861,1058315.710734562,5534.893580088341,1063850.6043146504,1083,2,492.3411764705882,78,92,44,37.46325728445698,0.6048344017094017,42.81381856540082,8229.95780590712,105.51227956291179,8
1085,32,0,0,169,0.0,0.0,1.0,169,5450,4000,1450,0.7339449541284404,69,40,29,210.33316526100498,0.43746184371184366,0.746346494385957,0.12693847363003816,1059720.1199001702,5328.857421874733,1065048.977322045,1084,3,496.1834319526627,63,106,40,37.23016274559404,0.6144179894179894,42.64322916666665,8235.416666666639,130.72089947089904,0
1086,32,1,1,169,0.0058823529411764705,0.0058823529411764705,0.9941176470588236,170,4550,3500,1050,0.7692307692307693,56,35,21,208.76996405561732,0.4381598793363499,0.7457704163529701,0.12657634277515512,1061104.9850251202,5755.3699165860035,1066860.3549417062,1085,0,494.25882352941176,66,104,44,37.098778475408515,0.6142676767676767,42.47512437810944,8240.796019900476,124.86054575606781,0
1087,32,1,1,169,0.0058823529411764705,0.0058823529411764705,0.9941176470588236,170,4050,2600,1450,0.6419753086419753,55,26,29,223.91840020281842,0.43795176354565496,0.7548632788113374,0.13274333584192247,1054307.708744247,9165.779092702138,1063473.487836949,1086,0,495.2294117647059,64,106,42,37.5533254255629,0.6070963541666667,43.30128205128205,8214.358974358973,128.34935897435895,8
1088,32,0,0,169,0.0,0.0,1.0,169,3850,2600,1250,0.6753246753246753,51,26,25,222.47936512664847,0.43704946228984687,0.7513426036546365,0.13239039660369575,1055458.444917032,9313.544948540104,1064771.9898655722,1087,1,499.1301775147929,68,101,45,37.44709927702344,0.6061580882352942,43.16123188405796,8218.840579710126,120.86530264279597,0
1089,32,1,0,170,0.0058823529411764705,0.0,1.0,170,4700,3500,1200,0.7446808510638298,59,35,24,220.3196515409895,0.43764792899408284,0.7507633979569883,0.13173943485781459,1056922.0230249036,7872.138363768792,1064794.1613886724,1088,0,497.18823529411765,71,99,42,37.32063279857399,0.6063673708920188,42.98321759259259,8224.537037037022,115.83854981742284,0
1090,32,0,0,170,0.0,0.0,1.0,170,4700,2800,1900,0.5957446808510638,66,28,38,218.80851079498237,0.43733684302123216,0.7487668608827516,0.12697785232748215,1047779.7067901255,7152.623456790248,1054932.3302469158,1089,1,498.18823529411765,74,96,39,38.49785165083674,0.5936092342342343,44.09722222222223,8188.888888888905,110.66066066066088,8
1091,32,3,1,172,0.017341040462427744,0.005780346820809248,0.9942196531791907,173,3750,2600,1150,0.6933333333333334,49,26,23,233.8889383189371,0.4392909553255366,0.7612812116684171,0.13368582675864188,1043087.2402214837,10443.313437887029,1053530.5536593709,1090,0,490.53179190751445,68,105,40,38.699028360826965,0.5908394607843137,44.67089371980679,8170.53140096625,120.15487354362132,8
1092,32,0,1,171,0.0,0.005813953488372093,0.9941860465116279,172,5650,4100,1550,0.7256637168141593,72,41,31,234.58957659456658,0.4393140271544494,0.7609598006458986,0.13487206186940992,1044899.3746220955,8974.500375305259,1053873.8749974007,1091,1,488.18023255813955,72,100,39,38.454245537625425,0.5910011574074074,44.44920091324203,8177.625570776309,113.57813292744873,0
1093,32,4,2,173,0.022857142857142857,0.011428571428571429,0.9885714285714285,175,5300,3800,1500,0.7169811320754716,68,38,30,228.63664169328106,0.44088122605363983,0.758801782352384,0.13266595568934425,1047744.1650390713,7610.54144965325,1055354.7064887246,1092,0,480.77142857142854,79,96,36,38.25078656354422,0.591376582278481,44.10156250000003,8188.75000000007,103.65506329114012,0
1094,32,2,0,175,0.011428571428571429,0.0,1.0,175,4950,3500,1450,0.7070707070707071,64,35,29,238.75743939613687,0.44175013683634373,0.7737280550774506,0.13955540471746133,1049992.3792104945,10188.698369151465,1060181.077579646,1093,0,481.76,80,95,40,37.710843373494,0.59375,43.827160493827186,8197.530864197597,102.46913580246996,0
1095,32,1,2,174,0.005681818181818182,0.011363636363636364,0.9886363636363636,176,5100,3600,1500,0.7058823529411765,66,36,30,238.1688938297959,0.4425236742424243,0.7750383105858487,0.1400813622339867,1051900.2623697412,9805.984381574566,1061706.246751316,1094,0,480.01704545454544,66,110,41,37.487746584202455,0.6029040404040404,43.59452736318407,8204.975124378092,124.31780491481958,0
1096,32,0,0,174,0.0,0.0,1.0,174,5100,3800,1300,0.7450980392156863,64,38,26,233.2081991822019,0.4415515026687042,0.7667194205192212,0.13776063069522054,1053226.2457991946,9224.199222851921,1062450.4450220466,1095,1,486.2586206896552,68,106,39,37.44961753456897,0.6034007352941176,43.43297101449273,8210.144927536176,120.73742540494376,0
1097,32,1,1,174,0.005714285714285714,0.005714285714285714,0.9942857142857143,175,5500,3900,1600,0.7090909090909091,71,39,32,232.46265775265033,0.4423604269293924,0.7678170260382369,0.13842409203458245,1055662.4164685807,8580.418204373862,1064242.8346729546,1096,0,484.4742857142857,72,103,40,37.1652963724237,0.6043113425925926,43.136415525114124,8219.63470319628,114.16159309994833,0
1098,32,2,4,172,0.011363636363636364,0.022727272727272728,0.9772727272727273,176,4400,3100,1300,0.7045454545454546,57,31,26,229.26699002605852,0.4429694264069264,0.7676603764897476,0.13734784196482738,1057491.995734255,8889.601367728017,1066381.5971019831,1097,0,482.60795454545456,75,101,37,37.0197903893657,0.6051388888888889,42.91392543859646,8226.754385964838,109.69005847953117,0
1099,32,0,1,171,0.0,0.005813953488372093,0.9941860465116279,172,5650,4000,1650,0.7079646017699115,73,40,33,234.4767951941876,0.4407597239222086,0.7688017507077236,0.1407445501327694,1058084.7760975878,9569.26546862397,1067654.0415662117,1098,1,494.3139534883721,77,95,37,36.8121191663204,0.604978354978355,42.84188034188031,8229.059829059759,106.87090687090596,0
1100,32,0,0,171,0.0,0.0,1.0,171,4650,2700,1950,0.5806451612903226,66,27,39,239.7208270474137,0.4395553835569315,0.7739145888551668,0.14460695119186182,1059579.8980933574,11950.673898750701,1071530.5719921081,1099,2,498.0175438596491,64,107,39,36.49128679370616,0.6136067708333333,42.6602564102564,8234.871794871779,128.66987179487154,0
1101,32,1,0,172,0.005813953488372093,0.0,1.0,172,4200,2900,1300,0.6904761904761905,55,29,26,253.10567233477732,0.43974044040981003,0.7843776959663329,0.14680465684040145,1047619.523380507,14431.688763252718,1062051.2121437597,1100,0,496.1162790697674,70,102,33,37.640234696022794,0.5953869047619047,44.1167840375587,8188.262910798161,116.97518443997373,8
1102,32,2,0,174,0.011494252873563218,0.0,1.0,174,5300,3800,1500,0.7169811320754716,68,38,30,250.07091171329157,0.4404053994197506,0.7847481568614241,0.14587337997726676,1049372.595679017,12383.512345679199,1061756.1080246961,1101,0,491.4022988505747,74,100,37,37.498531192942494,0.595579954954955,43.90277777777779,8195.111111111148,110.74474474474523,0
1103,32,4,0,178,0.02247191011235955,0.0,1.0,178,4150,2800,1350,0.6746987951807228,55,28,27,241.81950415122182,0.44252814278761715,0.7841277739510983,0.1425825149334052,1052659.7143486985,11160.73003275366,1063820.4443814522,1102,0,481.3370786516854,62,116,40,37.29936182556567,0.6063508064516129,43.50198412698411,8207.936507936476,132.38607270865285,0
1104,32,0,1,177,0.0,0.0056179775280898875,0.9943820224719101,178,5100,3900,1200,0.7647058823529411,63,39,24,241.73632591574196,0.44238399035104425,0.7811751982745538,0.14319429510380244,1054069.9835709482,10261.401017301367,1064331.3845882495,1103,1,482.3370786516854,66,112,38,37.12558301532496,0.6055871212121212,43.330223880597,8213.432835820873,124.44595205789201,0
1105,32,2,0,179,0.0111731843575419,0.0,1.0,179,5450,4400,1050,0.8073394495412844,65,44,21,237.1032030319882,0.44335859853953513,0.7757264675813016,0.14119737682598732,1055683.8920848977,8811.206440520722,1064495.0985254184,1104,0,479.7486033519553,70,109,41,37.043423006625545,0.6053571428571429,43.13380281690139,8219.718309859107,117.42454728370153,0
1106,32,2,1,180,0.011049723756906077,0.0055248618784530384,0.994475138121547,181,5150,3700,1450,0.7184466019417476,66,37,29,234.58089785436383,0.4445083896050747,0.7763230745458733,0.14094138719819344,1058372.9030973485,8304.813174660876,1066677.7162720093,1105,0,475.43646408839777,73,108,37,36.77360981883861,0.6071632420091324,42.80686936936935,8230.180180180136,112.74219424904295,0
1107,32,0,2,178,0.0,0.011111111111111112,0.9888888888888889,180,5550,3900,1650,0.7027027027027027,72,39,33,238.4600900547059,0.44394074591351124,0.7803295580966969,0.1436024733420051,1059068.13380103,8959.096512052547,1068027.2303130825,1106,1,479.0722222222222,73,107,38,36.58736617971586,0.608019406392694,42.722409909909906,8232.882882882877,112.77921757373805,0
1108,32,4,0,182,0.02197802197802198,0.0,1.0,182,4900,3300,1600,0.673469387755102,65,33,32,261.11101221403715,0.44554633902009594,0.8004705266030612,0.1553290676222038,1055361.094674559,13813.280736357801,1069174.375410917,1107,0,472.54395604395603,64,118,41,36.46704313823371,0.6083984375,43.173076923076934,8218.46153846156,128.4134615384619,8
1109,32,0,2,180,0.0,0.01098901098901099,0.989010989010989,182,6150,4600,1550,0.7479674796747967,77,46,31,261.2926467439953,0.44565448363790905,0.7987789612904743,0.15626701256797562,1056976.1097400808,12686.017051831659,1069662.1267919124,1108,1,473.54395604395603,65,117,37,36.26081005014841,0.609775641025641,42.976641414141426,8224.7474747475,126.53457653457693,0
1110,32,2,0,182,0.01098901098901099,0.0,1.0,182,5300,3600,1700,0.6792452830188679,70,36,34,257.50299136192996,0.4458872159148402,0.7973706455487826,0.1551298508936506,1059184.027777779,12848.611111111171,1072032.6388888902,1109,0,473.5164835164835,59,123,39,36.08299595141698,0.6165254237288136,42.708333333333336,8233.333333333341,139.54802259887018,0
1111,32,1,3,180,0.00546448087431694,0.01639344262295082,0.9836065573770492,183,6700,4700,2000,0.7014925373134329,87,47,40,253.22010836334437,0.44639354270501813,0.7957610131302926,0.15370955944955578,1061463.3560180648,10456.77320692263,1071920.1292249875,1110,0,471.92349726775956,63,120,41,35.909491837809384,0.6165674603174602,42.43164062499999,8242.187499999987,130.8283730158728,0
1112,32,0,0,180,0.0,0.0,1.0,180,5350,4100,1250,0.7663551401869159,66,41,25,251.12119821642224,0.44534450651769086,0.7902333748877364,0.15316730036908938,1062899.4486522614,12033.316625826154,1074932.7652780875,1111,1,480.27777777777777,66,114,38,35.78500120641814,0.6164772727272727,42.257462686567166,8247.761194029854,124.96607869742203,0
1113,32,2,2,180,0.01098901098901099,0.01098901098901099,0.989010989010989,182,6050,4300,1750,0.7107438016528925,78,43,35,250.26798746566394,0.4460371005605812,0.7909011297636883,0.15380547190851027,1065158.6129489627,10865.020478891096,1076023.633427854,1112,0,475.989010989011,68,114,38,35.52637352992805,0.6181066176470589,41.98369565217392,8256.521739130454,121.41943734015373,0
1114,32,1,0,181,0.0055248618784530384,0.0,1.0,181,5700,4300,1400,0.7543859649122807,71,43,28,246.27244683694454,0.4460251688152241,0.7866110341189021,0.1519531653305131,1066343.0748456793,10622.183641975345,1076965.2584876546,1113,0,479.49171270718233,71,110,39,35.48251513113651,0.6179577464788732,41.84027777777778,8261.111111111113,116.35367762128328,0
1115,32,0,2,179,0.0,0.011049723756906077,0.988950276243094,181,5400,3600,1800,0.6666666666666666,72,36,36,248.0755525565939,0.44578217720482916,0.7887069316089279,0.15374732429190613,1067662.9660493862,11372.21604938286,1079035.1820987691,1114,1,480.49171270718233,74,107,40,35.27228166388873,0.6181024774774775,41.680555555555564,8266.222222222248,111.70570570570605,0
1116,32,1,0,180,0.005555555555555556,0.0,1.0,180,4300,3100,1200,0.7209302325581395,55,31,24,246.39963453863703,0.4454874043037451,0.7855499580184717,0.15332391052012348,1068854.4379340266,12373.068576388783,1081227.5065104153,1115,0,481.1722222222222,63,117,40,35.16792611251049,0.6256613756613756,41.53645833333333,8270.833333333323,131.28306878306861,0
1117,32,0,2,178,0.0,0.011111111111111112,0.9888888888888889,180,5800,4500,1300,0.7758620689655172,71,45,26,243.63395657571422,0.4453554986550797,0.7820558200089516,0.15225728499045205,1070127.5539485766,10343.882001836533,1080471.435950413,1116,1,482.1722222222222,65,115,40,35.0817771268156,0.6259615384615385,41.38257575757576,8275.757575757574,127.3193473193473,0
1118,32,0,0,178,0.0,0.0,1.0,178,4800,3400,1400,0.7083333333333334,62,34,28,244.50433278239475,0.4447069605789373,0.7819706243627798,0.1533018428260875,1071092.311801443,11977.342209072713,1083069.654010516,1117,2,488.3258426966292,64,114,41,34.93986786414781,0.6277669270833333,41.26602564102563,8279.487179487154,129.36698717948678,0
1119,32,1,0,179,0.00558659217877095,0.0,1.0,179,4600,3000,1600,0.6521739130434783,62,30,32,241.56521130212604,0.44480624777687106,0.7810254206472529,0.15210328133405057,1072341.4672241407,11408.078623606118,1083749.5458477468,1118,0,486.5921787709497,67,112,41,34.861439842209094,0.6274875621890548,41.11519607843136,8284.313725490167,123.6464735147786,0
1120,32,0,2,177,0.0,0.0111731843575419,0.9888268156424581,179,4800,3400,1400,0.7083333333333334,62,34,28,247.99286006254715,0.44478663193354673,0.7895392581909175,0.15071777790190716,1061824.560322156,12064.98191978957,1073889.5422419454,1119,1,487.5921787709497,64,115,37,35.99922239502332,0.6163736979166667,42.38782051282051,8243.589743589739,128.80608974358967,8
1121,32,1,1,177,0.0056179775280898875,0.0056179775280898875,0.9943820224719101,178,5400,3800,1600,0.7037037037037037,70,38,32,243.56532994490152,0.44498799170528364,0.7831038240147812,0.1487525598762211,1063289.7500525108,10796.103759714373,1074085.8538122252,1120,0,489.55056179775283,68,110,39,35.93127781681894,0.6158088235294117,42.210144927536234,8249.275362318847,121.31287297527717,0
1122,32,0,0,177,0.0,0.0,1.0,177,4950,3500,1450,0.7070707070707071,64,35,29,239.56662392775664,0.4443401172744393,0.777992370846422,0.14691495370991353,1064522.0051132222,10654.788572356127,1075176.7936855783,1121,1,493.2768361581921,73,104,32,35.881448737539124,0.6147260273972603,42.060810810810814,8254.05405405406,113.06923361717891,0
1123,32,0,1,176,0.0,0.005649717514124294,0.9943502824858758,177,5550,3400,2150,0.6126126126126126,77,34,43,235.67055190499832,0.4443106916623866,0.7750001200024952,0.1452273505718238,1065965.6817482319,9293.344105878785,1075259.0258541107,1122,2,494.2768361581921,75,102,36,35.80297720192579,0.6155555555555556,41.885964912280706,8259.64912280703,110.1286549707604,0
1124,32,0,0,176,0.0,0.0,1.0,176,4700,3400,1300,0.723404255319149,60,34,26,239.18770259483176,0.4438169642857143,0.7792543692556775,0.14796154382810617,1067106.8875208527,11147.768969847117,1078254.6564906999,1123,5,498.0738636363636,76,100,39,35.57076130609393,0.6165021929824561,41.74783549783551,8264.069264069298,108.73775347459602,0
1125,32,0,1,175,0.0,0.005681818181818182,0.9943181818181818,176,4550,3000,1550,0.6593406593406593,61,30,31,232.57292698560605,0.44392857142857145,0.7711092990978485,0.14464039800187312,1068691.272733656,9959.731468728134,1078651.004202384,1124,6,499.0738636363636,65,111,38,35.54548346055981,0.624198717948718,41.55618686868689,8270.20202020207,127.233877233878,0
1126,32,0,2,173,0.0,0.011428571428571429,0.9885714285714285,175,4700,3000,1700,0.6382978723404256,64,30,34,231.2147661780386,0.4434250136836344,0.7690241224186167,0.1441250621323081,1069368.1130835025,9750.739644970707,1079118.8527284733,1125,7,502.8742857142857,64,111,42,35.49686441028184,0.6256510416666667,41.47435897435899,8272.820512820552,129.26282051282112,0
1127,32,3,1,175,0.017045454545454544,0.005681818181818182,0.9943181818181818,176,4150,2800,1350,0.6746987951807228,55,28,27,222.3227653230573,0.44412743506493507,0.761584479802625,0.13969066237350505,1071717.9138322019,8303.458049886698,1080021.3718820885,1126,0,498.4375,69,107,46,35.43655128794848,0.6256038647342995,41.1904761904762,8281.90476190478,120.0276052449968,0
1128,32,0,0,175,0.0,0.0,1.0,175,4700,3100,1600,0.6595744680851063,63,31,32,220.30916585924177,0.44401340996168587,0.7583513351694409,0.13876918419750556,1072447.2234278552,7553.990644290123,1080001.2140721453,1127,1,500.4,71,104,44,35.398679798826485,0.6254401408450705,41.10243055555556,8284.722222222224,116.68622848200316,0
1129,32,1,0,176,0.005681818181818182,0.0,1.0,176,4050,2500,1550,0.6172839506172839,56,25,31,216.56177023655275,0.44423633658008654,0.7555639917665773,0.13714127781512797,1074018.5952648928,7268.2736515083425,1081286.8689164012,1128,0,498.5511363636364,75,101,37,35.30199130649455,0.6254166666666667,40.91282894736843,8290.789473684239,110.54385964912319,0
1130,32,0,2,174,0.0,0.011363636363636364,0.9886363636363636,176,4500,3000,1500,0.6666666666666666,60,30,30,229.52530696765768,0.44396103896103895,0.7705846061495356,0.14155791556421646,1066212.6951331533,9244.559228650296,1075457.2543618036,1129,1,499.5511363636364,76,100,39,35.93100391293713,0.6154057017543859,41.856060606060616,8260.60606060609,108.69218500797486,8
1131,32,0,0,174,0.0,0.0,1.0,174,5650,4300,1350,0.7610619469026548,70,43,27,234.0713927387963,0.4433294853055168,0.772927545446279,0.14485111697816488,1067218.6879228342,9511.072927794035,1076729.7608506281,1130,4,506.0,76,98,40,35.68904632200165,0.6166392543859649,41.73430735930738,8264.502164502217,108.7434495329239,0
1132,32,1,1,174,0.005714285714285714,0.005714285714285714,0.9942857142857143,175,5100,3600,1500,0.7058823529411765,66,36,30,225.77235734982006,0.4434085933223864,0.7649480543270621,0.1405349257437481,1068952.3430326015,8167.978076216891,1077120.3211088185,1131,0,504.10285714285715,65,110,41,35.68896165353854,0.6245192307692308,41.524621212121225,8271.212121212144,127.24941724941759,0
1133,32,0,0,174,0.0,0.0,1.0,174,4950,3800,1150,0.7676767676767676,61,38,23,221.42312618106195,0.4428900073084845,0.7582640316247964,0.13827038747194395,1069900.409723685,7630.1386846836795,1077530.5484083686,1132,1,507.9712643678161,68,106,41,35.68424406951174,0.6239276960784313,41.41002415458939,8274.879227053172,121.68940039784077,0
1134,32,1,2,173,0.005714285714285714,0.011428571428571429,0.9885714285714285,175,4750,3400,1350,0.7157894736842105,61,34,27,218.55651584899962,0.44346195949644224,0.7553505316896605,0.13688297933085747,1070769.84002594,7054.745102452228,1077824.585128392,1133,0,506.0628571428571,71,104,40,35.65102855917824,0.6233861502347418,41.30497685185187,8278.240740740783,116.59494001043356,0
1135,32,2,0,175,0.011428571428571429,0.0,1.0,175,4200,2700,1500,0.6428571428571429,57,27,30,214.66514158588402,0.4435659551176792,0.752285061899066,0.13531701899694196,1072670.757750999,6853.004017531355,1079523.7617685304,1134,0,504.4114285714286,73,102,44,35.51724294153892,0.624714611872146,41.07545045045047,8285.585585585623,113.5011724052825,0
1136,32,1,1,175,0.005681818181818182,0.005681818181818182,0.9943181818181818,176,5050,4000,1050,0.7920792079207921,61,40,21,212.43121510977443,0.4437202380952381,0.7512503573286335,0.13445197852902244,1073858.3471446114,5374.206707941056,1079232.5538525525,1135,0,502.53977272727275,77,99,37,35.42874847500732,0.6243235930735931,40.93215811965814,8290.170940170989,107.66455766455829,0
1137,32,1,1,175,0.005681818181818182,0.005681818181818182,0.9943181818181818,176,5050,3600,1450,0.7128712871287128,65,36,29,219.20314389339478,0.44378314393939394,0.7580924248511622,0.13953877881091134,1075541.840277786,6902.4305555559895,1082444.2708333419,1136,0,503.52840909090907,79,97,39,35.04586848801394,0.6255274261603376,40.72916666666669,8296.66666666673,105.0210970464143,0
1138,32,1,1,175,0.005681818181818182,0.005681818181818182,0.9943181818181818,176,4550,3600,950,0.7912087912087912,55,36,19,216.50837558878914,0.4433400974025974,0.7558611222506717,0.1384056795792101,1076771.597897237,6876.013908174819,1083647.6118054118,1137,0,504.5056818181818,70,106,40,34.96434698186478,0.63125,40.58098591549294,8301.40845070418,118.59154929577402,0
1139,32,0,0,175,0.0,0.0,1.0,175,5550,3700,1850,0.6666666666666666,74,37,37,219.313727644165,0.4429488232074439,0.7579859093261159,0.14100984745877934,1078448.5951699647,6753.716295867502,1085202.3114658322,1138,1,508.3542857142857,71,104,40,34.6852071143308,0.6327758215962441,40.37905092592592,8307.870370370349,117.01225873761054,0
1140,32,0,0,175,0.0,0.0,1.0,175,5150,3700,1450,0.7184466019417476,66,37,29,222.19780678232252,0.44258483853311437,0.7626703162049053,0.14339825388101413,1079530.620391802,7823.867241083613,1087354.4876328856,1139,2,509.3542857142857,71,104,38,34.47722884408302,0.6340962441314554,40.24884259259259,8312.037037037024,117.07094418362006,0
1141,32,1,1,175,0.005681818181818182,0.005681818181818182,0.9943181818181818,176,4800,2900,1900,0.6041666666666666,67,29,38,223.35551242689934,0.44264813311688317,0.7652562155749927,0.14509859159382346,1081436.0422500193,8308.940274734134,1089744.9825247533,1140,0,507.45454545454544,73,103,44,34.21290405544425,0.6354166666666667,40.019707207207205,8319.369369369362,113.96396396396386,0
1142,32,0,2,173,0.0,0.011428571428571429,0.9885714285714285,175,4500,3200,1300,0.7111111111111111,58,32,26,222.90556982410462,0.442183908045977,0.7633996383363484,0.14506294695226607,1081946.6944444405,8734.388888888692,1090681.0833333293,1141,1,511.2742857142857,74,101,40,34.16185974469902,0.6355574324324325,39.95833333333332,8321.333333333303,112.45045045045003,0
1143,32,0,0,173,0.0,0.0,1.0,173,4500,3000,1500,0.6666666666666666,60,30,30,226.7750211075419,0.4410385020388045,0.7665288487191826,0.1480405921966962,1082841.7976675967,10012.294304439452,1092854.0919720363,1142,5,517.7167630057803,73,100,40,33.95125399058491,0.63712899543379,39.85078828828828,8324.774774774749,114.03801061335272,0
1144,32,1,0,174,0.005747126436781609,0.0,1.0,174,5750,4500,1250,0.782608695652174,70,45,25,225.32841209165454,0.44102828162026886,0.7670406307770044,0.14794722390877874,1084498.4304064687,8323.661847876087,1092822.0922543448,1143,0,515.735632183908,75,99,42,33.78548082828815,0.6381944444444445,39.65186403508771,8331.140350877175,111.081871345029,0
1145,32,1,0,175,0.005714285714285714,0.0,1.0,175,4800,3000,1800,0.625,66,30,36,218.2897432461288,0.44110290093048715,0.7606327236777062,0.1443951332396058,1086624.7277295114,7639.806564193924,1094264.5342937054,1144,0,513.7828571428571,66,109,44,33.708064868949585,0.6455176767676767,39.396766169154226,8339.303482587062,126.35308306950094,0
1146,32,1,1,175,0.005681818181818182,0.005681818181818182,0.9943181818181818,176,5050,3700,1350,0.7326732673267327,64,37,27,214.93150930583738,0.44116341991341995,0.7586877392590379,0.14312236249317511,1088518.8726992006,6541.400843425503,1095060.273542626,1145,0,511.85795454545456,67,109,44,33.56366604021066,0.6472325870646767,39.16973039215686,8346.568627450968,124.5756511559846,0
1147,32,0,0,175,0.0,0.0,1.0,175,5050,3400,1650,0.6732673267326733,67,34,33,214.17047391976138,0.4405706075533662,0.7566266944734095,0.14312856061954776,1089538.321995464,6619.387755101974,1096157.709750566,1146,1,515.3314285714285,69,106,44,33.45878953771289,0.6473429951690821,39.047619047619044,8350.476190476184,121.02139406487223,0
1148,32,0,0,175,0.0,0.0,1.0,175,6500,5400,1100,0.8307692307692308,76,54,22,212.42776967659117,0.44026272577996717,0.754398423339639,0.14269106121670222,1090985.0856535048,4851.105699159694,1095836.1913526645,1147,2,516.3314285714285,71,104,37,33.3273888673426,0.6480340375586855,38.87442129629629,8356.018518518506,117.69040166927472,0
1149,32,0,2,173,0.0,0.011428571428571429,0.9885714285714285,175,5200,3800,1400,0.7307692307692307,66,38,28,212.62702258469824,0.4398727422003284,0.7555925856581163,0.14357028162134916,1092454.4942765983,6257.069285461037,1098711.5635620593,1148,3,517.3314285714285,72,103,40,33.14265690985873,0.6493055555555556,38.698630136986296,8361.643835616427,116.13394216133926,0
1150,32,0,0,173,0.0,0.0,1.0,173,4500,3400,1100,0.7555555555555555,56,34,22,219.09486544300887,0.43841578169108747,0.761811671326162,0.1483183578713533,1093178.5702509913,8801.962350864182,1101980.5326018555,1149,6,524.2716763005781,73,100,41,32.88517376631302,0.6496860730593608,38.61204954954954,8364.41441441439,114.5810193755396,0
1151,32,0,0,173,0.0,0.0,1.0,173,5150,3600,1550,0.6990291262135923,67,36,31,224.68461882594755,0.43779545861899,0.7668732302963401,0.15287251549280248,1094597.545036531,9437.84643487011,1104035.391471401,1150,7,525.2716763005781,62,111,40,32.565664706997914,0.6577620967741935,38.44246031746031,8369.841269841254,134.99743983614925,0
1152,32,0,1,172,0.0,0.005780346820809248,0.9942196531791907,173,4600,3100,1500,0.6739130434782609,61,31,30,222.47789692867696,0.43712892637899364,0.7646897674415274,0.1519541047926615,1095674.658881288,9552.678765190649,1105227.3376464788,1151,8,526.2716763005781,63,110,42,32.49186258655719,0.6583994708994709,38.313802083333314,8373.958333333292,132.9199735449729,0
1153,32,1,1,172,0.005780346820809248,0.005780346820809248,0.9942196531791907,173,5000,3800,1200,0.76,62,38,24,217.3240055990066,0.4372241452704217,0.7593357735719544,0.14454372997294704,1088181.124848391,7697.576173856798,1095878.7010222478,1152,0,526.4046242774566,66,107,41,33.54261058781448,0.6474116161616161,39.21019900497511,8345.273631840764,126.44353987637521,8
1154,32,0,0,172,0.0,0.0,1.0,172,5550,3900,1650,0.7027027027027027,72,39,33,215.55563754198428,0.43696096264563217,0.75611506370427,0.1437318914385271,1088902.4804161827,6993.813677431537,1095896.2940936142,1153,1,529.546511627907,67,105,42,33.50044039929532,0.6476990049751243,39.12377450980391,8348.039215686249,124.59760023412312,0
1155,32,1,1,172,0.005780346820809248,0.005780346820809248,0.9942196531791907,173,5300,3800,1500,0.7169811320754716,68,38,30,214.1409599082812,0.43667383608908006,0.7557783166343737,0.14363506903761225,1090578.1790705079,6807.491624236607,1097385.6706947444,1154,0,527.4797687861271,70,103,37,33.33239674065749,0.6480654761904762,38.92312206572769,8354.46009389669,119.34942991280987,0
1156,32,0,2,170,0.0,0.011627906976744186,0.9883720930232558,172,4550,2800,1750,0.6153846153846154,63,28,35,216.22167437033693,0.43608263633890926,0.7575347343397689,0.1458628022956257,1092194.3352677003,8281.217581875686,1100475.5528495759,1155,1,531.2732558139535,71,101,39,33.08051617845214,0.6495011737089202,38.72974537037036,8360.648148148119,117.75560772039604,0
1157,32,0,1,169,0.0,0.0058823529411764705,0.9941176470588236,170,5600,4100,1500,0.7321428571428571,71,41,30,214.67750573382563,0.43577343659357237,0.7531492876687693,0.14520063497122393,1092931.8091782888,7325.5749463104285,1100257.3841245992,1156,2,537.4411764705883,72,98,42,33.0307745504841,0.6498842592592593,38.64155251141552,8363.470319634689,116.15930999492623,0
1158,32,0,0,169,0.0,0.0,1.0,169,4250,3000,1250,0.7058823529411765,55,30,25,218.22016139293677,0.43552174321405096,0.7558607664142878,0.147911855379183,1093531.825744662,9676.138300462499,1103207.9640451244,1157,3,537.1834319526628,73,96,42,32.86488620862946,0.6501141552511416,38.56981981981981,8365.765765765753,114.59953103788702,0
1159,32,0,0,169,0.0,0.0,1.0,169,5150,3600,1550,0.6990291262135923,67,36,31,218.3875893471914,0.4349200479008171,0.7564833986704798,0.14872564983000214,1094857.0421006915,8870.638020833145,1103727.6801215247,1158,4,538.1834319526628,63,106,41,32.69868923179027,0.6574074074074074,38.41145833333332,8370.83333333331,132.87037037037,0
1160,32,0,0,169,0.0,0.0,1.0,169,4250,3000,1250,0.7058823529411765,55,30,25,214.99113739154785,0.4344254837043298,0.7530232433454593,0.14717792280609993,1096316.387245234,9089.661406969144,1105406.0486522033,1159,5,539.1834319526628,64,105,44,32.60951083629239,0.6585286458333333,38.23717948717949,8376.410256410263,130.88141025641036,0
1161,32,0,1,168,0.0,0.005917159763313609,0.9940828402366864,169,5150,3900,1250,0.7572815533980582,64,39,25,215.2902125401261,0.43398521884098806,0.7536487131594674,0.14820288915505875,1097864.7307991516,8321.9062468114,1106186.637045963,1160,6,540.1834319526628,65,104,42,32.412923520314905,0.659775641025641,38.05239898989898,8382.323232323219,128.95881895881874,0
1162,32,0,0,168,0.0,0.0,1.0,168,4200,3000,1200,0.7142857142857143,54,30,24,215.96186992138382,0.43347085590723317,0.7529968474309106,0.14926073149916982,1098976.699988857,9667.412625924824,1108644.1126147818,1161,7,544.2619047619048,66,102,45,32.25984259753614,0.6605113636363636,37.91977611940297,8386.567164179067,127.06919945725859,0
1163,32,0,0,168,0.0,0.0,1.0,168,4500,2900,1600,0.6444444444444445,61,29,32,229.42293917882847,0.4332102164718183,0.7649194283890242,0.1481143148299789,1079634.7243880061,11438.594341723965,1091073.31872973,1162,8,545.2619047619048,66,102,41,34.276743675684294,0.6369949494949495,40.236318407960184,8312.437810945243,125.94602743856429,8
1164,32,1,0,169,0.005917159763313609,0.0,1.0,169,4200,2700,1500,0.6428571428571429,57,27,30,227.76968787550896,0.4333776533295764,0.7643663050796432,0.14770285183249116,1080921.845463139,11240.246271791735,1092162.0917349306,1163,0,543.0295857988166,68,101,42,34.16136667247489,0.6374080882352942,40.08152173913044,8317.391304347833,122.3145780051152,0
1165,32,0,0,169,0.0,0.0,1.0,169,4500,2900,1600,0.6444444444444445,61,29,32,229.8587190775297,0.433348302338687,0.7668774496110253,0.1496007864387273,1081971.4604591827,11440.114795918322,1093411.575255101,1164,1,544.0295857988166,69,100,35,33.9780042918455,0.6381340579710144,39.95535714285714,8321.428571428563,120.60041407867483,0
1166,32,0,1,168,0.0,0.005917159763313609,0.9940828402366864,169,4300,2900,1400,0.6744186046511628,57,29,28,230.4601611755452,0.4330327791866253,0.767068152464482,0.15033328394563705,1082625.5951200153,11800.41382882587,1094426.0089488411,1165,2,545.0295857988166,70,99,35,33.88195619477346,0.6383928571428572,39.87676056338028,8323.943661971827,118.91348088531181,0
1167,32,0,0,168,0.0,0.0,1.0,168,4400,3000,1400,0.6818181818181818,58,30,28,230.47286504223638,0.4327089867883281,0.7656377456433086,0.15035929294119735,1082659.5186042495,11904.728223593767,1094564.2468278431,1166,12,549.2619047619048,71,97,35,33.8774564330738,0.6379107981220657,39.872685185185176,8324.074074074051,117.24047991653593,0
1168,32,0,0,168,0.0,0.0,1.0,168,5550,4100,1450,0.7387387387387387,70,41,29,229.20572452221452,0.43236443779108447,0.7645684741143717,0.14999384882273165,1083545.017779601,10520.944170521712,1094065.9619501228,1167,13,550.2619047619048,73,95,36,33.80162411424244,0.6379851598173516,39.76632882882882,8327.477477477454,114.07503393804731,0
1169,32,1,0,169,0.005917159763313609,0.0,1.0,169,3900,2700,1200,0.6923076923076923,51,27,24,228.71376757598028,0.4322784587207664,0.764579496347805,0.15041186133393336,1084959.5667761536,11929.038036995269,1096888.604813149,1168,0,548.0,78,91,37,33.640732864111264,0.6374198717948718,39.59651898734176,8332.911392405033,106.83219733852606,0
1170,32,1,0,170,0.0058823529411764705,0.0,1.0,170,4700,2800,1900,0.5957446808510638,66,28,38,228.20251584921826,0.432294929806242,0.7662531628563116,0.1510045363062712,1086723.5134794668,10898.607961703317,1097622.12144117,1169,0,545.7705882352941,62,108,38,33.43761895698517,0.6481854838709677,39.38492063492064,8339.682539682548,134.5110087045572,0
1171,32,0,0,170,0.0,0.0,1.0,170,4850,3600,1250,0.7422680412371134,61,36,25,225.10714139146006,0.4320810128785242,0.7628357783791477,0.14946824661523012,1087701.5100499971,10119.875522905912,1097821.385572903,1170,1,546.7705882352941,65,105,39,33.39840597255851,0.6474358974358974,39.267676767676775,8343.434343434361,128.36052836052863,0
1172,32,0,0,170,0.0,0.0,1.0,170,4650,3200,1450,0.6881720430107527,61,32,29,225.75241406799782,0.4321571528019492,0.7634785077986137,0.15049264027202786,1088829.952383607,10511.198052028583,1099341.1504356356,1171,2,547.7705882352941,66,104,38,33.24331505651906,0.6482007575757576,39.13246268656717,8347.76119402987,126.48123021257379,0
1173,32,1,0,171,0.005847953216374269,0.0,1.0,171,4350,3200,1150,0.735632183908046,55,32,23,222.42653392390068,0.4323873409012728,0.7613155696258183,0.1489448013766167,1090107.4850054847,9943.765898854075,1100051.2509043387,1172,0,545.561403508772,68,103,40,33.17367939078463,0.6485906862745099,38.979468599033815,8352.657004830919,122.83319124751351,0
1174,32,0,1,170,0.0,0.005847953216374269,0.9941520467836258,171,6200,4700,1500,0.7580645161290323,77,47,30,221.6978178127638,0.4317351794518977,0.7602689008996413,0.14923685319879282,1091589.6267361075,8000.6076388887195,1099590.2343749963,1173,1,546.561403508772,71,100,36,33.01138251910935,0.6487676056338028,38.80208333333332,8358.333333333305,117.72300469483528,0
1175,32,0,1,169,0.0,0.0058823529411764705,0.9941176470588236,170,3950,2800,1150,0.7088607594936709,51,28,23,224.1012020358455,0.4310404339250493,0.761451779633868,0.1513639176890575,1092540.2015969064,11017.914490070374,1103558.1160869768,1174,5,550.7705882352941,70,100,38,32.83235547320943,0.6504464285714286,38.688380281690144,8361.971830985922,119.45674044265603,0
1176,32,0,1,168,0.0,0.005917159763313609,0.9940828402366864,169,4400,3300,1100,0.75,55,33,22,222.13839367027379,0.43056582840236685,0.7500074808264681,0.1465355129075513,1085835.5109813518,10041.151239907591,1095876.6622212594,1175,6,554.6213017751479,67,102,38,33.704525853620275,0.6439676616915423,39.491421568627445,8336.27450980391,124.42200760901359,8
1177,32,0,0,168,0.0,0.0,1.0,168,4350,2900,1450,0.6666666666666666,58,29,29,212.8114377896889,0.430337242182302,0.7421329917512771,0.13696199701447379,1078730.264257073,7963.227704759766,1086693.4919618326,1176,8,558.8869047619048,66,102,47,34.81939704209329,0.6358901515151515,40.34514925373134,8308.955223880597,125.89326096788784,8
1178,32,1,0,169,0.005917159763313609,0.0,1.0,169,5300,3900,1400,0.7358490566037735,67,39,28,209.715828011285,0.43073019395134776,0.73971614715554,0.13550033032646217,1079867.3611111098,6193.055555555504,1086060.4166666653,1177,0,556.5739644970414,69,100,45,34.76009088479015,0.6355676328502415,40.20833333333333,8313.333333333323,120.48309178743946,0
1179,32,1,0,170,0.0058823529411764705,0.0,1.0,170,3750,2700,1050,0.72,48,27,21,208.24304287596942,0.43141025641025643,0.7394244848347795,0.12813535547749605,1065523.6776423512,6627.5785777272595,1072151.2562200786,1178,0,554.2941176470588,83,87,39,36.565553419830195,0.6116967871485943,41.93948412698412,8257.936507936492,99.49321093899388,8
1180,32,1,1,170,0.005847953216374269,0.005847953216374269,0.9941520467836258,171,4450,3400,1050,0.7640449438202247,55,34,21,208.1716412876085,0.4318254787295035,0.7420588186075572,0.12858866639605762,1066676.6406203047,5760.365400216293,1072437.006020521,1179,0,552.046783625731,85,86,41,36.424909305562046,0.6123774509803921,41.79990310077519,8262.40310077519,97.20474236206105,0
1181,32,0,0,170,0.0,0.0,1.0,170,5050,3800,1250,0.7524752475247525,63,38,25,208.30670042539177,0.4315886413737093,0.741185470432784,0.12884907431818932,1067085.0421492609,5406.192840680382,1072491.2349899414,1180,1,555.8705882352941,86,84,42,36.370968365091876,0.6125242248062015,41.750478927203055,8263.984674329478,96.09284505034277,0
1182,32,0,1,169,0.0,0.0058823529411764705,0.9941176470588236,170,4350,2900,1450,0.6666666666666666,58,29,29,209.26228883837092,0.4315059751711336,0.7430103026625094,0.1298534865175853,1068031.0607698972,6349.724865436454,1074380.7856353337,1181,2,556.8705882352941,67,103,43,36.22944582789832,0.6222014925373134,41.63602941176471,8267.647058823537,123.39771729587369,0
1183,32,3,0,172,0.01744186046511628,0.0,1.0,172,5250,3600,1650,0.6857142857142857,69,36,33,206.91978843119736,0.43274357971802896,0.7434652376229265,0.1295600038927158,1070690.5596332315,4659.41281491778,1075349.9724481492,1182,0,545.4418604651163,70,102,43,35.96184021476103,0.6238095238095238,41.314553990610335,8277.934272300483,118.2562038900069,0
1184,32,1,1,172,0.005780346820809248,0.005780346820809248,0.9942196531791907,173,3950,2400,1550,0.6075949367088608,55,24,31,209.48206737217058,0.4325318143119595,0.7477521770787641,0.13189557049815684,1072327.3667909799,6376.670739026003,1078704.037530006,1183,0,543.2832369942197,71,102,46,35.69376140978353,0.625293427230047,41.116898148148145,8284.259259259252,116.67970787689087,0
1185,32,0,0,172,0.0,0.0,1.0,172,5050,3400,1650,0.6732673267326733,67,34,33,212.58622638053376,0.4318638367559726,0.7493858099347142,0.134433393053422,1073604.0220964209,6196.685536888237,1079800.707633309,1184,1,547.1627906976744,73,99,39,35.45606455820022,0.6258561643835616,40.96283783783784,8289.18918918919,113.55053683820809,0
1186,32,0,1,171,0.0,0.005813953488372093,0.9941860465116279,172,4400,2900,1500,0.6590909090909091,59,29,30,211.5473509087036,0.4318255870619702,0.7486845380099911,0.13413404523853778,1074386.0948304967,6656.706442907873,1081042.8012734046,1185,2,548.1627906976744,76,96,39,35.386648394675035,0.6254111842105263,40.8685064935065,8292.207792207812,109.10799726589225,0
1187,32,0,0,171,0.0,0.0,1.0,171,3900,2700,1200,0.6923076923076923,51,27,24,211.5314206846933,0.43141698199747736,0.7475688067117283,0.13439834091207883,1074983.9880539144,7378.578041268625,1082362.566095183,1186,3,550.9766081871345,78,93,39,35.31344321226305,0.625267094017094,40.79641350210972,8294.514767932533,106.33993292221196,0
1188,32,0,1,170,0.0,0.005847953216374269,0.9941520467836258,171,4650,3300,1350,0.7096774193548387,60,33,27,216.16886027263814,0.4313051828918702,0.7524240821543478,0.1379649865183096,1076299.5139629846,7682.487849074789,1083982.0018120594,1187,4,551.9766081871345,80,91,41,35.03125826391647,0.6260416666666666,40.63786008230454,8299.588477366291,103.74485596707864,0
1189,32,2,0,172,0.011627906976744186,0.0,1.0,172,4150,2500,1650,0.6024096385542169,58,25,33,213.39862200072966,0.43172358787796367,0.750927816940071,0.13696311557501356,1077932.525951556,7455.8631295654695,1085388.3890811214,1188,0,549.3023255813954,67,105,43,34.902226943657546,0.6343283582089552,40.44117647058823,8305.882352941167,123.96839332748011,0
1190,32,0,1,171,0.0,0.005813953488372093,0.9941860465116279,172,5000,3100,1900,0.62,69,31,38,214.85262822846838,0.43170375470329575,0.7514884680372478,0.13846410885684,1079125.2267573685,6970.578231292426,1086095.8049886608,1189,1,550.3023255813954,69,103,44,34.717845137138056,0.6346618357487923,40.297619047619044,8310.476190476182,120.44168391994467,0
1191,32,1,0,172,0.005813953488372093,0.0,1.0,172,4450,3200,1250,0.7191011235955056,57,32,25,209.4945727865817,0.431729962826964,0.7443585166696298,0.13557364103300418,1080329.262345677,6414.623456790029,1086743.8858024671,1190,0,551.0290697674419,74,98,43,34.70911949685535,0.6335867117117118,40.15277777777777,8315.111111111095,112.36636636636615,0
1192,32,0,3,169,0.0,0.01744186046511628,0.9825581395348837,172,4850,3200,1650,0.6597938144329897,65,32,33,213.4518071462627,0.4314126320322771,0.7455484505979852,0.13731212762876813,1078599.2672584802,6795.79255659142,1085395.0598150715,1191,1,552.0290697674419,70,102,43,34.818872313574786,0.6334821428571429,40.360915492957744,8308.45070422535,118.692152917505,8
1193,32,1,0,170,0.0058823529411764705,0.0,1.0,170,5350,3900,1450,0.7289719626168224,68,39,29,217.73728271756997,0.4307307982364543,0.7483663623076817,0.14124621303498477,1081022.299382713,7725.771604938116,1088748.0709876511,1192,0,552.5470588235294,74,96,44,34.40978715825097,0.6344313063063063,40.069444444444436,8317.777777777754,112.40240240240207,0
1194,32,1,1,170,0.005847953216374269,0.005847953216374269,0.9941520467836258,171,4550,2800,1750,0.6153846153846154,63,28,35,223.13649506646502,0.4313739823414746,0.7540176737195499,0.14559523799229918,1082703.311524334,9568.124426078954,1092271.4359504129,1193,0,550.3099415204679,76,95,36,34.06291712170854,0.6355537280701755,39.86742424242424,8324.242424242422,109.52950558213713,0
1195,32,0,0,170,0.0,0.0,1.0,170,4600,3700,900,0.8043478260869565,55,37,18,214.23096079455667,0.431031732219515,0.74984051265841,0.13329202940621857,1068821.8038975652,7194.944393429498,1076016.7482909947,1194,1,554.5294117647059,65,105,38,36.00339928350433,0.6243589743589744,41.540404040404056,8270.7070707071,127.24164724164768,8
1196,32,0,0,170,0.0,0.0,1.0,170,4050,2300,1750,0.5679012345679012,58,23,35,218.04205255676086,0.43114920524422784,0.7492741951454589,0.13335433976206562,1063715.291173697,8336.93308470515,1072052.2242584021,1195,2,555.5294117647059,71,99,46,36.536537238618955,0.6147300469483568,42.15856481481482,8250.925925925927,116.21022430881587,8
1197,32,2,1,171,0.011627906976744186,0.005813953488372093,0.9941860465116279,172,4850,3300,1550,0.6804123711340206,64,33,31,214.60939692594496,0.43247299854934496,0.7464339750384492,0.1321871535656233,1065826.8179012397,6497.29012345704,1072324.1080246968,1196,0,550.0581395348837,74,98,38,36.363768856840444,0.6158502252252251,41.90277777777779,8259.111111111151,111.60960960961015,0
1198,32,1,0,172,0.005813953488372093,0.0,1.0,172,5400,4100,1300,0.7592592592592593,67,41,26,215.43558272537283,0.4325601228523505,0.7474424899680663,0.13321371231141324,1066984.7964037044,6173.29827446922,1073158.0946781738,1197,0,551.0523255813954,75,97,40,36.1992573819507,0.6168055555555556,41.762609649122815,8263.596491228096,110.18128654970795,0
1199,32,3,2,173,0.017142857142857144,0.011428571428571429,0.9885714285714285,175,4600,3000,1600,0.6521739130434783,62,30,32,208.09944412014656,0.43390120415982486,0.7440359157361571,0.12977457796638317,1069500.694444447,4912.500000000178,1074413.1944444473,1198,0,542.5885714285714,69,106,45,36.07809562181036,0.6228864734299517,41.45833333333334,8273.333333333354,119.90338164251237,0
1200,32,0,0,173,0.0,0.0,1.0,173,4950,3300,1650,0.6666666666666666,66,33,33,210.5665158667479,0.43251781153380836,0.7423381727321252,0.13191707669705932,1070855.3890306072,5547.25765306092,1076402.646683668,1199,1,549.7745664739884,69,104,41,35.84717428817946,0.6245471014492754,41.29464285714284,8278.57142857139,119.97929606625202,0
1201,32,1,1,173,0.005747126436781609,0.005747126436781609,0.9942528735632183,174,4900,3200,1700,0.6530612244897959,66,32,34,206.5526177606389,0.4326283691006135,0.7389099211417218,0.13012814918920237,1072501.4073935065,4605.594649819608,1077107.0020433262,1200,0,547.6091954022988,72,102,46,35.74815825249854,0.625,41.0958904109589,8284.931506849309,115.06849315068484,0
1202,32,0,0,173,0.0,0.0,1.0,173,5150,4100,1050,0.7961165048543689,62,41,21,209.48268902010665,0.43234137652910337,0.7380500710578048,0.13255548393602404,1073791.3378395287,5238.139379424456,1079029.4772189532,1201,1,551.6763005780347,75,98,40,35.51338773962576,0.6251388888888889,40.94024122807018,8289.912280701763,110.53216374269017,0
1203,32,0,1,172,0.0,0.005780346820809248,0.9942196531791907,173,4400,3200,1200,0.7272727272727273,56,32,24,218.59363875108795,0.4323665815297755,0.7554911793798786,0.13116299514341428,1057974.8823188231,7253.315846664743,1065228.198165488,1202,2,552.6763005780347,77,96,38,37.23421405695488,0.6048430735930737,42.85523504273501,8228.632478632402,106.86535686535588,8
1204,32,2,0,174,0.011494252873563218,0.0,1.0,174,4550,3500,1050,0.7692307692307693,56,35,21,214.65595279974505,0.4331211381303568,0.7523651444009136,0.1295802688890602,1059796.7155612202,6148.334750566655,1065945.0503117868,1203,0,550.4597701149426,69,105,39,37.10941264334587,0.6109601449275363,42.633928571428555,8235.714285714252,119.35817805382973,0
1205,32,0,0,174,0.0,0.0,1.0,174,5250,3300,1950,0.6285714285714286,72,33,39,214.75158019841948,0.43277024782406487,0.7531826611762487,0.13015606821970527,1060996.7158191733,5520.144261500234,1066516.8600806736,1204,1,551.4597701149426,70,104,40,36.958157664843505,0.611904761904762,42.48826291079813,8240.375586854472,117.71965124077818,0
1206,32,1,1,174,0.005714285714285714,0.005714285714285714,0.9942857142857143,175,4650,3100,1550,0.6666666666666666,62,31,31,217.94464922932642,0.4334838533114395,0.7586538770010591,0.13276436703395214,1062521.9157235937,6664.193244170054,1069186.1089677638,1205,0,549.3028571428572,71,104,39,36.6868777603114,0.613262910798122,42.30324074074074,8246.296296296294,116.14501825769428,0
1207,32,1,2,173,0.005714285714285714,0.011428571428571429,0.9885714285714285,175,4300,2400,1900,0.5581395348837209,62,24,38,215.55151360392196,0.434143404488232,0.7570995431480114,0.1320636629449927,1064241.8970621957,6579.7903504930855,1070821.6874126887,1206,0,550.1657142857143,72,103,44,36.53556213345138,0.6148726851851851,42.09474885844749,8252.968036529675,114.62455606291216,0
1208,32,0,1,172,0.0,0.005780346820809248,0.9942196531791907,173,4900,3600,1300,0.7346938775510204,62,36,26,214.88300697002427,0.4342485549132948,0.7544174105848043,0.1322134596524432,1065506.610216265,6291.852869941761,1071798.463086207,1207,1,552.849710982659,71,102,38,36.396313374820146,0.616930751173709,41.94155092592593,8257.870370370381,116.30803338549833,0
1209,32,0,0,172,0.0,0.0,1.0,172,4350,3300,1050,0.7586206896551724,54,33,21,243.78283643105647,0.4339038204361032,0.7809968183160036,0.1452454042265709,1055830.7078344906,12728.680949380527,1068559.3887838712,1208,2,555.2790697674419,68,104,34,36.85354960037612,0.6066176470588236,43.115942028985515,8220.289855072479,120.88661551577174,8
1210,32,0,0,172,0.0,0.0,1.0,172,5950,4200,1750,0.7058823529411765,77,42,35,246.6407772101265,0.43395198671743956,0.784641985020567,0.14767226281062015,1057320.4158790184,11805.665826507124,1069126.0817055255,1209,3,556.2790697674419,68,104,36,36.594506107587506,0.6084558823529411,42.934782608695656,8226.086956521749,120.97186700767278,0
1211,32,0,2,170,0.0,0.011627906976744186,0.9883720930232558,172,4400,3200,1200,0.7272727272727273,56,32,24,244.5305540274913,0.43349015707874333,0.7816988961426894,0.14695640110609023,1058449.036281178,12964.62585034009,1071413.6621315181,1210,4,557.2790697674419,69,103,38,36.50823497647151,0.6092995169082125,42.797619047619044,8230.476190476182,119.28226363008959,0
1212,32,2,0,172,0.011627906976744186,0.0,1.0,172,4450,2600,1850,0.5842696629213483,63,26,37,241.34451535300212,0.4349053957568339,0.7788009141013581,0.14598811593031255,1060409.5804988663,12334.807256235857,1072744.387755102,1211,0,549.7732558139535,62,110,39,36.34633911368018,0.6159274193548387,42.55952380952381,8238.095238095239,132.87250384024577,0
1213,32,1,0,173,0.005780346820809248,0.0,1.0,173,5050,3200,1850,0.6336633663366337,69,32,37,237.59430023252236,0.4352973629968186,0.7764192637909499,0.14470714404458623,1062465.773380425,10837.162389465242,1073302.9357698902,1212,0,547.5895953757225,67,106,40,36.18748266159393,0.615360696517413,42.310049019607824,8246.078431372505,123.07579748317173,0
1214,32,0,0,173,0.0,0.0,1.0,173,4800,3300,1500,0.6875,63,33,30,237.44919568121324,0.4352399516063987,0.7762476970358883,0.14489662498431122,1063040.692314871,11083.631473313137,1074124.323788184,1213,1,548.5895953757225,68,105,41,36.11985572605519,0.6155024509803921,42.2403381642512,8248.309178743943,121.29866439329328,0
1215,32,0,0,173,0.0,0.0,1.0,173,4600,2900,1700,0.6304347826086957,63,29,34,236.28674580459045,0.4353883810548013,0.7753070308872263,0.14457544955162202,1063844.8979591813,11074.48979591816,1074919.3877550995,1214,2,549.5895953757225,69,104,41,36.05003462603877,0.6159420289855073,42.14285714285713,8251.428571428552,119.58592132505149,0
1216,32,3,2,174,0.017045454545454544,0.011363636363636364,0.9886363636363636,176,5050,3800,1250,0.7524752475247525,63,38,25,232.20137311296062,0.4371800595238095,0.7747614510818792,0.14302280797342218,1065826.8179012344,9247.2901234568,1075074.1080246912,1215,0,541.2045454545455,74,102,37,35.90972483811371,0.6158502252252251,41.90277777777778,8259.11111111111,111.60960960960959,0
1217,32,0,0,174,0.0,0.0,1.0,174,5550,3900,1650,0.7027027027027027,72,39,33,237.66442991094854,0.43558429118773945,0.7791601832601698,0.14695359977832612,1066974.2253086427,10366.364197530962,1077340.5895061737,1216,1,548.4252873563219,74,100,38,35.62653507592466,0.6172578828828829,41.76388888888889,8263.555555555562,111.66966966966976,0
1218,32,0,1,173,0.0,0.005747126436781609,0.9942528735632183,174,4950,3300,1650,0.6666666666666666,66,33,33,237.87161508006682,0.43555383916904744,0.780295412030579,0.14762324335369287,1068064.8341049382,11062.461419753077,1079127.2955246912,1217,2,549.4252873563219,59,115,41,35.48610177843478,0.6274717514124294,41.63194444444444,8267.777777777777,140.13182674199624,0
1219,32,0,1,172,0.0,0.005780346820809248,0.9942196531791907,173,4150,2900,1250,0.6987951807228916,54,29,25,231.84068496459116,0.4343479746381682,0.7695890631664992,0.1380634936176892,1055683.892084904,10200.095329409945,1065883.987414314,1218,3,553.5664739884393,70,103,45,37.178599306983465,0.6053571428571429,43.13380281690141,8219.718309859156,117.42454728370222,8
1220,32,0,1,171,0.0,0.005813953488372093,0.9941860465116279,172,5100,3700,1400,0.7254901960784313,65,37,28,231.7186678227111,0.43336265809873525,0.7692195475870183,0.13867707914147248,1057187.728049875,9494.02639644714,1066681.754446322,1219,4,557.546511627907,72,100,37,36.99460604714851,0.6061921296296297,42.950913242009136,8225.570776255718,114.2440385591072,0
1221,32,1,1,171,0.005813953488372093,0.005813953488372093,0.9941860465116279,172,4700,3300,1400,0.7021276595744681,61,33,28,233.66684415523994,0.43374798834942657,0.7722303617027524,0.14061419963468477,1058849.9091096485,10383.623339142807,1069233.5324487914,1220,0,558.4941860465116,76,96,39,36.73781289440471,0.606359649122807,42.74891774891775,8232.034632034625,108.31624515835033,0
1222,32,1,0,172,0.005813953488372093,0.0,1.0,172,5300,4000,1300,0.7547169811320755,66,40,26,235.12920277322166,0.4346376478988168,0.7717344935100783,0.14218987841441044,1060327.854938276,10162.808641975646,1070490.6635802519,1221,0,558.9418604651163,59,113,39,36.51650031471991,0.6179378531073446,42.569444444444464,8237.777777777814,139.62335216572566,0
1223,32,1,0,173,0.005780346820809248,0.0,1.0,173,4100,2800,1300,0.6829268292682927,54,28,26,231.10477789959208,0.4349066854864005,0.769763899151203,0.14096931999036355,1062922.1992788191,10429.279757775512,1073351.4790365947,1222,0,556.7052023121387,61,112,42,36.2980873693588,0.6197062841530054,42.25470430107527,8247.849462365597,135.21064692402618,0
1224,32,1,0,174,0.005747126436781609,0.0,1.0,174,5100,3900,1200,0.7647058823529411,63,39,24,229.52672679417967,0.435938641950701,0.7682198604600805,0.1409407917422112,1064909.3364197533,8985.030864197628,1073894.3672839508,1223,0,554.5,65,109,38,36.092418124719636,0.6195512820512821,42.01388888888889,8255.555555555558,127.00854700854705,0
1225,32,1,1,174,0.005714285714285714,0.005714285714285714,0.9942857142857143,175,5300,4200,1100,0.7924528301886793,64,42,22,230.61390708447047,0.4360591133004926,0.7712104144009608,0.14263056895646,1067050.2022305983,8915.323238334602,1075965.525468933,1224,0,552.3257142857143,70,105,41,35.79919895466423,0.6193452380952381,41.75469483568075,8263.84976525822,118.05499664654599,0
1226,32,0,0,174,0.0,0.0,1.0,174,5650,4100,1550,0.7256637168141593,72,41,31,228.55032528119065,0.43576561911722367,0.7679907364437535,0.1420336385111106,1068472.3351326715,8389.939949705014,1076862.2750823766,1225,1,553.3793103448276,61,113,41,35.67652460828294,0.6265368852459017,41.58266129032257,8269.354838709656,135.56319407720747,0
1227,32,0,0,174,0.0,0.0,1.0,174,5000,3400,1600,0.68,66,34,32,267.30286818996706,0.4360133878147631,0.7956530768286816,0.1602325857397353,1057677.9006624836,16744.067293644817,1074421.9679561285,1226,2,554.3793103448276,73,101,35,36.01874030477231,0.6063070776255708,42.89132882882882,8227.477477477452,112.70517092434866,8
1228,32,1,0,175,0.005714285714285714,0.0,1.0,175,5000,3300,1700,0.66,67,33,34,267.2964988932059,0.4365106732348112,0.797999197951692,0.16096880186923712,1059069.679012343,16617.123456789963,1075686.802469133,1227,0,552.2057142857143,74,101,39,35.8452772979198,0.607545045045045,42.722222222222214,8232.888888888869,111.25525525525498,0
1229,32,1,0,176,0.005681818181818182,0.0,1.0,176,4900,3300,1600,0.673469387755102,65,33,32,266.6765491341796,0.4373755411255411,0.7983228464947494,0.16149775011061746,1060756.9492669764,16475.800540123524,1077232.7498071,1228,0,550.0625,59,117,39,35.650902951026005,0.6184675141242938,42.517361111111114,8239.444444444453,139.6516007532958,0
1230,32,2,2,176,0.011235955056179775,0.011235955056179775,0.9887640449438202,178,4650,3700,950,0.7956989247311828,56,37,19,261.44619781434875,0.4390803868046298,0.7966958118696488,0.15951799521439866,1062999.1855281217,15333.419067215422,1078332.604595337,1229,0,544.870786516854,62,116,38,35.50647358179913,0.619119623655914,42.245370370370374,8248.148148148155,133.0346475507767,0
1231,32,0,1,175,0.0,0.005681818181818182,0.9943181818181818,176,4050,2000,2050,0.49382716049382713,61,20,41,259.9318174375469,0.43841991341991343,0.7925703755812838,0.15895260398147804,1063674.889053253,16046.589414858568,1079721.4784681115,1230,1,550.9715909090909,64,112,39,35.46146953405019,0.61865234375,42.16346153846153,8250.76923076922,128.91826923076906,0
1232,32,1,1,175,0.005681818181818182,0.005681818181818182,0.9943181818181818,176,4450,3400,1050,0.7640449438202247,55,34,21,261.09502557290466,0.43831371753246756,0.7903712098386706,0.16041732504192313,1065080.478360682,15967.442946956662,1081047.9213076388,1231,0,551.6931818181819,66,110,33,35.256728934417985,0.6191603535353536,41.99315920398009,8256.21890547262,125.09422584049425,0
1233,32,0,1,174,0.0,0.005714285714285714,0.9942857142857143,175,4100,3100,1000,0.7560975609756098,51,31,20,262.22870424791984,0.4376696770662288,0.7912663180002473,0.16157573268846057,1065933.3368764163,16803.66354875282,1082737.0004251692,1232,3,555.8457142857143,69,106,34,35.1214927452676,0.6185084541062802,41.88988095238095,8259.523809523804,119.70324361628701,0
1234,32,0,0,174,0.0,0.0,1.0,174,4050,2400,1650,0.5925925925925926,57,24,33,261.4668083088721,0.4368944200828295,0.7885647305346595,0.1613830735114423,1066444.0786936006,16917.945899182254,1083362.0245927828,1233,4,560.0229885057471,70,104,34,35.077712110018766,0.6186011904761906,41.82805164319249,8261.502347417836,118.02146210596909,0
1235,32,1,2,173,0.005714285714285714,0.011428571428571429,0.9885714285714285,175,4900,3600,1300,0.7346938775510204,62,36,26,258.2963218296842,0.4367911877394636,0.7881062995365167,0.16036538026350763,1068187.8700554331,15281.799571680793,1083469.669627114,1234,0,557.8171428571428,62,113,35,34.94312727970822,0.6255040322580645,41.61706349206351,8268.253968253995,133.35893497183864,0
1236,32,0,1,172,0.0,0.005780346820809248,0.9942196531791907,173,4450,2500,1950,0.5617977528089888,64,25,39,258.6828911472966,0.4365828180310974,0.787464933560952,0.16105096126267224,1069008.2908163294,16256.831065759827,1085265.1218820892,1235,1,564.2601156069364,62,111,35,34.831366340433696,0.6265120967741935,41.51785714285715,8271.428571428594,133.41013824884828,0
1237,32,0,0,172,0.0,0.0,1.0,172,4450,3100,1350,0.6966292134831461,58,31,27,251.64396759262115,0.43632700938392494,0.7849546448664821,0.1523996844067333,1060767.9528270843,14537.171268901817,1075305.1240959861,1236,2,568.2093023255813,64,108,37,36.03659675110472,0.6150716145833333,42.51602564102563,8239.487179487156,128.7419871794868,8
1238,32,1,0,173,0.005780346820809248,0.0,1.0,173,5500,3600,1900,0.6545454545454545,74,36,38,250.58398786779588,0.436437189138325,0.7851843911395509,0.15274728303941226,1062718.4256055309,13160.04421376358,1075878.4698192945,1237,0,565.9190751445087,67,106,34,35.821346489142485,0.6156716417910448,42.27941176470586,8247.058823529369,123.09043020193089,0
1239,32,1,0,174,0.005747126436781609,0.0,1.0,174,5650,3900,1750,0.6902654867256637,74,39,35,254.09634228654147,0.43665980112063424,0.7905078782463972,0.15596529705030338,1064789.9017543274,13661.843867883981,1078451.7456222114,1238,0,563.6609195402299,71,103,34,35.47339137831118,0.616050469483568,42.028356481481474,8255.092592592575,116.268909754825,0
1240,32,0,1,173,0.0,0.005747126436781609,0.9942528735632183,174,4350,3000,1350,0.6896551724137931,57,30,27,255.3450578535555,0.43657121342989397,0.7931498365128082,0.15732550338719054,1065916.7275383484,15285.313692070398,1081202.0412304187,1239,1,564.6609195402299,73,101,36,35.301228912158216,0.6164383561643836,41.89189189189189,8259.459459459453,113.14328026656784,0
1241,32,0,1,172,0.0,0.005780346820809248,0.9942196531791907,173,5250,4000,1250,0.7619047619047619,65,40,25,253.34916873017252,0.4368054622037012,0.7902530557125453,0.15671238999896306,1067089.0,14219.22222222224,1081308.2222222222,1240,2,565.3699421965318,74,99,38,35.2072577175433,0.6173986486486487,41.75,8264.0,111.67567567567568,0
1242,32,0,1,171,0.0,0.005813953488372093,0.9941860465116279,172,5050,3400,1650,0.6732673267326733,67,34,33,250.390218522372,0.4359891370869033,0.7865716429107268,0.1552419354838709,1067777.7777777796,14022.22222222231,1081800.0000000019,1241,3,569.4593023255813,77,95,39,35.19825268817205,0.6168831168831168,41.66666666666667,8266.66666666668,107.35930735930754,0
1243,32,0,0,171,0.0,0.0,1.0,171,4600,3200,1400,0.6956521739130435,60,32,28,252.96721406211776,0.4352410847379888,0.7889883182304414,0.15775493098044618,1069500.694444443,15309.72222222214,1084810.4166666653,1242,4,573.5672514619883,59,112,38,34.91807681976901,0.6292372881355932,41.45833333333333,8273.333333333323,140.22598870056478,0
1244,32,2,0,173,0.011560693641618497,0.0,1.0,173,4550,3500,1050,0.7692307692307693,56,35,21,245.6455918557799,0.43609272079580585,0.7842524998600187,0.15411498103090704,1071278.9069281672,13480.988226996462,1084759.8951551637,1243,0,567.9248554913295,63,110,40,34.88724996854951,0.6286375661375662,41.24348958333333,8280.208333333323,131.43187830687813,0
1245,32,1,0,174,0.005747126436781609,0.0,1.0,174,6100,4600,1500,0.7540983606557377,76,46,30,244.18483430184307,0.43642864261510866,0.7849399859398349,0.15415193460444254,1073103.0282823949,11507.097029988714,1084610.1253123835,1244,0,565.6551724137931,67,107,36,34.699465672936675,0.6284203980099503,41.023284313725505,8287.254901960812,123.6903716710569,0
1246,32,0,0,174,0.0,0.0,1.0,174,5300,4200,1100,0.7924528301886793,64,42,22,245.25037259520653,0.43635389675104647,0.7868012608279185,0.15560713295695902,1074580.4403888148,12608.25067777577,1087188.6910665906,1245,1,566.6551724137931,70,104,37,34.48928611865941,0.6285714285714286,40.84507042253522,8292.957746478898,118.47082494969854,0
1247,32,1,2,173,0.005714285714285714,0.011428571428571429,0.9885714285714285,175,3350,2300,1050,0.6865671641791045,44,23,21,241.8939587245456,0.4365914066776136,0.7848772735299292,0.15408835638437654,1075741.2886259085,13693.063773833243,1089434.3523997418,1246,0,564.4114285714286,77,98,39,34.43294190358466,0.6266233766233766,40.70512820512822,8297.435897435933,107.75890775890822,0
1248,32,1,0,174,0.005747126436781609,0.0,1.0,174,4700,3400,1300,0.723404255319149,60,34,26,244.14175839588646,0.4362230914889376,0.7857647388776734,0.15575962664091256,1076190.1150173668,13048.589409722574,1089238.7044270893,1247,0,568.5229885057471,79,95,40,34.31925059410252,0.6263185654008439,40.651041666666686,8299.166666666712,105.05274261603432,0
1249,32,1,0,175,0.005714285714285714,0.0,1.0,175,5300,3600,1700,0.6792452830188679,70,36,34,241.33835162783458,0.4365804597701149,0.7824795342588449,0.15509052008315644,1078298.3567979543,11746.949598523883,1090045.306396478,1248,0,566.2685714285715,63,112,40,34.13192267502609,0.6372354497354498,40.39713541666664,8307.29166666662,131.86177248677174,0
1250,32,0,1,174,0.0,0.005714285714285714,0.9942857142857143,175,5350,4000,1350,0.7476635514018691,67,40,27,240.65791954039935,0.4366365626710454,0.7816008605639522,0.15485065974557283,1078668.6554898017,11568.030900722748,1090236.6863905245,1249,1,567.2685714285715,64,111,40,34.10394292885648,0.6370442708333333,40.352564102564074,8308.71794871789,129.82371794871702,0
1251,32,1,0,175,0.005714285714285714,0.0,1.0,175,6150,4700,1450,0.7642276422764228,76,47,29,236.79770083467082,0.43743979200875754,0.7767564606881459,0.153357246883672,1080545.1848351122,10024.123083385482,1090569.3079184976,1250,0,564.6685714285715,68,107,42,33.97307424189612,0.6369485294117647,40.12681159420288,8315.942028985457,122.29326513213907,0
1252,32,0,1,174,0.0,0.005714285714285714,0.9942857142857143,175,5100,3300,1800,0.6470588235294118,69,33,36,213.84136764966223,0.4375697865353038,0.7542974030867646,0.13141022450637785,1065138.6697530942,5454.141975309072,1070592.8117284032,1251,1,565.6685714285715,74,101,40,36.46870682385031,0.6150056306306306,41.986111111111136,8256.444444444505,111.5735735735744,8
1253,32,0,1,173,0.0,0.005747126436781609,0.9942528735632183,174,5650,4500,1150,0.7964601769911505,68,45,23,212.45707693657488,0.43686189179013574,0.7504128630173594,0.1310221541265053,1066192.1095914184,4854.011811326923,1071046.1214027454,1252,2,569.9022988505748,75,99,40,36.3741548971718,0.6158333333333333,41.858552631578966,8260.526315789519,110.14035087719358,0
1254,32,0,1,172,0.0,0.005780346820809248,0.9942196531791907,173,5500,3900,1600,0.7090909090909091,71,39,32,215.47673322801154,0.4364175852489134,0.7533593746541307,0.13325266246512843,1067014.9042398862,5883.377174242202,1072898.2814141284,1253,3,574.1676300578034,78,95,40,36.194472810824614,0.6155181623931624,41.75896624472575,8263.7130801688,105.94503948934359,0
1255,32,2,1,173,0.011494252873563218,0.005747126436781609,0.9942528735632183,174,4850,3700,1150,0.7628865979381443,60,37,23,215.47049437585767,0.43711104467034306,0.7539879097488293,0.13422165347333287,1069171.2059364154,6424.969663110081,1075596.1755995254,1254,0,571.816091954023,67,107,41,35.928209876543214,0.6236007462686567,41.49816176470587,8272.058823529385,123.46356453028933,0
1256,32,0,1,172,0.0,0.005780346820809248,0.9942196531791907,173,5200,3800,1400,0.7307692307692307,66,38,28,215.11531971271938,0.43663742886588697,0.7529269810921513,0.134403287468176,1070058.4060217184,6237.191224528771,1076295.597246247,1255,1,576.0578034682081,67,106,43,35.82785412470876,0.6246890547263682,41.390931372549005,8275.4901960784,123.51477904594626,0
1257,32,0,0,172,0.0,0.0,1.0,172,4500,3200,1300,0.7111111111111111,58,32,26,215.63193512252303,0.43631638446892423,0.752714105613993,0.13511094962320525,1070900.0246505132,7284.048927629371,1078184.0735781426,1256,2,576.8023255813954,68,104,42,35.71062126782208,0.6251531862745099,41.28925120772946,8278.743961352628,121.74623472577393,0
1258,32,0,0,172,0.0,0.0,1.0,172,4800,3400,1400,0.7083333333333334,62,34,28,215.2646708362666,0.4363943005122626,0.7513432626692258,0.13322528149167087,1067246.2938618714,6748.084429880008,1073994.3782917513,1257,3,577.8023255813954,80,92,37,36.17134724227785,0.6149739583333333,41.73096707818928,8264.609053497894,103.30761316872368,8
1259,32,0,0,172,0.0,0.0,1.0,172,4550,2900,1650,0.6373626373626373,62,29,33,218.3323975079139,0.4367442143796183,0.7550608401443051,0.13553714121682767,1068152.2067317767,7692.4464398234095,1075844.6531716,1258,4,578.8023255813954,68,104,37,35.98013438504238,0.6217830882352942,41.621376811594196,8268.115942028968,121.5899403239554,0
1260,32,1,2,171,0.005780346820809248,0.011560693641618497,0.9884393063583815,173,4750,3300,1450,0.6947368421052632,62,33,29,211.8612973076362,0.4366598333109289,0.7485633664260134,0.1322472810372605,1069784.0465430233,5979.167187923478,1075763.2137309469,1259,0,576.4508670520231,72,101,39,35.945863914794984,0.6216724537037037,41.424086757990864,8274.429223744282,114.92262810755948,0
1261,32,1,0,172,0.005813953488372093,0.0,1.0,172,4150,2500,1650,0.6024096385542169,58,25,33,209.25412115276356,0.4374780418423319,0.74459464245957,0.13138414492050593,1071504.7479912369,6293.356870384076,1077798.104861621,1260,0,576.75,73,99,36,35.80105889178996,0.6232876712328768,41.216216216216225,8281.0810810811,113.43946686412465,0
1262,32,0,0,172,0.0,0.0,1.0,172,4350,3000,1350,0.6896551724137931,57,30,27,205.3043406981697,0.4370750033999728,0.7393591949701026,0.12942412000930859,1072688.4741805992,5295.51999323473,1077983.9941738339,1261,1,577.75,78,94,42,35.75743494423794,0.6224626068376069,41.073312236286924,8285.654008438829,106.22633344152345,0
1263,32,1,0,173,0.005780346820809248,0.0,1.0,173,5300,3500,1800,0.660377358490566,71,35,36,218.38615072149247,0.43698189720840613,0.7607012067839918,0.12909187075599982,1053431.5982277668,6110.974357070412,1059542.5725848372,1262,0,575.4046242774566,66,107,36,37.80434541121345,0.6047979797979798,43.407960199004975,8210.945273631842,124.40826172169457,8
1264,32,1,1,173,0.005747126436781609,0.005747126436781609,0.9942528735632183,174,5000,3800,1200,0.76,62,38,24,215.38096316578086,0.4373525845458774,0.7577732117015918,0.1277769042825329,1054533.3900226778,5625.2834467121265,1060158.67346939,1263,0,573.0919540229885,69,105,39,37.74441610634516,0.6044685990338164,43.27380952380953,8215.238095238112,119.06142167011757,0
1265,32,3,1,175,0.017045454545454544,0.005681818181818182,0.9943181818181818,176,5600,3600,2000,0.6428571428571429,76,36,40,208.17744913797873,0.438590367965368,0.7525561273365917,0.12446926320834552,1056898.2253086416,3204.4753086419046,1060102.7006172833,1264,0,567.4545454545455,74,102,37,37.635661532919016,0.6048704954954955,42.98611111111111,8224.44444444444,111.14114114114108,0
1266,32,0,2,173,0.0,0.011428571428571429,0.9885714285714285,175,5300,3700,1600,0.6981132075471698,69,37,32,208.83641948332544,0.43804187192118227,0.7491731448763264,0.122615574094981,1051367.884898126,3612.780928376106,1054980.665826502,1265,1,571.6971428571428,68,107,45,38.30609540636043,0.6011029411764706,43.659420289855056,8202.8985507246,120.63086104006764,8
1267,32,2,0,175,0.011428571428571429,0.0,1.0,175,5000,3400,1600,0.68,66,34,32,208.39270114277699,0.4385207991242474,0.7473338893522388,0.12332815827748636,1053786.6215518757,3920.2880986628843,1057706.9096505386,1266,0,572.64,72,103,46,38.016634232230544,0.6019965277777778,43.364726027397225,8212.328767123208,114.06012176560012,0
1268,32,1,0,176,0.005681818181818182,0.0,1.0,176,5250,3800,1450,0.7238095238095238,67,38,29,206.17541880326067,0.4393668831168831,0.7444522141412009,0.1225994548434358,1055238.0570223436,3062.8296687437464,1058300.8866910874,1267,0,570.3806818181819,75,101,47,37.89321707494975,0.6023611111111111,43.188048245614006,8217.982456140277,109.57309941520369,0
1269,32,0,1,175,0.0,0.005681818181818182,0.9943181818181818,176,5650,4200,1450,0.7433628318584071,71,42,29,213.34451433513073,0.4391531385281385,0.7500823879877734,0.12736462303202678,1056436.968665527,4227.006401124589,1060663.9750666516,1268,1,571.3806818181819,77,99,43,37.560147168373064,0.6029491341991342,43.04220085470083,8222.649572649514,106.78765678765603,0
1270,32,0,1,174,0.0,0.005714285714285714,0.9942857142857143,175,4900,3600,1300,0.7346938775510204,62,36,26,216.40133914024236,0.43862753147235906,0.7542257482763495,0.12956483288057527,1057315.6394961204,5860.904056176054,1063176.5435522965,1269,2,575.6228571428571,77,98,43,37.37245008398703,0.6040313852813852,42.93536324786322,8226.068376068313,106.83205683205601,0
1271,32,1,0,175,0.005714285714285714,0.0,1.0,175,5200,3800,1400,0.7307692307692307,66,38,28,214.3087898911669,0.4384510125889436,0.7506474008014918,0.1288397974381329,1058556.5800779876,5171.595941568823,1063728.1760195564,1270,0,575.48,81,94,44,37.27219972342943,0.6039094650205761,42.78455284552843,8230.894308943025,101.6159791227534,0
1272,32,0,2,173,0.0,0.011428571428571429,0.9885714285714285,175,5150,3500,1650,0.6796116504854369,68,35,33,214.15289912286133,0.43809113300492614,0.7488329776288816,0.12928432835656511,1059814.7384719865,5242.479755382811,1065057.2182273692,1271,1,576.48,67,108,44,37.120124298156846,0.6120957711442786,42.63174019607845,8235.784313725526,122.92215393620188,0
1273,32,4,1,176,0.022598870056497175,0.005649717514124294,0.9943502824858758,177,5350,4000,1350,0.7476635514018691,67,40,27,208.37169876058775,0.4397015707926725,0.7455550039617758,0.1270132045668238,1062711.5032265845,3537.8002439484385,1066249.3034705329,1272,0,569.2090395480226,72,105,45,36.910100954173835,0.6129918981481481,42.280251141552526,8247.031963470356,114.54211060375494,0
1274,32,2,2,176,0.011235955056179775,0.011235955056179775,0.9887640449438202,178,4700,3000,1700,0.6382978723404256,64,30,34,208.4466466924942,0.44089750100509956,0.7434248756467452,0.11987109901576701,1044975.148633844,3264.313121943503,1048239.4617557875,1273,0,565.876404494382,76,102,38,39.11287120851199,0.5892269736842105,44.4399350649351,8177.92207792216,107.60423786739683,8
1275,32,3,2,177,0.01675977653631285,0.0111731843575419,0.9888268156424581,179,5300,3900,1400,0.7358490566037735,67,39,28,209.69251986092345,0.44267727491473646,0.7453452172800541,0.121547434078678,1047424.3164062606,2827.408854167234,1050251.725260428,1274,0,557.1843575418994,79,100,33,38.7754452926209,0.5909810126582278,44.140625000000036,8187.500000000084,103.63924050633017,0
1276,32,2,2,177,0.0111731843575419,0.0111731843575419,0.9888268156424581,179,4000,2700,1300,0.675,53,27,26,211.41283974663526,0.4422418031929362,0.7472414312256355,0.1228658006361406,1048230.5325244669,4521.878718025461,1052752.4112424923,1275,0,558.1731843575419,81,98,35,38.6308977285887,0.5911779835390947,44.042174796748,8190.650406504148,101.11914082103887,0
1277,32,1,0,178,0.0056179775280898875,0.0,1.0,178,5100,3100,2000,0.6078431372549019,71,31,40,216.6975223556496,0.44214527920607716,0.7527428885103606,0.12646097567706283,1049506.746130171,4785.1023163897935,1054291.8484465608,1276,0,562.3033707865169,83,95,36,38.33649066318052,0.5919929718875502,43.88640873015875,8195.634920634968,98.74258940524058,0
1278,32,2,2,178,0.011111111111111112,0.011111111111111112,0.9888888888888889,180,5650,3800,1850,0.672566371681416,75,38,37,213.7719144645452,0.44338273329195116,0.7546662935076354,0.12572294721025676,1051878.1512345653,3322.4012345677465,1055200.552469133,1277,0,557.0444444444445,74,106,36,38.11605095426397,0.5986768018018018,43.597222222222214,8204.888888888869,110.87687687687661,0
1279,32,3,1,180,0.016574585635359115,0.0055248618784530384,0.994475138121547,181,5500,3800,1700,0.6909090909090909,72,38,34,204.69123510074147,0.44482172089216293,0.7469209821478606,0.12158166133092205,1054900.1736111082,1485.7638888887127,1056385.937499997,1278,0,550.060773480663,79,102,42,37.97329276538199,0.600210970464135,43.22916666666666,8216.666666666642,104.0084388185651,0
1280,32,2,3,179,0.01098901098901099,0.016483516483516484,0.9835164835164835,182,5850,4700,1150,0.8034188034188035,70,47,23,201.66104799435817,0.44659932608827635,0.7428152024125732,0.12030704556327347,1056228.7166402468,350.0379838818353,1056578.7546241286,1279,0,544.5604395604396,86,96,36,37.8862015937369,0.5992005813953488,43.067528735632195,8221.8390804598,95.60278000534652,0
1281,32,0,0,179,0.0,0.0,1.0,179,4750,3000,1750,0.631578947368421,65,30,35,192.64324349544918,0.4448324022346369,0.7348834433076703,0.11185828510791987,1047957.4245876833,-173.61653645779825,1047783.8080512255,1280,2,554.2625698324023,79,100,39,39.14530865767831,0.5916402953586498,44.075520833333364,8189.58333333341,103.66561181434696,8
1282,32,2,0,181,0.011049723756906077,0.0,1.0,181,5500,3400,2100,0.6181818181818182,76,34,42,193.23619741748192,0.44578985062410476,0.7396703696987872,0.11295623560414181,1050014.9695294865,-1119.8200113375106,1048895.149518149,1281,0,549.1270718232045,83,98,42,38.87416497240784,0.5926204819277108,43.82440476190479,8197.619047619111,98.76649454962785,0
1283,32,1,2,180,0.005494505494505495,0.01098901098901099,0.989010989010989,182,4700,3700,1000,0.7872340425531915,57,37,20,189.1538048128098,0.4461971040009714,0.7355636454933476,0.11095723189534905,1051086.7624381117,-1336.587939290679,1049750.1744988211,1282,0,547.1043956043956,73,109,44,38.84556239015818,0.5981735159817352,43.69369369369369,8201.801801801786,112.3534493397505,0
1284,32,2,2,180,0.01098901098901099,0.01098901098901099,0.989010989010989,182,5500,4000,1500,0.7272727272727273,70,40,30,186.4463751654217,0.4456974885151681,0.729939677149172,0.10998961837154257,1052816.312367597,-2641.242968807012,1050175.06939879,1283,0,547.9505494505495,77,105,45,38.70023774816046,0.5984848484848485,43.48290598290599,8208.547008547028,106.60450660450685,0
1285,32,0,0,180,0.0,0.0,1.0,180,5150,3300,1850,0.6407766990291263,70,33,37,185.55619477891457,0.4448123577488103,0.7266386721952829,0.10987428612189651,1053955.5574295823,-2036.4034594553927,1051919.153970127,1284,1,554.7333333333333,76,104,45,38.58174766322302,0.600328947368421,43.34415584415584,8212.987012987005,108.06561859193428,0
1286,32,7,2,185,0.0374331550802139,0.0106951871657754,0.9893048128342246,187,5200,3700,1500,0.7115384615384616,67,37,30,204.32301404671534,0.44760819772679356,0.7543106060391171,0.12263520527602709,1058061.2269502706,637.251787288968,1058698.4787375596,1285,0,534.9304812834224,83,104,40,37.59046832553729,0.602535140562249,42.84474206349206,8228.96825396825,99.14419583094278,8
1287,32,2,2,185,0.0106951871657754,0.0106951871657754,0.9893048128342246,187,5350,3700,1650,0.6915887850467289,70,37,33,223.56632181139625,0.4480142985835585,0.7794470521923242,0.12891030506898185,1045802.6478155855,4011.25026254996,1049813.8980781354,1286,0,535.9197860962566,68,119,42,38.623043991733105,0.5942095588235294,44.33876811594203,8181.15942028986,120.31116794543911,7
1288,32,6,2,189,0.031413612565445025,0.010471204188481676,0.9895287958115183,191,5400,3200,2200,0.5925925925925926,76,32,44,207.83061841023994,0.45016648296133005,0.7676757943529677,0.12150647759480124,1050063.1233889284,47.053660741862586,1050110.1770496701,1287,0,525.3455497382199,75,116,40,38.49429538280454,0.5959722222222222,43.81853070175439,8197.807017543868,109.30409356725157,0
1289,32,2,1,190,0.010471204188481676,0.005235602094240838,0.9947643979057592,191,5650,3900,1750,0.6902654867256637,74,39,35,203.61667700229893,0.449878295214476,0.7634583436322653,0.11968386917642654,1051708.0254413763,-1020.9413365956934,1050687.0841047806,1288,0,526.3350785340314,70,121,40,38.39759179780638,0.6004464285714286,43.61795774647886,8204.22535211264,117.20321931589486,0
1290,32,1,0,191,0.005235602094240838,0.0,1.0,191,4850,3400,1450,0.7010309278350515,63,34,29,205.05080553516748,0.44985648020575003,0.7647933862154972,0.12102440518421594,1052966.4857905312,132.32522257625988,1053098.8110131074,1289,0,527.303664921466,72,119,42,38.204333073756814,0.6009837962962963,43.464611872146094,8209.132420091268,114.01572805682316,0
1291,32,2,0,193,0.010362694300518135,0.0,1.0,193,6450,5300,1150,0.8217054263565892,76,53,23,204.6202626824673,0.45069961679620035,0.7671131139594993,0.12176497625934396,1055463.3426871689,-1856.162713527423,1053607.1799736414,1290,0,522.8290155440415,75,118,43,37.90518215130651,0.602638888888889,43.16063596491227,8218.859649122774,109.58479532163699,0
1292,32,1,0,194,0.005154639175257732,0.0,1.0,194,6250,4400,1850,0.704,81,44,37,203.15565384638236,0.4510910207788046,0.767210751096912,0.12128197132045372,1056436.968665529,-2125.771376653078,1054311.197288876,1291,0,521.1288659793814,77,117,37,37.82195788507179,0.6029491341991342,43.04220085470084,8222.64957264953,106.78765678765625,0
1293,32,2,2,194,0.01020408163265306,0.01020408163265306,0.9897959183673469,196,5500,4000,1500,0.7272727272727273,70,40,30,203.80454199055188,0.4521939865689866,0.7706097253716326,0.12260968435260362,1058765.708655552,-1543.7479344310223,1057221.960721121,1292,0,516.8010204081633,81,115,42,37.51646090534978,0.6041666666666667,42.759146341463385,8231.707317073091,101.62601626016162,0
1294,32,0,3,191,0.0,0.015463917525773196,0.9845360824742269,194,6450,4700,1750,0.7286821705426356,82,47,35,204.0854062430287,0.45179600003561066,0.7694460032800041,0.12320283306059346,1059805.59639665,-1991.8288641508625,1057813.767532499,1293,1,522.9175257731958,68,126,41,37.38036231033943,0.6115196078431373,42.632850241545896,8235.74879227054,121.11395282750794,0
1295,32,2,0,193,0.010362694300518135,0.0,1.0,193,4950,3500,1450,0.7070707070707071,64,35,29,202.05850491697285,0.45104706390328153,0.766674178467825,0.12287456605646532,1062003.8584183725,-632.6176303852003,1061371.2407879874,1294,0,525.9119170984455,69,124,46,37.1603587862685,0.613677536231884,42.366071428571445,8244.285714285754,119.48240165631528,0
1296,32,0,0,193,0.0,0.0,1.0,193,5300,3900,1400,0.7358490566037735,67,39,28,203.80794709930507,0.45101108232584913,0.7685214318271805,0.1244981973042446,1063353.7981859464,-556.0090702944849,1062797.789115652,1295,1,526.9119170984455,69,124,44,36.94826060186254,0.6153381642512077,42.20238095238097,8249.523809523851,119.55831608005582,0
1297,32,2,1,194,0.010256410256410256,0.005128205128205128,0.9948717948717949,195,6150,4300,1850,0.6991869918699187,80,43,37,204.3530539712848,0.45133822363203807,0.7725276547966873,0.12584724845688253,1065773.392052922,-1591.1904985298866,1064182.201554392,1296,0,522.4974358974359,72,123,41,36.63508320893461,0.6167534722222222,41.90924657534248,8258.904109589072,114.70700152207044,0
1298,32,1,0,195,0.005128205128205128,0.0,1.0,195,5600,4000,1600,0.7142857142857143,72,40,32,202.62069161221305,0.45126222574676184,0.7709404504825594,0.12528063996043343,1066963.3685628236,-1362.2288673806506,1065601.139695443,1297,0,523.4923076923077,73,122,44,36.532831380030906,0.617722602739726,41.765202702702716,8263.513513513544,113.19881525361019,0
1299,32,0,2,193,0.0,0.010256410256410256,0.9897435897435898,195,5750,4200,1550,0.7304347826086957,73,42,31,202.2632674297605,0.4509152788791964,0.7710090984284528,0.12540322580645166,1067777.7777777794,-1555.5555555554702,1066222.2222222239,1298,1,524.4923076923077,75,120,44,36.44153225806452,0.6177777777777778,41.66666666666667,8266.666666666679,110.22222222222238,0
1300,32,0,3,190,0.0,0.015544041450777202,0.9844559585492227,193,5600,3400,2200,0.6071428571428571,78,34,44,200.7290914850883,0.4505680591537133,0.7673011432368009,0.12509247222682207,1069297.926278351,-1272.159746251626,1068025.7665320996,1299,2,529.419689119171,67,126,43,36.293651734218216,0.6237562189054726,41.48284313725489,8272.549019607817,123.47088088966892,0
1301,32,0,1,189,0.0,0.005263157894736842,0.9947368421052631,190,6400,5100,1300,0.796875,77,51,26,217.4965736443256,0.44942100621925185,0.7797850087703664,0.13308323606524658,1063855.7323205017,1876.9953263167754,1065732.7276468184,1300,3,538.5315789473684,67,123,41,36.53321105368423,0.617070895522388,42.14154411764706,8251.470588235294,123.15627743634766,8
1302,32,2,1,190,0.010471204188481676,0.005235602094240838,0.9947643979057592,191,5300,3600,1700,0.6792452830188679,70,36,34,218.99643264566052,0.4493191420960779,0.7819288234785104,0.13507891111464881,1066244.842814997,3200.763380663556,1069445.6061956605,1301,0,536.6544502617801,72,119,36,36.19882354025022,0.6173321759259259,41.852168949771695,8260.730593607317,114.73236935565718,0
1303,32,0,0,190,0.0,0.0,1.0,190,5850,3700,2150,0.6324786324786325,80,37,43,219.09734387179566,0.44850610322101553,0.7814054981536052,0.13536216162480144,1066730.7372828934,2893.57423301691,1069624.3115159103,1302,1,540.478947368421,73,117,37,36.136116865652674,0.6174372146118721,41.793355855855864,8262.612612612631,113.18647414537851,0
1304,32,0,1,189,0.0,0.005263157894736842,0.9947368421052631,190,5650,3800,1850,0.672566371681416,75,38,37,220.1328206044444,0.44835584331198364,0.7827241930244426,0.13685469559739152,1068585.2220323398,3396.1357964412864,1071981.357828781,1303,2,541.478947368421,63,127,40,35.88009614980895,0.6253306878306879,41.569010416666686,8269.791666666704,131.26653439153498,0
1305,32,0,1,188,0.0,0.005291005291005291,0.9947089947089947,189,6250,4600,1650,0.736,79,46,33,216.05417061469595,0.4476164677849075,0.7777719656152451,0.13502149655577506,1070127.5539485812,2191.104224058989,1072318.6581726403,1304,3,545.2275132275132,65,124,42,35.79503844745513,0.6259615384615385,41.38257575757577,8275.75757575761,127.31934731934786,0
1306,32,0,0,188,0.0,0.0,1.0,188,5300,3800,1500,0.7169811320754716,68,38,30,215.02247671011412,0.44698984526112184,0.7747693235725603,0.1350152122990766,1071525.0210039956,3180.3927746274635,1074705.413778623,1305,4,549.0372340425532,68,120,42,35.649282464123225,0.6259191176470589,41.213768115942045,8281.159420289892,121.78175618073371,0
1307,32,0,0,188,0.0,0.0,1.0,188,3900,2200,1700,0.5641025641025641,56,22,34,215.80129475492092,0.446977400728183,0.7741685008559549,0.13604864234549402,1072704.0816326565,4798.18594104329,1077502.2675736998,1306,5,550.0372340425532,69,119,44,35.48371647509581,0.6268115942028986,41.071428571428584,8285.714285714312,120.08281573499002,0
1308,32,1,0,189,0.005291005291005291,0.0,1.0,189,4250,2600,1650,0.611764705882353,59,26,33,218.07336326166617,0.4469797178130512,0.7780722969154654,0.13826237201344116,1074365.8405403406,4808.114444015948,1079173.9549843566,1307,0,548.1216931216932,71,118,36,35.220034708652015,0.627787558685446,40.87094907407408,8292.129629629651,116.79055816379791,0
1309,32,0,0,189,0.0,0.0,1.0,189,5550,3600,1950,0.6486486486486487,75,36,39,220.8989384882011,0.44686245262486396,0.7813939120848585,0.14075710517319853,1075829.9382716052,4179.938271604924,1080009.8765432101,1308,1,549.1216931216932,74,115,38,34.96641224781288,0.6280968468468469,40.69444444444444,8297.77777777778,112.13213213213216,0
1310,32,0,0,189,0.0,0.0,1.0,189,5200,3300,1900,0.6346153846153846,71,33,38,221.45277752394898,0.44672290705092127,0.7822043221716963,0.14152022326289806,1076676.4492458703,4686.598036023925,1081363.0472818944,1309,2,550.1216931216932,63,126,39,34.847795624712425,0.6352513227513228,40.59244791666664,8301.041666666617,131.76256613756536,0
1311,32,0,0,189,0.0,0.0,1.0,189,5750,4100,1650,0.7130434782608696,74,41,33,217.19480088595822,0.44640277308717025,0.7777790455399185,0.13934857824712424,1077826.183139027,3269.6486473104683,1081095.8317863375,1310,3,551.1216931216932,66,123,39,34.81677548819936,0.6347853535353536,40.45398009950247,8305.472636815888,125.84049449721043,0
1312,32,0,1,188,0.0,0.005291005291005291,0.9947089947089947,189,6100,4100,2000,0.6721311475409836,81,41,40,215.70836216786316,0.44629371646215615,0.7756244358842999,0.13882641065762882,1078730.2642570676,2638.2277047594403,1081368.491961827,1311,4,552.1216931216932,66,123,41,34.74417699538945,0.6358901515151515,40.34514925373132,8308.955223880555,125.8932609678872,0
1313,32,0,1,187,0.0,0.005319148936170213,0.9946808510638298,188,5950,4500,1450,0.7563025210084033,74,45,29,213.36547291322728,0.44554864982743586,0.7724184748510543,0.13766457224949302,1079459.8832179913,2513.8936947326993,1081973.7769127241,1312,5,555.9468085106383,67,121,39,34.71534166863254,0.6361940298507462,40.257352941176464,8311.764705882339,124.0561896400349,0
1314,32,0,0,187,0.0,0.0,1.0,187,5800,3900,1900,0.6724137931034483,77,39,38,214.42475026790595,0.4449883081287256,0.7660643066399453,0.13132153546566866,1064124.1353651981,2434.910395947022,1066559.0457611452,1313,6,559.7272727272727,72,115,44,36.57919732934952,0.6147280092592593,42.1090182648402,8252.511415525158,114.61821410451608,8
1315,32,0,0,187,0.0,0.0,1.0,187,4800,3000,1800,0.625,66,30,36,215.0228075417295,0.44494158856113314,0.7660570987498876,0.13233980745057622,1065597.4104938332,3625.5493827164005,1069222.9598765497,1314,7,560.7272727272727,74,113,40,36.381473907037716,0.6155686936936937,41.93055555555558,8258.22222222227,111.59759759759824,0
1316,32,1,0,188,0.005319148936170213,0.0,1.0,188,5300,3900,1400,0.7358490566037735,67,39,28,215.00555928355737,0.44511664675541396,0.7655985465778232,0.13315473974073988,1067446.6068787044,3001.3909434585303,1070447.997822163,1315,0,558.7393617021277,77,111,41,36.153281888216746,0.6164772727272727,41.70673076923079,8265.384615384663,107.34265734265796,0
1317,32,1,0,189,0.005291005291005291,0.0,1.0,189,5650,3900,1750,0.6902654867256637,74,39,35,210.44529609535329,0.4453638035198319,0.7618745631167987,0.13126938521885026,1069572.512779707,1567.3008294753045,1071139.8136091824,1316,0,556.7777777777778,71,118,41,36.008582340104084,0.621919014084507,41.44965277777778,8273.611111111113,116.52973395931146,0
1318,32,0,1,188,0.0,0.005291005291005291,0.9947089947089947,189,5150,4100,1050,0.7961165048543689,62,41,21,209.8451748654574,0.44541188224698863,0.7612939693284022,0.13104115296043495,1069902.1209941423,1952.7595337879293,1071854.88052793,1317,1,557.7777777777778,72,117,41,35.983427141963745,0.6218171296296297,41.40981735159818,8274.885844748867,114.92897006595649,0
1319,32,0,0,188,0.0,0.0,1.0,188,5750,4500,1250,0.782608695652174,70,45,25,211.17257551865214,0.4455356126976903,0.7606313500343906,0.13206551744655326,1070339.372311507,1855.2643860079916,1072194.636697515,1318,2,559.7872340425532,73,115,42,35.895150756503746,0.6218607305936072,41.356981981982,8276.576576576626,113.37776132296749,0
1320,32,1,0,189,0.005291005291005291,0.0,1.0,189,6150,4700,1450,0.7642276422764228,76,47,29,207.81857911962828,0.4456898007429922,0.758315907229242,0.130613801750229,1071800.0771604984,597.9938271607734,1072398.070987659,1319,0,557.8201058201058,74,115,41,35.80180663625796,0.623170045045045,41.18055555555557,8282.222222222257,111.92192192192239,0
1321,32,0,1,188,0.0,0.005291005291005291,0.9947089947089947,189,5300,3400,1900,0.6415094339622641,72,34,38,207.44846775119052,0.4453966377725243,0.7580525313837463,0.13076106120412948,1072655.411400629,1404.1443040169306,1074059.5557046458,1320,1,558.8201058201058,75,114,46,35.705990948070514,0.62375,41.077302631578966,8285.526315789519,110.47368421052691,0
1322,32,1,1,188,0.005291005291005291,0.005291005291005291,0.9947089947089947,189,5100,3700,1400,0.7254901960784313,65,37,28,219.31029333349096,0.44564641262336296,0.767800884202998,0.13923653506986844,1074765.261977255,4241.416973775968,1079006.678951031,1321,0,558.4497354497355,78,111,38,35.13876170126172,0.625,40.822784810126606,8293.670886076012,106.32911392405143,0
1323,32,0,0,188,0.0,0.0,1.0,188,5150,3400,1750,0.6601941747572816,69,34,35,219.5292098149656,0.44473323662153447,0.7677997864321071,0.13990477201987955,1075872.6227370547,4487.093346204266,1080359.716083259,1322,1,562.4095744680851,80,108,40,34.996673113800185,0.6255208333333333,40.68930041152265,8297.94238683132,103.72427983539151,0
1324,32,1,1,188,0.005291005291005291,0.005291005291005291,0.9947089947089947,189,5400,3900,1500,0.7222222222222222,69,39,30,219.2600080695483,0.4449322676273031,0.770422964980547,0.14054043877057182,1077550.8555903973,4052.7618584198017,1081603.617448817,1323,0,560.4285714285714,67,122,39,34.7970530074966,0.6338619402985075,40.487132352941174,8304.411764705877,123.94644424934145,0
1325,32,0,0,188,0.0,0.0,1.0,188,5250,3900,1350,0.7428571428571429,66,39,27,217.18712817739348,0.4447907185117761,0.7673954725383478,0.13980608550341167,1078788.3031109222,4009.7866928048525,1082798.089803727,1324,1,563.0957446808511,68,120,41,34.69864341085272,0.6348039215686274,40.33816425120772,8309.178743961336,122.19380505825495,0
1326,32,0,0,188,0.0,0.0,1.0,188,5700,4000,1700,0.7017543859649122,74,40,34,217.91981484187585,0.44416908446163766,0.7681061943287248,0.14077731344053612,1079818.5744946988,3762.7727633405725,1083581.3472580393,1325,2,564.0957446808511,70,118,42,34.55295457540331,0.6349702380952381,40.21420187793427,8313.145539906101,118.75922199865859,0
1327,32,1,3,186,0.005291005291005291,0.015873015873015872,0.9841269841269842,189,6100,4000,2100,0.6557377049180327,82,40,42,216.50448083238936,0.4440691958422455,0.765300772779006,0.14078431349993603,1081715.5586419743,2939.2530864196688,1084654.8117283941,1326,0,562.1058201058202,74,115,37,34.35669390880117,0.6352759009009009,39.98611111111111,8320.444444444436,112.43843843843833,0
1328,32,2,2,186,0.010638297872340425,0.010638297872340425,0.9893617021276596,188,5500,3900,1600,0.7090909090909091,71,39,32,205.96453952269604,0.4442366404975917,0.7623293473656776,0.12760421661130994,1067559.7860919735,875.8919510762989,1068435.6780430498,1327,0,565.1595744680851,78,110,41,36.37283052577848,0.6161858974358974,41.69303797468355,8265.822784810134,105.9720869847453,8
1329,32,1,0,187,0.0053475935828877,0.0,1.0,187,4900,3600,1300,0.7346938775510204,62,36,26,204.7303505173594,0.44441449600368005,0.7602346669731603,0.1274688386021175,1069026.1295479483,1472.4188429135793,1070498.5483908618,1328,0,564.5454545454545,68,119,43,36.223742358758706,0.6228553921568627,41.51570048309179,8271.49758454107,121.6396703608981,0
1330,32,1,1,187,0.005319148936170213,0.005319148936170213,0.9946808510638298,188,5250,3200,2050,0.6095238095238096,73,32,41,203.67681389389327,0.4448932377593204,0.7607999961385479,0.1275294596085628,1070690.5596332306,764.9683704732752,1071455.5280037038,1329,0,562.5372340425532,70,118,45,36.045731246218956,0.6238095238095238,41.31455399061033,8277.934272300476,118.2562038900068,0
1331,32,0,1,186,0.0,0.0053475935828877,0.9946524064171123,187,5400,3600,1800,0.6666666666666666,72,36,36,205.0657904885308,0.44465408352979513,0.7616125237973979,0.12882338120433376,1071662.3685776654,1152.2581498381733,1072814.6267275035,1330,1,566.3101604278074,70,117,43,35.890022675736994,0.625,41.19718309859156,8281.690140845089,118.30985915492984,0
1332,32,0,0,186,0.0,0.0,1.0,186,4200,2900,1300,0.6904761904761905,55,29,26,203.49367911315323,0.44444807710936746,0.7582913438901782,0.12822402329319071,1072554.1282414203,2251.5971207696775,1074805.72536219,1331,2,568.5591397849462,73,113,46,35.82086255640732,0.6245719178082192,41.08952702702704,8285.13513513516,113.49500185116658,0
1333,32,0,0,186,0.0,0.0,1.0,186,4700,3500,1200,0.7446808510638298,59,35,24,203.95395260838868,0.4444492879976751,0.7590288565727692,0.12876955456723202,1073137.3391973071,1874.1204041880455,1075011.4596014952,1332,3,569.5591397849462,73,113,36,35.73712722397364,0.625285388127854,41.01914414414415,8287.3873873874,113.52585462174521,0
1334,32,1,0,187,0.0053475935828877,0.0,1.0,187,6550,4500,2050,0.6870229007633588,86,45,41,205.3361278097007,0.44469002165871235,0.763044354069218,0.13064019029668647,1075382.644780125,212.98163858110547,1075595.626418706,1333,0,567.5080213903743,75,112,39,35.424982377302,0.6270833333333333,40.7483552631579,8296.05263157895,110.61403508771933,0
1335,32,0,1,186,0.0,0.0053475935828877,0.9946524064171123,187,5450,4100,1350,0.7522935779816514,68,41,27,209.19017435202628,0.443847871504418,0.765972982840452,0.13355988054783238,1076406.250000002,2184.7222222223486,1078590.9722222243,1334,1,568.5080213903743,76,111,39,35.19912985274432,0.6278782894736843,40.62500000000001,8300.000000000016,109.21052631578969,0
1336,32,0,1,185,0.0,0.005376344086021506,0.9946236559139785,186,5550,3900,1650,0.7027027027027027,72,39,33,207.4815291782524,0.44299622202848005,0.7625928276506038,0.13296859739510627,1077502.4796667343,1962.3724349226036,1079464.8521016568,1335,2,572.5376344086021,70,116,39,35.1086659505503,0.6321428571428571,40.49295774647888,8304.225352112688,118.63179074446697,0
1337,32,0,0,185,0.0,0.0,1.0,185,5250,4000,1250,0.7619047619047619,65,40,25,213.0668244747663,0.4426153055229142,0.767351921450282,0.13696255784033784,1078383.3475056682,3703.543083900193,1082086.8905895683,1336,3,576.5675675675676,69,116,42,34.855410982460164,0.633756038647343,40.38690476190476,8307.619047619042,120.40027605244988,0
1338,32,1,1,185,0.005376344086021506,0.005376344086021506,0.9946236559139785,186,5650,3700,1950,0.6548672566371682,76,37,39,210.35405424839666,0.4427528334786399,0.7659092596717902,0.13586753230518725,1079771.1441186545,2576.847565157652,1082347.991683812,1337,0,574.4623655913979,71,115,43,34.75532783841986,0.6343896713615024,40.219907407407405,8312.962962962954,117.08398539384443,0
1339,32,1,0,186,0.005376344086021506,0.0,1.0,186,4950,3400,1550,0.6868686868686869,65,34,31,209.2709215942707,0.4432771481158578,0.7657296780534435,0.1312482920781139,1071176.4090017425,2683.2148603672217,1073859.6238621096,1338,0,575.2258064516129,70,116,37,35.84110625992289,0.6244047619047619,41.25586854460094,8279.81220657278,118.28303152246829,8
1340,32,2,2,186,0.010638297872340425,0.010638297872340425,0.9893617021276596,188,5800,4100,1700,0.7068965517241379,75,41,34,204.69600836435745,0.4439231567868927,0.7623116931131197,0.1292065596466424,1073065.7901234592,530.4567901236005,1073596.2469135828,1339,0,570.0957446808511,74,114,36,35.72671976116416,0.6247184684684685,41.027777777777786,8287.11111111113,111.98798798798823,0
1341,32,1,0,187,0.0053475935828877,0.0,1.0,187,4700,3500,1200,0.7446808510638298,59,35,24,206.09725371630128,0.44284160389473487,0.7636476812947399,0.13036272072416655,1073677.718144045,2156.4058171745323,1075834.1239612196,1340,0,574.1390374331551,75,112,38,35.61507936507938,0.625,40.953947368421055,8289.47368421053,110.52631578947374,0
1342,32,0,0,187,0.0,0.0,1.0,187,6000,4300,1700,0.7166666666666667,77,43,34,206.00369575084153,0.4426990493166964,0.7640965073573016,0.13071920501818068,1074610.462814604,874.7453664661725,1075485.2081810702,1341,1,575.1390374331551,76,111,39,35.502688312366224,0.6256853070175439,40.84145021645022,8293.073593073605,109.11938938254742,0
1343,32,0,0,187,0.0,0.0,1.0,187,4950,3600,1350,0.7272727272727273,63,36,27,205.2146894882791,0.442516962796849,0.7626464372633612,0.13043374007921385,1075093.3594375914,1774.9899855793315,1076868.3494231708,1342,2,576.1390374331551,78,109,39,35.46371890737064,0.625400641025641,40.78322784810127,8294.936708860769,106.3453424212919,0
1344,32,3,0,190,0.015789473684210527,0.0,1.0,190,4700,3300,1400,0.7021276595744681,61,33,28,201.44427026344638,0.4434842894272719,0.7630854659584743,0.12916132622773854,1077641.7233560027,716.9501133783174,1078358.673469381,1343,0,568.0263157894736,69,121,41,35.24823203363911,0.6328502415458936,40.47619047619045,8304.761904761855,120.35886818495443,0
1345,32,1,1,190,0.005235602094240838,0.005235602094240838,0.9947643979057592,191,4200,2600,1600,0.6190476190476191,58,26,32,216.2341989543822,0.44402957655919906,0.7815390207848325,0.13360564362419144,1066758.2844000054,3733.924621037136,1070492.2090210426,1344,0,566.0471204188482,75,116,39,36.20663915282128,0.6165277777777778,41.790021929824555,8262.719298245596,110.16959064327462,8
1346,32,1,0,191,0.005235602094240838,0.0,1.0,191,5350,3800,1550,0.7102803738317757,69,38,31,215.9209157127987,0.44404565077615504,0.7809913865901019,0.13387096774193552,1067777.7777777798,2561.1111111111913,1070338.888888891,1345,0,564.8848167539267,76,115,41,36.088709677419345,0.6173245614035088,41.66666666666667,8266.666666666682,108.77192982456161,0
1347,32,0,0,191,0.0,0.0,1.0,191,5200,3600,1600,0.6923076923076923,68,36,32,215.8552831135628,0.443783870671443,0.7811009343260609,0.1343026639919345,1068821.803897565,2742.166615651722,1071563.9705132167,1346,1,565.8848167539267,65,126,41,35.96141711447648,0.6243589743589744,41.540404040404056,8270.707070707098,127.24164724164766,0
1348,32,1,0,192,0.005208333333333333,0.0,1.0,192,5600,4100,1500,0.7321428571428571,71,41,30,212.82990049639463,0.4442649251018034,0.7789864731437592,0.132861269244791,1069804.882737411,1537.2933487121527,1071342.176086123,1347,0,563.9322916666666,67,125,43,35.91824644549762,0.6243781094527363,41.42156862745099,8274.509803921586,123.50014632718785,0
1349,32,1,0,193,0.0051813471502590676,0.0,1.0,193,4900,3400,1500,0.6938775510204082,64,34,30,212.66352243622111,0.4445254029936672,0.7786019981388399,0.1333546435921945,1071129.1688100162,2058.0204046640774,1073187.1892146803,1348,0,562.0051813471503,71,122,40,35.759151569372996,0.6238262910798122,41.26157407407408,8279.62962962965,116.61450182576971,0
1350,32,0,0,193,0.0,0.0,1.0,193,6050,4400,1650,0.7272727272727273,77,44,33,211.707568704793,0.444022785333909,0.7773962374271086,0.13348316684215367,1072737.8625341451,771.3449469362031,1073509.2074810814,1349,1,563.0051813471503,72,121,44,35.58555145302912,0.6252893518518519,41.06735159817352,8285.844748858468,115.08117706747872,0
1351,32,0,0,193,0.0,0.0,1.0,193,5100,3500,1600,0.6862745098039216,67,35,32,210.05907372400694,0.44383163320379965,0.7758797026357274,0.13272963449593886,1073370.667965266,1394.2496550606515,1074764.9176203266,1350,2,564.0051813471503,73,120,39,35.550271739130416,0.6255707762557078,40.990990990991,8288.288288288315,113.53819572997692,0
1352,32,0,0,193,0.0,0.0,1.0,193,5800,4200,1600,0.7241379310344828,74,42,32,200.13325235151603,0.4434785639752447,0.7649130214019064,0.12484772765277091,1069597.801499927,-1587.5826555575009,1068010.2188443695,1351,3,565.0051813471503,70,123,42,36.272082884109786,0.622470238095238,41.44659624413147,8273.708920187824,118.19584171696891,8
1353,32,0,1,192,0.0,0.0051813471502590676,0.9948186528497409,193,6250,4100,2150,0.656,84,41,43,200.4828161879186,0.442950084556707,0.7655803325983663,0.125696902597488,1071083.2238693973,-1903.2437814054774,1069179.9800879918,1352,4,566.0051813471503,72,121,43,36.07997371130231,0.6232638888888888,41.26712328767125,8279.452054794549,114.99238964992429,0
1354,32,0,1,191,0.0,0.005208333333333333,0.9947916666666666,192,6050,4400,1650,0.7272727272727273,77,44,33,198.163708153985,0.44264072953025013,0.7613766766832144,0.12469130402915263,1072143.7033835656,-1958.0056127129578,1070185.6977708526,1353,5,567.875,76,116,39,36.00938507098686,0.6226699561403508,41.13906926406929,8283.54978354985,108.99407609934013,0
1355,32,0,0,191,0.0,0.0,1.0,191,4500,3000,1500,0.6666666666666666,60,30,30,198.92884429586374,0.4417768898686507,0.7602852405485239,0.12552649592388954,1072972.8277494796,-10.951082985878656,1072961.8766664937,1354,7,571.8219895287958,77,114,36,35.88751439671327,0.6232413419913421,41.038995726495756,8286.752136752208,107.62015762015854,0
1356,32,2,1,192,0.010362694300518135,0.0051813471502590676,0.9948186528497409,193,6000,4300,1700,0.7166666666666667,77,43,34,197.29180871445766,0.44245196459412783,0.7611644225474201,0.1252747042479901,1074805.7651272754,-2189.9253162622695,1072615.839811013,1355,0,566.8860103626943,80,113,39,35.704450729383765,0.62421875,40.81790123456793,8293.827160493891,103.67283950617363,0
1357,32,1,0,193,0.0051813471502590676,0.0,1.0,193,5800,3900,1900,0.6724137931034483,77,39,38,195.28080107461784,0.4423406465889465,0.7597831442152898,0.12459334066179252,1076205.1934979972,-2367.5575386089004,1073837.6359593885,1356,0,567.8290155440415,85,108,43,35.584602092284726,0.6240196078431373,40.64922480620158,8299.224806201632,97.63793889648979,0
1358,32,0,0,193,0.0,0.0,1.0,193,6500,4700,1800,0.7230769230769231,83,47,36,193.68818848682642,0.4422922963442717,0.7579619233821511,0.12407689205963401,1077380.6488185753,-3364.818763913743,1074015.8300546615,1357,1,568.8290155440415,70,123,43,35.481568383558574,0.6319940476190475,40.50762910798122,8303.755868544591,118.6250838363513,0
1359,32,1,0,194,0.005154639175257732,0.0,1.0,194,4750,3000,1750,0.631578947368421,65,30,35,191.63444921520045,0.4425845307408793,0.7570240595133726,0.1237061529614722,1079606.3989491481,-2172.044473634685,1077434.3544755133,1358,0,566.8917525773196,72,122,43,35.26182432432435,0.6336805555555556,40.23972602739727,8312.328767123305,115.44901065449034,0
1360,32,0,0,194,0.0,0.0,1.0,194,4500,2500,2000,0.5555555555555556,65,25,40,192.67224960425932,0.44226014012784215,0.7579485379253263,0.12458761746791827,1080098.2993827146,-1679.006172839583,1078419.293209875,1359,1,567.8917525773196,74,120,46,35.17455587035157,0.6333051801801801,40.18055555555555,8314.22222222221,112.35435435435419,0
1361,32,0,0,194,0.0,0.0,1.0,194,5100,3500,1600,0.6862745098039216,67,35,32,196.10363010590356,0.4422339885689867,0.7613680970187802,0.12708533951018905,1080733.5069444417,-1512.8472222223972,1079220.6597222192,1360,2,568.8917525773196,75,119,45,35.00751503006012,0.6336111111111111,40.10416666666666,8316.666666666644,110.88888888888859,0
1362,32,0,0,194,0.0,0.0,1.0,194,5650,4000,1650,0.7079646017699115,73,40,33,194.7755471017507,0.4421666622153375,0.7597260548998628,0.12658484633329942,1081556.1185885402,-2317.8630561343857,1079238.2555324058,1361,3,569.8917525773196,78,116,43,34.94121276667681,0.6332799145299146,40.00527426160336,8319.831223628653,106.66450286703402,0
1363,32,0,0,194,0.0,0.0,1.0,194,4950,3400,1550,0.6868686868686869,65,34,31,197.18876940509236,0.4417693810871926,0.7625405429648404,0.12866885250084512,1082713.0434046271,-1050.2294704399528,1081662.8139341872,1362,4,570.8917525773196,80,114,38,34.73670984114427,0.6338541666666666,39.86625514403291,8324.279835390924,104.05349794238654,0
1364,32,0,1,193,0.0,0.005154639175257732,0.9948453608247423,194,5450,3500,1950,0.6422018348623854,74,35,39,201.3831182640305,0.44149729359186657,0.7673702551718344,0.1317487034617731,1083462.5295305548,-611.7874561807225,1082850.742074374,1363,5,571.8917525773196,80,114,39,34.53576723498886,0.634765625,39.77623456790122,8327.160493827125,104.08950617283907,0
1365,32,0,1,192,0.0,0.0051813471502590676,0.9948186528497409,193,6100,4400,1700,0.7213114754098361,78,44,34,200.03622012537124,0.44095423143350604,0.7647753333899605,0.1311236158470352,1084023.8463895726,-1331.193448492867,1082692.6529410798,1364,6,575.5647668393782,82,111,39,34.50206927033109,0.6346544715447154,39.70883534136546,8329.317269076291,101.57703986678403,0
1366,32,1,0,193,0.0051813471502590676,0.0,1.0,193,5250,3500,1750,0.6666666666666666,70,35,35,198.3326406322064,0.44055393638457113,0.7630531887817642,0.13059351025604338,1085313.980912077,-799.3624501311051,1084514.6184619458,1365,0,576.5181347150259,70,123,40,34.38849613189123,0.6416666666666666,39.55399061032864,8334.272300469487,119.06103286384982,0
1367,32,0,0,193,0.0,0.0,1.0,193,6300,4900,1400,0.7777777777777778,77,49,28,226.90082181380654,0.440540443293034,0.7853436244856147,0.14378678005363213,1074218.5441480228,3848.2140949636887,1078066.7582429864,1366,1,577.5181347150259,78,115,35,35.00945668583447,0.6243322649572649,40.88871308016879,8291.56118143464,106.30206642864923,8
1368,32,0,0,193,0.0,0.0,1.0,193,5350,3900,1450,0.7289719626168224,68,39,29,228.02207844502897,0.4404920930483593,0.7858941295544943,0.14514723627273,1075530.900607993,5098.958277698018,1080629.8588856908,1367,2,578.5181347150259,78,115,38,34.81856786858569,0.625934829059829,40.73048523206753,8296.624472573889,106.36698041761396,0
1369,32,0,2,191,0.0,0.010362694300518135,0.9896373056994818,193,4850,3600,1250,0.7422680412371134,61,36,25,229.1133724182306,0.4402638349165227,0.7867211323584826,0.14612150883843164,1076089.9622620514,5859.320055853236,1081949.2823179048,1368,3,579.5181347150259,81,112,39,34.721354804473854,0.6253858024691358,40.663109756097576,8298.780487804917,102.454080096357,0
1370,32,0,2,189,0.0,0.010471204188481676,0.9895287958115183,191,5500,3900,1600,0.7090909090909091,71,39,32,226.02836580827304,0.43968953798107835,0.7814900520468626,0.14449944790347644,1076787.7176146153,4976.913626970177,1081764.6312415856,1369,4,582.6387434554974,67,124,41,34.715394646196245,0.632929104477612,40.579044117647044,8301.470588235263,123.90254609306362,0
1371,32,1,0,190,0.005263157894736842,0.0,1.0,190,4750,3200,1550,0.6736842105263158,63,32,31,223.76894196610866,0.44023716699155296,0.776954568444856,0.14352692470559972,1077746.1620269273,5483.223676959656,1083229.385703887,1370,0,584.4736842105264,70,120,40,34.65599679668362,0.6324404761904762,40.463615023474155,8305.16431924877,118.64520456069671,0
1372,32,0,0,190,0.0,0.0,1.0,190,4600,3500,1100,0.7608695652173914,57,35,22,219.2012578521741,0.4402000371298617,0.7719336285205642,0.14119500016958414,1078978.1673565404,4702.674295917209,1083680.8416524576,1371,1,585.4736842105264,73,117,42,34.62299436253249,0.6324200913242009,40.315315315315296,8309.909909909868,113.83438232753244,0
1373,32,1,0,191,0.005235602094240838,0.0,1.0,191,4900,3100,1800,0.6326530612244898,67,31,36,214.60959909076516,0.4397653164324424,0.7686583055009886,0.13880430467293062,1080163.635084823,3262.696935595008,1083426.332020418,1372,0,583.4031413612565,75,116,43,34.59655404336129,0.6329166666666667,40.17269736842102,8314.473684210443,110.8596491228059,0
1374,32,0,1,190,0.0,0.005235602094240838,0.9947643979057592,191,6550,4700,1850,0.7175572519083969,84,47,37,220.65618782968463,0.43960227794617435,0.7721219302806408,0.14025855744312096,1075114.7315071777,2696.14362678206,1077810.8751339598,1373,1,584.4031413612565,86,105,34,35.060816012317176,0.6223352713178294,40.78065134099619,8295.019157088174,96.45371112893226,8
1375,32,0,1,189,0.0,0.005263157894736842,0.9947368421052631,190,5650,3900,1750,0.6902654867256637,74,39,35,209.0034447348252,0.4391789659333519,0.7690916406414641,0.12563073581762962,1058509.5877344373,596.4300242675563,1059106.017758705,1374,2,588.4631578947368,88,102,40,37.41449004975125,0.6013257575757576,42.790262172284656,8230.711610486926,93.53081375553325,8
1376,32,2,0,191,0.010471204188481676,0.0,1.0,191,4950,3100,1850,0.6262626262626263,68,31,37,202.80496216747198,0.4401729126481124,0.763424045521347,0.12271044888711875,1060494.714640132,-135.2819037208028,1060359.4327364112,1375,0,586.3612565445026,71,120,39,37.327959632855695,0.610768779342723,42.54918981481482,8238.425925925925,116.03416797078768,0
1377,32,1,0,192,0.005208333333333333,0.0,1.0,192,5400,4200,1200,0.7777777777777778,66,42,24,195.7390778480492,0.44089496073298434,0.7551160071010212,0.11909158085532653,1062154.8580292545,-2218.957511505746,1059935.9005177487,1376,0,584.3020833333334,77,115,44,37.30449515368269,0.6099837662337662,42.3477564102564,8244.871794871775,107.07625707625682,0
1378,32,4,3,193,0.02040816326530612,0.015306122448979591,0.9846938775510204,196,6200,4600,1600,0.7419354838709677,78,46,32,191.22474000532603,0.442010618349904,0.7539802123814183,0.11727559229697171,1064538.4083044904,-4686.783929258347,1059851.624375232,1377,0,573.3571428571429,84,112,37,37.12635008868616,0.6101190476190477,42.05882352941174,8254.11764705876,98.26330532212809,0
1379,32,1,0,194,0.005154639175257732,0.0,1.0,194,5650,4000,1650,0.7079646017699115,73,40,33,191.77410367740083,0.4417009419012517,0.7532169677884628,0.11797216772231989,1065448.983564008,-3584.895232603153,1061864.0883314048,1378,0,579.8041237113403,84,110,39,36.9997704642953,0.6112351190476191,41.94852941176469,8257.647058823484,98.305322128851,0
1380,32,0,3,191,0.0,0.015463917525773196,0.9845360824742269,194,4700,3100,1600,0.6595744680851063,63,31,32,194.04318531347093,0.4415768611007247,0.7547317967357605,0.1197807846787316,1066476.4948958808,-2111.500773691826,1064364.994122189,1379,1,580.8041237113403,85,109,41,36.81440104777544,0.6121323529411764,41.82412790697672,8261.627906976675,97.19562243501971,0
1381,32,0,0,191,0.0,0.0,1.0,191,4800,3000,1800,0.625,66,30,36,208.90223652732266,0.4400248002204464,0.7639830030812387,0.12841343363003097,1065227.8616064654,1505.6965401617153,1066733.5581466272,1380,2,588.9267015706806,80,111,39,36.585115131578945,0.6125,41.97530864197532,8256.790123456813,103.20987654321016,8
1382,32,1,0,192,0.005208333333333333,0.0,1.0,192,4900,3300,1600,0.673469387755102,65,33,32,206.13397072768282,0.44048649741855733,0.7679293614255265,0.12459377294851884,1060178.6250845976,407.7659338606327,1060586.3910184582,1381,0,586.8541666666666,68,124,44,37.28141555724981,0.6119791666666667,42.58756038647342,8237.198067632835,121.13526570048286,8
1383,32,1,1,192,0.0051813471502590676,0.0051813471502590676,0.9948186528497409,193,5300,3900,1400,0.7358490566037735,67,39,28,206.968827862358,0.4413219181778929,0.7718925729087949,0.12076943085720762,1049471.0377607308,-458.44188783393383,1049012.595872897,1382,0,584.8082901554404,73,120,39,38.590102964347246,0.596175799086758,43.89076576576576,8195.495495495474,112.26706158212977,8
1384,32,1,1,192,0.0051813471502590676,0.0051813471502590676,0.9948186528497409,193,5650,3800,1850,0.672566371681416,75,38,37,206.38338877916607,0.44160077540299364,0.7719226557264522,0.12098235350767311,1050879.990594291,-873.1652681864575,1050006.8253261044,1383,0,585.7772020725389,66,127,40,38.42968939577772,0.6016414141414141,43.71890547263681,8200.995024875612,124.25750037690321,0
1385,32,3,0,195,0.015384615384615385,0.0,1.0,195,6100,4200,1900,0.6885245901639344,80,42,38,198.2619659668961,0.4422394043528064,0.7643442455753864,0.11713843934128379,1053281.519484007,-3334.8670461003294,1049946.6524379067,1384,0,580.723076923077,73,122,41,38.33935690642086,0.600884703196347,43.426238738738725,8210.36036036033,112.47068986794972,0
1386,32,0,1,194,0.0,0.005128205128205128,0.9948717948717949,195,5750,3900,1850,0.6782608695652174,76,39,37,202.3221244679239,0.44219094193320996,0.7688436832300611,0.12012996379263413,1054787.5578302906,-2068.6280874886493,1052718.929742802,1385,1,581.723076923077,75,120,42,38.04810806242102,0.6018055555555555,43.242872807017534,8216.228070175413,109.54970760233884,0
1387,32,2,1,195,0.01020408163265306,0.00510204081632653,0.9948979591836735,196,5200,3800,1400,0.7307692307692307,66,38,28,204.7073841424089,0.4431258721437293,0.7721251044587454,0.1223412701998911,1056766.4274234716,-1134.4217985247815,1055632.005624947,1386,0,579.5918367346939,77,119,37,37.741200720570895,0.6033549783549783,43.00213675213673,8223.931623931567,106.80430680430607,0
1388,32,0,0,195,0.0,0.0,1.0,195,5700,4200,1500,0.7368421052631579,72,42,30,205.13763771644216,0.442535685963521,0.7718589244218961,0.1230889752019341,1057974.882318825,-1293.9063755574043,1056680.9759432676,1387,1,583.5641025641025,77,118,39,37.58022807928673,0.6048430735930737,42.85523504273502,8228.632478632417,106.86535686535606,0
1389,32,1,2,194,0.00510204081632653,0.01020408163265306,0.9897959183673469,196,6150,4700,1450,0.7642276422764228,76,47,29,203.24097252963958,0.4429334554334554,0.7714407832826906,0.1225918477615084,1059556.9470699409,-2280.9231253940316,1057276.023944547,1388,0,581.5816326530612,68,128,42,37.4329021471313,0.6112132352941176,42.66304347826086,8234.782608695634,121.09974424552402,0
1390,32,0,0,194,0.0,0.0,1.0,194,5200,3300,1900,0.6346153846153846,71,33,38,206.17106474718554,0.4417265370439613,0.7737042730859787,0.12462848919383511,1060208.3217308947,-283.14429098308165,1059925.1774399118,1389,1,588.5360824742268,66,128,44,37.276781220430436,0.6131628787878788,42.58395522388059,8237.313432835797,124.80777928539086,0
1391,32,1,0,195,0.005128205128205128,0.0,1.0,195,4150,2700,1450,0.6506024096385542,56,27,29,205.3255123464672,0.441892457485241,0.7743498266509337,0.12484325620545483,1061960.559039791,459.5191753171139,1062420.0782151083,1390,0,586.5128205128206,67,128,42,37.08154953026522,0.6147388059701493,42.37132352941176,8244.117647058814,123.04653204565395,0
1392,32,0,1,194,0.0,0.005128205128205128,0.9948717948717949,195,5750,4300,1450,0.7478260869565218,72,43,29,204.18602283198686,0.4416721737598026,0.7733968067878709,0.12462686002451256,1063108.2908163236,-1335.6292517009056,1061772.6615646228,1391,1,587.5128205128206,69,126,46,36.968883500750515,0.615036231884058,42.23214285714285,8248.571428571406,119.5445134575566,0
1393,32,2,2,194,0.01020408163265306,0.01020408163265306,0.9897959183673469,196,4950,3600,1350,0.7272727272727273,63,36,27,202.7577821121179,0.4421212715855573,0.7732073235172292,0.12459911737667267,1065138.669753086,-956.9691358025666,1064181.7006172836,1392,0,585.3367346938776,74,122,38,36.75467872458772,0.6150056306306306,41.98611111111111,8256.444444444442,111.57357357357354,0
1394,32,0,0,194,0.0,0.0,1.0,194,5400,3800,1600,0.7037037037037037,70,38,32,206.68729044811445,0.44125469615227103,0.7758792840917599,0.12740574769413626,1066056.25,-131.9444444444489,1065924.3055555555,1393,1,591.9742268041238,74,120,40,36.53988431530805,0.6161317567567568,41.875,8260.0,111.62162162162163,0
1395,32,0,0,194,0.0,0.0,1.0,194,5950,3900,2050,0.6554621848739496,80,39,41,208.96844134113212,0.4412641552267507,0.7781031138389625,0.12922787886536372,1067014.904239882,-155.5117146469711,1066859.392525235,1394,2,592.9742268041238,78,116,41,36.362543613309505,0.6155181623931624,41.758966244725734,8263.713080168767,105.94503948934317,0
1396,32,1,0,195,0.005128205128205128,0.0,1.0,195,5300,4200,1100,0.7924528301886793,64,42,22,209.0849834154719,0.4415278879196405,0.7794070815610048,0.12998634951726185,1068585.2220323363,385.02468532992043,1068970.2467176663,1395,0,590.9282051282051,63,132,42,36.165606499559146,0.6253306878306879,41.56901041666667,8269.791666666677,131.26653439153455,0
1397,32,0,1,194,0.0,0.005128205128205128,0.9948717948717949,195,4950,3400,1550,0.6868686868686869,65,34,31,207.772963904061,0.4415906687813904,0.7778648689024303,0.12962911831508564,1069633.2840236665,498.1755424062485,1070131.4595660728,1396,1,591.9282051282051,64,131,43,36.07017788521136,0.6259765625,41.442307692307686,8273.846153846138,129.2788461538459,0
1398,32,1,0,195,0.005128205128205128,0.0,1.0,195,5450,4200,1250,0.7706422018348624,67,42,25,203.55168311465883,0.4419012688342585,0.7731392268350439,0.12775830832180002,1071400.0071471885,-832.9450512265739,1070567.062095962,1397,0,591.9076923076923,68,127,44,35.96153472181707,0.625765931372549,41.228864734299506,8280.676328502394,121.77465188974108,0
1399,32,1,0,196,0.00510204081632653,0.0,1.0,196,4650,3100,1550,0.6666666666666666,62,31,31,198.8715751771994,0.4420356924821211,0.7686886939694906,0.12553010801469347,1073065.7901234527,-1169.5432098767815,1071896.2469135758,1398,0,589.8826530612245,74,122,41,35.87755640173046,0.6247184684684685,41.027777777777764,8287.111111111079,111.98798798798755,0
1400,32,2,1,197,0.010101010101010102,0.005050505050505051,0.9949494949494949,198,5350,3400,1950,0.6355140186915887,73,34,39,212.951248254175,0.44264023483566634,0.7826194306832119,0.13253138209232043,1068901.2615521965,574.7715816006357,1069476.033133797,1399,0,584.9141414141415,68,130,41,36.026663162198474,0.6227022058823529,41.53079710144928,8271.014492753635,121.63256606990639,8
1401,32,0,2,195,0.0,0.01015228426395939,0.9898477157360406,197,5500,3800,1700,0.6909090909090909,72,38,34,211.9526060057343,0.4422502503539487,0.781205169744754,0.13232960258062582,1069840.588424915,451.10014547375704,1070291.6885703888,1400,1,588.8730964467005,70,127,44,35.93652482269505,0.6227678571428572,41.41725352112676,8274.64788732394,118.20925553319914,0
1402,32,2,0,197,0.01015228426395939,0.0,1.0,197,5400,3700,1700,0.6851851851851852,71,37,34,209.060594276757,0.44239053489416075,0.7791777411055554,0.1312854202840465,1071555.847459394,4.020454118976886,1071559.867913513,1401,0,589.2791878172588,72,125,41,35.79976749742684,0.6238425925925926,41.210045662100455,8281.278538812785,115.0177574835109,0
1403,32,0,0,197,0.0,0.0,1.0,197,6000,4400,1600,0.7333333333333333,76,44,32,209.3011388935765,0.4422351427880797,0.7796464116883484,0.13177874855843105,1072320.8882446655,-512.4033662039137,1071808.4848784616,1402,1,590.2791878172588,73,124,42,35.699243742410225,0.6242865296803652,41.11768018018019,8284.234234234249,113.48266074293491,0
1404,32,1,0,198,0.005050505050505051,0.0,1.0,198,4600,3000,1600,0.6521739130434783,62,30,32,208.77224450648106,0.44243300176041295,0.7791105927941602,0.13195373137340155,1073453.3728569157,621.4540048782428,1074074.8268617939,1403,0,588.2929292929293,78,120,38,35.57341512251408,0.6233974358974359,40.981012658227854,8288.607594936724,106.26419993508621,0
1405,32,0,0,198,0.0,0.0,1.0,198,6300,4500,1800,0.7142857142857143,81,45,36,208.1206497849284,0.4421648806166573,0.7792076926629505,0.13204415979182182,1074569.7943793463,-1171.9672309024527,1073397.8271484438,1404,1,589.2929292929293,79,119,40,35.452831650170005,0.6243407172995781,40.846354166666686,8292.916666666713,104.97362869198372,0
1406,32,1,1,198,0.005025125628140704,0.005025125628140704,0.9949748743718593,199,5650,4100,1550,0.7256637168141593,72,41,31,205.5952553048024,0.442564252237619,0.7788002792899349,0.13112061728262644,1076086.057765585,-1202.3624447492148,1074883.6953208358,1405,0,587.3266331658291,80,119,44,35.33174650401669,0.62578125,40.66358024691358,8298.765432098768,103.7345679012346,0
1407,32,0,0,198,0.0,0.0,1.0,198,5200,3500,1700,0.6730769230769231,69,35,34,209.5941574423998,0.4421883812746757,0.7824240178325776,0.13418501396401333,1077204.4748520714,355.1528599605663,1077559.6277120318,1406,1,591.2424242424242,64,134,44,35.09048236674696,0.63525390625,40.52884615384615,8303.076923076926,129.73557692307696,0
1408,32,1,0,199,0.005025125628140704,0.0,1.0,199,6600,5500,1100,0.8333333333333334,77,55,22,205.2280616929956,0.44249657377798085,0.7787275055386929,0.1324874646787323,1079619.954648523,-2086.3378684809027,1077533.616780042,1407,0,589.2663316582915,69,130,43,34.907052016498625,0.6352657004830917,40.23809523809523,8312.380952380929,120.46928916494099,0
1409,32,0,0,199,0.0,0.0,1.0,199,6150,4300,1850,0.6991869918699187,80,43,37,201.3624816138647,0.44252089572441333,0.7747678960360316,0.130631237156823,1081038.5705272304,-2413.878143666439,1078624.6923835638,1408,1,590.2663316582915,70,129,45,34.83342270136028,0.6364583333333333,40.06748826291079,8317.84037558684,118.82629107981201,0
1410,32,1,1,199,0.005,0.005,0.995,200,5950,4700,1250,0.7899159663865546,72,47,25,198.8758764280154,0.4425921273031826,0.7724434462604184,0.12966931703023526,1082490.2732124014,-2893.7596380163704,1079596.513574385,1409,0,588.31,73,127,39,34.720117617346745,0.6367009132420092,39.89301801801802,8323.423423423423,114.01949895100579,0
1411,32,1,2,198,0.005,0.01,0.99,200,5650,3900,1750,0.6902654867256637,74,39,35,198.93261836592177,0.44212259212730315,0.7728418917476256,0.13003501997443045,1083218.382716049,-2552.506172839461,1080665.8765432094,1410,0,589.305,74,126,40,34.62943934379565,0.6371058558558558,39.80555555555556,8326.222222222219,112.51651651651648,0
1412,32,0,1,197,0.0,0.005050505050505051,0.9949494949494949,198,6150,4300,1850,0.6991869918699187,80,43,37,201.20663925917248,0.4415741595310123,0.7734365315733365,0.13194593537422714,1084143.7160493825,-2122.6172839506235,1082021.098765432,1411,1,595.9090909090909,74,124,42,34.45692384306192,0.6382319819819819,39.69444444444444,8329.777777777776,112.56456456456453,0
1413,32,0,0,197,0.0,0.0,1.0,197,5750,4100,1650,0.7130434782608696,74,41,33,200.37837232739543,0.4411420024862737,0.7715132981907347,0.13200439615198375,1085452.4439218075,-1649.761209631,1083802.6827121763,1412,2,599.2944162436548,67,130,45,34.318269815130655,0.6435012437810945,39.53737745098039,8334.803921568617,124.40005853087487,0
1414,32,0,0,197,0.0,0.0,1.0,197,6400,4700,1700,0.734375,81,47,34,201.22028536187946,0.44092833834041234,0.7720064169211014,0.13320042202789453,1086831.4313052818,-2061.493850498268,1084769.9374547836,1413,3,600.2944162436548,68,129,43,34.12761623416744,0.6446078431372548,39.371980676328505,8340.096618357493,122.64847968172784,0
1415,32,0,0,197,0.0,0.0,1.0,197,5850,4100,1750,0.7008547008547008,76,41,35,198.18576341858196,0.4407653924513968,0.768241708071272,0.13165875466616683,1087844.1713016562,-2130.9544860253127,1085713.216815631,1414,4,601.2944162436548,71,126,41,34.0828963916477,0.6442194835680751,39.25057870370371,8343.981481481493,117.52086593635906,0
1416,32,0,1,196,0.0,0.005076142131979695,0.9949238578680203,197,5350,3400,1950,0.6355140186915887,73,34,39,216.35639726132993,0.4404189975482579,0.7825374360229129,0.14194389828774356,1084271.379236942,2167.8098530554485,1086439.1890899974,1415,5,602.2944162436548,86,111,38,34.04690997455003,0.6334786821705427,39.67911877394635,8330.268199233686,96.8635837120196,8
1417,32,0,0,196,0.0,0.0,1.0,196,5250,3500,1750,0.6666666666666666,70,35,35,219.20000000000036,0.43983243938601085,0.7837959183673477,0.14421052631578948,1085069.4444444429,3119.4444444444143,1088188.8888888874,1416,6,605.7091836734694,70,126,38,33.87500000000002,0.6413690476190477,39.58333333333333,8333.333333333321,119.04761904761888,0
1418,32,0,2,194,0.0,0.01020408163265306,0.9897959183673469,196,6400,4900,1500,0.765625,79,49,30,215.0422892914573,0.4397850165707309,0.7789223162112953,0.14188191258171134,1085890.7334276852,1102.4858473338109,1086993.2192750191,1417,7,606.7091836734694,73,123,38,33.88261873885558,0.6408390410958904,39.4847972972973,8336.486486486492,114.19844502036291,0
1419,32,1,0,195,0.005128205128205128,0.0,1.0,195,5150,3000,2150,0.5825242718446602,73,30,43,209.2767009512723,0.43929861661820424,0.7717008019223788,0.1388286163177957,1087438.160009182,1365.0941230486033,1088803.2541322308,1418,0,610.651282051282,76,119,41,33.84338297614725,0.6413103070175439,39.29924242424242,8342.424242424238,109.76874003189788,0
1420,32,0,2,193,0.0,0.010256410256410256,0.9897435897435898,195,6400,4500,1900,0.703125,83,45,38,209.69685754625465,0.43889219314477046,0.7717596121438393,0.13956271340056906,1088368.3615517449,245.48505403338004,1088613.8466057782,1419,1,611.651282051282,78,117,42,33.71861307718235,0.641559829059829,39.187763713080166,8345.991561181429,106.99989181001831,0
1421,32,0,0,193,0.0,0.0,1.0,193,6300,4800,1500,0.7619047619047619,78,48,30,208.9941554066147,0.43804984348013815,0.7682490601482161,0.1395288719659362,1089252.995922876,629.5019814051675,1089882.4979042811,1420,2,611.6839378238342,80,113,40,33.62875203312139,0.641796875,39.081790123456784,8349.382716049371,104.36728395061714,0
1422,32,0,0,193,0.0,0.0,1.0,193,5500,4200,1300,0.7636363636363637,68,42,26,213.10165495562202,0.43767990788716177,0.7705136508569159,0.14280007806304518,1090304.9950807204,2369.1597716163815,1092674.1548523367,1421,3,612.6839378238342,82,111,37,33.39292868589743,0.6422764227642277,38.95582329317268,8353.413654618442,101.87089822705417,0
1423,32,0,0,193,0.0,0.0,1.0,193,5200,3900,1300,0.75,65,39,26,214.92235645504292,0.4375292350316638,0.7733366660327656,0.14456977800382162,1091382.336644147,3112.492716994133,1094494.8293611412,1422,4,613.6839378238342,83,110,39,33.213690787078825,0.6431977911646587,38.82688492063492,8357.539682539673,100.69324918722498,0
1424,32,0,0,193,0.0,0.0,1.0,193,4850,3700,1150,0.7628865979381443,60,37,23,215.5790909664605,0.4370491058578008,0.7752063833236265,0.1456661098528466,1092652.900310229,3660.6237981492504,1096313.5241083782,1423,5,614.6839378238342,85,108,42,33.04128041714948,0.6439950980392157,38.6749031007752,8362.403100775204,98.38121295029651,0
1425,32,0,1,192,0.0,0.0051813471502590676,0.9948186528497409,193,5800,4400,1400,0.7586206896551724,72,44,28,212.68703563208672,0.43694678324697755,0.7732898373822734,0.14423027534145783,1093666.0230192028,2121.716881497601,1095787.7399007003,1424,6,615.6839378238342,85,108,43,32.99315689908116,0.6452205882352942,38.55377906976745,8366.279069767466,98.4268125854996,0
1426,32,0,2,190,0.0,0.010416666666666666,0.9895833333333334,192,6000,4700,1300,0.7833333333333333,73,47,26,210.8702825469002,0.43677283304246656,0.770297773610308,0.1437601100132888,1095157.194450286,1787.2214054007736,1096944.4158556866,1425,7,618.2135416666666,68,124,41,32.85872283131371,0.654718137254902,38.37560386473432,8371.980676328558,123.11736288718467,0
1427,32,1,0,191,0.005235602094240838,0.0,1.0,191,5950,3500,2450,0.5882352941176471,84,35,49,207.34269596633257,0.4356790208505557,0.7668001714898682,0.14270996506487704,1097821.874517846,1375.0694306687665,1099196.9439485148,1426,0,620.9214659685864,70,121,43,32.62632556663306,0.6568452380952381,38.057511737089214,8382.15962441317,119.74513749161672,0
1428,32,2,1,192,0.010362694300518135,0.0051813471502590676,0.9948186528497409,193,6100,4300,1800,0.7049180327868853,79,43,36,200.7892835427622,0.43619904109096147,0.7613225639789583,0.13902043057909397,1099468.7530864226,-547.6913580245,1098921.061728398,1427,0,615.4766839378239,74,119,38,32.59764314224154,0.6568130630630631,37.86111111111112,8388.444444444467,113.35735735735766,0
1429,32,0,1,191,0.0,0.005208333333333333,0.9947916666666666,192,5900,4800,1100,0.8135593220338984,70,48,22,202.12300626125278,0.4351918130090169,0.7626003102137116,0.14039934467464582,1100369.6198818446,182.00311381426945,1100551.6229956588,1428,1,619.6822916666666,77,115,40,32.453139057221925,0.6565205627705628,37.75373931623933,8391.880341880382,108.9854589854595,0
1430,32,0,1,190,0.0,0.005235602094240838,0.9947643979057592,191,6000,5000,1000,0.8333333333333334,70,50,20,203.90447244802112,0.43444475062000554,0.7632893014950872,0.14182055125650547,1100728.5602378596,688.6952767543926,1101417.255514614,1429,2,623.9162303664922,78,113,41,32.36277984449361,0.656517094017094,37.71097046413504,8393.248945147725,107.60575570702211,0
1431,32,0,3,187,0.0,0.015789473684210527,0.9842105263157894,190,5450,4200,1250,0.7706422018348624,67,42,25,206.01942835640614,0.4335491506544138,0.7632221013394191,0.14382370164103792,1101753.1752966247,1946.5118728935367,1103699.687169518,1430,3,628.0842105263158,81,109,41,32.182744751577374,0.6565072016460906,37.58892276422767,8397.154471544784,103.66857372277511,0
1432,32,0,0,187,0.0,0.0,1.0,187,4850,3600,1250,0.7422680412371134,61,36,25,209.9259741314033,0.4329897648208844,0.7645459623483097,0.14689266427899034,1102395.83579382,4034.3039414845953,1106430.1397353045,1431,4,637.6684491978609,83,104,41,32.00210429757013,0.6565010040160643,37.512400793650826,8399.603174603266,101.20003824823212,0
1433,32,0,0,187,0.0,0.0,1.0,187,5500,3800,1700,0.6909090909090909,72,38,34,209.68252059721948,0.43276814635922795,0.7653939379997039,0.14723842432991827,1103362.8448114307,3371.180486675685,1106734.0252981063,1432,5,638.6684491978609,70,117,42,31.890980874164303,0.6635416666666667,37.397300469483554,8403.28638497649,120.04694835680701,0
1434,32,0,1,186,0.0,0.0053475935828877,0.9946524064171123,187,4750,3400,1350,0.7157894736842105,61,34,27,209.21919088461402,0.43232850324880684,0.7648563142784295,0.14760774639652396,1104658.5897917037,4073.1552719916926,1108731.7450636954,1433,6,639.6684491978609,72,115,42,31.745773143622593,0.6640625,37.2431506849315,8408.219178082176,116.780821917808,0
1435,32,0,0,186,0.0,0.0,1.0,186,4350,2800,1550,0.6436781609195402,59,28,31,209.5694199118061,0.4320776421582873,0.7642707970254239,0.1480490988306758,1105018.5600018713,4765.619722274067,1109784.1797241454,1434,7,643.1881720430108,72,114,42,31.692865287506113,0.6644965277777778,37.20034246575341,8409.589041095851,116.79984779299792,0
1436,32,0,1,185,0.0,0.005376344086021506,0.9946236559139785,186,4850,3300,1550,0.6804123711340206,64,33,31,209.3883498198759,0.4315218444250702,0.7632220180442515,0.14874247567545185,1106533.2872855098,4289.0358090950485,1110822.3230946048,1435,8,644.1881720430108,75,111,43,31.51379623356092,0.6648611111111111,37.020285087719294,8415.350877192974,112.20467836257298,0
1437,32,0,0,185,0.0,0.0,1.0,185,5750,4000,1750,0.6956521739130435,75,40,35,207.47964614908503,0.43115574813944374,0.7592858079344573,0.14769217094798498,1107098.5351562495,3190.082465277825,1110288.6176215273,1436,9,646.1405405405405,79,106,41,31.495437745437755,0.6637658227848101,36.953125,8417.499999999996,106.55063291139236,0
1438,32,0,0,185,0.0,0.0,1.0,185,5450,3600,1850,0.6605504587155964,73,36,37,193.47684584779697,0.4310578241284763,0.7450319055937709,0.13163651675935276,1094591.9346288878,-94.3609995128586,1094497.5736293748,1437,10,647.1405405405405,73,112,41,33.38261082108965,0.651398401826484,38.44313063063064,8369.819819819837,114.65506602492927,8
1439,32,0,1,184,0.0,0.005405405405405406,0.9945945945945946,185,6200,4100,2100,0.6612903225806451,83,41,42,192.12225941423924,0.4306893850372111,0.7421640843646038,0.13119882166088073,1095627.410493833,-1101.1172839502979,1094526.2932098827,1438,11,648.1405405405405,74,111,42,33.29197848663374,0.6521677927927928,38.319444444444464,8373.777777777823,113.15915915915977,0
1440,32,0,1,183,0.0,0.005434782608695652,0.9945652173913043,184,5650,3800,1850,0.672566371681416,75,38,37,193.80281293754206,0.4297079175576146,0.7440894937146807,0.13284301904991588,1096674.3827160553,57.71604938307155,1096732.0987654384,1439,12,652.4836956521739,74,110,42,33.12057913351018,0.6534346846846847,38.194444444444464,8377.777777777823,113.21321321321382,0
1441,32,0,0,183,0.0,0.0,1.0,183,6350,5200,1150,0.8188976377952756,75,52,23,192.98346610701708,0.42962729438139274,0.742270258104661,0.13302704279998145,1098241.3000401822,-561.5174592736871,1097679.7825809086,1440,13,655.2513661202186,77,106,43,32.95145614571655,0.6539502164502164,38.007478632478644,8383.760683760715,108.88000888000929,0
1442,32,0,0,183,0.0,0.0,1.0,183,4650,3200,1450,0.6881720430107527,61,32,29,194.5534466228445,0.4294559038411498,0.7444358307770793,0.13443369142699657,1098913.1784644616,1509.4692819052789,1100422.647746367,1441,14,656.2513661202186,77,106,45,32.82863670335643,0.6547619047619048,37.92735042735043,8386.324786324796,108.91330891330904,0
1443,32,0,0,183,0.0,0.0,1.0,183,4850,3600,1250,0.7422680412371134,61,36,25,198.6458467883912,0.4294471466602614,0.7512590008913702,0.12402171624673726,1069840.5884249147,1053.8779232515249,1070894.4663481663,1442,15,657.2513661202186,70,113,42,36.2806146572104,0.6227678571428572,41.41725352112676,8274.647887323938,118.20925553319911,8
1444,32,1,1,183,0.005434782608695652,0.005434782608695652,0.9945652173913043,184,6000,4500,1500,0.75,75,45,30,199.56922749557924,0.42973947196483725,0.7546048389609703,0.1254761253914146,1071910.3835668557,-15.93456141453953,1071894.449005441,1443,0,654.6739130434783,72,112,44,36.001731995516074,0.6242766203703703,41.16723744292237,8282.648401826478,115.03678335870109,0
1445,32,0,0,183,0.0,0.0,1.0,183,5200,3900,1300,0.75,65,39,26,195.4695287981155,0.4290117896675274,0.7480228075034401,0.12333432705383657,1072950.694444446,145.8333333333917,1073096.5277777794,1444,1,659.0218579234972,74,109,42,35.979820327165434,0.6245777027027026,41.04166666666667,8286.666666666679,111.98198198198214,0
1446,32,0,2,181,0.0,0.01092896174863388,0.9890710382513661,183,4400,3200,1200,0.7272727272727273,56,32,24,197.9350383305182,0.4287878560419544,0.7508548715422387,0.12551062626373216,1074403.8792426868,1532.434604072022,1075936.3138467588,1445,2,660.0218579234972,81,102,41,35.7371991274082,0.6233281893004115,40.86636178861791,8292.276422764284,102.37378299708992,0
1447,32,0,0,181,0.0,0.0,1.0,181,4550,3200,1350,0.7032967032967034,59,32,27,201.07000805764054,0.42838653570697766,0.751888028888362,0.1278664896987319,1075246.7555068182,2489.974758741944,1077736.73026556,1446,3,665.2817679558011,81,100,42,35.55229210565003,0.6243569958847737,40.76473577235775,8295.528455284631,102.41393154672384,0
1448,32,0,0,181,0.0,0.0,1.0,181,5400,3800,1600,0.7037037037037037,70,38,32,200.31358814197412,0.42826631880499283,0.7520348846315668,0.12784791252825034,1076304.5367166586,1519.6847366402626,1077824.2214532988,1447,4,666.2817679558011,84,97,44,35.441866691866686,0.6245039682539683,40.637254901960816,8299.607843137343,98.80485527544455,0
1449,32,0,0,181,0.0,0.0,1.0,181,4600,3300,1300,0.717391304347826,59,33,26,196.24389430256588,0.4279222938408021,0.7417550273708093,0.12270717203521952,1070286.2816900804,1207.429587494979,1071493.7112775755,1448,5,667.2817679558011,78,103,43,36.2878111989124,0.6195245726495726,41.36339662447258,8276.371308016895,106.10732446175506,8
1450,32,0,1,180,0.0,0.0055248618784530384,0.994475138121547,181,4750,3400,1350,0.7157894736842105,61,34,27,196.20579762006585,0.42800158583998366,0.7411588864867753,0.12307454577985998,1071225.0000000042,1086.1111111113655,1072311.1111111157,1449,6,668.2817679558011,79,102,43,36.17317498658078,0.620253164556962,41.250000000000014,8280.000000000033,104.8101265822789,0
1451,32,2,2,180,0.01098901098901099,0.01098901098901099,0.989010989010989,182,4300,2500,1800,0.5813953488372093,61,25,36,194.87633049279907,0.42873522655981217,0.7413934502618766,0.12301233036766375,1073075.4972702116,1123.4030499511432,1074198.9003201628,1450,0,663.510989010989,82,100,34,35.97982796220017,0.6213160569105691,41.02660642570283,8287.148594377559,101.06278773631169,0
1452,32,0,0,180,0.0,0.0,1.0,180,5850,4600,1250,0.7863247863247863,71,46,25,199.0766998445435,0.4286610283467825,0.7435951258369389,0.12606562550891973,1074011.7498104947,912.1429493076489,1074923.8927598023,1451,1,670.8888888888889,82,98,36,35.75584915714014,0.6224593495934959,40.91365461847392,8290.763052208897,101.1068664903524,0
1453,32,0,0,180,0.0,0.0,1.0,180,5250,3800,1450,0.7238095238095238,67,38,29,199.5744606515841,0.42816379577901925,0.7449210799584622,0.12680800053277702,1074999.2488432268,1658.4790577493568,1076657.727900976,1452,2,671.8888888888889,85,95,39,35.62149532710283,0.6225490196078431,40.79457364341088,8294.573643410919,97.5832193342461,0
1454,32,0,0,180,0.0,0.0,1.0,180,5150,4100,1050,0.7961165048543689,62,41,21,197.8613875296694,0.42798468859921374,0.743243124004088,0.12602257431858585,1075702.6344007377,1418.0031623705277,1077120.6375631082,1453,3,672.8888888888889,85,95,41,35.57943468647329,0.623406862745098,40.70978682170546,8297.28682170551,97.61513907888835,0
1455,32,2,2,180,0.01098901098901099,0.01098901098901099,0.989010989010989,182,5500,3700,1800,0.6727272727272727,73,37,36,192.3381196373367,0.4297622842167041,0.7392760447427187,0.1234431809256121,1077925.64841023,-434.76153518410774,1077490.886875046,1454,0,666.4835164835165,73,109,43,35.44971482546052,0.6311358447488584,40.44200450450449,8305.85585585582,113.77884734049069,0
1456,32,2,0,182,0.01098901098901099,0.0,1.0,182,5150,3400,1750,0.6601941747572816,69,34,35,187.85621930076974,0.43011644202942545,0.73340719637016,0.12135742265258273,1079821.784106644,-979.7524238229444,1078842.0316828212,1455,0,666.3131868131868,75,107,43,35.33357075023741,0.6325000000000001,40.21381578947367,8313.157894736809,110.84210526315745,0
1457,32,0,0,182,0.0,0.0,1.0,182,4450,2800,1650,0.6292134831460674,61,28,33,190.69228565539478,0.43009304231679923,0.736802233835494,0.1236507217110053,1080902.2770609583,373.9451565748732,1081276.2222175333,1456,1,667.3131868131868,76,106,44,35.12747445306128,0.6333607456140351,40.08387445887445,8317.316017315989,109.43836864889458,0
1458,32,0,1,181,0.0,0.005494505494505495,0.9945054945054945,182,4700,3300,1400,0.7021276595744681,61,33,28,190.0588360036114,0.4298982555198025,0.7362974551441375,0.12347248993354801,1081446.4189543983,7.689517349074777,1081454.1084717473,1457,2,668.3131868131868,78,104,44,35.07728102652534,0.6331463675213675,40.01845991561179,8319.409282700366,106.65909336795342,0
1459,32,1,0,182,0.005494505494505495,0.0,1.0,182,4150,2500,1650,0.6024096385542169,58,25,33,187.96083634538869,0.4298773855058386,0.7328953021249165,0.12258875702487157,1082575.2197265583,146.34874131920878,1082721.5684678776,1458,0,669.010989010989,79,103,39,34.993628088968954,0.6340981012658228,39.882812499999986,8323.749999999967,105.36392405063249,0
1460,32,0,2,180,0.0,0.01098901098901099,0.989010989010989,182,4700,3500,1200,0.7446808510638298,59,35,24,189.94741074707858,0.42991912553376643,0.7365961440694553,0.12412842423239245,1083141.2894375792,47.97668038378379,1083189.266117963,1459,1,670.010989010989,80,102,40,34.87266459074731,0.634375,39.814814814814795,8325.925925925874,104.07407407407342,0
1461,32,0,1,179,0.0,0.005555555555555556,0.9944444444444445,180,4650,3000,1650,0.6451612903225806,63,30,33,188.96664342054385,0.4291123525760397,0.7327442660366148,0.12382240814845635,1083919.3143054096,314.9189125979656,1084234.2332180075,1460,2,677.2888888888889,82,98,43,34.802987929344056,0.6345274390243902,39.72138554216866,8328.915662650565,101.57214222744591,0
1462,32,0,0,179,0.0,0.0,1.0,179,4500,3300,1200,0.7333333333333333,57,33,24,194.5274608850635,0.4280085472767978,0.7381843023228305,0.1277962410007432,1084660.9861591626,1899.2695117259432,1086560.2556708886,1461,3,682.0391061452514,84,95,45,34.567487213279335,0.6346726190476191,39.63235294117645,8331.764705882299,99.18767507002737,0
1463,32,0,0,179,0.0,0.0,1.0,179,4400,2800,1600,0.6363636363636364,60,28,32,197.1532357034949,0.4274396878203921,0.742898901914413,0.12993437466875837,1085572.7234007765,2604.8350019835675,1088177.5584027602,1462,4,683.0391061452514,68,111,45,34.38755747459526,0.6430759803921569,39.52294685990337,8335.265700483069,122.57743677180984,0
1464,32,1,0,180,0.005555555555555556,0.0,1.0,180,5650,4400,1250,0.7787610619469026,69,44,25,196.8185017518304,0.42798274881026277,0.7425777927860322,0.130487729071885,1087271.2645198242,1149.020256121842,1088420.284775946,1463,0,680.2388888888889,70,110,43,34.18856933813596,0.644047619047619,39.31924882629107,8341.78403755867,119.16834339369528,0
1465,32,0,0,180,0.0,0.0,1.0,180,5150,3600,1550,0.6990291262135923,67,36,31,196.74838136277296,0.4274887492240844,0.7412809349907952,0.130993559406066,1088473.9500902917,1681.0975671616866,1090155.0476574535,1464,1,681.2388888888889,73,107,45,34.043425171353014,0.6439783105022832,39.17511261261261,8346.396396396387,114.33419721090941,0
1466,32,0,0,180,0.0,0.0,1.0,180,4300,3100,1200,0.7209302325581395,55,31,24,198.99346751522313,0.4274732309124767,0.7448560985130785,0.13284617202348892,1089240.1111111094,3050.333333333303,1092290.4444444426,1465,2,682.2388888888889,74,106,47,33.891262110081996,0.6444256756756757,39.08333333333333,8349.33333333332,112.82882882882863,0
1467,32,0,1,179,0.0,0.005555555555555556,0.9944444444444445,180,4950,3500,1450,0.7070707070707071,64,35,29,200.54311486080286,0.42721588557831575,0.7448570858482564,0.13432301448762107,1090175.2631293358,2775.4286024302614,1092950.691731766,1466,3,683.2388888888889,79,101,46,33.73660439633525,0.64332805907173,38.97135416666665,8352.916666666631,105.73312236286876,0
1468,32,0,2,177,0.0,0.0111731843575419,0.9888268156424581,179,4350,3000,1350,0.6896551724137931,57,30,27,200.85543223227023,0.4276005377356517,0.7438547073251476,0.13470651238015516,1090541.8619493917,3658.251409845732,1094200.1133592373,1467,4,681.4972067039106,80,99,36,33.68368553273234,0.643359375,38.92746913580245,8354.320987654271,104.42901234567839,0
1469,32,0,0,177,0.0,0.0,1.0,177,5350,4100,1250,0.7663551401869159,66,41,25,201.3331011824562,0.4270846708611539,0.7420145529688507,0.13545185079552624,1091430.3655231625,3198.212043095785,1094628.5775662584,1468,5,684.9661016949152,81,96,36,33.56274319066146,0.6440329218106996,38.8211382113821,8357.723577235734,103.18177255846585,0
1470,32,0,0,177,0.0,0.0,1.0,177,5350,3900,1450,0.7289719626168224,68,39,29,203.22956781488904,0.4270097693032015,0.7448468422772403,0.13706583853987972,1092127.4533833084,3640.5180699727466,1095767.9714532811,1469,6,685.9661016949152,84,93,36,33.428123583032324,0.6437251984126984,38.7377450980392,8360.392156862701,99.5284780578893,0
1471,32,0,2,175,0.0,0.011299435028248588,0.9887005649717514,177,5350,3700,1650,0.6915887850467289,70,37,33,203.6205629069532,0.42644934514637906,0.7452182101039881,0.13774332196646766,1092975.2066115642,3760.445362717826,1096735.651974282,1470,7,686.9661016949152,87,90,37,33.31446256038646,0.6436781609195402,38.63636363636362,8363.636363636317,96.13375130616456,0
1472,32,0,2,173,0.0,0.011428571428571429,0.9885714285714285,175,5450,4200,1250,0.7706422018348624,67,42,25,210.7502987597406,0.42572796934865903,0.7521798856528936,0.1429186452245005,1093669.4388334716,5648.232195709991,1099317.6710291817,1471,13,689.2228571428572,88,87,37,33.04337526487001,0.6441761363636364,38.55337078651683,8366.292134831392,95.0715015321749,0
1473,32,0,0,173,0.0,0.0,1.0,173,5150,3600,1550,0.6990291262135923,67,36,31,209.60742386947555,0.4254114016220818,0.7475722280250789,0.1425719845948106,1094514.512471656,6133.673469387852,1100648.185941044,1472,14,691.5202312138729,69,104,37,32.970148687604315,0.6533816425120773,38.452380952380956,8369.523809523816,121.29744651483792,0
1474,32,0,1,172,0.0,0.005780346820809248,0.9942196531791907,173,5000,3400,1600,0.68,66,34,32,209.4799372715533,0.42514114800376396,0.7478104108473709,0.1429175669969735,1095363.6982300717,6291.343758954503,1101655.0419890261,1473,15,692.5202312138729,70,103,36,32.86991607790361,0.6538690476190476,38.35093896713616,8372.769953051664,119.61099932930948,0
1475,32,0,0,172,0.0,0.0,1.0,172,4900,3600,1300,0.7346938775510204,62,36,26,210.65631484833582,0.4246226030191758,0.7478684917059433,0.14431294817802717,1096514.9939534196,6897.5615604345,1103412.5555138541,1474,16,697.0639534883721,72,100,39,32.698771757694686,0.654224537037037,38.2134703196347,8377.168949771683,116.34956874682894,0
1476,32,1,0,173,0.005780346820809248,0.0,1.0,173,4900,3500,1400,0.7142857142857143,63,35,28,208.10267828505334,0.4250515302235964,0.7462026532769652,0.14318162750010313,1097721.854938273,6187.771604938383,1103909.6265432115,1475,0,694.028901734104,74,99,41,32.618599430864116,0.6547015765765766,38.06944444444445,8381.77777777779,113.26726726726743,0
1477,32,0,1,172,0.0,0.005780346820809248,0.9942196531791907,173,4100,2800,1300,0.6829268292682927,54,28,26,209.99152525890042,0.42499691938880674,0.7477550718305392,0.1448403084478052,1098412.8858154793,7431.479451284396,1105844.3652667638,1476,1,695.028901734104,76,97,43,32.48496230896325,0.6546052631578947,37.987012987012974,8384.415584415554,110.32125768967835,0
1478,32,0,0,172,0.0,0.0,1.0,172,4000,2800,1200,0.7,52,28,24,208.73512432477523,0.4245248538011696,0.7448589979089404,0.14439306022878776,1099221.19140625,7489.214409722253,1106710.4058159722,1477,2,698.5348837209302,79,93,38,32.419481702268584,0.6542721518987342,37.890625,8387.5,106.17088607594937,0
1479,32,0,0,172,0.0,0.0,1.0,172,3850,2700,1150,0.7012987012987013,50,27,23,207.41392073356263,0.424145190171812,0.742602910939572,0.14411557361225014,1100448.486108994,7399.667013835979,1107848.1531228302,1478,3,699.5348837209302,80,92,40,32.304794128704295,0.6553385416666666,37.74434156378601,8392.181069958848,104.9022633744856,0
1480,32,0,1,171,0.0,0.005813953488372093,0.9941860465116279,172,5300,4100,1200,0.7735849056603774,65,41,24,207.24501636557187,0.4237364851081191,0.7411325130451571,0.14443137240921172,1101279.407787997,5946.933778018309,1107226.3415660153,1479,4,700.5348837209302,85,87,40,32.20817943982763,0.6544117647058824,37.64534883720931,8395.34883720933,98.76880984952153,0
1481,32,0,0,171,0.0,0.0,1.0,171,5800,4500,1300,0.7758620689655172,71,45,26,204.1007496421502,0.4227998509345259,0.7338371618325032,0.13745083073365977,1091711.9138296172,4563.844001178029,1096275.7578307951,1480,22,705.6081871345029,88,83,38,33.45608552140274,0.6418087121212122,38.78745318352058,8358.801498127295,94.98638066053745,8
1482,32,0,0,171,0.0,0.0,1.0,171,4750,3200,1550,0.6736842105263158,63,32,31,204.32875943248652,0.42245728700837065,0.7355701242952262,0.13827858478465171,1093089.6111968416,5719.92884087775,1098809.5400377193,1481,23,706.6081871345029,89,82,40,33.28199493719466,0.6431413857677903,38.622685185185176,8364.074074074048,93.97836038285446,0
1483,32,0,0,171,0.0,0.0,1.0,171,4500,3300,1200,0.7333333333333333,57,33,24,205.8866276001524,0.42213478958835,0.7381667640958283,0.13984482197177445,1094120.7117167844,6352.96470456942,1100473.6764213538,1482,24,707.6081871345029,73,98,41,33.11549003247744,0.6508276255707763,38.49943693693694,8368.018018018018,114.630383808466,0
1484,32,0,0,171,0.0,0.0,1.0,171,4900,3500,1400,0.7142857142857143,63,35,28,204.1076332106563,0.4221247563352826,0.7349815181888153,0.1393142232972699,1095488.1580149657,5619.499028547256,1101107.657043513,1483,25,708.6081871345029,75,96,42,32.995314109615364,0.6515277777777777,38.33607456140351,8373.245614035084,111.64327485380112,0
1485,32,1,0,172,0.005813953488372093,0.0,1.0,172,5400,4000,1400,0.7407407407407407,68,40,28,199.07090066357677,0.4220166655333424,0.7310927961070925,0.1368147484076111,1097410.949545123,3892.5172248037616,1101303.4667699267,1484,0,705.4825581395348,78,94,43,32.89300339005806,0.6525106837606838,38.106540084388186,8380.59071729958,107.44347073460999,0
1486,32,1,1,172,0.005780346820809248,0.005780346820809248,0.9942196531791907,173,4450,3200,1250,0.7191011235955056,57,32,25,197.81152120747944,0.42225937626025,0.7299983275869519,0.13637758641767972,1098287.16472315,4400.770955307181,1102687.9356784571,1485,0,702.3988439306358,82,91,41,32.81938589768155,0.651930894308943,38.002008032128515,8383.93574297189,102.24311881673036,0
1487,32,0,1,171,0.0,0.005813953488372093,0.9941860465116279,172,4700,3300,1400,0.7021276595744681,61,33,28,197.5333223194147,0.4217793757649939,0.7289807972715798,0.13680683823869152,1099551.3927385723,4339.607933718176,1103891.0006722906,1486,1,706.6395348837209,85,87,38,32.67294852839256,0.652328431372549,37.85125968992249,8388.759689922517,98.69129046967667,0
1488,32,0,1,170,0.0,0.005847953216374269,0.9941520467836258,171,4550,2900,1650,0.6373626373626373,62,29,33,196.37067599234953,0.420651301456255,0.7263427533301028,0.13651220747738557,1100589.90849004,4474.71686410947,1105064.6253541496,1487,2,711.1988304093567,86,85,38,32.57722742144108,0.6532218992248062,37.72749042145594,8392.720306513413,97.58977100596991,0
1489,32,0,0,170,0.0,0.0,1.0,170,5000,3900,1100,0.78,61,39,22,195.98228678488383,0.4198398886181692,0.7247422292971404,0.13663887528848764,1101393.9557001533,4170.741217833141,1105564.6969179865,1488,4,716.3705882352941,86,84,39,32.48975113707236,0.6541908914728682,37.63170498084292,8395.785440613043,97.62541210015166,0
1490,32,0,0,170,0.0,0.0,1.0,170,3600,2500,1100,0.6944444444444444,47,25,22,196.31114187617183,0.4196977607611092,0.7264336633311597,0.13718106594958648,1102024.5078010126,5667.9379003886115,1107692.4457014012,1489,5,717.3705882352941,91,79,43,32.40455620748667,0.6532738095238095,37.55661231884058,8398.188405797095,92.28778467908896,0
1491,32,0,0,170,0.0,0.0,1.0,170,5100,3500,1600,0.6862745098039216,67,35,32,198.05190397001905,0.41913867618053136,0.7294455042805108,0.1390537549326575,1103327.8580523105,4603.2365980847035,1107931.0946503952,1490,6,718.3705882352941,73,97,42,32.200649959796294,0.6619577625570776,37.40146396396397,8403.153153153165,115.11168702949541,0
1492,32,0,0,170,0.0,0.0,1.0,170,4900,3600,1300,0.7346938775510204,62,36,26,196.23916154532725,0.4188798004408864,0.7268349940007313,0.1383489697558798,1104458.1054988052,4447.586517005177,1108905.6920158104,1491,7,719.3705882352941,75,95,44,32.11114516493645,0.6623611111111112,37.26699561403508,8407.45614035086,112.09941520467812,0
1493,32,0,0,170,0.0,0.0,1.0,170,4000,2900,1100,0.725,51,29,22,195.90003426964847,0.41858321731059284,0.7272865591793665,0.1385169268862381,1105264.889196675,5304.285934133559,1110569.1751308085,1492,8,720.3705882352941,75,95,46,32.02223265192602,0.6633333333333333,37.171052631578945,8410.526315789468,112.1403508771929,0
1494,32,1,0,171,0.005847953216374269,0.0,1.0,171,5250,3700,1550,0.7047619047619048,68,37,31,191.70669542201782,0.41818025455796354,0.7220195703780907,0.136354762236787,1106879.3402777747,2989.2361111109276,1109868.5763888857,1493,0,717.1520467836257,81,90,46,31.936881188118818,0.6626800411522633,36.97916666666666,8416.666666666642,103.90946502057584,0
1495,32,0,0,171,0.0,0.0,1.0,171,5850,4400,1450,0.7521367521367521,73,44,29,192.70647049735604,0.4179781561747506,0.723297475036855,0.1375391388322699,1107818.8996952905,2646.7740221086647,1110465.6737173991,1494,1,718.1520467836257,83,88,37,31.796827136057296,0.6630271084337349,36.86755952380951,8420.238095238063,101.44865174985618,0
1496,32,0,1,170,0.0,0.005847953216374269,0.9941520467836258,171,4450,2600,1850,0.5842696629213483,63,26,37,191.52756678965648,0.4178133241600734,0.7228485623379917,0.13711823474684748,1108654.3982465635,3817.575861362874,1112471.9741079265,1495,2,719.1520467836257,83,88,39,31.72674149275291,0.664031124497992,36.76835317460316,8423.412698412669,101.48689998087552,0
1497,32,0,1,169,0.0,0.0058823529411764705,0.9941176470588236,170,4350,3100,1250,0.7126436781609196,56,31,25,196.7909916964223,0.4170712959740109,0.7285726019521155,0.14117043260760015,1109201.3288158374,5306.165897731495,1114507.4947135688,1496,12,724.3705882352941,84,86,40,31.521992087502902,0.6643105158730158,36.70343137254901,8425.49019607841,100.30345471521916,0
1498,32,0,1,168,0.0,0.005917159763313609,0.9940828402366864,169,4600,3200,1400,0.6956521739130435,60,32,28,195.23689056592286,0.41637315675777214,0.7252504129673341,0.14050489291309545,1110069.7672750212,4945.313934802479,1115015.0812098237,1497,13,721.810650887574,87,82,41,31.457846485709105,0.664272030651341,36.60037878787878,8428.787878787864,96.88261929641223,0
1499,32,0,0,168,0.0,0.0,1.0,168,4300,3100,1200,0.7209302325581395,55,31,24,197.43587969384222,0.4158817781104458,0.7272682053322723,0.14240206773251896,1110668.4834854207,5957.161817033837,1116625.6453024545,1498,14,726.875,87,81,42,31.327500224638307,0.6649904214559387,36.529356060606055,8431.060606060593,96.90874259839762,0
1500,32,0,0,168,0.0,0.0,1.0,168,5350,3500,1850,0.6542056074766355,72,35,37,197.15748430447593,0.41506050399201594,0.727516371689864,0.14265116114678203,1111522.0053268475,4878.976463861587,1116400.981790709,1499,15,727.875,68,100,42,31.231623613418115,0.6744791666666667,36.428140096618364,8434.299516908228,124.033816425121,0
1501,32,0,0,168,0.0,0.0,1.0,168,4550,3500,1050,0.7692307692307693,56,35,21,191.0624434185498,0.41505753374203974,0.7179001775503209,0.1387286008617438,1112471.0735024286,4360.2883071662145,1116831.3618095948,1500,16,728.875,72,96,42,31.277621444161817,0.6734664351851851,36.31563926940639,8437.899543378991,117.1930492135971,0
1502,32,0,0,168,0.0,0.0,1.0,168,4400,3300,1100,0.75,55,33,22,189.25462809784108,0.41467734174508125,0.714765241161119,0.13766207363763822,1112952.740898852,4126.29141385692,1117079.032312709,1501,17,729.875,72,96,42,31.26713286082706,0.6740451388888888,36.258561643835606,8439.726027397235,117.21841704718382,0
1503,32,0,0,168,0.0,0.0,1.0,168,4400,3400,1000,0.7727272727272727,54,34,20,187.65651179027935,0.41461793674555647,0.7127560095543013,0.13672951131220212,1113405.2126450785,3787.547682818051,1117192.7603278966,1502,18,730.875,73,95,41,31.254669156883672,0.6740867579908676,36.20495495495496,8441.441441441448,115.63618412933491,0
1504,32,0,0,168,0.0,0.0,1.0,168,4800,3400,1400,0.7083333333333334,62,34,28,189.95510108695174,0.4142065571238476,0.7170323319768535,0.13877234314014003,1114118.2863606834,3926.4903416928937,1118044.7767023763,1503,19,731.875,73,95,43,31.10796970020272,0.6749429223744292,36.12049549549549,8444.144144144133,115.67320745402922,0
1505,32,1,0,169,0.005917159763313609,0.0,1.0,169,4100,3000,1100,0.7317073170731707,52,30,22,185.333459211893,0.41414394899971824,0.7112982733386621,0.1360075162813334,1115325.5465154496,3441.428336620608,1118766.9748520702,1504,0,728.5384615384615,77,92,44,31.084344967121915,0.674512987012987,35.9775641025641,8448.717948717944,109.72360972360966,0
1506,32,0,0,169,0.0,0.0,1.0,169,4600,3100,1500,0.6739130434782609,61,31,30,187.22543173142347,0.4139898562975486,0.7128857566657378,0.13785364365415337,1116214.2605251744,3396.7393663194985,1119610.999891494,1505,1,729.5384615384615,79,90,44,30.92725536110427,0.6747099156118144,35.872395833333336,8452.08333333334,106.98839662447266,0
1507,32,0,0,169,0.0,0.0,1.0,169,4050,2800,1250,0.691358024691358,53,28,25,186.0029455960353,0.41370808678500987,0.7108058163627196,0.1371231017533563,1116544.4444444454,3686.1111111111213,1120230.5555555564,1506,2,730.5384615384615,79,90,38,30.91975552050474,0.6751054852320675,35.833333333333336,8453.33333333334,107.00421940928278,0
1508,32,0,0,169,0.0,0.0,1.0,169,5150,3600,1550,0.6990291262135923,67,36,31,186.28110393051304,0.412947896120973,0.7106439463883203,0.1381558781888404,1118144.1869063815,2707.8266980811454,1120852.0136044626,1507,3,731.5384615384615,86,83,39,30.719707263312035,0.674297480620155,35.64415708812259,8459.386973180033,98.36496480441899,0
1509,32,0,0,169,0.0,0.0,1.0,169,4950,3600,1350,0.7272727272727273,63,36,27,184.8048414336649,0.41229777167277165,0.7095383804814783,0.13766074923119936,1119302.6675068263,2620.5103969754323,1121923.1779038017,1508,4,732.5384615384615,91,78,43,30.619292237442913,0.673992673992674,35.507246376811594,8463.76811594203,93.0084408345278,0
1510,32,0,0,169,0.0,0.0,1.0,169,5200,3900,1300,0.75,65,39,26,185.96923979116067,0.41191620879120877,0.7125212846600639,0.13899433700615232,1120191.940077378,2664.2487032752224,1122856.188780653,1509,5,733.5384615384615,71,98,47,30.481493885213343,0.6832453051643192,35.40219907407408,8467.129629629653,119.2553468961923,0
1511,32,0,0,169,0.0,0.0,1.0,169,4800,3100,1700,0.6458333333333334,65,31,34,184.60010345616698,0.4114187094956326,0.710596608921523,0.1384684860587643,1121142.3363819905,2792.598257040844,1123934.9346390313,1510,6,734.5384615384615,73,96,47,30.403427723123283,0.6833618721461188,35.28997747747748,8470.720720720723,116.03727014685921,0
1512,32,0,0,169,0.0,0.0,1.0,169,5250,3600,1650,0.6857142857142857,69,36,33,184.7429943506192,0.4110532896590589,0.7093297636730105,0.13918783887946487,1122303.327903291,2417.535473303713,1124720.8633765946,1511,7,735.5384615384615,78,91,49,30.2600899465631,0.6824252136752137,35.15295358649789,8475.105485232061,108.65519852861617,0
1513,32,0,0,169,0.0,0.0,1.0,169,5250,3900,1350,0.7428571428571429,66,39,27,184.80530493344,0.4107201559124636,0.7102535147398972,0.13976901026110156,1123309.301505276,2468.703599850298,1125778.0051051262,1512,8,736.5384615384615,78,91,49,30.13757568217634,0.6836271367521367,35.03428270042193,8478.902953586477,108.70388402033946,0
1514,32,0,1,168,0.0,0.005917159763313609,0.9940828402366864,169,4500,3000,1500,0.6666666666666666,60,30,30,183.60227688906642,0.4102373321123321,0.7086802041239286,0.1394538443548712,1124428.9594235262,2989.5434300325132,1127418.5028535586,1513,9,737.5384615384615,80,89,47,30.035008570227326,0.6841145833333333,34.902263374485585,8483.127572016434,106.03909465020543,0
1515,32,0,0,168,0.0,0.0,1.0,168,4000,2900,1100,0.725,51,29,22,180.16505077041802,0.4096256890979945,0.7014742335290296,0.13757373123682515,1125819.699837746,2966.672675920662,1128786.3725136667,1514,10,742.1488095238095,85,83,42,29.95928462709287,0.6838235294117647,34.738372093023244,8488.372093023225,99.86320109439087,0
1516,32,0,0,168,0.0,0.0,1.0,168,4400,3200,1200,0.7272727272727273,56,32,24,181.09982231596007,0.4089358485410132,0.7028376574967026,0.13877985334453863,1126745.221234448,2810.6718721831003,1129555.8931066312,1515,11,743.1488095238095,85,83,44,29.82350289835228,0.6849264705882353,34.62936046511627,8491.860465116257,99.90424076607361,0
1517,32,0,0,168,0.0,0.0,1.0,168,5050,3400,1650,0.6732673267326733,67,34,33,182.91354528923418,0.4085408052941735,0.7054322230694205,0.14083764756885467,1127979.8412993478,2614.558357370169,1130594.399656718,1516,12,744.1488095238095,85,83,46,29.627364551495475,0.6863970588235294,34.484011627906966,8496.511627906952,99.95896032831708,0
1518,32,0,0,168,0.0,0.0,1.0,168,5450,4200,1250,0.7706422018348624,67,42,25,184.19989385075579,0.4084442721699458,0.7065695880513514,0.14228217313971733,1128807.8725137187,2535.2580589849563,1131343.1305727037,1517,13,745.1488095238095,89,79,47,29.49397758798491,0.6859784644194756,34.386574074074076,8499.629629629639,95.50145651269257,0
1519,32,0,0,168,0.0,0.0,1.0,168,4700,3700,1000,0.7872340425531915,57,37,20,181.50584994452873,0.40785244986218044,0.6996035382183827,0.14081757173421502,1129941.389779053,2718.1944678698837,1132659.5842469228,1518,14,746.1488095238095,76,92,48,29.429787721441638,0.6924342105263157,34.253246753246756,8503.89610389611,111.89336978810671,0
1520,32,0,1,167,0.0,0.005952380952380952,0.9940476190476191,168,4850,3200,1650,0.6597938144329897,65,32,33,181.21022666484873,0.4073074089915407,0.6990827323689566,0.14131034148968818,1131261.1160070498,2549.216649753401,1133810.3326568033,1519,15,747.1488095238095,78,90,50,29.279686931799404,0.6931089743589743,34.098101265822784,8508.860759493668,109.08795845504702,0
1521,32,0,1,166,0.0,0.005988023952095809,0.9940119760479041,167,3500,1800,1700,0.5142857142857142,52,18,34,182.2870347425863,0.40707139936993486,0.6985082116948789,0.14256353544110106,1132007.3350694461,4370.052083333416,1136377.3871527796,1520,16,750.5209580838323,79,88,49,29.16177142484172,0.6935654008438819,34.01041666666667,8511.66666666668,107.74261603375545,0
1522,32,0,0,166,0.0,0.0,1.0,166,5350,3900,1450,0.7289719626168224,68,39,29,181.47156667961417,0.4067656991602775,0.6954385615537391,0.14239014737079625,1132844.8645404668,2565.826474622824,1135410.6910150896,1521,17,748.4457831325301,80,86,47,29.0832970856894,0.694140625,33.91203703703704,8514.81481481482,106.43518518518525,0
1523,32,0,0,166,0.0,0.0,1.0,166,4000,2800,1200,0.7,52,28,24,183.19350573634287,0.4063823475721066,0.6990102448741129,0.14407921667371854,1133445.8655562191,4327.98433472151,1137773.8498909406,1522,18,749.4457831325301,81,85,54,28.965611874761358,0.6944444444444444,33.841463414634156,8517.073170731728,105.14905149051516,0
1524,32,0,0,166,0.0,0.0,1.0,166,3300,2600,700,0.7878787878787878,40,26,14,204.47826712361487,0.4063070463672873,0.7221543447244523,0.16173064877488721,1134888.048680664,9911.988314704517,1144800.0369953685,1523,19,750.4457831325301,82,84,39,28.22636382200021,0.6957571138211383,33.67218875502007,8522.48995983934,103.93280438828464,8
1525,32,0,0,166,0.0,0.0,1.0,166,5050,3700,1350,0.7326732673267327,64,37,27,206.96034223609712,0.40553349762687113,0.7235334299073133,0.16412436442443945,1135556.6406249974,8753.0381944444,1144309.678819442,1524,20,751.4457831325301,83,83,39,28.080197132616487,0.6961596385542168,33.59374999999999,8524.99999999998,102.71084337349373,0
1526,32,0,0,166,0.0,0.0,1.0,166,4900,3500,1400,0.7142857142857143,63,35,28,211.46810389895649,0.40498585250091274,0.7284419423541268,0.16825846060320127,1136402.5322223778,9962.577751007699,1146365.1099733855,1525,21,752.4457831325301,83,83,40,27.85880329750438,0.6971636546184738,33.494543650793645,8528.174603174588,102.74909160451311,0
1527,32,0,1,165,0.0,0.006024096385542169,0.9939759036144579,166,4850,3400,1450,0.7010309278350515,63,34,29,215.33513953249636,0.4046032615309724,0.7381440024695969,0.15920679988386244,1117315.0634765648,10069.43901909735,1127384.502495662,1526,22,753.4457831325301,79,87,34,30.051788207276008,0.6760284810126582,35.74218750000001,8456.250000000018,107.04113924050655,7
1528,32,0,0,165,0.0,0.0,1.0,165,4200,2700,1500,0.6428571428571429,57,27,30,215.46544153236704,0.40367547425474254,0.7377561896108882,0.15992392186774718,1118349.2382179939,10993.122480005413,1129342.3606979994,1527,23,753.6,81,84,37,29.92344160420272,0.6764403292181069,35.619918699187,8460.16260162603,104.4464518719263,0
1529,32,0,0,165,0.0,0.0,1.0,165,4200,3000,1200,0.7142857142857143,54,30,24,217.878550558265,0.40346144370534615,0.7422422452287891,0.16231685661394463,1119334.6113040124,11575.800540123442,1130910.4118441357,1528,24,754.6,83,82,41,29.740660212230594,0.6768323293172691,35.50347222222222,8463.888888888889,101.97456492637215,0
1530,32,0,0,165,0.0,0.0,1.0,165,5500,4300,1200,0.7818181818181819,67,43,24,213.60654787415217,0.40344912540034494,0.7383705674741758,0.15995220079293637,1120690.6181809183,9377.370836915154,1130067.9890178335,1529,25,755.6,70,95,38,29.69006966387641,0.684375,35.343309859154935,8469.014084507056,120.98591549295794,0
1531,32,0,0,165,0.0,0.0,1.0,165,5150,3900,1250,0.7572815533980582,64,39,25,212.49739431715045,0.40306417836905645,0.7364121516790767,0.1597090272442783,1121662.4101133845,9520.067890517934,1131182.4780039024,1530,26,756.6,71,94,39,29.602264448208658,0.685005868544601,35.22858796296297,8472.685185185197,119.33359415753799,0
1532,32,0,0,165,0.0,0.0,1.0,165,4700,3300,1400,0.7021276595744681,61,33,28,211.83282834468076,0.40261148066026115,0.7365123198375736,0.16007733511907593,1123091.8382904886,9881.544119180326,1132973.382409669,1531,27,757.6,72,93,41,29.44763110177557,0.6861979166666667,35.059931506849324,8478.082191780843,117.7511415525117,0
1533,32,0,1,164,0.0,0.006060606060606061,0.9939393939393939,165,5850,4400,1450,0.7521367521367521,73,44,29,209.5128469236267,0.402229613205223,0.7341779812143092,0.15880466513196687,1123886.5047479956,8243.732245759507,1132130.2369937552,1532,28,758.6,73,92,43,29.41341795906807,0.6866438356164384,34.96621621621623,8481.081081081116,116.17919289152213,0
1534,32,0,0,164,0.0,0.0,1.0,164,5050,3900,1150,0.7722772277227723,62,39,23,208.67953153579884,0.4012333844580777,0.7302887948254879,0.15856893290062316,1124540.8895307502,9083.733204025768,1133624.622734776,1533,29,763.7256097560976,76,88,45,29.356746780969885,0.6859923245614035,34.889069264069285,8483.549783549835,111.62565504670836,0
1535,32,0,3,161,0.0,0.018292682926829267,0.9817073170731707,164,4250,3000,1250,0.7058823529411765,55,30,25,208.53181214299232,0.4009278829368048,0.7309251898325868,0.15899957806839166,1125434.5034627707,9887.779291068378,1135322.2827538392,1534,30,764.7256097560976,78,86,39,29.253152862019828,0.6861645299145299,34.78375527426162,8486.919831223679,108.80666450286768,0
1536,32,0,1,160,0.0,0.006211180124223602,0.9937888198757764,161,5100,3600,1500,0.7058823529411765,66,36,30,210.85873599610713,0.3994775491718427,0.7281541296683256,0.1616213575906991,1126804.3646918484,10219.308810764274,1137023.6735026126,1535,31,775.2111801242236,79,82,39,29.026677215707444,0.6873681434599156,34.62239583333336,8492.083333333396,107.49472573839742,0
1537,32,0,0,160,0.0,0.0,1.0,160,4400,3200,1200,0.7272727272727273,56,32,24,216.38485694105,0.39887644129979033,0.7335966653908701,0.16664982607891815,1128042.5941073461,12418.267069865866,1140460.861177212,1536,32,780.10625,81,79,40,28.731102286862512,0.6880144032921811,34.47662601626017,8496.747967479696,104.8981230553049,0
1538,32,0,0,160,0.0,0.0,1.0,160,3800,2200,1600,0.5789473684210527,54,22,32,213.48542794513804,0.3984849973794549,0.7302322120547173,0.16489882369841039,1128800.8457144448,12396.506322436404,1141197.3520368813,1537,33,781.10625,83,77,42,28.716958852732,0.6881275100401607,34.3874007936508,8499.603174603186,102.4048575253396,0
1539,32,0,0,160,0.0,0.0,1.0,160,4800,3400,1400,0.7083333333333334,62,34,28,212.104276214845,0.3983629782494759,0.7285892787142294,0.16446140079758936,1129791.8402777766,11126.736111111042,1140918.5763888876,1538,34,782.10625,69,91,41,28.63460407683261,0.6958031400966184,34.27083333333333,8503.333333333323,123.23671497584526,0
1540,32,0,0,160,0.0,0.0,1.0,160,4350,2900,1450,0.6666666666666666,58,29,29,211.02313562384387,0.39788636661425575,0.7259919986936643,0.1639981830660428,1130382.426697528,11357.368827160282,1141739.7955246882,1539,35,783.10625,71,89,43,28.592423252775948,0.6954225352112676,34.20138888888888,8505.555555555533,119.79655712050047,0
1541,32,0,0,160,0.0,0.0,1.0,160,4300,3200,1100,0.7441860465116279,54,32,22,212.67996755919017,0.3977676231656184,0.7282965799640866,0.1656812108450711,1130997.7849847793,11808.114444015624,1142805.8994287949,1540,36,784.10625,71,89,43,28.474508443525412,0.696156103286385,34.12905092592592,8507.870370370349,119.82916014606124,0
1542,32,0,0,160,0.0,0.0,1.0,160,4200,2600,1600,0.6190476190476191,58,26,32,221.58389748973678,0.3975653498427673,0.7411465897867879,0.16086561060695287,1112430.3490544544,13099.330485871058,1125529.6795403254,1541,37,785.10625,67,93,41,30.477751796123098,0.6761504975124378,36.320465686274524,8437.745098039248,125.93649400058578,8
1543,32,0,0,160,0.0,0.0,1.0,160,3700,2400,1300,0.6486486486486487,50,24,26,220.0319830359321,0.3969757272012579,0.7396409180651524,0.16035424375208632,1113464.6267361147,13299.565972222457,1126764.1927083372,1542,38,786.10625,67,93,42,30.39342711418229,0.6773942786069651,36.19791666666668,8441.666666666695,125.99502487562232,0
1544,32,0,2,158,0.0,0.0125,0.9875,160,4500,3500,1000,0.7777777777777778,55,35,20,217.02887780872268,0.3967554376310272,0.7361425913396475,0.1587963769313333,1114532.6530612286,11877.154195011575,1126409.8072562402,1543,39,787.10625,69,91,40,30.34341640354836,0.677536231884058,36.071428571428584,8445.714285714315,122.40165631470022,0
1545,32,0,0,158,0.0,0.0,1.0,158,4900,3400,1500,0.6938775510204082,64,34,30,216.51412677276556,0.3958719664597275,0.7320922530702103,0.15872773287355035,1115052.8904374614,11784.940575703265,1126837.8310131647,1544,40,789.1139240506329,71,87,41,30.294078021957954,0.6770833333333333,36.009837962962976,8447.685185185219,118.98148148148195,0
1546,32,0,0,158,0.0,0.0,1.0,158,4100,3100,1000,0.7560975609756098,51,31,20,215.7060546461273,0.39563008949447714,0.730981197320077,0.15867598010296236,1115965.524071644,12444.10406371858,1128409.6281353626,1545,41,790.1139240506329,72,86,42,30.20506897918017,0.677662037037037,35.90182648401827,8451.141552511435,117.37696600710326,0
1547,32,0,0,158,0.0,0.0,1.0,158,4400,3200,1200,0.7272727272727273,56,32,24,215.4126153059076,0.39536049746029184,0.731743822446286,0.15913066516754015,1117091.883902486,12127.136849687671,1129219.0207521736,1546,42,791.1139240506329,73,85,39,30.076702981549566,0.6785102739726028,35.76858108108109,8455.405405405423,115.8274713069236,0
1548,32,0,0,158,0.0,0.0,1.0,158,4250,2400,1850,0.5647058823529412,61,24,37,214.2482059187827,0.39488262248380773,0.7315615139723128,0.15883802048751774,1118044.272101495,12057.795887103375,1130102.0679885983,1547,43,792.1139240506329,73,85,39,29.992445018371576,0.6796518264840183,35.65596846846847,8459.009009009022,115.87683573984961,0
1549,32,0,0,158,0.0,0.0,1.0,158,4400,3600,800,0.8181818181818182,52,36,16,217.42998111640813,0.3943686339326507,0.7350794491454038,0.1617038648160272,1118877.9446676418,12655.522076130243,1131533.466743772,1548,44,793.1139240506329,73,85,40,29.80765818517336,0.6806506849315068,35.557432432432435,8462.16216216217,115.92002961865987,0
1550,32,0,0,158,0.0,0.0,1.0,158,3550,2600,950,0.7323943661971831,45,26,19,216.65614712507158,0.39394954849633157,0.7341640951361346,0.16128846508199746,1119141.2742382248,13343.767313019289,1132485.0415512442,1549,45,794.1139240506329,75,83,40,29.796330845771156,0.6799999999999999,35.52631578947368,8463.157894736825,112.84210526315768,0
1551,32,0,0,158,0.0,0.0,1.0,158,4450,3500,950,0.7865168539325843,54,35,19,213.04050947181793,0.39344563815205996,0.7295750345832899,0.15931236692488315,1120332.7269127006,11685.250983886566,1132017.9778965872,1550,46,795.1139240506329,66,92,41,29.748212886799823,0.6862373737373737,35.385572139303484,8467.661691542291,128.29790441730745,0
1552,32,0,0,158,0.0,0.0,1.0,158,3600,2600,1000,0.7222222222222222,46,26,20,212.4248900890974,0.39313069418689023,0.728700921617456,0.1590838676232917,1120718.026870676,12413.680735774778,1133131.707606451,1551,47,796.1139240506329,67,91,40,29.718037950261404,0.6861007462686567,35.34007352941177,8469.117647058834,126.40474100087812,0
1553,32,0,0,158,0.0,0.0,1.0,158,4350,3600,750,0.8275862068965517,51,36,15,210.2857359125475,0.39297616168131366,0.7250732628859577,0.1583591080082353,1122182.1377206924,11245.779331702355,1133427.9170523947,1552,48,797.1139240506329,70,88,41,29.598198622421666,0.6861607142857142,35.16725352112677,8474.64788732396,121.06639839034227,0
1554,32,0,0,158,0.0,0.0,1.0,158,3900,2600,1300,0.6666666666666666,52,26,26,206.65714797464014,0.3929257706468865,0.719732335076829,0.15614187804218038,1123050.967986571,10917.302014852901,1133968.2700014238,1553,49,798.1139240506329,73,85,42,29.58967598250181,0.6856449771689498,35.06475225225226,8477.927927927953,116.13599901271168,0
1555,32,0,1,157,0.0,0.006329113924050633,0.9936708860759493,158,3700,2600,1100,0.7027027027027027,48,26,22,207.74095649275407,0.39265785831384875,0.721186477717821,0.15724662267696418,1123528.3795197238,11380.572041636331,1134908.9515613602,1554,50,799.1139240506329,73,85,44,29.503486055776897,0.6862157534246576,35.00844594594595,8479.72972972974,116.16068122917451,0
1556,32,0,0,157,0.0,0.0,1.0,157,3600,2500,1100,0.6944444444444444,47,25,22,207.99901993562457,0.3919306984593609,0.7208240416268452,0.15808932774283938,1124602.926406138,11783.2613018425,1136386.1877079806,1555,71,804.8853503184713,73,84,45,29.367323280591844,0.6875,34.881756756756765,8483.783783783801,116.21621621621645,0
1557,32,0,0,157,0.0,0.0,1.0,157,3350,2100,1250,0.6268656716417911,46,21,25,208.25872482227697,0.3919000762153628,0.7212563522472444,0.1586788544196558,1125249.493827166,12118.604938271854,1137368.098765438,1556,72,805.8853503184713,74,83,47,29.282649872560306,0.6877815315315315,34.80555555555557,8486.222222222264,114.67867867867925,0
1558,32,0,0,157,0.0,0.0,1.0,157,4450,3500,950,0.7865168539325843,54,35,19,204.7936822555871,0.39168742174315424,0.7172423914963466,0.15692315902834428,1126722.5126965435,10299.130451078712,1137021.6431476222,1557,73,806.8853503184713,76,81,41,29.19746635399674,0.6885964912280702,34.632034632034646,8491.774891774929,111.73388015493327,0
1559,32,0,0,157,0.0,0.0,1.0,157,3950,2900,1050,0.7341772151898734,50,29,21,206.6373280815175,0.39133696717295446,0.7190304396404148,0.15875636850491523,1127411.8855531188,11243.075935608367,1138654.9614887272,1558,74,807.8853503184713,76,81,43,29.065695817619687,0.6894188596491229,34.5508658008658,8494.37229437229,111.76805650489855,0
1560,32,0,0,157,0.0,0.0,1.0,157,4650,3300,1350,0.7096774193548387,60,33,27,190.18646561825167,0.3913114486362894,0.6882022092796234,0.13668324772706558,1109699.2143211386,6159.954294217367,1115859.1686153559,1559,75,808.8853503184713,83,74,37,31.635677120120533,0.6652861445783133,36.64434523809522,8427.380952380903,101.53471026964944,8
1561,32,0,0,157,0.0,0.0,1.0,157,4300,3100,1200,0.7209302325581395,55,31,24,222.27274708136565,0.3910613669769721,0.73298840482608,0.14336838608862346,1079372.5765306111,12283.021541950067,1091655.5980725612,1560,76,809.8853503184713,69,88,43,34.49471945303846,0.634963768115942,40.26785714285714,8311.428571428562,120.45548654244293,8
1562,32,1,0,158,0.006329113924050633,0.0,1.0,158,4500,3300,1200,0.7333333333333333,57,33,24,218.5131786619336,0.392123713348921,0.7296491717612439,0.1416078911068889,1080733.50694444,11130.902777777537,1091864.4097222176,1561,0,805.753164556962,73,85,45,34.42510020040078,0.634560502283105,40.10416666666665,8316.666666666631,113.92694063926892,0
1563,32,1,1,158,0.006289308176100629,0.006289308176100629,0.9937106918238994,159,5000,3700,1300,0.74,63,37,26,216.91230763565557,0.39275502215853303,0.7285638444219693,0.1413850101576979,1082400.1479289895,10157.182774490273,1092557.3307034797,1562,0,801.6792452830189,77,82,39,34.26204046005339,0.6347402597402597,39.90384615384614,8323.076923076887,108.09190809190763,0
1564,32,0,0,158,0.0,0.0,1.0,158,4900,3600,1300,0.7346938775510204,62,36,26,220.0224933754567,0.3916248421080921,0.7303220199286113,0.14392256900114786,1083421.8635946847,11175.435961117204,1094597.299555802,1563,2,807.753164556962,78,80,41,34.05571742251497,0.6355502136752137,39.781118143459906,8327.004219409262,106.7564643514008,0
1565,32,1,0,159,0.006289308176100629,0.0,1.0,159,4950,3800,1150,0.7676767676767676,61,38,23,215.22128332133204,0.39229062176578294,0.7264757499049739,0.14143978985596192,1084759.4467474425,9942.664044784216,1094702.1107922266,1564,0,803.6666666666666,83,76,43,34.016615468876466,0.6351656626506024,39.620535714285694,8332.142857142806,100.38726333906995,0
1566,32,0,1,158,0.0,0.006289308176100629,0.9937106918238994,159,4050,3000,1050,0.7407407407407407,51,30,21,213.29134776079883,0.3927400950030518,0.7246738937966026,0.1410664844845566,1086579.6313799683,10501.606805293319,1097081.2381852616,1565,1,804.6666666666666,68,91,43,33.843847758081345,0.6443014705882353,39.4021739130435,8339.130434782655,122.63427109974494,0
1567,32,0,0,158,0.0,0.0,1.0,158,3900,2600,1300,0.6666666666666666,52,26,26,228.8236762230004,0.39251508371630517,0.7442205489123488,0.14844202585748478,1081030.2120472877,13973.06144575795,1095003.2734930457,1566,2,806.8227848101266,72,86,41,34.12064485434051,0.6354166666666667,40.06849315068493,8317.808219178078,115.52511415525107,7
1568,32,0,0,158,0.0,0.0,1.0,158,3950,2900,1050,0.7341772151898734,50,29,21,228.53908730521857,0.392417661049746,0.7436022457229963,0.14843145857665097,1081368.9012345679,13877.01234567904,1095245.913580247,1567,3,807.8227848101266,74,84,38,34.08639633864017,0.6348536036036037,40.02777777777778,8319.111111111111,112.42042042042043,0
1569,32,0,3,155,0.0,0.0189873417721519,0.9810126582278481,158,3850,2400,1450,0.6233766233766234,53,24,29,230.202780834137,0.39231016017630144,0.7452540699860466,0.14985398089991922,1082027.7479104588,14367.15930173723,1096394.9072121962,1568,4,808.8227848101266,76,82,36,33.96213737016422,0.6347313596491229,39.948593073593074,8321.645021645021,109.49532923217133,0
1570,32,0,0,155,0.0,0.0,1.0,155,3950,2900,1050,0.7341772151898734,50,29,21,237.59001591898215,0.3915950984499372,0.7484401136171084,0.15490482319682172,1082478.1002276954,16487.19781300961,1098965.298040705,1569,8,819.4774193548387,76,79,36,33.71463306808136,0.635279605263158,39.894480519480524,8323.376623376631,109.51811346548199,0
1571,32,0,0,155,0.0,0.0,1.0,155,5000,3900,1100,0.78,61,39,22,253.06313623532782,0.39179409300377044,0.7613866209691638,0.15083626582544887,1055954.8100597423,17444.647191299548,1073399.457251042,1570,9,820.4774193548387,68,87,34,36.59967483496894,0.6067708333333333,43.10084541062801,8220.772946859886,120.89371980676303,7
1572,32,2,0,157,0.012738853503184714,0.0,1.0,157,4350,3300,1050,0.7586206896551724,54,33,21,253.34286447481463,0.3941916408078829,0.7628306505735261,0.15214923180371753,1058244.3580461154,17869.73139634254,1076114.089442458,1571,0,811.0127388535032,72,85,37,36.30707984242356,0.607494212962963,42.82248858447487,8229.680365296761,114.30111618467724,0
1573,32,1,0,158,0.006329113924050633,0.0,1.0,158,4350,3300,1050,0.7586206896551724,54,33,21,251.86232382590038,0.3960651320916982,0.7631179171054823,0.15200609035867174,1059728.6303924879,17431.143095098225,1077159.773487586,1572,0,806.873417721519,62,96,37,36.16032230431525,0.6150873655913979,42.64219576719577,8235.449735449747,132.82983444273785,0
1574,32,1,0,159,0.006289308176100629,0.0,1.0,159,4100,3300,800,0.8048780487804879,49,33,16,245.96680622669186,0.3970407743544835,0.7576804649061535,0.14907854421971417,1061004.0429548007,16294.355167839974,1077298.3981226406,1573,0,802.7924528301887,65,94,39,36.15341791288715,0.6147435897435898,42.48737373737374,8240.40404040404,126.77544677544678,0
1575,32,0,1,158,0.0,0.006289308176100629,0.9937106918238994,159,3950,2900,1050,0.7341772151898734,50,29,21,244.6676905897297,0.39713531300586474,0.7559004490194074,0.14872133650300132,1061873.8552263542,16211.244771168942,1078085.0999975232,1574,1,803.7924528301887,66,93,39,36.07875678937838,0.6152146464646464,42.381840796019894,8243.78109452735,124.90577415950531,0
1576,32,0,1,157,0.0,0.006329113924050633,0.9936708860759493,158,4850,3600,1250,0.7422680412371134,61,36,25,246.31111004035645,0.39715273858475103,0.7561804204037295,0.15029782456235083,1063027.6826378063,15917.105702829214,1078944.7883406356,1575,2,799.9430379746835,66,92,39,35.89304742947908,0.616635101010101,42.241915422885576,8248.258706467665,124.97361676466159,0
1577,32,0,0,157,0.0,0.0,1.0,157,4050,2200,1850,0.5432098765432098,59,22,37,244.3947660050569,0.3967554031248299,0.7533556627454305,0.14962475799619954,1064021.3065364023,16558.247647071858,1080579.5541834743,1576,3,802.9936305732484,70,87,39,35.81906279038896,0.615625,42.12147887323944,8252.112676056344,117.88732394366205,0
1578,32,0,0,157,0.0,0.0,1.0,157,4400,3200,1200,0.7272727272727273,56,32,24,244.2654769221964,0.39654615112417657,0.7535547277817842,0.1499516318260237,1064830.803282878,16220.28080106762,1081051.0840839455,1577,4,803.9936305732484,72,85,31,35.72192414772204,0.6155960648148149,42.023401826484026,8255.25114155253,114.65626585489625,0
1579,32,0,0,157,0.0,0.0,1.0,157,4050,2700,1350,0.6666666666666666,54,27,27,246.02919424566917,0.39616677554575647,0.7563810650081753,0.15146740252854604,1065684.210392826,16987.88552065585,1082672.095913482,1578,5,804.9936305732484,73,84,32,35.570524708192465,0.6161529680365296,41.92004504504505,8258.558558558565,113.1309391583365,0
1580,32,0,1,156,0.0,0.006369426751592357,0.9936305732484076,157,3600,2400,1200,0.6666666666666666,48,24,24,245.99315571752578,0.39611743970820407,0.7569767569390562,0.15157615404026864,1065941.530864198,17442.86419753095,1083384.395061729,1579,6,805.9936305732484,74,83,33,35.539532214091,0.615990990990991,41.88888888888889,8259.55555555556,111.61561561561568,0
1581,32,1,0,157,0.006369426751592357,0.0,1.0,157,5550,4100,1450,0.7387387387387387,70,41,29,252.4541648349084,0.39609362240731666,0.7631629426331261,0.15634470869908854,1067442.3062957947,16946.051189070593,1084388.3574848652,1580,0,806.9490445859873,76,81,34,35.18654306115679,0.6169133771929824,41.70725108225108,8265.367965367952,108.75484164957831,0
1582,32,2,0,159,0.012578616352201259,0.0,1.0,159,5400,4300,1100,0.7962962962962963,65,43,22,257.0514841673807,0.39842899981423985,0.7703009581697697,0.16092718966781333,1070650.0771604895,17842.438271604708,1088492.5154320942,1581,0,797.7861635220125,65,94,34,34.670022371364645,0.6266025641025641,41.31944444444443,8277.777777777745,127.35042735042684,0
1583,32,0,0,159,0.0,0.0,1.0,159,3600,2200,1400,0.6111111111111112,50,22,28,259.9176274764403,0.3987126157683836,0.7717458184278125,0.1636252708926353,1072280.8570641803,20340.939271305077,1092621.7963354853,1582,1,798.7861635220125,66,93,35,34.39383020038836,0.6279987373737373,41.12251243781094,8284.079601990039,125.51635760590968,0
1584,32,0,0,159,0.0,0.0,1.0,159,4250,3300,950,0.7764705882352941,52,33,19,263.1017713878492,0.3989066687896399,0.7762295316694987,0.1664539489689458,1073737.8689987038,20450.467067954694,1094188.3360666584,1583,2,799.7861635220125,67,92,34,34.1309527329352,0.6291977611940298,40.946691176470594,8289.705882352951,123.7269534679545,0
1585,32,1,0,160,0.00625,0.0,1.0,160,4400,2700,1700,0.6136363636363636,61,27,34,263.79701069722944,0.39977234014675056,0.7793914427156983,0.16814324428682115,1075919.215901832,20364.854581322346,1096284.0704831544,1584,0,795.78125,70,90,35,33.84299858557285,0.6302083333333333,40.683685446009406,8298.122065727737,118.54460093896768,0
1586,32,0,0,160,0.0,0.0,1.0,160,5600,4000,1600,0.7142857142857143,72,40,32,259.3943293202775,0.39975514281970653,0.7765089139902013,0.16603044702486072,1077139.0724249112,18280.75345526521,1095419.8258801764,1585,1,796.78125,58,102,34,33.806392896026146,0.639367816091954,40.53672316384181,8302.824858757072,143.1521527371909,0
1587,32,0,0,160,0.0,0.0,1.0,160,4150,2900,1250,0.6987951807228916,54,29,25,257.75508131826933,0.3999074620020964,0.7745053779356623,0.16553168530287302,1078107.7415345318,19427.54971781768,1097535.2912523495,1586,2,797.78125,60,100,37,33.72927767910004,0.6390625,40.42008196721311,8306.557377049165,138.4426229508194,0
1588,32,0,0,160,0.0,0.0,1.0,160,4250,2800,1450,0.6588235294117647,57,28,29,255.44479053518126,0.39977397798742137,0.773108302606895,0.16474430608608132,1079336.6691597302,18892.18587408953,1098228.8550338198,1587,3,798.78125,61,99,37,33.63756549582767,0.6398565573770492,40.27217741935484,8311.29032258065,136.25066102591228,0
1589,32,0,0,160,0.0,0.0,1.0,160,3850,2600,1250,0.6753246753246753,51,26,25,251.84274092842062,0.40002866221174,0.7696369856579202,0.16313075230848204,1080598.1487697994,18578.15992567253,1099176.3086954718,1588,4,799.78125,63,97,40,33.575564706373555,0.6400462962962963,40.12044270833332,8316.145833333308,132.0023148148144,0
1590,32,0,1,159,0.0,0.00625,0.99375,160,5100,3700,1400,0.7254901960784313,65,37,28,253.34911278055083,0.3994857180293501,0.7712512141816414,0.1645570420237075,1081389.909192936,17693.834812773974,1099083.74400571,1589,5,800.78125,65,95,41,33.43881536344502,0.6397435897435897,40.02525252525251,8319.191919191893,127.98756798756759,0
1591,32,1,1,159,0.00625,0.00625,0.99375,160,4750,3400,1350,0.7157894736842105,61,34,27,241.89239725955335,0.39983212133123686,0.7576968229807628,0.15451289703310866,1076545.7034411463,15331.644192970081,1091877.3476341164,1590,0,796.39375,61,99,38,34.33370846557417,0.636441256830601,40.60819892473117,8300.537634408578,136.07438744932094,8
1592,32,0,0,159,0.0,0.0,1.0,159,5400,3800,1600,0.7037037037037037,70,38,32,241.001558641397,0.39962648939840245,0.7547422267243531,0.15444247793321625,1077487.2504340238,14735.221354166413,1092222.4717881903,1591,1,796.9433962264151,63,96,35,34.2406756982773,0.6362433862433863,40.49479166666665,8304.166666666635,131.8121693121688,0
1593,32,0,0,159,0.0,0.0,1.0,159,4150,3000,1150,0.7228915662650602,53,30,23,237.22755677488195,0.3994871692805775,0.7505085798586841,0.15250342935528108,1078402.3668639045,15215.351742274706,1093617.718606179,1592,2,797.9433962264151,64,95,38,34.225823045267454,0.63671875,40.38461538461538,8307.692307692301,129.8076923076922,0
1594,32,0,1,158,0.0,0.006289308176100629,0.9937106918238994,159,3700,2300,1400,0.6216216216216216,51,23,28,235.42907650288242,0.39971936947695247,0.7489242071921802,0.15192404716622862,1079505.492593006,15329.396240192133,1094834.8888331982,1593,3,798.9433962264151,66,93,37,34.136639332814624,0.6368371212121212,40.251865671641795,8311.940298507468,125.93848937132528,0
1595,32,0,1,157,0.0,0.006329113924050633,0.9936708860759493,158,3900,2800,1100,0.717948717948718,50,28,22,236.89831384510245,0.3984519874223978,0.7452424107618825,0.15348906559440914,1080670.7310847433,15701.814803146148,1096372.5458878893,1594,4,804.9240506329114,68,90,40,33.95500532481365,0.6371017156862745,40.11171497584542,8316.425120772976,122.300369423132,0
1596,32,1,1,157,0.006329113924050633,0.006329113924050633,0.9936708860759493,158,5400,4100,1300,0.7592592592592593,67,41,26,258.2426618119286,0.3996454150877476,0.770186845544123,0.16898692812864213,1083529.8923647234,18962.728711411666,1102492.621076135,1595,0,804.6835443037975,61,97,36,33.047848473109966,0.6449795081967213,39.76814516129032,8327.419354838703,136.5150713907984,8
1597,32,0,0,157,0.0,0.0,1.0,157,3850,2600,1250,0.6753246753246753,51,26,25,263.0957443556413,0.39849236485382983,0.7714386190455134,0.17251702498892052,1084120.2163696291,21795.483059353326,1105915.6994289826,1596,6,810.8089171974523,63,94,37,32.84881145918005,0.6443452380952381,39.697265625,8329.687500000002,132.21726190476193,0
1598,32,2,0,159,0.012578616352201259,0.0,1.0,159,4550,3200,1350,0.7032967032967034,59,32,27,258.6824981676353,0.40172790117559637,0.7694807143563949,0.17085384078295138,1086189.805179793,19845.65845762536,1106035.4636374183,1597,0,801.5974842767296,61,98,39,32.70892442610264,0.6482240437158471,39.44892473118281,8337.634408602176,136.68253128856026,0
1599,32,0,0,159,0.0,0.0,1.0,159,4500,3100,1400,0.6888888888888889,59,31,28,211.48078212160587,0.40131657511344637,0.726167700819224,0.1381126436456368,1082958.9851676004,9505.002637772952,1092463.9878053735,1598,1,802.5974842767296,73,86,43,34.334758143058124,0.6372716894977168,39.836711711711715,8325.225225225227,114.04418116746886,8
1600,32,0,1,158,0.0,0.006289308176100629,0.9937106918238994,159,4150,2800,1350,0.6746987951807228,55,28,27,212.13626195544853,0.4011656449858026,0.72745072712881,0.1390085443248435,1083927.5666551238,10038.068444136603,1093965.6350992604,1599,2,803.5974842767296,75,84,44,34.19892048446548,0.6375,39.7203947368421,8328.947368421046,111.05263157894728,0
1601,32,0,0,158,0.0,0.0,1.0,158,4950,4000,950,0.8080808080808081,59,40,19,215.00743840407495,0.39927336128356045,0.7284408754964813,0.14139510566951974,1084953.7067901255,10104.623456790247,1095058.3302469158,1600,3,809.6708860759494,74,84,44,33.998368801891665,0.6392173423423424,39.59722222222223,8332.888888888905,112.60660660660683,0
1602,32,0,0,158,0.0,0.0,1.0,158,3800,2500,1300,0.6578947368421053,51,25,26,215.01460099706895,0.39877113064043646,0.7288881619384733,0.14195569946470601,1086076.1190459516,11304.44467782208,1097380.5637237737,1601,4,810.6708860759494,68,90,42,33.860625024143374,0.6436887254901961,39.46256038647343,8337.198067632848,122.60585393577718,0
1603,32,0,0,158,0.0,0.0,1.0,158,4700,3600,1100,0.7659574468085106,58,36,22,216.42284388372292,0.3988660337552743,0.7314795059881893,0.1433272113407164,1086957.3422075196,10748.47983616892,1097705.8220436885,1602,5,811.6708860759494,68,90,44,33.715971618882136,0.6447610294117647,39.356884057971016,8340.579710144928,122.65558397271953,0
1604,32,0,0,158,0.0,0.0,1.0,158,3950,2800,1150,0.7088607594936709,51,28,23,217.91796611274856,0.3989391007551936,0.7342710232702663,0.14476458118074612,1087838.9227286533,11861.929099862384,1099700.8518285158,1603,6,812.6708860759494,68,90,45,33.56902308167362,0.6458333333333333,39.251207729468604,8343.961352657017,122.70531400966202,0
1605,32,0,0,158,0.0,0.0,1.0,158,4150,2800,1350,0.6746987951807228,55,28,27,201.09128824453853,0.39911294982396733,0.7134021064922482,0.12577573121878952,1070374.4839557183,7298.596776547919,1077673.0807322662,1604,7,813.6708860759494,72,86,46,36.15156864908609,0.6223958333333333,41.352739726027416,8276.712328767158,114.95433789954387,8
1606,32,0,0,158,0.0,0.0,1.0,158,3700,2400,1300,0.6486486486486487,50,24,26,200.60788977942283,0.3989844526861781,0.7128813652704491,0.1257562419558601,1071038.521629746,7671.755539323536,1078710.2771690695,1605,8,814.6708860759494,73,85,44,36.08224519405153,0.6227168949771689,41.27252252252255,8279.279279279343,113.41478464766223,0
1607,32,0,0,158,0.0,0.0,1.0,158,3900,2900,1000,0.7435897435897436,49,29,20,200.80134792688065,0.3987274584105996,0.7129698944219287,0.1261541576962075,1071685.0493827218,7539.160493827487,1079224.2098765492,1606,9,815.6708860759494,74,84,46,35.99759400379237,0.6230292792792793,41.194444444444464,8281.777777777823,111.91591591591653,0
1608,32,0,0,158,0.0,0.0,1.0,158,3350,2400,950,0.7164179104477612,43,24,19,199.95025489151587,0.39854269128436665,0.7110026800127442,0.12583882275380426,1072198.297903435,7927.2645920085815,1080125.5624954437,1607,10,816.6708860759494,77,81,45,35.95641594442151,0.6222943722943723,41.13247863247866,8283.760683760753,107.58130758130848,0
1609,32,0,0,158,0.0,0.0,1.0,158,3800,2800,1000,0.7368421052631579,48,28,20,201.23965028381238,0.39842427235346284,0.7130290426482124,0.12709804536574476,1073234.8025601371,7795.479267923902,1081030.281828061,1608,11,817.6708860759494,78,80,35,35.79542561857245,0.6231303418803419,41.007383966244745,8287.763713080216,106.25338093692585,0
1610,32,0,1,157,0.0,0.006329113924050633,0.9936708860759493,158,4550,3300,1250,0.7252747252747253,58,33,25,204.18945308500074,0.39868210647961516,0.7162593831763524,0.12920161625639415,1073781.27002885,7700.962052022074,1081482.2320808722,1609,12,818.6708860759494,78,80,35,35.651753448363664,0.6237980769230769,40.94145569620256,8289.873417721587,106.28042843232804,0
1611,32,0,1,156,0.0,0.006369426751592357,0.9936305732484076,157,4100,2900,1200,0.7073170731707317,53,29,24,207.0326551940658,0.39747332462300616,0.7180086369063727,0.13124534644754218,1074327.876586737,8984.190567751268,1083312.0671544883,1610,13,824.7006369426751,78,79,36,35.51080466788791,0.624465811965812,40.87552742616036,8291.98312236293,106.30747592772987,0
1612,32,1,0,157,0.006369426751592357,0.0,1.0,157,3550,2300,1250,0.647887323943662,48,23,25,206.85210028202158,0.39867269584626275,0.7173989911677399,0.13148905031172295,1075125.766841952,9528.404587715639,1084654.1714296676,1611,0,824.6751592356688,80,77,37,35.41728679863076,0.624609375,40.779320987654344,8295.061728395118,103.68827160493898,0
1613,32,0,0,157,0.0,0.0,1.0,157,4300,2800,1500,0.6511627906976745,58,28,30,202.29142132575896,0.39873053786270346,0.7078089623561328,0.1262998552060025,1069845.444444448,7584.111111111326,1077429.5555555592,1612,1,825.6751592356688,74,83,41,36.18574766355141,0.620777027027027,41.41666666666668,8274.666666666695,111.81981981982021,8
1614,32,2,0,159,0.012578616352201259,0.0,1.0,159,4700,3200,1500,0.6808510638297872,62,32,30,197.3043679500514,0.4005519730382401,0.7043538243051319,0.12375435833707549,1071202.884729533,5770.601623566673,1076973.4863530996,1613,0,816.2767295597484,77,82,43,36.14747311827958,0.6210768398268398,41.25267094017096,8279.914529914575,107.53135753135811,0
1615,32,0,1,158,0.0,0.006289308176100629,0.9937106918238994,159,4400,3400,1000,0.7727272727272727,54,34,20,199.29720043061968,0.40050221585330253,0.7079888086132522,0.12535736435929215,1072033.0637228757,6530.637673805937,1078563.7013966816,1614,1,817.2767295597484,78,81,43,35.99366647988725,0.6216613247863247,41.15242616033756,8283.122362869226,106.19387644704136,0
1616,32,1,1,158,0.006289308176100629,0.006289308176100629,0.9937106918238994,159,3800,2600,1200,0.6842105263157895,50,26,24,197.11922029195875,0.40068797601040257,0.7048071897077912,0.12461943926932353,1073526.2345679053,6722.530864197752,1080248.765432103,1615,0,815.6540880503145,80,79,39,35.86628686327081,0.62265625,40.972222222222236,8288.888888888921,103.61111111111151,0
1617,32,0,0,158,0.0,0.0,1.0,158,5500,4300,1200,0.7818181818181819,67,43,24,196.08719381085197,0.3996848880647155,0.7030594037497175,0.12448191329197439,1074740.2284842248,5048.559095821411,1079788.787580046,1616,1,821.5443037974684,82,76,40,35.74372911723406,0.6233485772357723,40.825803212851426,8293.574297188808,101.14114996571718,0
1618,32,1,1,158,0.006289308176100629,0.006289308176100629,0.9937106918238994,159,4750,3100,1650,0.6526315789473685,64,31,33,192.77125988799176,0.40019372130669,0.7006477048718653,0.12295270838096167,1076111.5258587354,4938.674923955714,1081050.2007826911,1617,0,817.37106918239,87,72,45,35.661191367322445,0.6232040229885057,40.66051136363638,8298.863636363683,95.38923719958257,0
1619,32,1,0,159,0.006289308176100629,0.0,1.0,159,4750,3800,950,0.8,57,38,19,192.370602452684,0.400147281267415,0.7009136859139029,0.12341437606202324,1077808.7335646327,4917.74308091805,1082726.4766455507,1618,0,818.3396226415094,73,86,45,35.4632190765448,0.6309931506849316,40.45608108108104,8305.405405405303,113.77267678637402,0
1620,32,0,0,159,0.0,0.0,1.0,159,3700,2400,1300,0.6486486486486487,50,24,26,190.6924383984461,0.4002700156569275,0.6974634595610738,0.12265829747306403,1078568.7934027677,5634.9826388883985,1084203.776041656,1619,1,819.3396226415094,75,84,45,35.41353226345703,0.6309722222222223,40.3645833333333,8308.333333333256,110.77777777777675,0
1621,32,0,0,159,0.0,0.0,1.0,159,6150,5100,1050,0.8292682926829268,72,51,21,195.69731276291503,0.3999316667993525,0.7007028475827364,0.12660575329303983,1080240.0901742927,4330.016557175459,1084570.106731468,1620,2,820.3396226415094,78,81,43,35.07857167021885,0.6316773504273504,40.16350210970463,8314.767932489429,106.5995888780696,0
1622,32,0,0,159,0.0,0.0,1.0,159,5050,3700,1350,0.7326732673267327,64,37,27,194.09089431911323,0.4000195711594088,0.6969460624063113,0.12610362676618903,1081473.1744497274,5130.819122215345,1086603.9935719427,1621,3,821.3396226415094,81,78,47,34.96917652040783,0.6319444444444444,40.01524390243901,8319.512195121913,102.71002710027054,0
1623,32,0,0,159,0.0,0.0,1.0,159,5250,3800,1450,0.7238095238095238,67,38,29,237.47267394474912,0.4001224026749463,0.7486772405038185,0.14546094481249544,1064173.4671749428,13492.42375821761,1077665.8909331604,1622,4,822.3396226415094,73,86,39,35.9786924840347,0.6142979452054795,42.10304054054053,8252.702702702683,113.05072195483127,8
1624,32,0,1,158,0.0,0.006289308176100629,0.9937106918238994,159,4550,3000,1550,0.6593406593406593,61,30,31,236.53395014861803,0.4005420216012525,0.749004169995251,0.14528130825482166,1064986.8111354613,14031.107458810227,1079017.9185942716,1623,5,823.3396226415094,73,86,31,35.902035137494565,0.615296803652968,42.00450450450451,8255.855855855867,113.09391583364201,0
1625,32,0,0,158,0.0,0.0,1.0,158,3400,2400,1000,0.7058823529411765,44,24,20,235.14856668159013,0.4006700327877664,0.7477839817085286,0.14488185882639942,1065916.7275383524,15129.758136515076,1081046.4856748674,1624,6,828.4810126582279,73,85,34,35.82251672484002,0.6164383561643836,41.8918918918919,8259.459459459484,113.14328026656827,0
1626,32,0,0,158,0.0,0.0,1.0,158,3600,2100,1500,0.5833333333333334,51,21,30,237.17617156259266,0.4007682953048994,0.7489524119552724,0.14631242949996398,1066285.7067901255,15379.512345679159,1081665.2191358046,1625,7,829.4810126582279,74,84,34,35.72445347106401,0.6164132882882882,41.84722222222223,8260.888888888905,111.63363363363385,0
1627,32,0,0,158,0.0,0.0,1.0,158,3750,2700,1050,0.72,48,27,21,235.12721681759118,0.40095558198285364,0.7473644009296585,0.14544096704944415,1067089.0000000002,14830.333333333354,1081919.3333333335,1626,8,830.4810126582279,74,84,34,35.677839625685685,0.6173986486486487,41.75,8264.000000000002,111.6756756756757,0
1628,32,0,0,158,0.0,0.0,1.0,158,3650,2600,1050,0.7123287671232876,47,26,21,232.7759003703645,0.40100933241957587,0.7445502188509336,0.14426594522460562,1067664.4766899422,14455.311970991082,1082119.7886609333,1627,9,831.4810126582279,75,83,35,35.66731442669919,0.6176388888888888,41.68037280701754,8266.228070175432,110.21637426900575,0
1629,32,0,0,158,0.0,0.0,1.0,158,4300,3100,1200,0.7209302325581395,55,31,24,236.49621762023884,0.40104964524711767,0.7494441209458718,0.14717673965768294,1068885.207624717,14657.461734693921,1083542.6693594109,1628,10,832.4810126582279,69,89,35,35.42008511332448,0.6221316425120773,41.532738095238095,8270.952380952383,119.86887508626643,0
1630,32,1,1,158,0.006289308176100629,0.006289308176100629,0.9937106918238994,159,4750,3800,950,0.8,57,38,19,240.58550226837716,0.40201649284823393,0.7543723712796577,0.15051534439288464,1070447.6762767532,14956.838369811965,1085404.514646565,1629,0,828.2389937106918,70,89,37,35.12100586122138,0.6235119047619048,41.343896713615024,8276.995305164322,118.24279007377604,0
1631,32,0,1,157,0.0,0.006329113924050633,0.9936708860759493,158,4400,3200,1200,0.7272727272727273,56,32,24,244.1218089915188,0.4017114474992609,0.7565363523030912,0.15316884899265115,1071297.8885637787,16305.435704996919,1087603.3242687755,1630,1,834.4050632911392,70,88,33,34.92433047948443,0.6245535714285715,41.2411971830986,8280.281690140859,118.2897384305837,0
1632,32,2,3,156,0.012578616352201259,0.018867924528301886,0.9811320754716981,159,3950,3000,950,0.759493670886076,49,30,19,241.35438978187443,0.4035888198922591,0.7536851177993369,0.15264498893936185,1073641.3611111208,16075.611111111615,1089716.9722222325,1631,0,823.8364779874214,74,85,30,34.706248994692,0.6254222972972974,40.958333333333364,8289.333333333409,112.01801801801903,0
1633,32,0,0,156,0.0,0.0,1.0,156,3550,2300,1250,0.647887323943662,48,23,25,249.04600792443594,0.4006866901020127,0.7576836696593268,0.15761494944433774,1073837.4015907855,18736.983605227215,1092574.3851960127,1632,3,840.4166666666666,73,83,31,34.48276642758824,0.6261415525114156,40.934684684684704,8290.090090090134,113.5628779464402,0
1634,32,0,1,155,0.0,0.00641025641025641,0.9935897435897436,156,4500,3400,1100,0.7555555555555555,56,34,22,247.6933586859621,0.40085728563551143,0.756881813164535,0.15722167570973086,1074700.511816142,17539.235870652883,1092239.7476867947,1633,4,841.4166666666666,75,81,33,34.4111379942532,0.62625,40.83059210526318,8293.421052631627,110.5789473684217,0
1635,32,1,0,156,0.00641025641025641,0.0,1.0,156,3750,2800,950,0.7466666666666667,47,28,19,246.84224115805924,0.40236593603529086,0.7572986325655351,0.15754013249769808,1076296.8118535203,18185.103437839713,1094481.91529136,1634,0,832.9871794871794,78,78,37,34.23604050160992,0.6268696581196581,40.63818565400846,8299.578059071782,106.40484691117669,0
1636,32,2,0,158,0.012658227848101266,0.0,1.0,158,3550,2600,950,0.7323943661971831,45,26,19,242.91060837067823,0.4042108428068478,0.7552626705352186,0.15608524176900446,1078269.234878365,17234.60716633767,1095503.8420447027,1635,0,823.4303797468355,64,94,39,34.09469720353108,0.6365559895833333,40.40064102564101,8307.179487179452,129.79967948717893,0
1637,32,0,0,158,0.0,0.0,1.0,158,5000,3400,1600,0.68,66,34,32,243.5864418357984,0.40408234566905854,0.7562648765334283,0.15692918222263919,1079027.7937200223,15967.30818283813,1094995.1019028604,1636,1,824.4303797468355,65,93,39,33.983631133260374,0.6368589743589743,40.30934343434341,8310.101010100962,127.8477078477071,0
1638,32,0,0,158,0.0,0.0,1.0,158,3800,2500,1300,0.6578947368421053,51,25,26,241.70630547242004,0.40395132897954794,0.754303566083802,0.1561560851240665,1079841.8914900445,16800.91881728138,1096642.810307326,1637,2,825.4303797468355,67,91,36,33.93214271674822,0.636660447761194,40.2113970588235,8313.235294117589,124.07813871817297,0
1639,32,0,0,158,0.0,0.0,1.0,158,5200,4200,1000,0.8076923076923077,62,42,20,242.14692420692333,0.40322989733666587,0.7540929740219648,0.15723114761852205,1081298.571728624,15566.624658684912,1096865.1963873089,1638,3,826.4303797468355,68,90,36,33.741289198606275,0.6378676470588236,40.036231884057955,8318.84057971011,122.33589087808984,0
1640,32,0,0,158,0.0,0.0,1.0,158,3900,2700,1200,0.6923076923076923,51,27,24,242.00616568194633,0.4032987650837163,0.7546531302876489,0.1578649491368981,1082625.5951200111,16900.413828825614,1099526.0089488367,1639,4,827.4303797468355,70,88,33,33.58161778529797,0.6383928571428572,39.876760563380266,8323.943661971794,118.91348088531134,0
1641,32,0,0,158,0.0,0.0,1.0,158,4050,3000,1050,0.7407407407407407,51,30,21,240.86710374935646,0.4032156198769115,0.7513452359392934,0.158005702038817,1084237.2220397796,16581.41588999379,1100818.6379297734,1640,5,828.4303797468355,72,86,34,33.413044272689056,0.6393229166666667,39.68321917808218,8330.13698630135,115.69634703196319,0
1642,32,0,1,157,0.0,0.006329113924050633,0.9936708860759493,158,4400,3300,1100,0.75,55,33,22,244.48000000000062,0.4031895845091242,0.7552405063291148,0.16084210526315784,1085069.4444444412,17055.55555555537,1102124.9999999965,1641,6,829.4303797468355,66,92,35,33.216666666666654,0.6436237373737373,39.58333333333332,8333.333333333308,126.26262626262589,0
1643,32,0,0,157,0.0,0.0,1.0,157,3250,1900,1350,0.5846153846153846,46,19,27,236.06188771353914,0.4017927622625075,0.7531735557213259,0.15413452668354624,1082900.3906250005,16476.30208333338,1099376.692708334,1642,7,835.6687898089172,71,86,36,33.70245245245245,0.6382042253521127,39.84375,8325.000000000004,117.25352112676062,8
1644,32,0,1,156,0.0,0.006369426751592357,0.9936305732484076,157,4400,3100,1300,0.7045454545454546,57,31,26,248.23447456196888,0.401723011595623,0.7664949295573895,0.15429139760138938,1068520.243963864,17248.712263839217,1085768.9562277033,1643,8,836.6687898089172,57,100,38,35.161914772858914,0.6295687134502924,41.57686781609195,8269.540229885044,145.07965315587796,8
1645,32,0,0,156,0.0,0.0,1.0,156,5250,3700,1550,0.7047619047619048,68,37,31,251.94206056810583,0.4015594844223877,0.76769620753578,0.1573845436060799,1070005.9504640591,17465.90079600968,1087471.8512600688,1644,9,840.4102564102565,57,99,40,34.88197965136466,0.6313961988304093,41.39727011494251,8275.287356321802,145.1804799354702,0
1646,32,0,2,154,0.0,0.01282051282051282,0.9871794871794872,156,4500,3000,1500,0.6666666666666666,60,30,30,248.63896956111535,0.4018472566859664,0.7641046972993721,0.14973148367357753,1059066.5462563338,16965.04295156483,1076031.5892078986,1645,10,841.4102564102565,72,84,35,36.325684045110016,0.6085069444444444,42.72260273972603,8232.87671232877,114.34550989345514,8
1647,32,1,2,153,0.0064516129032258064,0.012903225806451613,0.9870967741935484,155,3200,2000,1200,0.625,44,20,24,242.4013482511092,0.40180316994833126,0.75643193577385,0.14689333064835686,1060954.498054365,17235.36015229133,1078189.8582066563,1646,0,847.5612903225806,62,93,36,36.251391207568176,0.6165994623655914,42.49338624338624,8240.211640211633,132.90663935825216,0
1648,32,0,0,153,0.0,0.0,1.0,153,5300,3800,1500,0.7169811320754716,68,38,30,240.0012652922575,0.40058658697397087,0.7499480644821639,0.14598941892181713,1062088.794378699,15080.530900723237,1077169.3252794223,1647,1,857.4509803921569,64,89,37,36.17227509278264,0.61669921875,42.35576923076923,8244.61538461539,128.82211538461547,0
1649,32,3,0,156,0.019230769230769232,0.0,1.0,156,4250,3000,1250,0.7058823529411765,55,30,25,240.55887841590945,0.40348773090708573,0.7564646741405419,0.14794502763475717,1065373.087424309,15806.991001057351,1081180.0784253664,1648,0,841.9423076923077,67,89,38,35.750284456317374,0.6189365671641791,41.9577205882353,8257.35294117648,123.24407374890268,0
1650,32,3,0,159,0.018867924528301886,0.0,1.0,159,4050,3100,950,0.7654320987654321,50,31,19,236.38786243783179,0.40587765039938434,0.7586208329852209,0.1467699937031933,1068201.3170369337,14651.9651975273,1082853.282234461,1649,0,827.0377358490566,60,99,41,35.50753970876567,0.6269097222222222,41.61543715846993,8268.306010928933,137.8051001821489,0
1651,32,2,0,161,0.012422360248447204,0.0,1.0,161,5400,3900,1500,0.7222222222222222,69,39,30,232.76497032161484,0.4072835791925466,0.7573330706868,0.14587568636926052,1070959.6318211711,12256.377383300513,1083216.0092044717,1650,0,817.7515527950311,64,97,42,35.26000371655104,0.6276041666666667,41.282051282051285,8278.974358974365,129.35897435897445,0
1652,32,0,0,161,0.0,0.0,1.0,161,4850,3500,1350,0.7216494845360825,62,35,27,236.4691165099245,0.40698434265010347,0.7608383218566057,0.14876601380434518,1072087.673611113,13653.125000000162,1085740.7986111133,1651,1,818.7515527950311,65,96,42,35.02473172367541,0.6283653846153846,41.14583333333334,8283.33333333335,127.4358974358977,0
1653,32,1,0,162,0.006172839506172839,0.0,1.0,162,4800,3600,1200,0.75,60,36,24,237.92244890405036,0.4074561319428469,0.7631944626900098,0.15085068012222308,1074372.89744329,13923.486159169495,1088296.3836024597,1652,0,814.6913580246913,67,95,42,34.70481595333805,0.6299751243781094,40.870098039215684,8292.15686274509,123.7635352648521,0
1654,32,0,0,162,0.0,0.0,1.0,162,4800,3600,1200,0.75,60,36,24,240.77313552373178,0.4074776985405005,0.7653231980160657,0.15332883213274334,1075654.5696807376,14597.744696492255,1090252.31437723,1653,1,815.6913580246913,68,94,42,34.47270742358078,0.6309742647058824,40.71557971014492,8297.10144927535,122.01619778346102,0
1655,32,0,0,162,0.0,0.0,1.0,162,4000,2700,1300,0.675,53,27,26,249.36783138016443,0.4075248255501878,0.7742472962607365,0.1508830588043807,1060492.6944683893,16490.552682818183,1076983.2471512074,1654,2,816.6913580246913,58,104,38,36.12944612078819,0.6188936781609196,42.54943502824861,8238.418079096087,142.04169101889806,8
1656,32,1,0,163,0.006134969325153374,0.0,1.0,163,4950,3500,1450,0.7070707070707071,64,35,29,244.80043323517532,0.4086018960337297,0.7713413958491946,0.14947011125346255,1063216.1617755853,14505.155405060752,1077721.3171806461,1655,0,812.6748466257669,65,98,38,35.90857721586155,0.6174679487179487,42.21906565656566,8248.989898989908,126.90753690753705,0
1657,32,0,0,163,0.0,0.0,1.0,163,3750,2800,950,0.7466666666666667,47,28,19,240.69659491587987,0.4087707339241082,0.7678322656183956,0.1369850224114676,1041746.2685667458,13798.955922067991,1055545.224488814,1656,1,813.6748466257669,71,92,37,38.69333645177748,0.587588028169014,44.83506944444445,8165.277777777794,115.00391236306751,8
1658,32,3,0,166,0.018072289156626505,0.0,1.0,166,5350,4000,1350,0.7476635514018691,67,40,27,235.3795131241455,0.41177741268102713,0.7662911063649278,0.13523045839176476,1044680.1506223897,10629.26104479163,1055309.4116671814,1657,0,799.9518072289156,65,101,39,38.46149886761377,0.594551282051282,44.47601010101012,8176.76767676771,125.79642579642632,0
1659,32,3,0,169,0.01775147928994083,0.0,1.0,169,5250,4000,1250,0.7619047619047619,65,40,25,231.71484672617612,0.41531065088757396,0.7669734670647226,0.13443213577271684,1047698.4693877561,9503.45804988671,1057201.9274376428,1658,0,786.7337278106509,69,100,36,38.177725440024844,0.5960144927536232,44.10714285714286,8188.571428571437,118.67494824016575,0
1660,32,2,2,169,0.011695906432748537,0.011695906432748537,0.9883040935672515,171,4850,3600,1250,0.7422680412371134,61,36,25,228.16482122794298,0.4175682261208577,0.7666497203863754,0.1331751345268141,1049557.5629340266,8844.422743055478,1058401.985677082,1659,0,778.5204678362574,71,100,39,38.03645568547703,0.5972711267605634,43.88020833333333,8195.833333333323,115.43427230046935,0
1661,32,3,1,171,0.01744186046511628,0.005813953488372093,0.9941860465116279,172,5550,4000,1550,0.7207207207207207,71,40,31,222.80470218956518,0.41849486037445033,0.7627303270512877,0.13090514996018224,1051574.2884087795,6909.13923182446,1058483.427640604,1660,0,774.953488372093,62,110,40,37.922310007524466,0.6050067204301075,43.63425925925926,8203.703703703706,132.31780167264043,0
1662,32,4,0,175,0.022857142857142857,0.0,1.0,175,4950,3600,1350,0.7272727272727273,63,36,27,223.7431389834437,0.4209742747673782,0.7611340912203814,0.12893043865178538,1045606.4975009601,6839.455978469805,1052445.95347943,1661,0,762.5828571428572,67,108,44,38.643036912751704,0.5945273631840796,44.36274509803921,8180.3921568627375,122.09540532630952,8
1663,32,3,0,178,0.016853932584269662,0.0,1.0,178,5300,3600,1700,0.6792452830188679,70,36,34,220.45192125806898,0.4230979813368882,0.7602043276682815,0.12828828800814168,1048636.7862690503,5334.798846979738,1053971.58511603,1662,0,750.7134831460675,72,106,45,38.3488471471304,0.595630787037037,43.99257990867579,8192.237442922362,113.78107559614392,0
1664,32,1,2,177,0.00558659217877095,0.0111731843575419,0.9888268156424581,179,5150,3600,1550,0.6990291262135923,67,36,31,220.22750083952118,0.42427761387650914,0.7629396717977961,0.12884859697005244,1050287.8559989627,5310.453937750184,1055598.3099367127,1663,0,747.5139664804469,75,104,46,38.14869425275059,0.59625,43.79111842105264,8198.684210526328,109.31578947368438,0
1665,32,3,1,179,0.016666666666666666,0.005555555555555556,0.9944444444444445,180,4600,3100,1500,0.6739130434782609,61,31,30,214.72169747861366,0.4248758535071384,0.7569515388981207,0.126459328101848,1052308.1230550434,4590.677290582453,1056898.800345626,1664,0,744.2888888888889,65,115,47,38.038174144049876,0.6040064102564102,43.544823232323225,8206.56565656564,126.25485625485601,0
1666,32,1,0,180,0.005555555555555556,0.0,1.0,180,5000,3700,1300,0.74,63,37,26,211.95914649528112,0.4257461721498034,0.7528850865329977,0.12582161272060102,1054714.115994531,3711.260764544823,1058425.3767590758,1665,0,745.2166666666667,68,112,46,37.809798906332674,0.6052389705882353,43.25181159420287,8215.942028985444,120.82267689684477,0
1667,32,2,3,179,0.01098901098901099,0.016483516483516484,0.9835164835164835,182,4750,3300,1450,0.6947368421052632,62,33,29,210.14027939741536,0.42685060105640216,0.7538423257970988,0.125289970464015,1056045.706457046,3233.5479622646885,1059279.2544193107,1666,0,738.0164835164835,70,112,38,37.69107037481203,0.6058035714285714,43.08978873239435,8221.126760563333,117.44466800804761,0
1668,32,1,2,178,0.005555555555555556,0.011111111111111112,0.9888888888888889,180,4300,3200,1100,0.7441860465116279,54,32,22,225.92269916417504,0.4274344351334575,0.7703883192958207,0.12700769314586977,1037909.7111455156,6597.472686140855,1044507.1838316564,1667,0,745.2944444444445,72,108,42,39.5512353633257,0.5823206018518519,45.30536529680366,8150.228310502294,113.19761542364297,8
1669,32,5,2,181,0.0273224043715847,0.01092896174863388,0.9890710382513661,183,4700,3100,1600,0.6595744680851063,63,31,32,224.6333450520286,0.4291931884144999,0.7727179444369072,0.12740035562337118,1040664.9519311894,5453.609846142477,1046118.5617773319,1668,0,734.016393442623,76,107,40,39.238652839663345,0.5838815789473684,44.96753246753248,8161.03896103899,107.3820915926183,0
1670,32,4,2,183,0.021621621621621623,0.010810810810810811,0.9891891891891892,185,5100,3100,2000,0.6078431372549019,71,31,40,236.40574371963754,0.43166740109674895,0.7877362264573629,0.13535230547202348,1043610.5375260183,7243.105055497968,1050853.6425815164,1669,0,727.0594594594595,61,124,41,38.56921419643445,0.5957991803278688,44.606854838709694,8172.580645161321,133.9767318878905,8
1671,32,2,0,185,0.010810810810810811,0.0,1.0,185,5900,4300,1600,0.7288135593220338,75,43,32,229.65252072993968,0.4315951821386604,0.7810951669335411,0.13260427286561405,1046233.1532643744,5154.016183679622,1051387.169448054,1670,0,728.0378378378379,67,118,41,38.413618982008416,0.5953047263681592,44.28615196078433,8182.843137254941,122.13198712320808,0
1672,32,5,4,186,0.02631578947368421,0.021052631578947368,0.9789473684210527,190,5450,4100,1350,0.7522935779816514,68,41,27,223.83102399588012,0.43459574863083633,0.7811550516382058,0.13051854587084308,1049258.7777777833,3521.3333333336623,1052780.111111117,1671,0,709.8526315789474,74,116,37,38.18472719383884,0.5954391891891893,43.916666666666686,8194.666666666712,110.73873873873934,0
1673,32,2,0,188,0.010638297872340425,0.0,1.0,188,4600,3300,1300,0.717391304347826,59,33,26,226.61168186389557,0.43361315754541657,0.7809391780923027,0.13263110111120416,1050397.2345679037,5406.456790123591,1055803.6913580273,1672,0,718.2659574468086,74,114,39,37.97148290690951,0.5968468468468469,43.777777777777786,8199.11111111113,110.79879879879904,0
1674,32,1,3,186,0.005291005291005291,0.015873015873015872,0.9841269841269842,189,4650,3000,1650,0.6451612903225806,63,30,33,230.17204697324198,0.4339972888288491,0.7849126429080906,0.1357889756608385,1052826.2780902456,6016.235907050252,1058842.5139972959,1673,0,715.4603174603175,65,124,38,37.57735751348469,0.6046474358974359,43.48169191919192,8208.585858585855,126.28593628593623,0
1675,32,0,1,185,0.0,0.005376344086021506,0.9946236559139785,186,5550,3400,2150,0.6126126126126126,77,34,43,228.53937739900746,0.431971083987213,0.7817253792614822,0.13554749280216957,1054453.1075963434,5446.811341303255,1059899.9189376466,1674,1,727.9086021505376,66,120,37,37.416601057816514,0.6060606060606061,43.283582089552226,8214.925373134303,124.46856625961065,0
1676,32,1,4,182,0.005376344086021506,0.021505376344086023,0.978494623655914,186,5750,3900,1850,0.6782608695652174,76,39,37,227.99747752550914,0.43248510607381574,0.7811300938774892,0.13584051392065982,1055830.7078344827,5195.3476160467635,1061026.0554505293,1675,0,728.8333333333334,68,118,35,37.25905030559472,0.6066176470588236,43.115942028985486,8220.289855072419,120.88661551577086,0
1677,32,2,1,183,0.010869565217391304,0.005434782608695652,0.9945652173913043,184,5100,3700,1400,0.7254901960784313,65,37,28,257.21975463284696,0.4321048150787994,0.7994053162869008,0.15259277408466834,1054522.603235534,12348.809051806944,1066871.412287341,1676,0,734.9184782608696,67,117,37,36.671651550410715,0.6055659203980099,43.275122549019606,8215.196078431369,122.61486684225923,8
1678,32,0,0,183,0.0,0.0,1.0,183,5900,4100,1800,0.6949152542372882,77,41,36,260.61188728638405,0.43114854180427953,0.8017452156119891,0.15542190791017005,1056123.2461734698,12547.654478458122,1068670.900651928,1677,1,739.9125683060109,69,114,35,36.38472584226278,0.6064311594202898,43.080357142857146,8221.428571428576,119.15113871635617,0
1679,32,0,0,183,0.0,0.0,1.0,183,5050,3500,1550,0.693069306930693,66,35,31,259.65776693044137,0.4313712244040113,0.8014873022324582,0.15571895818539938,1057812.250000004,13283.833333333605,1071096.0833333377,1678,2,740.9125683060109,74,109,37,36.19854966780101,0.6059966216216216,42.875000000000014,8228.000000000031,111.1891891891896,0
1680,32,0,1,182,0.0,0.00546448087431694,0.994535519125683,183,5650,4000,1650,0.7079646017699115,73,40,33,256.8106500224816,0.4315813967453312,0.799585582303955,0.15448740601914585,1058744.258620062,12129.360252757873,1070873.6188728197,1679,3,741.9125683060109,77,106,38,36.155599972311634,0.6057900432900433,42.76175213675214,8231.623931623948,106.90420690420711,0
1681,32,1,0,183,0.00546448087431694,0.0,1.0,183,5400,4200,1200,0.7777777777777778,66,42,24,253.607953521665,0.4321806381232611,0.7958028215862472,0.15358910626583444,1060767.952827086,11803.837935568583,1072571.7907626545,1680,0,740.3715846994536,64,119,37,35.98602726084519,0.6150716145833333,42.516025641025635,8239.487179487169,128.741987179487,0
1682,32,2,3,182,0.010810810810810811,0.016216216216216217,0.9837837837837837,185,5500,3500,2000,0.6363636363636364,75,35,40,248.49182727219195,0.4334606345475911,0.7933017429590559,0.15144605438641912,1062667.1604063134,10312.820894303464,1072979.9813006169,1681,0,733.3567567567568,68,117,39,35.8816364985453,0.6150428921568627,42.28562801932368,8246.859903381664,121.27735152031859,0
1683,32,2,0,184,0.010869565217391304,0.0,1.0,184,5300,3700,1600,0.6981132075471698,69,37,32,255.9136389315727,0.4331213619624614,0.7996113554172946,0.15744193757143882,1065474.6392084914,12433.898421829963,1077908.5376303215,1682,0,736.0869565217391,70,114,38,35.34145393901493,0.6174107142857144,41.94542253521127,8257.746478873247,117.96780684104638,0
1684,32,0,1,183,0.0,0.005434782608695652,0.9945652173913043,184,5500,4100,1400,0.7454545454545455,69,41,28,261.6549683182961,0.4329320355191257,0.8050683626582986,0.16157420638783093,1066582.1250214342,13515.302426268838,1080097.427447703,1683,1,737.0869565217391,71,113,38,35.05570809518475,0.6182511737089202,41.811342592592595,8262.037037037044,116.36671883150765,0
1685,32,0,0,183,0.0,0.0,1.0,183,5050,3100,1950,0.6138613861386139,70,31,39,258.7932292075065,0.4328386777157269,0.801923803443374,0.16039052913100557,1067664.4766899443,13610.867526546715,1081275.344216491,1684,2,740.8688524590164,75,108,38,34.99523575812244,0.6176388888888888,41.68037280701755,8266.228070175448,110.21637426900597,0
1686,32,1,0,184,0.005434782608695652,0.0,1.0,184,5650,3600,2050,0.6371681415929203,77,36,41,253.6146053632668,0.43343814346242177,0.7997589479874727,0.15889649792073865,1070874.6380276186,11867.889743381314,1082742.527771,1685,0,737.8369565217391,63,121,37,34.7311130334487,0.6281415343915344,41.29231770833335,8278.645833333363,131.4070767195772,0
1687,32,2,0,186,0.010752688172043012,0.0,1.0,186,5700,4500,1200,0.7894736842105263,69,45,24,247.47578572471048,0.43454240530853433,0.7952538157206035,0.15591592969239446,1072513.0630221085,10184.202594282484,1082697.265616391,1686,0,730.8924731182796,70,116,42,34.68719895732985,0.6260416666666666,41.09448356807512,8284.976525821603,118.35680751173719,0
1688,32,0,2,184,0.0,0.010752688172043012,0.989247311827957,186,5900,4200,1700,0.711864406779661,76,42,34,245.8328135719197,0.434349874067616,0.7950269197814264,0.15552382619990673,1073728.926276756,9691.56059203441,1083420.4868687904,1687,1,731.8924731182796,70,116,39,34.579416095599484,0.627529761904762,40.947769953051655,8289.671361502371,118.42387659289102,0
1689,32,0,0,184,0.0,0.0,1.0,184,5250,4100,1150,0.780952380952381,64,41,23,251.07547678426263,0.433001331472242,0.7971814721249626,0.1589064791776529,1073850.550486017,11873.507791664026,1085724.058277681,1688,3,740.8369565217391,70,114,40,34.42856401253446,0.6276785714285714,40.9330985915493,8290.14084507044,118.4305835010063,0
1690,32,1,1,184,0.005405405405405406,0.005405405405405406,0.9945945945945946,185,6150,4900,1250,0.7967479674796748,74,49,25,249.1842165049501,0.43322194477085785,0.798010064144614,0.15852247721491086,1075354.9865321412,10442.297956740607,1085797.284488882,1689,0,737.827027027027,73,112,41,34.29163046822683,0.6279965753424658,40.75168918918919,8295.945945945952,113.64309514994456,0
1691,32,1,0,185,0.005405405405405406,0.0,1.0,185,4650,3400,1250,0.7311827956989247,59,34,25,246.53296370532428,0.4327519095182139,0.7965376013983194,0.15734198777920166,1076295.4088364753,11418.459392577977,1087713.8682290532,1690,0,738.6648648648649,77,108,43,34.24423519214598,0.6272997835497836,40.638354700854705,8299.572649572658,107.7866577866579,0
1692,32,0,1,184,0.0,0.005405405405405406,0.9945945945945946,185,5700,4200,1500,0.7368421052631579,72,42,30,243.61116466879568,0.43268213866039956,0.7940563612602853,0.15627153460588775,1077779.0419151161,9811.801531311772,1087590.843446428,1691,1,739.6648648648649,62,123,42,34.136963538680426,0.6372647849462365,40.45965608465607,8305.291005290974,133.9563065369512,0
1693,32,0,1,183,0.0,0.005434782608695652,0.9945652173913043,184,6200,4400,1800,0.7096774193548387,80,44,36,239.33899099302863,0.4318919775085135,0.7878111447210172,0.15410330869566533,1078859.4496423341,8642.626420138009,1087502.076062472,1692,2,744.554347826087,66,118,43,34.114676885003774,0.6360479797979798,40.329601990049746,8309.452736318397,125.90079903512722,0
1694,32,0,1,182,0.0,0.00546448087431694,0.994535519125683,183,4800,3400,1400,0.7083333333333334,62,34,28,243.02927933328928,0.4313236854220461,0.789591813842023,0.15696854381058817,1079763.963917968,11082.851600207709,1090846.8155181757,1693,3,749.4644808743169,66,117,43,33.907375266822285,0.6371527777777778,40.220771144278594,8312.935323383052,125.95356550580381,0
1695,32,1,0,183,0.00546448087431694,0.0,1.0,183,4950,3500,1450,0.7070707070707071,64,35,29,233.88691531184665,0.4317115034328149,0.7815185139639085,0.14322474354608825,1064090.4903628107,8225.368480725509,1072315.858843536,1694,0,750.2896174863388,69,114,42,36.08145797268705,0.616243961352657,42.113095238095234,8252.380952380943,119.5997239475499,8
1696,32,0,0,183,0.0,0.0,1.0,183,5650,4300,1350,0.7610619469026548,70,43,27,236.71979852681966,0.43187788986969317,0.7835546626766801,0.14539705403751713,1064990.0847770474,8170.847660296571,1073160.932437344,1695,1,751.2896174863388,70,113,34,35.896834423277426,0.6168154761904762,42.00410798122065,8255.868544600917,117.94097920858452,0
1697,32,1,0,184,0.005434782608695652,0.0,1.0,184,5850,4200,1650,0.717948717948718,75,42,33,237.23897066022298,0.43209182208759006,0.7859482577998247,0.1464971166229181,1066582.1250214316,7956.969092935438,1074539.094114367,1696,0,748.2010869565217,71,113,37,35.68610146064481,0.6182511737089202,41.81134259259259,8262.037037037024,116.36671883150737,0
1698,32,1,0,185,0.005405405405405406,0.0,1.0,185,5150,3100,2050,0.6019417475728155,72,31,41,236.7325702393333,0.43256340579710145,0.7873147340889266,0.1467741935483871,1067777.7777777815,8405.555555555751,1076183.3333333372,1697,0,745.1513513513513,73,112,39,35.55107526881721,0.6187214611872146,41.66666666666668,8266.666666666695,113.24200913242048,0
1699,32,2,1,186,0.0106951871657754,0.0053475935828877,0.9946524064171123,187,5500,3900,1600,0.7090909090909091,71,39,32,228.70401460915292,0.4329550246295977,0.7813658637355325,0.1426484241897003,1069551.389489622,6022.139321414996,1075573.528811037,1698,0,738.1711229946524,67,120,40,35.539114034048254,0.6240671641791045,41.45220588235295,8273.529411764726,123.48551360842875,0
1700,32,0,2,184,0.0,0.010752688172043012,0.989247311827957,186,5450,3800,1650,0.6972477064220184,71,38,33,208.43471045404596,0.43246331008427785,0.7626671812935455,0.12696315225752994,1062502.8271604923,1642.493827160446,1064145.3209876528,1699,1,743.0967741935484,74,112,42,36.934308864216156,0.6117680180180181,42.30555555555555,8246.22222222221,111.43543543543527,8
1701,32,1,1,184,0.005405405405405406,0.005405405405405406,0.9945945945945946,185,5550,4100,1450,0.7387387387387387,70,41,29,208.2942216145866,0.43298815119467293,0.7594249121808188,0.1275459732729515,1064074.9456995812,1778.1325108153924,1065853.0782103965,1700,0,747.627027027027,78,107,45,36.74338292940653,0.6119123931623931,42.114978902953574,8252.320675105453,105.79898301417248,0
1702,32,2,0,186,0.010752688172043012,0.0,1.0,186,6300,4900,1400,0.7777777777777778,77,49,28,206.9509872185979,0.4334005376344086,0.7608541510900586,0.12763129017508743,1066203.15546715,630.3591199022353,1066833.5145870522,1701,0,744.5752688172043,81,105,44,36.51492503649756,0.6132973251028806,41.85721544715447,8260.569105691064,101.98233463816128,0
1703,32,0,0,186,0.0,0.0,1.0,186,5000,3500,1500,0.7,65,35,30,204.3909094259329,0.433858253414705,0.7591798535068344,0.12667805145179128,1067674.031971262,1444.5732730118775,1069118.605244274,1702,1,745.5752688172043,82,104,45,36.39937488866218,0.6147103658536586,41.67921686746989,8266.265060240992,100.8081104907438,0
1704,32,2,2,186,0.010638297872340425,0.010638297872340425,0.9893617021276596,188,4950,3800,1150,0.7676767676767676,61,38,23,200.579941284215,0.4350555381727159,0.7564730005858569,0.12496382115991472,1069213.4452160497,342.55401234569626,1069555.9992283953,1703,0,738.6329787234042,71,117,47,36.307924781732716,0.6214788732394366,41.49305555555556,8272.222222222224,116.510172143975,0
1705,32,1,0,187,0.0053475935828877,0.0,1.0,187,5650,3800,1850,0.672566371681416,75,38,37,203.06481270379098,0.43570069767887604,0.7567348311716577,0.1271958121291849,1070805.4464937958,438.58148689256404,1071244.0279806885,1704,0,739.4705882352941,73,114,45,36.047402691624036,0.6224315068493151,41.30067567567569,8278.378378378415,113.40244353943034,0
1706,32,1,0,188,0.005319148936170213,0.0,1.0,188,5000,3400,1600,0.68,66,34,32,203.18866911863478,0.4366223641294042,0.7578470069634096,0.12787692085050745,1072198.2979034295,971.7090364528381,1073170.0069398824,1705,0,736.531914893617,77,111,44,35.872583918008,0.6222943722943723,41.132478632478644,8283.76068376071,107.58130758130794,0
1707,32,0,0,188,0.0,0.0,1.0,188,5750,3900,1850,0.6782608695652174,76,39,37,200.8415267088608,0.4366223641294042,0.7554945995446825,0.12672386685234283,1072950.6944444505,-251.388888888574,1072699.305555562,1706,1,737.531914893617,79,109,50,35.84070796460179,0.6223628691983123,41.041666666666686,8286.666666666715,104.8945147679331,0
1708,32,1,1,188,0.005291005291005291,0.005291005291005291,0.9947089947089947,189,5600,4300,1300,0.7678571428571429,69,43,26,201.37244165117872,0.43683979699050624,0.7576637585354284,0.12779166933303177,1074636.1449815365,-119.57911969137876,1074516.5658618452,1707,0,734.6243386243386,82,107,40,35.61955205811139,0.6232215447154472,40.83835341365463,8293.172690763084,101.13625232637906,0
1709,32,0,1,187,0.0,0.005319148936170213,0.9946808510638298,188,5500,4600,900,0.8363636363636363,64,46,18,202.23205767930338,0.4358502104903857,0.7580286805544105,0.12861161894777418,1075260.7216012687,390.4376542316054,1075651.1592555004,1708,1,739.5212765957447,82,106,41,35.52045007100441,0.6239837398373984,40.763052208835354,8295.582329317302,101.16563816240611,0
1710,32,0,4,183,0.0,0.0213903743315508,0.9786096256684492,187,4900,3400,1500,0.6938775510204082,64,34,30,203.43108881112667,0.4349651639737029,0.759224747740735,0.12969751891713505,1075989.6236552736,1477.9481379337562,1077467.5717932074,1709,2,744.4545454545455,82,105,42,35.39972817757992,0.6248729674796748,40.67520080321288,8298.393574297266,101.19992163777154,0
1711,32,1,0,184,0.005434782608695652,0.0,1.0,184,4800,3200,1600,0.6666666666666666,64,32,32,210.35772085912117,0.432804580462501,0.7621636833174588,0.13459874265927246,1077042.066903357,3712.822892637538,1080754.8897959944,1710,0,757.0869565217391,67,117,43,35.09064228218296,0.6332400497512438,40.548406862745104,8302.450980392176,123.91717881182352,0
1712,32,2,1,185,0.010752688172043012,0.005376344086021506,0.9946236559139785,186,5150,3500,1650,0.6796116504854369,68,35,33,201.9859431114637,0.43362697374794146,0.7545047644024832,0.1302110639555033,1079212.1302045283,1247.1359873387119,1080459.266191867,1711,0,749.9354838709677,73,113,40,35.04132791327913,0.6327054794520548,40.28716216216216,8310.810810810808,113.84672343576449,0
1713,32,0,0,185,0.0,0.0,1.0,185,5600,4100,1500,0.7321428571428571,71,41,30,202.2722064137978,0.4334043282412848,0.7530651790712448,0.13088162022591426,1080289.2862197687,1102.4994977716215,1081391.7857175404,1712,1,753.7621621621622,77,108,45,34.90169561940002,0.6321699134199135,40.15758547008545,8314.957264957216,107.98645798645735,0
1714,32,0,0,185,0.0,0.0,1.0,185,5500,4500,1000,0.8181818181818182,65,45,20,209.42556748944318,0.4333749510379945,0.7582359018978744,0.13175254055981478,1072087.6736111154,2404.5138888891165,1074492.1875000047,1713,2,754.7621621621622,77,108,44,35.72476525821601,0.6221590909090908,41.14583333333335,8283.333333333369,107.57575757575803,8
1715,32,1,1,185,0.005376344086021506,0.005376344086021506,0.9946236559139785,186,5400,4600,800,0.8518518518518519,62,46,16,211.35118326165548,0.43330003390487265,0.760950385638433,0.13360054301316,1073490.2587890716,2776.6872829865933,1076266.9460720583,1714,0,751.6989247311828,79,107,38,35.50207149918734,0.6230221518987342,40.97656250000003,8288.750000000071,104.92088607595026,0
1716,32,0,1,184,0.0,0.005405405405405406,0.9945945945945946,185,4250,3100,1150,0.7294117647058823,54,31,23,214.63560045264762,0.4329612220916568,0.7643055257488856,0.13592677204986692,1074029.958767371,4855.013020833834,1078884.9717882047,1715,4,756.7621621621622,79,106,38,35.35049586223073,0.6236814345991561,40.911458333333364,8290.83333333341,104.94725738396723,0
1717,32,0,0,184,0.0,0.0,1.0,184,5450,4300,1150,0.7889908256880734,66,43,23,213.6342525581082,0.43223969470182944,0.7622308896898464,0.13580024058069426,1075125.7668419525,3686.73792104897,1078812.5047630013,1716,5,761.8532608695652,80,104,40,35.24147938681351,0.624609375,40.779320987654344,8295.061728395121,103.68827160493902,0
1718,32,0,0,184,0.0,0.0,1.0,184,4850,3300,1550,0.6804123711340206,64,33,31,214.63894342442242,0.432332501781896,0.7645357337210319,0.13694425079272274,1076205.1934979972,4549.10912805775,1080754.302626055,1717,6,762.8532608695652,85,99,41,35.082547169811356,0.6240196078431373,40.64922480620158,8299.224806201632,97.63793889648979,0
1719,32,1,0,185,0.005405405405405406,0.0,1.0,185,5650,4300,1350,0.7610619469026548,70,43,27,207.6744894318707,0.43265643360752054,0.7585821573786184,0.13364018966857288,1078696.0694204152,2153.5310938101647,1080849.6005142254,1718,0,759.7243243243244,67,118,40,34.95698131760078,0.6352611940298507,40.349264705882355,8308.823529411766,124.01229148375769,0
1720,32,1,2,184,0.005376344086021506,0.010752688172043012,0.989247311827957,186,5800,4300,1500,0.7413793103448276,73,43,30,201.91679270677957,0.43296582873195777,0.7523538054368131,0.1306846195050331,1080362.2590702975,628.6564625851515,1080990.9155328826,1719,0,756.6344086021505,69,117,45,34.90197762761045,0.6361714975845411,40.14880952380953,8315.238095238115,120.51069703243645,0
1721,32,1,1,184,0.005405405405405406,0.005405405405405406,0.9945945945945946,185,4650,3400,1250,0.7311827956989247,59,34,25,205.20775761853207,0.432897571484528,0.7561138932780471,0.13370858494774723,1082298.260807826,2769.1998349621285,1085067.460642788,1720,0,761.5675675675676,71,114,42,34.578964324785346,0.6374706572769953,39.916087962962955,8322.685185185172,117.2209181011996,0
1722,32,0,1,183,0.0,0.005434782608695652,0.9945652173913043,184,5500,3800,1700,0.6909090909090909,72,38,34,206.29289575864956,0.43264990199572345,0.7564935994047732,0.13471103422176564,1082930.0890306695,2380.1567940617997,1085310.2458247314,1721,1,766.6032608695652,72,112,43,34.47327044025157,0.6377314814814814,39.84018264840182,8325.114155251133,115.62658548959907,0
1723,32,0,1,182,0.0,0.00546448087431694,0.994535519125683,183,5400,3600,1800,0.6666666666666666,72,36,36,208.95548649118254,0.43212684401208995,0.7587214929253729,0.1369654697167123,1084013.958003611,3302.132791575364,1087316.0907951863,1722,2,771.3989071038251,73,110,43,34.27112063526402,0.6385559360730594,39.71002252252252,8329.279279279275,114.09971615451062,0
1724,32,0,0,182,0.0,0.0,1.0,182,5300,4100,1200,0.7735849056603774,65,41,24,209.76599844527254,0.4318897607916945,0.758436199148067,0.13789674435893168,1084846.8775111376,3812.7976842719163,1088659.6751954095,1723,3,776.3021978021978,77,105,45,34.14794679796216,0.6377164502164503,39.610042735042725,8332.478632478611,108.21400821400793,0
1725,32,0,2,180,0.0,0.01098901098901099,0.989010989010989,182,4750,3400,1350,0.7157894736842105,61,34,27,210.96588338129018,0.4315627972395928,0.7584289407000893,0.13940548036604397,1086327.8606268521,4685.623351770244,1091013.4839786224,1724,4,777.3021978021978,68,114,45,33.93527906527619,0.6439950980392157,39.432367149758456,8338.164251207729,122.62006251776072,0
1726,32,0,0,180,0.0,0.0,1.0,180,5100,3400,1700,0.6666666666666666,68,34,34,206.16582360297517,0.4309868352989861,0.7489557931595066,0.1368023407552231,1087516.0489541336,3741.7283828165614,1091257.7773369502,1725,5,782.3444444444444,70,110,47,33.9149549803039,0.6443452380952381,39.28990610328639,8342.723004694852,119.18175720992645,0
1727,32,0,0,180,0.0,0.0,1.0,180,3750,2300,1450,0.6133333333333333,52,23,29,206.93622571634342,0.4307579402027726,0.7502274366228443,0.1377054020298456,1088327.0941840261,5292.860243055449,1093619.9544270816,1726,6,783.3444444444444,71,109,44,33.79566067565318,0.644806338028169,39.19270833333333,8345.83333333332,117.54694835680732,0
1728,32,0,1,179,0.0,0.005555555555555556,0.9944444444444445,180,5800,4300,1500,0.7413793103448276,73,43,30,205.81024664539885,0.43066095075522454,0.7481678952682789,0.13742580376669422,1089299.6192338008,3037.804661049471,1092337.4238948503,1727,7,784.3444444444444,75,105,43,33.7061271033601,0.6440277777777778,39.07620614035087,8349.561403508756,111.32748538011676,0
1729,32,0,0,179,0.0,0.0,1.0,179,5600,4000,1600,0.7142857142857143,72,40,32,207.795615671399,0.4300185173560982,0.7506196309624731,0.13950132793299744,1090826.5194852056,3933.793641423612,1094760.3131266292,1728,8,789.2737430167598,76,103,38,33.46771756212977,0.645422149122807,38.89339826839827,8355.411255411265,109.93962178172717,0
1730,32,0,0,179,0.0,0.0,1.0,179,4300,3000,1300,0.6976744186046512,56,30,26,209.60727926385653,0.4298825141757161,0.7531758571494278,0.14116871138143758,1091730.972175374,5666.951753153152,1097397.9239285272,1729,9,790.2737430167598,76,103,38,33.30992024444557,0.6465186403508771,38.785173160173166,8358.874458874478,109.98519024834839,0
1731,32,0,0,179,0.0,0.0,1.0,179,4450,2800,1650,0.6292134831460674,61,28,33,209.53392927099108,0.42972820287489805,0.7539407185746692,0.14163625084297174,1092761.9832758068,5544.142422748262,1098306.125698555,1730,10,791.2737430167598,77,102,42,33.18593821861108,0.6473214285714286,38.66185897435898,8362.820512820525,108.60805860805876,0
1732,32,0,0,179,0.0,0.0,1.0,179,5400,3900,1500,0.7222222222222222,69,39,30,211.4782081235378,0.429511120875442,0.7558740933995294,0.14352867248675028,1093897.4437513961,5067.094255092927,1098964.5380064892,1731,11,792.2737430167598,66,113,44,32.99651662900861,0.6543560606060606,38.52611940298509,8367.164179104508,126.77521483491678,0
1733,32,0,0,179,0.0,0.0,1.0,179,5150,4100,1050,0.7961165048543689,62,41,21,206.98761258429846,0.4292155755026887,0.7491717050459927,0.14113401720294075,1095198.6955768436,4388.512660577764,1099587.2082374212,1732,12,793.2737430167598,66,113,44,32.955243245384686,0.6559343434343434,38.37064676616916,8372.139303482598,126.8505955073121,0
1734,32,0,0,179,0.0,0.0,1.0,179,5550,3600,1950,0.6486486486486487,75,36,39,206.25921818884072,0.42875002615445773,0.7498895726863477,0.14114342255477452,1096203.8676530658,3870.4305435409738,1100074.2981966068,1733,13,794.2737430167598,67,112,43,32.85179034743764,0.6565609452736318,38.25061274509804,8375.98039215686,125.0146327187591,0
1735,32,0,0,179,0.0,0.0,1.0,179,4900,3700,1200,0.7551020408163265,61,37,24,207.4686035576409,0.42838909463728997,0.7515206239368541,0.14288846514052414,1098000.9228722113,4860.143634659679,1102861.066506871,1734,14,795.2737430167598,67,112,40,32.6012245872561,0.6587375621890548,38.03615196078431,8382.843137254891,125.117061750073,0
1736,32,0,0,179,0.0,0.0,1.0,179,5750,4100,1650,0.7130434782608696,74,41,33,208.2443427248437,0.42815631996317455,0.7517918838983568,0.1439403204109087,1099002.7777777796,4222.222222222283,1103225.0000000019,1735,15,796.2737430167598,69,110,45,32.458929517753035,0.6588164251207729,37.91666666666667,8386.66666666668,121.54589371980697,0
1737,32,0,0,179,0.0,0.0,1.0,179,4200,2800,1400,0.6666666666666666,56,28,28,208.1601138026224,0.4279104680601762,0.7519397075956509,0.14424739664310962,1099706.6327214066,5783.011563357329,1105489.644284764,1736,16,797.2737430167598,71,108,37,32.375478266467994,0.6585974178403755,37.832754629629626,8389.351851851843,118.1598852373499,0
1738,32,0,0,179,0.0,0.0,1.0,179,4750,3400,1350,0.7157894736842105,61,34,27,207.2212790511259,0.4274475341577218,0.7505818480429913,0.144176440254269,1100822.5563478635,5072.77162694676,1105895.3279748103,1737,17,798.2737430167598,72,107,41,32.26435280890726,0.6594328703703703,37.69977168949771,8393.607305936053,116.57787924911185,0
1739,32,0,0,179,0.0,0.0,1.0,179,5150,3600,1550,0.6990291262135923,67,36,31,208.04809640544133,0.42713368066453244,0.7525763120206117,0.14545136904227018,1102154.632314746,4910.2346395042,1107064.8669542503,1738,18,799.2737430167598,75,104,42,32.08071135133252,0.6595833333333334,37.541118421052616,8398.684210526279,111.98245614035038,0
1740,32,0,0,179,0.0,0.0,1.0,179,5050,3600,1450,0.7128712871287128,65,36,29,209.46154917647237,0.4266197455694349,0.7544777649459031,0.14682869085216946,1102886.063202849,5352.444672721655,1108238.5078755706,1739,19,800.2737430167598,67,112,43,31.954715852733514,0.6646455223880596,37.45404411764704,8401.470588235248,125.39508340649624,0
1741,32,0,1,178,0.0,0.00558659217877095,0.994413407821229,179,4400,3100,1300,0.7045454545454546,57,31,26,208.69606269001846,0.4265268972443663,0.7536499579449512,0.14656602223248555,1103400.9192678253,5855.085483948223,1109256.0047517736,1740,20,801.2737430167598,67,112,42,31.912260106165764,0.6652674129353233,37.39276960784312,8403.431372548985,125.4243488440147,0
1742,32,0,0,178,0.0,0.0,1.0,178,6150,5200,950,0.8455284552845529,71,52,19,208.15146358118346,0.4260425262912884,0.7512003935780167,0.146717696261779,1104402.994381428,4226.619932787002,1108629.614314215,1741,21,806.4157303370787,68,110,37,31.804861230822272,0.6659007352941176,37.273550724637666,8407.24637681156,123.63597612958176,0
1743,32,0,0,178,0.0,0.0,1.0,178,4600,2500,2100,0.5434782608695652,67,25,42,208.28408030437214,0.4258269588861381,0.7501431548484052,0.14748720729269027,1105661.9861325412,5858.3579818242415,1111520.3441143655,1742,22,807.4157303370787,71,107,38,31.64855072463768,0.6657863849765258,37.12384259259258,8412.037037037011,118.47939488784523,0
1744,32,0,0,178,0.0,0.0,1.0,178,4600,3400,1200,0.7391304347826086,58,34,24,209.73688942202128,0.42542293531390846,0.7513380432455579,0.14911430905483378,1106760.8655953207,6225.71625679712,1112986.5818521178,1743,23,808.4157303370787,73,105,44,31.477021337329607,0.6660958904109588,36.99324324324323,8416.216216216182,115.29063309885181,0
1745,32,0,0,178,0.0,0.0,1.0,178,5050,3700,1350,0.7326732673267327,64,37,27,208.80330565345957,0.42483310057343576,0.7498696213387854,0.14929321247659122,1108303.0707117538,5633.468966098746,1113936.5396778525,1744,24,809.4157303370787,76,102,34,31.314572089437153,0.666529605263158,36.81006493506493,8422.077922077908,110.816814764183,0
1746,32,0,0,178,0.0,0.0,1.0,178,5350,4100,1250,0.7663551401869159,66,41,25,211.45829014141967,0.4245295869569818,0.7535309001753261,0.15169969410329726,1109214.7384091388,5960.530396731781,1115175.2688058706,1745,25,810.4157303370787,76,102,37,31.13418195208,0.6676260964912281,36.70183982683983,8425.541125541133,110.86238323080438,0
1747,32,0,0,178,0.0,0.0,1.0,178,5200,4000,1200,0.7692307692307693,64,40,24,210.5379910119189,0.4240263759283946,0.7536569588389983,0.15144027261300252,1109933.3735022875,5936.62852285066,1115870.0020251381,1746,26,811.4157303370787,78,100,39,31.07133917396743,0.6676014957264957,36.6165611814346,8428.27004219409,108.05474413069346,0
1748,32,0,0,178,0.0,0.0,1.0,178,5200,4100,1100,0.7884615384615384,63,41,22,240.43764599670487,0.42385841850229583,0.7765638776479107,0.1664310725074683,1099400.9150955144,12067.473606437718,1111468.388701952,1747,27,812.4157303370787,78,100,33,31.566587022132815,0.6549145299145299,37.869198312236286,8388.185654008432,107.54084171805683,8
1749,32,0,0,178,0.0,0.0,1.0,178,5100,3800,1300,0.7450980392156863,64,38,26,240.90001060415753,0.423385624960325,0.777662778513649,0.16716900115597957,1100095.062934029,12302.58246527781,1112397.6453993067,1748,28,813.4157303370787,79,99,33,31.469733836527958,0.6553270042194093,37.786458333333336,8390.833333333341,106.21308016877647,0
1750,32,0,1,177,0.0,0.0056179775280898875,0.9943820224719101,178,5100,3900,1200,0.7647058823529411,63,39,24,243.55353790562614,0.42319650754353666,0.7811595196546237,0.16950242683563468,1100899.9711853075,12925.616572476789,1113825.5877577842,1749,29,814.4157303370787,81,97,33,31.301909293428267,0.6554783950617284,37.69054878048781,8393.9024390244,103.62842517314073,0
1751,32,0,1,176,0.0,0.005649717514124294,0.9943502824858758,177,4950,3300,1650,0.6666666666666666,66,33,33,238.38063863995583,0.42321119029275805,0.7754933464329168,0.16662037671130903,1102093.060813657,12193.529535484853,1114286.590349142,1750,30,810.6836158192091,85,92,34,31.292112793058884,0.6553921568627451,37.54844961240311,8398.44961240313,98.80528955768389,0
1752,32,0,0,176,0.0,0.0,1.0,176,4650,3600,1050,0.7741935483870968,57,36,21,223.2174715142734,0.42229978354978354,0.7622671536053891,0.14745374872320455,1086235.8024863226,8643.361859854816,1094879.1643461774,1751,31,815.8920454545455,66,110,41,33.627329594048945,0.6450441919191919,39.443407960198996,8337.810945273617,126.33046886778207,7
1753,32,0,1,175,0.0,0.005681818181818182,0.9943181818181818,176,4500,2900,1600,0.6444444444444445,61,29,32,223.272327636922,0.4223390151515152,0.7619955261682818,0.14791369481423322,1087054.4784580506,8841.836734693923,1095896.3151927446,1752,32,816.8920454545455,69,107,42,33.5255385552257,0.6443236714975845,39.345238095238095,8340.952380952385,120.88336783988964,0
1754,32,0,1,174,0.0,0.005714285714285714,0.9942857142857143,175,4900,3600,1300,0.7346938775510204,62,36,26,225.7953659763303,0.4220224411603722,0.7629655841561562,0.14991135306067724,1087675.1736111077,9218.402777777574,1096893.5763888853,1753,33,822.1542857142857,69,106,40,33.383689572513,0.6450785024154589,39.27083333333332,8343.333333333307,120.91787439613488,0
1755,32,0,0,174,0.0,0.0,1.0,174,5150,3900,1250,0.7572815533980582,64,39,25,226.78067441734675,0.4218774223196687,0.7637670224855158,0.15091921923089682,1088342.843473593,9413.024808046805,1097755.8682816399,1754,34,823.5344827586207,68,106,39,33.276173111059634,0.6464460784313726,39.190821256038646,8345.893719806762,122.73373117362884,0
1756,32,0,0,174,0.0,0.0,1.0,174,4400,3000,1400,0.6818181818181818,58,30,28,223.65906780008675,0.42157082585874694,0.7603173589689365,0.14923845597378757,1089098.9433825752,9517.370883801152,1098616.3142663764,1755,35,824.5344827586207,68,106,42,33.2649818693824,0.6473651960784313,39.10024154589372,8348.792270531394,122.77635691957933,0
1757,32,0,1,173,0.0,0.005747126436781609,0.9942528735632183,174,3700,2500,1200,0.6756756756756757,49,25,24,223.2404600634569,0.4213272097092109,0.759485019174817,0.14935685269261015,1089855.3058414443,10159.959975728747,1100015.265817173,1756,36,825.5344827586207,68,106,44,33.1833015193583,0.6482843137254901,39.009661835748794,8351.690821256047,122.8189826655301,0
1758,32,0,0,173,0.0,0.0,1.0,173,5150,3600,1550,0.6990291262135923,67,36,31,220.6801039147182,0.4207652798315186,0.7560137717552671,0.1482542548325751,1091023.1750797534,8403.421529993193,1099426.5966097466,1757,37,830.693641618497,72,101,40,33.10724043715846,0.6475694444444444,38.869863013698634,8356.164383561652,116.05783866057851,0
1759,32,0,0,173,0.0,0.0,1.0,173,4600,3200,1400,0.6956521739130435,60,32,28,217.93092661751123,0.4206812631626115,0.752442441461743,0.14037035666411737,1078964.9871057323,7827.967885560658,1086792.954991293,1758,38,831.693641618497,70,103,44,34.65760357815445,0.6339285714285714,40.316901408450704,8309.859154929572,118.71227364185104,8
1760,32,0,0,173,0.0,0.0,1.0,173,5700,4500,1200,0.7894736842105263,69,45,24,221.4361758348414,0.4208030873325268,0.7570394825358393,0.14364962175952514,1081030.2120472873,7575.839223535724,1088606.051270823,1759,39,832.693641618497,72,101,37,34.31266926511493,0.6354166666666667,40.06849315068493,8317.808219178074,115.52511415525103,0
1761,32,1,0,174,0.005747126436781609,0.0,1.0,174,4900,3500,1400,0.7142857142857143,63,35,28,222.05949137201245,0.4212538480278165,0.7595887053225929,0.1446675304157019,1082255.9552796048,8365.041392744104,1090620.9966723488,1760,0,828.9022988505748,73,101,36,34.14587392653533,0.6364155251141552,39.921171171171174,8322.52252252253,114.00715784277438,0
1762,32,0,0,174,0.0,0.0,1.0,174,5100,3600,1500,0.7058823529411765,66,36,30,206.15204928596557,0.4211348083183841,0.7414150632402068,0.121891897470579,1053511.1785761076,3536.6976818271964,1057047.8762579348,1761,1,829.9022988505748,76,98,38,38.10837111626595,0.5997807017543859,43.39826839826838,8211.255411255364,108.04283435862321,8
1763,32,0,0,174,0.0,0.0,1.0,174,5400,3700,1700,0.6851851851851852,71,37,34,175.65034284203563,0.42134797244922817,0.6972717733473235,0.11085746803209257,1073025.7561436668,-2504.531611006145,1070521.2245326606,1762,2,830.9022988505748,91,83,34,36.48383758890051,0.6181318681318682,41.03260869565217,8286.956521739126,91.06545628284755,8
1764,32,0,0,174,0.0,0.0,1.0,174,4950,4000,950,0.8080808080808081,59,40,19,217.3554202106295,0.42136527473257596,0.7509739660895522,0.13663851440487232,1071866.4421478938,6845.196188545664,1078711.6383364394,1763,3,831.9022988505748,77,97,38,35.54678766145539,0.6218885281385281,41.17254273504274,8282.478632478642,107.5646575646577,7
1765,32,1,0,175,0.005714285714285714,0.0,1.0,175,4850,3200,1650,0.6597938144329897,65,32,33,219.4374751348106,0.4215544608648057,0.7557598868230753,0.1387120970084774,1073490.2587890623,7262.798394097227,1080753.0571831595,1764,0,828.1428571428571,79,96,37,35.29261758742607,0.6230221518987342,40.9765625,8288.749999999998,104.92088607594934,0
1766,32,1,1,175,0.005681818181818182,0.005681818181818182,0.9943181818181818,176,4500,3100,1400,0.6888888888888889,59,31,28,218.18494254456766,0.42223349567099566,0.7575333441733456,0.1387503933470546,1075246.7555068058,7220.530314296966,1082467.2858211028,1765,0,824.4318181818181,81,95,39,35.10861264925434,0.6243569958847737,40.76473577235772,8295.528455284535,102.41393154672265,0
1767,32,0,0,175,0.0,0.0,1.0,175,4650,3100,1550,0.6666666666666666,62,31,31,217.12439696591073,0.42146962233169133,0.7556917551400468,0.1387448312779933,1076656.868450838,7103.694660318728,1083760.5631111567,1766,1,830.1142857142858,68,107,40,34.96248714815031,0.6321997549019608,40.59480676328502,8300.96618357487,122.07303211139515,0
1768,32,0,0,175,0.0,0.0,1.0,175,4550,3500,1050,0.7692307692307693,56,35,21,215.66054617371628,0.4210426929392446,0.7543089809213597,0.13834463096337757,1077785.0124857025,6937.140890102322,1084722.153375805,1767,2,831.1142857142858,68,107,40,34.86166046223052,0.633578431372549,40.45893719806762,8305.314009661812,122.13697073032075,0
1769,32,0,0,175,0.0,0.0,1.0,175,4900,3400,1500,0.6938775510204082,64,34,30,214.4908498288199,0.4208921729611385,0.7527859189521089,0.13811311179014354,1078877.905328793,6381.88775510169,1085259.7930838948,1768,3,832.1142857142858,69,106,40,34.75764087870103,0.6343599033816425,40.327380952380935,8309.52380952377,120.42788129744594,0
1770,32,0,0,175,0.0,0.0,1.0,175,5100,3700,1400,0.7254901960784313,65,37,28,206.11256381160268,0.4205391351943076,0.7384935507422736,0.12472997418289744,1060538.6272699274,3618.06709756841,1064156.6943674958,1769,4,833.1142857142858,75,100,38,37.237365133446886,0.6088888888888888,42.5438596491228,8238.596491228056,109.84795321637408,8
1771,32,2,0,177,0.011299435028248588,0.0,1.0,177,4700,2700,2000,0.574468085106383,67,27,40,204.0100497293709,0.422681529275809,0.7383738510047266,0.12409304807854422,1062080.5365668347,3235.0206163191715,1065315.557183154,1770,0,824.6892655367232,79,98,42,37.10059003386059,0.609045358649789,42.356770833333314,8244.583333333288,104.361814345991,0
1772,32,0,0,177,0.0,0.0,1.0,177,5150,3600,1550,0.6990291262135923,67,36,31,205.2630179910925,0.42235918507104947,0.737032536703524,0.12548043081442772,1063576.4921729404,3112.5841295591645,1066689.0763024995,1771,1,825.6892655367232,85,92,41,36.883201791474825,0.6085784313725491,42.175387596899206,8250.387596899178,97.06338349293151,0
1773,32,0,0,177,0.0,0.0,1.0,177,5200,3600,1600,0.6923076923076923,68,36,32,205.23318136210383,0.42250631313131315,0.7398037155454225,0.12595456833073254,1064746.4726275501,3104.261184285841,1067850.733811836,1772,2,826.6892655367232,87,90,38,36.73929128619283,0.6093151340996168,42.033617424242415,8254.924242424213,94.88418669453118,0
1774,32,3,0,180,0.016666666666666666,0.0,1.0,180,4350,2900,1450,0.6666666666666666,58,29,29,206.2582433890385,0.4244620318642665,0.7486675533581029,0.12760118910171858,1067129.7279871765,3670.8606325713713,1070800.588619748,1773,0,813.8944444444444,92,88,42,36.41835089849791,0.6106204710144927,41.745071684587806,8264.15770609317,89.82780115318664,0
1775,32,1,1,180,0.0055248618784530384,0.0055248618784530384,0.994475138121547,181,5300,3800,1500,0.7169811320754716,68,38,30,205.18715364361015,0.42489257213014114,0.7502487240403324,0.12746943963403645,1068367.6613550673,2343.0638956657303,1070710.725250733,1774,0,810.3922651933701,72,109,43,36.293187549468975,0.6199363425925926,41.59531963470322,8268.94977168956,114.84652460679945,0
1776,32,1,1,180,0.0055248618784530384,0.0055248618784530384,0.994475138121547,181,4600,3200,1400,0.6956521739130435,60,32,28,199.91066103151243,0.4245523838755883,0.7439507037551951,0.1248978262365098,1070045.0619421427,1982.6831332721672,1072027.745075415,1775,0,811.3646408839779,75,106,45,36.222705109179586,0.6205555555555555,41.392543859649145,8275.43859649128,110.3391812865504,0
1777,32,0,0,180,0.0,0.0,1.0,180,5350,3600,1750,0.6728971962616822,71,36,35,203.4533028342947,0.4245855317608111,0.7469210663878718,0.12777615506303605,1071583.4715428941,2253.439309608544,1073836.9108525028,1776,1,813.0666666666667,76,104,42,35.94147499564385,0.621984649122807,41.20670995670998,8281.385281385335,108.96559580770179,0
1778,32,0,0,180,0.0,0.0,1.0,180,4950,3300,1650,0.6666666666666666,66,33,33,200.5380139315714,0.42435017070142766,0.7422433717076569,0.12647793551921924,1072824.377024262,2078.4139731643254,1074902.7909974263,1777,2,814.0666666666667,81,99,47,35.864117281528,0.6213991769547325,41.0569105691057,8286.178861788649,102.29850446652652,0
1779,32,0,0,180,0.0,0.0,1.0,180,5050,3600,1450,0.7128712871287128,65,36,29,201.07947012834876,0.4243301262156011,0.7435396575982591,0.12729542348265693,1073923.2487045126,2138.7835616037573,1076062.0322661165,1778,3,815.0666666666667,86,94,42,35.71484964722558,0.6208817829457365,40.924329501915715,8290.42145593871,96.40024948765941,0
1780,32,0,0,180,0.0,0.0,1.0,180,5150,3600,1550,0.6990291262135923,67,36,31,201.76590399189382,0.4243786209393751,0.7449714183637013,0.12805958396220232,1074677.7777777808,2216.666666666899,1076894.4444444478,1779,4,816.0666666666667,89,91,43,35.604233654876744,0.6207865168539326,40.83333333333334,8293.333333333358,93.18352059925121,0
1781,32,0,1,179,0.0,0.005555555555555556,0.9944444444444445,180,4600,3100,1500,0.6739130434782609,61,31,30,201.91534596337917,0.4240682547072212,0.7465269407615716,0.12853383532042267,1075541.8402777822,2833.680555555788,1078375.520833338,1780,5,817.0666666666667,89,91,45,35.4940906655953,0.6218398876404494,40.72916666666668,8296.6666666667,93.22097378277192,0
1782,32,0,1,178,0.0,0.00558659217877095,0.994413407821229,179,4300,3100,1200,0.7209302325581395,55,31,24,206.39983741479625,0.4239572217688783,0.7521368210878716,0.13173445844216347,1076309.1079970333,4330.004979730711,1080639.112976764,1781,6,819.8435754189944,88,91,45,35.28344990974731,0.6231060606060606,40.63670411985021,8299.62546816485,94.31392577460056,0
1783,32,0,1,177,0.0,0.0056179775280898875,0.9943820224719101,178,5100,3600,1500,0.7058823529411765,66,36,30,205.95045040279967,0.4236507860936541,0.7500315761526579,0.13182643367192418,1077147.4489795917,3667.8004535146983,1080815.2494331065,1782,7,822.6629213483146,69,109,42,35.1920356350845,0.6322463768115942,40.535714285714285,8302.857142857141,120.33126293995856,0
1784,32,0,0,177,0.0,0.0,1.0,177,4550,3400,1150,0.7472527472527473,57,34,23,204.58580573946364,0.4234760208012327,0.745795631282641,0.13142037351738386,1078183.5241133382,4166.209003148169,1082349.7331164863,1783,8,827.9548022598871,72,105,45,35.10013559073588,0.6319444444444444,40.41095890410958,8306.849315068463,115.37290715372865,0
1785,32,0,0,177,0.0,0.0,1.0,177,4100,2900,1200,0.7073170731707317,53,29,24,206.39302193704003,0.4234104819380243,0.7486915741035687,0.13290658928557117,1078894.8442484469,5035.273451345589,1083930.1176997924,1784,9,828.9548022598871,72,105,46,34.96583873685752,0.6328125,40.32534246575341,8309.589041095851,115.41095890410904,0
1786,32,0,0,177,0.0,0.0,1.0,177,4950,2800,2150,0.5656565656565656,71,28,43,206.4878975022011,0.42329277948981336,0.7481059405073585,0.13368126513031714,1080444.7530864144,4269.75308641946,1084714.506172834,1785,10,829.9548022598871,74,103,45,34.773071441297006,0.6337274774774775,40.13888888888887,8315.555555555513,112.3723723723718,0
1787,32,0,0,177,0.0,0.0,1.0,177,4950,3300,1650,0.6666666666666666,66,33,33,203.63230247919492,0.42300654853620956,0.7446204049791365,0.13226927034909755,1081400.0092455524,3691.594756738494,1085091.6040022909,1786,11,830.9548022598871,77,100,45,34.73008809780655,0.6335227272727273,40.02403846153843,8319.230769230693,108.04195804195706,0
1788,32,0,0,177,0.0,0.0,1.0,177,4700,3100,1600,0.6595744680851063,63,31,32,204.2938334220397,0.42299986089710667,0.7458300393893624,0.1331714816719591,1082424.5473304505,4126.532032850441,1086551.079363301,1787,12,831.9548022598871,81,96,39,34.58725071225068,0.6331018518518519,39.90091463414632,8323.170731707258,102.75519421860812,0
1789,32,0,0,177,0.0,0.0,1.0,177,4200,3000,1200,0.7142857142857143,54,30,24,203.2069746213847,0.42263739085772983,0.7449618796882971,0.1327775002968309,1083106.8736811772,4418.97419847537,1087525.8478796526,1788,13,832.9548022598871,83,94,40,34.53188797801185,0.6331576305220883,39.81894841269839,8325.793650793586,100.31076687703116,0
1790,32,0,1,176,0.0,0.005649717514124294,0.9943502824858758,177,5000,3500,1500,0.7,65,35,30,192.21084294812147,0.42248758774182504,0.7185431649832661,0.12111560610897404,1072556.663598108,831.4040839631398,1073388.0676820714,1789,14,833.9548022598871,91,86,41,36.11267510677686,0.6175595238095238,41.089221014492736,8285.14492753618,91.04554865424373,8
1791,32,2,2,176,0.011235955056179775,0.011235955056179775,0.9887640449438202,178,4350,2900,1450,0.6666666666666666,58,29,29,187.58237956674216,0.4232507300196788,0.7137108894531792,0.11868529996886269,1073761.193252799,333.7359433564352,1074094.9291961556,1790,0,824.7359550561798,97,81,35,36.084441161989155,0.6172680412371134,40.94387755102038,8289.795918367252,85.46181359141497,0
1792,32,0,0,176,0.0,0.0,1.0,176,5050,3600,1450,0.7128712871287128,65,36,29,192.8652276522104,0.4222936958874459,0.7197409723085064,0.1223381217116685,1074505.0069444315,1196.9305555549854,1075701.9374999865,1791,16,835.1079545454545,99,77,36,35.85614465257119,0.6176346801346801,40.854166666666636,8292.666666666566,83.76430976430875,0
1793,32,0,0,176,0.0,0.0,1.0,176,5700,4200,1500,0.7368421052631579,72,42,30,194.74400326365696,0.42181953463203464,0.723466119788744,0.12405346349629669,1075741.2886258916,998.8330046017632,1076740.1216304933,1792,17,836.1079545454545,103,73,38,35.655516069221264,0.6181229773462783,40.705128205128176,8297.4358974358,80.55763007219224,0
1794,32,0,0,176,0.0,0.0,1.0,176,5250,3600,1650,0.6857142857142857,69,36,33,193.2897896304717,0.4216937229437229,0.7223948310130197,0.12349852222477882,1076619.7379506913,1169.920532100813,1077789.658482792,1793,18,837.1079545454545,80,96,41,35.585328772329945,0.6264322916666667,40.599279835390966,8300.823045267538,103.76028806584422,0
1795,32,0,0,176,0.0,0.0,1.0,176,4350,2900,1450,0.6666666666666666,58,29,29,191.72969394030616,0.42156452922077925,0.7199038628462537,0.12263374692586596,1076933.4995084028,1746.0260509621671,1078679.525559365,1794,19,838.1079545454545,81,95,41,35.58727700794854,0.6264146090534979,40.56148373983742,8302.032520325267,102.49422864599094,0
1796,32,0,0,176,0.0,0.0,1.0,176,4250,3100,1150,0.7294117647058823,54,31,23,192.00355233473826,0.4215022997835498,0.7214958457886409,0.1231586061501987,1077760.8425670606,1936.782068031463,1079697.624635092,1795,20,839.1079545454545,82,94,42,35.47862266279822,0.6270325203252032,40.46184738955825,8305.220883534179,101.28318150651438,0
1797,32,0,0,176,0.0,0.0,1.0,176,4850,4000,850,0.8247422680412371,57,40,17,191.7509219670138,0.4215854978354978,0.7191108955192225,0.12331776214710367,1078518.4770484113,1311.3824664987392,1079829.85951491,1796,21,840.1079545454545,85,91,40,35.392222610994494,0.6268382352941176,40.37063953488374,8308.139534883774,97.74281805745616,0
1798,32,0,0,176,0.0,0.0,1.0,176,5150,3600,1550,0.6990291262135923,67,36,31,215.86948147422143,0.42180465367965364,0.7507471906606327,0.1336326694480642,1067319.789073096,5730.353886876261,1073050.1429599721,1797,22,841.1079545454545,93,83,40,36.14664228200393,0.6105510752688172,41.72207446808507,8264.893617021165,88.86982383893726,8
1799,32,0,0,176,0.0,0.0,1.0,176,5550,4100,1450,0.7387387387387387,70,41,29,216.57829659141225,0.4214508928571428,0.7529740715923481,0.1346134108305825,1068516.0005668965,5533.475056689505,1074049.475623586,1798,23,842.1079545454545,69,107,41,35.98050788897846,0.6216787439613527,41.57738095238096,8269.523809523835,119.84817115251934,0
1800,32,0,0,176,0.0,0.0,1.0,176,4850,3000,1850,0.6185567010309279,67,30,37,211.45301080467326,0.4212398538961039,0.7521757789551415,0.13126897067509868,1068157.713529654,5123.032908016355,1073280.7464376704,1799,24,843.1079545454545,67,109,42,36.15720292089089,0.6223569651741294,41.62071078431374,8268.137254901978,123.4050336552534,8
1801,32,2,0,178,0.011235955056179775,0.0,1.0,178,5300,3600,1700,0.6792452830188679,70,36,34,205.5855781463169,0.4227045377600034,0.7490679643008182,0.12875921971398585,1070769.8400259353,3126.9673246742436,1073896.8073506095,1800,0,834.623595505618,71,107,43,35.98658026210318,0.6233861502347418,41.304976851851855,8278.240740740746,116.59494001043305,0
1802,32,1,1,178,0.00558659217877095,0.00558659217877095,0.994413407821229,179,5650,4300,1350,0.7610619469026548,70,43,27,206.0369931439467,0.4235348272759609,0.7504898271510336,0.12969684279669186,1072260.250000007,2735.0555555558667,1074995.305555563,1801,0,830.9553072625698,74,105,46,35.79121733998606,0.6237331081081081,41.12500000000002,8284.000000000055,111.94594594594669,0
1803,32,1,1,178,0.00558659217877095,0.00558659217877095,0.994413407821229,179,4950,3700,1250,0.7474747474747475,62,37,25,199.4989780278604,0.4245038499361831,0.7466877043614235,0.12314596436902568,1066470.1614769688,1801.9414623724124,1068272.1029393412,1802,0,831.2290502793296,78,101,40,36.674327545114096,0.6148504273504274,41.82489451476793,8261.603375527407,105.91799199394111,8
1804,32,2,0,180,0.011111111111111112,0.0,1.0,180,4700,3400,1300,0.723404255319149,60,34,26,206.59364323646685,0.42562137906062486,0.7548476638244743,0.12120353571642903,1051127.511053439,2731.2524029217966,1053858.763456361,1803,0,827.5888888888888,67,113,42,38.393497489839824,0.6013681592039801,43.68872549019607,8201.96078431371,122.41732513901059,8
1805,32,0,0,180,0.0,0.0,1.0,180,5550,3600,1950,0.6486486486486487,75,36,39,207.53108535284687,0.42600157769501346,0.7555212155700768,0.12219516626997529,1052234.9157798246,2124.2908235893915,1054359.206603414,1804,1,828.5888888888888,68,112,38,38.231686976315196,0.6021752450980392,43.55374396135263,8206.28019323666,120.68059107700971,0
1806,32,1,1,180,0.0055248618784530384,0.0055248618784530384,0.994475138121547,181,5000,3600,1400,0.72,64,36,28,203.44979270755363,0.42723424391242065,0.7519331410107475,0.12037332965465498,1053711.7546510538,1675.48761145355,1055387.2422625073,1805,0,825.0055248618785,71,110,45,38.15278873980528,0.602406103286385,43.37384259259256,8212.037037036964,115.66249347939386,0
1807,32,2,0,182,0.01098901098901099,0.0,1.0,182,5950,4500,1450,0.7563025210084033,74,45,29,200.13577181230792,0.4287358589844778,0.7483218563910208,0.11905219340377826,1055350.6968490265,-107.31475069274029,1055243.3820983337,1806,0,821.2417582417582,75,107,40,38.034341978866436,0.6025,43.17434210526314,8218.421052631547,109.57894736842063,0
1808,32,3,3,182,0.016216216216216217,0.016216216216216217,0.9837837837837837,185,4150,3100,1050,0.7469879518072289,52,31,21,198.44768466591947,0.4299525068546808,0.7499746835443044,0.11912892924473847,1058112.2504340245,845.9852430554351,1058958.23567708,1807,0,808.9081081081081,79,106,37,37.735232067510545,0.6041666666666667,42.83854166666666,8229.16666666664,104.16666666666633,0
1809,32,2,1,183,0.010869565217391304,0.005434782608695652,0.9945652173913043,184,5900,4400,1500,0.7457627118644068,74,44,30,208.20782295935666,0.42933235824027877,0.7611713725903613,0.11881829491798127,1042593.9089885486,715.2416042386185,1043309.1505927872,1808,0,814.1141304347826,68,116,42,39.41638575117789,0.5902267156862745,44.73128019323674,8168.599033816484,120.12645637965417,8
1810,32,6,0,189,0.031746031746031744,0.0,1.0,189,4750,3400,1350,0.7157894736842105,61,34,27,202.00921550990273,0.4327413786633645,0.7592802418097173,0.11677484390999998,1046582.8427977884,-266.1241920587804,1046316.7186057296,1809,0,793.5079365079365,75,114,48,39.076902465166164,0.5916666666666667,44.2434210526316,8184.2105263158255,109.12280701754435,0
1811,32,1,2,188,0.005263157894736842,0.010526315789473684,0.9894736842105263,190,5500,4000,1500,0.7272727272727273,70,40,30,202.69198482913785,0.43319873758470245,0.7611913134424215,0.11808609617529917,1048983.013847808,-975.9101742269804,1048007.1036735809,1810,0,790.3263157894737,77,113,40,38.760398737808394,0.59375,43.95032051282055,8193.589743589826,106.41025641025747,0
1812,32,1,0,189,0.005291005291005291,0.0,1.0,189,4750,3400,1350,0.7157894736842105,61,34,27,204.8089319137901,0.432553754362265,0.7638169275205926,0.11966007075962314,1049858.5799958052,454.08288589405583,1050312.6628816992,1811,0,795.4920634920635,77,112,42,38.59716863910468,0.594832251082251,43.843482905982924,8197.00854700859,106.45465645465703,0
1813,32,1,0,190,0.005263157894736842,0.0,1.0,190,5250,3500,1750,0.6666666666666666,70,35,35,201.5535093771483,0.4333257913301773,0.7617972050187629,0.11829515511777675,1051253.1575896265,-873.247368800618,1050379.9102208258,1812,0,792.3,67,123,41,38.507054423394905,0.601523631840796,43.67340686274509,8202.450980392137,122.42464149839012,0
1814,32,5,0,195,0.02564102564102564,0.0,1.0,195,5500,3900,1600,0.7090909090909091,71,39,32,193.15689915850675,0.4355493876112433,0.759257256174509,0.11483829792414049,1055185.4938271542,-3736.7283950620954,1051448.7654320921,1813,0,772.9589743589744,74,121,46,38.23406796466554,0.602759009009009,43.19444444444442,8217.777777777726,111.05105105105035,0
1815,32,3,2,196,0.015151515151515152,0.010101010101010102,0.98989898989899,198,4550,3100,1450,0.6813186813186813,60,31,29,190.37778408208834,0.4364408680715787,0.7576873364695262,0.11386088398855657,1056988.7741464998,-3904.563875669607,1053084.2102708302,1814,0,762.2323232323232,81,117,39,38.08191856538001,0.6019804526748971,42.97510162601624,8224.796747967424,101.54070059219042,0
1816,32,1,1,196,0.005076142131979695,0.005076142131979695,0.9949238578680203,197,6200,4700,1500,0.7580645161290323,77,47,30,201.29267456816456,0.4362190942366794,0.7609342463091264,0.11677465110244813,1047678.1605292591,-3422.0121960820125,1044256.1483331771,1815,0,767.0964467005076,83,114,38,38.958737177933926,0.5897339357429718,44.10962301587302,8188.492063492072,98.65653088544664,8
1817,32,2,1,197,0.010101010101010102,0.005050505050505051,0.9949494949494949,198,5900,4100,1800,0.6949152542372882,77,41,36,221.73097058382166,0.43717953648156693,0.7862559977546677,0.12683731374451715,1043333.9495962651,767.8898574067925,1044101.839453672,1816,0,764.1919191919192,68,130,41,38.9785939501429,0.5911458333333333,44.64070048309182,8171.49758454113,120.16908212560486,8
1818,32,4,0,201,0.01990049751243781,0.0,1.0,201,6500,4600,1900,0.7076923076923077,84,46,38,216.60063585797548,0.4385945273631841,0.7850279645366285,0.12516540560647993,1046473.7034331717,-1366.626085544577,1045107.0773476271,1817,0,753.7313432835821,73,128,43,38.717341846469985,0.5924657534246576,44.256756756756786,8183.783783783853,112.10662717512128,0
1819,32,2,3,200,0.009852216748768473,0.014778325123152709,0.9852216748768473,203,5400,4000,1400,0.7407407407407407,68,40,28,211.02593219983498,0.43959420572599134,0.7813848239434686,0.1227551784444752,1048517.0049450529,-1747.1443208178653,1046769.860624235,1818,0,747.2955665024631,80,123,38,38.60508975518272,0.5919270833333333,44.00720164609056,8191.76954732516,102.39711934156449,0
1820,32,0,0,200,0.0,0.0,1.0,200,5850,3800,2050,0.6495726495726496,79,38,41,214.40027509546638,0.4379250418760469,0.7816703956066307,0.12496727356335102,1049130.7400173668,-863.216145833092,1048267.5238715337,1819,1,759.49,79,121,42,38.44219295569347,0.5930907172995781,43.932291666666686,8194.166666666712,103.72362869198369,0
1821,32,0,0,200,0.0,0.0,1.0,200,5500,4000,1500,0.7272727272727273,70,40,30,214.42174609360558,0.43822079145728643,0.7832856118118254,0.1256413796987704,1050750.6164996536,-439.24362024283073,1050311.3728794106,1820,2,760.49,67,133,42,38.239795664215826,0.6009017412935324,43.734681372548984,8200.490196078352,122.39537606087092,0
1822,32,2,1,201,0.009900990099009901,0.0049504950495049506,0.995049504950495,202,5650,3800,1850,0.672566371681416,75,38,37,205.3096115348254,0.4393297538709095,0.7747126751005471,0.12119762974304031,1053018.0277777696,-2811.055555555986,1050206.9722222136,1821,0,753.950495049505,74,128,44,38.19128634075035,0.6000844594594594,43.45833333333331,8209.333333333268,110.93693693693606,0
1823,32,0,2,199,0.0,0.009950248756218905,0.9900497512437811,201,5100,4000,1100,0.7843137254901961,62,40,22,205.3673862597066,0.4389842454394693,0.774139154842804,0.12145863727702652,1053588.1975308547,-2025.4691358029972,1051562.7283950518,1822,1,758.6616915422885,74,127,45,38.11893357148012,0.6007882882882882,43.38888888888886,8211.55555555548,110.96696696696594,0
1824,32,1,0,200,0.005,0.0,1.0,200,6850,5300,1550,0.7737226277372263,84,53,31,207.28251687327761,0.43869137353433835,0.7761044362292058,0.12323059519609116,1055171.046306679,-3106.2979579484836,1052064.7483487306,1823,0,763.34,78,122,45,37.87310878346,0.6009615384615384,43.19620253164556,8217.72151898732,105.35540408958103,0
1825,32,1,0,201,0.004975124378109453,0.0,1.0,201,5500,3800,1700,0.6909090909090909,72,38,34,205.59024215892862,0.4388266998341625,0.7764754715941848,0.12291671924821013,1056884.295062459,-2242.9803688282113,1054641.314693631,1824,0,760.5373134328358,81,120,41,37.703884934756815,0.6018518518518519,42.98780487804877,8224.39024390241,101.53568202348654,0
1826,32,4,0,205,0.01951219512195122,0.0,1.0,205,5950,4000,1950,0.6722689075630253,79,40,39,201.0431216188453,0.44097222222222227,0.77652488391643,0.12121470219780606,1059429.0816326542,-4351.814058956839,1055077.2675736973,1825,0,746.6780487804878,69,136,47,37.505301102629325,0.6105072463768115,42.67857142857143,8234.285714285723,119.33747412008294,0
1827,32,1,2,204,0.0048543689320388345,0.009708737864077669,0.9902912621359223,206,5450,3700,1750,0.6788990825688074,72,37,35,199.2924018754404,0.44131985555292447,0.7763022030800262,0.12077648828671954,1060971.5289834074,-4361.287133487798,1056610.2418499195,1826,0,744.0485436893204,71,135,42,37.35936709927524,0.6113556338028169,42.491319444444436,8240.277777777754,116.06025039123597,0
1828,32,0,1,203,0.0,0.004901960784313725,0.9950980392156863,204,7100,4900,2200,0.6901408450704225,93,49,44,201.88139829233336,0.4405989407257156,0.7772497809089767,0.12275193858957734,1061967.3854597823,-5021.707856505303,1056945.677603277,1827,1,751.5294117647059,73,131,45,37.16943503442244,0.6115867579908676,42.37049549549549,8244.144144144131,112.93348142663193,0
1829,32,2,2,203,0.00975609756097561,0.00975609756097561,0.9902439024390244,205,5900,4400,1500,0.7457627118644068,74,44,30,199.6042036333002,0.4415182129762474,0.7757546999804232,0.12211882546189518,1063815.8165252774,-4431.578225992578,1059384.2382992848,1828,0,748.790243902439,75,130,46,36.99951496305745,0.6129166666666667,42.14638157894737,8251.315789473689,110.01754385964918,0
1830,32,0,0,203,0.0,0.0,1.0,203,6200,4200,2000,0.6774193548387096,82,42,40,209.7809326972514,0.44049448048253104,0.7842414777068987,0.12888107953959124,1065060.2108341071,-2114.1351184978193,1062946.0757156094,1829,1,756.9852216748768,75,128,37,36.58317396231763,0.6144444444444445,41.99561403508773,8256.140350877227,110.0818713450297,0
1831,32,0,1,202,0.0,0.0049261083743842365,0.9950738916256158,203,6150,4600,1550,0.7479674796747967,77,46,31,250.89762490933043,0.44033190264839295,0.8127879958168103,0.15429165844997078,1065350.3839761855,6708.776207173644,1072059.1601833592,1830,2,757.9852216748768,77,126,29,35.48631956664251,0.6139069264069263,41.960470085470085,8257.264957264959,107.23720723720726,8
1832,32,0,2,200,0.0,0.009900990099009901,0.9900990099009901,202,5300,3900,1400,0.7358490566037735,67,39,28,249.16775950771762,0.4396622498070703,0.8113852896436631,0.15370255133789676,1066271.3650173594,7436.089409722149,1073707.4544270816,1831,3,762.7128712871287,79,123,32,35.416666666666664,0.6141877637130801,41.84895833333333,8260.83333333332,104.56751054852303,0
1833,32,3,2,201,0.014778325123152709,0.009852216748768473,0.9901477832512315,203,6400,4800,1600,0.75,80,48,32,201.01897697318532,0.4398858297159765,0.7725774697950127,0.12422175534541183,1066799.4666121379,-4110.612517217968,1062688.85409492,1832,0,759.1527093596059,87,116,40,36.5944271263103,0.6118295019157088,41.78503787878786,8262.878787878739,94.97561825147976,8
1834,32,0,0,201,0.0,0.0,1.0,201,5650,3600,2050,0.6371681415929203,77,36,41,198.6271130710631,0.43859556384742954,0.7657869494612675,0.12233160141028009,1065799.1294901625,-3510.6791591437113,1062288.4503310188,1833,1,767.6417910447761,86,115,35,36.77968624358258,0.6109496124031008,41.906130268199206,8259.00383141755,96.03492827229711,8
1835,32,1,3,199,0.0049504950495049506,0.01485148514851485,0.9851485148514851,202,6050,4700,1350,0.7768595041322314,74,47,27,197.0095990712484,0.4388443508529958,0.765305344093733,0.12190728584145064,1067197.3323373776,-4400.376285261875,1062796.9560521157,1834,0,764.8366336633663,88,114,37,36.648860237469385,0.6119791666666667,41.73689138576776,8264.419475655355,93.91385767790176,0
1836,32,0,0,199,0.0,0.0,1.0,199,5900,3900,2000,0.6610169491525424,79,39,40,200.50231349983088,0.437548643892865,0.7651535861410828,0.1244521834752446,1068113.3019667948,-2868.1623751426814,1065245.139591652,1835,1,776.929648241206,76,123,39,36.44562542541494,0.6177357456140351,41.62608225108226,8267.965367965387,108.78901799954457,0
1837,32,0,0,199,0.0,0.0,1.0,199,4850,3200,1650,0.6597938144329897,65,32,33,198.6614780649159,0.4377358171328021,0.7626286744190813,0.12393405497753804,1069608.4228515625,-2152.001953124995,1067456.4208984375,1836,2,777.929648241206,79,120,39,36.30882686206375,0.6182753164556962,41.4453125,8273.75,104.73101265822785,0
1838,32,1,0,200,0.005,0.0,1.0,200,5850,4400,1450,0.7521367521367521,73,44,29,195.76563399438143,0.4383291457286432,0.7617052874466097,0.12280721277584106,1071246.036688645,-3907.3680927357186,1067338.6685959091,1837,0,775.035,81,119,39,36.18197383278513,0.6194701646090535,41.2474593495935,8280.081300813014,102.22322593596313,0
1839,32,0,1,199,0.0,0.005,0.995,200,6450,4700,1750,0.7286821705426356,82,47,35,194.8369858162058,0.43839091289782245,0.7617699243746336,0.12268306909086435,1072347.5831035047,-4663.405832163668,1067684.177271341,1838,1,776.035,82,118,44,36.07040996057139,0.6204268292682926,41.11445783132532,8284.33734939764,101.02850426094682,0
1840,32,0,0,199,0.0,0.0,1.0,199,6300,5200,1100,0.8253968253968254,74,52,22,192.49299048317914,0.43788280628732895,0.7583474800113528,0.12163918760320136,1073392.3742563636,-4775.89838351022,1068616.4758728533,1839,2,780.8693467336683,85,114,36,36.00257981045017,0.6205882352941177,40.98837209302328,8288.372093023325,97.51025991792147,0
1841,32,2,3,198,0.009950248756218905,0.014925373134328358,0.9850746268656716,201,5850,4300,1550,0.7350427350427351,74,43,31,190.62434826877157,0.43871268656716417,0.7595269712916923,0.12138261532618938,1075629.236716051,-5041.775554432907,1070587.461161618,1840,0,774.0895522388059,88,113,40,35.77609879775501,0.6222774621212122,40.71863295880152,8297.003745318414,94.28413346952743,0
1842,32,2,0,200,0.01,0.0,1.0,200,6850,5600,1250,0.8175182481751825,81,56,25,187.89611219763728,0.4384348827470687,0.7533406754772389,0.12048705499679085,1077671.8657049453,-6351.929241852919,1071319.9364630925,1841,0,775.04,81,119,42,35.59614129548054,0.6273148148148149,40.47256097560978,8304.878048780549,102.52935862692036,0
1843,32,0,0,200,0.0,0.0,1.0,200,4100,2600,1500,0.6341463414634146,56,26,30,188.12184648456167,0.4383448492462312,0.7530882774433936,0.1208760814704675,1078259.725765311,-3531.157879818304,1074728.5678854927,1842,1,776.04,83,117,43,35.51817617273338,0.6272590361445782,40.40178571428573,8307.142857142895,100.08605851979392,0
1844,32,0,2,198,0.0,0.01,0.99,200,5800,4200,1600,0.7241379310344828,74,42,32,215.6398509362412,0.43827627721943047,0.7831813812659227,0.13255002595067467,1065216.4848867704,140.62480316162782,1065357.109689932,1843,2,777.04,83,117,34,36.4126756219862,0.611320281124498,41.976686507936485,8256.746031745966,99.47886785236103,8
1845,32,0,1,197,0.0,0.005050505050505051,0.9949494949494949,198,5400,3700,1700,0.6851851851851852,71,37,34,214.0210313775804,0.4375122844348733,0.7800507927739231,0.13197128234594066,1066157.4778931122,636.0246059205415,1066793.5024990328,1844,3,785.7070707070707,84,114,35,36.33806494492972,0.6121031746031746,41.8627450980392,8260.392156862701,98.33800186741311,0
1846,32,0,1,196,0.0,0.005076142131979695,0.9949238578680203,197,5500,4000,1500,0.7272727272727273,70,40,30,218.2576874502492,0.437429857729894,0.7827183867030629,0.1351844126145335,1067480.8635552858,1697.180935394119,1069178.0444906799,1845,4,790.4720812182741,86,111,37,36.06504658601026,0.6130087209302326,41.702586206896534,8265.517241379266,96.11066559743333,0
1847,32,0,0,196,0.0,0.0,1.0,196,5900,3900,2000,0.6610169491525424,79,39,40,220.2392494006261,0.4373817155067155,0.7834414618419712,0.13650478278560588,1067683.1522796454,1929.147211152514,1069612.299490798,1846,5,794.1071428571429,90,106,38,35.988851715631945,0.6119212962962963,41.67811355311354,8266.300366300333,91.84778184778148,0
1848,32,1,0,197,0.005076142131979695,0.0,1.0,197,6050,4200,1850,0.6942148760330579,79,42,37,214.9541438887428,0.4378064677647709,0.7774737917452268,0.13398760945239518,1069364.6242112992,522.8714604495217,1069887.4956717486,1847,0,791.0710659898477,75,122,38,35.917673982964,0.6197222222222223,41.4747807017544,8272.807017543888,110.30409356725184,0
1849,32,1,0,198,0.005050505050505051,0.0,1.0,198,5050,3300,1750,0.6534653465346535,68,33,35,209.1928553541746,0.4383283981951495,0.773346563639177,0.13130968442493898,1071424.047707108,176.85116699582795,1071600.898874104,1848,0,788.070707070707,77,121,39,35.8125935387315,0.6213474025974026,41.22596153846156,8280.769230769289,107.5424575424583,0
1850,32,0,3,195,0.0,0.015151515151515152,0.9848484848484849,198,5850,4600,1250,0.7863247863247863,71,46,25,196.3875535647889,0.43812543796680853,0.7576710695653868,0.12238952241548873,1069304.3426979368,-3450.387224269174,1065853.9554736677,1849,1,789.070707070707,78,120,43,36.40509707912547,0.6183226495726496,41.482067510548546,8272.573839662504,106.0586389700321,8
1851,32,1,0,196,0.00510204081632653,0.0,1.0,196,4800,3000,1800,0.625,66,30,36,196.04624153273392,0.43698652537938254,0.7554785872119527,0.12280780402381261,1070825.3421615835,-2013.743266243353,1068811.5988953402,1850,0,797.6377551020408,81,115,44,36.22652221949422,0.6189557613168724,41.2982723577236,8278.455284552896,102.20315166114686,0
1852,32,0,1,195,0.0,0.00510204081632653,0.9948979591836735,196,5600,4300,1300,0.7678571428571429,69,43,26,197.97862471301042,0.43675431711146,0.7600773757355692,0.12446203266052493,1071877.23339696,-2358.2438941764035,1069518.9895027836,1851,1,798.6377551020408,81,115,46,36.0469836400818,0.6202417695473251,41.171239837398396,8282.520325203308,102.25333734818899,0
1853,32,0,1,194,0.0,0.005128205128205128,0.9948717948717949,195,4950,3400,1550,0.6868686868686869,65,34,31,197.227804131782,0.43560555996123007,0.7586236536957263,0.12438277795456852,1072806.8335262404,-1632.5327932096807,1071174.3007330308,1852,2,803.6,83,112,50,35.951991842663936,0.6206074297188755,41.05902777777779,8286.111111111157,99.83266398929105,0
1854,32,1,1,194,0.005128205128205128,0.005128205128205128,0.9948717948717949,195,5650,4100,1550,0.7256637168141593,72,41,31,196.29994324697518,0.43467706405850737,0.7588624494443781,0.12445035236919991,1074348.7024439499,-2471.0821365578668,1071877.620307392,1853,0,804.5692307692308,83,112,42,35.78635464522719,0.6224899598393574,40.8730158730159,8292.063492063566,99.90437942245259,0
1855,32,0,1,193,0.0,0.005154639175257732,0.9948453608247423,194,5800,4400,1400,0.7586206896551724,72,44,28,197.95947244300697,0.4344274700425547,0.7601801715001437,0.12578185006770734,1074999.2488432266,-2038.743164472873,1072960.5056787536,1854,4,809.7164948453608,85,109,42,35.66335669781936,0.6225490196078431,40.79457364341088,8294.573643410917,97.58321933424608,0
1856,32,1,1,193,0.005154639175257732,0.005154639175257732,0.9948453608247423,194,4900,3000,1900,0.6122448979591837,68,30,38,195.09847435459784,0.43424774762744156,0.7572033603950514,0.12452183741988665,1076310.1873285414,-1702.7049039777212,1074607.4824245637,1855,0,810.6082474226804,89,105,44,35.576433203921034,0.6227762172284644,40.6365740740741,8299.6296296297,93.25426550145731,0
1857,32,0,1,192,0.0,0.0051813471502590676,0.9948186528497409,193,6100,4700,1400,0.7704918032786885,75,47,28,192.89385927092846,0.43317546416234887,0.7529089262169728,0.12349702120971442,1077213.3456790063,-3142.4320987657698,1074070.9135802404,1856,1,815.7823834196892,74,119,42,35.52271794597293,0.6297860360360361,40.52777777777776,8303.111111111064,112.20420420420356,0
1858,32,0,0,192,0.0,0.0,1.0,192,5400,3900,1500,0.7222222222222222,69,39,30,231.58709227834944,0.43294441263089006,0.7902043081956998,0.1389089680600413,1057864.994247202,5197.575608152314,1063062.5698553543,1857,2,818.5260416666666,77,115,42,36.91375818011841,0.6047077922077921,42.86858974358973,8228.205128205098,106.85980685980647,8
1859,32,2,2,192,0.010309278350515464,0.010309278350515464,0.9896907216494846,194,5750,4200,1550,0.7304347826086957,73,42,31,222.73874822375987,0.43392836475971724,0.7837545879608119,0.13436016610389986,1059573.8995064304,2651.6328053261554,1062225.5323117566,1858,0,811.0773195876288,65,129,44,36.9290478380865,0.6129807692307692,42.66098484848486,8234.848484848504,126.68997668997699,0
1860,32,0,1,191,0.0,0.005208333333333333,0.9947916666666666,192,5600,3800,1800,0.6785714285714286,74,38,36,220.1165215952293,0.43371532322571266,0.7782314485675197,0.1332016768142382,1060532.1747448994,2688.130668934344,1063220.3054138338,1859,1,814.2916666666666,69,123,44,36.8776250891085,0.6118659420289856,42.54464285714286,8238.57142857144,119.39958592132523,0
1861,32,0,0,191,0.0,0.0,1.0,191,5850,4300,1550,0.7350427350427351,74,43,31,216.5533788306433,0.4328534031413613,0.7730070211190454,0.1314835197198773,1061535.0265059136,1925.799347386528,1063460.8258533,1860,2,819.2722513089005,72,119,43,36.84502705297953,0.6115451388888888,42.42294520547946,8242.465753424676,114.47869101978716,0
1862,32,2,1,192,0.010362694300518135,0.0051813471502590676,0.9948186528497409,193,4950,2900,2050,0.5858585858585859,70,29,41,218.61485489049096,0.43321144573978126,0.7767499207619337,0.1348620746050308,1066285.7067901294,3071.1790123460214,1069356.8858024755,1861,0,811.7720207253886,74,119,41,36.203619016875614,0.6164132882882882,41.84722222222224,8260.888888888936,111.63363363363428,7
1863,32,0,0,192,0.0,0.0,1.0,192,5300,3800,1500,0.7169811320754716,68,38,30,220.01554929731404,0.43280068353694007,0.7772783286180827,0.13594809936671548,1066771.5214529359,3241.2644534399005,1070012.7859063759,1862,1,817.0,76,116,41,36.10736365065231,0.6160910087719298,41.78841991341992,8262.77056277058,108.72066529961289,0
1864,32,0,1,191,0.0,0.005208333333333333,0.9947916666666666,192,5450,4000,1450,0.7339449541284404,69,40,29,220.3789535096582,0.43268024650959863,0.777021461455135,0.1366941795621502,1067906.3056916948,3218.8148189403546,1071125.1205106352,1863,2,818.0,66,126,43,35.95765380834889,0.6226325757575757,41.65111940298509,8267.16417910451,125.2600633197653,0
1865,32,0,0,191,0.0,0.0,1.0,191,5400,3900,1500,0.7222222222222222,69,39,30,216.38782215778465,0.4323137687149812,0.770869390093184,0.13455659743985235,1068651.5474398534,2648.636199211546,1071300.183639065,1864,3,823.0471204188482,68,123,41,35.968684892030296,0.6223958333333333,41.560990338164274,8270.048309178796,121.61835748792346,0
1866,32,0,1,190,0.0,0.005235602094240838,0.9947643979057592,191,5550,3800,1750,0.6846846846846847,73,38,35,211.92570744947702,0.4324733627261872,0.7651589750702115,0.13223463563996402,1069665.9786076278,1587.943850212147,1071253.9224578398,1865,4,824.0471204188482,72,119,42,35.95877023546726,0.6215277777777778,41.43835616438359,8273.972602739797,114.91628614916385,0
1867,32,0,1,189,0.0,0.005263157894736842,0.9947368421052631,190,5650,4200,1450,0.7433628318584071,71,42,29,214.25244040060372,0.4319670704539125,0.7679421727866276,0.13434226564196855,1071110.0030864317,2247.5864197537335,1073357.5895061854,1866,5,829.3473684210526,74,116,42,35.72040456635714,0.6223254504504505,41.26388888888893,8279.555555555648,111.88588588588713,0
1868,32,2,1,190,0.010471204188481676,0.005235602094240838,0.9947643979057592,191,5400,3800,1600,0.7037037037037037,70,38,32,224.0194218292664,0.4327167722972352,0.7812139420027688,0.13989167613975637,1069900.409723685,4335.6942402392315,1074236.103963924,1867,0,825.8429319371728,68,123,43,35.61710646661607,0.6239276960784313,41.41002415458939,8274.879227053172,121.68940039784077,8
1869,32,1,0,191,0.005235602094240838,0.0,1.0,191,5100,3300,1800,0.6470588235294118,69,33,36,205.9294274095255,0.4330417011114173,0.7655288044484527,0.11910015005635041,1046736.2001281898,-189.2427317557267,1046546.957396434,1868,0,822.7015706806283,78,113,42,38.95751709798262,0.5905448717948718,44.224683544303815,8184.81012658232,104.93346316131179,8
1870,32,3,2,192,0.015463917525773196,0.010309278350515464,0.9896907216494846,194,5000,3900,1100,0.78,61,39,22,222.60257209283014,0.4353494515962466,0.7893193878626175,0.12794545799033352,1044814.818461337,2715.6931900391724,1047530.5116513761,1869,0,810.9639175257732,68,126,39,38.77114471948167,0.592984068627451,44.45954106280192,8177.294685990307,120.25433361750451,8
1871,32,1,1,192,0.0051813471502590676,0.0051813471502590676,0.9948186528497409,193,5400,3400,2000,0.6296296296296297,74,34,40,221.51599006060556,0.4351555753454231,0.7871747090323356,0.12783379717802043,1046058.376865256,2343.7314024992493,1048402.1082677552,1870,0,816.0932642487047,70,123,39,38.64351426822736,0.593452380952381,44.307511737089186,8182.159624413111,116.887994634473,0
1872,32,1,1,192,0.0051813471502590676,0.0051813471502590676,0.9948186528497409,193,6700,4700,2000,0.7014925373134329,87,47,40,221.5120840988868,0.4358133635578583,0.7859126191756876,0.12843461412011023,1047510.7571676378,1107.2581872412215,1048618.015354879,1871,0,810.2227979274611,73,120,37,38.46223936843261,0.59375,44.13006756756756,8187.837837837816,112.16216216216186,0
1873,32,0,1,191,0.0,0.005208333333333333,0.9947916666666666,192,5750,4000,1750,0.6956521739130435,75,40,35,198.36166374862367,0.4356002763234439,0.7550999876176325,0.11218268882590171,1039781.9100091766,-2899.4260789717964,1036882.4839302048,1872,2,815.4427083333334,87,105,37,40.01903789004456,0.578544061302682,45.07575757575756,8157.575757575709,93.76523859282425,7
1874,32,2,0,193,0.010362694300518135,0.0,1.0,193,4850,3600,1250,0.7422680412371134,61,36,25,198.84216031681729,0.43667242371905585,0.7587789883111096,0.1130898931181816,1041539.8724825237,-2029.592339894588,1039510.280142629,1873,0,811.8704663212435,90,103,40,39.78709602644057,0.5797453703703703,44.860347985347985,8164.468864468865,90.71632071632072,0
1875,32,6,0,199,0.03015075376884422,0.0,1.0,199,6050,4000,2050,0.6611570247933884,81,40,41,199.67875468653887,0.4395684229226943,0.7637776572451409,0.11520972158677102,1045999.0791479246,-4077.2412944948464,1041921.8378534297,1874,0,788.3618090452261,82,117,45,39.20926798540551,0.5880335365853658,44.3147590361446,8181.9277108434335,99.77960622979796,0
1876,32,5,5,199,0.024509803921568627,0.024509803921568627,0.9754901960784313,204,5450,3800,1650,0.6972477064220184,71,38,33,195.51099408834813,0.4420402500080492,0.765990695136068,0.11382792169951284,1048781.5858334824,-5240.333914428087,1043541.2519190543,1875,0,770.0147058823529,87,117,40,38.96933322545349,0.5896791187739463,43.97490530303032,8192.803030303074,94.17014977359855,0
1877,32,0,0,199,0.0,0.0,1.0,199,5400,3900,1500,0.7222222222222222,69,39,30,201.55866918681508,0.43981058491108743,0.7689339511959703,0.11724753663724315,1048515.7655709395,-2932.5115340251064,1045583.2540369144,1876,1,790.3517587939698,84,115,41,38.84759921489781,0.5904017857142857,44.007352941176485,8191.764705882395,97.52100840336185,0
1878,32,0,1,198,0.0,0.005025125628140704,0.9949748743718593,199,6300,4300,2000,0.6825396825396826,83,43,40,203.59056643422616,0.43995122921002316,0.770744648484367,0.11875098515030509,1049349.046641277,-3372.4866414172648,1045976.5599998597,1877,2,791.3517587939698,86,113,42,38.691811990587034,0.5907218992248062,43.90565134099619,8195.019157088173,95.29092043125782,0
1879,32,0,1,197,0.0,0.005050505050505051,0.9949494949494949,198,4800,3400,1400,0.7083333333333334,62,34,28,204.1829807472914,0.43996596677434235,0.7711557915515077,0.11948185685442288,1050340.2970679088,-1507.6774691354558,1048832.6195987733,1878,3,793.570707070707,89,109,42,38.553242309256035,0.590941011235955,43.78472222222224,8198.888888888949,92.12234706616796,0
1880,32,2,0,199,0.010050251256281407,0.0,1.0,199,5150,3600,1550,0.6990291262135923,67,36,31,203.64810109280685,0.44067348527147526,0.7724379696440355,0.12006907829312738,1052642.7502625498,-2076.2605559848575,1050566.489706565,1879,0,790.5477386934673,71,128,45,38.280559629232656,0.6010856807511737,43.50405092592589,8207.870370370289,115.60380803338434,0
1881,32,2,0,201,0.009950248756218905,0.0,1.0,201,6700,4200,2500,0.6268656716417911,92,42,50,199.4157170242804,0.44132980928689886,0.7697587312423506,0.11829671966144882,1054511.1627639984,-4842.7800734622015,1049668.382690536,1880,0,783.6716417910447,76,125,44,38.157045370711884,0.6010142543859649,43.276515151515135,8215.151515151472,108.094098883572,0
1882,32,2,0,203,0.009852216748768473,0.0,1.0,203,5200,3400,1800,0.6538461538461539,70,34,36,198.74745968702214,0.44195158432099363,0.7707499519373617,0.11846789666540582,1055970.3233506905,-3825.7161458335513,1052144.607204857,1881,0,776.9408866995074,79,124,41,37.993115391113335,0.6015295358649789,43.09895833333332,8220.833333333303,104.06118143459877,0
1883,32,1,2,202,0.004901960784313725,0.00980392156862745,0.9901960784313726,204,6150,4200,1950,0.6829268292682927,81,42,39,194.4693718013583,0.4419723349109759,0.7670910098639818,0.1164849623465457,1057449.0411037067,-5821.709852922785,1051627.331250784,1882,0,774.1274509803922,83,121,42,37.919711623494585,0.6017821285140562,42.919146825396815,8226.587301587275,99.115509657678,0
1884,32,1,0,203,0.0049261083743842365,0.0,1.0,203,5900,4100,1800,0.6949152542372882,77,41,36,191.33278305947553,0.4421852899575672,0.7627013592371932,0.11504064311409717,1058592.635255643,-5991.304994054917,1052601.330261588,1883,0,778.5862068965517,86,117,44,37.85871386677839,0.6021075581395349,42.78017241379309,8231.03448275858,95.70970328789046,0
1885,32,0,1,202,0.0,0.0049261083743842365,0.9950738916256158,203,6450,4300,2150,0.6666666666666666,86,43,43,189.4161195729806,0.44221475719000475,0.759791879463344,0.11455165326556375,1060343.3162892552,-6880.776722669009,1053462.5395665863,1884,1,779.5862068965517,73,130,42,37.6913823272091,0.6095890410958904,42.567567567567544,8237.837837837782,112.84709366901072,0
1886,32,2,0,204,0.00980392156862745,0.0,1.0,204,6250,4400,1850,0.704,81,44,37,199.69341271943222,0.4426052030007405,0.7769405800169833,0.11724331041257431,1051357.2704081608,-5060.175736961655,1046297.0946711991,1885,0,776.3578431372549,69,135,39,38.541787607879584,0.6005434782608696,43.66071428571428,8202.857142857123,118.88198757763946,8
1887,32,3,2,205,0.014492753623188406,0.00966183574879227,0.9903381642512077,207,6900,5400,1500,0.782608695652174,84,54,30,196.46966366395787,0.4441561918609196,0.7768144563408699,0.11616754780831245,1053512.679698274,-6903.343630793217,1046609.3360674807,1886,0,766.0917874396135,73,134,42,38.356636403532846,0.6011700913242009,43.39808558558557,8211.26126126122,112.48303097618108,0
1888,32,2,1,206,0.00966183574879227,0.004830917874396135,0.9951690821256038,207,5450,3800,1650,0.6972477064220184,71,38,33,197.30570289935383,0.44398324031080466,0.7784771648931184,0.1173489788456715,1055299.6327160415,-5206.672839506591,1050092.959876535,1887,0,767.0434782608696,74,133,47,38.11336145512227,0.6028997747747749,43.18055555555553,8218.22222222216,111.05705705705623,0
1889,32,1,3,204,0.004830917874396135,0.014492753623188406,0.9855072463768116,207,5750,4000,1750,0.6956521739130435,75,40,35,211.28362730444834,0.44386696214999294,0.7929142171756507,0.12334234138909222,1049608.3809681302,-2796.9868039807375,1046811.3941641494,1888,0,767.4444444444445,83,124,42,38.462485071495415,0.5921184738955823,43.874007936507944,8196.031746031764,98.74737043411764,8
1890,32,1,2,203,0.004878048780487805,0.00975609756097561,0.9902439024390244,205,5150,3400,1750,0.6601941747572816,69,34,35,212.5445692719183,0.44344113661724854,0.7930072833054003,0.12459891242574885,1050891.9440375394,-1477.7248806426405,1049414.2191568967,1889,0,775.8780487804878,63,142,44,38.27030145222067,0.6035052910052909,43.71744791666665,8201.041666666635,130.17526455026405,0
1891,32,3,0,206,0.014563106796116505,0.0,1.0,206,5300,3800,1500,0.7169811320754716,68,38,30,201.14450917465675,0.44467302075933385,0.7817989037831528,0.11885310579812924,1053311.238662125,-4126.445578231707,1049184.7930838934,1890,0,773.0485436893204,69,137,45,38.26170591192045,0.6029589371980677,43.42261904761902,8210.47619047614,118.99240855762521,0
1892,32,1,2,205,0.004830917874396135,0.00966183574879227,0.9903381642512077,207,6200,4600,1600,0.7419354838709677,78,46,32,197.88840507339123,0.44533851601707236,0.7786486441997247,0.11760715915788836,1055071.3611111033,-5842.7222222225955,1049228.6388888808,1891,0,770.3091787439613,74,133,46,38.126723998052896,0.6026182432432432,43.20833333333331,8217.333333333272,111.04504504504422,0
1893,32,1,2,204,0.0048543689320388345,0.009708737864077669,0.9902912621359223,206,5550,3500,2050,0.6306306306306306,76,35,41,193.6070157519033,0.44502476517483625,0.7726308892727389,0.11546813586603212,1056139.343956783,-5854.802679671393,1050284.5412771115,1892,0,774.6359223300971,75,131,44,38.10421668000353,0.6034722222222222,43.07839912280698,8221.491228070085,109.61988304093447,0
1894,32,3,2,205,0.014492753623188406,0.00966183574879227,0.9903381642512077,207,6550,4700,1850,0.7175572519083969,84,47,37,192.4516028609989,0.4457313212325876,0.7733852753012567,0.11590015797632429,1059079.4402513308,-7185.692833300613,1051893.7474180302,1893,0,771.304347826087,81,126,48,37.769661696209596,0.6045524691358024,42.72103658536583,8232.926829268232,101.64107196627447,0
1895,32,0,0,205,0.0,0.0,1.0,205,6000,4600,1400,0.7666666666666667,74,46,28,194.5027327431431,0.4449465965247888,0.7739102764306218,0.11752508187209831,1060080.2579144135,-5762.2985817178505,1054317.9593326957,1894,1,779.6585365853658,66,139,48,37.59299247000081,0.6130050505050505,42.59950248756221,8236.815920398054,124.80024121815234,0
1896,32,1,0,206,0.0048543689320388345,0.0,1.0,206,7100,6000,1100,0.8450704225352113,82,60,22,189.58173895082172,0.44511356460651985,0.768865861742398,0.11531849385921046,1062085.0725440364,-8029.613006677999,1054055.4595373585,1895,0,776.8689320388349,70,136,45,37.47176508551151,0.6132440476190476,42.35622065727703,8244.600938967204,117.78001341381719,0
1897,32,0,1,205,0.0,0.0048543689320388345,0.9951456310679612,206,5800,4000,1800,0.6896551724137931,76,40,36,190.45212172180373,0.44502476517483625,0.7699158074585883,0.11650202571134102,1063770.8893684514,-6480.5154187774115,1057290.373949674,1896,1,777.8689320388349,72,134,52,37.24105331119719,0.6142939814814814,42.15182648401829,8251.141552511464,114.59918822932589,0
1898,32,0,0,205,0.0,0.0,1.0,205,5150,3600,1550,0.6990291262135923,67,36,31,192.00813124671353,0.4447861868324566,0.7713004218145698,0.117964628646682,1065066.4113811296,-5249.717739412869,1059816.6936417168,1897,2,782.5560975609756,72,133,42,37.04095459321943,0.6158854166666667,41.994863013698655,8256.164383561703,114.66894977169032,0
1899,32,0,1,204,0.0,0.004878048780487805,0.9951219512195122,205,6250,4500,1750,0.72,80,45,35,190.07664077751792,0.44442551410808223,0.7693322068762836,0.11748354073589191,1066859.4567901292,-6692.987654320768,1060166.4691358085,1898,3,783.5560975609756,74,131,45,36.86957652036714,0.6171171171171171,41.77777777777779,8263.111111111155,111.66366366366425,0
1900,32,0,0,204,0.0,0.0,1.0,204,6000,4500,1500,0.75,75,45,30,192.12382406232933,0.44430660195112526,0.7708802149819445,0.11907128287085578,1067664.4766899443,-5775.243584564381,1061889.2331053799,1899,6,788.3823529411765,75,129,45,36.717437346350444,0.6176388888888888,41.68037280701755,8266.228070175448,110.21637426900597,0
1901,32,1,1,204,0.004878048780487805,0.004878048780487805,0.9951219512195122,205,6200,4200,2000,0.6774193548387096,82,42,40,192.2739473939133,0.444579945799458,0.7645724382252919,0.1155747338054883,1058509.5877344368,-6495.236642399137,1052014.3510920377,1900,0,785.5317073170731,88,117,44,37.8447890122558,0.6013257575757576,42.790262172284656,8230.711610486922,93.5308137555332,8
1902,32,1,1,204,0.004878048780487805,0.004878048780487805,0.9951219512195122,205,6800,5100,1700,0.75,85,51,34,190.83074870092278,0.44484895584249956,0.764134456303283,0.115225956473665,1059870.249999993,-7348.833333333716,1052521.4166666593,1901,0,785.409756097561,74,131,44,37.713493605310035,0.6085304054054055,42.62499999999998,8235.999999999945,111.29729729729657,0
1903,32,1,1,204,0.004878048780487805,0.004878048780487805,0.9951219512195122,205,6650,4700,1950,0.706766917293233,86,47,39,208.8294232588915,0.44459489080184916,0.7752687833816694,0.1202304238156702,1045333.683281705,-3990.713961437704,1041342.9693202673,1902,0,785.9853658536585,78,127,36,39.058335482761635,0.5888087606837606,44.39609704641351,8179.324894514781,104.86313967326642,7
1904,32,1,0,205,0.004878048780487805,0.0,1.0,205,6150,4000,2150,0.6504065040650406,83,40,43,205.41808708556846,0.44544476327116217,0.7836363789157592,0.11790212816440687,1044378.4439815785,-4243.155568780178,1040135.2884127983,1903,0,786.3560975609756,70,135,44,39.26474388423112,0.5913690476190476,44.512910798122086,8175.586854460134,116.79409792085906,8
1905,32,9,4,210,0.04205607476635514,0.018691588785046728,0.9813084112149533,214,6200,4500,1700,0.7258064516129032,79,45,34,195.85319630047078,0.44961598511108186,0.7820428892126039,0.11417029297353701,1049167.1727311835,-7903.45115341366,1041263.7215777698,1904,0,754.2429906542056,81,133,40,38.912590534775305,0.5923353909465021,43.9278455284553,8194.30894308947,101.16430793937619,0
1906,32,0,0,210,0.0,0.0,1.0,210,7300,5800,1500,0.7945205479452054,88,58,30,199.31365422067063,0.44796081111870584,0.7832648472997608,0.11642411714095068,1049791.831912226,-7452.430762112285,1042339.4011501138,1905,1,769.4619047619047,81,129,43,38.74623917212196,0.5931069958847737,43.85162601626018,8196.74796747971,101.19441935160137,0
1907,32,3,0,213,0.014084507042253521,0.0,1.0,213,5650,4600,1050,0.8141592920353983,67,46,21,195.42679879783836,0.4495434346118641,0.7826677479216524,0.11502146931323882,1052111.0323461427,-7127.861793741027,1044983.1705524017,1906,0,759.6103286384977,68,145,44,38.55748851995761,0.6020220588235294,43.568840579710134,8205.79710144925,120.67348678601839,0
1908,32,0,1,212,0.0,0.004694835680751174,0.9953051643192489,213,6100,4200,1900,0.6885245901639344,80,42,38,197.6487088075264,0.44972798003956654,0.7840204033784528,0.11674071218055988,1053189.0624999935,-7067.708333333661,1046121.3541666599,1907,1,760.6103286384977,69,144,45,38.36657531465692,0.6028079710144927,43.43749999999998,8209.999999999949,118.98550724637607,0
1909,32,2,1,213,0.009345794392523364,0.004672897196261682,0.9953271028037384,214,6850,4700,2150,0.6861313868613139,90,47,43,189.33184851188003,0.4500076784695713,0.7750845033899938,0.11252190765464888,1055071.361111103,-9698.277777778128,1045373.083333325,1908,0,757.7336448598131,74,140,46,38.34644924008871,0.6026182432432432,43.20833333333331,8217.33333333327,111.04504504504419,0
1910,32,1,4,210,0.004672897196261682,0.018691588785046728,0.9813084112149533,214,6150,3900,2250,0.6341463414634146,84,39,45,186.75047623987297,0.44998482588156147,0.7720390974808753,0.11151348407243145,1056505.601670997,-9489.415147569953,1047016.186523427,1909,0,758.7009345794393,79,135,42,38.23499915547673,0.6021888185654009,43.033854166666636,8222.916666666588,104.08755274261503,0
1911,32,0,1,209,0.0,0.004761904761904762,0.9952380952380953,210,5400,3600,1800,0.6666666666666666,72,36,36,190.57885472654044,0.4488531935900357,0.7727638051687122,0.11389749938998445,1056766.4274234646,-7120.532909636284,1049645.8945138282,1910,2,772.5285714285715,77,133,44,38.10430090764217,0.6033549783549783,43.00213675213671,8223.931623931514,106.80430680430537,0
1912,32,1,1,209,0.004761904761904762,0.004761904761904762,0.9952380952380953,210,5900,4000,1900,0.6779661016949152,78,40,38,191.49767206897496,0.4493340358471937,0.7739777694693506,0.11524574612388644,1058870.2806902207,-7345.761244960575,1051524.51944526,1911,0,770.5904761904762,81,129,47,37.82009736144711,0.604295267489712,42.74644308943086,8232.113821138131,101.63103482886582,0
1913,32,0,1,208,0.0,0.004784688995215311,0.9952153110047847,209,5850,4000,1850,0.6837606837606838,77,40,37,188.66751373852006,0.4491022957305852,0.7695452063939106,0.11407168146299401,1060271.454627614,-7642.244153496652,1052629.2104741174,1912,1,774.3205741626795,70,139,46,37.71954196588017,0.6110119047619047,42.57629107981222,8237.558685446047,117.67940979208639,0
1914,32,1,0,209,0.004784688995215311,0.0,1.0,209,6500,4900,1600,0.7538461538461538,81,49,32,190.1776602750358,0.4490380781499203,0.7689862627360116,0.11181071350062827,1051779.5963192803,-8295.003449395961,1043484.5928698843,1913,0,775.2153110047847,73,136,42,38.733254639288454,0.5990296803652968,43.609234234234194,8204.50450450441,112.39047266444398,7
1915,32,0,0,209,0.0,0.0,1.0,209,5800,4300,1500,0.7413793103448276,73,43,30,215.03683024129137,0.44880708655379703,0.7923649098434196,0.12169922230412514,1040002.6353516583,-2872.2259702780766,1037130.4093813803,1914,1,776.2153110047847,76,133,33,39.566309384838505,0.5830592105263157,45.04870129870129,8158.441558441536,107.34791524265178,8
1916,32,1,1,209,0.004761904761904762,0.004761904761904762,0.9952380952380953,210,5450,3900,1550,0.7155963302752294,70,39,31,216.29138746299267,0.44970475431001744,0.7951029880622089,0.12293407839052488,1041337.3905371084,-2403.5381967273806,1038933.852340381,1915,0,773.5142857142857,77,133,37,39.36723507651502,0.584280303030303,44.88514957264957,8163.6752136752,106.02175602175585,0
1917,32,1,0,210,0.004761904761904762,0.0,1.0,210,5450,4100,1350,0.7522935779816514,68,41,27,218.51146245206775,0.45009730766309713,0.797490727610696,0.124806146953927,1042862.6495940678,-1874.511460112426,1040988.1381339554,1916,0,774.4380952380952,66,144,37,39.119750116720475,0.5916982323232323,44.69838308457711,8169.651741293519,123.7826021408109,0
1918,32,2,1,211,0.009433962264150943,0.0047169811320754715,0.9952830188679245,212,5650,3900,1750,0.6902654867256637,74,39,35,210.08332664372597,0.4509066961757429,0.7903603744084013,0.12073723406726092,1044782.6880173491,-4151.715456308126,1040630.972561041,1917,0,768.122641509434,72,140,39,39.09507389621026,0.5908564814814814,44.46347031963471,8177.168949771703,113.57179096905143,0
1919,32,2,1,212,0.009389671361502348,0.004694835680751174,0.9953051643192489,213,5900,4400,1500,0.7457627118644068,74,44,30,201.92087845803457,0.4519822024389524,0.781620298113471,0.11657789806301526,1046196.6593005087,-6250.210302835874,1039946.4489976728,1918,0,765.3802816901408,78,135,42,39.12730538510463,0.5898771367521367,44.29061181434601,8182.700421940966,104.90641566590982,0
1920,32,3,1,214,0.013953488372093023,0.004651162790697674,0.9953488372093023,215,6600,4800,1800,0.7272727272727273,84,48,36,198.21096675338734,0.4526072230674491,0.77968336392864,0.11506272070013128,1047881.2579719417,-8059.68856292501,1039821.5694090168,1919,0,759.0418604651163,83,132,33,39.01230193342056,0.5899849397590362,44.08482142857144,8189.285714285737,98.66609294320166,0
1921,32,1,1,214,0.004651162790697674,0.004651162790697674,0.9953488372093023,215,6500,4400,2100,0.676923076923077,86,44,42,194.82116843809348,0.452743968702456,0.7765879355482641,0.11357560203189587,1049185.8864095453,-8619.275940187064,1040566.6104693583,1920,0,760.0372093023256,88,127,36,38.93668967198381,0.58984375,43.92556179775281,8194.382022471918,93.11797752808998,0
1922,32,3,2,215,0.013824884792626729,0.009216589861751152,0.9907834101382489,217,6650,4400,2250,0.6616541353383458,89,44,45,195.25258647576587,0.4527889784946237,0.7784438125878415,0.11448494919206956,1050953.551323147,-9009.720167652562,1041943.8311554944,1921,0,754.0092165898618,77,140,39,38.70580610702933,0.596185064935065,43.70993589743591,8201.282051282085,106.51015651015695,0
1923,32,2,2,215,0.009216589861751152,0.009216589861751152,0.9907834101382489,217,5750,4200,1550,0.7304347826086957,73,42,31,200.96216047760976,0.452779200091028,0.785217173418062,0.1187104346865009,1053221.5390161856,-6818.464811550699,1046403.0742046349,1922,0,754.963133640553,78,139,40,38.27752937951826,0.5985576923076923,43.433544303797476,8210.126582278499,105.2580331061346,0
1924,32,2,0,217,0.009216589861751152,0.0,1.0,217,5450,3600,1850,0.6605504587155964,73,36,37,199.2450119681196,0.45259074358536727,0.7844342037890419,0.11868072452014036,1055756.249999996,-6779.166666666881,1048977.083333329,1923,0,755.7880184331797,79,138,38,38.006893755068894,0.6012658227848101,43.124999999999986,8219.999999999969,104.05063291139201,0
1925,32,0,0,217,0.0,0.0,1.0,217,5750,3900,1850,0.6782608695652174,76,39,37,202.21718782720592,0.45265208084428515,0.7889517120410503,0.12101548354162184,1057173.2374807305,-6394.280174093076,1050778.9573066374,1924,1,756.7880184331797,80,137,38,37.75473617503834,0.6026041666666666,42.95267489711932,8225.514403292134,102.81893004115167,0
1926,32,2,3,216,0.0091324200913242,0.0136986301369863,0.9863013698630136,219,6450,5100,1350,0.7906976744186046,78,51,27,199.15094494254907,0.45294237778057056,0.7878283696596597,0.11997630097758469,1059184.0277777808,-8062.499999999751,1051121.527777781,1925,0,750.8675799086758,74,145,41,37.58434547908231,0.6076858108108107,42.70833333333334,8233.333333333358,111.2612612612616,0
1927,32,0,2,214,0.0,0.009259259259259259,0.9907407407407407,216,5850,4700,1150,0.8034188034188035,70,47,23,193.171523677066,0.4523130203847258,0.7796924961721738,0.11437106999170413,1053922.2257653004,-8332.447562358633,1045589.7782029419,1926,1,762.074074074074,69,147,45,38.39043263562744,0.603713768115942,43.34821428571426,8212.857142857098,119.02691511387098,8
1928,32,2,1,215,0.009259259259259259,0.004629629629629629,0.9953703703703703,216,6150,4500,1650,0.7317073170731707,78,45,33,185.012273367771,0.4523466659488946,0.7707239131008092,0.11056527250001255,1056751.585834141,-10247.5973439658,1046503.9884901751,1927,0,762.8888888888889,73,143,43,38.24919893739384,0.6051655251141552,43.00394144144143,8223.873873873843,112.65580649142251,0
1929,32,1,0,216,0.004629629629629629,0.0,1.0,216,5700,4100,1600,0.7192982456140351,73,41,32,187.79896280982686,0.4528325078954924,0.7732625922614353,0.11288718558024699,1058515.8431485463,-9142.364507787006,1049373.4786407594,1928,0,762.75,76,140,48,37.959115692771576,0.6059484649122807,42.78950216450214,8230.73593073587,108.2991569833667,0
1930,32,1,0,217,0.004608294930875576,0.0,1.0,217,6250,4400,1850,0.704,81,44,37,184.6462548909605,0.45355880554133243,0.7711110768614282,0.11178877443398533,1060671.123456792,-10480.209876543024,1050190.913580249,1929,0,760.2304147465438,74,143,50,37.77364962059919,0.6095157657657657,42.527777777777786,8239.111111111126,111.33933933933955,0
1931,32,4,1,220,0.01809954751131222,0.004524886877828055,0.995475113122172,221,5700,4200,1500,0.7368421052631579,72,42,30,214.182598029254,0.45487110928287394,0.8086535735283684,0.1285227392851225,1057990.1836422153,-4579.382755612885,1053410.8008866024,1930,0,747.4524886877828,78,143,40,37.345742317027316,0.6044337606837606,42.85337552742614,8228.691983122306,105.49605106567058,8
1932,32,0,2,218,0.0,0.00909090909090909,0.990909090909091,220,7200,5400,1800,0.75,90,54,36,213.0365592389075,0.4545043759512937,0.8071559720587376,0.12816151261521289,1058760.5447382582,-6089.059298210403,1052671.485440048,1931,1,751.6818181818181,80,140,42,37.279616390874686,0.6045572916666666,42.75977366255141,8231.687242798276,102.89609053497846,0
1933,32,2,1,219,0.00909090909090909,0.004545454545454545,0.9954545454545455,220,6050,4400,1650,0.7272727272727273,77,44,33,208.4914740108827,0.4544023280752733,0.8027245974551473,0.1260921183756581,1060353.858184111,-5835.052226813863,1054518.805957297,1932,0,752.3590909090909,65,155,42,37.19901446876341,0.6139423076923076,42.56628787878787,8237.878787878766,126.7365967365964,0
1934,32,1,2,218,0.004545454545454545,0.00909090909090909,0.990909090909091,220,7450,5300,2150,0.7114093959731543,96,53,43,207.840856381999,0.4543439532309395,0.8014951404055348,0.12668051641936823,1062689.9562476578,-7275.921884987698,1055414.03436267,1933,0,753.3318181818182,70,150,38,36.92644882158716,0.6139880952380952,42.282863849765256,8246.948356807508,117.81354795439297,0
1935,32,1,1,218,0.0045662100456621,0.0045662100456621,0.995433789954338,219,7250,5600,1650,0.7724137931034483,89,56,33,202.80148481260008,0.4543658274335665,0.7957784624675039,0.12433893609953099,1064450.7438271602,-7875.561728395131,1056575.1820987652,1934,0,757.4520547945206,74,145,35,36.83857447992389,0.6141610360360361,42.06944444444444,8253.777777777776,111.5375375375375,0
1936,32,0,1,217,0.0,0.0045871559633027525,0.9954128440366973,218,5650,3600,2050,0.6371681415929203,77,36,41,206.79821387119924,0.4536721909835257,0.7989827759943706,0.12724172453486737,1065512.8981994467,-5180.7671591259605,1060332.1310403207,1935,1,761.440366972477,75,143,37,36.60417109269879,0.615,41.94078947368421,8257.894736842112,110.10526315789483,0
1937,32,1,0,218,0.0045871559633027525,0.0,1.0,218,5300,3900,1400,0.7358490566037735,67,39,28,205.21036151790616,0.45339254005834356,0.7975132244907275,0.1266399633406695,1066396.1947916169,-5132.890269098318,1061263.3045225185,1936,0,762.4220183486239,80,138,40,36.536010792860104,0.6139322916666667,41.83384773662552,8261.316872428008,103.2664609053501,0
1938,32,1,1,218,0.0045662100456621,0.0045662100456621,0.995433789954338,219,7000,5500,1500,0.7857142857142857,85,55,30,202.5884495317372,0.453865743649896,0.7966195315952265,0.12560483870967734,1067777.77777778,-7536.111111111117,1060241.666666669,1937,0,759.9360730593608,83,136,43,36.43313172043009,0.6144578313253012,41.66666666666667,8266.666666666684,99.5983935742974,0
1939,32,2,2,218,0.00909090909090909,0.00909090909090909,0.990909090909091,220,5350,3900,1450,0.7289719626168224,68,39,29,196.7364054228313,0.4543975716064757,0.791703904475862,0.1226883814722281,1069500.694444446,-7268.055555555507,1062232.6388888904,1938,0,756.8636363636364,69,151,44,36.37187751813051,0.6228864734299517,41.458333333333336,8273.333333333343,119.90338164251222,0
1940,32,1,2,217,0.0045662100456621,0.0091324200913242,0.9908675799086758,219,6350,4400,1950,0.6929133858267716,83,44,39,194.28993443216842,0.45335082317456327,0.7878558452955715,0.12120253148665831,1069597.8014999204,-8587.582655557857,1061010.2188443625,1939,0,752.4703196347032,70,149,43,36.42316385783728,0.622470238095238,41.44659624413145,8273.708920187775,118.19584171696822,8
1941,32,1,0,218,0.0045871559633027525,0.0,1.0,218,6250,4700,1550,0.752,78,47,31,188.68755599880558,0.45287859890922927,0.7804797345950543,0.11852290194176486,1071633.5915858736,-9409.215335487836,1062224.3762503858,1940,0,756.7522935779816,75,143,43,36.31743635914272,0.6225,41.20065789473684,8281.578947368429,110.42105263157906,0
1942,32,1,1,218,0.0045662100456621,0.0045662100456621,0.995433789954338,219,5950,3900,2050,0.6554621848739496,80,39,41,185.46813528138705,0.4528690670688283,0.7776354760898301,0.11696285294334857,1072797.728729369,-9956.041143691436,1062841.6875856775,1941,0,754.2922374429223,78,141,48,36.25761703500018,0.6225961538461539,41.06012658227848,8286.075949367078,106.23174294060355,0
1943,32,0,1,217,0.0,0.0045871559633027525,0.9954128440366973,218,6650,4300,2350,0.6466165413533834,90,43,47,184.20514725208812,0.4522853866317169,0.775121367205345,0.11664819202061733,1074011.7498104924,-10682.301495136919,1063329.4483153555,1942,1,758.5825688073395,82,136,42,36.14115077827299,0.6224593495934959,40.91365461847391,8290.763052208878,101.10686649035217,0
1944,32,0,0,217,0.0,0.0,1.0,217,6750,4700,2050,0.6962962962962963,88,47,41,185.2979312313051,0.4518529185867896,0.7746587499130428,0.1176155394410041,1074697.8683109523,-10322.141660657291,1064375.726650295,1943,3,763.073732718894,85,132,43,36.028561246903806,0.6221813725490196,40.83091085271319,8293.410852713207,97.56953944368479,0
1945,32,0,1,216,0.0,0.004608294930875576,0.9953917050691244,217,6400,4300,2100,0.671875,85,43,42,182.51458765782687,0.4516102363884622,0.7703387784160334,0.11637340197797098,1076017.7082895038,-10522.214331804093,1065495.4939576997,1944,4,764.073732718894,88,129,44,35.93869883106919,0.622750946969697,40.67181647940077,8298.501872659224,94.30115764385482,0
1946,32,0,4,212,0.0,0.018518518518518517,0.9814814814814815,216,6400,4700,1700,0.734375,81,47,34,186.67130194830008,0.45154859316681023,0.7754972500035187,0.11942168574137793,1076990.5071879243,-9391.355967454234,1067599.1512204702,1945,5,768.5879629629629,73,143,43,35.71151637639486,0.6299942922374429,40.5546171171171,8302.2522522522,113.72948290756437,0
1947,32,0,0,212,0.0,0.0,1.0,212,6950,4800,2150,0.6906474820143885,91,48,43,184.67269659199093,0.45065612983993564,0.7686701485860279,0.11850717910411761,1077885.6505126506,-9538.79006040355,1068346.860452247,1946,6,782.9764150943396,75,137,46,35.65358161271585,0.6301388888888889,40.446820175438575,8305.70175438591,110.74269005847879,0
1948,32,0,0,212,0.0,0.0,1.0,212,7200,5500,1700,0.7638888888888888,89,55,34,185.66444565186416,0.4503133476407643,0.7695994349712447,0.119721556334132,1079290.1234567794,-9522.839506173415,1069767.283950606,1947,7,783.9764150943396,77,135,45,35.45565953654186,0.6309523809523809,40.27777777777774,8311.111111111026,107.93650793650683,0
1949,32,2,0,214,0.009345794392523364,0.0,1.0,214,5950,4600,1350,0.773109243697479,73,46,27,185.53338924748903,0.4505881342050224,0.7702799719406976,0.12045543393275983,1081261.815057167,-8627.966157710784,1072633.8488994562,1948,0,777.6401869158879,81,133,45,35.2175364868387,0.631687242798354,40.04065040650404,8318.699186991807,102.69998996286182,0
1950,32,0,2,212,0.0,0.009345794392523364,0.9906542056074766,214,6100,4700,1400,0.7704918032786885,75,47,28,191.41131756568876,0.4504176538984687,0.7755106458004357,0.12483294423745897,1082560.8558732865,-7457.120046451108,1075103.7358268353,1949,1,778.6401869158879,82,132,38,34.905633825468826,0.6328760162601625,39.884538152610425,8323.69477911642,101.5084729160539,0
1951,32,0,1,211,0.0,0.0047169811320754715,0.9952830188679245,212,5400,3800,1600,0.7037037037037037,70,38,32,195.39467735672147,0.44969252064144977,0.7782882328524734,0.1275233272119047,1082769.7940355726,-5486.509088563469,1077283.284947009,1950,10,786.9764150943396,82,130,38,34.77642962820017,0.6331300813008129,39.859437751003995,8324.497991967814,101.51826819472943,0
1952,32,0,1,210,0.0,0.004739336492890996,0.995260663507109,211,6700,5100,1600,0.7611940298507462,83,51,32,193.32492323390963,0.4495213646279997,0.7745264619547589,0.12319322235862964,1075844.9054552955,-7302.47324825239,1068542.432207043,1951,11,791.0047393364929,76,135,45,35.679583159432404,0.6271929824561404,40.692640692640694,8297.8354978355,109.18204602415132,8
1953,32,0,0,210,0.0,0.0,1.0,210,6500,5100,1400,0.7846153846153846,79,51,28,193.58634003525452,0.4494422609554189,0.773310383256832,0.12355219322250065,1076299.5139629827,-6828.623262036428,1069470.8907009463,1952,12,794.3857142857142,80,130,47,35.616963341266704,0.6260416666666666,40.637860082304535,8299.588477366276,103.74485596707845,0
1954,32,0,0,210,0.0,0.0,1.0,210,6000,4100,1900,0.6833333333333333,79,41,38,193.12702335746638,0.44942612212349053,0.7744510548825645,0.12376275162425375,1077487.2504340238,-6381.6189236113105,1071105.6315104126,1953,13,795.3857142857142,71,139,46,35.483044823549065,0.6316021126760563,40.49479166666665,8304.166666666635,116.96009389671318,0
1955,32,2,1,211,0.009433962264150943,0.0047169811320754715,0.9952830188679245,212,6400,4900,1500,0.765625,79,49,30,188.06647709902262,0.4498098862857313,0.7701308638066602,0.12134994237329079,1079479.9872316394,-8197.200340489862,1071282.7868911496,1954,0,788.872641509434,75,137,46,35.37000026383833,0.6320833333333333,40.25493421052629,8311.84210526309,110.82456140350786,0
1956,32,1,0,212,0.0047169811320754715,0.0,1.0,212,5400,3300,2100,0.6111111111111112,75,33,42,185.9944730087293,0.4499924550657248,0.7678461352915962,0.12060273197197512,1080898.0042372027,-7591.789065143237,1073306.2151720594,1955,0,789.7311320754717,78,134,49,35.250101461038966,0.6324786324786325,40.08438818565398,8317.299578058995,106.63204587255122,0
1957,32,0,0,212,0.0,0.0,1.0,212,6250,4500,1750,0.72,80,45,35,184.75714990138172,0.4496347692926764,0.766524552491535,0.12009214743589718,1081599.9999999905,-8683.333333333818,1072916.6666666567,1956,1,790.7311320754717,79,133,39,35.196314102564095,0.6329113924050633,39.99999999999997,8319.999999999927,105.31645569620161,0
1958,32,0,1,211,0.0,0.0047169811320754715,0.9952830188679245,212,6250,4000,2250,0.64,85,40,45,185.61150231917486,0.4493320404482995,0.768174892357399,0.12110645362828304,1082693.9272526044,-8457.910722159686,1074236.0165304446,1957,2,791.7311320754717,83,129,42,35.04021269326722,0.6326556224899598,39.86855158730156,8324.206349206275,100.29164276152139,0
1959,32,0,2,209,0.0,0.009478672985781991,0.990521327014218,211,6250,4800,1450,0.768,77,48,29,188.16242508636833,0.4488640637929737,0.770227870615916,0.12322602949804258,1083757.6641465293,-7665.505941650467,1076092.158204879,1958,3,796.3744075829384,85,126,43,34.843694249235966,0.6332107843137256,39.74079457364339,8328.294573643361,97.97993616051014,0
1960,32,0,2,207,0.0,0.009569377990430622,0.9904306220095693,209,6600,4900,1700,0.7424242424242424,83,49,34,191.2203525517067,0.4479310437369648,0.7717244336129434,0.12553727115902075,1084463.9087945311,-6925.685806142031,1077538.2229883892,1959,4,804.8421052631579,85,124,45,34.67770075369867,0.6340686274509804,39.65600775193795,8331.007751937888,98.01185590515163,0
1961,32,0,0,207,0.0,0.0,1.0,207,6350,5100,1250,0.8031496062992126,76,51,25,191.22740447529972,0.44729863358504135,0.7696118128430947,0.12591813671785834,1085321.0693365133,-6241.373777684121,1079079.6955588292,1960,5,813.1884057971015,68,139,46,34.572682394311755,0.6427696078431373,39.55314009661838,8334.29951690826,122.56322818982736,0
1962,32,0,1,206,0.0,0.004830917874396135,0.9951690821256038,207,5500,3400,2100,0.6181818181818182,76,34,42,189.49154225428506,0.44675632787705394,0.767445755295481,0.125153052181452,1086185.8028628174,-5735.395408162916,1080450.4074546546,1961,6,814.1884057971015,69,138,46,34.51219134921087,0.6432669082125604,39.44940476190478,8337.619047619091,120.83505866114625,0
1963,32,1,0,207,0.004830917874396135,0.0,1.0,207,6250,4100,2150,0.656,84,41,43,186.9166622625964,0.44711981927051575,0.7648596765930888,0.12406722543772615,1087602.7500482309,-6991.784818672526,1080610.9652295583,1962,0,810.8599033816425,71,136,47,34.40621358415181,0.6439260563380282,39.27951388888891,8343.055555555598,117.50782472613518,0
1964,32,0,0,207,0.0,0.0,1.0,207,6300,4800,1500,0.7619047619047619,78,48,30,190.008296005784,0.4466889060863311,0.7678873830418738,0.126739207437934,1088997.0790069092,-6316.304132523879,1082680.7748743852,1963,1,811.8599033816425,72,135,46,34.155362905431296,0.6451099537037037,39.112442922374456,8348.401826484078,115.95002536783441,0
1965,32,0,1,206,0.0,0.004830917874396135,0.9951690821256038,207,6650,5000,1650,0.7518796992481203,83,50,33,189.04328449761755,0.44642801307005614,0.7670269980458155,0.12651996768188623,1089950.3014167862,-6840.443016200235,1083109.8584005858,1964,2,812.8599033816425,72,135,50,34.06422557541959,0.6462673611111112,38.99828767123291,8352.054794520625,116.00076103500868,0
1966,32,0,0,206,0.0,0.0,1.0,206,5950,4600,1350,0.773109243697479,73,46,27,192.58536690655072,0.4457341739679533,0.7709261404824019,0.12951985834444896,1091328.4444444487,-5115.222222221924,1086213.2222222267,1965,3,817.5242718446602,74,132,42,33.80364550095729,0.6469594594594594,38.83333333333335,8357.333333333367,112.93693693693739,0
1967,32,0,0,206,0.0,0.0,1.0,206,6400,4800,1600,0.75,80,48,32,194.2056132959039,0.44545346909779776,0.7734922706061866,0.13116348344138792,1092522.6757369658,-5165.192743763939,1087357.4829932018,1966,4,818.5242718446602,76,130,43,33.61569855732726,0.6474780701754386,38.690476190476204,8361.904761904796,110.02506265664205,0
1968,32,0,1,205,0.0,0.0048543689320388345,0.9951456310679612,206,5200,3500,1700,0.6730769230769231,69,35,34,196.78200728881592,0.44540166942931564,0.7763474875171297,0.13338923505553196,1093549.490017364,-3361.8272569442456,1090187.6627604198,1967,5,819.5242718446602,79,127,45,33.42319122090514,0.6474156118143459,38.56770833333334,8365.833333333358,105.89662447257415,0
1969,32,0,0,205,0.0,0.0,1.0,205,5800,3600,2200,0.6206896551724138,80,36,44,240.04212347103496,0.44489877251713694,0.812049113661085,0.15280430826583263,1075541.8402777766,4835.069444444413,1080376.909722221,1968,13,824.4975609756098,69,136,39,34.50557452792287,0.6302838164251208,40.729166666666664,8296.666666666659,120.24154589371969,8
1970,32,1,0,206,0.0048543689320388345,0.0,1.0,206,4850,3100,1750,0.6391752577319587,66,31,35,235.04620981728237,0.4456034414713079,0.8090935465297959,0.15036029750543004,1076973.2645420858,4577.696781032412,1081550.9613231183,1969,0,821.4902912621359,60,146,39,34.45857741503762,0.6376736111111111,40.55669398907103,8302.185792349706,138.36976320582843,0
1971,32,0,0,206,0.0,0.0,1.0,206,6250,4100,2150,0.656,84,41,43,234.52878412917454,0.4452364038203489,0.8077237029249902,0.15065883432193217,1078191.0500825788,3123.3672069648164,1081314.4172895437,1970,1,822.4902912621359,62,144,43,34.32192144373674,0.637768817204301,40.41005291005289,8306.878306878263,133.98190817545586,0
1972,32,0,0,206,0.0,0.0,1.0,206,5750,4000,1750,0.6956521739130435,75,40,35,234.85849869869753,0.44496260557265765,0.8081759256683447,0.1512280738853232,1078877.905328794,3726.7290249430075,1082604.6343537369,1971,2,823.4902912621359,62,144,44,34.22874880611269,0.638608870967742,40.327380952380935,8309.523809523776,134.02457757296415,0
1973,32,0,0,206,0.0,0.0,1.0,206,5400,4100,1300,0.7592592592592593,67,41,26,239.9464249271639,0.44483877969847657,0.8121932666821943,0.15535658224245968,1080471.001842923,5251.030825936023,1085722.032668859,1972,3,824.4902912621359,65,141,41,33.90038212369673,0.6386217948717949,40.13573232323232,8315.656565656556,127.93317793317779,0
1974,32,0,1,205,0.0,0.0048543689320388345,0.9951456310679612,206,6300,4200,2100,0.6666666666666666,84,42,42,238.98470909750412,0.4445511682058568,0.8110433890324553,0.1554224694337565,1081752.9465830477,4204.482650903674,1085957.4292339515,1973,4,825.4902912621359,67,139,36,33.76757590039667,0.6389925373134329,39.98161764705883,8320.588235294139,124.18788410886775,0
1975,32,0,0,205,0.0,0.0,1.0,205,5000,3700,1300,0.74,63,37,26,240.083820382392,0.4439931053722302,0.8113268122814705,0.1565724536407504,1082554.799995336,5980.778431235498,1088535.5784265716,1974,5,830.3073170731707,68,137,36,33.6403317856452,0.6393995098039216,39.8852657004831,8323.671497584568,122.40693378800836,0
1976,32,0,0,205,0.0,0.0,1.0,205,6250,4500,1750,0.72,80,45,35,229.65872835793215,0.4439442850310856,0.8050801339665836,0.141912800025587,1066784.419173241,1749.270627876319,1068533.6898011172,1975,6,831.3073170731707,77,128,36,35.85676881303334,0.6156655844155844,41.78685897435897,8262.820512820508,107.30935730935725,8
1977,32,2,1,206,0.00966183574879227,0.004830917874396135,0.9951690821256038,207,6350,4600,1750,0.7244094488188977,81,46,35,224.15104994269643,0.4447248800087551,0.8023995613565504,0.13964891772580504,1069213.4452160457,183.06327160480305,1069396.5084876504,1976,0,824.2657004830918,65,142,39,35.69859525408552,0.6248397435897436,41.49305555555554,8272.222222222194,127.26495726495682,0
1978,32,1,1,206,0.004830917874396135,0.004830917874396135,0.9951690821256038,207,6150,4500,1650,0.7317073170731707,78,45,33,218.06164409634454,0.44521735221925174,0.7974770902674033,0.13698170629328035,1071650.042153839,-812.8459824034535,1070837.1961714355,1977,0,821.1159420289855,68,139,40,35.55520717882903,0.6260723039215687,41.19867149758453,8281.642512077267,121.78886047172452,0
1979,32,1,0,207,0.004830917874396135,0.0,1.0,207,6450,4800,1650,0.7441860465116279,81,48,33,216.05316478389994,0.445008246955271,0.795979948177814,0.13655282197623025,1073447.3843330985,-1465.6590771670963,1071981.7252559315,1978,0,821.2850241545893,72,135,37,35.38556357426179,0.6261574074074074,40.98173515981733,8288.584474885802,115.11922881785836,0
1980,32,0,0,207,0.0,0.0,1.0,207,5500,3700,1800,0.6727272727272727,73,37,36,218.01370211384773,0.4448900145396557,0.7976250371038753,0.13814038605196494,1074187.5183883167,-62.480470335412065,1074125.0379179814,1979,1,822.2850241545893,73,134,38,35.2435554408649,0.6265696347031964,40.89245495495494,8291.44144144141,113.58138960878644,0
1981,32,1,1,207,0.004807692307692308,0.004807692307692308,0.9951923076923077,208,6600,5100,1500,0.7727272727272727,81,51,30,209.5583720635335,0.445172662733804,0.790810286635433,0.1285123028678786,1064522.0051132287,-3584.1003165323655,1060937.9047966963,1980,0,819.3269230769231,73,135,39,36.65547915302339,0.6147260273972603,42.060810810810835,8254.054054054111,113.0692336171796,8
1982,32,0,1,206,0.0,0.004830917874396135,0.9951690821256038,207,5350,3900,1450,0.7289719626168224,68,39,29,208.80750105161843,0.44467602363866615,0.7895773258934691,0.12826746493170935,1065024.0000000084,-2272.999999999662,1062751.0000000086,1981,1,824.2657004830918,74,133,39,36.61276647286823,0.6148648648648649,42.00000000000003,8256.000000000065,111.56756756756845,0
1983,32,2,2,206,0.009615384615384616,0.009615384615384616,0.9903846153846154,208,5400,3700,1700,0.6851851851851852,71,37,34,206.1208049232195,0.44508895392047565,0.7883756373309687,0.12726676033515558,1066547.973356013,-3032.4546485258415,1063515.518707487,1982,0,820.9326923076923,76,132,41,36.4937560038425,0.6158168859649122,41.815476190476204,8261.904761904792,108.7092731829578,0
1984,32,0,1,205,0.0,0.0048543689320388345,0.9951456310679612,206,4850,3500,1350,0.7216494845360825,62,35,27,209.5927708807391,0.4451924974346831,0.790720238798017,0.1251702078611788,1056546.7825443791,-1761.0864562787506,1054785.6960881003,1983,1,822.7330097087379,77,129,38,37.64291653674254,0.6030844155844156,43.02884615384615,8223.076923076926,106.79320679320682,8
1985,32,0,0,205,0.0,0.0,1.0,205,6450,4900,1550,0.7596899224806202,80,49,31,207.31523997370152,0.44444344811095166,0.7872945590994371,0.1243126438956697,1057773.1933984933,-3591.499314568612,1054181.6940839246,1984,2,827.7414634146342,78,127,38,37.54925213675214,0.6041666666666667,42.879746835443036,8227.84810126582,105.48523206751051,0
1986,32,2,2,205,0.00966183574879227,0.00966183574879227,0.9903381642512077,207,6100,3900,2200,0.639344262295082,83,39,44,208.34457311687436,0.4450043384456639,0.7901429779400926,0.1257740185020001,1059805.5963966516,-3339.0510863729514,1056466.5453102787,1985,0,820.7342995169082,68,139,39,37.2707453464727,0.6115196078431373,42.6328502415459,8235.748792270553,121.11395282750813,0
1987,32,1,1,205,0.0048543689320388345,0.0048543689320388345,0.9951456310679612,206,6000,4100,1900,0.6833333333333333,79,41,38,209.88754795219356,0.4452586036782698,0.7897534240514548,0.12736176648118824,1061359.4394024615,-2646.7739535802934,1058712.6654488812,1986,0,821.5776699029126,70,136,42,37.03847431880758,0.6123511904761905,42.4442488262911,8241.784037558733,117.73977196512476,0
1988,32,2,1,206,0.00966183574879227,0.004830917874396135,0.9951690821256038,207,5700,4200,1500,0.7368421052631579,72,42,30,208.281150911885,0.44608015571502274,0.788909227651958,0.12718415193895907,1063244.3116680966,-2809.250213050401,1060435.061455046,1987,0,818.56038647343,73,134,44,36.84649110832016,0.613156392694064,42.215653153153184,8249.099099099174,113.0013575219065,0
1989,32,1,2,205,0.004830917874396135,0.00966183574879227,0.9903381642512077,207,6050,4400,1650,0.7272727272727273,77,44,33,208.5725909108037,0.4459394493691666,0.7889888984171773,0.12802658845325743,1064799.088798493,-3032.419049966873,1061766.669748526,1988,0,819.5072463768116,77,130,39,36.64663897085469,0.6132305194805194,42.027243589743605,8255.128205128245,107.20945720945772,0
1990,32,0,1,204,0.0,0.004878048780487805,0.9951219512195122,205,5550,3700,1850,0.6666666666666666,74,37,37,211.79093496606671,0.4456051729634944,0.7900719845946236,0.13038620105365528,1065678.5395597888,-1409.7891466717788,1064268.750413117,1989,1,827.9756097560976,81,124,39,36.45484675461048,0.6126543209876543,41.92073170731708,8258.536585365877,101.95724179464045,0
1991,32,0,1,203,0.0,0.004901960784313725,0.9950980392156863,204,5700,3700,2000,0.6491228070175439,77,37,40,212.2389970378685,0.4451256077143501,0.7903270391205619,0.13099921966591696,1066445.521640368,-1231.734418304436,1065213.7872220636,1990,2,833.0245098039215,83,121,40,36.348457738924374,0.6128263052208835,41.82787698412698,8261.50793650793,99.53624019889071,0
1992,32,2,1,204,0.00975609756097561,0.004878048780487805,0.9951219512195122,205,4650,3300,1350,0.7096774193548387,60,33,27,209.22733500066346,0.4457307109835804,0.789325287874141,0.13000252467461781,1068420.4946969133,-941.4454468949098,1067479.0492500183,1991,0,823.8146341463415,66,139,41,36.18226440446828,0.6232638888888888,41.58893034825871,8269.154228855721,125.29021558872304,0
1993,32,2,2,204,0.009708737864077669,0.009708737864077669,0.9902912621359223,206,6200,4400,1800,0.7096774193548387,80,44,36,206.11061415421716,0.4464953824295525,0.7852104936996485,0.12868223784867464,1069840.5884249178,-3298.8998545261124,1066541.6885703916,1992,0,820.7815533980582,70,136,45,36.08758865248227,0.6227678571428572,41.41725352112677,8274.647887323961,118.20925553319944,0
1994,32,0,0,204,0.0,0.0,1.0,204,5550,3600,1950,0.6486486486486487,75,36,39,206.07683663489163,0.44648038813226437,0.7836539584355104,0.1289790808203683,1070569.11451101,-2226.100696510839,1068343.0138144991,1993,1,829.5392156862745,70,134,43,35.998619855179356,0.6236607142857142,41.32922535211268,8277.464788732397,118.24949698189138,0
1995,32,1,1,204,0.004878048780487805,0.004878048780487805,0.9951219512195122,205,6150,4500,1650,0.7317073170731707,78,45,33,208.47272379707485,0.4465377411127052,0.7871249256080126,0.13150835294484617,1072882.5485966855,-2416.6505559401394,1070465.8980407454,1994,0,826.4878048780488,75,130,47,35.651486882266816,0.6240277777777778,41.0498903508772,8286.403508771946,110.48538011695928,0
1996,32,1,0,205,0.004878048780487805,0.0,1.0,205,5700,4000,1700,0.7017543859649122,74,40,34,211.31986378652368,0.4468784871672246,0.7902546875325542,0.1339750433009117,1074353.84385851,-1293.5384114581593,1073060.3054470518,1995,0,823.9365853658536,79,126,39,35.396514831750494,0.6240770042194093,40.87239583333334,8292.083333333358,104.96308016877668,0
1997,32,0,3,202,0.0,0.014634146341463415,0.9853658536585366,205,6200,4300,1900,0.6935483870967742,81,43,38,218.21811609596867,0.4467868244858919,0.7933472094593839,0.13618541352958036,1069719.191518437,-513.5786550288567,1069205.612863408,1996,1,824.9365853658536,70,135,39,35.78950105916173,0.6226190476190476,41.431924882629104,8274.178403755863,118.20254862508375,8
1998,32,1,0,203,0.0049261083743842365,0.0,1.0,203,5750,4400,1350,0.7652173913043478,71,44,27,215.60043628077213,0.446127802435416,0.7892379215533605,0.13522942618745243,1071201.3699933302,-159.7034569752941,1071041.666536355,1997,0,833.9950738916256,72,131,40,35.67425412231841,0.6234085648148149,41.25285388127855,8279.908675799104,114.9987316083209,0
1999,32,0,0,203,0.0,0.0,1.0,203,5000,3700,1300,0.74,63,37,26,218.18352405611338,0.44598249849615507,0.7914509799012264,0.13736834674572912,1072314.7506925224,1192.2822406894315,1073507.032933212,1998,1,834.9950738916256,75,128,40,35.47005153183679,0.6233333333333333,41.11842105263158,8284.210526315801,110.45614035087735,0
2000,32,3,2,204,0.014563106796116505,0.009708737864077669,0.9902912621359223,206,6400,4900,1500,0.765625,79,49,30,216.25909894155973,0.44729753729576127,0.7928560071309816,0.13711833995193382,1074379.1702653803,-1131.1457433653677,1073248.024522015,1999,0,823.8203883495146,80,126,37,35.2654052936311,0.6236979166666667,40.86934156378603,8292.181069958906,103.65226337448632,0
2001,31.900849383263044,1,1,204,0.004878048780487805,0.004878048780487805,0.9951219512195122,205,5600,4300,1300,0.7678571428571429,69,43,26,219.44493112682278,0.44708373186673045,0.7949590995488294,0.13959578310462753,1072007.2359757058,449.31081322919,1072456.546788935,2000,0,828.8341463414635,80,125,40,35.06457000181888,0.6248697916666667,40.75360082304529,8270.180333297376,103.3772541662172,0
2002,32.16235068382039,0,0,204,0.0,0.0,1.0,204,5500,3400,2100,0.6181818181818182,76,34,42,219.67902739519178,0.44687178032132396,0.7959419257443838,0.14032162964317285,1082003.133621385,1238.67920649893,1083241.812827884,2001,1,833.5,63,141,41,34.91044163477022,0.6350859788359788,40.60872395833332,8342.633184375716,132.4227489583447,0
2003,32.636734680262876,1,2,203,0.004878048780487805,0.00975609756097561,0.9902439024390244,205,4650,2900,1750,0.6236559139784946,64,29,35,220.32234117851917,0.44691236250597804,0.7965336433519972,0.14155710420719836,1099695.790682929,2807.5102374850926,1102503.3009204143,2002,0,830.4292682926829,65,140,43,34.68456144617381,0.6358974358974359,40.404040404040394,8472.364457401556,130.34406857540856,0
2004,32.199935128995904,0,0,203,0.0,0.0,1.0,203,4550,3300,1250,0.7252747252747253,58,33,25,218.37198661671835,0.44655863369588195,0.7927741629567195,0.14081228102526278,1086033.4987710777,2281.858531788914,1088315.3573028666,2003,1,835.3793103448276,65,138,40,34.606172014260245,0.6371794871794871,40.277777777777764,8363.038707114181,128.6621339556028,0
2005,31.828375030443105,2,2,203,0.00975609756097561,0.00975609756097561,0.9902439024390244,205,5600,4200,1400,0.75,70,42,28,213.47745203182893,0.44672106647537063,0.7897065109859918,0.1388646487646779,1076014.5914440744,-659.0293338900683,1075355.5621101842,2004,0,828.219512195122,71,134,39,34.422988649641134,0.6368838028169015,39.97395833333332,8276.206371848264,116.56628692744034,0
2006,31.630812319040263,0,1,202,0.0,0.0049261083743842365,0.9950738916256158,203,6550,4900,1650,0.7480916030534351,82,49,33,216.46006060914834,0.44594490237201057,0.790166452012949,0.14132068463628158,1070376.6619771388,-811.2405747622779,1069565.4214023766,2005,1,837.1379310344828,70,133,44,34.216153470185745,0.6386904761904761,39.84741784037558,8228.837500604757,117.55482143721082,0
2007,31.60085276026538,0,0,202,0.0,0.0,1.0,202,5400,3500,1900,0.6481481481481481,73,35,38,218.44643174785438,0.44583908017667434,0.7918138641707757,0.14306964493751606,1070261.1131471603,958.9442410967658,1071220.057388257,2006,2,841.3069306930693,73,129,44,34.05284899129213,0.6382705479452055,39.73817567567568,8224.495589591028,112.66432314508258,0
2008,31.65133078183726,1,0,203,0.0049261083743842365,0.0,1.0,203,5300,3600,1700,0.6792452830188679,70,36,34,216.2912158738618,0.44570306784373015,0.7909106467225553,0.14256691181405642,1073783.3124944523,549.9796488976231,1074333.29214335,2007,0,838.1576354679803,63,140,42,33.884237274014815,0.6461640211640212,39.51822916666667,8244.594691284574,130.86658240134244,0
2009,31.61134929237476,0,0,203,0.0,0.0,1.0,203,5800,3900,1900,0.6724137931034483,77,39,38,215.3616443135178,0.44539010551301433,0.790153034266154,0.14240432956589877,1073320.5772429232,-169.58312188595028,1073150.9941210372,2008,1,839.1576354679803,65,138,42,33.79760715078835,0.6459935897435898,39.40972222222222,8237.610293030297,126.73246604661995,0
2010,31.623766779939103,0,1,202,0.0,0.0049261083743842365,0.9950738916256158,203,6350,4500,1850,0.7086614173228346,82,45,37,213.66953408760614,0.4449846770391325,0.7890430757232645,0.1421366900669735,1075433.6920461624,-992.5168156762957,1074441.175230486,2009,2,840.1576354679803,65,138,42,33.632141128056155,0.648076923076923,39.204545454545475,8247.334631813708,126.88207125867244,0
2011,31.685428813171885,0,2,200,0.0,0.009900990099009901,0.9900990099009901,202,6050,4500,1550,0.743801652892562,76,45,31,212.03810461862793,0.44457066975354254,0.785614257787133,0.14157944121793709,1078581.7104544542,-709.9156877838559,1077871.7947666703,2010,3,841.4207920792079,69,133,44,33.544827192882416,0.6470410628019323,39.077380952380956,8267.44507157971,119.81804451564797,0
2012,31.517816857546475,0,0,200,0.0,0.0,1.0,200,5000,2900,2100,0.58,71,29,42,212.93588488337693,0.4438578308207705,0.7844442195361743,0.1426530176489144,1073805.702518405,730.3534917147499,1074536.0560101196,2011,4,842.9,68,132,40,33.40598673683806,0.6487438725490196,38.96437198067634,8227.273117207696,120.98931054717201,0
2013,31.885412316265604,0,0,200,0.0,0.0,1.0,200,6250,4700,1550,0.752,78,47,31,216.2004976005827,0.44370917085427136,0.7869587686776764,0.14545734158297768,1087528.0606130653,774.8215718286137,1088302.8821848938,2012,5,843.9,70,130,41,33.173707074111526,0.6491071428571429,38.820422535211286,8327.818516052863,118.96883594361232,0
2014,31.576326531425543,0,0,200,0.0,0.0,1.0,200,5750,4600,1150,0.8,69,46,23,215.58190333647744,0.4434207495812395,0.7866916280573211,0.14551386508115333,1077891.9783489734,724.8008567188272,1078616.7792056922,2013,6,844.9,73,127,42,33.07765865747226,0.6486872146118721,38.710585585585605,8250.55986875456,113.02136806513097,0
2015,31.411412341812856,0,1,199,0.0,0.005,0.995,200,6150,3800,2350,0.6178861788617886,85,38,47,218.85520870303262,0.44297895728643216,0.7901959939694161,0.14834229693550152,1073418.0964800396,834.6283061505073,1074252.72478619,2014,7,845.9,73,127,43,32.848284155359366,0.6501141552511416,38.56981981981984,8211.891188234118,112.49166011279614,0
2016,31.49558918231418,0,1,198,0.0,0.005025125628140704,0.9949748743718593,199,6600,4600,2000,0.696969696969697,86,46,40,218.6092817050619,0.4423834238532731,0.789579351279228,0.14902144165085496,1077867.1974211931,726.3547603389252,1078593.5521815321,2015,11,851.1155778894472,63,136,43,32.65962631164198,0.6577380952380952,38.37890624999999,8239.910490177692,130.7922300028205,0
2017,31.965380771032006,0,0,198,0.0,0.0,1.0,198,4650,3500,1150,0.7526881720430108,58,35,23,231.9033829199958,0.4419191919191919,0.7967315229405707,0.14928988223271505,1077642.099241891,5731.769678240253,1083373.8689201311,2016,12,856.2626262626262,71,127,38,34.313943986330884,0.6332159624413145,40.33564814814816,8300.2698796077,116.90520957193944,7
2018,31.88408308737495,0,1,197,0.0,0.005050505050505051,0.9949494949494949,198,6250,4700,1550,0.752,78,47,31,231.07405127948294,0.44175361910133487,0.7959693058017709,0.1492267862200421,1075813.814512668,3868.531308375255,1079682.3458210432,2017,13,857.2626262626262,72,126,37,34.22274100521839,0.6338252314814814,40.22545662100457,8282.673125080777,115.03712673723301,0
2019,31.974320058518256,0,0,197,0.0,0.0,1.0,197,6350,4800,1550,0.7559055118110236,79,48,31,233.38512184588546,0.44130171103974586,0.7976853718769343,0.1511827242595615,1079745.9980409862,4649.33026308054,1084395.3283040668,2018,14,859.1979695431472,71,126,38,34.05338983837147,0.6354166666666667,40.11863425925926,8309.529965439287,117.0356333160463,0
2020,32.40503395471815,0,1,196,0.0,0.005076142131979695,0.9949238578680203,197,5750,4200,1550,0.7304347826086957,73,42,31,231.12623830686857,0.44120567008529304,0.7960129676891481,0.15024442341025512,1095314.1926325676,5481.169821457985,1100795.3624540255,2019,15,860.1979695431472,72,125,41,33.98779796205843,0.6361400462962963,39.99714611872146,8425.40130834645,117.01946261592292,0
2021,31.927158003384513,1,0,197,0.005076142131979695,0.0,1.0,197,5250,3800,1450,0.7238095238095238,67,38,29,233.18818733311724,0.44082258537932945,0.7973704369723096,0.15222715966454778,1080376.9114625766,5736.226724102107,1086113.1381866788,2020,0,861.0507614213197,73,124,38,33.78441597676891,0.63712899543379,39.85078828828829,8305.824986775764,113.77842447638032,0
2022,32.05474023094089,1,0,198,0.005050505050505051,0.0,1.0,198,5100,3600,1500,0.7058823529411765,66,36,30,228.00935183537933,0.44097702917499876,0.7940155852777213,0.14976395618451407,1086461.8937385597,4844.694437033677,1091306.5881755934,2021,0,857.6969696969697,74,124,40,33.702412070130535,0.638795045045045,39.6388888888889,8345.807782905826,112.78118625548413,0
2023,32.146883659338805,0,0,198,0.0,0.0,1.0,198,5100,3900,1200,0.7647058823529411,63,39,24,228.55050414150503,0.44064000837477996,0.7954597483745474,0.15050041577586223,1090314.3078467585,5138.376946214468,1095452.6847929729,2022,1,858.6969696969697,65,133,40,33.59921019674383,0.644551282051282,39.55176767676767,8372.599023775374,128.80921575039036,0
2024,31.669825655876675,0,0,198,0.0,0.0,1.0,198,6550,4600,1950,0.7022900763358778,85,46,39,231.19237244391684,0.440320078962211,0.7973380075742285,0.15280168410924969,1075175.8136652545,3564.4894311176345,1078740.3030963722,2023,2,859.6969696969697,65,133,40,33.40122148193011,0.6458333333333333,39.42550505050504,8252.348825418598,126.95921269874766,0
2025,31.60510373067854,1,0,199,0.005025125628140704,0.0,1.0,199,5450,4000,1450,0.7339449541284404,69,40,29,233.98550308808143,0.4405169788335617,0.7991727086954314,0.15564495825362332,1074787.7031226247,5046.948285605972,1079834.6514082307,2024,0,856.3718592964824,68,131,39,33.103714423540765,0.6462928921568627,39.20591787439613,8242.42401792679,121.21211791068811,0
2026,31.453560119996098,0,0,199,0.0,0.0,1.0,199,5500,3300,2200,0.6,77,33,44,240.68732829064334,0.4398444241409065,0.8052125031939352,0.16095790499653187,1071120.7425693953,6261.037961143525,1077381.7805305389,2025,1,857.3718592964824,68,131,42,32.74341509033762,0.6481311274509804,39.024758454106276,8208.600449794267,120.71471249697451,0
2027,31.97562835631919,0,0,199,0.0,0.0,1.0,199,5450,4200,1250,0.7706422018348624,67,42,25,242.713466919737,0.4399205624079996,0.8066425191033288,0.16272959421137104,1089625.1050976017,7643.337380204189,1097268.4424778058,2026,2,858.3718592964824,70,129,35,32.6014621033307,0.6479166666666667,38.937793427230034,8347.628095251492,119.25182993216417,0
2028,31.80022721779271,0,0,199,0.0,0.0,1.0,199,6050,4400,1650,0.7272727272727273,77,44,33,240.25059849246685,0.4398497115205658,0.8047068712824743,0.16175943779485533,1084833.4043500356,6276.374931943245,1091109.7792819787,2027,3,859.3718592964824,73,126,37,32.51958036933248,0.6478310502283104,38.79504504504504,8306.376917980873,113.78598517782018,0
2029,31.743067132906535,0,1,198,0.0,0.005025125628140704,0.9949748743718593,199,4750,3000,1750,0.631578947368421,65,30,35,246.30245873559534,0.43950708931864707,0.8076188331509968,0.1665277293840152,1084050.9106990458,8850.880939947112,1092901.791638993,2028,4,860.3718592964824,73,126,38,32.21726991992531,0.64925799086758,38.65427927927927,8295.914757735667,113.64266791418721,0
2030,32.075490640804425,0,0,198,0.0,0.0,1.0,198,6150,4600,1550,0.7479674796747967,77,46,31,246.35622137185229,0.438808559366935,0.8079254637407847,0.16729280788767942,1096634.0881988434,8282.526039246739,1104916.61423809,2029,8,865.6969696969697,60,138,39,32.065483576046496,0.6585069444444445,38.50751366120218,8387.49979820078,139.79166330334635,0
2031,32.50390550527533,1,1,198,0.005025125628140704,0.005025125628140704,0.9949748743718593,199,6000,3900,2100,0.65,81,39,42,243.67270382866,0.4385934301135306,0.8063456420228281,0.16636601427059386,1112818.4280687496,8432.69504757411,1121251.1231163237,2030,0,862.3417085427136,62,137,39,31.950456000674,0.6589381720430108,38.32671957671957,8505.403580133701,137.1839287118339,0
2032,32.2626682265543,0,1,197,0.0,0.005050505050505051,0.9949494949494949,198,5050,3400,1650,0.6732673267326733,67,34,33,241.6715222458606,0.43830543164299507,0.8040815253854741,0.16552219353820263,1105450.7143902408,8781.191382892743,1114231.9057731335,2031,1,865.510101010101,64,134,38,31.89470462197735,0.65869140625,38.22115384615385,8445.68406219174,131.96381347174594,0
2033,32.56709136249949,0,0,197,0.0,0.0,1.0,197,5800,4200,1600,0.7241379310344828,74,42,32,239.64304068102922,0.437700714803688,0.8016224569971517,0.16496704878403345,1117320.655987562,8351.623883316359,1125672.2798708782,2032,2,870.730964467005,65,132,38,31.775007029382824,0.659775641025641,38.052398989899,8530.871454283537,131.24417621974672,0
2034,32.33063113552253,0,0,197,0.0,0.0,1.0,197,6400,4900,1500,0.765625,79,49,30,243.1630105506252,0.43747841776304436,0.8063642335181929,0.16845582103141493,1110990.3468482227,8230.351486459414,1119220.698334682,2033,3,871.730964467005,66,131,35,31.467327916814934,0.661300505050505,37.842039800995025,8475.732310435023,128.42018652174278,0
2035,32.38799215721621,0,1,196,0.0,0.005076142131979695,0.9949238578680203,197,5800,3900,1900,0.6724137931034483,77,39,38,241.42675012346436,0.43750431644739113,0.8058475686960076,0.16797847388720324,1114175.1081702402,8598.335086799914,1122773.44325704,2034,4,872.730964467005,67,130,37,31.366497790496194,0.662157960199005,37.699142156862735,8495.39812665459,126.79698696499389,0
2036,31.91590634248362,0,0,196,0.0,0.0,1.0,196,5450,4100,1350,0.7522935779816514,68,41,27,244.29281391402608,0.43734301412872845,0.8067372305119529,0.1702213520528448,1098338.2909740559,9013.230346314926,1107351.5213203707,2035,5,876.3265306122449,68,128,38,31.2419678137108,0.6620710784313726,37.65096618357488,8373.107192326099,123.13392929891322,0
2037,32.41239156821434,0,1,195,0.0,0.00510204081632653,0.9948979591836735,196,5250,3800,1450,0.7238095238095238,67,38,29,245.66188590109078,0.43720020059305775,0.807725880434438,0.17156852401039163,1116066.0413605806,10384.977702160775,1126451.0190627414,2036,6,877.3265306122449,68,128,40,31.128712918752015,0.6628370098039216,37.575483091787426,8505.806199128441,125.0853852813006,0
2038,32.121999444806846,0,1,194,0.0,0.005128205128205128,0.9948717948717949,195,5800,4000,1800,0.6896551724137931,76,40,36,247.5223729346708,0.43652304167768086,0.808150564316017,0.17362700758410113,1107279.2950396938,10015.279721930865,1117294.5747616247,2037,7,882.5794871794872,60,135,41,30.932540972944857,0.6694444444444445,37.431693989071036,8434.21897990693,140.57031633178215,0
2039,32.31685560769671,0,0,194,0.0,0.0,1.0,194,5150,3600,1550,0.6990291262135923,67,36,31,246.66376473225301,0.43614623951711984,0.8062535773572261,0.17353855476246985,1114819.7489103044,11047.127252816088,1125866.8761631204,2038,8,887.9381443298969,62,132,41,30.855653825170986,0.669018817204301,37.33465608465608,8488.517992458166,136.9115805235188,0
2040,31.822612629419336,0,0,194,0.0,0.0,1.0,194,5200,3800,1400,0.7307692307692307,66,38,28,244.85076034408462,0.4358702571087727,0.8044016267482894,0.17274410785721217,1098531.40347549,9795.249880565621,1108326.6533560555,2039,9,888.9381443298969,64,130,41,30.809979059933323,0.6686197916666667,37.243589743589745,8361.595459486529,130.649929054477,0
2041,32.16736435860805,0,2,192,0.0,0.010309278350515464,0.9896907216494846,194,5950,3900,2050,0.6554621848739496,80,39,41,240.80938486532926,0.43560707227178036,0.8006872852233671,0.1704739704739703,1111372.7862936142,8775.799404686328,1120148.5856983005,2040,10,889.9381443298969,67,127,40,30.802253302253263,0.667910447761194,37.13235294117646,8455.759381031134,126.20536389598708,0
2042,32.36739574957254,0,0,192,0.0,0.0,1.0,192,5250,3700,1550,0.7047619047619048,68,37,31,242.86183337254616,0.4347401741564863,0.7996218249098153,0.17262257038208806,1119400.2069793919,10721.917308924574,1130122.1242883164,2041,11,898.2864583333334,70,122,42,30.613935996132223,0.6675595238095238,37.001173708920184,8512.587092236456,121.60838703194936,0
2043,31.897040764398596,0,1,191,0.0,0.005208333333333333,0.9947916666666666,192,4550,3100,1450,0.6813186813186813,60,31,29,242.41438463218174,0.4343584115037813,0.8006207947659945,0.17292997509918587,1104118.190723057,10580.826353065273,1114699.017076122,2042,12,899.2864583333334,70,122,40,30.50548771421135,0.66875,36.883802816901394,8392.628067322801,119.89468667604001,0
2044,31.444583054546058,0,2,189,0.0,0.010471204188481676,0.9895287958115183,191,5800,4100,1700,0.7068965517241379,75,41,34,241.70617487226252,0.4342174152659135,0.798860031181637,0.1727653055835487,1088984.087049525,8642.835635500569,1097626.9226850255,2043,13,904.4083769633507,71,120,36,30.458800597365,0.6688673708920188,36.82002314814814,8275.58464041154,116.55753014664141,0
2045,31.03150675219755,0,0,189,0.0,0.0,1.0,189,5100,3000,2100,0.5882352941176471,72,30,42,242.48517538664316,0.43347663139329806,0.7960107127085694,0.1738290622942268,1075448.23221234,9256.050641452817,1084704.282853793,2044,14,905.7407407407408,73,116,36,30.341778948118822,0.6688070776255708,36.72578828828828,8169.795478411445,111.91500655358145,0
2046,31.389091732919034,0,2,187,0.0,0.010582010582010581,0.9894179894179894,189,4550,3400,1150,0.7472527472527473,57,34,23,242.77445666532304,0.43325851814326993,0.7961391811287579,0.1743409505120226,1088306.2932249983,10492.593804630043,1098798.8870296283,2045,15,906.7407407407408,73,116,36,30.27648963845975,0.6693778538812785,36.669481981981974,8265.705786144637,113.22884638554298,0
2047,31.8774686525877,0,0,187,0.0,0.0,1.0,187,4800,3100,1700,0.6458333333333334,65,31,34,221.66576436609643,0.43273340616794126,0.7746594825100488,0.15655315717169097,1100715.2537229022,6598.177613181621,1107313.4313360837,2046,16,901.0160427807486,67,120,44,31.38376809482172,0.6671330845771144,37.20894607843136,8377.113583565264,125.03154602336215,8
2048,31.693670890293003,0,0,187,0.0,0.0,1.0,187,5100,3200,1900,0.6274509803921569,70,32,38,218.66714399965895,0.4323764207540299,0.7707308397789832,0.15507455036081821,1095488.6046229654,5409.472891414951,1100898.0775143804,2047,17,902.0160427807486,70,117,42,31.325214366757805,0.6668154761904762,37.07453051643191,8333.073298487956,119.04390426411366,0
2049,31.776452139146894,0,0,187,0.0,0.0,1.0,187,5600,4000,1600,0.7142857142857143,72,40,32,217.01061100315337,0.43223626205125254,0.7689615823507032,0.15417816893505826,1098840.2924632556,4692.0006524669,1103532.2931157225,2048,18,903.0160427807486,70,117,42,31.308809855880973,0.6674107142857143,37.01584507042253,8356.703412473697,119.38147732105281,0
2050,31.51072836289609,0,0,187,0.0,0.0,1.0,187,5200,3500,1700,0.6730769230769231,69,35,34,218.0050125219732,0.4321368332279148,0.770234866676375,0.15546477256956143,1090655.5549713294,4953.675583736942,1095609.2305550664,2049,19,904.0160427807486,73,114,43,31.158879942218192,0.6670947488584476,36.89470720720721,8290.639412033946,113.5704029045746,0
2051,31.868382253334286,0,1,186,0.0,0.0053475935828877,0.9946524064171123,187,5100,3900,1200,0.7647058823529411,63,39,24,215.9448284381653,0.43179302512793977,0.7681095122141215,0.154288182852427,1103549.4060789663,5161.157433752485,1108710.5635127188,2050,20,905.0160427807486,74,113,40,31.150385264935608,0.6672297297297297,36.83333333333334,8386.695929669157,113.33372877931292,0
2052,32.04004212164565,0,1,185,0.0,0.005376344086021506,0.9946236559139785,186,4750,3600,1150,0.7578947368421053,59,36,23,215.74334748473336,0.4315890487261455,0.7671757776482702,0.15456107702869348,1110228.8404139194,5954.897300998618,1116183.737714918,2051,21,908.9408602150538,75,111,41,31.06663586192533,0.6676388888888889,36.74616228070175,8434.66404921118,112.46218732281574,0
2053,32.5334039840919,0,0,185,0.0,0.0,1.0,185,5850,4300,1550,0.7350427350427351,74,43,31,215.8927845056659,0.43047517626321974,0.7637468009592847,0.15506266391871304,1128027.4474880213,5856.597327401379,1133884.0448154227,2052,22,913.5837837837838,80,105,43,30.978862463577045,0.6662760416666667,36.664094650205755,8567.21339226142,107.09016740326774,0
2054,32.20710181097066,0,0,185,0.0,0.0,1.0,185,5900,4400,1500,0.7457627118644068,74,44,30,218.95919495644685,0.42997698785742267,0.7680643467132691,0.15783784303794726,1117704.7660762493,6046.347155807762,1123751.113232057,2053,23,914.5837837837838,81,104,43,30.778716026166457,0.6670524691358024,36.54725609756097,8485.049345245417,104.75369562031379,0
2055,32.36953127172359,0,1,184,0.0,0.005405405405405406,0.9945945945945946,185,4850,3200,1650,0.6597938144329897,65,32,33,218.0526841404028,0.42935761848805326,0.7678088410391097,0.1577718453877112,1124361.4854394568,7184.007968832828,1131545.4934082895,2054,24,915.5837837837838,67,118,45,30.68043124491457,0.6750621890547264,36.427696078431374,8531.711934149453,127.33898409178288,0
2056,31.86728223491572,0,1,183,0.0,0.005434782608695652,0.9945652173913043,184,5600,3800,1800,0.6785714285714286,74,38,36,220.00992621742682,0.4287340619307833,0.7666809369832635,0.15992682167453787,1108158.6719797293,6361.181531892329,1114519.8535116217,2055,25,921.3804347826087,69,115,44,30.477654892224354,0.6754227053140096,36.2797619047619,8404.04725844011,121.7977863542045,0
2057,31.745359537750737,0,1,182,0.0,0.00546448087431694,0.994535519125683,183,5150,3600,1550,0.6990291262135923,67,36,31,216.49566327877056,0.42826367621449585,0.7609760073451062,0.15792059662206617,1104846.546650196,6088.897187658564,1110935.4438378545,2056,26,926.3989071038251,71,112,46,30.457154346713466,0.6754694835680751,36.168981481481474,8375.410540081328,117.96352873353983,0
2058,31.638371719793255,0,0,182,0.0,0.0,1.0,182,5550,3500,2050,0.6306306306306306,76,35,41,214.3601557102802,0.427594332463117,0.7567889884385535,0.15699093484677737,1102185.9830663016,5302.951790356123,1107488.9348566576,2057,27,931.8351648351648,74,108,39,30.383451723230717,0.6752533783783784,36.041666666666664,8351.211868537092,112.85421443969042,0
2059,31.820641453398604,1,0,183,0.00546448087431694,0.0,1.0,183,4900,2900,2000,0.5918367346938775,69,29,40,209.85891458481365,0.4276706899657719,0.752278893573888,0.15426580583643495,1109523.0336579462,5068.659910061186,1114591.6935680073,2058,0,927.7377049180328,77,106,44,30.382278075587465,0.6750541125541125,35.924145299145295,8403.063088935673,109.13068946669705,0
2060,31.511344554408726,0,1,182,0.0,0.00546448087431694,0.994535519125683,183,4400,2600,1800,0.5909090909090909,62,26,36,212.5294613029751,0.4270701975620008,0.7554503416310496,0.15680810072135842,1099711.0597967892,5744.199825506954,1105455.259622296,2059,1,928.7377049180328,79,104,37,30.19241826844094,0.6753691983122363,35.80729166666666,8325.067461054055,105.38060077283615,0
2061,31.25095159362201,0,0,182,0.0,0.0,1.0,182,4650,3100,1550,0.6666666666666666,62,31,31,212.48316795108212,0.426772180397871,0.7532129703694519,0.15731102549461928,1091513.0418194742,5335.629797144659,1096848.6716166188,2060,2,923.5274725274726,80,102,39,30.08364960425586,0.6760416666666667,35.69958847736625,8259.639366668189,103.24549208335236,0
2062,31.43029443535858,0,0,182,0.0,0.0,1.0,182,5650,4300,1350,0.7610619469026548,70,43,27,212.07025112420934,0.4264755732297169,0.7538467275759022,0.1576052247243728,1098772.1656343797,4553.377818874886,1103325.5434532545,2061,3,924.5274725274726,82,100,41,29.97225386428719,0.6764481707317074,35.579819277108435,8310.804134771215,101.35126993623433,0
2063,31.08940340060873,0,0,182,0.0,0.0,1.0,182,5550,3800,1750,0.6846846846846847,73,38,35,213.1571137936263,0.425945601359966,0.7566929526673813,0.15905366800770865,1087894.191517941,4428.477195362941,1092322.668713304,2062,4,925.5274725274726,84,98,44,29.814433069285535,0.6769593253968254,35.45343137254902,8224.594990305644,97.91184512268624,0
2064,31.420550615588162,0,0,182,0.0,0.0,1.0,182,4000,2700,1300,0.675,53,27,26,219.54714942845175,0.42572362030234956,0.7619943761306045,0.15238373431412522,1080232.333141642,7032.38589233838,1087264.7190339803,2063,5,926.5274725274726,81,101,38,32.022494590317464,0.6545781893004115,37.779471544715435,8239.11338677551,101.71744921945074,8
2065,31.171295205705547,0,0,182,0.0,0.0,1.0,182,5300,3800,1500,0.7169811320754716,68,38,30,183.87309540992027,0.4254244834355332,0.7283670572969456,0.1244495725676539,1064813.275773596,-2541.8973899862203,1062271.3783836097,2064,6,927.5274725274726,80,102,43,33.812730627306294,0.646484375,38.618827160493844,8147.589699793833,101.8448712474229,8
2066,31.29396677618912,0,1,181,0.0,0.005494505494505495,0.9945054945054945,182,4650,3100,1550,0.6666666666666666,62,31,31,183.00333712396832,0.42498052132030034,0.7272971230679277,0.12425106160788185,1069868.5023711754,-1892.0987564503162,1067976.4036147252,2065,7,928.5274725274726,72,110,46,33.72783083219647,0.6511863425925926,38.513127853881294,8182.961489350285,113.65224290764284,0
2067,31.02407890733764,0,0,181,0.0,0.0,1.0,181,5000,3800,1200,0.76,62,38,24,186.5939818682353,0.42469434213218743,0.7309724064294889,0.12712105052361053,1061567.9329832816,-1583.5624722034509,1059984.370511078,2066,8,932.646408839779,72,109,44,33.51765486645216,0.65234375,38.39897260273973,8115.930916213208,112.72126272518344,0
2068,31.208812449821085,0,0,181,0.0,0.0,1.0,181,5200,3400,1800,0.6538461538461539,70,34,36,187.6473500829983,0.42426207284632694,0.7323079834058295,0.12805692067256938,1068355.1092461084,-1305.1989604671235,1067049.9102856414,2067,9,933.646408839779,72,109,44,33.4319499736416,0.6529224537037037,38.34189497716895,8166.038725633123,113.41720452268227,0
2069,31.595734211290193,0,1,180,0.0,0.0055248618784530384,0.994475138121547,181,5300,3600,1700,0.6792452830188679,70,36,34,186.3775048098749,0.42384131368938,0.7307572324862359,0.12778977796156876,1082898.4516363407,-1134.417724308436,1081764.0339120324,2068,10,934.646408839779,72,109,40,33.30528758811133,0.6545138888888888,38.18493150684931,8272.239316620313,114.89221273083768,0
2070,31.635364245618053,0,1,179,0.0,0.005555555555555556,0.9944444444444445,180,5050,3700,1350,0.7326732673267327,64,37,27,184.60351957900397,0.42342941754603763,0.7261279336291264,0.12690734847616764,1084983.2981212274,-991.6528964771296,1083991.6452247503,2069,39,940.7833333333333,74,106,47,33.26240476569267,0.654420045045045,38.09722222222222,8285.38977193916,111.9647266478265,0
2071,31.260679797449114,0,0,179,0.0,0.0,1.0,179,5300,3900,1400,0.7358490566037735,67,39,28,196.13948207229902,0.423177818927458,0.7283576087576356,0.12809937208446118,1057951.1452598865,401.1979378142728,1058352.3431977008,2070,40,945.0167597765363,90,89,37,34.73230523289921,0.6305555555555555,39.83516483516486,8132.929606644113,90.36588451826792,8
2072,30.868707879442137,0,0,179,0.0,0.0,1.0,179,5000,3500,1500,0.7,65,35,30,192.4624036526085,0.4228404264222794,0.7235176380584276,0.12612103007885334,1045617.1826393288,-551.6007457531705,1045065.5818935756,2071,41,946.0167597765363,91,88,38,34.70977611507453,0.6314102564102564,39.71920289855073,8034.531892353012,88.29155925662651,0
2073,30.92108657951865,0,1,178,0.0,0.00558659217877095,0.994413407821229,179,5500,4100,1400,0.7454545454545455,69,41,28,191.28276994462556,0.42294373653045425,0.7225776109247168,0.125719630191957,1048211.6948504772,-1199.032704129837,1047012.6621463473,2072,42,947.0167597765363,91,88,40,34.63662832833268,0.6324404761904762,39.617300724637694,8051.315988102287,88.4759998692559,0
2074,31.06119393931496,0,0,178,0.0,0.0,1.0,178,4650,2800,1850,0.6021505376344086,65,28,37,194.4330453087726,0.42273958399458306,0.7244592017734579,0.12826089068999683,1053982.7440991339,735.8149276180902,1054718.559026752,2073,43,953.0449438202247,78,100,39,34.425878591554024,0.6384882478632479,39.491033755274245,8091.719523457844,103.73999389048518,0
2075,31.404779374568285,0,0,178,0.0,0.0,1.0,178,4650,3500,1150,0.7526881720430108,58,35,23,192.60980023570104,0.42238449290082314,0.7216036394181606,0.12743185118434397,1066464.6472623989,832.3085335293445,1067296.9557959281,2074,44,954.0449438202247,80,98,40,34.37083641746855,0.638671875,39.39043209876541,8184.385982839785,102.30482478549732,0
2076,31.41348206469985,0,0,178,0.0,0.0,1.0,178,4350,3000,1350,0.6896551724137931,57,30,27,192.63421053031098,0.42179796440889566,0.7248997541788507,0.12797677761181406,1067918.5848699869,1193.5307014151758,1069112.115571402,2075,45,955.0449438202247,80,98,42,34.22601433550339,0.6401041666666667,39.24897119341562,8191.097766767625,102.38872208459532,0
2077,31.670619199645575,0,0,178,0.0,0.0,1.0,178,5450,4200,1250,0.7706422018348624,67,42,25,190.59689043633327,0.4218078831545314,0.7214605052907992,0.12729576509317403,1078149.9231503138,48.404555324015746,1078198.3277056378,2076,46,956.0449438202247,84,94,44,34.09535662846762,0.6403769841269842,39.06862745098037,8263.858137240804,98.379263538581,0
2078,31.709961863547203,0,0,178,0.0,0.0,1.0,178,5850,4500,1350,0.7692307692307693,72,45,27,187.80070298209574,0.42151164328487695,0.7181106934723271,0.12608022518289344,1080944.638247507,-849.5674104785498,1080095.0708370283,2077,47,957.0449438202247,88,90,38,33.98917850792651,0.6407433712121212,38.89279026217226,8279.699663083686,94.08749617140552,0
2079,31.363407504933967,0,0,178,0.0,0.0,1.0,178,4850,3400,1450,0.7010309278350515,63,34,29,185.01757113193997,0.4213225258680886,0.7144180492191015,0.12459934075204046,1069993.9259821773,-856.4645377699458,1069137.4614444072,2078,48,958.0449438202247,88,90,40,33.95456208740325,0.6418087121212122,38.78745318352058,8192.515551206849,93.09676762735056,0
2080,31.26238712430643,0,0,178,0.0,0.0,1.0,178,4550,3000,1550,0.6593406593406593,61,30,31,190.98204139663125,0.4208675860682621,0.7200353203143011,0.12898633257403183,1067339.5884678692,618.5386938065831,1067958.1271616758,2079,49,959.0449438202247,90,88,42,33.69993356112377,0.6421296296296296,38.690476190476176,8169.159492601458,90.76843880668287,0
2081,31.242885739358872,1,1,178,0.00558659217877095,0.00558659217877095,0.994413407821229,179,4900,3400,1500,0.6938775510204082,64,34,30,185.3717742164671,0.4211260017157324,0.7120693295383782,0.12594268462112904,1068304.1387254463,-1093.3132803336189,1067210.8254451128,2080,0,954.68156424581,81,98,43,33.643212215421464,0.6473765432098766,38.4908536585366,8170.300378943663,100.86790591288474,0
2082,31.476929089423383,0,0,178,0.0,0.0,1.0,178,5400,4200,1200,0.7777777777777778,66,42,24,182.25089287375025,0.4207948486002666,0.704359036644683,0.12430696359222866,1077384.4555655979,-1729.1442009739817,1075655.311364624,2081,1,950.3258426966293,85,93,43,33.59156790580686,0.6471813725490196,38.35998062015504,8235.624336974748,96.88969808205586,0
2083,31.55051846146519,0,0,178,0.0,0.0,1.0,178,4000,2400,1600,0.6,56,24,32,181.4940633680308,0.4204364512579615,0.7040933282161517,0.12401520345128678,1080403.2441100746,-382.64503009186,1080020.5990799828,2082,2,951.3258426966293,85,93,44,33.54970841432934,0.6477941176470587,38.29941860465117,8256.789024690157,97.13869440811949,0
2084,31.62972282471269,2,0,180,0.011111111111111112,0.0,1.0,180,5150,3300,1850,0.6407766990291263,70,33,37,179.26878227839936,0.4212251707014277,0.7043116133082221,0.1232159617244364,1084736.212746423,-2258.132009532999,1082478.08073689,2083,0,941.7444444444444,87,93,44,33.408709981167604,0.649066091954023,38.1036931818182,8283.707593475057,95.21502981005813,0
2085,31.899843195688213,0,1,179,0.0,0.005555555555555556,0.9944444444444445,180,5800,4200,1600,0.7241379310344828,74,42,32,183.52266319903566,0.42065810573142975,0.7108389411631875,0.126542873190271,1094885.764912044,-1612.729704925347,1093273.0352071186,2084,1,942.7444444444444,89,91,45,33.189348927272455,0.6494616104868913,37.997685185185205,8357.832759499988,93.90823325280886,0
2086,32.37162806107943,0,2,177,0.0,0.0111731843575419,0.9888268156424581,179,4600,3300,1300,0.717391304347826,59,33,26,184.71976121802288,0.4203047517418869,0.7139103193254988,0.1278300940505149,1112096.1305826914,685.226338544765,1112781.3569212363,2085,2,940.8994413407821,90,89,36,33.03583125900695,0.6503472222222222,37.87774725274728,8485.32407246639,94.28137858295989,0
2087,32.11625230842572,0,1,176,0.0,0.005649717514124294,0.9943502824858758,177,5400,3700,1700,0.6851851851851852,71,37,34,189.53767588093206,0.4200185113850368,0.7164973702955597,0.13158550879503664,1104215.5399306626,1058.0894220136206,1105273.6293526762,2086,3,944.9435028248588,91,86,37,32.801525618883154,0.6510989010989011,37.77173913043481,8421.788988486713,92.54713174161223,0
2088,32.32483581390592,0,1,175,0.0,0.005681818181818182,0.9943181818181818,176,3700,2600,1100,0.7027027027027027,48,26,22,189.08488144286946,0.4194568452380953,0.7152722836919723,0.13160329987163183,1112093.6720821706,3156.020027804885,1115249.6921099755,2087,4,943.3977272727273,93,83,39,32.72847049131849,0.6513216845878136,37.68838652482272,8479.179837665926,91.17397674909598,0
2089,32.64218422149069,0,1,174,0.0,0.005714285714285714,0.9942857142857143,175,5250,3500,1750,0.6666666666666666,70,35,35,190.85725093001673,0.4184564860426929,0.7183578307146474,0.13306054985333024,1123486.1039209259,2635.0938504847954,1126121.1977714107,2088,5,949.7657142857142,93,82,40,32.62551388184946,0.6518817204301075,37.63297872340427,8564.232642154448,92.08852303391879,0
2090,32.95337702767796,0,0,174,0.0,0.0,1.0,174,5000,3900,1100,0.78,61,39,22,172.92334934333883,0.4179269649857152,0.6904676564662755,0.11628638455841245,1123817.0726501595,-933.1575496216856,1122883.9151005377,2089,6,955.1781609195402,98,76,37,34.320148933027156,0.6382865646258503,38.83627946127945,8606.226548863555,87.81863825370975,8
2091,33.32699259707222,0,0,174,0.0,0.0,1.0,174,4750,3400,1350,0.7157894736842105,61,34,27,175.88863142270878,0.4176674307354993,0.6973521878152311,0.11857558592436668,1137291.3370304976,457.3233598391598,1137748.6603903368,2090,7,956.1781609195402,98,76,39,34.157050894787005,0.6391369047619048,38.75210437710437,8706.606683424907,88.84292534107048,0
2092,33.30674475107725,0,1,173,0.0,0.005747126436781609,0.9942528735632183,174,4900,3300,1600,0.673469387755102,65,33,32,178.99558691550143,0.41751171018536976,0.702999555321991,0.1209851312511264,1137365.250594083,1016.6721134764834,1138381.9227075595,2091,8,957.1781609195402,101,73,41,33.98642047674877,0.6392326732673268,38.66421568627449,8704.244262459757,86.1806362619778,0
2093,33.49648451725417,0,1,172,0.0,0.005780346820809248,0.9942196531791907,173,5150,3900,1250,0.7572815533980582,64,39,25,177.89983491968076,0.41663446027691897,0.7010797569162872,0.12061146730060984,1144742.113471704,979.8866024442709,1145722.0000741484,2092,9,963.6473988439307,103,70,43,33.91071565397286,0.6397653721682848,38.5616987179487,8757.264011111405,85.02198069040199,0
2094,33.008607257631354,0,1,171,0.0,0.005813953488372093,0.9941860465116279,172,4800,3500,1300,0.7291666666666666,61,35,26,176.2382985621183,0.4165278344439911,0.6961801990804799,0.11986965215517469,1129000.1071830916,594.6115932795583,1129594.718776371,2093,10,968.3953488372093,82,90,44,33.844369801663476,0.6473577235772358,38.453815261044184,8633.275291780108,105.28384502170863,0
2095,32.62092062652804,0,0,171,0.0,0.0,1.0,171,5100,3800,1300,0.7450980392156863,64,38,26,177.46616841312908,0.41605750487329435,0.6965800827487949,0.12130691239805401,1117161.0695756273,351.65890358001843,1117512.7284792073,2094,11,969.2631578947369,85,86,42,33.64279130220144,0.6479166666666667,38.28730620155039,8537.309011354078,100.4389295453421,0
2096,32.24133768636762,0,0,171,0.0,0.0,1.0,171,4550,3300,1250,0.7252747252747253,58,33,25,178.07222291303668,0.41625243664717354,0.6952407538634422,0.12225630766382442,1105396.2365906397,618.073009880065,1106014.3096005197,2095,12,970.2631578947369,90,81,41,33.478044675642586,0.6476851851851853,38.14102564102564,8442.683618513576,93.80759576126196,0
2097,32.399795012042006,0,0,171,0.0,0.0,1.0,171,4650,3300,1350,0.7096774193548387,60,33,27,178.76322337253106,0.41623237014103887,0.696100689498959,0.12323756433559947,1111991.5358510073,906.6382623396184,1112898.174113347,2096,13,971.2631578947369,92,79,43,33.3205078876491,0.6484375,38.00403225806453,8488.61564882031,92.26756140022077,0
2098,31.99370914626184,0,1,170,0.0,0.005847953216374269,0.9941520467836258,171,5650,3800,1850,0.672566371681416,75,38,37,178.19466979210569,0.4159557390207545,0.6955715581112674,0.1233738769394692,1099246.4787367454,-674.027340274105,1098572.4513964714,2097,14,972.2631578947369,94,77,37,33.190679856666804,0.6492686170212766,37.86184210526316,8386.771979821073,89.22097850873482,0
2099,32.32358835670978,0,1,169,0.0,0.0058823529411764705,0.9941176470588236,170,4800,3500,1300,0.7291666666666666,61,35,26,174.24549969761318,0.41536358626290754,0.6859734684490648,0.12112993883206834,1111716.0514986895,-57.69621695053547,1111658.355281739,2098,15,977.8470588235294,95,75,38,33.15789065408965,0.6503289473684211,37.72786458333334,8477.576542643601,89.23764781730107,0
2100,31.89354475512547,0,0,169,0.0,0.0,1.0,169,4950,3700,1250,0.7474747474747475,62,37,25,177.93818503918538,0.4149936601859679,0.6907597443313367,0.12404453547140791,1097698.8607194235,314.5085991992087,1098013.3693186226,2099,16,984.0650887573964,99,70,38,32.9669488889771,0.6501473063973064,37.63541666666667,8367.736580701525,84.52259172425782,0
2101,32.3185842862422,0,0,169,0.0,0.0,1.0,169,3800,2600,1200,0.6842105263157895,50,26,24,185.77480868305847,0.4148058138442754,0.7094451295285975,0.12712222430773518,1107109.2074880044,3534.6002424673543,1110643.8077304717,2100,17,985.0650887573964,78,91,43,33.38895605595016,0.6510416666666667,38.25158227848102,8459.338299923455,108.45305512722378,8
2102,32.094067293260316,0,0,169,0.0,0.0,1.0,169,4250,2800,1450,0.6588235294117647,57,28,29,190.8027642717464,0.4149965952850568,0.7112973700189298,0.12003667575070706,1075239.1856609418,2981.7217754820795,1078220.907436424,2101,18,986.0650887573964,81,88,44,36.2068242790074,0.6204989711934157,41.14583333333336,8307.683044140878,102.5639881992701,8
2103,31.90925970197947,0,0,169,0.0,0.0,1.0,169,4500,2800,1700,0.6222222222222222,62,28,34,190.501747165252,0.41438609467455617,0.7122708276408842,0.12040804210779868,1070414.5801538308,2483.169542093089,1072897.7496959239,2102,19,987.0650887573964,84,85,36,36.04602337244512,0.621031746031746,40.98039215686276,8265.123934571593,98.39433255442373,0
2104,31.72902724597566,4,0,173,0.023121387283236993,0.0,1.0,173,4750,3400,1350,0.7157894736842105,61,34,27,188.5453460428045,0.416540641663306,0.7165772918262621,0.12037895170425297,1067291.3510621483,896.5634229012862,1068187.9144850497,2103,0,965.2196531791908,89,84,43,35.73460508701473,0.6228932584269663,40.62500000000002,8229.716441924998,92.46872406657302,0
2105,32.08151336009728,0,0,173,0.0,0.0,1.0,173,4650,3200,1450,0.6881720430107527,61,32,29,186.45629033900312,0.4164468230496931,0.7146238104492169,0.11959759044312154,1080499.4291271328,1043.183053691047,1081542.6121808237,2104,1,966.2196531791908,76,97,42,35.62342541916429,0.6295230263157895,40.46266233766233,8326.350565658342,109.55724428497818,0
2106,31.923394320896065,1,0,174,0.005747126436781609,0.0,1.0,174,4450,3400,1050,0.7640449438202247,55,34,21,182.52572704958024,0.41705769827032535,0.7092029156264692,0.1176108657319469,1076493.1403266864,47.53862040286003,1076540.6789470892,2105,0,961.6609195402299,80,94,45,35.56336865735695,0.6294270833333333,40.30349794238683,8290.39383894257,103.62992298678212,0
2107,31.636195761013763,0,1,173,0.0,0.005747126436781609,0.9942528735632183,174,4400,2900,1500,0.6590909090909091,59,29,30,214.78681446547398,0.41661752818195913,0.75223931569835,0.13736585925866004,1064657.200750166,6534.865729371384,1071192.0664795374,2106,1,962.6609195402299,69,105,40,34.993164697334706,0.6319444444444444,40.56547619047619,8207.521382403484,118.9495852522244,8
2108,31.441251891546923,1,1,173,0.005747126436781609,0.005747126436781609,0.9942528735632183,174,4850,3500,1350,0.7216494845360825,62,35,27,213.207674725082,0.4163088554470356,0.7508596490202311,0.13692498689331642,1059286.9592933145,5519.621891505863,1064806.5811848203,2107,0,963.6379310344828,70,104,41,34.88514761016597,0.6328869047619048,40.41960093896713,8161.532712986187,116.59332447123124,0
2109,31.749457899042973,1,0,174,0.005747126436781609,0.0,1.0,174,4100,2900,1200,0.7073170731707317,53,29,24,210.7060116460774,0.41619604455960846,0.7448860007169888,0.13585124922359684,1070802.2120243479,6224.892671489349,1077027.1046958372,2108,0,964.6206896551724,75,99,40,34.80993939873696,0.6318055555555555,40.28234649122806,8245.894705714963,109.94526274286618,0
2110,32.11703980193467,0,0,174,0.0,0.0,1.0,174,4100,2800,1300,0.6829268292682927,54,28,26,209.85223104582664,0.41605693420149276,0.7437036853219336,0.13563007650383713,1083906.1136473238,6592.023238620297,1090498.136885944,2109,1,965.6206896551724,77,97,43,34.74563928583666,0.6317640692640693,40.19764957264956,8344.08242931136,108.3647068741735,0
2111,32.20367741056741,0,0,174,0.0,0.0,1.0,174,4750,3200,1550,0.6736842105263158,63,32,31,207.45757078359514,0.41608392576351516,0.7387367811096623,0.13446756911916996,1087664.8089877008,5578.85981987843,1093243.6688075792,2110,2,966.6206896551724,82,92,42,34.70602556054535,0.6307164634146342,40.09789156626507,8369.803658326331,102.07077632105282,0
2112,32.420238709744915,0,0,174,0.0,0.0,1.0,174,5000,3700,1300,0.74,63,37,26,210.26871315359932,0.41557662281575974,0.7442114126066814,0.13698203529336833,1096460.0579105075,6310.249080232776,1102770.3069907404,2111,3,967.6206896551724,82,92,34,34.45356608599141,0.6324949186991871,39.92218875502009,8431.784723670246,102.82664297158836,0
2113,32.66740724307193,0,0,174,0.0,0.0,1.0,174,6100,5200,900,0.8524590163934426,70,52,18,206.97672320867332,0.41552333178304873,0.739632361417107,0.13563648948562212,1106553.6709941642,4906.170575380082,1111459.8415695443,2112,4,968.6206896551724,84,90,39,34.330908548738975,0.6338045634920635,39.71813725490196,8502.733608279468,101.22301914618414,0
2114,32.962121209810654,0,1,173,0.0,0.005747126436781609,0.9942528735632183,174,5150,3900,1250,0.7572815533980582,64,39,25,208.16263076944796,0.4154658882023343,0.741101307865796,0.13676061010767024,1117287.0576162806,6565.482647612388,1123852.540263893,2113,5,969.6206896551724,87,87,39,34.21076559374431,0.6336206896551724,39.630681818181834,8582.325025224894,98.64741408304477,0
2115,33.2322293841537,0,0,173,0.0,0.0,1.0,173,4800,3300,1500,0.6875,63,33,30,210.87877714769877,0.414732883003988,0.7445229859920581,0.13879367334016035,1126975.890166663,8131.059518656999,1135106.94968532,2114,7,976.1965317919075,72,101,40,34.077128193888925,0.6404803240740741,39.569063926940636,8654.700606309765,120.20417508763563,0
2116,32.871765682830414,0,0,173,0.0,0.0,1.0,173,4850,3400,1450,0.7010309278350515,63,34,29,201.99477693820987,0.4147062777255008,0.7381092914302525,0.1312752825492161,1111017.5575203549,5433.948741151569,1116451.5062615064,2115,8,977.1965317919075,73,100,49,34.75388016603498,0.6355593607305936,40.00563063063061,8546.473988765132,117.07498614746757,8
2117,32.388502107642026,0,1,172,0.0,0.005780346820809248,0.9942196531791907,173,6050,4700,1350,0.7768595041322314,74,47,27,202.1170227984376,0.41450323744230855,0.7393301049961092,0.13193178372077166,1095962.0593766123,3652.517708248774,1099614.577084861,2116,9,978.1965317919075,76,97,42,34.595900502686796,0.6356907894736843,39.85389610389608,8425.742634333768,110.86503466228642,0
2118,32.585665032385364,0,0,172,0.0,0.0,1.0,172,4450,2600,1850,0.5842696629213483,63,26,37,195.96106131715499,0.41427818577451375,0.7270343102915997,0.129287429726552,1105753.5876462727,4486.929318083029,1110240.5169643557,2117,10,983.7209302325581,74,98,42,34.38105329565852,0.6403434684684685,39.48611111111111,8489.018319617384,114.7164637786133,8
2119,32.84987204554758,0,0,172,0.0,0.0,1.0,172,4700,3300,1400,0.7021276595744681,61,33,28,194.79792057026089,0.41416627000317335,0.7253694340278023,0.128875701521327,1115529.385670521,4360.560932727594,1119889.9466032486,2118,11,984.7209302325581,75,97,41,34.31484695487533,0.6408333333333334,39.39144736842105,8560.957607922712,114.1461014389695,0
2120,32.9079470719906,0,0,172,0.0,0.0,1.0,172,4000,2500,1500,0.625,55,25,30,194.87039286168238,0.4142278945101772,0.7252003106810925,0.12930862710556598,1118375.7455802618,5187.664181640348,1123563.4097619022,2119,12,985.7209302325581,77,95,43,34.209054741658974,0.6409632034632035,39.2895299145299,8579.446350686405,111.42138117774552,0
2121,32.939184835346005,0,0,172,0.0,0.0,1.0,172,5850,4500,1350,0.7692307692307693,72,45,27,193.02399943817898,0.4138623974341538,0.7223924262355581,0.12873758378370864,1120928.7576862636,3023.2303787743626,1123951.988065038,2120,13,986.7209302325581,77,95,41,34.0802299291869,0.6427218614718615,39.1159188034188,8593.3089711336,111.60141520952727,0
2122,33.13059349991333,1,0,173,0.005780346820809248,0.0,1.0,173,4750,3100,1650,0.6526315789473685,64,31,33,190.32756657984308,0.4139123202043285,0.720032608432235,0.12750980831069877,1128759.2900594177,3616.801786280034,1132376.0918456977,2121,0,982.0115606936416,78,95,44,33.99536545941306,0.6438301282051282,38.963607594936704,8648.290605456003,110.87552058276927,0
2123,32.60482758925019,0,2,171,0.0,0.011560693641618497,0.9884393063583815,173,4550,3400,1150,0.7472527472527473,57,34,23,190.34219144512622,0.4138255029797912,0.7208901780217691,0.1279324058855044,1111778.098063093,3173.655917204707,1114951.7539802976,2122,1,983.0115606936416,79,94,40,33.883459646323615,0.6445147679324894,38.854166666666664,8514.614871484398,107.779935082081,0
2124,32.31223122993588,0,0,171,0.0,0.0,1.0,171,3750,2200,1550,0.5866666666666667,53,22,31,198.63846791570717,0.4130604288499025,0.7247509921621917,0.12660210786434978,1086395.5088928053,5209.987887394906,1091605.4967802002,2123,16,992.7894736842105,84,87,37,35.53530639571519,0.6240079365079365,40.68627450980396,8379.005059135437,99.75006022780283,7
2125,32.36719343980581,0,0,171,0.0,0.0,1.0,171,4500,3200,1300,0.7111111111111111,58,32,26,200.21014829615913,0.412583132668272,0.7272734195771582,0.12803168053775874,1089230.5473573247,4915.001883023234,1094145.549240348,2124,17,993.7894736842105,73,98,39,35.3746156628685,0.629851598173516,40.56869369369369,8397.063275557717,115.02826404873585,0
2126,31.886601839192164,1,0,172,0.005813953488372093,0.0,1.0,172,4000,2800,1200,0.7,52,28,24,201.7385053623804,0.4137646482161476,0.7296569957781449,0.12950928184924565,1074179.3938880851,4940.669082809817,1079120.0629708949,2125,0,989.0058139534884,75,97,39,35.19665047347485,0.6302777777777777,40.433114035087705,8276.705943402123,110.35607924536164,0
2127,31.826035904510853,0,0,172,0.0,0.0,1.0,172,3750,2500,1250,0.6666666666666666,50,25,25,200.8368734413676,0.41358969128246975,0.7286920921395188,0.1293864753857046,1073158.3580471736,4955.953867532968,1078114.3119147066,2126,1,990.0058139534884,75,97,42,35.094221160781835,0.6315277777777778,40.30975877192981,8264.910941375603,110.1988125516747,0
2128,31.81003684267939,0,1,171,0.0,0.005813953488372093,0.9941860465116279,172,4450,3000,1450,0.6741573033707865,59,30,29,196.505234918736,0.41306340382610274,0.7232721256466434,0.1273456002914919,1074317.8960318973,3371.8181074297945,1077689.7141393272,2127,2,991.0058139534884,77,95,42,34.99707748830994,0.632711038961039,40.10416666666665,8267.296033592154,107.36748095574227,0
2129,32.260769980497074,0,0,171,0.0,0.0,1.0,171,4700,3600,1100,0.7659574468085106,58,36,22,198.2031579392072,0.41290276344455906,0.7240957677592392,0.12886145965721088,1090480.3855291554,4327.331216528339,1094807.7167456837,2128,3,997.6608187134503,78,93,47,34.8386496948797,0.6334134615384616,39.992088607594916,8388.055422539797,107.53917208384355,0
2130,32.02862585466803,0,0,171,0.0,0.0,1.0,171,4550,3300,1250,0.7252747252747253,58,33,25,196.13651997630072,0.41275513129228303,0.7219559330443195,0.1278870810135601,1083467.3101940064,3751.5015459068586,1087218.8117399132,2129,4,998.6608187134503,80,91,38,34.7903070305547,0.63359375,39.89197530864195,8330.902604636205,104.13628255795257,0
2131,32.44522933526473,1,0,172,0.005813953488372093,0.0,1.0,172,4500,2600,1900,0.5777777777777777,64,26,38,194.56109366672234,0.41363148261480576,0.7232291542355018,0.12759099075562905,1099234.7594335885,3873.6633983747947,1103108.4228319633,2130,0,993.8488372093024,84,88,44,34.62907819782494,0.6340525793650793,39.69362745098037,8445.69995478375,100.54404708075893,0
2132,32.4416135628569,0,0,172,0.0,0.0,1.0,172,3600,2400,1200,0.6666666666666666,48,24,24,195.0214499203819,0.41364210752980646,0.7242393180542053,0.12816643199685485,1099733.2839775183,4894.315913399258,1104627.5998909175,2131,1,994.8488372093024,84,88,44,34.542131438163786,0.634796626984127,39.620098039215655,8447.144158946248,100.56123998745534,0
2133,32.44066846824812,0,0,172,0.0,0.0,1.0,172,3950,3100,850,0.7848101265822784,48,31,17,195.4130902508884,0.41330777687111836,0.7257217581306281,0.12872610728103978,1100383.6824104963,4655.875168297467,1105039.5575787937,2132,2,995.8488372093024,70,102,47,34.449576597382624,0.6418154761904762,39.539319248826295,8449.518593263047,120.70740847518638,0
2134,32.23202547209938,0,0,172,0.0,0.0,1.0,172,5400,4100,1300,0.7592592592592593,67,41,26,209.84951135942129,0.41310732014143886,0.743632595185324,0.13552005513651189,1087553.8800216957,5844.530059919147,1093398.410081615,2133,3,996.8488372093024,72,100,38,34.77410052183466,0.6338252314814814,40.22545662100457,8373.059699194775,116.29249582214965,8
2135,31.796093730235174,1,0,173,0.005780346820809248,0.0,1.0,173,4600,2800,1800,0.6086956521739131,64,28,36,209.56699208666316,0.41347263297038134,0.7439877104316783,0.13600054867871,1074248.7402405608,5825.415449020407,1080074.1556895813,2134,0,992.0809248554913,74,99,43,34.60797802236942,0.634572072072072,40.055555555555564,8265.217920209487,111.69213405688495,0
2136,31.8854509572121,1,2,172,0.005747126436781609,0.011494252873563218,0.9885057471264368,174,5150,4100,1050,0.7961165048543689,62,41,21,205.6652572583617,0.4144554348548269,0.7409296808108636,0.1339332285072747,1078266.635372652,4402.396991404923,1082669.032364057,2135,0,987.3735632183908,76,98,33,34.58643275766403,0.6348684210526316,39.935064935064936,8292.28773270354,109.10904911452026,0
2137,31.772853009841004,0,0,172,0.0,0.0,1.0,172,5250,3400,1850,0.6476190476190476,71,34,37,208.70502539819455,0.41338285960378984,0.7439003225506062,0.1361787897313156,1075017.9115728335,5222.328107664343,1080240.239680498,2136,6,999.8488372093024,76,96,37,34.438326659386014,0.6355537280701755,39.867424242424235,8265.154092616762,108.75202753443108,0
2138,31.684905716649173,0,0,172,0.0,0.0,1.0,172,4350,3200,1150,0.735632183908046,55,32,23,206.5496459866449,0.41307544539643687,0.7413097458748941,0.13519549301956757,1072934.467557915,5572.846888191354,1078507.3144461063,2137,7,1000.8488372093024,76,96,38,34.38393460518792,0.6366502192982456,39.759199134199136,8245.705239058178,108.49612156655496,0
2139,32.1660747873727,0,1,171,0.0,0.005813953488372093,0.9941860465116279,172,5400,4400,1000,0.8148148148148148,64,44,20,206.39999999999944,0.412964237952763,0.7431627906976732,0.13578947368421057,1090700.7781091577,5224.128120346011,1095924.9062295037,2138,8,1001.8488372093024,76,96,42,34.20833333333332,0.6384320175438596,39.58333333333334,8376.581975878333,110.21818389313596,0
2140,32.08175465438713,0,0,171,0.0,0.0,1.0,171,4800,3200,1600,0.6666666666666666,64,32,32,227.3744606957627,0.4121646026831785,0.7655008258559868,0.1414073981729257,1071421.6004101825,9722.781714211531,1081144.382124394,2139,9,1007.2748538011696,65,106,39,35.679834605597954,0.624198717948718,41.556186868686886,8291.331004823105,127.55893853574008,8
2141,32.560068684579704,1,0,172,0.005813953488372093,0.0,1.0,172,5450,4400,1050,0.8073394495412844,65,44,21,222.24999016870757,0.4127489063420826,0.7610377462014255,0.13883034971789365,1088720.3892777073,8543.619162688432,1097264.0084403958,2140,0,1002.4127906976744,69,103,41,35.65139831971459,0.6234903381642511,41.398809523809526,8420.072523818844,122.0300365770847,0
2142,32.976233812824894,2,0,174,0.011494252873563218,0.0,1.0,174,5250,4200,1050,0.8,63,42,21,223.56409559453866,0.414081705534516,0.7650939004539594,0.14098256902507858,1105515.2475890578,9380.703298644097,1114895.950887702,2141,0,991.8793103448276,73,101,44,35.272435897435905,0.6248573059360731,41.061373873873876,8538.820678306787,116.97014627817516,0
2143,33.12922706900781,0,0,174,0.0,0.0,1.0,174,5400,3800,1600,0.7037037037037037,70,38,32,220.97562365388123,0.41384570238965296,0.7623089468373552,0.13979062495368894,1111602.691816512,8927.419615897295,1120530.1114324094,2142,1,992.8793103448276,76,98,36,35.2252946193883,0.6245888157894737,40.94967532467532,8582.137028469013,112.92285563775017,0
2144,33.159527770277926,0,1,173,0.0,0.005747126436781609,0.9942528735632183,174,4400,2700,1700,0.6136363636363636,61,27,34,227.13433591578868,0.41384431820698514,0.7691219897932857,0.14418288957835274,1113665.491981938,11390.33439072957,1125055.8263726677,2143,2,993.8793103448276,76,98,38,34.941234297247455,0.6258223684210527,40.82792207792208,8594.023715137788,113.07925940970773,0
2145,33.54258276291975,0,1,172,0.0,0.005780346820809248,0.9942196531791907,173,4600,3300,1300,0.717391304347826,59,33,26,228.78790035492995,0.41311556212752615,0.7691429895069539,0.14568928991513383,1127492.3056091245,12391.319453329997,1139883.6250624545,2144,3,1000.6127167630058,78,95,39,34.78522511526986,0.6260683760683761,40.71729957805906,8697.011437896257,111.5001466396956,0
2146,33.11477745578612,0,0,172,0.0,0.0,1.0,172,4950,3500,1450,0.7070707070707071,64,35,29,228.89441205349345,0.4123501178657238,0.7685215099976885,0.14648495570731673,1114614.989028134,11675.828515920917,1126290.817544055,2145,4,1007.4069767441861,62,110,39,34.603486914776084,0.6364247311827957,40.54232804232802,8591.883066074628,138.57875913023594,0
2147,32.72864438891755,0,1,171,0.0,0.005813953488372093,0.9941860465116279,172,5250,3900,1350,0.7428571428571429,66,39,27,229.75739513132794,0.4124004091300603,0.7682129466648977,0.14744230101244563,1102436.531575699,11008.589158489518,1113445.1207341887,2146,5,1008.4069767441861,63,109,38,34.48251761041782,0.6367394179894179,40.44596354166665,8494.8517589529,134.8389168087762,0
2148,32.41807119020189,0,1,170,0.0,0.005847953216374269,0.9941520467836258,171,4450,3300,1150,0.7415730337078652,56,33,23,229.28110420265898,0.41193670450636394,0.7662916155637323,0.1474462143914676,1092593.5776800374,11452.21238704256,1104045.79006708,2147,6,1005.1052631578947,65,106,40,34.41970618034448,0.6362179487179487,40.37247474747475,8416.6235965723,129.48651687034308,0
2149,32.23542672898067,2,0,172,0.011627906976744186,0.0,1.0,172,4700,3500,1200,0.7446808510638298,59,35,24,220.8624225602774,0.41294227979509496,0.7572987597158176,0.14295171068847365,1088320.9637872204,8973.840917036261,1097294.8047042566,2148,0,999.8779069767442,71,101,40,34.40840571237678,0.6351232394366197,40.14756944444444,8376.45398552115,117.9782251481852,0
2150,32.23795183346956,1,0,173,0.005780346820809248,0.0,1.0,173,5800,4000,1800,0.6896551724137931,76,40,36,217.83266118100423,0.41287891517677106,0.7546855072555734,0.1415446179285982,1089547.0906531177,7067.788447797816,1096614.8791009155,2149,0,995.0924855491329,72,101,42,34.34801500182948,0.6359953703703703,40.01141552511415,8381.499463553293,116.40971477157352,0
2151,31.882800511641797,0,2,171,0.0,0.011560693641618497,0.9884393063583815,173,5150,3600,1550,0.6990291262135923,67,36,31,217.44470547735696,0.4130469485145853,0.7545506738523375,0.14160348726451116,1078175.4897501846,7138.710364326976,1085314.2001145117,2150,1,996.0924855491329,73,100,35,34.28027740189446,0.6362728310502284,39.93524774774776,8291.592616168133,113.58346049545388,0
2152,31.858228199876727,0,1,170,0.0,0.005847953216374269,0.9941520467836258,171,4250,2800,1450,0.6588235294117647,57,28,29,221.00513268829974,0.4123165348010549,0.7550803926851244,0.14434466312720384,1078184.707312797,9206.870860431916,1087391.5781732288,2151,3,1007.2982456140351,78,93,36,34.08405554710859,0.6350160256410257,39.83386075949366,8288.432233804928,106.2619517154478,0
2153,32.255625040429415,0,0,170,0.0,0.0,1.0,170,4800,3100,1700,0.6458333333333334,65,31,34,220.2911197433134,0.41150873071121935,0.7531775171150752,0.14411868115117782,1092117.5343091483,9316.758904853505,1101434.293214002,2152,4,1014.2058823529412,80,90,37,34.04373610081541,0.634765625,39.77623456790122,8393.680204386397,104.92100255482997,0
2154,32.087825741997634,0,0,170,0.0,0.0,1.0,170,4800,3500,1300,0.7291666666666666,61,35,26,221.84117396669646,0.4111338322311173,0.7562101585717225,0.1456289023026943,1087418.335300822,9446.832019208832,1096865.167320031,2153,5,1015.2058823529412,82,88,39,33.88319112353775,0.6351626016260163,39.658634538152604,8353.788368373458,101.87546790699339,0
2155,31.972835524586095,0,0,170,0.0,0.0,1.0,170,3700,2300,1400,0.6216216216216216,51,23,28,220.79999999999941,0.41076618517229374,0.755294117647058,0.14526315789473687,1084148.3399992604,10175.990694367347,1094324.3306936277,2154,6,1016.2058823529412,76,94,41,33.83333333333332,0.6384320175438596,39.58333333333334,8326.25925119432,109.55604277887264,0
2156,32.009755054733674,0,0,170,0.0,0.0,1.0,170,4750,3400,1350,0.7157894736842105,61,34,27,217.4676871858726,0.4104645260471052,0.7514268770257984,0.1436385309277065,1086533.1099344715,8507.168493664534,1095040.2784281361,2155,7,1017.2058823529412,68,102,41,33.78128802363987,0.6438419117647058,39.44746376811594,8340.222863672217,122.65033623047378,0
2157,32.29132005374399,0,0,170,0.0,0.0,1.0,170,4950,3700,1250,0.7474747474747475,62,37,25,228.30492950561103,0.4109416695672352,0.7574218724294735,0.14281439921977987,1080155.323561751,10370.957000175193,1090526.2805619263,2156,8,1018.2058823529412,71,99,38,35.4432356341127,0.6229460093896714,41.348379629629626,8352.202255799108,117.63665149012827,8
2158,32.160478969250924,1,0,171,0.005847953216374269,0.0,1.0,171,4900,3600,1300,0.7346938775510204,62,36,26,228.22816899198065,0.4118249054007568,0.7582945378830324,0.14344121177624108,1077175.1200237959,10068.341065349385,1087243.4610891452,2157,0,1013.2456140350877,74,97,41,35.273566765047825,0.623170045045045,41.18055555555554,8323.757299888735,112.48320675525318,0
2159,32.38277696123074,3,1,173,0.017241379310344827,0.005747126436781609,0.9942528735632183,174,4750,3600,1150,0.7578947368421053,59,36,23,222.76729153767278,0.4140394879631475,0.7572470989938558,0.1409206761571381,1086549.5589676844,8859.540474536781,1095409.0994422212,2158,0,996.7586206896551,79,95,38,35.179745748513,0.6232858649789029,40.95052083333333,8388.741505777145,106.1866013389512,0
2160,32.49046859964763,1,0,174,0.005747126436781609,0.0,1.0,174,5150,3300,1850,0.6407766990291263,70,33,37,224.75155060130493,0.41406924789050564,0.7605386797521154,0.14271086171451466,1091279.4675808651,9103.350495633162,1100382.8180764983,2159,0,997.7528735632184,80,94,39,34.99274337600475,0.62421875,40.8179012345679,8420.947841529034,105.26184801911293,0
2161,32.698007970500875,1,2,173,0.005714285714285714,0.011428571428571429,0.9885714285714285,175,5800,3900,1900,0.6724137931034483,77,39,38,221.09633220868324,0.4147222222222222,0.7595762197179301,0.14140813754857448,1100405.3627458923,7859.11792917634,1108264.4806750687,2160,0,993.0457142857143,67,108,41,34.82768461659581,0.6330845771144278,40.56372549019607,8483.049371758603,126.61267719042691,0
2162,32.61636028922018,0,0,173,0.0,0.0,1.0,173,4200,2800,1400,0.6666666666666666,56,28,28,217.14556944287432,0.41445982883003984,0.751486319674054,0.13955802643563472,1099098.3663457024,8932.868126773883,1108031.2344724764,2161,1,1001.1907514450867,71,102,41,34.75627879328282,0.6326291079812207,40.393518518518505,8467.418533416734,119.25941596361598,0
2163,32.95129080004329,0,0,173,0.0,0.0,1.0,173,4700,3300,1400,0.7021276595744681,61,33,28,218.1708787802063,0.4143996168839898,0.7505687334718123,0.1410195044389261,1112088.3811505674,9225.05987937501,1121313.4410299424,2162,2,1002.1907514450867,74,99,42,34.526243807690925,0.6331644144144144,40.19444444444443,8560.928412577874,115.6882217915929,0
2164,33.168262576556124,0,0,173,0.0,0.0,1.0,173,4550,3500,1050,0.7692307692307693,56,35,21,217.331865258496,0.41446683021911546,0.7479534186898378,0.14105917830132075,1120649.6809995775,9560.577094595097,1130210.2580941727,2163,3,1003.1907514450867,77,96,43,34.401222279304726,0.6332521645021645,40.05074786324785,8622.065051451154,111.97487079806695,0
2165,32.6514131090014,0,0,173,0.0,0.0,1.0,173,5100,3700,1400,0.7254901960784313,65,37,28,214.59280097196944,0.41437441188331764,0.7443959404276548,0.1401565890757332,1105028.6307640288,7726.237805974286,1112754.868570003,2164,4,1004.1907514450867,78,95,38,34.25088270572534,0.6350160256410257,39.833860759493646,8494.79208931569,108.90759088866268,0
2166,32.15257873056333,1,1,173,0.005747126436781609,0.005747126436781609,0.9942528735632183,174,4750,3300,1450,0.6947368421052632,62,33,29,212.5625265922289,0.4149862689079353,0.7440474669546642,0.1394782244993986,1089489.5300727903,6766.92944160996,1096256.4595144002,2165,0,999.4137931034483,80,94,42,34.13978494623652,0.6358072916666666,39.673353909464986,8370.172984089331,104.62716230111664,0
2167,31.957943821277937,1,0,174,0.005747126436781609,0.0,1.0,174,4700,3600,1100,0.7659574468085106,58,36,22,209.20708910799075,0.41439522290877684,0.7403171497073537,0.13797993564868036,1084356.0356328336,5870.99395428507,1090227.0295871187,2166,0,1000.051724137931,72,102,40,34.047824459538376,0.6412037037037037,39.49771689497716,8325.117328784945,115.62662956645757,0
2168,32.21589476284641,0,1,173,0.0,0.005747126436781609,0.9942528735632183,174,4700,3500,1200,0.7446808510638298,59,35,24,207.16169361290466,0.41426234137266627,0.7378578993964175,0.13707618282878165,1094044.0675301065,5828.804383337516,1099872.871913444,2167,1,1001.051724137931,73,101,43,33.98734291167044,0.641837899543379,39.386261261261254,8395.904780959141,115.01239425971426,0
2169,31.981312537139996,0,0,173,0.0,0.0,1.0,173,5250,3400,1850,0.6476190476190476,71,34,37,203.7429303255727,0.4135216426939105,0.7312500519593848,0.13529770183947537,1087097.8963171167,4447.702189282875,1091545.5985063997,2168,2,1007.7283236994219,74,99,42,33.9515749569417,0.6425957207207207,39.26388888888888,8338.683059162882,112.68490620490381,0
2170,31.82482480376989,1,0,174,0.005747126436781609,0.0,1.0,174,4350,3000,1350,0.6896551724137931,57,30,27,202.38777705232542,0.4143059431267025,0.7313507402772892,0.13501161688325358,1083067.157580559,4689.910884221883,1087757.0684647807,2169,0,1002.9310344827586,78,96,45,33.82852774689174,0.6423611111111112,39.10864978902953,8302.821513283088,106.44642965747549,0
2171,32.079249053223485,0,0,174,0.0,0.0,1.0,174,5950,4600,1350,0.773109243697479,73,46,27,203.8624900256117,0.41434193187606577,0.7347372443527627,0.13631237846577363,1092387.9819055407,3789.3868130632645,1096177.3687186039,2170,1,1003.9310344827586,78,96,40,33.709327000808386,0.6431623931623931,39.0295358649789,8371.736514522658,107.32995531439305,0
2172,32.207387874964155,0,0,174,0.0,0.0,1.0,174,4500,2800,1700,0.6222222222222222,62,28,34,202.46813480332833,0.4141204626492149,0.7328218882578716,0.13577505287488167,1097582.1642592289,5145.082718193173,1102727.246977422,2171,2,1004.9310344827586,82,92,35,33.6449019325065,0.6425304878048781,38.93072289156626,8408.359470067815,102.54096914716848,0
2173,32.27084634225113,0,0,174,0.0,0.0,1.0,174,4250,3000,1250,0.7058823529411765,55,30,25,204.66590782860715,0.414096931543862,0.7361927593521134,0.13751929441783026,1100306.2105454805,5989.033894148933,1106295.2444396294,2172,3,1005.9310344827586,83,91,35,33.519525437680066,0.6428212851405622,38.8640873015873,8427.076913133968,101.53104714619238,0
2174,31.79865946542978,0,1,173,0.0,0.005747126436781609,0.9942528735632183,174,5050,3400,1650,0.6732673267326733,67,34,33,203.33020458933294,0.4138256317409696,0.7346605803956074,0.13708391212635704,1085154.096960501,4278.920909186372,1089433.0178696874,2173,4,1006.9310344827586,84,90,37,33.43799840510368,0.6436011904761905,38.75000000000001,8307.399785343549,98.89761649218511,0
2175,31.348767524654686,0,0,173,0.0,0.0,1.0,173,5350,3800,1550,0.7102803738317757,69,38,31,205.1299630050681,0.41254424877895773,0.7358049137014442,0.13849845063945773,1070202.6846636666,3956.1274225966727,1074158.8120862632,2174,8,1013.7283236994219,84,89,37,33.340954569615135,0.6440972222222222,38.70098039215687,8191.402220106482,97.51669309650573,0
2176,31.524646294264645,0,1,172,0.0,0.005780346820809248,0.9942196531791907,173,5350,3600,1750,0.6728971962616822,71,36,35,208.42444586885955,0.4120191445982883,0.7390840564990309,0.14150922903727892,1077751.7236225675,4975.961156048625,1082727.684778616,2175,9,1014.7283236994219,73,100,41,33.0634959086994,0.6506849315068493,38.51351351351353,8243.268997216537,112.92149311255531,0
2177,31.65258509811723,1,0,173,0.005780346820809248,0.0,1.0,173,4250,2800,1450,0.6588235294117647,57,28,29,206.3017807101526,0.4120219451539185,0.7370699103458873,0.14086958502568864,1083708.2764314043,5864.1894396261,1089572.4658710305,2176,0,1015.664739884393,75,98,41,32.92391228437742,0.6516666666666666,38.32236842105265,8282.773501826447,110.43698002435262,0
2178,31.30323207182685,0,1,172,0.0,0.005780346820809248,0.9942196531791907,173,5100,4100,1000,0.803921568627451,61,41,20,207.016077410843,0.41172648653492855,0.7390865611325081,0.14170584395671298,1072421.0073207086,4701.67805370379,1077122.6853744125,2177,1,1016.664739884393,75,98,41,32.82128146053685,0.6525000000000001,38.24013157894738,8193.929908275099,109.25239877700132,0
2179,31.223280918153353,1,0,173,0.005780346820809248,0.0,1.0,173,4850,3900,950,0.8041237113402062,58,39,19,205.0915184835319,0.41261986378097415,0.7378158792907283,0.14131648465372149,1071475.0273737349,4500.088076252643,1075975.1154499876,2178,0,1015.9826589595376,77,96,43,32.64786282306162,0.653814935064935,38.020833333333336,8179.84911553706,106.2318066952865,0
2180,31.041492439387174,0,0,173,0.0,0.0,1.0,173,4850,2900,1950,0.5979381443298969,68,29,39,208.06090739036006,0.4119309270959359,0.7409266934764318,0.14379063265962458,1066041.0424382011,4910.293321011545,1070951.3357592127,2179,1,1016.9826589595376,78,95,35,32.469121050513195,0.6543803418803419,37.92194092827005,8135.294089204383,104.29864216928696,0
2181,30.778946419734186,0,0,173,0.0,0.0,1.0,173,4350,3000,1350,0.6896551724137931,57,30,27,207.39543215786955,0.41183990903795314,0.7398889861083358,0.1438055930416966,1057907.5557971562,4931.038943525437,1062838.5947406816,2180,2,1017.9826589595376,79,94,37,32.37485101311084,0.6550632911392404,37.81250000000001,8069.855014424075,102.15006347372247,0
2182,31.245101585862244,0,1,172,0.0,0.005780346820809248,0.9942196531791907,173,4900,3500,1400,0.7142857142857143,63,35,28,210.01833511857203,0.4113568131917373,0.7466126424177093,0.14590892743388884,1074458.1652466161,5631.183003930133,1080089.3482505463,2181,3,1018.9826589595376,83,90,39,32.240243364226714,0.6541164658634537,37.74801587301589,8194.089885141586,98.72397451977814,8
2183,31.095804623156152,0,0,172,0.0,0.0,1.0,172,5900,4500,1400,0.7627118644067796,73,45,28,249.31155861209174,0.4103880502289315,0.7784964411300033,0.1587476854604447,1045227.5648591636,11817.462659872253,1057045.0275190359,2182,4,1025.8779069767443,76,96,40,34.25553932310693,0.6269188596491229,40.719696969697,8062.529645663089,106.0859163903038,8
2184,30.774515792768216,2,0,174,0.011494252873563218,0.0,1.0,174,5750,4300,1450,0.7478260869565218,72,43,29,243.51511867688006,0.41246844063517374,0.7769627227670581,0.15613616432811642,1036371.9448239146,9924.447427436633,1046296.3922513511,2183,0,1015.0747126436781,62,112,41,34.15639334862384,0.6370967741935484,40.47619047619045,7986.7195747898,128.8180576579,0
2185,30.573788977692246,0,0,174,0.0,0.0,1.0,174,4400,3100,1300,0.7045454545454546,57,31,26,242.32048776955972,0.41241930215046624,0.7758130560354746,0.1555044192539697,1029852.0610009622,10710.850750447597,1040562.9117514098,2184,1,1016.0747126436781,63,111,42,34.15643746995256,0.6367394179894179,40.44596354166664,7935.5503389852765,125.96111649182978,0
2186,30.596339004597777,1,0,175,0.005714285714285714,0.0,1.0,175,4500,3600,900,0.8,54,36,18,236.57120526405282,0.41320607553366173,0.7705401082782386,0.1523890798891428,1031659.4467523114,9312.183748048039,1040971.6305003595,2185,0,1011.2628571428571,66,109,43,34.17063302001636,0.6362058080808081,40.314054726368155,7945.43921632146,120.38544267153726,0
2187,30.933635307872596,0,1,174,0.0,0.005714285714285714,0.9942857142857143,175,5450,4300,1150,0.7889908256880734,66,43,23,234.9751501541199,0.413011767925561,0.769216161482023,0.15204482272378597,1044294.5048240343,8626.651615229912,1052921.1564392643,2186,1,1012.2628571428571,68,107,42,34.05134015028274,0.6366421568627452,40.15700483091787,8037.888449865678,118.20424190978939,0
2188,31.39740416477205,0,0,174,0.0,0.0,1.0,174,4450,3100,1350,0.6966292134831461,58,31,27,231.7307280978387,0.4123404037384006,0.7637021673356053,0.15061321823849666,1061210.1739656986,9933.001255580899,1071143.1752212795,2187,2,1019.0344827586207,76,98,35,33.97776939486965,0.6341831140350878,40.002705627705616,8163.2401331541105,107.41105438360671,0
2189,31.038822053556647,0,0,174,0.0,0.0,1.0,174,4950,3100,1850,0.6262626262626263,68,31,37,233.86295410214842,0.41237293203109426,0.7681209317338218,0.15265392421535273,1050291.5888294147,9374.858726456883,1059666.4475558717,2188,3,1020.0344827586207,76,98,36,33.770042468365354,0.6356907894736843,39.85389610389608,8074.628626757184,106.24511350996295,0
2190,30.724976001703425,0,2,172,0.0,0.011494252873563218,0.9885057471264368,174,5300,3700,1600,0.6981132075471698,69,37,32,236.32141629348837,0.4123078754457068,0.7713533315400871,0.15499858473309008,1040991.5474156281,9101.719366961806,1050093.26678259,2189,4,1021.0344827586207,78,96,39,33.537107858035284,0.6364850427350428,39.688818565400815,7998.054802553057,102.53916413529561,0
2191,30.290418172551398,0,0,172,0.0,0.0,1.0,172,5550,4600,950,0.8288288288288288,65,46,19,238.07999999999979,0.4107889636882905,0.7695348837209299,0.1566315789473684,1027100.2255775087,8956.40434109866,1036056.6299186073,2190,7,1033.703488372093,63,109,36,33.383333333333326,0.6455026455026456,39.583333333333336,7888.129732435266,125.20840845135343,0
2192,30.02620027182532,0,0,172,0.0,0.0,1.0,172,5250,3800,1450,0.7238095238095238,67,38,29,235.20224327121744,0.41052050750260666,0.7663969366065218,0.15531754959802835,1019143.7380612029,8290.978681561908,1027434.7167427648,2191,8,1034.703488372093,64,108,40,33.32705437323165,0.6461588541666667,39.45512820512821,7823.172500309886,122.23707031734197,0
2193,29.761354151875047,1,1,172,0.005780346820809248,0.005780346820809248,0.9942196531791907,173,5600,4400,1200,0.7857142857142857,68,44,24,235.12418984004697,0.41137921763677915,0.7642666548877959,0.15633315070427173,1011970.5527280258,7387.75127043246,1019358.3039984583,2192,0,1029.7167630057804,68,105,40,33.08946972328357,0.6461397058823529,39.22101449275363,7761.135743047867,114.13434916246864,0
2194,29.61447938064866,0,0,172,0.0,0.0,1.0,172,4500,3100,1400,0.6888888888888889,59,31,28,231.8138943749787,0.4108229634162927,0.7588868143836422,0.15495203830318557,1008371.0138016732,7850.88233684255,1016221.8961385158,2193,1,1032.093023255814,70,102,35,32.9910889975825,0.646875,39.0404929577465,7728.179940487103,110.40257057838718,0
2195,29.766458404971445,0,0,172,0.0,0.0,1.0,172,4800,3000,1800,0.625,66,30,36,230.84403807262197,0.4106756312616166,0.7590628794443588,0.15470463161680534,1014229.7933586458,7625.780206494384,1021855.5735651401,2194,2,1033.093023255814,70,102,37,32.926338073024986,0.6477678571428571,38.952464788732414,7770.460598586556,111.00657997980795,0
2196,30.3699318350024,0,1,171,0.0,0.005813953488372093,0.9941860465116279,172,4800,3100,1700,0.6458333333333334,65,31,34,227.11916860889787,0.41053184074527405,0.7553260890000177,0.15285441325854682,1035928.6239553631,7855.849562180769,1043784.4735175439,2195,3,1034.093023255814,73,99,41,32.8769761070691,0.6476883561643836,38.80912162162166,7932.349172275829,108.66231742843601,0
2197,30.238508523733216,0,0,171,0.0,0.0,1.0,171,5150,3700,1450,0.7184466019417476,66,37,29,229.79528986412572,0.40955165692007794,0.7561320391589264,0.155317504141769,1032584.1470258886,8106.594674983251,1040690.7417008718,2196,4,1040.923976608187,75,96,42,32.65966722609745,0.6481944444444445,38.665021929824576,7902.379961924668,105.36506615899557,0
2198,30.406570102458893,0,0,171,0.0,0.0,1.0,171,5000,3300,1700,0.66,67,33,34,229.18497417214238,0.40943985781447084,0.7558149669350338,0.15528648109756316,1038980.9375307705,8423.763866667836,1047404.7013974384,2197,5,1041.923976608187,76,95,44,32.59094907886565,0.6485745614035088,38.5822510822511,7948.817108494573,104.58969879598123,0
2199,30.44747855290434,0,0,171,0.0,0.0,1.0,171,4000,2700,1300,0.675,53,27,26,231.24493659521374,0.4095258571264763,0.7575755679329108,0.15708965401985106,1041073.1575321096,9948.57926089854,1051021.7367930082,2198,6,1042.923976608187,66,105,42,32.44785473642491,0.6546717171717171,38.49502487562191,7962.167121577323,120.63889578147459,0
2200,30.723517455377813,0,0,171,0.0,0.0,1.0,171,4900,3500,1400,0.7142857142857143,63,35,28,231.54311325089563,0.40919475977525516,0.7572519073666935,0.157996269246635,1051713.9947735833,9603.426519882383,1061317.4212934657,2199,7,1043.923976608187,68,103,41,32.28697880606201,0.6550245098039216,38.34541062801933,8038.949343849776,118.21984329190846,0
2201,30.926267259589824,0,0,171,0.0,0.0,1.0,171,5800,4100,1700,0.7068965517241379,75,41,34,230.7239445844272,0.409005561288843,0.7582980072816032,0.15812724414000134,1059836.24635338,8905.919874440973,1068742.1662278208,2200,8,1044.923976608187,69,102,40,32.15903815911628,0.6559480676328502,38.199404761904766,8096.5151770530465,117.34079966743546,0
2202,31.08821378166221,1,1,171,0.005813953488372093,0.005813953488372093,0.9941860465116279,172,5050,3400,1650,0.6732673267326733,67,34,33,225.8091413386047,0.40939922480620156,0.752500752787187,0.15572380688163973,1067069.294999393,8740.800250520706,1075810.0952499136,2201,0,1039.843023255814,73,99,45,32.07631538888591,0.655964611872146,37.99268018018019,8145.339570918914,111.57999412217691,0
2203,31.581147743757846,0,0,171,0.0,0.0,1.0,171,5350,4200,1150,0.7850467289719626,65,42,23,229.32965373384377,0.4093208920995299,0.7543796835447014,0.1586225168099617,1084804.2087508463,10205.554712369554,1095009.763463216,2202,1,1045.923976608187,73,98,36,31.88327962764054,0.6569634703196348,37.89414414414414,8277.603758287876,113.39183230531337,0
2204,31.21643626491083,0,0,171,0.0,0.0,1.0,171,4300,2900,1400,0.6744186046511628,57,29,28,230.0604851547315,0.4090757940603142,0.7566516936463556,0.15980711552694388,1073428.5206216287,10890.697246627351,1084319.2178682561,2203,2,1046.923976608187,73,98,39,31.720119878332415,0.658390410958904,37.753378378378365,8186.404949539507,112.1425335553357,0
2205,31.02814551047408,0,0,171,0.0,0.0,1.0,171,4350,3200,1150,0.735632183908046,55,32,23,228.73178186186323,0.4088923288613691,0.7558981103754736,0.1593025772790141,1067659.5253709315,10291.53313197671,1077951.058502908,2204,3,1047.923976608187,74,97,41,31.666269589157128,0.6587837837837838,37.66666666666666,8139.7168389143435,109.99617349884248,0
2206,31.26365361464369,0,0,171,0.0,0.0,1.0,171,4100,2400,1700,0.5853658536585366,58,24,34,227.82061396294873,0.4085526315789474,0.7561167659277344,0.15907031338565927,1076446.7820735497,10747.353358087123,1087194.1354316368,2205,4,1048.923976608187,74,97,42,31.60494072192229,0.6596283783783784,37.58333333333332,8204.103769376054,110.86626715373045,0
2207,31.633895585795408,0,0,171,0.0,0.0,1.0,171,5250,4000,1250,0.7619047619047619,65,40,25,222.43623933591246,0.4085526315789474,0.757917066231172,0.1428507937664099,1065775.4910444852,7963.418440864249,1073738.9094853494,2206,5,1049.923976608187,65,106,40,34.645819399687895,0.6357371794871796,40.41982323232324,8211.532208011015,126.33126473863099,8
2208,31.387665326518732,1,0,172,0.005813953488372093,0.0,1.0,172,4200,2900,1300,0.6904761904761905,55,29,26,220.14702085733498,0.4090358527131783,0.7561507837299848,0.1422647420928979,1059252.8452229304,8038.27164209673,1067291.1168650272,2207,0,1044.8139534883721,68,104,42,34.48292560094526,0.6361825980392157,40.20229468599033,8154.443426993656,119.91828569108318,0
2209,31.894075967509824,0,0,172,0.0,0.0,1.0,172,4250,3200,1050,0.7529411764705882,53,32,21,219.34930000736657,0.4087950213064962,0.7551153077257291,0.1422999468411027,1077460.1966313682,8618.027983377995,1086078.2246147462,2208,1,1045.8139534883721,70,102,45,34.36588681304211,0.6364583333333333,40.0674882629108,8290.307275768364,118.4329610824052,0
2210,31.915373922261164,0,0,172,0.0,0.0,1.0,172,5050,3800,1250,0.7524752475247525,63,38,25,216.9514264513672,0.40870931365882407,0.7526667104011537,0.14122159507346657,1079153.6041972253,7374.782758144616,1086528.38695537,2209,2,1046.8139534883721,70,102,40,34.30829807240243,0.6376488095238095,39.95011737089203,8299.589242548138,118.56556060783055,0
2211,31.80969804489483,0,0,172,0.0,0.0,1.0,172,5050,3500,1550,0.693069306930693,66,35,31,216.47057754693913,0.4086384808921529,0.75275788488347,0.1414866391576248,1076751.6973832264,7167.012361438883,1083918.7097446653,2210,3,1047.8139534883721,73,99,41,34.17617939839865,0.6375570776255708,39.808558558558566,8276.6111861182,113.37823542627672,0
2212,31.88214720613593,1,1,172,0.005780346820809248,0.005780346820809248,0.9942196531791907,173,4550,3200,1350,0.7032967032967034,59,32,27,211.0994241078696,0.4091695792445221,0.7470260567553184,0.13849434756755669,1080276.8088501622,6459.162445071261,1086735.9712952334,2211,0,1042.7514450867052,75,98,42,34.18392083048142,0.6379166666666667,39.67927631578947,8299.583633307833,110.6611151107711,0
2213,32.165254436172916,0,0,172,0.0,0.0,1.0,172,4350,2700,1650,0.6206896551724138,60,27,33,215.23422411690376,0.40852444013781225,0.7504385837731258,0.14149003913258756,1090446.3397265642,8190.2743744329055,1098636.614100997,2212,1,1049.7906976744187,76,96,43,34.00591403435856,0.638157894736842,39.61038961038961,8375.498070717751,110.2039219831283,0
2214,32.23307111090652,1,0,173,0.005780346820809248,0.0,1.0,173,4100,2900,1200,0.7073170731707317,53,29,24,211.15457938535238,0.40842883228032445,0.746955791870533,0.1392792790776181,1093722.1129445457,7488.88654465292,1101210.9994891987,2213,0,1044.7167630057804,69,104,43,33.993345138809545,0.6428140096618358,39.49404761904763,8396.906887909685,121.69430272332876,0
2215,32.48180007511283,0,0,173,0.0,0.0,1.0,173,4300,2700,1600,0.627906976744186,59,27,32,214.12827584104915,0.40842183089124884,0.7515935969004266,0.1417942061004151,1103295.4584803458,8349.350853531338,1111644.8093338772,2214,1,1045.7167630057804,69,104,43,33.77908221524408,0.6441727053140096,39.36011904761905,8466.052504696458,122.69641311154287,0
2216,32.82113723508268,0,0,173,0.0,0.0,1.0,173,4400,2500,1900,0.5681818181818182,63,25,38,215.17591725162103,0.4080479567146122,0.7525597877065398,0.14306698297530318,1116006.48237829,9027.54370090077,1125034.026079191,2215,2,1046.7167630057804,71,102,44,33.61032131299122,0.644512910798122,39.22164351851852,8559.04222601802,120.54989050729606,0
2217,32.4971264995536,0,1,172,0.0,0.005780346820809248,0.9942196531791907,173,3700,2500,1200,0.6756756756756757,49,25,24,213.495571688214,0.4077889053188153,0.7503515834432517,0.14237903670736474,1105860.921095054,8919.28191136862,1114780.2030064226,2216,3,1047.7167630057804,73,100,43,33.54910834727244,0.6445490867579908,39.118806306306304,8477.8891528185,116.13546784682876,0
2218,32.04653751917588,0,1,171,0.0,0.005813953488372093,0.9941860465116279,172,4750,3500,1250,0.7368421052631579,60,35,25,211.03312518551476,0.40761282243075386,0.7461215555365754,0.14105661291749022,1091172.6128945479,6904.713323196234,1098077.326217744,2217,4,1054.1744186046512,74,98,41,33.53458140401296,0.644847972972973,39.04166666666668,8362.811020108304,113.0109597311933,0
2219,31.630136559130637,0,0,171,0.0,0.0,1.0,171,4500,3200,1300,0.7111111111111111,58,32,26,213.87732682137613,0.40758513931888546,0.7486264309801518,0.1434484268061117,1077953.8932994863,7409.979427117765,1085363.872726604,2218,5,1059.561403508772,75,96,34,33.34164566708665,0.6455555555555555,38.925438596491226,8257.824029308118,110.1043203907749,0
2220,31.590868250911868,1,0,172,0.005813953488372093,0.0,1.0,172,4250,3300,950,0.7764705882352941,52,33,19,215.82190397056536,0.4083785246384695,0.753026001861606,0.1455402932566759,1078129.1911661404,7886.778952744381,1086015.9701188847,2219,0,1054.3953488372092,77,95,35,33.10346700403823,0.6465097402597403,38.741987179487175,8253.367462507857,107.18659042217996,0
2221,31.307007735002646,0,0,172,0.0,0.0,1.0,172,5400,3700,1700,0.6851851851851852,71,37,34,216.40750610183886,0.40804136066911467,0.7542404899913173,0.1462891122421026,1069109.5685912417,6472.667097688674,1075582.2356889304,2220,1,1055.3953488372092,78,94,37,33.00475109317187,0.6469017094017093,38.66033755274262,8181.76283369927,104.8943953038368,0
2222,31.35646727537323,0,0,172,0.0,0.0,1.0,172,5050,3400,1650,0.6732673267326733,67,34,33,213.3078275504319,0.40744707375674327,0.7510953529243467,0.14483550581884994,1072022.4560316838,6284.156236279561,1078306.6122679634,2221,2,1056.3953488372092,67,105,39,32.93326498730719,0.6539179104477613,38.511029411764724,8199.37034912107,122.37866192718016,0
2223,31.057161299319993,0,0,172,0.0,0.0,1.0,172,5300,4000,1300,0.7547169811320755,66,40,26,213.31941897315,0.40726432521873157,0.7511978193648114,0.14529869858359915,1062644.4858455954,5636.540859121076,1068281.0267047165,2222,3,1057.3953488372092,68,104,39,32.82548476454293,0.6544117647058824,38.405797101449295,8124.373354387378,119.47607874099084,0
2224,31.010896724565637,0,0,172,0.0,0.0,1.0,172,5500,3600,1900,0.6545454545454545,74,36,38,215.2347757348748,0.4068634117593726,0.7568481836333079,0.13773324186354238,1043779.7022602727,5031.538026520848,1048811.2402867936,2223,4,1058.3953488372092,64,108,39,34.9604951616224,0.6350911458333333,40.544871794871796,8045.936185428169,125.71775289731514,8
2225,31.10315356274303,1,0,173,0.005780346820809248,0.0,1.0,173,5100,3700,1400,0.7254901960784313,65,37,28,213.0963338856349,0.4077160908724291,0.7560301420115967,0.13685261239426144,1047894.2965294904,4960.486578020153,1052854.7831075105,2224,0,1053.271676300578,65,108,41,34.88826483046553,0.6357371794871796,40.41982323232323,8073.762099849031,124.21172461306202,0
2226,30.801465785980223,1,0,174,0.005747126436781609,0.0,1.0,174,5200,3900,1300,0.75,65,39,26,211.68481836889669,0.40832696609306135,0.7550588133224341,0.13670034843487253,1039274.7095458194,3999.7356251190095,1043274.4451709385,2225,0,1048.212643678161,67,107,42,34.72770963557023,0.6365049751243781,40.22671568627452,8001.397928900943,119.4238496850887,0
2227,30.62193777310801,0,0,174,0.0,0.0,1.0,174,5400,4200,1200,0.7777777777777778,66,42,24,209.80515385375153,0.40833042654973095,0.753081894047748,0.1358760691662334,1034012.1065953919,3188.2138221776404,1037200.3204175695,2226,1,1049.212643678161,68,106,41,34.674538166608606,0.6369485294117647,40.126811594202906,7957.820604261503,117.02677359208093,0
2228,30.64221748413734,0,0,174,0.0,0.0,1.0,174,4400,2800,1600,0.6363636363636364,60,28,32,206.59536957269202,0.4083615706597568,0.7476112218036908,0.13420208801557648,1035532.2439340933,3587.2333280007215,1039119.477262094,2227,2,1050.212643678161,75,99,39,34.650903275692414,0.6344444444444444,40.02192982456141,7966.304567422127,106.21739423229502,0
2229,30.344981214042964,1,0,175,0.005714285714285714,0.0,1.0,175,4550,3100,1450,0.6813186813186813,60,31,29,203.81964588640705,0.40900383141762453,0.7457675819719614,0.1329680546973228,1026659.3037288405,2300.6671463995267,1028959.97087524,2228,0,1045.2057142857143,78,97,42,34.57152693295488,0.6346153846153846,39.87341772151899,7893.536252513713,101.1991827245348,0
2230,30.868256999405844,1,0,176,0.005681818181818182,0.0,1.0,176,5700,4300,1400,0.7543859649122807,71,43,28,202.23804749135638,0.41012107683982685,0.7462724766083559,0.13260991459665222,1045774.9807947495,1399.0980462481466,1047174.0788409977,2229,0,1040.2613636363637,81,95,44,34.43335895433766,0.6351594650205761,39.697662601626014,8035.079448359053,99.19851170813645,0
2231,30.8928704616672,0,0,176,0.0,0.0,1.0,176,4150,3000,1150,0.7228915662650602,53,30,23,203.1999999999996,0.4101481331168831,0.7479545454545451,0.13368421052631585,1047528.4309104844,3221.5554322021017,1050749.9863426865,2230,1,1041.2613636363637,81,95,44,34.291666666666664,0.6363168724279835,39.58333333333334,8045.0183493925215,99.32121419003113,0
2232,30.91485151078119,1,0,177,0.005649717514124294,0.0,1.0,177,5150,3500,1650,0.6796116504854369,68,35,33,203.2634890942626,0.4112978299948639,0.7483520975431266,0.13449358421748778,1049854.3757709346,2129.4126920158387,1051983.7884629504,2231,0,1036.3728813559321,68,109,44,34.08976809747241,0.6444546568627452,39.38707729468599,8056.809807225477,118.48249716508055,0
2233,30.96760950861121,0,0,177,0.0,0.0,1.0,177,4700,3500,1200,0.7446808510638298,59,35,24,204.12693782304564,0.41121490326998805,0.7489139132599387,0.13550765080513058,1052548.8391469559,2870.7142888539156,1055419.5534358097,2232,1,1037.3728813559321,70,107,42,33.953139947104845,0.6444940476190476,39.27523474178404,8074.022719740759,115.34318171058227,0
2234,30.95410968781704,1,0,178,0.0056179775280898875,0.0,1.0,178,4450,3100,1350,0.6966292134831461,58,31,27,199.23111825933233,0.41170597134937265,0.743845467335337,0.13289621183889588,1053414.9749156996,1924.6086887164106,1055339.5836044159,2233,0,1032.5393258426966,74,104,43,33.91339260363431,0.6441441441441442,39.11111111111112,8075.583282999401,109.12950382431623,0
2235,31.226042029496977,1,2,177,0.00558659217877095,0.0111731843575419,0.9888268156424581,179,4800,3600,1200,0.75,60,36,24,210.92853572307135,0.41237472014730187,0.7564685992348259,0.1341842131245778,1049343.4708238184,3667.2963542868833,1053010.7671781052,2234,0,1027.7653631284916,81,98,39,35.28375310335817,0.6244855967078189,40.752032520325216,8095.287928582025,99.94182627879044,8
2236,31.22537742692735,0,2,175,0.0,0.011299435028248588,0.9887005649717514,177,5300,3500,1800,0.660377358490566,71,35,36,215.79928572832432,0.4107695065057353,0.7597231925341261,0.13789981526503575,1050597.8802074958,4643.654427293894,1055241.5346347897,2235,1,1040.3559322033898,67,110,37,34.99640762174719,0.632773631840796,40.594362745098046,8100.03892995693,120.89610343219299,0
2237,31.198418912609963,0,0,175,0.0,0.0,1.0,175,5950,5000,950,0.8403361344537815,69,50,19,217.05920073943224,0.40941023535851123,0.7582851492059803,0.1391818246889812,1050664.8970625696,4661.296560275874,1055326.1936228455,2236,2,1052.9885714285715,68,107,37,34.84078393733156,0.6334252450980392,40.47403381642513,8096.799811695027,119.07058546610334,0
2238,30.79802203459478,3,0,178,0.016853932584269662,0.0,1.0,178,4850,3600,1250,0.7422680412371134,61,36,25,214.42617736982885,0.411473872701496,0.7581873283796148,0.1387097139085328,1039638.9915647805,4135.162961172078,1043774.1545259525,2237,0,1036.2247191011236,74,104,43,34.59515982467395,0.6334459459459459,40.16666666666668,8002.352725322236,108.13990169354373,0
2239,31.103149255037028,0,0,178,0.0,0.0,1.0,178,4950,3600,1350,0.7272727272727273,63,36,27,215.18432587677728,0.411618686387778,0.7583750121226396,0.1396115906288533,1050768.1229029133,4671.76603593407,1055439.8889388472,2238,1,1037.2247191011236,77,101,41,34.47068947801067,0.6331168831168832,40.06410256410257,8084.825014690726,104.99772746351591,0
2240,31.402032385561093,0,0,178,0.0,0.0,1.0,178,5000,3600,1400,0.72,64,36,28,211.57616365424258,0.4113495577561946,0.7537747567062469,0.13760824364319477,1061560.9490552838,4320.19861725478,1065881.1476725386,2239,2,1038.2247191011236,78,100,34,34.477476335361736,0.6335470085470085,39.9789029535865,8165.190910380601,104.68193474846925,0
2241,31.556942847838464,0,2,176,0.0,0.011235955056179775,0.9887640449438202,178,5350,3800,1550,0.7102803738317757,69,38,31,213.67341654550134,0.4112212753126389,0.7569498349949477,0.13945285195702622,1067778.2658670822,4681.166036169997,1072459.4319032521,2240,3,1039.2247191011236,82,96,35,34.30092547922293,0.6331300813008129,39.859437751004016,8209.240855296131,100.11269335726989,0
2242,32.0530637609141,0,1,175,0.0,0.005681818181818182,0.9943181818181818,176,4300,2800,1500,0.6511627906976745,58,28,30,220.29933453543538,0.4100006764069264,0.7614244777506882,0.14398631158854522,1084983.9188047573,8304.247058867493,1093288.1658636248,2241,4,1052.0,82,94,36,34.07725175252429,0.6336382113821138,39.80923694779117,8339.911118113358,101.70623314772388,0
2243,31.90376343921326,0,0,175,0.0,0.0,1.0,175,4950,3900,1050,0.7878787878787878,60,39,21,215.9404224971773,0.4091338259441708,0.7564553352879468,0.14176261852688604,1081195.398620589,6744.758236026761,1087940.1568566158,2242,5,1058.7314285714285,84,91,39,34.03500203979164,0.6344246031746033,39.65686274509804,8305.925864003017,98.88006980955973,0
2244,32.03318738680976,0,0,175,0.0,0.0,1.0,175,5050,3500,1550,0.693069306930693,66,35,31,213.81259343890193,0.4091967706622879,0.7526341196537187,0.1410273554643816,1086929.2292744762,6429.831479144679,1093359.060753621,2243,6,1059.7314285714285,70,105,38,33.9253867237366,0.6422619047619047,39.49530516431926,8344.795704815082,119.21136721164403,0
2245,31.75032200553795,0,0,175,0.0,0.0,1.0,175,4950,3600,1350,0.7272727272727273,63,36,27,212.3922543037611,0.40942665571975917,0.7504983941953132,0.14061912757376946,1078398.3445134598,5858.691085731709,1084257.0355991914,2244,7,1060.7314285714285,71,104,40,33.83066194837639,0.6430457746478873,39.36631944444446,8275.203283127432,116.55215891728777,0
2246,32.193212264346975,0,0,175,0.0,0.0,1.0,175,4500,3400,1100,0.7555555555555555,56,34,22,212.06347274959202,0.40915571975916804,0.7500225168876642,0.14080028248839255,1094254.4066929384,6910.2779109700205,1101164.6846039083,2245,8,1061.7314285714285,72,103,41,33.740262879451265,0.6435185185185186,39.26940639269408,8393.755343809229,116.57993533068374,0
2247,32.41941100977686,0,0,175,0.0,0.0,1.0,175,5050,3500,1550,0.693069306930693,66,35,31,210.2320625962582,0.409263820470717,0.7478264786025797,0.14003942538569844,1102881.0956775183,6322.193508541324,1109203.2891860595,2246,9,1062.7314285714285,75,100,38,33.674717128194324,0.6431944444444444,39.15844298245615,8456.32964538193,112.75106193842572,0
2248,32.70295903206984,0,0,175,0.0,0.0,1.0,175,4650,3200,1450,0.6881720430107527,61,32,29,206.64160020282202,0.40925424192665577,0.743121508992542,0.13809086415742658,1113459.6972650073,6367.418720838274,1119827.1159858457,2247,10,1063.7314285714285,77,98,40,33.65681508017742,0.6433982683982684,39.04914529914531,8533.865110665687,110.8294170216323,0
2249,32.75236505962725,0,0,175,0.0,0.0,1.0,175,4050,2400,1650,0.5925925925925926,57,24,33,208.17849922287118,0.4091516146688561,0.7447942747366423,0.13961782995452637,1116182.0367303863,7423.0202532119665,1123605.0569835983,2248,11,1064.7314285714285,80,95,35,33.49250036943994,0.643359375,38.927469135802475,8550.742837905014,106.88428547381268,0
2250,32.41126625383646,0,0,175,0.0,0.0,1.0,175,4150,3000,1150,0.7228915662650602,53,30,23,212.08977460527407,0.40889162561576353,0.750002180595513,0.14267410508309084,1105428.2986694241,7740.00774141801,1113168.306410842,2249,12,1065.7314285714285,80,95,35,33.285325061138714,0.6444010416666667,38.824588477366255,8465.025801815395,105.81282252269243,0
2251,32.052676723575125,0,0,175,0.0,0.0,1.0,175,5600,4100,1500,0.7321428571428571,71,41,30,211.49846117575012,0.40848932676518884,0.7503261660057354,0.14288841526935372,1094411.2309019377,5693.2582458437955,1100104.4891477814,2250,13,1066.7314285714285,82,93,37,33.152835142317464,0.6450711382113821,38.67971887550202,8376.01449219733,102.14651819752841,0
2252,32.105661270053716,0,0,175,0.0,0.0,1.0,175,4550,2900,1650,0.6373626373626373,62,29,33,209.49673702971745,0.407807881773399,0.748670551202196,0.14185921907440893,1096864.5917292153,6407.910586140844,1103272.5023153562,2251,14,1067.7314285714285,84,91,39,33.12675808720112,0.6450892857142857,38.602941176470594,8392.325427576558,99.90863604257807,0
2253,31.941052489791836,0,0,175,0.0,0.0,1.0,175,4500,3200,1300,0.7111111111111111,58,32,26,210.55913958890778,0.40786945812807884,0.7493647181221141,0.1432193280733229,1092498.296678009,6507.100270174058,1099005.396948183,2252,15,1068.7314285714285,69,106,38,32.94525678956156,0.6533816425120773,38.45238095238098,8354.106228580133,121.07400331275555,0
2254,32.28210755502481,0,0,175,0.0,0.0,1.0,175,4000,3000,1000,0.75,50,30,20,210.769311585803,0.40808155446086486,0.7491335630157843,0.14354533329163033,1104524.6365329116,7559.979454320407,1112084.615987232,2253,16,1069.7314285714285,70,105,38,32.89610207515426,0.6532738095238095,38.40962441314556,8444.688640054206,120.63840914363152,0
2255,32.66660484787889,0,0,175,0.0,0.0,1.0,175,5250,4100,1150,0.780952380952381,64,41,23,208.1834567512874,0.40789819376026276,0.7462113020581775,0.1421321008899896,1118380.9320359686,6315.681679195113,1124696.6137151637,2254,17,1070.7314285714285,72,103,40,32.880039626276954,0.6530671296296297,38.32762557077627,8547.94805508569,118.72150076507903,0
2256,33.12479637859841,0,0,175,0.0,0.0,1.0,175,3750,2800,950,0.7466666666666667,47,28,19,207.76592724394635,0.40792419266557195,0.7450464314141683,0.14211792736523357,1134620.2030514206,8397.083711338862,1143017.2867627596,2255,18,1071.7314285714285,74,101,40,32.825904307066445,0.6527308558558558,38.26388888888891,8669.955385481804,117.16155926326762,0
2257,32.71052389866181,0,0,175,0.0,0.0,1.0,175,4750,3500,1250,0.7368421052631579,60,35,25,204.81643023463909,0.4081308155446086,0.7406440475591054,0.14070768318540958,1121664.767284029,6197.074711016679,1127861.8419950455,2256,19,1072.7314285714285,78,97,39,32.755987446083616,0.6523771367521367,38.119725738396646,8566.240969822342,109.82360217720951,0
2258,32.38433527738559,0,1,174,0.0,0.005714285714285714,0.9942857142857143,175,4950,3300,1650,0.6666666666666666,66,33,33,202.89603311247728,0.4080760810071155,0.7373295840201668,0.13996433374508332,1111641.7454157963,5159.54007741953,1116801.2854932158,2257,20,1073.7314285714285,81,94,41,32.666496977924304,0.6525205761316872,37.9827235772358,8485.255328142295,104.75623861904069,0
2259,32.09702651397205,1,2,173,0.005714285714285714,0.011428571428571429,0.9885714285714285,175,5350,4200,1150,0.7850467289719626,65,42,23,200.67369557541517,0.408132183908046,0.7354347076831578,0.13894665086042343,1102814.9494104534,3911.1902868022885,1106726.1396972558,2258,0,1073.2285714285715,83,92,35,32.59915519497928,0.6529869477911647,37.85962301587304,8413.926630442213,101.37261000532786,0
2260,32.143944732225535,0,0,173,0.0,0.0,1.0,173,4550,3500,1050,0.7692307692307693,56,35,21,202.0850241718232,0.407373022807725,0.7340084184843563,0.14030549471864748,1105185.6209508409,5518.292584840852,1110703.9135356818,2259,22,1084.5895953757226,84,89,36,32.47032432937658,0.6535218253968254,37.76960784313729,8429.119232600115,100.34665753095375,0
2261,31.94533361758634,0,0,173,0.0,0.0,1.0,173,3900,2500,1400,0.6410256410256411,53,25,28,206.58707337647417,0.40707476363310485,0.7385820221173551,0.14403908403238697,1099524.9615772287,6929.528783324282,1106454.490360553,2260,23,1085.5895953757226,87,86,38,32.20998759305214,0.6538553639846743,37.63020833333336,8381.490525968355,96.33897156285465,0
2262,31.87990757267239,0,0,173,0.0,0.0,1.0,173,4900,3400,1500,0.6938775510204082,64,34,30,204.2024431226427,0.40677650445848457,0.7349177330895778,0.14289073921720868,1098264.4971302943,5353.658701773651,1103618.155832068,2261,24,1086.5895953757226,88,85,39,32.15162898886761,0.6547111742424243,37.51170411985021,8368.102611567518,95.09207513144906,0
2263,31.782567315760303,0,0,173,0.0,0.0,1.0,173,5650,4600,1050,0.8141592920353983,67,46,21,207.0546444541509,0.40616038221983236,0.7371216300536889,0.14558969225884127,1096234.697271804,5146.09709638353,1101380.7943681877,2262,25,1087.5895953757226,77,96,37,31.914872205555845,0.6605790043290043,37.3530982905983,8347.592833854953,108.41029654357082,0
2264,32.25231920045925,0,0,173,0.0,0.0,1.0,173,5050,3400,1650,0.6732673267326733,67,34,33,206.0560505346938,0.40558766859344897,0.7356515452360586,0.14517187945025622,1112980.0279772682,6217.253777797801,1119197.281755066,2263,26,1088.5895953757226,78,95,39,31.875711035267354,0.6607905982905983,37.289029535864984,8473.038076871715,108.62869329322712,0
2265,32.43492801260773,0,1,172,0.0,0.005780346820809248,0.9942196531791907,173,3700,2400,1300,0.6486486486486487,50,24,26,205.66384167582447,0.40526840525160196,0.735054001905711,0.14548271894839912,1120405.4221443667,7785.376670526859,1128190.7988148935,2264,27,1089.5895953757226,78,95,40,31.751446439918375,0.6621260683760684,37.15717299578059,8525.288172512166,109.29856631425854,0
2266,32.444082620999794,0,0,172,0.0,0.0,1.0,172,5050,3700,1350,0.7326732673267327,64,37,27,206.12566726505187,0.4050444263112562,0.7356417022716986,0.14655164917588118,1122129.038847093,6809.919377969691,1128938.9582250626,2265,28,1094.656976744186,79,93,38,31.570921415251565,0.6633702531645569,36.9921875,8533.047198718426,108.01325567998008,0
2267,32.0033089402253,0,0,172,0.0,0.0,1.0,172,5000,3400,1600,0.68,66,34,32,207.8953058977093,0.40441188970488234,0.7385878045886118,0.14853003984221708,1108209.0102360914,6678.290236326003,1114887.3004724174,2266,29,1095.656976744186,82,90,33,31.363759200089024,0.6637449186991871,36.83483935742972,8422.155938348205,102.70921876034397,0
2268,32.484001539165895,0,0,172,0.0,0.0,1.0,172,4050,3200,850,0.7901234567901234,49,32,17,211.3340657820556,0.404348848542545,0.7425878745143957,0.15139833892911186,1125605.5468741774,9125.7593375508,1134731.3062117281,2267,30,1096.656976744186,82,90,35,31.183555015255546,0.6646341463414633,36.74698795180723,8551.511248563545,104.28672254345787,0
2269,32.92663556099025,0,0,172,0.0,0.0,1.0,172,4450,2700,1750,0.6067415730337079,62,27,35,217.29700239618518,0.4044558060202185,0.7496289368662601,0.15659516126418943,1142596.1505505706,10806.543692811625,1153402.6942433822,2268,31,1097.656976744186,84,88,38,30.831821494472084,0.6657986111111112,36.55637254901959,8674.312311943671,103.26562276123418,0
2270,32.80118132146787,0,0,172,0.0,0.0,1.0,172,5150,3900,1250,0.7572815533980582,64,39,25,216.97843790228706,0.40434176526587784,0.7502287737513138,0.1566074631096988,1138671.285903506,9863.423379905853,1148534.7092834117,2269,32,1098.656976744186,85,87,39,30.789548282308193,0.6659313725490197,36.50678294573641,8642.888789573728,101.68104458322033,0
2271,33.19605203889394,0,0,172,0.0,0.0,1.0,172,4250,2900,1350,0.6823529411764706,56,29,27,217.5870555463815,0.4039387268235188,0.749591117943065,0.1580077636094995,1154086.673515644,11572.86422711737,1165659.5377427612,2270,33,1099.656976744186,70,102,42,30.574101893581112,0.6745535714285714,36.311619718309856,8753.413193882634,125.04875991260906,0
2272,32.823899624019354,1,1,172,0.005780346820809248,0.005780346820809248,0.9942196531791907,173,4950,3500,1450,0.7070707070707071,64,35,29,214.82168861170783,0.4040963727203477,0.7471733769488393,0.1565395568531585,1142101.9586796917,9519.654266061918,1151621.6129457536,2271,0,1094.2947976878613,72,101,42,30.53451975261896,0.6746238425925926,36.20148401826483,8658.896009549713,120.26244457707935,0
2273,32.747207332183535,0,1,171,0.0,0.005813953488372093,0.9941860465116279,172,5150,3900,1250,0.7572815533980582,64,39,25,199.8974754299463,0.40356756312616165,0.7239890371887305,0.13789979081511253,1124106.057522886,5391.192602867279,1129497.2501257532,2272,1,1099.5058139534883,79,93,45,32.74409258062912,0.6533491561181435,37.98177083333336,8580.365275332471,108.61221867509457,8
2274,33.027515336085514,0,0,171,0.0,0.0,1.0,171,4250,3100,1150,0.7294117647058823,54,31,23,198.36570425778777,0.40297557619539043,0.720861162113204,0.13718667860461484,1134447.4450732546,6557.093277081153,1141004.5383503358,2273,36,1106.9298245614036,80,91,44,32.69947091245115,0.6537760416666667,37.89866255144035,8656.555942190891,108.20694927738614,0
2275,33.10782303938956,0,0,171,0.0,0.0,1.0,171,4400,3600,800,0.8181818181818182,52,36,16,199.14487631349274,0.4029684095860566,0.7210930609633743,0.13816972746174205,1138130.1450368706,6730.557392405319,1144860.702429276,2274,37,1107.9298245614036,81,90,39,32.57044030489481,0.6544495884773662,37.792174796747986,8681.130276372507,107.1744478564507,0
2276,32.67269056056778,0,0,171,0.0,0.0,1.0,171,4850,3800,1050,0.7835051546391752,59,38,21,198.87209360290862,0.4030357757137943,0.7212009249880891,0.138217085363389,1123656.4269959254,5642.781225408876,1129299.2082213343,2275,38,1108.9298245614036,83,88,40,32.51990834870052,0.6542419678714859,37.73561507936509,8568.88309356957,103.23955534421168,0
2277,32.77134930864713,1,0,172,0.005813953488372093,0.0,1.0,172,5850,4300,1550,0.7350427350427351,74,43,31,222.17217975934585,0.4039458101001859,0.758709968901593,0.1491937144005963,1117199.815849669,9392.143662811884,1126591.959512481,2276,0,1103.4767441860465,72,100,34,33.08286427309326,0.6474247685185186,38.884132420091305,8557.11930649159,118.84887925682763,8
2278,32.48892448400324,1,0,173,0.005780346820809248,0.0,1.0,173,4100,3000,1100,0.7317073170731707,52,30,22,220.64599769418643,0.4040585652193395,0.7595807489951705,0.14895167493066436,1109082.230164206,10242.911039894785,1119325.1412041006,2277,0,1098.092485549133,75,98,37,32.94079591551265,0.6477777777777778,38.706140350877185,8489.156474274074,113.18875299032098,0
2279,32.20637086611307,1,1,173,0.005747126436781609,0.005747126436781609,0.9942528735632183,174,4600,3400,1200,0.7391304347826086,58,34,24,221.7425120236185,0.4044810145505282,0.7618033612675736,0.1504253257241306,1100821.164787322,9419.770073741362,1110240.9348610635,2278,0,1092.7758620689656,70,104,39,32.74402390438247,0.6519345238095238,38.54166666666667,8420.624049369157,120.29462927670224,0
2280,32.36978586659567,0,0,173,0.0,0.0,1.0,173,5350,4200,1150,0.7850467289719626,65,42,23,221.67356395644248,0.40438482995026215,0.7590665909164451,0.150920936843744,1107429.1069210595,9147.551392058405,1116576.658313118,2279,1,1087.0,68,105,38,32.6223764452396,0.6542585784313726,38.42089371980677,8467.259657465342,124.51852437449031,0
2281,32.07050623938605,0,1,172,0.0,0.005780346820809248,0.9942196531791907,173,4750,3400,1350,0.7157894736842105,61,34,27,217.8418611508795,0.403981549939508,0.7553439951508698,0.1489832089456725,1098457.0247542325,8507.984533343913,1106965.0092875764,2280,2,1088.0,68,105,39,32.5683509257657,0.6557904411764706,38.26992753623188,8393.815921984236,123.43846944094466,0
2282,31.704979647312463,0,0,172,0.0,0.0,1.0,172,4950,3300,1650,0.6666666666666666,66,33,33,218.21408548802916,0.40344148080148695,0.7531885529363245,0.14948684547918278,1086399.0312324553,8063.514215094314,1094462.5454475495,2281,3,1093.0290697674418,69,103,38,32.50175269061696,0.6557971014492754,38.21428571428572,8299.910743385743,120.2885614983441,0
2283,31.24915726401333,0,0,172,0.0,0.0,1.0,172,3750,2600,1150,0.6933333333333334,49,26,23,218.72887826980465,0.403025692461127,0.7542645645168415,0.15054685399495393,1072062.7626463154,8748.21710169144,1080810.979748007,2282,4,1094.0290697674418,70,102,42,32.328073074194386,0.6568452380952381,38.057511737089214,8185.482009854694,116.93545728363848,0
2284,31.26268304206497,0,0,172,0.0,0.0,1.0,172,4800,3800,1000,0.7916666666666666,58,38,20,207.78983402830846,0.4027154449431071,0.7391075054019602,0.13435639495142138,1055197.485340194,4651.862069185477,1059849.3474093797,2283,5,1095.0290697674418,79,93,38,34.783543817446805,0.6310654008438819,40.182291666666664,8122.598664340675,102.81770461190727,8
2285,31.084185681924396,0,0,172,0.0,0.0,1.0,172,5400,4300,1100,0.7962962962962963,65,43,22,206.73067464436585,0.4024774468470919,0.7387356603917208,0.13446362183970503,1050830.2834498168,3647.770686862101,1054478.0541366788,2284,6,1096.0290697674418,81,91,35,34.60166389825261,0.6323302469135803,39.977134146341456,8082.599043741225,99.7851733795213,0
2286,30.849302067540286,0,0,172,0.0,0.0,1.0,172,4400,3300,1100,0.75,55,33,22,208.762943453649,0.4020701584387325,0.7406618858873135,0.13629754503466743,1043934.8586651506,4786.982773761225,1048721.8414389119,2285,7,1097.0290697674418,82,90,35,34.415854599835974,0.6332571138211383,39.846887550200805,8025.541949774634,97.87246280212969,0
2287,30.889214591309088,0,0,172,0.0,0.0,1.0,172,4300,2700,1600,0.627906976744186,59,27,32,209.64547983064455,0.4016359535790381,0.7439202978179453,0.1374224795097205,1046395.162913242,5174.403204282248,1051569.5661175242,2286,8,1098.0290697674418,82,90,37,34.251948730311774,0.6346544715447154,39.70883534136545,8040.189641362306,98.0510931873452,0
2288,31.152553735905492,0,0,172,0.0,0.0,1.0,172,4400,3300,1100,0.75,55,33,22,208.07197501351493,0.40190511809238855,0.7420061218524541,0.13654843883880355,1055638.0574860356,5129.739104109694,1060767.7965901452,2287,9,1099.0290697674418,84,88,38,34.25236156224011,0.6343005952380952,39.669117647058805,8109.971801615637,96.5472833525671,0
2289,31.12208680680523,0,1,171,0.0,0.005813953488372093,0.9941860465116279,172,4350,2700,1650,0.6206896551724138,60,27,33,210.5431071792107,0.4017953273040482,0.7426014073506879,0.13868795869152437,1055647.7717670053,5701.872390927163,1061349.6441579324,2288,10,1100.0290697674418,72,100,37,34.0567304004821,0.6407696759259259,39.54052511415526,8106.04238705218,112.58392204239139,0
2290,31.01927778487422,0,0,171,0.0,0.0,1.0,171,4200,3100,1100,0.7380952380952381,53,31,22,211.06559681000806,0.4007195275771127,0.7423844966782176,0.13932160761233287,1052737.0445652246,6039.314519032649,1058776.3590842572,2289,12,1107.4035087719299,72,99,38,33.97026874064338,0.6414930555555556,39.46917808219178,8081.4779365900895,112.2427491193068,0
2291,31.062630412185445,0,1,170,0.0,0.005847953216374269,0.9941520467836258,171,4850,3000,1850,0.6185567010309279,67,30,37,209.92934669321656,0.4007252608645797,0.7399879824623727,0.13889683573171818,1054858.215039153,5239.1391874285,1060097.3542265813,2290,13,1108.4035087719299,74,97,37,33.917896859234006,0.6413288288288288,39.3888888888889,8095.266625753466,109.3954949426144,0
2292,30.706752887757833,0,0,170,0.0,0.0,1.0,170,4750,3100,1650,0.6526315789473685,64,31,33,211.79898486963972,0.39993401206636503,0.7401194901259831,0.14057363189777772,1043630.1144758792,5457.959765075657,1049088.0742409548,2291,14,1112.1470588235295,75,95,37,33.75981319875233,0.6419444444444444,39.281798245614056,8005.809394612569,106.74412526150093,0
2293,31.256860351350774,0,2,168,0.0,0.011764705882352941,0.9882352941176471,170,5550,3900,1650,0.7027027027027027,72,39,33,208.06295647823327,0.39950545306880153,0.7352013369930133,0.13852889067976953,1063200.553427305,4692.53009507605,1067893.083522381,2292,15,1113.1470588235295,78,92,38,33.74776721770051,0.6416933760683761,39.17457805907175,8152.583789689785,104.52030499602289,0
2294,31.39359283166034,0,1,167,0.0,0.005952380952380952,0.9940476190476191,168,4050,3100,950,0.7654320987654321,50,31,19,214.2027613600013,0.3991978839939169,0.7384252252125392,0.14322295341939095,1069032.805150621,8147.9557695382955,1077180.7609201593,2293,17,1124.904761904762,80,88,41,33.44030782371588,0.6423177083333333,39.03034979423869,8192.774939980516,102.40968674975645,0
2295,31.702187488824396,0,0,167,0.0,0.0,1.0,167,4400,3100,1300,0.7045454545454546,57,31,26,215.38040230900808,0.39877774571339253,0.7389942284245203,0.1445410932140842,1080573.4032388143,8746.866862798017,1089320.2701016124,2294,18,1130.5149700598802,82,85,35,33.28216128308662,0.6427845528455285,38.905622489959846,8277.262908101204,100.94223058660005,0
2296,31.891348054000154,0,2,165,0.0,0.011976047904191617,0.9880239520958084,167,4250,2900,1350,0.6823529411764706,56,29,27,214.4215409603683,0.39855229300435274,0.7385508146220003,0.14433879569345645,1087883.2724492985,9003.121532717523,1096886.393982016,2295,19,1131.5149700598802,83,84,37,33.20143735460284,0.6434487951807228,38.80208333333334,8329.953671396424,100.36088760718583,0
2297,32.15720911252956,0,0,165,0.0,0.0,1.0,165,5400,4000,1400,0.7407407407407407,68,40,28,208.96054849100818,0.39860187238236017,0.7252357589113805,0.14134163075381367,1098316.6680776514,7500.970675664665,1105817.6387533161,2296,20,1135.9818181818182,84,81,38,33.17830684109343,0.6447172619047619,38.63970588235295,8404.61763165343,100.05497180539797,0
2298,32.53469053461179,0,0,165,0.0,0.0,1.0,165,5200,3600,1600,0.6923076923076923,68,36,32,231.3550951149049,0.3984340354767184,0.7481204092257705,0.14237916745224247,1083375.6512673236,11928.895368824622,1095304.5466361484,2297,21,1136.9818181818182,77,88,34,35.963266749465234,0.6141774891774892,41.933760683760674,8396.105233584889,109.04032770889467,8
2299,32.91601636885982,2,0,167,0.011976047904191617,0.0,1.0,167,4950,3200,1750,0.6464646464646465,67,32,35,227.05619978656267,0.3997246470913594,0.7485729318028438,0.14095535229296918,1098734.274470816,11544.885787318188,1110279.1602581341,2298,0,1124.3532934131736,67,100,38,35.754048833027056,0.6223569651741294,41.62071078431375,8504.816913197945,126.93756586862604,0
2300,33.191158873752286,0,0,167,0.0,0.0,1.0,167,5250,3600,1650,0.6857142857142857,69,36,33,227.53175782010604,0.3998133251569151,0.7506101826824532,0.1419648967644799,1109466.9470130566,11837.792939437746,1121304.7399524944,2299,1,1125.3532934131736,68,99,34,35.55716120745021,0.6236213235294117,41.440217391304365,8581.898822928111,126.20439445482516,0
2301,32.72405926251029,0,0,167,0.0,0.0,1.0,167,5050,3700,1350,0.7326732673267327,64,37,27,223.8176734582529,0.3998554096626025,0.7469389354155296,0.14029202434118312,1095242.9566650952,10576.94608646419,1105819.9027515594,2300,2,1126.3532934131736,71,96,38,35.48534222445898,0.6236795774647887,41.276041666666686,8466.498145131285,119.24645274832795,0
2302,33.17019353603503,0,0,167,0.0,0.0,1.0,167,4900,3800,1100,0.7755102040816326,60,38,22,223.23278620181358,0.3999020032224707,0.7463580252821795,0.14058009163691532,1111598.685741099,11329.054351252289,1122927.7400923513,2301,3,1127.3532934131736,72,95,42,35.330889783020076,0.6248553240740741,41.11015981735162,8587.426103371685,119.2698069912734,0
2303,33.184641522581735,0,0,167,0.0,0.0,1.0,167,5450,4200,1250,0.7706422018348624,67,42,25,248.99165621264916,0.4002642305749946,0.7782436976186387,0.1548167512375614,1108185.4864139266,16335.787930604944,1124521.2743445316,2302,4,1128.3532934131736,60,107,38,35.12937205409453,0.6274305555555555,41.56420765027324,8576.099125730085,142.93498542883475,8
2304,33.589212221474924,3,0,170,0.01764705882352941,0.0,1.0,170,5150,4100,1050,0.7961165048543689,62,41,21,242.21171992153575,0.4022464903121012,0.776011319641472,0.15227565155518605,1125121.6394666883,15353.52948323304,1140475.1689499214,2303,0,1109.4235294117648,64,106,40,34.90070274286422,0.6287434895833333,41.1698717948718,8693.90010559363,135.84218914990046,0
2305,33.68413819455806,0,0,170,0.0,0.0,1.0,170,4800,3400,1400,0.7083333333333334,62,34,28,237.06632965917603,0.4026163127973083,0.7710781414186405,0.14965807950776808,1129579.709426963,14757.063154265732,1144336.7725812288,2304,1,1110.4235294117648,67,103,42,34.88381836823219,0.6284203980099503,41.02328431372549,8723.407480349242,130.2001116470036,0
2306,33.21836629617316,0,0,170,0.0,0.0,1.0,170,4450,3300,1150,0.7415730337078652,56,33,23,234.0308717612499,0.40260978651815754,0.7682663179385141,0.14819034571688613,1114882.9666606407,13733.406519871804,1128616.3731805126,2305,2,1111.4235294117648,67,103,37,34.85268974556059,0.6295087064676617,40.91605392156863,8606.345422291328,128.45291675061682,0
2307,33.1686514337707,0,0,170,0.0,0.0,1.0,170,4650,3400,1250,0.7311827956989247,59,34,25,239.08442741942517,0.40241327300150825,0.772796396712744,0.1521303467677576,1114693.0450650768,14651.14968555959,1129344.1947506364,2306,3,1112.4235294117648,69,101,40,34.54564152603987,0.630132850241546,40.7440476190476,8599.170316654017,124.6256567631017,0
2308,33.33740077458472,1,0,171,0.005847953216374269,0.0,1.0,171,4200,2400,1800,0.5714285714285714,60,24,36,237.32085640393166,0.40315187478500175,0.7725008568793188,0.15133057207055842,1121012.7771839453,14807.942464208525,1135820.7196481538,2307,0,1106.9122807017543,70,101,42,34.51454891755298,0.6303571428571428,40.669014084507026,8645.421010732938,123.50601443904198,0
2309,32.92829530916861,0,0,171,0.0,0.0,1.0,171,4950,3200,1750,0.6464646464646465,67,32,35,240.02048688537178,0.40299564270152505,0.7751397320566926,0.1535525056500015,1108235.2090719615,14049.830892992713,1122285.0399649541,2308,1,1107.9122807017543,58,113,42,34.32715209254847,0.6391882183908046,40.55437853107344,8543.102040399577,147.29486276550995,0
2310,32.5134053429935,0,0,171,0.0,0.0,1.0,171,5200,4100,1100,0.7884615384615384,63,41,22,240.3670779188543,0.4028451439055154,0.7751068175908673,0.15442460378063233,1095518.7190321048,13265.326659830564,1108784.0456919353,2309,2,1108.9122807017543,61,110,41,34.16681498500635,0.6384904371584699,40.40658602150536,8440.265893054284,138.36501464023416,0
2311,32.85301615081736,0,0,171,0.0,0.0,1.0,171,5800,4500,1300,0.7758620689655172,71,45,26,239.699562783728,0.4027462446967091,0.7747316378731943,0.15481347701595635,1108538.406513351,13143.234274044084,1121681.6407873952,2310,3,1109.9122807017543,61,110,40,33.9949014788945,0.6403688524590163,40.22177419354838,8534.498248050013,139.90980734508219,0
2312,32.58754662648864,1,0,172,0.005813953488372093,0.0,1.0,172,4850,3300,1550,0.6804123711340206,64,33,31,235.45697964522566,0.40359447957749667,0.771234582283642,0.15273143643112305,1100852.3862112388,12590.675578507504,1113443.0617897464,2311,0,1104.453488372093,63,109,43,33.9514193279065,0.640542328042328,40.07161458333333,8470.428379313526,134.4512441160877,0
2313,32.13935393522462,1,2,171,0.005780346820809248,0.011560693641618497,0.9884393063583815,173,4550,3500,1050,0.7692307692307693,56,35,21,232.73931675195138,0.4043876305058924,0.768424402039342,0.15181136485679886,1087323.7483653186,11462.597256542902,1098786.3456218615,2312,0,1099.063583815029,66,107,37,33.8246867093021,0.640625,39.878731343283576,8360.129519437845,126.66862908239159,0
2314,31.941844634789447,1,0,172,0.005813953488372093,0.0,1.0,172,4700,3500,1200,0.7446808510638298,59,35,24,235.0184635631899,0.40351443855115826,0.7720930232558147,0.1539205430378634,1081804.62320074,11748.812084038544,1093553.4352847785,2313,0,1106.4418604651162,66,106,39,33.6221873755476,0.6420454545454546,39.738805970149244,8313.22262416626,125.95791854797362,0
2315,31.752746092946023,0,0,172,0.0,0.0,1.0,172,4350,2800,1550,0.6436781609195402,59,28,31,233.96907324503368,0.40311565007479944,0.7720371959704369,0.15364886668867953,1076171.2786553132,11608.159343981195,1087779.4379992944,2314,1,1107.4418604651162,66,106,40,33.55403280385366,0.6429924242424243,39.645522388059696,8266.969621773527,125.25711548141707,0
2316,31.280764216250603,1,1,172,0.005780346820809248,0.005780346820809248,0.9942196531791907,173,4700,3000,1700,0.6382978723404256,64,30,34,230.25395425843905,0.4041243782766501,0.7697576012924692,0.1519357407511574,1061516.0939624212,9583.655628764242,1071099.7495911855,2315,0,1102.0346820809248,60,113,40,33.48231843209229,0.6486111111111111,39.48087431693991,8149.2373443155975,135.82062240525997,0
2317,31.637063363617628,0,0,172,0.0,0.0,1.0,172,4550,3300,1250,0.7252747252747253,58,33,25,212.64161145124433,0.40352293848315884,0.7487139157585607,0.13521181227667983,1063022.903554727,6258.5806442917965,1069281.484199019,2316,1,1109.3953488372092,79,93,35,35.2558830177307,0.6251318565400844,40.768229166666686,8201.331959717018,103.81432860401289,8
2318,31.163003028419222,2,1,173,0.011494252873563218,0.005747126436781609,0.9942528735632183,174,3950,2700,1250,0.6835443037974683,52,27,25,207.1959920439572,0.4056035866941288,0.7455319527927657,0.13288841263055232,1049538.3372880272,4742.027396511594,1054280.3646845387,2317,0,1097.632183908046,71,103,36,35.08841304792166,0.6318955399061033,40.46585648148148,8087.863300445781,113.9135676119124,0
2319,31.189181630385153,1,0,174,0.005747126436781609,0.0,1.0,174,5000,3500,1500,0.7,65,35,30,210.67562444789093,0.4046388113746595,0.7513782093136998,0.13607523426569496,1052411.8229114201,4543.5035936412305,1056955.3265050615,2318,0,1098.6149425287356,71,103,39,34.74697408479988,0.6343896713615024,40.2199074074074,8102.328491828621,114.11730270181157,0
2320,30.91242200000068,1,0,175,0.005714285714285714,0.0,1.0,175,3700,2400,1300,0.6486486486486487,50,24,26,212.0965029947199,0.40529556650246307,0.7546225867666212,0.13770399470982891,1044518.7660815208,5607.755519650011,1050126.5216011708,2319,0,1093.3314285714287,72,103,34,34.52629267757163,0.6357060185185186,40.03995433789954,8035.994634646281,111.61103659230946,0
2321,31.054005729144777,0,0,175,0.0,0.0,1.0,175,5250,4200,1050,0.8,63,42,21,212.9569383950711,0.40518336070060207,0.755204980886764,0.13858855605043113,1049961.838997091,4469.3317328956455,1054431.1707299866,2320,1,1094.3314285714287,74,101,34,34.420565614484865,0.6355574324324325,39.95833333333332,8075.335406482993,109.12615414166207,0
2322,30.685677509407856,0,0,175,0.0,0.0,1.0,175,5050,3600,1450,0.7128712871287128,65,36,29,212.20350112391847,0.40558018609742746,0.754847025184209,0.13879775828800062,1038902.6873095534,4041.7575148267733,1042944.4448243801,2321,2,1095.3314285714287,77,98,36,34.2617718758019,0.6359577922077921,39.78365384615383,7984.914880753333,103.70019325653679,0
2323,30.695973410891536,0,0,175,0.0,0.0,1.0,175,6050,4400,1650,0.7272727272727273,77,44,33,212.83336914840675,0.40547892720306516,0.7557325618318453,0.13976034895911382,1040338.025476201,3233.7294030600137,1043571.754879261,2322,3,1096.3314285714287,80,95,38,34.10646661727172,0.6360677083333333,39.64763374485595,7991.769312030564,99.89711640038205,0
2324,30.820331528183026,0,1,174,0.0,0.005714285714285714,0.9942857142857143,175,5000,3500,1500,0.7,65,35,30,211.57410703759834,0.4051765188834154,0.7542335789914076,0.13955088575629934,1045775.3950425036,4251.799073601628,1050027.1941161053,2323,4,1097.3314285714287,70,105,40,33.983700345423124,0.6422619047619047,39.49530516431923,8028.841059483785,114.69772942119693,0
2325,30.795512103876302,0,0,174,0.0,0.0,1.0,174,5900,4700,1200,0.7966101694915254,71,47,24,211.83319305985253,0.40521809182114144,0.753575443875709,0.14018968184350353,1045852.1478678173,3609.2399902687416,1049461.387858086,2324,5,1100.9195402298851,71,103,39,33.86000703156801,0.6428990610328639,39.38078703703702,8025.9021273036,113.04087503244507,0
2326,30.910627345018636,0,0,174,0.0,0.0,1.0,174,4450,3100,1350,0.6966292134831461,58,31,27,208.1605784292052,0.4053108320598853,0.7487007751591559,0.13802097214215706,1050284.5611057207,4475.568351006073,1054760.1294567268,2325,6,1101.9195402298851,73,101,39,33.88946262397176,0.6425513698630136,39.31587837837837,8057.909738209451,110.38232518095138,0
2327,30.91514340262127,0,0,174,0.0,0.0,1.0,174,4350,3200,1150,0.735632183908046,55,32,23,207.59435113042417,0.40493848692224216,0.7485640713563009,0.13821472267681026,1051572.7580330945,4510.112874062195,1056082.8709071567,2326,7,1102.9195402298851,73,101,41,33.7605352870275,0.6439783105022832,39.17511261261261,8063.4387965536225,110.458065706214,0
2328,31.466048137995333,0,0,174,0.0,0.0,1.0,174,4800,3300,1500,0.6875,63,33,30,210.1505830619334,0.4050824419196952,0.7519355940043402,0.14029455769017302,1071065.0553142966,5416.989174312074,1076482.0444886086,2327,8,1103.9195402298851,74,100,43,33.600154370275746,0.6444256756756757,39.08333333333332,8210.016393338587,110.94616747754847,0
2329,31.15358476919947,0,1,173,0.0,0.005747126436781609,0.9942528735632183,174,5100,3500,1600,0.6862745098039216,67,35,32,211.95911383402014,0.4049654784842646,0.7468461935047743,0.13905449555924151,1055582.8524925879,4848.081198543121,1060430.933691131,2328,9,1104.9195402298851,85,89,41,34.16251783609403,0.6338235294117647,39.68023255813953,8109.893942098275,95.41051696586206,7
2330,31.517335727724472,0,0,173,0.0,0.0,1.0,173,4750,3200,1550,0.6736842105263158,63,32,31,197.92854993896162,0.40489453107496526,0.7336968090562017,0.1268055849758035,1061158.061895981,2656.695289421979,1063814.757185403,2329,10,1108.4393063583816,68,105,45,35.368064847673914,0.6331188725490196,40.50422705314009,8178.615395891533,120.2737558219343,8
2331,31.60866731098834,1,0,174,0.005747126436781609,0.0,1.0,174,4400,3100,1300,0.7045454545454546,57,31,26,197.69282080810882,0.40590464642437935,0.7326136908620424,0.12718821303318134,1065439.8804342693,2925.963072900933,1068365.8435071702,2330,0,1103.0632183908046,69,105,47,35.22418997401803,0.6340579710144927,40.357142857142854,8206.964691103036,118.94151726236284,0
2332,31.686919507639363,2,0,176,0.011363636363636364,0.0,1.0,176,5100,3400,1700,0.6666666666666666,68,34,34,196.5349516161664,0.40643939393939393,0.7340998293302468,0.1275481729102851,1070571.1982519734,1780.9317300225334,1072352.1299819958,2331,0,1091.5170454545455,72,104,52,34.94538068836805,0.6355613425925926,40.05422374429224,8236.880888565438,114.40112345229775,0
2333,31.5569196112315,1,1,176,0.005649717514124294,0.005649717514124294,0.9943502824858758,177,5000,3800,1200,0.76,62,38,24,198.2879248056408,0.40700035310734467,0.7386673109353448,0.12945734121765298,1067877.762118882,1949.4530793290332,1069827.2151982111,2332,0,1086.3446327683616,74,103,41,34.68870677842437,0.6366835585585586,39.84722222222223,8209.620294971919,110.94081479691782,0
2334,31.41808903425038,0,1,175,0.0,0.005681818181818182,0.9943181818181818,176,4300,3100,1200,0.7209302325581395,55,31,24,199.18601233570024,0.40613771645021646,0.7399528680778678,0.13052925331535703,1064231.2059974198,2895.994025167922,1067127.2000225878,2333,1,1093.5113636363637,76,100,42,34.534173596673604,0.6370614035087719,39.71861471861473,8177.543736728614,107.59925969379755,0
2335,31.48294111777108,0,0,175,0.0,0.0,1.0,175,4600,2900,1700,0.6304347826086957,63,29,34,202.77941945917135,0.4050506294471812,0.7444753583083921,0.13330115608599868,1067312.0618696085,3685.7840575383534,1070997.8459271467,2334,2,1100.7428571428572,75,100,43,34.330587430255804,0.6386111111111111,39.61074561403511,8197.819563533703,109.30426084711604,0
2336,31.671555355124315,1,0,176,0.005681818181818182,0.0,1.0,176,5250,3700,1550,0.7047619047619048,68,37,31,199.26716298681157,0.4059963474025974,0.7418271968115384,0.13199186042962888,1075856.727709497,2426.583582189391,1078283.3112916865,2335,0,1095.4829545454545,66,110,44,34.1562282533055,0.6459911616161615,39.35012437810946,8255.186964064998,125.07859036462119,0
2337,31.879121418527397,0,0,176,0.0,0.0,1.0,176,5100,3300,1800,0.6470588235294118,69,33,36,200.1920483578837,0.4058887987012987,0.7435261420549395,0.133027774764597,1083812.0721802295,3094.1117529526236,1086906.1839331822,2336,1,1096.4829545454545,66,110,44,34.02111157484695,0.6470959595959596,39.24129353233831,8312.758464420744,125.95088582455672,0
2338,31.63985745599867,0,1,175,0.0,0.005681818181818182,0.9943181818181818,176,5050,3400,1650,0.6732673267326733,67,34,33,199.72031983936333,0.406133658008658,0.7414602612955914,0.13341317365269473,1077153.3015018879,2775.8803783966514,1079929.1818802846,2337,2,1097.4829545454545,69,107,47,33.85104790419164,0.6471920289855073,39.0625,8256.02530492465,119.65254065108188,0
2339,31.583570938607718,0,0,175,0.0,0.0,1.0,175,4300,2800,1500,0.6511627906976745,58,28,30,209.63788525220954,0.40566091954022987,0.7500231089200444,0.13648540753982782,1067985.3411496824,5478.037679795454,1073463.3788294778,2338,3,1098.6685714285713,77,98,39,34.492149386329764,0.6343344155844156,39.943910256410234,8213.499958433546,106.66883062900709,8
2340,31.85489678236385,0,0,175,0.0,0.0,1.0,175,5800,4200,1600,0.7241379310344828,74,42,32,211.149969378974,0.4053297755883963,0.7519188943782324,0.13792048179670635,1078097.9148872027,4728.0683431933485,1082825.983230396,2339,4,1099.6685714285713,79,96,40,34.337255809685836,0.6346255274261603,39.83072916666664,8287.665268338636,104.90715529542578,0
2341,32.31016864773361,0,1,174,0.0,0.005714285714285714,0.9942857142857143,175,4750,3500,1250,0.7368421052631579,60,35,25,209.01586822313516,0.40539545703338803,0.7492037184023268,0.13692409035542605,1094349.7540493766,5997.292796480611,1100347.0468458573,2340,5,1100.6685714285713,84,91,40,34.29034435131996,0.6336805555555556,39.73039215686272,8409.354923291186,100.11136813441888,0
2342,32.566145871428716,0,0,174,0.0,0.0,1.0,174,4450,3300,1150,0.7415730337078652,56,33,23,210.74000304699456,0.40460074635129445,0.7509291146682717,0.13849476819961531,1103951.074318357,7279.330553116284,1111230.4048714733,2341,9,1107.9655172413793,83,91,40,34.13329880459111,0.6351656626506024,39.62053571428569,8479.55561585296,102.16332067292723,0
2343,32.128519453685264,0,1,173,0.0,0.005747126436781609,0.9942528735632183,174,5650,4000,1650,0.7079646017699115,73,40,33,211.04516238832443,0.4042048701082985,0.751862436647907,0.1392290747554628,1090219.7909224043,5567.122562836734,1095786.913485241,2342,10,1108.9655172413793,65,109,40,33.99067005937235,0.6451923076923076,39.48863636363636,8369.844414496974,128.7668371461073,0
2344,32.02571225038795,1,0,174,0.005747126436781609,0.0,1.0,174,5600,4300,1300,0.7678571428571429,69,43,26,208.4928058954035,0.40504922153566764,0.7491531457048703,0.13821278059688655,1088114.274787087,4972.799657040359,1093087.0744441273,2343,0,1107.816091954023,67,107,41,33.88798701298705,0.6456778606965174,39.322916666666664,8348.369261103726,124.60252628513024,0
2345,31.76495948240202,0,1,173,0.0,0.005747126436781609,0.9942528735632183,174,4250,3200,1050,0.7529411764705882,53,32,21,204.0810798001491,0.4049710152149359,0.743372828662177,0.13576890997482988,1080257.3495469918,5042.017271519442,1085299.3668185112,2344,1,1108.816091954023,70,104,43,33.879481698169826,0.6452380952380952,39.201877934272304,8284.241780504384,118.34631115006263,0
2346,32.27323732495457,0,0,173,0.0,0.0,1.0,173,4050,2600,1450,0.6419753086419753,55,26,29,205.40223369029383,0.4041201774432048,0.7429035992284332,0.13691710446098626,1098107.1106627844,6460.730672266015,1104567.8413350505,2345,2,1116.0693641618498,71,102,45,33.77660926552421,0.645393192488263,39.134837962962955,8418.963284234003,118.57694766526765,0
2347,32.04000794837749,1,2,172,0.005747126436781609,0.011494252873563218,0.9885057471264368,174,4850,3600,1250,0.7422680412371134,61,36,25,202.2332455065424,0.4048665094235156,0.7384950344465473,0.13547422302750944,1091578.373646601,4500.687445460968,1096079.0610920622,2346,0,1110.6494252873563,75,99,42,33.68759298153497,0.6451388888888889,38.966557017543856,8363.513587950225,111.513514506003,0
2348,32.010721146133655,0,2,170,0.0,0.011627906976744186,0.9883720930232558,172,5150,3700,1450,0.7184466019417476,66,37,29,208.45737960594778,0.4037488950088399,0.7424412808087362,0.14032399445957433,1091955.348358181,5975.230113089314,1097930.5784712704,2347,1,1111.3546511627908,75,97,37,33.35722000664673,0.6468055555555556,38.802083333333336,8361.133674367728,111.48178232490304,0
2349,31.956453195709734,0,0,170,0.0,0.0,1.0,170,5200,3600,1600,0.6923076923076923,68,36,32,206.17956359171595,0.4029078199327068,0.7370489257054089,0.1391946267310036,1090922.9656212765,5785.204192795332,1096708.1698140719,2348,5,1124.3058823529411,76,94,39,33.31661489343346,0.6473410087719298,38.70400432900435,8350.093255886593,109.86964810377097,0
2350,31.99224994421502,0,1,169,0.0,0.0058823529411764705,0.9941176470588236,170,5450,4400,1050,0.8073394495412844,65,44,21,222.0147053607898,0.4025554008585683,0.7576059268772128,0.14169397281669102,1076034.741665865,8329.107225784219,1084363.8488916494,2349,6,1125.3058823529411,77,93,42,34.880144774556776,0.6272997835497836,40.63835470085471,8297.56258235312,107.760553017573,8
2351,32.11497287212727,0,1,168,0.0,0.005917159763313609,0.9940828402366864,169,3750,2800,950,0.7466666666666667,47,28,19,222.16189515052386,0.4019412745374284,0.7577313433557615,0.13698467468856074,1069973.9315443707,9991.48727871081,1079965.4188230815,2350,18,1132.9289940828403,78,91,35,36.12966321022969,0.6144497863247863,41.86445147679325,8290.016138154475,106.28225818146763,8
2352,31.964548087907325,2,0,170,0.011764705882352941,0.0,1.0,170,3600,2400,1200,0.6666666666666666,48,24,24,219.92424351533083,0.40404701821557026,0.7581344181991778,0.13625412688498267,1066379.7879666935,9304.553633722926,1075684.3416004165,2351,0,1117.105882352941,79,91,39,36.01190476190477,0.6157700421940928,41.69270833333334,8256.675845936292,104.51488412577585,0
2353,32.023363709743904,3,0,173,0.017341040462427744,0.0,1.0,173,4800,3700,1100,0.7708333333333334,59,37,22,215.5978049772376,0.40702435363176054,0.7568004936288115,0.13464693103295386,1070712.8147592915,6768.666524620463,1077481.481283912,2352,0,1098.7167630057804,67,106,42,35.83102551191674,0.6245335820895522,41.40624999999999,8281.041709316574,123.59763745248618,0
2354,31.63474167175214,1,0,174,0.005747126436781609,0.0,1.0,174,4850,3400,1450,0.7010309278350515,63,34,29,215.53828367977582,0.40810480477487654,0.7536540945372086,0.13134032360191314,1050488.3035834087,5634.089196009613,1056122.3927794183,2353,0,1093.396551724138,74,100,39,36.73706548100243,0.6119087837837838,42.29166666666668,8152.53655165782,110.16941286024081,8
2355,31.472990226161027,1,1,174,0.005714285714285714,0.005714285714285714,0.9942857142857143,175,4850,3100,1750,0.6391752577319587,66,31,35,211.20714437786592,0.40878626163108917,0.7497092500449616,0.12938473651734064,1046675.7287298328,4363.078350929953,1051038.8070807627,2354,0,1088.142857142857,76,99,38,36.65252570289552,0.6129385964912281,42.0995670995671,8116.897803998031,106.80128689471094,0
2356,31.31665357939465,0,1,173,0.0,0.005747126436781609,0.9942528735632183,174,5600,4000,1600,0.7142857142857143,72,40,32,212.81376270575387,0.40864325183265787,0.7504829373590736,0.13081787178088936,1042480.3726577748,3970.834130439295,1046451.2067882142,2355,1,1082.0229885057472,80,94,39,36.48418809808613,0.6125,41.975308641975296,8080.46987418945,101.00587342736813,0
2357,31.77803059901006,0,1,172,0.0,0.005780346820809248,0.9942196531791907,173,5250,4300,950,0.819047619047619,62,43,19,211.37697052457924,0.4077580992068826,0.7486109475593241,0.13040688509412537,1058911.6013614195,4915.905269821436,1063827.506631241,2356,2,1089.2601156069363,81,92,40,36.38769970147296,0.6134259259259259,41.84451219512194,8203.672990765765,101.27991346624401,0
2358,31.35674297913887,0,0,172,0.0,0.0,1.0,172,5900,4500,1400,0.7627118644067796,73,45,28,209.27242398873491,0.40694699442404464,0.7449881952190922,0.1294318806256746,1045602.0231699698,3463.1339832608705,1049065.1571532306,2357,3,1096.5639534883721,82,90,41,36.35015227357404,0.6139481707317074,41.75451807228915,8097.737202331068,98.75289271135449,0
2359,31.208109836212266,0,1,171,0.0,0.005813953488372093,0.9941860465116279,172,5100,4000,1100,0.7843137254901961,62,40,22,209.32409271088412,0.40680178725236865,0.7460771471076841,0.1298371947956984,1041479.2900878108,4101.3414949613125,1045580.6315827721,2358,4,1097.5639534883721,66,106,43,36.24325489960082,0.6226325757575757,41.651119402985074,8062.580241734126,122.16030669294129,0
2360,31.176584304214376,0,0,171,0.0,0.0,1.0,171,5650,4300,1350,0.7610619469026548,70,43,27,194.88354108612873,0.4071694759775255,0.7274883820793285,0.11259519095246992,1019490.7654642843,-113.60590434223832,1019377.1595599421,2359,5,1102.327485380117,72,99,43,39.27981903061416,0.5928819444444444,44.26369863013701,7972.984359305552,110.73589387924378,8
2361,31.372392628773813,0,0,171,0.0,0.0,1.0,171,5100,3700,1400,0.7254901960784313,65,37,28,194.21675193407324,0.40722824217406256,0.7268168611804025,0.11245766595013287,1026560.9713307807,575.0675028307146,1027136.0388336114,2360,6,1103.327485380117,74,97,37,39.21211339739761,0.5927646396396397,44.180555555555586,8025.668053185973,108.45497369170234,0
2362,31.656872207922575,1,1,171,0.005813953488372093,0.005813953488372093,0.9941860465116279,172,6400,5000,1400,0.78125,78,50,28,197.86455177210223,0.407974069540777,0.7310981399899168,0.11536257760330305,1037969.3637596371,275.4685826952591,1038244.8323423323,2361,0,1097.906976744186,78,94,41,38.85452602852585,0.5936164529914529,43.92141350210973,8106.647087949218,103.93137292242588,8
2363,31.83483970298228,3,0,174,0.017241379310344827,0.0,1.0,174,5250,3800,1450,0.7238095238095238,67,38,29,196.65664853174002,0.41121367904679645,0.7325559689565684,0.11615921618267604,1047764.9354256329,1159.9881299756717,1048924.9235556086,2362,0,1082.287356321839,72,102,43,38.39057285873193,0.6012731481481481,43.4360730593607,8167.671487722841,113.43988177392835,0
2364,31.731532394827916,3,0,177,0.01694915254237288,0.0,1.0,177,4850,3300,1550,0.6804123711340206,64,33,31,193.23289616794872,0.41420829053244307,0.7336084607405897,0.11502470727323177,1046702.9347667391,201.4879024932393,1046904.4226692324,2363,0,1064.9265536723165,77,100,49,38.18583294337855,0.6018668831168832,43.149038461538424,8150.274606700299,105.84772216493894,0
2365,31.258840786877855,2,1,178,0.0111731843575419,0.00558659217877095,0.994413407821229,179,4550,3400,1150,0.7472527472527473,57,34,23,192.38754989433397,0.41552764003096687,0.736465810447793,0.1153812265899612,1033324.2742515526,-590.2549260808173,1032734.0193254718,2364,0,1054.0167597765362,81,98,41,37.92668140572764,0.6030092592592593,42.87347560975608,8037.477087997849,99.2281121975043,0
2366,31.261544997585062,1,1,178,0.00558659217877095,0.00558659217877095,0.994413407821229,179,5450,3700,1750,0.6788990825688074,72,37,35,192.30890701888555,0.4154609461636641,0.7370307909996741,0.1157408732831305,1034452.6430556985,-1463.1085702324272,1032989.5344854661,2365,0,1055.0055865921788,86,93,43,37.79699571814202,0.6024709302325582,42.744252873563205,8042.212114680437,93.51409435674927,0
2367,30.827163731031504,1,0,179,0.00558659217877095,0.0,1.0,179,4800,3700,1100,0.7708333333333334,59,37,22,193.87140427038216,0.41503201305630527,0.7391916163955954,0.1172064387747215,1021382.5963503441,-996.6243496460424,1020385.9720006981,2366,0,1055.9832402234638,72,107,43,37.58926921655578,0.6099537037037037,42.57990867579908,7935.531302908216,110.21571254039189,0
2368,30.710340308905106,2,0,181,0.011049723756906077,0.0,1.0,181,4850,3200,1650,0.6597938144329897,65,32,33,224.77279587883982,0.4172242684673624,0.7746221226218566,0.13015913063681656,1004916.863238403,4125.5945951779395,1009042.4578335809,2367,0,1045.3038674033148,72,109,34,38.42790142049681,0.59375,44.178082191780824,7856.378154367167,109.11636325509954,8
2369,30.77974110182235,2,0,183,0.01092896174863388,0.0,1.0,183,4450,2600,1850,0.5842696629213483,63,26,37,223.35529970173144,0.4190511219199744,0.7759475077502949,0.13001102035302733,1008724.47974346,4010.791697914796,1012735.2714413748,2368,0,1034.8688524590164,75,108,38,38.26472910755393,0.5943055555555555,43.98300438596492,7880.1368426664,105.068491235552,0
2370,31.224742897582164,1,0,184,0.005434782608695652,0.0,1.0,184,4750,3700,1050,0.7789473684210526,58,37,21,225.7620341131115,0.420133939177952,0.7803771205621768,0.1321422004660905,1024968.4585777011,4729.79282205665,1029698.2513997578,2369,0,1030.2391304347825,81,103,40,37.99082796232028,0.5938786008230452,43.77540650406505,8000.5470559481055,98.77218587590254,0
2371,31.75792076983405,2,0,186,0.010752688172043012,0.0,1.0,186,5100,3700,1400,0.7254901960784313,65,37,28,220.48257214355476,0.42251646808098425,0.7780052393376558,0.1296871783868282,1043961.8440798768,3735.078520492087,1047696.9226003689,2370,0,1020.1505376344086,65,121,41,37.938825967417614,0.6035256410256411,43.59217171717172,8142.97949537129,125.27660762109677,0
2372,31.6650238444768,3,0,189,0.015873015873015872,0.0,1.0,189,5450,3800,1650,0.6972477064220184,71,38,33,214.19866281616464,0.4250311925400578,0.7744768187260833,0.12695946442833492,1043219.463107465,1441.242804282932,1044660.7059117479,2371,0,1004.941798941799,72,117,44,37.809332555079955,0.6025752314814814,43.30764840182646,8128.169434050935,112.89124213959632,0
2373,31.994621034345975,1,0,190,0.005263157894736842,0.0,1.0,190,5800,4000,1800,0.6896551724137931,76,40,36,213.60929887443965,0.4251044277360067,0.7746172589001339,0.12718092686512908,1055445.3701939627,1290.5891054808667,1056735.9592994435,2372,0,1000.6473684210526,76,114,46,37.65449166973891,0.6023848684210527,43.141233766233746,8218.09888499897,108.13288006577592,0
2374,31.57454637635451,4,3,191,0.020618556701030927,0.015463917525773196,0.9845360824742269,194,5350,3800,1550,0.7102803738317757,69,38,31,212.83142716761134,0.4272597172515713,0.7788775122087594,0.1279073287581654,1044379.4532579669,305.35390828419986,1044684.8071662511,2373,0,980.9948453608248,81,113,41,37.3231733919428,0.6037808641975309,42.79725609756095,8121.059965473121,100.25999957374223,0
2375,31.900037920681907,1,2,190,0.005208333333333333,0.010416666666666666,0.9895833333333334,192,5900,4400,1500,0.7457627118644068,74,44,30,210.27701086451228,0.4267117964659686,0.7661407945837249,0.12485441046575349,1051495.4751467889,-78.93490971479332,1051416.540237074,2374,0,992.1822916666666,77,115,42,37.843501855126725,0.6009199134199135,43.242521367521356,8190.573304794711,106.37108188045079,8
2376,31.50390555865012,2,3,189,0.010416666666666666,0.015625,0.984375,192,4100,2600,1500,0.6341463414634146,56,26,30,184.44840340836623,0.42679473894706227,0.7329804766734271,0.10955790708472819,1038546.1076015,-4188.365717386054,1034357.741884114,2375,0,993.1354166666666,83,109,47,38.49306964164975,0.598644578313253,43.22916666666666,8089.284083549208,97.46125401866516,8
2377,31.640911902103745,4,2,191,0.02072538860103627,0.010362694300518135,0.9896373056994818,193,5450,3800,1650,0.6972477064220184,71,38,33,178.11805609553102,0.4278175823978123,0.7253723451212035,0.10658751680146948,1045293.2948669038,-6812.878053722773,1038480.416813181,2376,0,985.2020725388601,92,101,33,38.376309062123234,0.5983922101449275,42.95474910394266,8133.146138456332,88.40376237452534,0
2378,32.137179195270726,1,1,191,0.005208333333333333,0.005208333333333333,0.9947916666666666,192,4900,3200,1700,0.6530612244897959,66,32,34,178.42091108009896,0.4276559773123909,0.7267851941057764,0.10726288395994296,1063090.031839181,-5364.50159181627,1057725.5302473647,2377,0,991.328125,94,98,40,38.195835820047186,0.5995124113475176,42.785087719298254,8266.161727660781,87.93789071979555,0
2379,32.13983859518928,0,1,190,0.0,0.005235602094240838,0.9947643979057592,191,5550,3500,2050,0.6306306306306306,76,35,41,184.50420896553115,0.42729861302470834,0.7332937033964142,0.11131078101327009,1064243.3524396613,-4478.524422259395,1059764.828017402,2378,1,997.5026178010471,79,112,42,37.90814949740267,0.6060126582278481,42.65624999999997,8270.986588480671,104.69603276557812,0
2380,32.57678883010257,2,0,192,0.010416666666666666,0.0,1.0,192,4500,3300,1200,0.7333333333333333,57,33,24,182.71319477609737,0.4283246300538104,0.7311624628782414,0.1107102272986762,1080043.157152037,-3432.372852138097,1076610.784299899,2379,0,993.21875,83,109,42,37.7926097600128,0.6060491967871486,42.49751984126981,8388.60391935856,101.06751710070554,0
2381,32.215820506081016,2,0,194,0.010309278350515464,0.0,1.0,194,5450,4200,1250,0.7706422018348624,67,42,25,179.58864864936226,0.4295198796360593,0.7303232449962735,0.10956970648192303,1070157.546075518,-5812.37049167639,1064345.1755838415,2380,0,983.9690721649484,87,107,43,37.61772866437043,0.6071599616858238,42.24668560606058,8303.734511362549,95.44522426853504,0
2382,32.04100049361619,0,1,193,0.0,0.005154639175257732,0.9948453608247423,194,6150,4600,1550,0.7479674796747967,77,46,31,179.89582561104217,0.4295282258782473,0.7311351311332805,0.11011206029159334,1065317.2541735116,-6620.774604553739,1058696.4795689578,2381,1,984.9690721649484,89,105,41,37.49064931178935,0.6076779026217228,42.12962962962961,8262.42466432598,92.83623218343797,0
2383,32.37640751839487,1,3,191,0.005154639175257732,0.015463917525773196,0.9845360824742269,194,5600,4100,1500,0.7321428571428571,71,41,30,193.01446970952796,0.42937521143813545,0.7390590587885579,0.12113869362145632,1083987.8944514962,-2554.930276179143,1081432.964175317,2382,0,985.8865979381443,85,109,46,36.23599669225488,0.6181372549019608,41.23062015503877,8378.022895142813,98.56497523697426,7
2384,32.16204628218769,1,2,190,0.005208333333333333,0.010416666666666666,0.9895833333333334,192,5400,4100,1300,0.7592592592592593,67,41,26,192.55602822097478,0.42815476839732397,0.7377538618253572,0.12164066081935393,1078735.0131299286,-2256.6140737597934,1076478.3990561687,2383,0,996.6979166666666,88,104,38,36.012321689487415,0.619436553030303,40.99953183520601,8329.985044224422,94.6589209570957,0
2385,32.652034479870416,0,2,188,0.0,0.010526315789473684,0.9894736842105263,190,6100,4500,1600,0.7377049180327869,77,45,32,209.04841207947956,0.42718718091525104,0.7569647760311682,0.12859439567350583,1087148.5532552693,1353.3357505032127,1088501.8890057725,2384,1,1008.1,91,99,37,36.55522830649523,0.6088598901098901,41.94972826086955,8425.866370365968,92.59193813588975,8
2386,32.532659916225626,0,1,187,0.0,0.005319148936170213,0.9946808510638298,188,5750,4200,1550,0.7304347826086957,73,42,31,210.30307636645728,0.4259579919975727,0.7576371434416658,0.1297463047413392,1084061.9959409016,2246.3145436664036,1086308.310484568,2385,2,1019.7872340425532,93,95,39,36.4148709363553,0.6093189964157706,41.84397163120566,8398.502276245445,90.30647608866069,0
2387,32.0354133729878,0,0,187,0.0,0.0,1.0,187,4850,3700,1150,0.7628865979381443,60,37,23,207.46618106139434,0.42500071876257833,0.7556494738657933,0.12862903225806457,1068959.453175045,2104.5870919406334,1071064.0402669858,2386,3,1026.1764705882354,85,102,40,36.30712365591401,0.6137254901960785,41.66666666666667,8275.815121355188,97.3625308394728,0
2388,32.223571846236254,0,0,187,0.0,0.0,1.0,187,4600,3400,1200,0.7391304347826086,58,34,24,203.29533325607966,0.42489530025108774,0.7493175890563404,0.12637652948880307,1076026.377653073,1750.228207463133,1077776.6058605362,2387,4,1027.1764705882354,76,111,41,36.318248442652994,0.6182839912280702,41.571969696969724,8327.474201551084,109.57202896777741,0
2389,32.64983556409375,1,0,188,0.005319148936170213,0.0,1.0,188,4900,3500,1400,0.7142857142857143,63,35,28,199.01695842366416,0.4253636174005386,0.7448045286744909,0.12135475942615395,1084402.5544683582,662.8996194285437,1085065.4540877866,2388,0,1022.7074468085107,84,104,40,37.13783621003914,0.6080109126984127,42.267156862745075,8414.934947897676,100.17779699878186,8
2390,32.45910518828854,0,0,188,0.0,0.0,1.0,188,5450,3800,1650,0.6972477064220184,71,38,33,195.57245100740732,0.4252622833466075,0.7397607420873378,0.11955553060320837,1078833.3598352256,-851.9831176940479,1077981.3767175316,2389,1,1023.7074468085107,87,101,44,37.133329124772345,0.6078783524904214,42.17566287878786,8368.747278718136,96.1924974565303,0
2391,32.4460493553851,0,1,187,0.0,0.005319148936170213,0.9946808510638298,188,5200,3600,1600,0.6923076923076923,68,36,32,196.74713777432856,0.42521013482762543,0.7432906024989738,0.1206431113597835,1079328.6541116782,-329.0353171421748,1078999.618794536,2390,2,1024.7074468085107,88,100,35,36.98980170614389,0.6086647727272727,42.06460674157301,8368.984500163517,95.10209659276724,0
2392,32.09213980135069,2,0,189,0.010582010582010581,0.0,1.0,189,5250,3700,1550,0.7047619047619048,68,37,31,196.8306682195399,0.4262050170738114,0.7484183181553361,0.12129911827500348,1069049.961618556,-965.6363389095486,1068084.3252796463,2391,0,1010.0370370370371,90,99,40,36.80364613360529,0.6098379629629629,41.88415750915749,8283.489702159479,92.03877446843866,0
2393,31.636782080438138,1,0,190,0.005263157894736842,0.0,1.0,190,5900,4900,1000,0.8305084745762712,69,49,20,196.18307825946562,0.4268477907732294,0.7506150553393429,0.12155920456697714,1055478.6808205445,-2486.5886718773636,1052992.0921486672,2392,0,1005.7157894736843,94,96,42,36.620963862240686,0.6105939716312057,41.688596491228054,8172.141581699097,86.93767640105422,0
2394,32.00199031696638,0,0,190,0.0,0.0,1.0,190,5700,4000,1700,0.7017543859649122,74,40,34,198.8813627151505,0.4268547526222965,0.7543369439180965,0.12378535652605255,1068992.7190060471,-1179.4542623004772,1067813.2647437467,2393,1,1006.7157894736843,74,116,42,36.38724699982092,0.6196509009009009,41.5277777777778,8271.625552760388,111.77872368595119,0
2395,32.22872714249311,0,0,190,0.0,0.0,1.0,190,5250,3700,1550,0.7047619047619048,68,37,31,211.7293218337535,0.42693655434883504,0.7652992475101632,0.12562946249160814,1062117.0749471372,1726.2655973217543,1063843.340544459,2394,2,1007.7157894736843,79,111,39,37.83246479349463,0.5998154008438819,43.268229166666686,8274.138190996617,104.7359264683116,8
2396,32.04944106307778,1,0,191,0.005235602094240838,0.0,1.0,191,5150,3600,1550,0.6990291262135923,67,36,31,216.76039163575152,0.42742491044364844,0.7724117514320772,0.12959504265882188,1058517.2164092804,2538.9212764123085,1061056.1376856926,2395,0,1003.434554973822,81,110,39,37.41679847106891,0.6018518518518519,42.987804878048784,8237.097200053238,101.69255802534862,0
2397,31.81271128538652,1,0,192,0.005208333333333333,0.0,1.0,192,5700,4100,1600,0.7192982456140351,73,41,32,224.83898301269363,0.427995132526178,0.782715339970784,0.1353159384002993,1052683.9618383714,3236.878282702304,1055920.8401210736,2396,0,999.203125,84,108,42,36.961004986026396,0.6031746031746033,42.74509803921567,8183.975922828801,97.42828479558096,0
2398,31.98925276496375,1,0,193,0.0051813471502590676,0.0,1.0,193,5550,4200,1350,0.7567567567567568,69,42,27,224.7582222615366,0.4292680897380541,0.7828304596372258,0.13597144288435503,1060089.485066249,3502.7656203275023,1063592.2506865766,2397,0,995.020725388601,67,126,42,36.76886231107939,0.6128731343283582,42.55514705882353,8235.468473774215,122.91743990707785,0
2399,32.39253508926005,1,1,193,0.005154639175257732,0.005154639175257732,0.9948453608247423,194,4350,3100,1250,0.7126436781609196,56,31,25,225.01809610784557,0.42984148816836704,0.7838579949745208,0.13681848225947907,1074990.9345687008,5228.48268596833,1080219.4172546691,2398,0,990.8865979381443,70,124,44,36.57377088078966,0.6130952380952381,42.37089201877933,8345.259920296428,119.21799886137755,0
2400,32.41722424775258,1,1,193,0.005154639175257732,0.005154639175257732,0.9948453608247423,194,5250,3400,1850,0.6476190476190476,71,34,37,242.79643752831,0.43007907786264976,0.8015547463405481,0.14204879329645698,1063972.5497250927,7615.748940233104,1071588.2986653259,2399,0,991.8453608247422,73,121,38,37.571596340860374,0.5971746575342466,43.79222972972973,8305.54474286804,113.77458551874027,8
2401,32.71862657898344,2,0,195,0.010256410256410256,0.0,1.0,195,6650,4900,1750,0.7368421052631579,84,49,35,235.31655028472838,0.43085844567803333,0.7967096186385534,0.13879449223380644,1076403.4516260482,5009.109390243124,1081412.5610162914,2400,0,987.7384615384616,63,132,40,37.45346869712353,0.6058201058201058,43.48958333333332,8392.66853653609,133.21696089739825,0
2402,32.57640069767975,0,0,195,0.0,0.0,1.0,195,5950,4500,1450,0.7563025210084033,74,45,29,238.403766241363,0.4310655123799454,0.7975564961731563,0.14136482894333824,1073373.5783325154,6229.260731688068,1079602.8390642034,2401,1,988.7384615384616,65,130,40,37.17228968131978,0.6065705128205128,43.29229797979798,8362.612963190677,128.65558404908734,0
2403,32.52086042277539,2,2,195,0.01015228426395939,0.01015228426395939,0.9898477157360406,197,6850,5400,1450,0.7883211678832117,83,54,29,239.59697268747476,0.4321432887875962,0.7987476163464948,0.14296632990377256,1073480.0150907398,5190.512371248868,1078670.5274619886,2402,0,979.6903553299493,70,127,36,36.90425207940764,0.6061011904761905,43.06044600938965,8355.895372418754,119.36993389169649,0
2404,32.05380457337598,2,0,197,0.01015228426395939,0.0,1.0,197,5650,4100,1550,0.7256637168141593,72,41,31,238.99310750787316,0.43212818122172725,0.7999481825158232,0.14364290639644547,1060258.955876674,5628.916525603698,1065887.8724022778,2403,0,980.5837563451777,72,125,38,36.64690245030048,0.6077835648148149,42.79394977168948,8244.432469108162,114.50600651539114,0
2405,32.06113457368948,1,2,196,0.005050505050505051,0.010101010101010102,0.98989898989899,198,4500,2600,1900,0.5777777777777777,64,26,38,236.91215818697268,0.43265619391888427,0.7987211594049737,0.1428501135564484,1061471.9611574863,6195.122634555733,1067667.083792042,2404,0,976.6262626262626,64,134,39,36.579970314089394,0.6134440104166667,42.67628205128205,8250.090350155962,128.9076617211869,0
2406,32.198439148115774,1,0,197,0.005076142131979695,0.0,1.0,197,5300,3600,1700,0.6792452830188679,70,36,34,236.56582365576486,0.43269579405366204,0.794701102995899,0.14353595067211716,1067910.749579335,5826.237213016018,1073736.9867923511,2405,0,982.0558375634517,67,130,41,36.35511459386584,0.6139614427860697,42.44791666666666,8292.775082678758,123.77276242804116,0
2407,32.30246007675132,1,0,198,0.005050505050505051,0.0,1.0,198,5200,3500,1700,0.6730769230769231,69,35,34,228.95114135574454,0.4334883308550821,0.7890192621201626,0.1398571781680859,1073404.4879176007,4351.436529022618,1077755.9244466233,2406,0,978.0909090909091,69,129,43,36.300075040406355,0.6153381642512077,42.20238095238095,8327.497297167256,120.6883666256124,0
2408,31.912228656187025,1,1,198,0.005025125628140704,0.005025125628140704,0.9949748743718593,199,5300,3700,1600,0.6981132075471698,69,37,32,227.33975979379477,0.43444177960509617,0.7891330108022729,0.139374595515948,1061512.0568439537,3164.779204224198,1064676.836048178,2407,0,974.1708542713568,71,128,37,36.208024829855646,0.6156103286384976,42.07175925925925,8231.06499540656,115.93049289305013,0
2409,31.971362770564422,1,0,199,0.005025125628140704,0.0,1.0,199,4600,2700,1900,0.5869565217391305,65,27,38,231.35200654951984,0.43455175710200833,0.7882121433776175,0.1358691990082419,1050503.27201595,4207.207973545166,1054710.4799894951,2408,0,975.1658291457286,72,127,37,37.719408108358834,0.5991030092592593,43.65011415525114,8195.855196535236,113.8313221741005,8
2410,31.864157669739864,0,2,197,0.0,0.010050251256281407,0.9899497487437185,199,5200,3400,1800,0.6538461538461539,70,34,36,230.48771786275012,0.43429161802277383,0.7880125122036428,0.13590827501562194,1048207.3137234736,3319.7823174335927,1051527.096040907,2409,1,976.1658291457286,74,125,36,37.58799003682045,0.5996621621621622,43.50000000000001,8173.156442288293,110.44806003092287,0
2411,31.903880629659927,1,1,197,0.005050505050505051,0.005050505050505051,0.9949494949494949,198,5900,4100,1800,0.6949152542372882,77,41,36,226.7363096644028,0.43420777145396433,0.7834314223058623,0.13462730974699882,1051622.1392941163,2188.1846049866454,1053810.3238991029,2410,0,981.7727272727273,77,121,37,37.420897049134844,0.6009199134199135,43.24252136752138,8191.559949063084,106.3838954423777,0
2412,31.617808999041,3,0,200,0.015,0.0,1.0,200,6200,4500,1700,0.7258064516129032,79,45,34,218.5360255172447,0.4353376256281407,0.7772315484804624,0.13085649361561247,1044718.6361418342,-538.2682947531976,1044180.367847081,2411,0,972.725,83,117,35,37.31367583212737,0.6016566265060241,42.931547619047635,8127.94122706006,97.92700273566336,0
2413,31.800830252543616,1,2,199,0.004975124378109453,0.009950248756218905,0.9900497512437811,201,5250,3800,1450,0.7238095238095238,67,38,29,218.66006824337646,0.4359276533996683,0.7808312405855269,0.13155731073113922,1052199.782538287,564.8152510979089,1052764.5977893851,2412,0,968.8805970149253,86,115,37,37.1313319370103,0.6023498062015504,42.75622605363987,8180.56558879197,95.12285568362756,0
2414,31.629272106101844,0,0,199,0.0,0.0,1.0,199,6300,4100,2200,0.6507936507936508,85,41,44,220.22024452843755,0.43496100028763346,0.7817387275434375,0.1330782350114676,1047829.7556876398,50.66500434091904,1047880.4206919807,2413,1,969.0603015075377,73,126,37,36.927157388165824,0.6093036529680365,42.59572072072072,8141.5099905993575,111.52753411779942,0
2415,32.11214408845723,1,1,199,0.005,0.005,0.995,200,4850,3200,1650,0.6597938144329897,65,32,33,220.07748012967167,0.4348926926298158,0.7826310536821091,0.13351928192188295,1065020.6701183957,2027.4130731340856,1067048.0831915298,2414,0,965.21,76,124,40,36.78323178204994,0.609375,42.4512987012987,8270.44100589892,108.82159218288052,0
2416,31.90681943152345,0,1,198,0.0,0.005025125628140704,0.9949748743718593,199,4450,2600,1850,0.5842696629213483,63,26,37,223.5032323507884,0.43459722856707783,0.7843027159953087,0.13595078441778233,1058989.2620507688,3087.504618624618,1062076.7666693935,2415,1,971.0201005025126,76,123,40,36.59818850091885,0.6103344298245614,42.35660173160173,8220.58138627386,108.16554455623499,0
2417,31.838884406296973,2,1,199,0.01,0.005,0.995,200,5450,3800,1650,0.6972477064220184,71,38,33,225.09413038833827,0.4349408500837521,0.788934972484475,0.13790409652340876,1058870.4038414336,2219.102549327112,1061089.5063907607,2416,0,966.84,79,121,40,36.29109447838308,0.6116824894514767,42.09635416666666,8211.364367650032,103.94132110949408,0
2418,31.40178193746368,2,1,200,0.009950248756218905,0.004975124378109453,0.9950248756218906,201,5700,3800,1900,0.6666666666666666,76,38,38,225.5468067343374,0.4354798922056385,0.7911836431627126,0.139173082327637,1046425.0799057288,1303.5670518919069,1047728.6469576207,2417,0,955.9303482587064,84,117,35,36.015479129086366,0.6123511904761905,41.83823529411763,8106.739439884882,96.5088028557724,0
2419,31.570920014985333,0,1,199,0.0,0.005,0.995,200,5100,3600,1500,0.7058823529411765,66,36,30,228.56295483633372,0.43511254187604687,0.7941438469934987,0.14127456794826532,1052560.8659455604,3015.2843331212716,1055576.1502786817,2418,1,961.695,84,116,36,35.87493869931816,0.6129712301587302,41.77696078431371,8152.33891710481,97.05165377505726,0
2420,31.232536474770413,0,0,199,0.0,0.0,1.0,199,6650,4600,2050,0.6917293233082706,87,46,41,225.93278866626,0.43438573338070824,0.7915252247892328,0.1413665850466862,1044812.1281528516,761.4635491808231,1045573.5917020324,2419,2,967.4974874371859,69,130,41,35.4952920645879,0.6240942028985508,41.33928571428573,8078.63019351877,117.08159700751841,7
2421,30.926591070875194,0,3,196,0.0,0.01507537688442211,0.9849246231155779,199,5000,3100,1900,0.62,69,31,38,226.94323716218932,0.43447879126271083,0.7934507847360845,0.1425080726345275,1035597.0703514025,2204.350308245589,1037801.4206596481,2420,3,968.4974874371859,70,129,43,35.33883251129127,0.6248511904761904,41.21185446009392,8003.435151102853,114.33478787289789,0
2422,30.769523911691167,3,5,194,0.01507537688442211,0.02512562814070352,0.9748743718592965,199,5600,4200,1400,0.75,70,42,28,221.24977584496216,0.4349483105764513,0.7870128533623979,0.1400397715926744,1032578.7150294879,291.5618485111181,1032870.276877999,2421,0,969.3266331658291,74,125,34,35.19864990439429,0.6257038288288288,40.930555555555586,7971.443465621952,107.72220899489125,0
2423,30.385267438630095,0,0,194,0.0,0.0,1.0,194,6100,4600,1500,0.7540983606557377,76,46,30,225.2075214879264,0.4319564259387853,0.787887763755347,0.1425518235165889,1019697.3151176563,1028.701001108081,1020726.0161187643,2422,5,994.9587628865979,71,123,36,35.09434159825763,0.6272007042253521,40.92881944444444,7871.947106822182,110.87249446228425,0
2424,30.79982588282211,0,2,192,0.0,0.010309278350515464,0.9896907216494846,194,5200,3300,1900,0.6346153846153846,71,33,38,225.1634838584772,0.43166875879137506,0.7875155003065073,0.14312687453413436,1034798.5381856101,2599.768789906474,1037398.3069755166,2423,6,995.9587628865979,73,121,40,34.94315096388813,0.6277111872146119,40.779842342342356,7983.9357211735805,109.36898248182987,0
2425,31.106593337115537,2,1,193,0.010309278350515464,0.005154639175257732,0.9948453608247423,194,5200,3600,1600,0.6923076923076923,68,36,32,222.40427953634236,0.4312397619429162,0.7852785574771386,0.14226020127645583,1046879.452974305,2566.0941000298308,1049445.547074335,2424,0,996.2268041237113,63,131,43,34.789836888331244,0.6355820105820106,40.559895833333314,8070.2978156513545,128.09996532779928,0
2426,31.301799239109695,1,0,194,0.005154639175257732,0.0,1.0,194,6050,4100,1950,0.6776859504132231,80,41,39,214.33656885961878,0.4312731469116678,0.7753083940128838,0.13767341432727473,1054637.0366329642,359.4567648370944,1054996.4933978012,2425,0,997.1855670103092,68,126,43,34.84976252786661,0.6340379901960784,40.41364734299517,8125.519896082295,119.49293964826904,0
2427,31.13000926714448,0,1,193,0.0,0.005154639175257732,0.9948453608247423,194,5300,3600,1700,0.6792452830188679,70,36,34,213.3003892652805,0.431176330502288,0.7746213301479259,0.13744558392372466,1049749.544701516,682.3973031766982,1050431.9420046927,2426,1,998.1855670103092,70,124,41,34.7628665047172,0.634077380952381,40.30223004694834,8084.393985295217,115.49134264707453,0
2428,31.316385467779675,4,1,196,0.02030456852791878,0.005076142131979695,0.9949238578680203,197,5750,3900,1850,0.6782608695652174,76,39,37,204.95272982422742,0.43171056493663457,0.7691348373363198,0.133260875075157,1058581.9503443115,-1758.1479068558538,1056823.8024374556,2427,0,983.8121827411168,76,121,36,34.66018470343392,0.6343201754385965,39.98917748917748,8142.59914354334,107.13946241504395,0
2429,31.042591897082595,0,0,196,0.0,0.0,1.0,196,5850,4200,1650,0.717948717948718,75,42,33,208.21709765223335,0.431119178440607,0.7701765619465424,0.13561270099262776,1049800.1722159004,-1332.7310052783396,1048467.4412106221,2428,1,989.8316326530612,77,119,36,34.515465064530474,0.634469696969697,39.930555555555536,8073.229628789834,104.84713803623161,0
2430,31.20885780461307,0,1,195,0.0,0.00510204081632653,0.9948979591836735,196,4400,2600,1800,0.5909090909090909,62,26,36,214.62395022968414,0.43098944706087566,0.779211519618572,0.13736386085977959,1050487.2119964676,1491.9430208897352,1051979.1550173573,2429,2,990.8316326530612,72,124,38,34.97073731874091,0.6306423611111112,40.539383561643824,8097.469484321888,112.4648539489151,8
2431,31.627827203743415,0,0,195,0.0,0.0,1.0,195,5750,4200,1550,0.7304347826086957,73,42,31,212.15870113735403,0.43031985196933653,0.7741492453051697,0.13633563607963717,1065750.4625323191,471.64677347822135,1066222.1093057974,2430,3,996.8923076923077,77,118,37,34.89028713754134,0.6297348484848485,40.397970085470085,8210.648143877777,106.63179407633477,0
2432,31.479921497680976,0,1,194,0.0,0.005128205128205128,0.9948717948717949,195,6000,4200,1800,0.7,78,42,36,211.7927894693226,0.430069829940964,0.7726146081989063,0.13658683386823778,1061784.4977990764,-24.3398791697864,1061760.1579199065,2431,4,997.8923076923077,79,116,37,34.77261618288464,0.6301424050632911,40.273437500000014,8176.171798362568,103.49584554889326,0
2433,31.72270701021271,1,2,193,0.005128205128205128,0.010256410256410256,0.9897435897435898,195,5700,4100,1600,0.7192982456140351,73,41,32,213.94674299965067,0.42987047316944227,0.7756627811246151,0.13882842748802313,1071739.6363304325,1159.0409073050223,1072898.6772377375,2432,0,998.5487179487179,80,115,38,34.49780669206289,0.6319010416666666,40.05915637860081,8246.027222189128,103.0753402773641,0
2434,31.260311421351613,0,0,193,0.0,0.0,1.0,193,5050,3900,1150,0.7722772277227723,62,39,23,214.40482104046623,0.429329933074266,0.7743286868177128,0.13947420681750114,1056822.9468192316,1667.586956847052,1058490.5337760786,2433,1,1009.5544041450777,82,111,36,34.39727222999823,0.6319867886178862,39.972389558232926,8128.544080559522,99.12858634828685,0
2435,31.045205557220598,0,2,191,0.0,0.010362694300518135,0.9896373056994818,193,5850,4500,1350,0.7692307692307693,72,45,27,213.4264461174897,0.42942550913932065,0.7734359756112636,0.13930491557724595,1050489.3843638645,390.4431977856575,1050879.8275616502,2434,2,1010.5544041450777,83,110,37,34.30399307210729,0.632781124497992,39.856150793650784,8076.219273057683,97.30384666334557,0
2436,31.14579016903523,0,2,189,0.0,0.010471204188481676,0.9895287958115183,191,5600,4200,1400,0.75,70,42,28,213.47264876517946,0.42869132910811064,0.7726247932192982,0.13994896955349914,1055122.3442531321,1247.952319808318,1056370.2965729404,2435,3,1021.8010471204188,85,106,39,34.14785946952069,0.633578431372549,39.70445736434108,8107.1103528653875,95.37776885723986,0
2437,31.440157680750094,0,0,189,0.0,0.0,1.0,189,5500,3400,2100,0.6181818181818182,76,34,42,211.7906191560458,0.4276192352433487,0.7696430952244897,0.13939630033282974,1066207.917761552,1862.567010359271,1068070.4847719113,2436,4,1033.0740740740741,69,120,40,34.05275650915183,0.6420591787439613,39.56845238095236,8188.008922184593,118.66679597368974,0
2438,31.95593064056627,0,1,188,0.0,0.005291005291005291,0.9947089947089947,189,4650,3300,1350,0.7096774193548387,60,33,27,209.28815951844214,0.427506660662689,0.7674205225429613,0.13821307168198071,1084658.9681053802,2951.2558279893537,1087610.2239333696,2437,5,1034.0740740740741,71,118,39,34.00018740629683,0.6421654929577465,39.453124999999986,8326.01786611626,117.26785726924311,0
2439,31.48518382511621,1,0,189,0.005291005291005291,0.0,1.0,189,5400,4200,1200,0.7777777777777778,66,42,24,208.94542779956964,0.4275723291680738,0.7675677381685042,0.1389220733840198,1070575.7404254586,1538.3812150076715,1072114.1216404664,2438,0,1032.6878306878307,74,115,39,33.77338978838231,0.6430180180180181,39.222222222222214,8210.636270838626,110.95454420052197,0
2440,31.711620444304486,0,0,189,0.0,0.0,1.0,189,4500,2800,1700,0.6222222222222222,62,28,34,207.41293806221162,0.427790442418102,0.7658657457475262,0.1384140457947335,1079316.577464445,2472.8444862300767,1081789.421950675,2439,1,1033.6878306878307,76,113,43,33.684840471499164,0.6433662280701755,39.09632034632033,8273.678461699863,108.86419028552451,0
2441,31.9908634725334,1,0,190,0.005263157894736842,0.0,1.0,190,4800,3100,1700,0.6458333333333334,65,31,34,207.1620294793513,0.4282343590457625,0.7663767755184603,0.13877804865913726,1089908.2983390351,2357.523006059939,1092265.821345095,2440,0,1029.2421052631578,80,110,43,33.558417085427116,0.64296875,38.96604938271604,8350.701475893524,104.38376844866904,0
2442,31.92505583287743,0,4,186,0.0,0.021052631578947368,0.9789473684210527,190,6700,5100,1600,0.7611940298507462,83,51,32,227.28899592319388,0.42812412976886666,0.7865896004025168,0.14600603961009959,1075661.8907953617,4197.222222344189,1079859.113017706,2441,1,1030.2421052631578,67,123,36,34.51035642629527,0.634639303482587,40.410539215686256,8287.408029165726,123.69265715172726,8
2443,32.40233704086438,0,0,186,0.0,0.0,1.0,186,4700,3000,1700,0.6382978723404256,64,30,34,225.8875001231802,0.4270070473699506,0.7810100850988824,0.145532463562507,1092605.9936408973,7461.20730462893,1100067.2009455264,2442,10,1049.0913978494623,68,118,40,34.44185269154751,0.6351102941176471,40.30797101449274,8414.628650014305,123.7445389707986,0
2444,32.67262173529749,2,0,188,0.010638297872340425,0.0,1.0,188,5000,3500,1500,0.7,65,35,30,221.2094857863837,0.4281986005233815,0.7757715576000745,0.1434390094638469,1103622.2259760776,6226.341022118361,1109848.566998196,2443,0,1038.9202127659576,76,112,39,34.334283211020306,0.6333607456140351,40.083874458874455,8492.141252709276,111.73870069354311,0
2445,32.9191467016265,0,0,188,0.0,0.0,1.0,188,5600,4000,1600,0.7142857142857143,72,40,32,217.9759063090757,0.42798941385064665,0.7717332106837929,0.14178392200225864,1112875.5849502934,5316.012847756567,1118191.59779805,2444,1,1039.9202127659576,76,112,43,34.30774500112723,0.6344572368421053,39.97564935064935,8559.779745021142,112.62868085554135,0
2446,33.226229827717816,0,1,187,0.0,0.005319148936170213,0.9946808510638298,188,5750,4300,1450,0.7478260869565218,72,43,29,219.76824602215527,0.42777548640345886,0.7739911481523687,0.14344167877414707,1124284.2399426952,6066.395088511576,1130350.6350312068,2445,2,1040.9202127659576,79,109,32,34.13964871448353,0.6343618143459915,39.856770833333336,8643.578720416335,109.41238886602956,0
2447,33.51655414607012,0,3,184,0.0,0.016042780748663103,0.983957219251337,187,5300,4000,1300,0.7547169811320755,66,40,26,218.83622582474806,0.4278218618825829,0.7719653318209039,0.1431135162681947,1134698.1689129854,6962.61294703389,1141660.7818600193,2446,3,1046.326203208556,80,107,33,34.09473740568678,0.6346354166666667,39.789094650205755,8721.37289855429,109.01716123192861,0
2448,33.70084584303906,0,0,184,0.0,0.0,1.0,184,4750,3200,1550,0.6736842105263158,63,32,31,220.63447395226046,0.4265518581214857,0.7708123020155258,0.1442787738043838,1140914.7833330452,8795.026609008743,1149709.8099420539,2447,15,1063.0760869565217,79,105,34,34.050573792367246,0.6350210970464135,39.791666666666664,8769.24092874078,111.00304973089597,0
2449,33.38391943588567,0,0,184,0.0,0.0,1.0,184,5250,3800,1450,0.7238095238095238,67,38,29,222.524669330829,0.42642502177872815,0.7729401473118496,0.1459061170043829,1130989.9710824226,8284.633866319857,1139274.6049487425,2448,16,1064.0760869565217,80,104,36,33.90673632725658,0.635546875,39.69907407407407,8689.865140197538,108.62331425246923,0
2450,32.96165363410064,0,1,183,0.0,0.005434782608695652,0.9945652173913043,184,5550,4200,1350,0.7567567567567568,69,42,27,223.5049161649878,0.4258440494575117,0.7761139354449353,0.14717391884729242,1117940.5983318752,7623.043941519914,1125563.642273395,2449,17,1065.0760869565217,67,117,39,33.73157079559266,0.6433457711442786,39.55269607843133,8584.773821798,128.13095256414925,0
2451,33.29302421401739,0,1,182,0.0,0.00546448087431694,0.994535519125683,183,5400,4200,1200,0.7777777777777778,66,42,24,223.1873823742465,0.42529499189335257,0.7748116484470506,0.14753621188204627,1130333.5047655683,8455.235227706686,1138788.739993275,2450,18,1071.4918032786886,69,114,38,33.60381807625682,0.6435688405797102,39.41964285714283,8675.508140054386,125.73200202977371,0
2452,33.18056868897877,0,0,182,0.0,0.0,1.0,182,5450,3700,1750,0.6788990825688074,72,37,35,223.60083149265844,0.42475664298868715,0.7736369477126899,0.1484352027066127,1127764.448402415,8583.813678127695,1136348.2620805427,2451,19,1078.2527472527472,70,112,39,33.44540731153752,0.6444940476190476,39.275234741784026,8650.99598256807,123.58565689382958,0
2453,32.70247264017289,0,0,182,0.0,0.0,1.0,182,5100,3900,1200,0.7647058823529411,63,39,24,224.99501910741714,0.42452011616376256,0.7739503507598058,0.1498245520679218,1112416.122827441,8557.617362191439,1120973.7401896324,2452,20,1079.2527472527472,72,110,38,33.30096467713404,0.64453125,39.16952054794518,8529.801618003945,118.46946691672146,0
2454,32.88788248175861,0,0,182,0.0,0.0,1.0,182,5250,3600,1650,0.6857142857142857,69,36,33,225.51006583367717,0.42405971100722484,0.7739198740369704,0.15067151909257165,1119700.897726855,8850.764632081959,1128551.6623589369,2453,21,1080.2527472527472,74,108,37,33.17099567099565,0.6447072072072072,39.05555555555554,8581.910223156648,115.97175977238714,0
2455,33.26405937097159,0,0,182,0.0,0.0,1.0,182,5250,3800,1450,0.7238095238095238,67,38,29,224.55630122480008,0.42392500455345755,0.7710140375859351,0.15052254373975327,1133465.3364191942,9255.356702563637,1142720.6931217578,2454,22,1081.2527472527472,79,103,38,33.08316499576036,0.6435917721518987,38.9453125,8683.73862407044,109.92074207684101,0
2456,33.403011212436155,1,0,183,0.00546448087431694,0.0,1.0,183,3750,2300,1450,0.6133333333333333,52,23,29,220.92123894962234,0.4243905002101724,0.7690152874685057,0.148502072140019,1139028.6747310532,9977.125204146061,1149005.7999351993,2455,0,1076.3387978142077,80,103,34,33.080957305362666,0.644140625,38.8503086419753,8723.18606855633,109.03982585695412,0
2457,33.48013282279851,0,2,181,0.0,0.01092896174863388,0.9890710382513661,183,4450,3400,1050,0.7640449438202247,55,34,21,204.8121205043033,0.4240764927240337,0.7554264227461007,0.13828385159571688,1142964.4882107552,5768.596098311897,1148733.084309067,2456,1,1077.3387978142077,84,99,38,33.34925976299908,0.6440972222222222,38.70098039215685,8748.325882937586,104.14673670163793,8
2458,33.823209509327754,0,0,181,0.0,0.0,1.0,181,4200,2600,1600,0.6190476190476191,58,26,32,204.86157873829978,0.4226506547984448,0.7516079802998048,0.13862765852005807,1155344.0183457187,6937.119916830859,1162281.1382625496,2457,25,1089.7513812154696,86,95,39,33.27091922430903,0.6441375968992248,38.625478927203055,8840.52518664539,102.79680449587661,0
2459,33.53769017391752,0,1,180,0.0,0.0055248618784530384,0.994475138121547,181,4700,2800,1900,0.5957446808510638,66,28,38,205.55229282074862,0.4224102209944751,0.7527899451916089,0.1394422310756973,1146325.9649777454,6225.986084226659,1152551.9510619722,2458,26,1090.7513812154696,84,97,40,33.167330677290856,0.6457093253968254,38.54166666666667,8768.708576722196,104.38938781812138,0
2460,33.876825768085084,0,0,180,0.0,0.0,1.0,180,4800,3300,1500,0.6875,63,33,30,205.54712927891106,0.42197716221808396,0.7524279392417179,0.1397901047584973,1158665.9078200508,6832.090229150668,1165497.9980492014,2459,27,1097.3555555555556,73,107,41,33.08127018299241,0.6512557077625571,38.45720720720718,8860.239622339765,121.37314551150362,0
2461,34.0738135778566,0,0,180,0.0,0.0,1.0,180,4750,3300,1450,0.6947368421052632,62,33,29,205.88019211212054,0.4219532381543554,0.7535899367009176,0.140547443671399,1166532.644323213,7283.192983664391,1173815.8373068774,2460,28,1098.3555555555556,73,107,41,32.94326169598508,0.6525399543378996,38.330518018018005,8916.077148068325,122.13804312422363,0
2462,34.10522346582596,0,0,180,0.0,0.0,1.0,180,4950,3400,1550,0.6868686868686869,65,34,31,203.67067150612584,0.421721756672874,0.7494149629399984,0.1396258769273126,1168862.9171802448,6662.619048141707,1175525.5362283865,2461,29,1099.3555555555556,76,104,42,32.85763189169638,0.6525493421052632,38.18993506493505,8929.090770212752,117.48803645016778,0
2463,34.28840449229989,1,0,181,0.0055248618784530384,0.0,1.0,181,4400,3100,1300,0.7045454545454546,57,31,26,202.79830371492727,0.42186412932269285,0.7495075231333428,0.13970862337753717,1176600.247269303,7122.506859355704,1183722.7541286587,2462,0,1094.2762430939226,78,103,42,32.71466680088584,0.6533119658119658,38.02742616033755,8982.621577703236,115.16181509875943,0
2464,34.096751038797706,0,0,181,0.0,0.0,1.0,181,5600,4000,1600,0.7142857142857143,72,40,32,205.01520524692492,0.42183215674237773,0.7515596204907653,0.14156539604597015,1170714.4799691408,6202.853879283959,1176917.3338484247,2463,1,1095.2762430939226,80,101,43,32.5776815363727,0.6532552083333334,37.95010288065843,8935.05010182072,111.68812627275899,0
2465,34.19886665515255,0,0,181,0.0,0.0,1.0,181,5750,4000,1750,0.6956521739130435,75,40,35,201.53481801209566,0.42152266216492734,0.7470696697554282,0.13987156993204064,1175728.8472811647,5440.059853676101,1181168.9071348407,2464,2,1096.2762430939226,84,97,40,32.49725428798428,0.6533978174603174,37.78186274509804,8967.563110542882,106.75670369693907,0
2466,34.30596116604209,0,1,180,0.0,0.0055248618784530384,0.994475138121547,181,5800,4000,1800,0.6896551724137931,76,40,36,203.0277400307726,0.42147917945569874,0.7502974032375014,0.14159035550680307,1180844.2334060112,5948.827207358652,1186793.0606133698,2465,3,1097.2762430939226,84,97,41,32.29555892884944,0.6550099206349207,37.62254901960785,9001.11064417847,107.15607909736275,0
2467,34.078835227487126,0,0,180,0.0,0.0,1.0,180,5800,3600,2200,0.6206896551724138,80,36,44,201.70356566119602,0.4212031864266501,0.74796003182857,0.14114099170093908,1174015.2639816117,5560.612977152507,1179575.8769587642,2466,4,1104.0722222222223,86,94,43,32.217496084781565,0.6554021317829457,37.511973180076644,8945.286215184438,104.01495599051673,0
2468,33.52398705914941,0,0,180,0.0,0.0,1.0,180,4650,3700,950,0.7956989247311828,56,37,19,204.7415464477492,0.4206387078419201,0.7477016511561578,0.13974690251104702,1147660.3385232878,6344.750501201121,1154005.0890244888,2467,5,1105.0722222222223,75,105,42,32.97872688701482,0.6515277777777777,38.336074561403514,8772.018050249759,116.96024066999678,8
2469,33.08155096350976,0,0,180,0.0,0.0,1.0,180,4300,3100,1200,0.7209302325581395,55,31,24,200.9705721165797,0.42042727084626524,0.7410733390100643,0.1376499652087857,1133517.546617075,5260.733969563266,1138778.2805866383,2468,6,1106.0722222222223,80,100,44,32.959160280343234,0.6505208333333333,38.22016460905351,8660.08296570483,108.25103707131038,0
2470,32.94255557174701,1,0,181,0.0055248618784530384,0.0,1.0,181,4350,3000,1350,0.6896551724137931,57,30,27,204.07942018836852,0.4204304788213628,0.7460967014286182,0.14056660422169193,1130367.5684524837,5586.951593903852,1135954.5200463876,2469,0,1100.9558011049724,83,98,40,32.687031558185396,0.6512299196787148,38.033234126984134,8629.854742722679,103.97415352677926,0
2471,32.81000004601717,0,0,181,0.0,0.0,1.0,181,5250,3800,1450,0.7238095238095238,67,38,29,205.15740847990762,0.4200698281154082,0.7489212963743008,0.1420350810723657,1127279.6113627278,4803.9527398828395,1132083.5641026106,2470,1,1101.9558011049724,85,96,35,32.485444968117555,0.6522058823529412,37.86337209302325,8600.702773690677,101.18473851400796,0
2472,32.60078068388783,0,1,180,0.0,0.0055248618784530384,0.994475138121547,181,4650,3100,1550,0.6666666666666666,62,31,31,204.92354100822422,0.42001355637405363,0.7485535671444437,0.14237897002701605,1121096.3882357539,5097.808337760185,1126194.196573514,2471,2,1102.9558011049724,88,93,37,32.371580309724635,0.65234375,37.745786516853926,8549.692097189522,97.15559201351729,0
2473,33.04558958299399,0,1,179,0.0,0.005555555555555556,0.9944444444444445,180,5150,4000,1150,0.7766990291262136,63,40,23,204.3687915365133,0.41898794744465134,0.746657116957278,0.14251101523603377,1137431.8385072742,5341.114058177368,1142772.9525654516,2472,3,1109.7111111111112,90,90,37,32.26380829806728,0.6528935185185185,37.62591575091576,8670.306305309146,96.33673672565718,0
2474,32.903184617662305,0,0,179,0.0,0.0,1.0,179,5100,3600,1500,0.7058823529411765,66,36,30,207.38674770284933,0.4182568576988262,0.7490794805860617,0.14491788980747466,1133123.2477109989,6098.949017854993,1139222.196728854,2473,4,1116.022346368715,90,89,38,32.11451927131042,0.653587962962963,37.557234432234445,8635.202767046092,95.94669741162325,0
2475,32.91217076822613,0,1,178,0.0,0.00558659217877095,0.994413407821229,179,5950,4300,1650,0.7226890756302521,76,43,33,203.5053680128245,0.4178344632059088,0.7441776906841575,0.1428769399561254,1134767.2350694104,4436.244756338936,1139203.4798257493,2474,5,1117.022346368715,74,105,41,32.05878334302995,0.6614583333333333,37.402777777777764,8642.644621039568,116.79249487891308,0
2476,33.22367777202091,0,0,178,0.0,0.0,1.0,178,4600,2900,1700,0.6304347826086957,63,29,34,201.89804527200138,0.41767441122325905,0.7404930479396465,0.14233849318937014,1146692.5065559014,6102.99512033733,1152795.5016762386,2475,6,1121.6573033707866,75,103,41,31.96246761263846,0.6623611111111112,37.26699561403507,8728.956677794205,116.38608903725607,0
2477,32.777380061873195,0,0,178,0.0,0.0,1.0,178,3700,2500,1200,0.6756756756756757,49,25,24,199.73083180871572,0.41752629128843183,0.7368812738164305,0.1412672239274952,1132197.88433924,5926.965042228656,1138124.8493814685,2476,7,1122.6573033707866,79,99,42,31.911762277486055,0.6616561181434599,37.161458333333314,8615.158775116775,109.05264272299716,0
2478,32.878860922268686,0,1,177,0.0,0.0056179775280898875,0.9943820224719101,178,5700,4200,1500,0.7368421052631579,72,42,30,199.09374781208507,0.4171255739647475,0.7366910926559198,0.14133198147154122,1136729.9102541415,3963.1636165181776,1140693.0738706598,2477,8,1123.6573033707866,81,97,41,31.80736714975843,0.662037037037037,37.04268292682925,8645.737056541644,106.73749452520548,0
2479,33.255448777218454,0,1,176,0.0,0.005649717514124294,0.9943502824858758,177,4550,3300,1250,0.7252747252747253,58,33,25,195.785155159277,0.41637909818524227,0.7301390976272162,0.13941559235964135,1150630.7152196032,5105.282622059605,1155735.9978416627,2478,9,1130.3107344632767,83,94,42,31.7916784518927,0.6622740963855422,36.94196428571426,8748.113032132069,105.39895219436228,0
2480,32.9890892703814,0,1,175,0.0,0.005681818181818182,0.9943181818181818,176,5000,3600,1400,0.72,64,36,28,196.11459514559405,0.4158062770562771,0.7286512972829897,0.13992903710777763,1141975.1459539826,4591.598683018904,1146566.7446370015,2479,10,1137.0113636363637,86,90,43,31.717176313554205,0.6618217054263567,36.87739463601531,8680.175117407774,100.93226880706715,0
2481,32.71690885317381,0,0,175,0.0,0.0,1.0,175,4650,3200,1450,0.6881720430107527,61,32,29,197.19982047197516,0.4153762999452655,0.7281119571714474,0.1413308230944507,1133790.3432730478,5066.650429260333,1138856.993702308,2480,11,1144.0742857142857,86,89,35,31.542110090352303,0.6632751937984496,36.733716475095754,8613.259002198012,100.15417444416293,0
2482,32.71378186838462,0,0,175,0.0,0.0,1.0,175,5300,3900,1400,0.7358490566037735,67,39,28,199.21419432281874,0.4148426382047072,0.7337976179652708,0.14330653520972306,1134713.3958975521,4910.202990207785,1139623.59888776,2481,12,1145.0742857142857,86,89,36,31.3669613904294,0.6644864341085271,36.61398467432947,8616.352652546917,100.19014712263856,0
2483,32.29876656623256,0,0,175,0.0,0.0,1.0,175,5550,4100,1450,0.7387387387387387,70,41,29,199.66496947602877,0.41448823207443897,0.7350033635844413,0.1439608732512932,1120945.3833621554,4212.705150659665,1125158.088512815,2482,13,1146.0742857142857,88,87,37,31.279894121131317,0.6645359848484849,36.54026217228462,8509.424571698139,96.69800649656976,0
2484,32.00218036267553,0,0,175,0.0,0.0,1.0,175,4200,2700,1500,0.6428571428571429,57,27,30,200.34579189803597,0.41447318007662837,0.736541683662266,0.1445601252791998,1110855.059005355,5311.0272960730645,1116166.086301428,2483,14,1147.0742857142857,89,86,37,31.237416721575535,0.6644428838951311,36.51620370370368,8432.055971716465,94.74220192939849,0
2485,32.44160376032106,0,0,175,0.0,0.0,1.0,175,4500,3100,1400,0.6888888888888889,59,31,28,202.5530065243531,0.41414887794198135,0.7386302896139227,0.14691312036297408,1127528.4650265176,6176.856106581947,1133705.3211330995,2484,15,1148.0742857142857,76,99,36,31.00980040022578,0.6711896929824561,36.35010822510822,8553.225320412559,112.54243842648104,0
2486,32.4887662638478,0,0,175,0.0,0.0,1.0,175,5150,3700,1450,0.7184466019417476,66,37,29,200.4250761814089,0.41384920634920636,0.7359864617120293,0.14606518141853728,1130471.6250341241,5164.972313676993,1135636.597347801,2485,16,1149.0742857142857,79,96,36,30.910661401776878,0.6714135021097046,36.19791666666666,8570.604225332747,108.48866108016135,0
2487,32.64901960811975,0,0,175,0.0,0.0,1.0,175,5300,3800,1500,0.7169811320754716,68,38,30,202.27848269253047,0.4134948002189382,0.7385569771950231,0.14771796222573425,1136608.567004388,5682.291269795753,1142290.8582741837,2486,17,1150.0742857142857,79,96,40,30.795347068015456,0.6720727848101266,36.13281249999999,8615.004978626894,109.050695931986,0
2488,32.66966072984705,0,0,175,0.0,0.0,1.0,175,3950,3100,850,0.7848101265822784,48,31,17,201.62211466453928,0.4131061850027367,0.7385052310647979,0.14751838357434374,1137846.8595431768,6933.0179971000425,1144779.8775402769,2487,18,1151.0742857142857,80,95,40,30.751169419675477,0.672265625,36.07253086419753,8622.42087395385,107.78026092442312,0
2489,32.3413941042552,0,0,175,0.0,0.0,1.0,175,5000,3800,1200,0.76,62,38,24,199.52481832510085,0.41275451559934323,0.736251617841486,0.14639901787756673,1127182.2360914776,4980.166175086516,1132162.402266564,2488,19,1152.0742857142857,80,95,42,30.714706121123545,0.6731770833333333,35.98251028806584,8538.693685189799,106.73367106487248,0
2490,32.54407511649189,0,0,175,0.0,0.0,1.0,175,4750,3900,850,0.8210526315789474,56,39,17,199.57975109654316,0.41247810618500275,0.7370635674912431,0.14685161825439333,1135010.4848451917,5555.02201147394,1140565.5068566657,2489,20,1153.0742857142857,82,93,41,30.622544826712293,0.6732723577235773,35.89357429718875,8595.09935682046,104.8182848392739,0
2491,32.505801480833085,0,0,175,0.0,0.0,1.0,175,5000,3700,1300,0.74,63,37,26,206.85776064167072,0.41255199781061846,0.747594318284629,0.14779565794262367,1125622.1804149144,6568.736713844812,1132190.9171287592,2490,21,1154.0742857142857,74,101,38,31.38952659911334,0.6672297297297297,36.833333333333336,8554.443423039247,115.60058679782766,8
2492,32.502684511213616,0,0,175,0.0,0.0,1.0,175,4900,3500,1400,0.7142857142857143,63,35,28,207.05206827056898,0.4128393541324576,0.745859285567525,0.1345423786746138,1098500.4530992375,5589.358162070789,1104089.8112613084,2491,22,1155.0742857142857,77,98,46,34.62755119512361,0.6336580086580086,40.010683760683754,8450.350722012627,109.74481457159256,8
2493,32.01073407183528,0,1,174,0.0,0.005714285714285714,0.9942857142857143,175,4200,2600,1600,0.6190476190476191,58,26,32,206.88433536681032,0.4125971538040503,0.746284512904126,0.13493073351690396,1082938.3584820505,5608.596507556767,1088546.9549896072,2492,23,1156.0742857142857,79,96,41,34.50139535465788,0.6340981012658228,39.8828125,8326.54211657621,105.39926729843305,0
2494,31.536361178039257,0,0,174,0.0,0.0,1.0,174,4900,3500,1400,0.7142857142857143,63,35,28,206.75133794804069,0.41168776161052417,0.74485866403954,0.13505929344613457,1067342.4478066491,4434.895826552049,1071777.3436332012,2493,24,1163.2356321839081,80,94,41,34.448577265912064,0.6342447916666667,39.82767489711932,8204.888412974646,102.56110516218307,0
2495,31.849507847731676,0,0,174,0.0,0.0,1.0,174,4550,3300,1250,0.7252747252747253,58,33,25,206.3708049074359,0.41119706885478263,0.7448690478795372,0.13512044359663225,1078597.2140158734,5168.19504547452,1083765.4090613478,2494,25,1164.2356321839081,81,93,43,34.377643953075925,0.6346450617283951,39.748475609756085,8288.88296845117,102.33188849939715,0
2496,31.616914850985367,1,0,175,0.005714285714285714,0.0,1.0,175,5150,3800,1350,0.7378640776699029,65,38,27,200.55698290873707,0.41192665571975917,0.7338046574915289,0.12753399563010587,1062360.3952493072,2462.759126587294,1064823.1543758945,2495,0,1158.577142857143,80,95,39,35.56735125839203,0.6247395833333333,40.766460905349824,8196.16473207522,102.45205915094024,8
2497,31.59461779018602,0,0,175,0.0,0.0,1.0,175,4950,3800,1150,0.7676767676767676,61,38,23,201.17218639968974,0.41177476737821567,0.7362415912500575,0.12825735537108401,1062358.7782998297,2793.407634296471,1065152.1859341261,2496,1,1159.577142857143,82,93,42,35.458307119005006,0.6248729674796748,40.67520080321289,8193.267914139326,99.91790139194299,0
2498,31.775662614903982,0,0,175,0.0,0.0,1.0,175,5150,3500,1650,0.6796116504854369,68,35,33,203.80920246912254,0.4120374931581828,0.7384325219829238,0.1305543519816489,1069814.1837077602,3457.595114326615,1073271.7788220868,2497,2,1160.577142857143,71,104,43,35.22059916741004,0.6314553990610329,40.509259259259245,8245.490229469266,116.13366520379248,0
2499,32.255370539907155,0,0,175,0.0,0.0,1.0,175,4800,3700,1100,0.7708333333333334,59,37,22,208.73174021086078,0.4120525451559934,0.7450257891803205,0.13435767515447553,1087385.2645934601,5594.363711647866,1092979.628305108,2498,3,1161.577142857143,72,103,45,34.91967540437068,0.6326678240740741,40.33961187214611,8375.44203360001,116.32558380000013,0
2500,32.55481570613363,2,0,177,0.011299435028248588,0.0,1.0,177,5400,3800,1600,0.7037037037037037,70,38,32,204.13572636254537,0.4132746961136791,0.7416188308821039,0.13229055513624632,1099471.2545631162,4088.2726329959087,1103559.527196112,2499,0,1149.4406779661017,75,102,44,34.79876419505675,0.6336111111111111,40.10416666666665,8460.860956958648,112.8114794261153,0
2501,32.74902957354673,0,0,177,0.0,0.0,1.0,177,4800,3200,1600,0.6666666666666666,64,32,32,204.82456528636104,0.4129108885464818,0.7439766665187006,0.1333516803684816,1107394.841115682,5164.333386375395,1112559.1745020573,2500,1,1150.4406779661017,77,100,39,34.617322703230094,0.6343344155844156,39.943910256410234,8516.584573793689,110.6049944648531,0
2502,33.05613364874778,0,0,177,0.0,0.0,1.0,177,4900,3300,1600,0.673469387755102,65,33,32,202.35853479398915,0.41289082562917306,0.7409750307367702,0.1322011212477085,1118804.4996492101,4979.927853986905,1123784.427503197,2501,2,1151.4406779661017,81,96,43,34.55982577348108,0.6338734567901234,39.824695121951194,8600.389650152416,106.17765000188167,0
2503,32.761584979650316,0,0,177,0.0,0.0,1.0,177,5100,3500,1600,0.6862745098039216,67,35,32,200.92875102245821,0.41265408320493063,0.7397857241284287,0.13180926067073157,1110047.3540094073,4108.085683378548,1114155.439692786,2502,3,1152.4406779661017,83,94,44,34.452013465447145,0.6345381526104418,39.682539682539655,8528.412597877152,102.75195901056809,0
2504,33.03483956943153,1,0,178,0.0056179775280898875,0.0,1.0,178,4800,3000,1800,0.625,66,30,36,209.7094601907244,0.41345828307835547,0.7554887832266308,0.13369313729700605,1110769.6415072402,6187.78038334558,1116957.421890586,2503,0,1146.9606741573034,79,99,40,35.238836446408285,0.626054852320675,40.677083333333336,8566.690948760399,108.43912593367594,8
2505,32.83061997352875,0,0,178,0.0,0.0,1.0,178,5550,4000,1550,0.7207207207207207,71,40,31,207.4493863177588,0.41341331809814,0.752906092839341,0.13256239513194729,1104603.515312474,4679.864275202511,1109283.3795876766,2504,1,1147.9606741573034,68,110,42,35.21346194882534,0.6321997549019608,40.594806763285035,8516.433318314412,125.24166644580018,0
2506,33.18630670472915,0,1,177,0.0,0.0056179775280898875,0.9943820224719101,178,4100,2700,1400,0.6585365853658537,55,27,28,204.90355109449226,0.41313956071859326,0.7496677745084581,0.13131644970142703,1117447.7426664515,6093.802126976147,1123541.5447934277,2505,2,1148.9606741573034,70,108,42,35.17556629730138,0.6321428571428571,40.49295774647888,8612.080296262475,123.02971851803535,0
2507,33.38507930732677,0,2,175,0.0,0.011299435028248588,0.9887005649717514,177,5000,3800,1200,0.76,62,38,24,196.05145720250857,0.4125363807567197,0.7417971638598848,0.12222979103090977,1115713.3403537846,3347.445239327402,1119060.785593112,2506,3,1155.6440677966102,67,110,42,36.39895765440145,0.6239116915422885,41.46752450980391,8631.12719775968,128.82279399641314,8
2508,33.757447992069764,0,0,175,0.0,0.0,1.0,175,4600,3100,1500,0.6739130434782609,61,31,30,196.19108373979918,0.41267241379310343,0.7377034823326354,0.12272582907978008,1129197.7874489303,4707.70753523759,1133905.4949841679,2507,4,1155.3085714285714,71,104,45,36.27386545847781,0.6229460093896714,41.34837962962961,8731.418622717312,122.97772708052553,0
2509,33.538043964388265,2,0,177,0.011299435028248588,0.0,1.0,177,5050,3600,1450,0.7128712871287128,65,36,29,194.9195156307564,0.4147058508816983,0.7379008998881369,0.12287010179959289,1124227.46977395,3376.7747734257027,1127604.2445473757,2508,0,1143.2429378531074,73,104,46,36.02850567213946,0.624714611872146,41.07545045045044,8683.82292625219,118.95647844181083,0
2510,33.30462917974331,0,0,177,0.0,0.0,1.0,177,5250,4200,1050,0.8,63,42,21,196.72519474075486,0.41484896635850027,0.7388311802100895,0.12454493237951023,1117721.4949905793,3326.795753589672,1121048.290744169,2509,1,1144.2429378531074,76,101,41,35.8259142255409,0.6248629385964912,40.92261904761904,8628.476101478107,113.53258028260667,0
2511,33.014938286076685,0,3,174,0.0,0.01694915254237288,0.9830508474576272,177,5250,3700,1550,0.7047619047619048,68,37,31,200.8723471908864,0.41473126391028936,0.7430479274693307,0.12762600520615514,1109079.0632537608,3906.6629312104433,1112985.7261849712,2510,2,1145.2429378531074,78,99,43,35.58973022009697,0.625267094017094,40.7964135021097,8557.590411757577,109.71269758663561,0
2512,33.17625329156616,1,0,175,0.005714285714285714,0.0,1.0,175,4950,3600,1350,0.7272727272727273,63,36,27,200.30082835697993,0.4133757525998905,0.7396374198576035,0.1276973191216724,1115530.0950275613,4738.320418232223,1120268.4154457934,2511,0,1158.6114285714286,80,95,47,35.482167947764275,0.6256510416666667,40.6764403292181,8603.384100108422,107.54230125135527,0
2513,32.989011422225374,0,0,175,0.0,0.0,1.0,175,5150,3800,1350,0.7378640776699029,65,38,27,200.20336841099103,0.4132389162561576,0.7401385118487642,0.12835716563382668,1110928.0660081152,4332.308175426778,1115260.3741835419,2512,1,1159.6114285714286,63,112,42,35.282808090310425,0.6364087301587302,40.47851562500002,8561.357212359811,135.8945589263462,0
2514,33.006323144984286,0,0,175,0.0,0.0,1.0,175,4350,3100,1250,0.7126436781609196,56,31,25,198.91213229690572,0.41287219485495347,0.7386525573192237,0.12787208504801123,1112315.5312820652,4900.610822856404,1117216.1421049216,2513,2,1160.6114285714286,64,111,44,35.220550411522645,0.63671875,40.3846153846154,8568.9492780248,133.8898324691375,0
2515,32.86610182022934,1,0,176,0.005681818181818182,0.0,1.0,176,5750,4400,1350,0.7652173913043478,71,44,27,243.71174309599974,0.41412540584415586,0.7855793468135246,0.14941529260763584,1093248.5280362507,12337.500880970001,1105586.0289172207,2514,0,1155.0113636363637,66,110,39,35.78486035764518,0.6183712121212122,42.07089552238805,8477.124210161743,128.44127591154157,8
2516,32.497145148770784,1,0,177,0.005649717514124294,0.0,1.0,177,4200,2600,1600,0.6190476190476191,58,26,32,244.53130992411315,0.4145493601266906,0.7864047115946597,0.15048481109666267,1082119.0241317018,13322.396492945372,1095441.420624647,2515,0,1149.4802259887006,69,108,37,35.62401491561911,0.6180555555555556,41.934523809523796,8386.391237648524,121.54190199490614,0
2517,32.63923860675047,0,1,176,0.0,0.005649717514124294,0.9943502824858758,177,4900,3500,1400,0.7142857142857143,63,35,28,243.71099442044888,0.4145734356274611,0.7854712503937711,0.1504331613778241,1087766.4735968283,12720.129795501347,1100486.6033923295,2516,1,1150.4802259887006,71,106,38,35.533821331838965,0.6181044600938967,41.82581018518517,8426.608983470189,118.68463357000266,0
2518,32.867816559286496,0,0,176,0.0,0.0,1.0,176,4100,2700,1400,0.6585365853658537,55,27,28,246.04430690787808,0.41469155844155847,0.786777474013099,0.15269279587843285,1097025.1362446733,14683.3578615682,1111708.4941062415,2517,2,1153.159090909091,60,116,39,35.27552875082619,0.6267361111111112,41.63251366120218,8491.975145867558,141.53291909779264,0
2519,32.5805060377599,2,0,178,0.011235955056179775,0.0,1.0,178,5500,4300,1200,0.7818181818181819,67,43,24,247.1297711932889,0.41581629954082816,0.7897519183122381,0.1548335716640651,1090301.1753107093,12789.175997261951,1103090.3513079712,2518,0,1141.191011235955,63,115,38,34.89888067526473,0.6281415343915344,41.292317708333336,8428.827204918525,133.79090801457977,0
2520,32.36832302084553,1,0,179,0.00558659217877095,0.0,1.0,179,5050,3600,1450,0.7128712871287128,65,36,29,244.58905897751896,0.41689028728056415,0.7886894676346954,0.15411781734948538,1084897.512605498,12220.812339046079,1097118.3249445441,2519,0,1135.8100558659219,64,115,35,34.75708199224231,0.6295572916666667,41.0897435897436,8380.490812897138,130.9451689515178,0
2521,31.857376830357484,0,1,178,0.0,0.00558659217877095,0.994413407821229,179,5150,3900,1250,0.7572815533980582,64,39,25,256.4566715826958,0.41709690749691375,0.7999149302583732,0.15529532908128063,1056003.5030296368,13213.82871332956,1069217.3317429663,2520,1,1136.8100558659219,60,119,35,35.91725803599061,0.6177083333333333,42.52049180327869,8202.62171871807,136.7103619786345,8
2522,32.02239909605908,3,1,180,0.016574585635359115,0.0055248618784530384,0.994475138121547,181,4750,3200,1550,0.6736842105263158,63,32,31,247.68080963240214,0.418707796193984,0.795817348819879,0.1510891102210602,1063683.5485804218,11740.800501013162,1075424.349081435,2521,0,1125.2265193370165,63,118,39,35.86869579860235,0.6183862433862434,42.25260416666667,8253.689975344925,131.01095198960198,0
2523,32.29307203627587,1,2,179,0.0055248618784530384,0.011049723756906077,0.988950276243094,181,5500,4200,1300,0.7636363636363637,68,42,26,247.81258439103348,0.4199713525680377,0.7959438591674948,0.1522817789578494,1074884.8417112385,11573.998109442,1086458.8398206804,2522,0,1116.7182320441989,64,117,34,35.59329710144929,0.6204427083333333,41.9871794871795,8332.026599103265,130.1879156109885,0
2524,32.62290025059529,0,1,178,0.0,0.00558659217877095,0.994413407821229,179,5850,4300,1550,0.7350427350427351,74,43,31,249.93188336567587,0.4186465591195363,0.7960952902068401,0.15403421362896078,1086752.0172233554,12672.795683216293,1099424.8129065717,2523,2,1130.1340782122904,62,117,34,35.43041231610189,0.6228158602150538,41.88161375661377,8420.57036726264,135.8156510848813,0
2525,32.21850036924663,0,0,178,0.0,0.0,1.0,178,4650,2800,1850,0.6021505376344086,65,28,37,251.33779140253202,0.4178555936435388,0.7962915519118674,0.1550429449690931,1073555.4495003675,13715.011125115194,1087270.4606254827,2524,3,1137.4719101123596,62,116,36,35.360223318175024,0.6231518817204301,41.84854497354499,8317.252749091429,134.14923788857143,0
2526,32.63601804153221,1,0,179,0.00558659217877095,0.0,1.0,179,4750,3300,1450,0.6947368421052632,62,33,29,249.9793191136338,0.41822678007239555,0.7965238836857595,0.15466170748921976,1088364.1603144684,13863.706348618383,1102227.866663087,2525,0,1132.1117318435754,68,111,37,35.28623760254086,0.6205575980392157,41.7421497584541,8428.507859850399,123.94864499779999,0
2527,32.423492031154574,1,0,180,0.005555555555555556,0.0,1.0,180,5750,4400,1350,0.7652173913043478,71,44,27,257.50151972725104,0.4186581833229878,0.8031583171741703,0.1610594271528747,1084541.8541886958,14104.235132280126,1098646.0893209758,2526,0,1126.8166666666666,62,118,34,34.69230113575827,0.6281922043010753,41.352513227513235,8386.254726245901,135.26217300396615,0
2528,31.91214178229944,0,0,180,0.0,0.0,1.0,180,5650,4700,950,0.831858407079646,66,47,19,253.1894295929218,0.41866335609352373,0.7997557619539042,0.15910541976364578,1068813.2550560148,12472.443677797435,1081285.6987338122,2527,1,1127.8166666666666,64,116,38,34.63299793601651,0.6285807291666667,41.185897435897445,8259.31233628425,129.05175525444142,0
2529,31.437233817200326,1,0,181,0.0055248618784530384,0.0,1.0,181,5800,4000,1800,0.6896551724137931,76,40,36,253.40275048834306,0.41933445876816045,0.801422086119078,0.16040739952528482,1055015.5592285264,11468.768903301436,1066484.3281318278,2528,0,1122.5801104972375,68,113,34,34.36194957558804,0.6288296568627452,40.926932367149774,8144.540602913303,119.77265592519564,0
2530,31.742245089552735,0,0,181,0.0,0.0,1.0,181,5050,3500,1550,0.693069306930693,66,35,31,251.34133780437796,0.41911065070595455,0.8011560257397738,0.1599970817890278,1066878.5218176849,12380.134989682985,1079258.656807368,2529,1,1123.5801104972375,69,112,37,34.21261885630107,0.6302838164251208,40.72916666666668,8229.838336239272,119.27301936578655,0
2531,31.904886342104074,1,1,181,0.005494505494505495,0.005494505494505495,0.9945054945054945,182,5000,3600,1400,0.72,64,36,28,248.09732090849462,0.4190951773824702,0.7998643494383229,0.15906230493099488,1074417.030276622,11911.9973500182,1086329.0276266402,2530,0,1118.401098901099,56,126,37,34.040149754712104,0.6415550595238095,40.478801169590646,8279.994352050808,147.85704200090728,0
2532,32.01574822970492,1,0,182,0.005494505494505495,0.0,1.0,182,5350,3700,1650,0.6915887850467289,70,37,33,242.17648154369957,0.4191641116710178,0.7950336543130572,0.15610937964539087,1079723.407119192,10546.723155300266,1090270.1302744923,2531,0,1118.857142857143,58,124,43,33.999971674597795,0.641882183908046,40.28954802259887,8314.824443131343,143.3590421229542,0
2533,32.457262503329325,0,0,182,0.0,0.0,1.0,182,4800,3500,1300,0.7291666666666666,61,35,26,247.1132153503034,0.41915399287636856,0.7962061807253895,0.15246157564179272,1081560.0454944584,12253.556087311073,1093813.6015817695,2532,1,1119.857142857143,70,112,36,35.46331552625593,0.618452380952381,41.842723004694825,8379.078506581302,119.70112152259003,8
2534,32.57549398885327,0,0,182,0.0,0.0,1.0,182,5850,4600,1250,0.7863247863247863,71,46,25,248.4391259105097,0.41894719001072594,0.7979439914923787,0.15403225806451612,1086980.8931697232,11759.716596102317,1098740.6097658256,2533,2,1120.857142857143,67,115,37,35.24865591397849,0.6218905472636815,41.66666666666667,8415.335947120439,125.60202906149908,0
2535,32.74722154417771,2,0,184,0.010869565217391304,0.0,1.0,184,6300,4100,2200,0.6507936507936508,85,41,44,238.18907502308014,0.41991738932446343,0.7908997143763876,0.1490275897742836,1095466.6510217641,9085.637665101298,1104552.2886868655,2534,0,1109.6630434782608,63,121,38,35.18017451128451,0.6276455026455027,41.34114583333335,8470.358801759023,134.4501397104607,0
2536,32.54144502307526,1,1,184,0.005405405405405406,0.005405405405405406,0.9945945945945946,185,5250,3500,1750,0.6666666666666666,70,35,35,225.61796958188572,0.42071215236976106,0.780201217310716,0.13567046406166836,1076539.3308854587,6327.323601883585,1082866.6544873423,2535,0,1104.6594594594594,76,109,40,36.97253777918023,0.6060855263157895,42.77597402597401,8370.441499847808,110.13738815589221,8
2537,32.0539958751067,1,1,184,0.005405405405405406,0.005405405405405406,0.9945945945945946,185,4550,3100,1450,0.6813186813186813,60,31,29,227.42525396867285,0.42047223854289073,0.7820391636657851,0.1373196859300377,1061653.1881523144,6739.34918843844,1068392.5373407528,2536,0,1105.6,62,123,41,36.77231894299541,0.615255376344086,42.62566137566139,8249.875988622893,133.06251594553052,0
2538,31.70388866698664,0,0,184,0.0,0.0,1.0,184,5100,3500,1600,0.6862745098039216,67,35,32,231.3494463258304,0.4203455393205037,0.7825332642386085,0.14010899186268894,1050952.1586855473,6727.440005367829,1057679.5986909152,2537,1,1111.3423913043478,64,120,44,36.55914815045332,0.6150716145833333,42.516025641025664,8163.243256610214,127.5506758845346,0
2539,31.868611874466435,1,1,184,0.005405405405405406,0.005405405405405406,0.9945945945945946,185,5200,3500,1700,0.6730769230769231,69,35,34,225.1446499540742,0.42079049157853504,0.777539285647393,0.1370817425669747,1058009.9682237897,5441.0567887334055,1063451.0250125232,2538,0,1106.3297297297297,69,116,43,36.519933394933396,0.6141304347826086,42.321428571428584,8211.858381224147,119.01244030759634,0
2540,32.178503151771054,2,1,185,0.010752688172043012,0.005376344086021506,0.9946236559139785,186,4700,3200,1500,0.6808510638297872,62,32,30,221.83851345725287,0.42168579870192774,0.7758456804553506,0.13607651197036905,1070533.7713210094,5597.124087128133,1076130.8954081375,2539,0,1100.467741935484,72,114,38,36.329659235492606,0.615306712962963,42.05194063926942,8300.382441132528,115.283089460174,0
2541,31.73765025996597,1,0,186,0.005376344086021506,0.0,1.0,186,5050,3900,1150,0.7722772277227723,62,39,23,222.1105515765418,0.4217245471277729,0.7760271520649233,0.13692333937286497,1057338.720153274,4719.217267295911,1062057.9374205698,2540,0,1101.4623655913979,75,111,43,36.13896927379247,0.6156944444444444,41.872258771929836,8192.367973491519,109.23157297988692,0
2542,31.58695728515928,0,0,186,0.0,0.0,1.0,186,5200,3500,1700,0.6730769230769231,69,35,34,220.64066958612608,0.4216718734863896,0.7742943724406739,0.13648834680489846,1053333.1148381403,4081.6247510256544,1057414.739589166,2541,1,1102.4623655913979,76,110,44,36.04974244805311,0.6165021929824561,41.74783549783552,8157.400088929841,107.33421169644528,0
2543,31.20564418111829,1,0,187,0.0053475935828877,0.0,1.0,187,6550,5200,1350,0.7938931297709924,79,52,27,217.37382358886822,0.4222825982788032,0.772172238132651,0.13569786028772543,1043248.4535602047,1404.9810607111212,1044653.4346209158,2542,0,1097.5614973262032,67,120,43,35.800750394944714,0.6243781094527363,41.42156862745098,8069.106522323479,120.43442570632058,0
2544,31.460951155194614,0,1,186,0.0,0.0053475935828877,0.9946524064171123,187,5300,4100,1200,0.7735849056603774,65,41,24,216.1992626951187,0.4227545857052499,0.7713860201293969,0.13537104001232733,1052656.2371404113,2816.7004682350075,1055472.9376086462,2543,1,1098.5614973262032,67,120,42,35.721573300961296,0.6254664179104478,41.314338235294116,8138.496969328603,121.47010401982989,0
2545,30.997418202820093,0,0,186,0.0,0.0,1.0,186,5000,3700,1300,0.74,63,37,26,214.87107397028896,0.42281919015789987,0.7693390113857812,0.13500858809578248,1038140.2615784539,2413.2625874317696,1040553.5241658858,2544,2,1097.6720430107528,69,117,44,35.62940815700706,0.6256038647342995,41.19047619047618,8022.427044396517,116.26705861444228,0
2546,31.163726490239625,1,0,187,0.0053475935828877,0.0,1.0,187,4450,3000,1450,0.6741573033707865,59,30,29,233.24427543477137,0.4234601709696586,0.7944315746173325,0.14051545373753335,1031503.792015535,6268.470915376647,1037772.2629309116,2545,0,1092.7967914438502,72,115,40,36.70715249662618,0.6086516203703703,42.70833333333334,8018.167128217925,111.36343233636006,8
2547,31.309180787134657,2,0,189,0.010582010582010581,0.0,1.0,189,5100,3800,1300,0.7450980392156863,64,38,26,211.43085867791623,0.42541699500919355,0.7739144914269145,0.12371033766344057,1027634.4968600672,554.7288156348072,1028189.2256757021,2546,0,1082.2222222222222,80,109,40,38.37148019876529,0.594140625,43.788580246913604,8021.769660777879,100.27212075972349,8
2548,31.247696905194484,1,0,190,0.005263157894736842,0.0,1.0,190,5350,3700,1650,0.6915887850467289,70,37,33,211.7298405688079,0.4260993919985148,0.7751101892662697,0.12422299894643928,1026430.930012051,115.21143326897572,1026546.14144532,2547,0,1077.5210526315789,65,125,40,38.25995484400658,0.6025641025641026,43.686868686868685,8009.195040094034,123.21838523221591,0
2549,31.36748701212653,0,1,189,0.0,0.005263157894736842,0.9947368421052631,190,4900,3300,1600,0.673469387755102,65,33,32,209.72651697928626,0.4263366750208855,0.7712080590713553,0.12355672869696872,1031603.3924048666,370.9172786175177,1031974.3096834841,2548,1,1078.5210526315789,71,119,40,38.154192756811646,0.6007922535211268,43.53298611111109,8044.725727198553,113.3059961577261,0
2550,31.74193970038215,3,1,191,0.015625,0.005208333333333333,0.9947916666666666,192,6350,4800,1550,0.7559055118110236,79,48,31,209.42863545114085,0.4281343168266434,0.7711511525960151,0.12490716136410945,1047629.3047997756,-869.2848474314305,1046760.0199523441,2549,0,1055.953125,78,114,34,37.69683944914889,0.6021634615384616,43.0775316455696,8155.217498179622,104.55407048948234,0
2551,32.23864181580748,0,0,191,0.0,0.0,1.0,191,6300,4300,2000,0.6825396825396826,83,43,40,203.95215329840775,0.42718724166437033,0.7615848334248485,0.11973191117165338,1059167.5041195701,-1296.1013662227833,1057871.4027533473,2550,1,1062.4816753926702,72,119,40,38.43636346767611,0.5989583333333333,43.66438356164383,8263.912122990367,114.7765572637551,8
2552,32.54692178901676,1,0,192,0.005208333333333333,0.0,1.0,192,5600,4500,1100,0.8035714285714286,67,45,22,199.10478311002208,0.42755087896305993,0.7571911349507485,0.11734953720749107,1070525.7280001487,-1370.6414225664344,1069155.0865775822,2551,0,1057.9427083333333,75,117,42,38.41029631806765,0.5990277777777777,43.51699561403509,8347.732283962041,111.30309711949388,0
2553,32.39827488982568,2,0,194,0.010309278350515464,0.0,1.0,194,6600,5200,1400,0.7878787878787878,80,52,28,193.54436552976978,0.42960723697095954,0.7538087971044718,0.11492024522377406,1067921.239755608,-4061.972243147043,1063859.267512461,2552,0,1048.0257731958764,79,115,44,38.27278470848758,0.6000791139240507,43.24218750000001,8318.510189485338,105.29759733525744,0
2554,32.5732465999979,5,2,197,0.02512562814070352,0.010050251256281407,0.9899497487437185,199,4850,3400,1450,0.7010309278350515,63,34,29,187.87820844160652,0.4332362570427897,0.7514825267037288,0.11277943434625033,1077054.6902393266,-4178.97888084107,1072875.7113584855,2553,0,1022.6683417085427,86,113,40,38.008563025731775,0.6015019379844961,42.840038314176255,8376.534847638379,97.4015679957951,0
2555,32.66496126019805,2,0,199,0.010050251256281407,0.0,1.0,199,6150,4700,1450,0.7642276422764228,76,47,29,186.69775743924504,0.43315906129976484,0.7516183807493906,0.11300249261496206,1082635.0249412865,-5524.893743656477,1077110.13119763,2554,0,1023.6030150753769,78,121,41,37.73014186213252,0.6076388888888888,42.53691983122361,8410.021539644285,107.82078896979853,0
2556,32.582638740829424,2,4,197,0.009950248756218905,0.01990049751243781,0.9800995024875622,201,6300,4600,1700,0.7301587301587301,80,46,34,183.22622934958645,0.433818407960199,0.7502715175846275,0.11154144166047385,1081666.2782216321,-6862.073285370227,1074804.204936262,2555,0,1014.407960199005,81,120,40,37.60599487280612,0.6085390946502058,42.3272357723577,8395.65859018013,103.65010605160654,0
2557,32.532493444330626,2,4,195,0.010050251256281407,0.020100502512562814,0.9798994974874372,199,5950,4000,1950,0.6722689075630253,79,40,39,192.78957987826246,0.4336592474155288,0.7545325609524491,0.11704705957507384,1079178.748624235,-4139.116487837291,1075039.6321363975,2556,0,1023.7939698492462,80,119,41,37.45964185264695,0.6079427083333333,42.425411522633716,8379.543611066005,104.74429513832506,8
2558,32.54455389688822,0,3,192,0.0,0.015384615384615385,0.9846153846153847,195,5550,3900,1650,0.7027027027027027,72,39,33,195.57621284377507,0.43173076923076925,0.7534930139720586,0.11920156038288364,1080764.964885196,-2275.616238703917,1078489.348646492,2557,1,1045.7230769230769,80,115,43,37.24363772455091,0.609375,42.28395061728392,8387.253859228826,104.84067324036032,0
2559,32.620394833145376,1,0,193,0.0051813471502590676,0.0,1.0,193,6600,4800,1800,0.7272727272727273,84,48,36,192.86854878840202,0.4311661179476108,0.7488022968537469,0.11802950472884387,1084521.9193856153,-3365.9662557770002,1081155.9531298382,2558,0,1049.8860103626944,81,112,43,37.16331469530517,0.6104681069958848,42.1366869918699,8411.603083308108,103.8469516457791,0
2560,32.54687786715596,0,1,192,0.0,0.0051813471502590676,0.9948186528497409,193,6200,4600,1600,0.7419354838709677,78,46,32,192.34226998869195,0.43124370322394934,0.7474347844936693,0.11809401738015307,1083073.4397700126,-3135.8392060352808,1079937.6005639774,2559,1,1050.8860103626944,82,111,34,37.05598932996042,0.6112804878048781,42.018072289156606,8396.506293138218,102.39641820900266,0
2561,32.70199749698547,2,2,192,0.010309278350515464,0.010309278350515464,0.9896907216494846,194,4550,2800,1750,0.6153846153846154,63,28,35,190.38472057634482,0.4314834722148033,0.7483327635239483,0.1176808309065546,1090281.3315857784,-1835.4186672875435,1088445.9129184908,2560,0,1045.7628865979382,85,109,39,36.85948176118331,0.6126225490196078,41.77567829457362,8444.451122071565,99.34648378907724,0
2562,32.71736814502621,2,1,193,0.010309278350515464,0.005154639175257732,0.9948453608247423,194,5550,4000,1550,0.7207207207207207,71,40,31,190.71959874422294,0.4304785846553781,0.7494482024158151,0.11855492949885875,1092505.2171388848,-2677.568672260203,1089827.6484666246,2561,0,1046.721649484536,77,117,42,36.644477890892816,0.6178300865800865,41.573183760683776,8455.045285448783,109.80578292790628,0
2563,32.66822699056537,0,1,192,0.0,0.0051813471502590676,0.9948186528497409,193,5300,3900,1400,0.7358490566037735,67,39,28,191.42279253184722,0.4298213064910766,0.7506196032153185,0.11922120989891016,1091445.6585146354,-2114.484830073203,1089331.173684562,2562,1,1053.1191709844559,76,117,41,36.55613268439048,0.6189692982456141,41.50432900432903,8444.59525616515,111.11309547585724,0
2564,32.654333894824234,1,0,193,0.0051813471502590676,0.0,1.0,193,4850,3200,1650,0.6597938144329897,65,32,33,190.76844169797153,0.42880820020149685,0.7491196552706554,0.11938756802467394,1092434.0325584232,-1769.6123901994297,1090664.4201682238,2563,0,1053.9740932642487,80,113,45,36.397741208445204,0.6190104166666667,41.33230452674899,8446.621295788307,105.58276619735383,0
2565,32.543017240686595,0,3,190,0.0,0.015544041450777202,0.9844559585492227,193,5400,3500,1900,0.6481481481481481,73,35,38,190.9024539469094,0.4285405872193437,0.7495415991899488,0.1198420304885215,1089638.2682468025,-2397.0761354445513,1087241.192111358,2564,1,1054.9740932642487,81,112,40,36.28191833161526,0.619727366255144,41.22205284552849,8421.415195757529,103.9680888365127,0
2566,32.8239315645422,1,0,191,0.005235602094240838,0.0,1.0,191,5400,3900,1500,0.7222222222222222,69,39,30,189.06473010577994,0.42835032607697254,0.7462639643007296,0.11931818551825416,1100640.1253893592,-1981.5543499335004,1098658.5710394257,2565,0,1066.6701570680627,83,108,45,36.13809677728298,0.6208584337349398,41.03422619047622,8500.274837082596,102.41294984436863,0
2567,33.129458689800835,1,3,189,0.005208333333333333,0.015625,0.984375,192,4850,2800,2050,0.5773195876288659,69,28,41,188.96928341232353,0.42885296229639325,0.7482302258217062,0.11981275855333169,1112293.5163527948,-1212.138254127428,1111081.3780986674,2566,0,1062.109375,84,108,42,35.973338850792146,0.6221478174603174,40.87009803921571,8584.833382302015,102.20039740835732,0
2568,33.54213228649699,0,1,188,0.0,0.005291005291005291,0.9947089947089947,189,5150,3700,1450,0.7184466019417476,66,37,29,192.08285077776094,0.42723460542609476,0.7493715058221009,0.12220066056409755,1127188.423856337,352.7131636037666,1127541.137019941,2567,2,1079.7883597883597,82,107,42,35.77076374433204,0.6241107723577235,40.750502008032164,8695.780956854622,106.04610922993442,0
2569,33.88957108126878,0,2,186,0.0,0.010638297872340425,0.9893617021276596,188,4700,3300,1400,0.7021276595744681,61,33,28,193.3839776777781,0.4266691081655099,0.7494445868580686,0.12346823190196698,1139967.0663030408,1790.2731406703042,1141757.339443711,2568,3,1086.3563829787233,83,105,44,35.6091030789826,0.625,40.62500000000003,8790.10749920417,105.90490962896591,0
2570,33.77487575411064,1,1,186,0.0053475935828877,0.0053475935828877,0.9946524064171123,187,5050,3900,1150,0.7722772277227723,62,39,23,198.31399057853548,0.42604771625170107,0.7529581097609832,0.12693387344847598,1136880.2690041172,2641.8525912409364,1139522.1215953582,2569,0,1093.042780748663,70,117,45,35.39145697860711,0.6316964285714286,40.536971830985905,8763.331539193738,125.19045055991053,0
2571,33.56864790675786,0,0,186,0.0,0.0,1.0,186,5700,4200,1500,0.7368421052631579,72,42,30,198.63933882987686,0.4253923278116827,0.7523921540023235,0.12740862595723368,1130577.545185675,2015.4352143173082,1132592.9803999923,2570,1,1099.763440860215,70,116,43,35.30820143207086,0.6324404761904762,40.46361502347416,8712.285526269712,124.46122180385304,0
2572,33.40155442227766,0,1,185,0.0,0.005376344086021506,0.9946236559139785,186,5650,4400,1250,0.7787610619469026,69,44,25,194.42215488235766,0.4253033275210694,0.747015732684255,0.12523393551919432,1126235.8742940302,943.0411172122072,1127178.9154112425,2571,2,1100.763440860215,73,113,45,35.266469716681094,0.6324200913242009,40.3153153153153,8673.872128127483,118.82016613873265,0
2573,33.645176589018604,1,0,186,0.005376344086021506,0.0,1.0,186,4350,3200,1150,0.735632183908046,55,32,23,192.10769997441366,0.42541291291291294,0.7428693259477162,0.12433058927408021,1135892.4186548274,2092.735993230224,1137985.1546480577,2572,0,1101.5860215053763,78,108,45,35.15840395121868,0.6318108974358974,40.15031645569618,8742.688489448632,112.08574986472605,0
2574,33.064230358960785,1,0,187,0.0053475935828877,0.0,1.0,187,5300,3700,1600,0.6981132075471698,69,37,32,190.30225434144,0.4258668276694842,0.7423896488028787,0.12365001992956434,1117459.05273923,-169.004625895142,1117290.048113335,2573,0,1096.6898395721926,79,108,47,35.06541000984958,0.6327795358649789,40.013020833333314,8596.269369496955,108.81353632274626,0
2575,33.00720202929248,0,1,186,0.0,0.0053475935828877,0.9946524064171123,187,5000,3200,1800,0.64,68,32,36,191.96664167761128,0.42558651026392963,0.7452746531044141,0.1251681913143565,1116570.6753071789,468.8645468840441,1117039.539854063,2574,1,1097.6898395721926,80,107,45,34.89876891130226,0.63359375,39.89197530864195,8585.438120427789,107.31797650534736,0
2576,33.02487505630073,0,0,186,0.0,0.0,1.0,186,4650,3100,1550,0.6666666666666666,62,31,31,194.55159239611461,0.425182844134457,0.7479669483217417,0.12706535949500447,1117663.6870399616,1638.650015387249,1119302.3370553488,2575,3,1104.5860215053763,82,104,45,34.77277295385111,0.6333841463414633,39.83433734939758,8591.938502975796,104.77973784116824,0
2577,32.8089577251248,0,1,185,0.0,0.005376344086021506,0.9946236559139785,186,5850,4100,1750,0.7008547008547008,76,41,35,196.28601118594477,0.42484318996415765,0.7506328088613496,0.12867638511078552,1111453.1104784077,582.5395352034238,1112035.6500136112,2576,4,1105.5860215053763,84,102,45,34.596672944130574,0.6339285714285714,39.70588235294117,8539.978701980985,101.66641311882124,0
2578,33.04116001850594,0,0,185,0.0,0.0,1.0,185,6150,4700,1450,0.7642276422764228,76,47,29,195.70282224099785,0.4242521053662358,0.7498049063470991,0.12903941419961915,1121032.6759582309,727.8517018809243,1121760.527660112,2577,5,1111.6702702702703,67,118,46,34.408813584239944,0.6438121890547264,39.50674019607845,8606.999480923649,128.46267881975595,0
2579,32.931439191963015,0,0,185,0.0,0.0,1.0,185,5350,4000,1350,0.7476635514018691,67,40,27,193.60772601273013,0.42408685859772816,0.7464456000075139,0.12827440511649324,1118725.5089548817,968.7803642379567,1119694.2893191196,2578,6,1112.6702702702703,68,117,47,34.295243059577636,0.6449142156862745,39.34178743961355,8583.850076818182,126.23308936497327,0
2580,33.13510995264215,1,0,186,0.005376344086021506,0.0,1.0,186,5450,4100,1350,0.7522935779816514,68,41,27,195.48907856072393,0.4243703380800155,0.7495774568392481,0.1301305385466702,1127028.8869177294,1414.3677229733653,1128443.2546407029,2579,0,1107.6827956989248,69,117,45,34.08283172628899,0.6459842995169083,39.18154761904764,8642.248097320868,125.24997242494011,0
2581,33.29230308343507,0,0,186,0.0,0.0,1.0,186,4100,2700,1400,0.6585365853658537,55,27,28,196.55671417285356,0.4242232151506345,0.7511393326597411,0.13115827572742467,1133090.8628892722,3243.3233737598925,1136334.186263032,2580,1,1108.6827956989248,70,116,47,33.97099758196031,0.6462797619047619,39.099178403755886,8685.98922729942,124.08556038999171,0
2582,33.42070813319798,0,0,186,0.0,0.0,1.0,186,5500,4100,1400,0.7454545454545455,69,41,28,194.2090777823559,0.42416872517678966,0.7475864377107841,0.13013046762636019,1138689.5085827766,1528.767868461318,1140218.276451238,2581,2,1109.6827956989248,74,112,47,33.888667198723084,0.6456925675675675,38.95833333333336,8724.197352270277,117.89455881446321,0
2583,33.0283304740117,0,0,186,0.0,0.0,1.0,186,5850,4100,1750,0.7008547008547008,76,41,35,194.30008979240813,0.4236728664148019,0.7479635060280216,0.13099586698907617,1127117.5808088412,749.8094315523563,1127867.3902403936,2582,3,1110.6827956989248,79,107,44,33.67391015417335,0.6455696202531646,38.75000000000003,8628.651336335626,109.22343463715983,0
2584,32.79183189607588,0,0,186,0.0,0.0,1.0,186,6200,4400,1800,0.7096774193548387,80,44,36,192.59323271614616,0.4232950692628112,0.7462232736342693,0.13024701371558375,1119939.4418629752,-261.4484890581116,1119677.9933739172,2583,4,1111.6827956989248,79,107,45,33.612328949116545,0.6466244725738397,38.64583333333337,8570.28189867243,108.48458099585355,0
2585,33.220297849190565,0,0,186,0.0,0.0,1.0,186,5000,3100,1900,0.62,69,31,38,192.40410177426716,0.4230480480480481,0.7463539251825899,0.1303783628898537,1135154.3156938085,1481.6692972502574,1136635.9849910587,2584,5,1112.6827956989248,83,103,45,33.549019259048436,0.6457078313253012,38.578869047619065,8684.487834310394,104.63238354590835,0
2586,32.983618695052016,0,0,186,0.0,0.0,1.0,186,5550,4000,1550,0.7207207207207207,71,40,31,193.78230612273933,0.42275138041267074,0.7477129126347082,0.13186072341817565,1128273.5128384512,977.8886510079346,1129251.4014894592,2585,6,1113.6827956989248,70,116,45,33.37037712212996,0.6529761904761905,38.43896713615024,8627.229373465205,123.24613390664578,0
2587,33.17918691181364,0,1,185,0.0,0.005376344086021506,0.9946236559139785,186,4950,3500,1450,0.7070707070707071,64,35,29,200.2338438903277,0.4223439164971423,0.7546680550794278,0.13391014124437262,1129896.7416153299,3098.7135545589254,1132995.4551698887,2586,7,1114.6827956989248,79,107,44,33.797803472534056,0.6428006329113924,39.02343750000001,8658.990146790135,109.60747021253334,8
2588,32.69732800868968,1,1,185,0.005376344086021506,0.005376344086021506,0.9946236559139785,186,5650,4000,1650,0.7079646017699115,73,40,33,213.97329608626026,0.42236934515160324,0.7634923886117098,0.13728171425303695,1101313.6327015895,4280.341602778295,1105593.9743043678,2587,0,1114.6344086021506,66,120,43,34.900388363084545,0.6347853535353536,40.45398009950248,8486.461346036449,128.5827476672189,7
2589,32.715421719002244,1,0,186,0.005376344086021506,0.0,1.0,186,4550,3300,1250,0.7252747252747253,58,33,25,211.43549537008525,0.4226296861377507,0.7612175218845998,0.13641934016343854,1103593.2908819234,4917.758828944388,1108511.0497108677,2588,0,1110.4193548387098,67,119,47,34.765471416214524,0.6361940298507462,40.25735294117647,8497.590236939368,126.8297050289458,0
2590,32.573055990891646,0,0,186,0.0,0.0,1.0,186,5200,3900,1300,0.75,65,39,26,211.73319292381748,0.42270294488036425,0.761986680009145,0.13712472471747877,1099895.5876975819,4176.880933205429,1104072.4686307872,2589,1,1111.4193548387098,68,118,48,34.62443360055769,0.6369485294117647,40.12681159420289,8464.863916473547,124.48329288931687,0
2591,32.09178470528253,0,2,184,0.0,0.010752688172043012,0.989247311827957,186,4550,3200,1350,0.7032967032967034,59,32,27,212.20334399998097,0.42248135232006195,0.7632638239703948,0.13772820883285614,1084274.0872686228,4267.3174261858385,1088541.4046948086,2590,2,1112.4193548387098,68,118,51,34.53513076640146,0.6377144607843137,40.05132850241546,8342.216800124697,122.67965882536319,0
2592,31.75520639811968,0,0,184,0.0,0.0,1.0,184,5050,3400,1650,0.6732673267326733,67,34,33,212.29011566793952,0.421594103904332,0.7612112702719751,0.13814496571138118,1073650.0725711249,3735.0596186031034,1077385.132189728,2591,3,1112.4076086956522,68,116,42,34.440372520561155,0.6386335784313726,39.96074879227053,8257.60009371394,121.43529549579323,0
2593,31.43991159329747,0,0,184,0.0,0.0,1.0,184,4700,3200,1500,0.6808510638297872,62,32,30,214.09888515937138,0.42133857507721545,0.7639413988657848,0.13964360121588845,1063642.3747626883,4044.9293289915745,1067687.3040916799,2592,4,1113.4076086956522,69,115,43,34.31183257055684,0.6388888888888888,39.88095238095238,8178.11986087559,118.52347624457377,0
2594,31.206199196081716,0,0,184,0.0,0.0,1.0,184,5350,3900,1450,0.7289719626168224,68,39,29,212.70644016716105,0.4213657984873684,0.7625636826337026,0.13898806226692845,1056246.1171108636,2784.0703022076527,1059030.1874130713,2593,5,1114.4076086956522,70,114,44,34.283838013608495,0.6389880952380953,39.818075117370896,8119.288975107303,115.98984250153289,0
2595,30.923251485694117,0,0,184,0.0,0.0,1.0,184,4550,3200,1350,0.7032967032967034,59,32,27,212.3690816656814,0.42132743822760754,0.7621339248381269,0.13907198434961565,1047277.423402343,3131.8689314312996,1050409.2923337743,2594,6,1115.4076086956522,71,113,44,34.21541173309619,0.639231220657277,39.742476851851855,8048.008839354044,113.35223717400062,0
2596,30.570936228351293,0,0,184,0.0,0.0,1.0,184,5150,4000,1150,0.7766990291262136,63,40,23,209.69885091934037,0.4209444543438663,0.7588414770336125,0.137565124159325,1035827.8348336851,1492.3813429785523,1037320.2161766636,2595,7,1116.4076086956522,73,111,44,34.22302808269797,0.6388413242009132,39.68186936936938,7958.1689705926565,109.01601329578982,0
2597,30.230264791304513,0,0,184,0.0,0.0,1.0,184,4800,3500,1300,0.7291666666666666,61,35,26,210.43990917376436,0.42070996178823156,0.7602974655027492,0.13851092705529655,1025184.7729784916,1547.9581023840092,1026732.7310808756,2596,8,1117.4076086956522,65,119,43,34.08701240328868,0.6443910256410257,39.567550505050505,7872.941908480363,121.12218320739021,0
2598,29.87618584543736,0,0,184,0.0,0.0,1.0,184,4350,3000,1350,0.6896551724137931,57,30,27,205.50993056565684,0.42069573136928806,0.7541288458100792,0.13590973957952365,1014444.0696958981,545.6660651893208,1014989.7357610874,2597,9,1118.4076086956522,69,115,41,34.04927097609263,0.643719806763285,39.40476190476191,7785.591763769342,112.83466324303394,0
2599,29.6752271415208,0,0,184,0.0,0.0,1.0,184,5500,4000,1500,0.7272727272727273,70,40,30,200.11160370583372,0.4206152985665637,0.7466788109829656,0.13276918625843662,1008477.4009469666,-1938.393999082179,1006539.0069478845,2598,10,1119.4076086956522,71,113,43,34.07695153533113,0.6437793427230047,39.293981481481495,7736.5103166985955,108.9649340380084,0
2600,30.06439086743098,0,0,184,0.0,0.0,1.0,184,5850,4700,1150,0.8034188034188035,70,47,23,199.17442089030743,0.42025335095430427,0.7452163061564063,0.13270934252225614,1022836.9485084591,-1905.4086231235924,1020931.5398853356,2599,11,1120.4076086956522,71,113,44,33.953826955074874,0.6452464788732395,39.149305555555564,7842.317235818601,110.45517233547325,0
2601,30.432861086954436,0,2,182,0.0,0.010869565217391304,0.9891304347826086,184,5350,4000,1350,0.7476635514018691,67,40,27,197.99378404912105,0.4203065603468757,0.7436897802670641,0.132398841552994,1036345.3938642038,-1112.0107773897316,1035233.3830868141,2600,12,1121.4076086956522,72,112,46,33.859719868044536,0.6459780092592593,39.02682648401828,7942.1603370335615,110.30778245879947,0
2602,30.822623073484046,0,0,182,0.0,0.0,1.0,182,5200,3800,1400,0.7307692307692307,66,38,28,199.36066123424328,0.4199729828182867,0.741798533613478,0.13367110713124736,1050350.3997598626,279.710044755916,1050630.1098046184,2601,13,1131.7692307692307,73,109,39,33.73121787267696,0.6464041095890412,38.935810810810835,8046.683101363167,110.22853563511188,0
2603,31.374294502984924,0,1,181,0.0,0.005494505494505495,0.9945054945054945,182,5150,3700,1450,0.7184466019417476,66,37,29,199.017585338136,0.419830054843867,0.7420411350795677,0.1338757317957518,1070051.45153508,1041.8112144161214,1071093.2627494961,2602,14,1132.7692307692307,76,106,40,33.62793086777861,0.6461074561403508,38.8257575757576,8194.157598412217,107.81786313700286,0
2604,31.129355954973445,0,1,180,0.0,0.0055248618784530384,0.994475138121547,181,5300,3900,1400,0.7358490566037735,67,39,28,200.84646015421094,0.41900322283609576,0.742574413971619,0.13571006672298458,1062921.881921089,1196.8194808609323,1064118.7014019499,2603,15,1139.7624309392265,77,104,45,33.426597846824755,0.6471861471861472,38.675213675213705,8134.872293361727,105.64769212158087,0
2605,31.0798762244808,1,0,181,0.0055248618784530384,0.0,1.0,181,4850,3400,1450,0.7010309278350515,63,34,29,203.09769031539957,0.4193306220585226,0.7468325864387244,0.1382668938948139,1063284.931021364,2140.1427275215747,1065425.0737488854,2604,0,1139.9779005524863,69,112,45,33.11004285660106,0.6536835748792271,38.42261904761905,8129.792623123866,117.82308149454879,0
2606,31.11539952833094,0,0,181,0.0,0.0,1.0,181,5200,3900,1300,0.75,65,39,26,201.12774203242324,0.4192973705749949,0.7442078821195215,0.13716943213398214,1064984.756118914,1439.5958594295307,1066424.3519783437,2605,1,1140.9779005524863,69,112,43,33.10085124938386,0.6542874396135265,38.363095238095234,8140.936823022526,117.98459163800763,0
2607,30.825990275232375,0,0,181,0.0,0.0,1.0,181,5050,3500,1550,0.693069306930693,66,35,31,200.54476172165263,0.4191682013505218,0.7442162043975851,0.13707659247565873,1055679.3402886696,1092.192350532493,1056771.532639202,2606,2,1141.9779005524863,69,112,47,33.04020725535905,0.655042270531401,38.28869047619047,8067.510282299267,116.92043887390241,0
2608,30.640935908310222,1,0,182,0.005494505494505495,0.0,1.0,182,4900,3400,1500,0.6938775510204082,64,34,30,198.42606747139556,0.4191792898629915,0.7433695003302163,0.13634270371780274,1050746.5522318387,399.1012536980561,1051145.6534855368,2607,0,1136.6978021978023,72,110,47,32.91707531920304,0.6552372685185186,38.11358447488583,8024.444873362094,111.45062324114019,0
2609,30.330493674384584,0,0,182,0.0,0.0,1.0,182,5000,3800,1200,0.76,62,38,24,199.34732596330582,0.41912553376641776,0.7444372549481602,0.13787048514995562,1041818.0629652156,136.72899847701774,1041954.7919636926,2608,1,1137.6978021978023,75,107,39,32.67253438268057,0.6559722222222222,37.89747807017542,7949.698883432738,105.9959851124365,0
2610,30.296624842280114,0,2,180,0.0,0.01098901098901099,0.989010989010989,182,5100,3800,1300,0.7450980392156863,64,38,26,199.45902971475968,0.4188978608868112,0.7449245285158603,0.13825164505980075,1041232.9009062417,36.66082436846864,1041269.5617306102,2609,2,1138.6978021978023,76,106,41,32.5953517371861,0.65625,37.82467532467531,7943.027454591267,104.51351913935878,0
2611,30.066080636641175,0,0,180,0.0,0.0,1.0,180,4950,3000,1950,0.6060606060606061,69,30,39,200.9006378853974,0.41770122077384647,0.7447576174471322,0.13998686238676278,1034680.866501185,623.6092175805388,1035304.4757187655,2610,6,1152.0722222222223,75,105,45,32.38015472894134,0.6584722222222222,37.65076754385963,7887.813177987195,105.1708423731626,0
2612,30.346075417535143,0,0,180,0.0,0.0,1.0,180,4700,3700,1000,0.7872340425531915,57,37,20,205.23225942113976,0.41708048830953864,0.7505469081079847,0.1435442068236819,1045301.6146232457,2205.922429138612,1047507.5370523842,2611,7,1153.0722222222223,76,104,46,32.14026474933857,0.659265350877193,37.52705627705626,7965.02374527887,104.80294401682723,0
2613,30.899355921469713,0,0,180,0.0,0.0,1.0,180,5100,3800,1300,0.7450980392156863,64,38,26,205.42083222871776,0.41693371094558246,0.7508816820961026,0.14399329678716763,1064946.7533515897,2652.4496705509273,1067599.2030221405,2612,8,1154.0722222222223,68,112,45,32.06148295095163,0.6640625,37.45471014492753,8112.480356737312,119.30118171672518,0
2614,30.75746084447136,0,0,180,0.0,0.0,1.0,180,4550,3400,1150,0.7472527472527473,57,34,23,204.75765015711724,0.4168625853507138,0.7502921325677454,0.14385203065178342,1060652.0317610935,2885.323531554598,1063537.355292648,2613,9,1155.0722222222223,69,111,43,32.00362647325478,0.6642512077294687,37.38095238095237,8077.495074155199,117.06514600224926,0
2615,30.74003803587035,0,0,180,0.0,0.0,1.0,180,4600,2900,1700,0.6304347826086957,63,29,34,203.8332722088663,0.4168186168011587,0.749128114431103,0.14351689889499597,1060629.9634643686,2638.335211142477,1063268.298675511,2614,10,1156.0722222222223,70,110,47,31.954761239877108,0.6644345238095238,37.30927230046948,8075.12296115402,115.35889944505743,0
2616,31.234777294393304,0,0,180,0.0,0.0,1.0,180,4800,3400,1400,0.7083333333333334,62,34,28,203.4846169292349,0.4168309021311815,0.7489679874225377,0.14364131742268507,1078390.678054626,3087.1828048006437,1081477.8608594267,2615,11,1157.0722222222223,71,109,45,31.878051074528802,0.6647593896713615,37.22511574074073,8207.714988397925,115.60161955490035,0
2617,31.118332724924564,0,0,180,0.0,0.0,1.0,180,4300,2800,1500,0.6511627906976745,58,28,30,206.03822709750816,0.4167436116283882,0.7508219580214295,0.1457672316942184,1074961.9893955742,3996.652498454921,1078958.6418940292,2616,12,1158.0722222222223,71,109,45,31.73712021136062,0.6654929577464789,37.15277777777778,8179.3673169333,115.20235657652535,0
2618,31.36022895393887,0,0,180,0.0,0.0,1.0,180,5200,3700,1500,0.7115384615384616,67,37,30,207.685883678751,0.4164920856610801,0.7531412989824364,0.1475920640840667,1084517.4671253446,3847.793704993662,1088365.260830338,2617,13,1159.0722222222223,73,107,45,31.5453331013934,0.665953196347032,37.00731981981983,8247.51066366049,112.97959813233548,0
2619,31.740587207342173,0,0,180,0.0,0.0,1.0,180,5900,4700,1200,0.7966101694915254,71,47,24,207.23542129148788,0.41602201013863027,0.7535408455330326,0.1478112884392298,1098660.064694712,3636.2562726283277,1102296.3209673404,2618,14,1160.0722222222223,74,106,45,31.436294693130616,0.6666666666666667,36.888888888888886,8351.301167442913,112.85542118166099,0
2620,32.02908822805102,0,1,179,0.0,0.005555555555555556,0.9944444444444445,180,5350,3800,1550,0.7102803738317757,69,38,31,206.2273160866703,0.4156702617421891,0.752389299640158,0.1476809035332064,1109733.7096964773,4421.480904321768,1114155.190600799,2619,15,1161.0722222222223,75,105,38,31.331137838869786,0.6675,36.75986842105264,8431.341399505882,112.4178853267451,0
2621,32.12775301439573,0,0,179,0.0,0.0,1.0,179,5250,3700,1550,0.7047619047619048,68,37,31,210.33853157521696,0.41568456677756155,0.7558874164070235,0.15115024710870295,1114100.8308895503,5817.666559207637,1119918.497448758,2620,16,1168.167597765363,76,103,38,31.108414239482222,0.6681743421052632,36.64772727272729,8460.916773961635,111.32785228896888,0
2622,32.423477952283,0,0,179,0.0,0.0,1.0,179,5450,4100,1350,0.7522935779816514,68,41,27,211.03077741945555,0.41568587450044986,0.7573152802977607,0.15215936283761222,1125280.0486663335,6243.7446969319135,1131523.7933632655,2621,17,1169.167597765363,76,103,39,30.979674796747968,0.6692708333333333,36.539502164502174,8542.30564286679,112.39875845877354,0
2623,32.22760326351053,0,1,178,0.0,0.00558659217877095,0.994413407821229,179,3300,2400,900,0.7272727272727273,42,24,18,211.53476514310685,0.4157237984642102,0.7581485715727987,0.15271586936461978,1118826.6938127824,8234.148382305195,1127060.8421950876,2622,18,1170.167597765363,76,103,39,30.924953794024052,0.6696820175438596,36.498917748917755,8492.008338293548,111.73695181965195,0
2624,32.080606027069216,0,0,178,0.0,0.0,1.0,178,4800,3100,1700,0.6458333333333334,65,31,34,213.02211268130606,0.4155405584121543,0.7583787101718111,0.15442113548167924,1114832.5197630962,7096.795729151829,1121929.3154922482,2623,19,1176.4943820224719,68,110,40,30.751803813777688,0.6750919117647058,36.36775362318841,8457.482232045753,124.37473870655519,0
2625,32.010611897971124,0,0,178,0.0,0.0,1.0,178,5100,3600,1500,0.7058823529411765,66,36,30,210.3355359138499,0.4152582047863899,0.7544981727473383,0.1529400272905292,1113223.1041685145,6130.075641392747,1119353.1798099072,2624,20,1177.4943820224719,71,107,39,30.7230808967396,0.6744424882629108,36.270254629629626,8442.150525001669,118.90352852115026,0
2626,31.979040820190605,0,0,178,0.0,0.0,1.0,178,4850,3500,1350,0.7216494845360825,62,35,27,210.37325433745195,0.4150056073975327,0.7548913529051127,0.15338489775463549,1112857.389893274,6373.086145066074,1119230.47603834,2625,21,1178.4943820224719,71,107,42,30.633454437437173,0.6753227699530516,36.18344907407407,8436.600251102067,118.82535564932489,0
2627,31.838033791565678,0,1,177,0.0,0.0056179775280898875,0.9943820224719101,178,4900,3400,1500,0.6938775510204082,64,34,30,207.05303140978813,0.4148409562199793,0.7507276040085027,0.15176232492397299,1109357.4753000957,5439.16563559878,1114796.6409356946,2626,22,1179.4943820224719,72,106,42,30.550112612612605,0.6765046296296297,36.01598173515981,8404.732093949266,116.7323901937398,0
2628,31.71330803984017,0,0,177,0.0,0.0,1.0,177,4750,3200,1550,0.6736842105263158,63,32,31,203.86256369046097,0.4140625,0.7454616023662386,0.15006172155841951,1106140.2660091312,4950.118085973914,1111090.384095105,2627,23,1182.0395480225989,73,104,43,30.49679999644689,0.6773687214611872,35.88119369369369,8376.081063506763,114.74083648639402,0
2629,31.776791651170406,0,0,177,0.0,0.0,1.0,177,5300,4300,1000,0.8113207547169812,63,43,20,204.03018519331152,0.4137615562403698,0.7447440160412355,0.15070091609795602,1109262.5527883114,4564.608814680843,1113827.1616029923,2628,24,1183.0395480225989,75,102,37,30.381998478403695,0.6775,35.773026315789465,8396.285491382425,111.95047321843234,0
2630,31.481698435849577,0,0,177,0.0,0.0,1.0,177,5500,4200,1300,0.7636363636363637,68,42,26,203.6256814775224,0.41322253252867663,0.7446566701113311,0.1510589286284018,1100101.8700069792,3901.7985949735044,1104003.6686019527,2629,25,1184.0395480225989,75,102,39,30.252834231992246,0.6788888888888889,35.6359649122807,8322.628829915928,110.96838439887904,0
2631,31.79455905707714,0,2,175,0.0,0.011299435028248588,0.9887005649717514,177,5350,4200,1150,0.7850467289719626,65,42,23,204.89593614580028,0.41270624678993323,0.7463868135416367,0.15274271009559146,1112316.9170423867,4831.843201642059,1117148.7602440289,2630,26,1185.0395480225989,77,100,40,30.063603355716005,0.6795183982683983,35.48344017094017,8410.18738305992,109.22321276701194,0
2632,31.539204237192486,0,0,175,0.0,0.0,1.0,175,5750,4500,1250,0.782608695652174,70,45,25,205.45204363210237,0.411551724137931,0.7441414204509949,0.15405535206118703,1104906.6312939462,4651.06508440088,1109557.696378347,2631,27,1194.3257142857142,71,104,39,29.862629354321538,0.6842723004694835,35.300925925925945,8348.39815861801,117.5830726565917,0
2633,31.665294294969037,0,0,175,0.0,0.0,1.0,175,4950,3800,1150,0.7676767676767676,61,38,23,208.07336199232097,0.41107006020799125,0.7478239692773603,0.15645680653999516,1110051.6229162044,6244.434633041682,1116296.0575492461,2632,28,1195.3257142857142,71,104,42,29.704631552107248,0.6851525821596245,35.214120370370395,8384.522803624528,118.0918704735849,0
2634,31.395775169360544,0,0,175,0.0,0.0,1.0,175,4650,3800,850,0.8172043010752689,55,38,17,207.05044721542933,0.4110495347564313,0.7470712178676768,0.15597800356895755,1101084.5575677808,5946.010013282695,1107030.5675810636,2633,29,1196.3257142857142,71,104,42,29.672648312028855,0.6857394366197183,35.15625000000002,8314.97483001038,117.11232154944197,0
2635,31.653980728312362,0,0,175,0.0,0.0,1.0,175,4400,3100,1300,0.7045454545454546,57,31,26,207.10434695298432,0.41047482211275316,0.7475969451833582,0.1565291748142806,1110989.2835638362,6618.1420088506675,1117607.4255726868,2634,30,1197.3257142857142,71,104,41,29.567850252097784,0.6867664319248826,35.05497685185187,8386.564656793793,118.12062896892667,0
2636,31.67389395552318,0,1,174,0.0,0.005714285714285714,0.9942857142857143,175,5300,4100,1200,0.7735849056603774,65,41,24,209.55237728871364,0.41007936507936504,0.7503595405740477,0.1589734618760472,1112659.686665126,6332.0964907986545,1118991.7831559246,2635,31,1198.3257142857142,71,104,41,29.384824791223195,0.6879401408450705,34.93923611111113,8395.506527186672,118.24657080544608,0
2637,31.375630351869162,0,0,174,0.0,0.0,1.0,174,4350,3200,1150,0.735632183908046,55,32,23,208.30777088590995,0.4097789737116028,0.7475127520661453,0.15832399341667697,1102660.1784859218,6788.536765012785,1109448.7152509347,2636,32,1203.6149425287356,73,101,44,29.35913772963794,0.6875,34.881756756756786,8318.251999536997,113.94865752790406,0
2638,31.832777930859564,0,0,174,0.0,0.0,1.0,174,5550,4300,1250,0.7747747747747747,68,43,25,207.35563931379562,0.4092889730471951,0.746706663946417,0.15834807498017614,1119955.607317976,6095.822191698189,1126051.4295096742,2637,33,1204.6149425287356,74,100,37,29.235714784369165,0.6884853603603603,34.736111111111136,8444.086468076264,114.10927659562519,0
2639,31.41545093087133,0,0,174,0.0,0.0,1.0,174,3650,2200,1450,0.6027397260273972,51,22,29,207.7919880706091,0.4089380827409031,0.7466706499129632,0.1589687764562622,1105736.0288876328,7502.617544772593,1113238.6464324053,2638,34,1205.6149425287356,74,100,37,29.167430072065475,0.6890484234234234,34.68055555555558,8335.129987950539,112.63689172906133,0
2640,31.476736869271612,0,0,174,0.0,0.0,1.0,174,5000,4100,900,0.82,59,41,18,200.50644132507756,0.40870000332203843,0.7344266004300861,0.1369492598681789,1077761.8896728079,3419.6402188172647,1081181.529891625,2639,35,1206.6149425287356,72,102,42,33.0663703946053,0.6532118055555556,38.31335616438357,8237.04163021652,114.40335597522943,8
2641,31.603173420368474,0,2,172,0.0,0.011494252873563218,0.9885057471264368,174,4650,3700,950,0.7956989247311828,56,37,19,201.23348842259895,0.408771980820765,0.7352188005297169,0.13805144555104967,1083304.5518274978,4149.430797665612,1087453.9826251634,2640,36,1207.6149425287356,74,100,43,32.8977031614683,0.6537162162162162,38.16666666666668,8274.764240566501,111.8211383860338,0
2642,31.279083756155153,0,2,170,0.0,0.011627906976744186,0.9883720930232558,172,4400,2900,1500,0.6590909090909091,59,29,30,200.8394190772418,0.40867673058615533,0.7326574346875026,0.13827536697789078,1073171.1296128526,4307.013248382655,1077478.1428612352,2641,37,1209.860465116279,77,95,45,32.78650480074776,0.6535443722943723,38.04754273504275,8193.632850921274,106.41081624573084,0
2643,31.687722691754942,0,0,170,0.0,0.0,1.0,170,5100,3700,1400,0.7254901960784313,65,37,28,206.67888116309564,0.4083507367444019,0.7355639090982646,0.14275465276534485,1088078.350828637,5876.56323341001,1093954.914062047,2642,38,1223.9,77,93,47,32.52449294195585,0.6546266233766234,37.940705128205146,8304.062264694321,107.84496447654962,0
2644,31.59532802670025,0,0,170,0.0,0.0,1.0,170,5550,4500,1050,0.8108108108108109,66,45,21,231.45407908100785,0.4080635804617705,0.7679651930085576,0.14864214129813935,1064476.1139531787,9725.46773175275,1074201.5816849314,2643,39,1224.9,65,105,36,34.41173415617842,0.6357371794871796,40.419823232323246,8201.520834203613,126.17724360313251,8
2645,31.477918127323072,0,0,170,0.0,0.0,1.0,170,4150,3200,950,0.7710843373493976,51,32,19,229.90731981959337,0.4079562594268477,0.7661704011954131,0.1481864227372229,1061558.0228908062,10661.991975162538,1072220.0148659688,2644,40,1225.9,68,102,41,34.32201747757175,0.6352634803921569,40.29287439613528,8175.0396368409,120.22117113001323,0
2646,31.425739982609514,0,0,170,0.0,0.0,1.0,170,4350,2700,1650,0.6206896551724138,60,27,33,230.29076587125275,0.40772856479870057,0.766613744311953,0.1489572484872134,1060799.9144084065,10508.484945054444,1071308.3993534609,2645,41,1226.9,70,100,43,34.18654714850369,0.6354166666666667,40.170187793427246,8165.344118134048,116.64777311620068,0
2647,31.165234749704723,0,0,170,0.0,0.0,1.0,170,3850,2800,1050,0.7272727272727273,49,28,21,231.53913822466626,0.40793885601577906,0.7663102762768887,0.15011020534340752,1052655.0645224077,10896.16929746985,1063551.2338198775,2646,42,1227.9,73,97,41,34.072158434431,0.634703196347032,40.0900900900901,8100.153356116967,110.96100487831463,0
2648,30.92077277869743,0,0,170,0.0,0.0,1.0,170,4800,3400,1400,0.7083333333333334,62,34,28,227.87361846356032,0.4080556038983641,0.7623436966589816,0.1482434756132309,1045358.3336130679,8841.917214289739,1054200.2508273576,2647,43,1228.9,77,93,37,34.04523607758546,0.6340638528138528,39.97061965811967,8040.309385336812,104.41960240697158,0
2649,31.346504515141486,0,0,170,0.0,0.0,1.0,170,4350,2900,1450,0.6666666666666666,58,29,29,227.339978578289,0.4081687260703098,0.7620447676016155,0.1484683245954959,1060840.1414240124,9884.275005264735,1070724.416429277,2648,44,1229.9,77,93,39,33.922529216501566,0.6354166666666667,39.83707264957265,8155.198376862589,105.91166723198167,0
2650,31.1924121799236,0,0,170,0.0,0.0,1.0,170,4600,3300,1300,0.717391304347826,59,33,26,223.9686431927934,0.40788374521406195,0.7590500259278916,0.14667196679958014,1056400.5192012512,8720.118190733196,1065120.6373919845,2649,45,1230.9,78,92,40,33.91258823926774,0.6359508547008548,39.74156118143459,8118.088496932099,104.07805765297563,0
2651,31.691861595058914,0,0,170,0.0,0.0,1.0,170,4650,3400,1250,0.7311827956989247,59,34,25,226.53208135124643,0.4078634412344819,0.7626463179730332,0.1488670902667538,1074302.575324657,10022.799677859712,1084325.3750025167,2650,46,1231.9,80,90,40,33.723514594754775,0.636328125,39.62191358024691,8251.866277201098,103.14832846501372,0
2652,31.600230396418485,0,0,170,0.0,0.0,1.0,170,5150,3800,1350,0.7378640776699029,65,38,27,227.27081438812496,0.4078192075646827,0.7630882531172687,0.14965774058391237,1071773.6654532661,9566.57475746197,1081340.240210728,2651,47,1232.9,65,105,40,33.6325394901628,0.644551282051282,39.55176767676768,8230.224147754083,126.61883304237051,0
2653,32.06979593693368,0,0,170,0.0,0.0,1.0,170,4750,3100,1650,0.6526315789473685,64,31,33,224.99072845152335,0.40804762733495764,0.7607494437269777,0.14886987141658264,1089075.7661484857,10256.389992929644,1099332.1561414152,2652,48,1233.9,68,102,38,33.52352816235106,0.6444546568627452,39.38707729468598,8357.803249687273,122.90887131893048,0
2654,32.53665844798746,0,0,170,0.0,0.0,1.0,170,4550,3400,1150,0.7472527472527473,57,34,23,222.5652368048145,0.4076952082608191,0.7585038764635372,0.14763803042724477,1105663.6498744136,10666.458412154687,1116330.1082865682,2653,49,1234.9,69,101,38,33.4983327625245,0.6447765700483092,39.30059523809523,8482.287490331708,122.93170275843055,0
2655,32.508938360311745,0,0,170,0.0,0.0,1.0,170,5300,4100,1200,0.7735849056603774,65,41,24,224.82918001662043,0.4075683083884441,0.7602932904515161,0.149700867503201,1105807.246451872,10423.547295242053,1116230.793747114,2654,50,1235.9,70,100,38,33.30837270784115,0.6455357142857143,39.17253521126759,8479.22397549326,121.13177107847514,0
2656,32.87200065581593,1,0,171,0.005847953216374269,0.0,1.0,171,5450,3800,1650,0.6972477064220184,71,38,33,219.21142543562385,0.40813696823758744,0.755768140510191,0.14682321916026797,1119875.1130242741,9447.883967186383,1129322.9969914604,2655,0,1229.6666666666667,74,97,39,33.25019509772624,0.6455518018018018,38.97222222222223,8580.505282297301,115.95277408509867,0
2657,32.421821455087645,0,0,171,0.0,0.0,1.0,171,3600,2700,900,0.75,45,27,18,219.22278948237502,0.4083261667239995,0.7484551154518593,0.13366326650153976,1076801.2989387545,9411.87689431979,1086213.1758330744,2656,1,1230.6666666666667,68,103,43,36.62051409715714,0.6151960784313726,42.27053140096619,8356.05881463251,122.88321786224279,8
2658,32.627192389922484,2,0,173,0.011560693641618497,0.0,1.0,173,4250,2800,1450,0.6588235294117647,57,28,29,213.6978446808081,0.4103598153873729,0.7455153769174465,0.13127153316106807,1085898.2171214023,7560.821708315245,1093459.0388297176,2657,0,1217.4277456647399,74,99,34,36.48659560723516,0.6148648648648649,42.00000000000001,8417.815636600018,113.75426535945971,0
2659,32.9788208925498,0,0,173,0.0,0.0,1.0,173,4550,3000,1550,0.6593406593406593,61,30,31,218.8396863696491,0.4105992628937581,0.7505786405884551,0.1348663183440863,1098595.8464018933,8933.274094718017,1107529.1204966113,2658,1,1218.4277456647399,76,97,36,36.23449510831587,0.6151315789473684,41.88311688311689,8512.390457654921,112.00513760072265,0
2660,33.212568797030464,0,0,173,0.0,0.0,1.0,173,4750,3600,1150,0.7578947368421053,59,36,23,217.3987755669345,0.41072948873056414,0.7477319867157388,0.1344979116122972,1107576.9092607251,8807.172783898139,1116384.0820446233,2659,2,1219.4277456647399,80,93,37,36.12936958470276,0.61484375,41.74382716049382,8577.35090768987,107.21688634612337,0
2661,33.20473999871699,0,0,173,0.0,0.0,1.0,173,4000,3200,800,0.8,48,32,16,218.36522842442957,0.41061466594972446,0.7495642291602831,0.135502131810391,1108240.4276068213,9800.234824710205,1118040.6624315316,2660,3,1220.4277456647399,67,106,38,35.99425866635044,0.6222014925373134,41.6360294117647,8578.908468418509,128.04340997639565,0
2662,33.31290300987057,1,0,174,0.005747126436781609,0.0,1.0,174,4800,3200,1600,0.6666666666666666,64,32,32,211.74384189032583,0.41145245055699514,0.7421337593751374,0.1320793786534739,1113455.1681329396,7553.455014621673,1121008.6231475612,2661,0,1214.4080459770114,71,103,39,35.97500839348667,0.621919014084507,41.44965277777779,8613.062640182283,121.31074141101807,0
2663,33.66325209330143,0,0,174,0.0,0.0,1.0,174,5300,3800,1500,0.7169811320754716,68,38,30,210.04569758324448,0.4114953602196975,0.740891417591159,0.13146456875986826,1126217.1398422122,7211.412953673162,1133428.5527958854,2662,1,1215.4080459770114,73,101,43,35.89555216949644,0.6221461187214612,41.32882882882886,8707.712844404741,119.28373759458549,0
2664,33.761413730347165,1,0,175,0.005714285714285714,0.0,1.0,175,4700,3600,1100,0.7659574468085106,58,36,22,205.99451552828074,0.4123467432950192,0.7382262932175554,0.12964406580415389,1131219.6445049876,6905.008525176061,1138124.6530301636,2663,0,1209.4571428571428,75,100,45,35.79959098851062,0.6231944444444444,41.13212719298247,8739.745355332652,116.52993807110202,0
2665,33.960371797653146,0,0,175,0.0,0.0,1.0,175,4850,3200,1650,0.6597938144329897,65,32,33,209.54352479042203,0.4121469622331691,0.7402356706430016,0.13224404970706674,1138750.9671357418,7873.578302425465,1146624.5454381674,2664,1,1210.4571428571428,78,97,44,35.60728530210458,0.6228632478632479,41.03375527426163,8794.589953928175,112.75115325548941,0
2666,34.3396292708113,1,1,175,0.005681818181818182,0.005681818181818182,0.9943181818181818,176,4350,2900,1450,0.6666666666666666,58,29,29,206.32265230140814,0.412285579004329,0.73793074599526,0.13074700673465012,1152759.743590574,8018.089552780094,1160777.8331433542,2665,0,1204.5738636363637,82,94,37,35.54249814330459,0.6227134146341464,40.88855421686749,8897.790988016754,108.50964619532627,0
2667,34.320677181591755,0,1,174,0.0,0.005714285714285714,0.9942857142857143,175,4350,3000,1350,0.6896551724137931,57,30,27,224.99257944206008,0.4116858237547893,0.7580273277211385,0.14075582452312646,1148068.208987721,12311.365543114702,1160379.5745308357,2666,3,1212.4571428571428,67,108,44,35.52542937518509,0.6251554726368159,41.34497549019608,8877.215597597682,132.4957551880251,8
2668,34.31952127980068,3,0,177,0.01694915254237288,0.0,1.0,177,4200,2800,1400,0.6666666666666666,56,28,28,218.82849652479518,0.41374015579524054,0.7539555183598687,0.13797296379218,1150495.3094027648,10752.231763087268,1161247.541165852,2667,0,1199.723163841808,72,105,48,35.401167383078004,0.6252893518518519,41.06735159817352,8886.44453686165,123.42284078974515,0
2669,34.28190626200949,2,2,177,0.0111731843575419,0.0111731843575419,0.9888268156424581,179,5050,3800,1250,0.7524752475247525,63,38,25,230.4350116952468,0.41514970811625135,0.7628134485082092,0.14507627937064269,1148768.8911022523,12093.31457125664,1160862.205673509,2668,0,1187.3072625698323,79,100,37,35.154285283170715,0.6215717299578059,41.119791666666664,8874.907035172819,112.34059538193442,8
2670,34.13440753933099,1,0,178,0.0056179775280898875,0.0,1.0,178,3950,3000,950,0.759493670886076,49,30,19,225.4331918951995,0.4141830127594744,0.7556577930047104,0.14243437711655504,1144943.4964874722,12071.653390564321,1157015.1498780365,2669,0,1194.9606741573034,81,97,44,35.15452572465546,0.6220421810699588,40.993394308943095,8841.037034037356,109.14860535848587,0
2671,33.6479014457776,1,0,179,0.00558659217877095,0.0,1.0,179,4650,3200,1450,0.6881720430107527,61,32,29,226.28466819315332,0.414686774213797,0.7593876649038016,0.1435716135097692,1129913.5082222342,10686.420659005946,1140599.92888124,2670,0,1189.2793296089385,84,95,36,34.9813212275973,0.6223958333333333,40.845588235294116,8720.002106297283,103.80954888449146,0
2672,33.09363327197503,1,1,179,0.005555555555555556,0.005555555555555556,0.9944444444444445,180,5100,3600,1500,0.7058823529411765,66,36,30,223.85721664086498,0.41574526691495967,0.758689543229603,0.14258773860186533,1112482.4255320192,8707.44386829526,1121189.8694003145,2671,0,1183.6666666666667,87,93,38,34.90341816936774,0.6227250957854407,40.70785984848485,8580.918996479799,98.63125283310113,0
2673,33.08243295027838,0,0,179,0.0,0.0,1.0,179,4650,3300,1350,0.7096774193548387,60,33,27,228.427691916649,0.41492216433368906,0.7635908582130824,0.1461431965444611,1113437.6007473143,10417.996246383711,1123855.596993698,2672,1,1191.2625698324023,71,108,38,34.6261663785572,0.6310152582159625,40.55266203703702,8583.14916228789,120.8894248209562,0
2674,33.02451198721065,0,0,179,0.0,0.0,1.0,179,3650,2500,1150,0.684931506849315,48,25,23,230.71512942351094,0.41474039085221687,0.7668109275349955,0.14797278179221865,1112232.0711260322,11871.75324776434,1124103.8243737966,2673,2,1192.2625698324023,71,108,35,34.47801113031197,0.6318955399061033,40.465856481481474,8570.988433717748,120.7181469537711,0
2675,32.73218820872076,1,1,179,0.005555555555555556,0.005555555555555556,0.9944444444444445,180,4900,3200,1700,0.6530612244897959,66,32,34,225.62741490225682,0.4156928926132837,0.7636560402179482,0.14574567525450224,1104503.858906833,8941.270086942837,1113445.128993776,2674,0,1186.6333333333334,73,107,36,34.35535762665942,0.6334189497716896,40.21677927927926,8503.273274098228,116.48319553559217,0
2676,32.60461073361924,1,0,180,0.005555555555555556,0.0,1.0,180,4300,2700,1600,0.627906976744186,59,27,32,226.41281982357037,0.4157426805296917,0.7632608824752067,0.14658075636328657,1100858.768548872,9549.707602930393,1110408.4761518026,2675,0,1187.588888888889,74,106,41,34.255300195973646,0.6337274774774775,40.13888888888887,8472.670372583514,114.4955455754529,0
2677,32.78560182105253,1,0,181,0.0055248618784530384,0.0,1.0,181,4800,3400,1400,0.7083333333333334,62,34,28,223.46389019039242,0.41597861673828523,0.7615141047369889,0.14546719814188605,1108591.5906975737,8546.03789792682,1117137.6285955005,2676,0,1182.0220994475137,76,105,32,34.137383169467114,0.6347313596491229,39.94859307359306,8525.941880493643,112.18344579596899,0
2678,32.987984753044024,0,1,180,0.0,0.0055248618784530384,0.994475138121547,181,4500,3100,1400,0.6888888888888889,59,31,28,223.4649379948033,0.41582386944956,0.7624621323080081,0.14605056648616987,1116620.9687263535,9205.127108025987,1125826.0958343796,2677,1,1183.0220994475137,77,104,34,33.996037143492586,0.6356872294372294,39.81036324786322,8583.131770079488,111.46924376726608,0
2679,32.97584104734473,0,0,180,0.0,0.0,1.0,180,4850,3500,1350,0.7216494845360825,62,35,27,226.07546622696233,0.41463506103869235,0.7649082659190598,0.1479950738614102,1116687.15077047,9641.113648017967,1126328.264418488,2678,2,1190.5833333333333,78,102,36,33.87124014118996,0.6358173076923077,39.75474683544301,8581.80610168034,110.02315514974795,0
2680,33.01151791699173,0,0,180,0.0,0.0,1.0,180,4200,3200,1000,0.7619047619047619,52,32,20,225.78122088856415,0.4148271001448376,0.7666764573575733,0.14827265350501626,1118835.4498276112,10322.406767096392,1129157.8565947076,2679,3,1191.5833333333333,83,97,38,33.76701794077951,0.6349146586345382,39.645337301587276,8594.70261244092,103.55063388483036,0
2681,33.24818183558612,0,0,180,0.0,0.0,1.0,180,5100,3100,2000,0.6078431372549019,71,31,40,226.4919665638703,0.41446823918890957,0.769391468449494,0.1490733657074903,1127524.0345928033,9975.027188590599,1137499.0617813938,2680,4,1192.5833333333333,68,112,40,33.66966649276371,0.6426164215686274,39.56823671497584,8658.88262146279,127.33650913915868,0
2682,33.19817327417496,0,1,179,0.0,0.005555555555555556,0.9944444444444445,180,4850,3500,1350,0.7216494845360825,62,35,27,227.85207555977277,0.4141048520587627,0.7711649881648153,0.15048894722655862,1126855.7653558918,10501.28499856737,1137357.050354459,2681,5,1193.5833333333333,69,111,38,33.51270537057132,0.6432669082125604,39.449404761904766,8649.803807403727,125.35947546961923,0
2683,32.72740899892764,0,0,179,0.0,0.0,1.0,179,4550,3200,1350,0.7032967032967034,59,32,27,231.25771910310587,0.41298150356746804,0.7740664241855173,0.15320386565090777,1111764.8912691432,11070.842586762938,1122835.7338559062,2682,6,1201.195530726257,69,110,40,33.31739552409226,0.6443236714975845,39.345238095238095,8530.555000375247,123.63123188949633,0
2684,32.95140603372085,0,1,178,0.0,0.00558659217877095,0.994413407821229,179,5750,4300,1450,0.7478260869565218,72,43,29,229.58814312814812,0.4126493419538426,0.7711752871999857,0.15281908521836451,1120761.2698760673,9912.699768158269,1130673.9696442257,2683,7,1202.195530726257,72,107,37,33.19575901812743,0.6443865740740741,39.1837899543379,8594.26083739083,119.36473385265042,0
2685,32.59970641729828,0,0,178,0.0,0.0,1.0,178,4700,3100,1600,0.6595744680851063,63,31,32,230.32738380024722,0.41165902262003007,0.7700120372244799,0.15392246001762733,1109950.3268166478,10830.390984781538,1120780.7178014293,2684,8,1209.8033707865168,73,105,39,33.037994030280124,0.6452625570776256,39.04842342342342,8506.944785527527,116.53349021270584,0
2686,32.56097403899266,0,0,178,0.0,0.0,1.0,178,5600,4100,1500,0.7321428571428571,71,41,30,234.94958913626957,0.41102819039759625,0.7732294752827618,0.15741622472130085,1109374.1880159762,10929.40193454732,1120303.5899505236,2685,9,1210.8033707865168,76,102,42,32.827939296572694,0.6447368421052632,38.961038961038966,8499.682833555242,111.83793202046371,0
2687,32.965503649661095,0,0,178,0.0,0.0,1.0,178,5450,3900,1550,0.7155963302752294,70,39,31,232.0584523210613,0.4108992467043315,0.7701459562015203,0.15598844724540867,1124109.8503100113,11121.838420360244,1135231.6887303717,2686,10,1211.8033707865168,80,98,35,32.79010932190871,0.644140625,38.85030864197531,8608.931103570834,107.61163879463543,0
2688,33.10734557046762,0,0,178,0.0,0.0,1.0,178,4850,3700,1150,0.7628865979381443,60,37,23,242.13337727508846,0.4104608381472312,0.7808122220127116,0.15623000712080523,1116822.212251845,13633.986813674885,1130456.19906552,2687,11,1212.8033707865168,64,114,41,33.96715099539321,0.6380208333333333,40.25641025641025,8599.42078535478,134.36594977116843,8
2689,33.03541676510275,1,0,179,0.00558659217877095,0.0,1.0,179,4750,3100,1650,0.6526315789473685,64,31,33,245.67919969891634,0.4109414558617371,0.7835244194421198,0.15952472921626437,1116285.9051426721,14299.64556212626,1130585.5507047984,2688,0,1207.022346368715,68,111,38,33.649462833914065,0.6378676470588236,40.03623188405796,8588.011423536655,126.29428564024492,0
2690,33.10807922403077,0,0,179,0.0,0.0,1.0,179,4700,3300,1400,0.7021276595744681,61,33,28,245.69637551455875,0.4106642186094198,0.7829880879457518,0.1597815615498313,1119200.4816088427,14496.700361088075,1133697.1819699309,2689,1,1208.022346368715,72,107,42,33.59435023597848,0.6362847222222222,39.98287671232875,8608.667517412763,119.56482663073282,0
2691,33.38099636512708,0,0,179,0.0,0.0,1.0,179,4150,2900,1250,0.6987951807228916,54,29,25,245.1514036846351,0.41045367522440523,0.7828996013838287,0.1599149042521534,1129344.2664745494,15422.066433885791,1144766.3329084353,2690,2,1209.022346368715,77,102,34,33.50018824656876,0.6350108225108225,39.877136752136735,8683.160352563327,112.76831626705619,0
2692,33.22408492304294,1,3,177,0.005555555555555556,0.016666666666666666,0.9833333333333333,180,4000,2800,1200,0.7,52,28,24,241.3434361339585,0.41154433064349266,0.7815993063892233,0.15829848999967452,1125675.149568615,14334.861713499195,1140010.0112821143,2691,0,1203.3,79,101,36,33.40502867813791,0.6360759493670887,39.687499999999986,8648.644606529575,109.47651400670348,0
2693,33.034960151018,0,0,177,0.0,0.0,1.0,177,5900,4500,1400,0.7627118644067796,73,45,28,244.09366321700756,0.4097235597500428,0.7817751091438037,0.16102493782929791,1120965.9568609449,13424.137350349047,1134390.0942112939,2692,1,1222.8757062146892,66,111,38,33.13116694517385,0.6445707070707071,39.49004975124377,8605.935825411312,130.39296705168655,0
2694,32.967147590479364,0,0,177,0.0,0.0,1.0,177,5300,3700,1600,0.6981132075471698,69,37,32,240.1118302471016,0.40947477957541517,0.7784377692664006,0.15903085993205218,1119837.4625725958,13077.24454351503,1132914.7071161107,2693,2,1223.8757062146892,67,110,34,33.095124400039154,0.6453669154228856,39.35355392156861,8592.769856801535,128.25029637017215,0
2695,32.76802601700797,0,1,176,0.0,0.005649717514124294,0.9943502824858758,177,4050,2800,1250,0.691358024691358,53,28,25,241.36482027514177,0.409386502739257,0.7788786326329489,0.16041148674923103,1114076.9339324404,14329.795786256786,1128406.7297186973,2694,3,1224.8757062146892,68,109,36,32.94218819351973,0.6459865196078431,39.2361111111111,8544.717895407264,125.65761610893036,0
2696,32.55464616357344,1,0,177,0.005649717514124294,0.0,1.0,177,4600,3200,1400,0.6956521739130435,60,32,28,235.61406836558638,0.4099054635336415,0.7734425276330117,0.1574232542273092,1108357.1497636111,12228.907451577667,1120586.0572151889,2695,0,1219.774011299435,72,105,42,32.90714259674447,0.6456886574074074,39.05536529680363,8494.960251045428,117.98555904229761,0
2697,32.764313574872574,0,0,177,0.0,0.0,1.0,177,3900,2800,1100,0.717948717948718,50,28,22,232.6605668910988,0.40997902756377336,0.7701322024758839,0.1559338710876551,1116397.4809543423,12648.334158926227,1129045.8151132686,2696,1,1220.774011299435,73,104,43,32.876280668643844,0.6462614155251142,38.94988738738738,8553.127748395415,117.1661335396632,0
2698,33.079210303671545,1,0,178,0.0056179775280898875,0.0,1.0,178,5000,3600,1400,0.72,64,36,28,228.55997758619796,0.4108364279819717,0.7682208923122047,0.15387154976409723,1128433.0600936527,10982.92698450594,1139415.9870781587,2697,0,1214.9101123595506,76,102,38,32.828685001035836,0.6463815789473684,38.798701298701296,8640.332691332382,113.68858804384713,0
2699,33.40318706235038,0,3,175,0.0,0.016853932584269662,0.9831460674157303,178,5050,4000,1050,0.7920792079207921,61,40,21,227.0100334130612,0.41056796060009737,0.7649191193822378,0.15344937284491136,1140679.1544370824,11139.122592468799,1151818.277029551,2698,1,1215.9101123595506,77,101,39,32.729220961725154,0.6473214285714286,38.661858974358964,8729.52681120637,113.3704780676152,0
2700,33.1210330558378,0,0,175,0.0,0.0,1.0,175,4850,2900,1950,0.5979381443298969,68,29,39,223.0479853922785,0.4099808429118774,0.7569930625873444,0.1515181917481736,1132482.5311870165,10669.589414642647,1143152.1206016592,2699,2,1233.6742857142858,67,108,43,32.662910296213866,0.6540733830845771,38.495710784313744,8661.292207356153,129.2730180202411,0
2701,32.814838177216885,0,0,175,0.0,0.0,1.0,175,5000,3800,1200,0.76,62,38,24,222.3571646618884,0.4096182266009852,0.7578540894603423,0.15146363386242834,1122801.8941430293,9932.609131728457,1132734.5032747579,2700,3,1234.6742857142858,67,108,40,32.58702006597569,0.6550062189054726,38.40379901960785,8584.237002946296,128.12294034248202,0
2702,32.51891819021997,0,0,175,0.0,0.0,1.0,175,5400,4100,1300,0.7592592592592593,67,41,26,221.96021474007085,0.40934181718664475,0.7582765184287947,0.1517997728973811,1113815.7239185255,9044.555452364697,1122860.2793708902,2701,4,1235.6742857142858,68,107,42,32.460561227432684,0.6557904411764706,38.26992753623189,8511.178814369629,125.16439432896513,0
2703,32.59348747064153,0,0,175,0.0,0.0,1.0,175,5500,4200,1300,0.7636363636363637,68,42,26,223.56025408832653,0.4094170771756979,0.7611325789395658,0.15351845476706727,1117529.1826437027,9467.021604589281,1126996.204248292,2702,5,1236.6742857142858,68,107,38,32.27977631730658,0.6571691176470589,38.1340579710145,8535.124300509497,125.516533831022,0
2704,32.389197109151596,0,0,175,0.0,0.0,1.0,175,5600,3900,1700,0.6964285714285714,73,39,34,220.23613977838465,0.40889846743295016,0.756857379571547,0.15155360359892273,1111116.9843148699,8341.623093541428,1119458.6074084113,2703,6,1237.6742857142858,71,104,42,32.295463960231984,0.65625,38.064236111111114,8483.889086533422,119.49139558497777,0
2705,32.81440288630908,0,1,174,0.0,0.005714285714285714,0.9942857142857143,175,3800,2100,1700,0.5526315789473685,55,21,34,221.55921189637763,0.4087424740010947,0.756812495069811,0.15279654712274957,1126325.591587738,11109.562082180157,1137435.153669918,2704,7,1238.6742857142858,71,104,44,32.18686729247195,0.6569835680751174,37.99189814814815,8597.639413643781,121.09351286822228,0
2706,33.20745562384029,0,0,174,0.0,0.0,1.0,174,4750,3100,1650,0.6526315789473685,64,31,33,223.73123765019295,0.40813179633689894,0.7589238285979214,0.1549252381029666,1140993.0874454605,11505.159120897702,1152498.2465663583,2705,8,1246.5977011494253,72,102,33,31.99177145138172,0.6578414351851851,37.85673515981736,8705.110834268999,120.90431714262498,0
2707,33.62044762502471,0,0,174,0.0,0.0,1.0,174,5700,4300,1400,0.7543859649122807,71,43,28,221.50245822656348,0.40801483290146834,0.7564087110620845,0.1538134576600131,1156001.738776274,10711.44537062549,1166713.1841468995,2706,9,1247.5977011494253,74,100,35,31.95529456420035,0.6577984234234234,37.7638888888889,8816.495439001297,119.14183025677428,0
2708,33.684510604871555,1,0,175,0.005714285714285714,0.0,1.0,175,4300,2700,1600,0.627906976744186,59,27,32,218.7499562962526,0.4080131362889983,0.755297709923664,0.1527518351535671,1159828.2542336222,11442.475984952986,1171270.730218575,2707,0,1241.462857142857,77,98,38,31.839694656488582,0.6582792207792207,37.58012820512822,8839.484954403424,114.79850590134318,0
2709,34.00385271670334,0,0,175,0.0,0.0,1.0,175,4500,3100,1400,0.6888888888888889,59,31,28,220.66400098462162,0.4079105090311987,0.7587558213074239,0.1548208539381004,1172212.8479351245,12233.035406188224,1184445.8833413129,2708,1,1242.462857142857,68,107,38,31.630421242262216,0.6643688725490196,37.424516908212546,8928.57805407033,131.30261844221076,0
2710,34.328925998883975,0,0,175,0.0,0.0,1.0,175,5850,4100,1750,0.7008547008547008,76,41,35,223.02140309155814,0.4075519978106185,0.7626167487684739,0.1569810847003682,1184371.831558715,11978.053531268453,1196349.8850899835,2709,2,1243.462857142857,68,107,37,31.460488505747115,0.6654411764705883,37.318840579710134,9017.562083040148,132.61120710353157,0
2711,34.23779955217674,0,0,175,0.0,0.0,1.0,175,5500,3900,1600,0.7090909090909091,71,39,32,222.08337712367228,0.406888341543514,0.760423953872287,0.15693015914857386,1182369.8248809283,12016.936743736402,1194386.7616246648,2710,3,1244.462857142857,70,105,38,31.35537040138447,0.665625,37.19190140845071,8997.971000266183,128.54244286094547,0
2712,34.161665227287806,0,0,175,0.0,0.0,1.0,175,4600,2800,1800,0.6086956521739131,64,28,36,223.079961543933,0.40647099069512865,0.760596653193337,0.15806128236084385,1180531.0443646014,13070.563995654953,1193601.6083602563,2711,4,1245.462857142857,70,105,39,31.239187454657046,0.6665178571428572,37.10387323943662,8980.969471945,128.29956388492857,0
2713,34.29005568836047,1,1,175,0.005681818181818182,0.005681818181818182,0.9943181818181818,176,4900,3600,1300,0.7346938775510204,62,36,26,218.04126961608256,0.4063649891774892,0.7561066270178427,0.15518540418109694,1186280.2225800285,11631.609170359678,1197911.8317503883,2712,0,1239.3806818181818,74,102,39,31.222939437140305,0.6659628378378378,36.958333333333336,9019.713398359158,121.88801889674536,0
2714,34.58669469430634,0,0,175,0.0,0.0,1.0,175,5050,3900,1150,0.7722772277227723,62,39,23,216.47236123570585,0.4055815544608648,0.7531184255174752,0.15446587132242756,1197300.8504518673,11786.508441366987,1209087.3588932343,2713,1,1247.2457142857143,74,101,41,31.179070994985487,0.6668074324324325,36.87500000000001,9100.624041439372,122.98140596539693,0
2715,34.94605169578751,0,0,175,0.0,0.0,1.0,175,5200,3800,1400,0.7307692307692307,66,38,28,217.34382278349946,0.4051067323481117,0.7556875642343266,0.15572572869539422,1210960.2143851726,12438.944446640051,1223399.1588318127,2714,2,1248.2457142857143,76,99,37,31.02068345323742,0.6672149122807017,36.74242424242425,9199.812851731958,121.05016910173629,0
2716,35.07787038763426,0,1,174,0.0,0.005714285714285714,0.9942857142857143,175,5100,3600,1500,0.7058823529411765,66,36,30,219.8685069148744,0.40505199781061846,0.7577386807280835,0.1582074630383826,1216795.237860962,13406.990433923767,1230202.2282948857,2715,3,1249.2457142857143,77,98,38,30.814013672700227,0.6681547619047619,36.60523504273504,9239.327425952324,119.99126527210811,0
2717,34.498586866728985,0,3,171,0.0,0.017241379310344827,0.9827586206896551,174,4850,3700,1150,0.7628865979381443,60,37,23,218.5164376457293,0.4042297853963192,0.7560864075149278,0.1578894734917956,1197913.0574933079,12702.738786548292,1210615.7962798562,2716,4,1257.287356321839,76,98,39,30.713338466803567,0.6699561403508771,36.47186147186147,9091.348378840381,119.62300498474185,0
2718,34.16272446705995,0,0,171,0.0,0.0,1.0,171,4950,3800,1150,0.7676767676767676,61,38,23,221.6875751847393,0.40315187478500175,0.7566742944317315,0.16024844720496903,1186372.5208398686,13450.809482159497,1199823.3303220281,2717,10,1267.3157894736842,67,104,40,30.61594202898552,0.6747512437810945,36.45833333333334,9003.301343923114,134.37763199885245,0
2719,33.78333521002853,0,0,171,0.0,0.0,1.0,171,5100,3800,1300,0.7450980392156863,64,38,26,220.5087876829683,0.4026588120628369,0.7553867822804363,0.16016195237023753,1174561.692522685,12500.234975406674,1187061.9274980917,2718,11,1268.3157894736842,67,104,40,30.490443824793772,0.6763059701492538,36.30514705882354,8908.491610070974,132.9625613443429,0
2720,34.027856562752426,0,0,171,0.0,0.0,1.0,171,4700,3500,1200,0.7446808510638298,59,35,24,218.6364433094139,0.402301914918014,0.7532612316653631,0.15952362715538754,1184359.4316102075,12888.826745443082,1197248.2583556506,2719,12,1269.3157894736842,69,102,40,30.39222598232751,0.6766304347826086,36.16071428571429,8977.885369904789,130.1142807232578,0
2721,34.335706978250116,0,0,171,0.0,0.0,1.0,171,5250,3800,1450,0.7238095238095238,67,38,29,218.21905284320772,0.4018274853801169,0.753152798254713,0.15986144946070852,1196232.836791755,12758.159324928129,1208990.9961166831,2720,13,1270.3157894736842,70,101,43,30.27259800652142,0.6773809523809524,36.03286384976526,9063.498238742332,129.4785462677476,0
2722,34.264379402285,0,0,171,0.0,0.0,1.0,171,4900,3700,1200,0.7551020408163265,61,37,24,217.93870370370365,0.4012942896456828,0.7529883040935685,0.16024904684095884,1194809.6492378337,12979.053225514124,1207788.7024633477,2721,14,1271.3157894736842,70,101,41,30.160069444444474,0.6785714285714286,35.91549295774649,9048.691743561194,129.26702490801705,0
2723,34.515808522912266,0,0,171,0.0,0.0,1.0,171,4700,3200,1500,0.6808510638297872,62,32,30,216.15166334712748,0.4007797270955166,0.7502863403140421,0.15927890295230568,1204199.4358344637,13157.942211458234,1217357.378045922,2722,15,1272.3157894736842,74,97,44,30.137515992779136,0.6772240990990991,35.847222222222214,9117.446698573152,123.20873916990746,0
2724,34.549771618040396,0,0,171,0.0,0.0,1.0,171,5500,4400,1100,0.8,66,44,22,220.5768784515111,0.4001576654053434,0.7538324399592251,0.16313551183059363,1206436.9884963408,13522.420994192806,1219959.4094905336,2723,16,1273.3157894736842,75,96,38,29.9027648116453,0.6779166666666667,35.731907894736835,9130.402228172088,121.73869637562784,0
2725,34.2907919595862,0,0,171,0.0,0.0,1.0,171,4150,2900,1250,0.6987951807228916,54,29,25,222.14621970072776,0.40012183235867443,0.7571422201993927,0.16488429820020195,1198411.7746142573,14894.529075079507,1213306.3036893369,2724,17,1274.3157894736842,76,95,39,29.74647785225739,0.6785910087719298,35.61958874458874,9065.813680549138,119.28702211248866,0
2726,34.39043430128518,0,0,171,0.0,0.0,1.0,171,5750,4800,950,0.8347826086956521,67,48,19,222.41487816887977,0.399572870083706,0.758045324947372,0.16601857070666037,1203502.8875651627,13585.389622740066,1217088.2771879027,2725,18,1275.3157894736842,79,92,40,29.55856055386027,0.6790611814345991,35.44270833333333,9098.240157988434,115.16759693656245,0
2727,34.48873460550755,0,0,171,0.0,0.0,1.0,171,4800,3700,1100,0.7708333333333334,59,37,22,223.86723886635076,0.3992976722852884,0.7593254088380328,0.1678445385544944,1208204.4275594042,15095.477836764669,1223299.9053961688,2726,19,1276.3157894736842,64,107,40,29.378821819943095,0.6883138020833333,35.304487179487175,9129.013292935379,142.6408327021153,0
2728,33.88501892538393,0,0,171,0.0,0.0,1.0,171,4800,3300,1500,0.6875,63,33,30,226.42241305016543,0.39882467606925814,0.7622792029941732,0.17035494377379726,1188031.0184213563,14799.369993881835,1202830.3884152381,2727,20,1277.3157894736842,65,106,37,29.199944371597716,0.6887820512820513,35.19570707070707,8972.89847743201,138.04459196049248,0
2729,33.56407411558605,0,0,171,0.0,0.0,1.0,171,3850,2600,1250,0.6753246753246753,51,26,25,225.8067245141547,0.39876877651645454,0.7617210524599345,0.17012903812908542,1177163.7507320042,15112.2981539181,1192276.0488859222,2728,21,1278.3157894736842,66,105,38,29.171925447607865,0.688604797979798,35.1523631840796,8889.365711427357,134.68735926405088,0
2730,33.38705628174536,0,0,171,0.0,0.0,1.0,171,4750,3100,1650,0.6526315789473685,64,31,33,225.19278252611576,0.39815818140121545,0.7609376718148648,0.17020384725811089,1171822.2168092143,13827.181125837704,1185649.397935052,2729,22,1279.3157894736842,68,103,39,29.087962962962962,0.6884191176470589,35.05434782608696,8845.755400734171,130.08463824609075,0
2731,33.729001194663724,0,0,171,0.0,0.0,1.0,171,4150,2800,1350,0.6746987951807228,55,28,27,221.16005414617183,0.3978084508657264,0.7570652518685095,0.16789579236609414,1185044.0262349958,14066.88020154598,1199110.9064365418,2730,23,1280.3157894736842,70,101,37,29.05528189801491,0.6886904761904762,34.91784037558686,8940.956478655891,127.72794969508416,0
2732,33.30516085668304,0,0,171,0.0,0.0,1.0,171,5200,3900,1300,0.75,65,39,26,220.01421350773785,0.3976292856323816,0.7555632551329474,0.16737430232761613,1170719.8926924784,12115.003285720111,1182834.8959781984,2731,24,1281.3157894736842,73,98,44,29.0200060168472,0.687785388127854,34.85360360360363,8830.743382551887,120.96908743221763,0
2733,32.818271246387276,0,0,171,0.0,0.0,1.0,171,4350,3200,1150,0.735632183908046,55,32,23,222.4678272211057,0.3974157206742346,0.7589350533952195,0.16988856585749396,1154627.6917680635,12823.502767392749,1167451.1945354561,2732,25,1282.3157894736842,74,97,38,28.834843010977895,0.6884853603603603,34.736111111111136,8705.502257427152,117.64192239766422,0
2734,33.03092298519296,0,0,171,0.0,0.0,1.0,171,4900,3500,1400,0.7142857142857143,63,35,28,224.01470686902118,0.3972250888659557,0.7598595361018157,0.17152016226514893,1162816.1683786851,12997.584620382298,1175813.7529990675,2733,26,1283.3157894736842,77,94,38,28.711340530474622,0.6879058441558441,34.655448717948744,8764.575437938089,113.825655038157,0
2735,33.41280340967172,0,0,171,0.0,0.0,1.0,171,5200,3500,1700,0.6730769230769231,69,35,34,222.3933978080698,0.39695992432060545,0.7582794072450003,0.17112604166036668,1177606.489732115,12978.381706472272,1190584.8714385873,2734,27,1284.3157894736842,80,91,39,28.599136191168178,0.6881510416666667,34.503600823045296,8870.978991675396,110.88723739594245,0
2736,33.568238685406996,0,0,171,0.0,0.0,1.0,171,4850,3800,1050,0.7835051546391752,59,38,21,223.02734990421195,0.39689399151473453,0.7598199235452692,0.17205202129511013,1183778.0425976277,13752.975943069214,1197531.018540697,2735,28,1285.3157894736842,81,90,40,28.502782295353846,0.6885288065843622,34.425813008130106,8914.857697626065,110.05997157563043,0
2737,33.51964320059152,0,0,171,0.0,0.0,1.0,171,5000,3200,1800,0.64,68,32,36,225.77572693402846,0.396582960669648,0.7629892471997737,0.17491644560213343,1183219.4382695302,14228.44575955507,1197447.8840290853,2736,29,1286.3157894736842,65,106,40,28.297136422136422,0.6979166666666667,34.29608585858585,8906.300399020782,137.02000613878127,0
2738,33.2200103248205,0,1,170,0.0,0.005847953216374269,0.9941520467836258,171,3850,2400,1450,0.6233766233766234,53,24,29,225.110727428276,0.3963507625272331,0.7616324662671878,0.17509396920945186,1173704.067121187,14792.67526703525,1188496.7423882221,2737,30,1287.3157894736842,67,104,39,28.19187124224438,0.6979166666666667,34.17585784313725,8830.680747037524,131.80120517966455,0
2739,32.81227577766708,0,0,170,0.0,0.0,1.0,170,4800,3500,1300,0.7291666666666666,61,35,26,225.9600303518381,0.396032747418494,0.7611626433139373,0.17611083281620316,1159832.8170419296,13615.171708370312,1173447.9887503,2738,31,1294.7588235294118,67,103,40,28.10663565132224,0.6985385572139303,34.11458333333332,8724.30561692656,130.2135166705457,0
2740,32.84990742732774,0,0,170,0.0,0.0,1.0,170,4150,3200,950,0.7710843373493976,51,32,19,228.049925512338,0.395500493096647,0.7642238444470806,0.17846268393518433,1162233.6307732824,14859.458585156077,1177093.0893584385,2739,32,1295.7588235294118,67,103,38,27.925724637681174,0.6997823383084577,33.99203431372548,8738.33704772587,130.42294101083388,0
2741,32.770849177575904,0,0,170,0.0,0.0,1.0,170,3800,2600,1200,0.6842105263157895,50,26,24,226.65466967687695,0.39529092702169627,0.7628089628860681,0.1776049463635214,1159782.9889051793,14774.046049432836,1174557.0349546121,2740,33,1296.7588235294118,68,102,43,27.922199209366543,0.6996017156862745,33.95229468599033,8718.609224885557,128.21484154243467,0
2742,32.5807607912999,0,1,169,0.0,0.0058823529411764705,0.9941176470588236,170,4400,3200,1200,0.7272727272727273,56,32,24,224.8485449746485,0.3949965193177863,0.7610634993206806,0.17680873230971364,1153969.9740193656,13493.693920537367,1167463.667939903,2741,34,1297.7588235294118,70,100,41,27.862415706594646,0.6995535714285714,33.84683098591549,8671.47273349429,123.8781819070613,0
2743,32.34090653718635,0,1,168,0.0,0.005917159763313609,0.9940828402366864,169,5700,4700,1000,0.8245614035087719,67,47,20,222.93464606681462,0.39457564337372025,0.7576741781936858,0.17627925106520248,1146906.3202796336,11637.030916666445,1158543.3511963,2742,35,1297.8224852071005,74,95,37,27.74337244676227,0.6991835585585586,33.68055555555555,8613.012261813154,116.39205759206965,0
2744,32.35805384833654,0,0,168,0.0,0.0,1.0,168,3750,2300,1450,0.6133333333333333,52,23,29,202.53322871607432,0.39396281841079744,0.7281128086792168,0.14445743542158498,1120032.887299099,8018.775386574555,1128051.6626856735,2743,36,1300.2380952380952,74,94,41,31.56001460444823,0.6666666666666667,36.88888888888888,8513.76350142896,115.0508581274184,8
2745,32.71866854298954,1,1,168,0.005917159763313609,0.005917159763313609,0.9940828402366864,169,5350,4100,1250,0.7663551401869159,66,41,25,199.39626872760124,0.3946636963463887,0.7253411148037077,0.14270517271681182,1133462.6233634718,6051.643568174626,1139514.2669316465,2744,0,1293.5384615384614,77,92,39,31.530314561136446,0.6663961038961039,36.77884615384613,8612.24568619551,111.84734657396767,0
2746,32.376192065418834,0,0,168,0.0,0.0,1.0,168,4300,2900,1400,0.6744186046511628,57,29,28,205.46186159992453,0.39282595523239233,0.7310067130300391,0.1476569938320154,1122736.7071228442,8235.9147864056,1130972.6219092498,2745,38,1302.2380952380952,77,91,41,31.23436443542931,0.6677489177489178,36.645299145299134,8526.422376202694,110.73275813250252,0
2747,32.67194852869516,0,1,167,0.0,0.005952380952380952,0.9940476190476191,168,3900,2400,1500,0.6153846153846154,54,24,30,207.82992618989422,0.3926269484839844,0.7342201586516968,0.14962275469115835,1133481.3168012146,9614.267681684018,1143095.5844828987,2746,39,1303.2380952380952,79,89,41,31.11406327236776,0.667457805907173,36.58854166666666,8606.165608535171,108.93880517133128,0
2748,33.07563116874063,0,0,167,0.0,0.0,1.0,167,4950,4000,950,0.8080808080808081,59,40,19,213.78003383360786,0.3920908183632734,0.7378585439752283,0.15467411630369554,1148876.706777807,10771.380249120608,1159648.0870269276,2747,40,1311.497005988024,70,97,43,30.794368679840417,0.6733630952380952,36.42899061032863,8717.777493345431,124.5396784763633,0
2749,32.63456466614686,0,0,167,0.0,0.0,1.0,167,4900,3600,1300,0.7346938775510204,62,36,26,212.91423405353544,0.3917887117331602,0.7385728871421073,0.15474484283603845,1134797.6008307608,10022.912397334276,1144820.5132280951,2748,41,1312.497005988024,71,96,40,30.669848584595112,0.6742957746478873,36.28472222222222,8606.233286089773,121.21455332520807,0
2750,32.36294429051357,0,0,167,0.0,0.0,1.0,167,4250,3000,1250,0.7058823529411765,55,30,25,212.75970643999477,0.39179923285958207,0.7380202778734493,0.15515729253301128,1126273.8261588546,10275.13772492158,1136548.9638837762,2749,42,1313.497005988024,73,94,44,30.56370718173088,0.6743721461187215,36.17680180180181,8538.095465833425,116.96021186073185,0
2751,31.999067433967202,0,0,167,0.0,0.0,1.0,167,4550,3100,1450,0.6813186813186813,60,31,29,209.99584342359063,0.39160083447562705,0.7348063582339568,0.1535928027996567,1114399.6335632182,8853.858192209796,1123253.491755428,2750,43,1314.497005988024,74,93,41,30.54119303231237,0.6748310810810811,36.08333333333334,8445.087213614537,114.12280018398023,0
2752,32.309045257234835,0,0,167,0.0,0.0,1.0,167,3750,2100,1650,0.56,54,21,33,210.25373934216006,0.3914445205973595,0.7357695823306645,0.15409006924391208,1125737.2682864508,10188.094034811005,1135925.3623212618,2751,44,1315.497005988024,75,92,43,30.469453097957757,0.675,36.01973684210527,8528.950269385197,113.71933692513596,0
2753,32.14018322188819,0,0,167,0.0,0.0,1.0,167,4950,3700,1250,0.7474747474747475,62,37,25,212.4219336152418,0.39107177211841376,0.7400387102067398,0.1562193059884917,1120784.1412848602,9265.826891405739,1130049.968176266,2752,45,1316.497005988024,75,92,41,30.300238737803607,0.6761111111111111,35.91008771929825,8487.898167754141,113.17197557005522,0
2754,32.45195074540783,0,2,165,0.0,0.011976047904191617,0.9880239520958084,167,5450,3700,1750,0.6788990825688074,72,37,35,212.94070059434813,0.39113189284082434,0.7416425386139465,0.15694096070955527,1132243.4178554886,9370.141328297374,1141613.559183786,2753,46,1317.497005988024,75,92,45,30.216548625884222,0.6768055555555555,35.841557017543856,8572.456780650282,114.29942374200375,0
2755,32.08010061954059,0,0,165,0.0,0.0,1.0,165,4300,2900,1400,0.6744186046511628,57,29,28,207.2806951091878,0.39091217048534127,0.7258689168096204,0.13975734019412486,1094778.798946065,8085.302087268172,1102864.101033333,2754,47,1328.139393939394,85,80,39,33.332319146305665,0.6432598039215687,38.74757751937983,8381.004000276982,98.60004706208214,8
2756,32.072362441504055,0,0,165,0.0,0.0,1.0,165,5050,3800,1250,0.7524752475247525,63,38,25,203.273284231692,0.3909368070953437,0.7206618637127113,0.13755287646552466,1095538.0236990426,6488.72241560022,1102026.7461146428,2755,48,1329.139393939394,86,79,43,33.31243319590775,0.6441375968992248,38.625478927203055,8382.898372821259,97.47556247466581,0
2757,32.332596940349326,0,0,165,0.0,0.0,1.0,165,5350,3800,1550,0.7102803738317757,69,38,31,205.31195619283915,0.39095990391722096,0.7295720446326692,0.13807889929363962,1102671.3351175247,6928.321770149972,1109599.6568876747,2756,49,1330.139393939394,74,91,39,33.47126941076366,0.6469594594594594,38.83333333333335,8444.196567587938,114.11076442686404,8
2758,32.23218845277576,0,1,164,0.0,0.006060606060606061,0.9939393939393939,165,4450,3100,1350,0.6966292134831461,58,31,27,203.4702358871184,0.39115853658536587,0.7271996071341715,0.1371023521938659,1099791.1804426955,7304.954182249577,1107096.134624945,2757,50,1331.139393939394,77,88,39,33.45341708842427,0.6462391774891775,38.768696581196586,8420.056601559127,109.35138443583281,0
2759,31.948145179654254,0,0,164,0.0,0.0,1.0,164,4650,3600,1050,0.7741935483870968,57,36,21,202.2076859257765,0.39104896129482764,0.7235311270954525,0.13684677831740327,1091325.7343705613,6684.890267664052,1098010.6246382254,2758,51,1331.0670731707316,77,87,41,33.336526670754125,0.6477272727272727,38.621794871794876,8350.548844233357,108.4486862887449,0
2760,31.616234134599036,1,0,165,0.006060606060606061,0.0,1.0,165,4100,3000,1100,0.7317073170731707,52,30,22,204.15979130875493,0.3921640182310914,0.727899053370328,0.138679272876801,1081014.0210303564,7039.919387079284,1088053.9404174357,2759,0,1323.9939393939394,70,95,43,33.15882611460207,0.6523809523809524,38.49765258215964,8267.719442709727,118.11027775299611,0
2761,31.458426319648876,0,0,165,0.0,0.0,1.0,165,4700,3400,1300,0.723404255319149,60,34,26,203.53341263977862,0.3919037940379404,0.7296588139586428,0.1293617649615783,1056890.8217129994,5322.519146181025,1062213.3408591803,2760,1,1324.9939393939394,71,94,43,35.50823473051663,0.6286678403755869,40.7841435185185,8154.522922007312,114.85243552122975,8
2762,31.954354898880855,1,1,165,0.006024096385542169,0.006024096385542169,0.9939759036144579,166,5250,3800,1450,0.7238095238095238,67,38,29,191.15699429803328,0.3926311305829378,0.715682729970258,0.1177524848467644,1064333.464729008,2240.957209681803,1066574.42193869,2761,0,1318.0060240963855,84,82,40,36.965738410648434,0.6117311507936508,41.89950980392157,8247.434663300608,98.1837459916739,8
2763,32.22359097560226,0,0,165,0.0,0.0,1.0,165,5350,3800,1550,0.7102803738317757,69,38,31,195.36591849342128,0.3928630820399113,0.7195237814316329,0.12104607482989899,1075039.2433693311,3655.205839464519,1078694.4492087956,2762,1,1313.5575757575757,86,79,42,36.64412796267114,0.6131298449612403,41.69061302681993,8323.656030982344,96.78669803467841,0
2764,32.4173159963599,1,1,165,0.006024096385542169,0.006024096385542169,0.9939759036144579,166,3150,1900,1250,0.6031746031746031,44,19,25,195.51840370480897,0.3942337531945966,0.7210061090893951,0.12147324079906996,1082325.9915526719,5972.930031320504,1088298.9215839924,2763,0,1306.6385542168675,69,97,43,36.53991505902677,0.6215277777777778,41.5922619047619,8376.885301737928,121.40413480779605,0
2765,32.87664301999578,0,0,165,0.0,0.0,1.0,165,4500,3300,1200,0.7333333333333333,57,33,24,194.61456320546546,0.39304323725055434,0.718133843685679,0.1214050423847756,1098899.534215163,5272.370571594578,1104171.9047867577,2764,1,1315.5333333333333,70,95,42,36.414770470407966,0.622470238095238,41.44659624413145,8500.367956886514,121.43382795552162,0
2766,33.005777051544264,1,0,166,0.006024096385542169,0.0,1.0,166,3800,2600,1200,0.6842105263157895,50,26,24,190.49850003981769,0.39465209322137035,0.7137781233384077,0.11930817288976639,1104419.7654534942,5078.061746643716,1109497.8272001378,2765,0,1308.6024096385543,74,92,42,36.37746519202543,0.6219031531531531,41.305555555555564,8538.411157806462,115.38393456495218,0
2767,33.20502121089346,0,1,165,0.0,0.006024096385542169,0.9939759036144579,166,3150,2000,1150,0.6349206349206349,43,20,23,193.16530648181296,0.3946399233296824,0.7178630373687296,0.12145355928085888,1112284.7757667692,6620.965921208606,1118905.7416879777,2766,1,1309.6024096385543,76,90,43,36.16635307235319,0.6223958333333333,41.16612554112555,8594.584291504687,113.08663541453535,0
2768,33.21244669736803,1,0,166,0.006024096385542169,0.0,1.0,166,4550,3100,1450,0.6813186813186813,60,31,29,193.18344388667634,0.3955077887306803,0.717212062909764,0.12199816169438037,1113869.1472954466,5286.21558273019,1119155.3628781768,2767,0,1297.6927710843374,80,86,46,36.00755995828989,0.622265625,41.01080246913582,8601.664918187986,107.52081147734982,0
2769,33.29660122424939,1,0,167,0.005988023952095809,0.0,1.0,167,4100,2700,1400,0.6585365853658537,55,27,28,191.46728281765763,0.3957566794122598,0.7171569979320727,0.1214626089985205,1118070.803798593,5314.795760214587,1123385.5995588077,2768,0,1290.9161676646706,82,85,42,35.88904628149873,0.6230945121951219,40.850903614457856,8628.784119974034,105.22907463382968,0
2770,32.81985784507793,1,0,168,0.005952380952380952,0.0,1.0,168,5150,3400,1750,0.6601941747572816,69,34,35,190.18830230265323,0.39709271932325824,0.7171469656062894,0.12118280832582744,1103379.8695037605,3219.988835168925,1106599.8583389295,2769,0,1284.2261904761904,87,81,44,35.76436440549015,0.6228448275862069,40.69602272727275,8510.319672754285,97.81976635349753,0
2771,32.47841599771934,0,1,167,0.0,0.005952380952380952,0.9940476190476191,168,5000,3800,1200,0.76,62,38,24,188.22277060047304,0.3972130144472959,0.7145008605851957,0.12017299969107205,1092499.0615639167,2526.6400491957647,1095025.7016131126,2770,1,1285.2261904761904,88,80,44,35.74297188755018,0.6232244318181819,40.62500000000002,8424.089149408515,95.72828578873313,0
2772,32.747933916702294,0,0,167,0.0,0.0,1.0,167,4700,3200,1500,0.6808510638297872,62,32,30,189.82078408223143,0.3974836471635043,0.7146065194200284,0.1215994280355817,1102562.1965826382,3757.8441309485725,1106320.0407135868,2771,2,1292.4730538922156,70,97,43,35.5819245773732,0.6319940476190475,40.5076291079812,8497.839013860192,121.39770019800274,0
2773,32.74830772256407,0,0,167,0.0,0.0,1.0,167,4800,3600,1200,0.75,60,36,24,187.9243533362775,0.3973047880143328,0.7113956861813144,0.12085344396563047,1103730.867738847,3283.581915422002,1107014.449654269,2772,3,1293.4730538922156,73,94,45,35.49257211017134,0.6318493150684932,40.3716216216216,8502.390028645379,116.4710962828134,0
2774,32.29726138686675,1,0,168,0.005952380952380952,0.0,1.0,168,4750,3500,1250,0.7368421052631579,60,35,25,187.05810442622482,0.3984375,0.711485086042541,0.12101128365491642,1090261.9587208254,2438.467065267726,1092700.425786093,2773,0,1286.767857142857,76,92,45,35.30461984345982,0.6325383771929824,40.16504329004326,8391.957514306598,110.42049360929734,0
2775,32.410348372663265,0,0,168,0.0,0.0,1.0,168,5900,4500,1400,0.7627118644067796,73,45,28,185.64857646887688,0.39835433300066536,0.7076446280991753,0.12053573428296245,1095140.6321224822,1162.259877352511,1096302.8919998347,2774,1,1287.767857142857,79,89,45,35.21292470156105,0.6325158227848101,40.03906249999997,8425.424547659066,106.650943641254,0
2776,32.33076137373008,0,0,168,0.0,0.0,1.0,168,4900,3500,1400,0.7142857142857143,63,35,28,185.53368360001252,0.3979533492538732,0.7072662565276493,0.12068754597694563,1092998.6515917222,2057.6131999315576,1095056.2647916537,2775,2,1288.767857142857,79,89,42,35.14959939909865,0.6331751054852321,39.973958333333314,8406.839904080547,106.41569498836135,0
2777,32.54371141328231,1,0,169,0.005917159763313609,0.0,1.0,169,4300,3100,1200,0.7209302325581395,55,31,24,184.75798216701799,0.399148527754297,0.7064497918903041,0.12064732018201231,1101327.1512860977,2595.796435473559,1103922.9477215712,2776,0,1282.1360946745563,80,89,43,35.0338811995386,0.6341145833333333,39.840534979423836,8466.554551063466,105.83193188829333,0
2778,32.663066591266606,0,0,169,0.0,0.0,1.0,169,4750,3300,1450,0.6947368421052632,62,33,29,183.94236810455712,0.39901791584483887,0.7044478776121008,0.1204355159909883,1106148.7290474407,2143.5233393660133,1108292.2523868068,2777,1,1283.1360946745563,81,88,45,34.96134743983989,0.6346450617283951,39.74847560975606,8500.612871637088,104.94583792144553,0
2779,33.11180628095754,0,0,169,0.0,0.0,1.0,169,5350,4000,1350,0.7476635514018691,67,40,27,185.31140447863652,0.39914412510566355,0.7072348646336497,0.12196469446749429,1122888.8041566813,2466.8202743222414,1125355.6244310036,2778,2,1284.1360946745563,74,95,47,34.74336924252928,0.6394988738738738,39.56944444444444,8623.326105197702,116.531433854023,0
2780,33.07308573700339,0,0,169,0.0,0.0,1.0,169,5600,4500,1100,0.8035714285714286,67,45,22,186.80509500164405,0.39929381515919976,0.7088588050126521,0.12329136270108484,1122400.6693503098,2534.0327335786365,1124934.7020838885,2779,3,1285.1360946745563,75,94,49,34.60691989337822,0.64,39.47368421052631,8616.409178850863,114.88545571801151,0
2781,33.34653046128927,1,0,170,0.0058823529411764705,0.0,1.0,170,3900,2500,1400,0.6410256410256411,53,25,28,183.63581600078143,0.4002247940596357,0.7047768264993051,0.12160566750041656,1132675.5728256202,3699.960615996879,1136375.5334416172,2780,0,1278.570588235294,78,92,48,34.572878197669525,0.639823717948718,39.35917721518986,8691.467136449135,111.42906585191199,0
2782,33.58100033673758,0,0,170,0.0,0.0,1.0,170,4150,2400,1750,0.5783132530120482,59,24,35,184.95657290604302,0.4000478593804386,0.7076733586414541,0.12271682414423755,1141216.8841139462,4065.1127656456592,1145281.9968795918,2781,1,1279.570588235294,78,92,51,34.47130622429026,0.6404914529914529,39.293248945147674,8754.793494962743,112.24094224311209,0
2783,33.22275454910623,1,0,171,0.005847953216374269,0.0,1.0,171,4350,2700,1650,0.6206896551724138,60,27,33,181.23014456816642,0.400332530673088,0.7038545567639949,0.12070056952378057,1130160.9192960802,2413.845357864026,1132574.7646539442,2782,0,1273.0818713450292,81,90,50,34.436993701196464,0.6405606995884774,39.164126016260155,8665.68621896337,106.98378048102926,0
2784,32.71644149565987,0,0,171,0.0,0.0,1.0,171,5450,4400,1050,0.8073394495412844,65,44,21,180.45078733867177,0.4001418988648091,0.7006678594837827,0.12078645073325855,1114394.0826080078,568.6579224342086,1114962.740530442,2783,1,1274.0818713450292,82,89,46,34.283590581974956,0.641895325203252,38.99347389558232,8539.204741280575,104.13664318634848,0
2785,32.59458687403309,1,0,172,0.005813953488372093,0.0,1.0,172,4900,3600,1300,0.7346938775510204,62,36,26,184.12086685228147,0.4008780429756562,0.7102667719847962,0.12404299613853442,1112107.0421763605,1652.42252760761,1113759.464703968,2784,0,1267.6686046511627,84,88,37,33.96480343404013,0.6433531746031746,38.77450980392157,8514.536933907957,101.36353492747568,0
2786,32.76982834394288,0,1,171,0.0,0.005813953488372093,0.9941860465116279,172,4400,3000,1400,0.6818181818181818,58,30,28,182.96568447089436,0.4005005043292987,0.7138681251156527,0.11960102298926598,1109284.9159057254,1792.214782385593,1111077.130688111,2785,1,1268.6686046511627,79,93,40,35.04400615523195,0.6348892405063291,39.80468749999998,8526.555726523517,107.9310851458673,8
2787,32.61591895393094,0,0,171,0.0,0.0,1.0,171,4950,3700,1250,0.7474747474747475,62,37,25,183.98202132855917,0.3990167411994037,0.7135324850933016,0.12063921916939126,1104983.4144605743,1509.4164253976062,1106492.830885972,2786,2,1277.0584795321638,81,90,40,34.9085675825159,0.6351594650205761,39.69766260162599,8489.999940104086,104.81481407535908,0
2788,33.00408918281983,0,0,171,0.0,0.0,1.0,171,4550,3200,1350,0.7032967032967034,59,32,27,186.22594345620286,0.3990554408898062,0.7179809048944976,0.12256867305868743,1119240.8720467307,2936.3374703290233,1122177.2095170598,2787,3,1278.0584795321638,71,100,43,34.71896237246079,0.6409917840375587,39.56886574074073,8595.2923810755,121.06045607148592,0
2789,33.3048456993781,0,0,171,0.0,0.0,1.0,171,5200,4100,1100,0.7884615384615384,63,41,22,186.5512150029382,0.39848784543056986,0.7179646127583263,0.12318503169780179,1130413.7605909738,2776.0120988573167,1133189.772689831,2788,4,1279.0584795321638,73,98,40,34.59617618455888,0.6411244292237444,39.45664414414414,8677.356264777436,118.86789403804707,0
2790,33.44468726971277,0,1,170,0.0,0.005847953216374269,0.9941520467836258,171,4050,2600,1450,0.6419753086419753,55,26,29,188.4205443017153,0.3984606123151015,0.7203969368724461,0.12512270527683425,1136840.432413976,4590.818611927796,1141431.2510259037,2789,5,1280.0584795321638,74,97,44,34.351084891422076,0.6425957207207207,39.26388888888889,8720.237696032204,117.84104994638113,0
2791,32.99251830165191,0,0,170,0.0,0.0,1.0,170,4650,3300,1350,0.7096774193548387,60,33,27,191.31268675615502,0.3975794755772131,0.7232305480108654,0.1272503832525797,1121948.4174142333,4278.593227466621,1126227.0106417,2790,6,1288.5117647058823,74,96,43,34.2190578899718,0.6431587837837838,39.208333333333336,8604.173835418309,116.27261939754472,0
2792,32.55173046805774,1,0,171,0.005847953216374269,0.0,1.0,171,4250,3000,1250,0.7058823529411765,55,30,25,188.81249403933248,0.39878597637885566,0.7215595180180745,0.1264746061854963,1108991.4620515588,3428.2887636559344,1112419.7508152148,2791,0,1281.970760233918,77,94,45,34.04042600361537,0.6442099567099567,38.96901709401708,8497.01019936772,110.35078180997039,0
2793,32.968645121806766,0,0,171,0.0,0.0,1.0,171,4750,3200,1550,0.6736842105263158,63,32,31,189.93731705368407,0.39868134388258225,0.7234983041712995,0.12796672375825788,1124881.4040135117,3781.3911763814444,1128662.795189893,2792,1,1282.970760233918,80,91,43,33.811475409836056,0.644921875,38.77314814814814,8612.295374990466,107.65369218738083,0
2794,33.18896754675212,0,0,171,0.0,0.0,1.0,171,4600,3300,1300,0.717391304347826,59,33,26,178.43301834129238,0.39881894278179103,0.6986136014719508,0.11563386513286288,1120888.415270831,1200.7006321122667,1122089.1159029433,2793,2,1283.970760233918,83,88,47,35.466766867067435,0.6302710843373494,40.10416666666665,8625.674378036052,103.92378768718135,8
2795,33.48471472660159,0,0,171,0.0,0.0,1.0,171,4250,3300,950,0.7764705882352941,52,33,19,177.59269554840458,0.3986053778236441,0.6970820877317041,0.11539445745970561,1131676.668780539,1745.5020195948186,1133422.1708001338,2794,3,1284.970760233918,84,87,48,35.39506245580958,0.630828373015873,40.01225490196077,8705.61547702022,103.63827948833594,0
2796,33.15602787285719,0,1,170,0.0,0.005847953216374269,0.9941520467836258,171,3850,2400,1450,0.6233766233766234,53,24,29,177.6476599353537,0.3986168443985782,0.6981676854152803,0.11571634865402233,1121307.696971575,1789.537686899895,1123097.234658475,2795,4,1285.970760233918,84,87,38,35.306325197122476,0.6316964285714286,39.92647058823527,8623.00519016874,102.654823692485,0
2797,33.319961757753944,0,0,170,0.0,0.0,1.0,170,4700,3600,1100,0.7659574468085106,58,36,22,179.05437222681655,0.3990631163708087,0.6974059508310759,0.11710468467064061,1128061.7857648646,1696.8789766376476,1129758.6647415024,2796,5,1288.0764705882352,86,84,38,35.127647663307684,0.6323885658914729,39.786877394636,8670.291294076427,100.81734062879566,0
2798,33.33720153740425,2,0,172,0.011627906976744186,0.0,1.0,172,3850,2000,1850,0.5194805194805194,57,20,37,203.7937706683447,0.400812168502652,0.7388858784544734,0.12763492846229305,1115509.6953275094,7216.785405578004,1122726.4807330875,2797,0,1274.0872093023256,74,98,45,36.03352392712697,0.6219031531531531,41.305555555555564,8624.14883105129,116.54255177096339,8
2799,33.23031452001798,0,0,172,0.0,0.0,1.0,172,5500,4100,1400,0.7454545454545455,69,41,28,200.57969307037703,0.4008567931456548,0.7349035462104461,0.12632645034267698,1113642.6142229708,4774.818750187186,1118417.432973158,2798,1,1275.0872093023256,79,93,42,35.91389838890844,0.6217035864978904,41.106770833333336,8603.103432311436,108.9000434469802,0
2800,32.77381857329612,0,0,172,0.0,0.0,1.0,172,5050,3900,1150,0.7722772277227723,62,39,23,202.80297105958476,0.40064854481164147,0.7384078889633046,0.12811956829171955,1099267.7278097498,5136.952237947049,1104404.680047697,2799,2,1276.0872093023256,80,92,38,35.745303707381666,0.6223958333333333,40.99794238683126,8488.486446324343,106.1060805790543,0
2801,32.92223638441344,0,0,172,0.0,0.0,1.0,172,5200,3500,1700,0.6730769230769231,69,35,34,206.9691162790506,0.400244089713949,0.7442237811705172,0.1311566720287685,1105178.7564050138,6147.574108705189,1111326.330513719,2800,3,1277.0872093023256,82,90,39,35.52574752171524,0.6227134146341464,40.88855421686747,8530.528267979415,104.03083253633433,0
2802,32.489262372688806,0,0,172,0.0,0.0,1.0,172,4750,3200,1550,0.6736842105263158,63,32,31,205.7579309245839,0.40035813046828955,0.7434411612074734,0.13077499263572093,1091521.799703003,5767.853413193534,1097289.6531161964,2801,4,1278.0872093023256,84,88,42,35.45074539838629,0.623015873015873,40.78431372549019,8421.72644248913,100.25864812487059,0
2803,32.64075434877422,0,0,172,0.0,0.0,1.0,172,4550,3200,1350,0.7032967032967034,59,32,27,205.57567695468697,0.4004601296522961,0.7434724060802471,0.13103131670195903,1097458.7298023459,6172.164261789703,1103630.8940641356,2802,5,1279.0872093023256,87,85,42,35.35328319715161,0.6229645593869733,40.68418560606061,8464.263796384917,97.29038846419445,0
2804,32.54866372444807,0,0,172,0.0,0.0,1.0,172,5950,4800,1150,0.8067226890756303,71,48,23,199.9189323172257,0.40065279477764176,0.7359196908292975,0.12812885926791917,1095992.9915739032,3471.9497405231014,1099464.9413144263,2803,6,1280.0872093023256,69,103,42,35.30299663589274,0.6326992753623188,40.49107142857141,8446.668849563195,122.41549057337964,0
2805,32.11866686909207,0,1,171,0.0,0.005813953488372093,0.9941860465116279,172,5200,3900,1300,0.75,65,39,26,196.01267783797215,0.4010062502833311,0.7305658339564289,0.12606753882155794,1082538.7443820783,2838.263629936974,1085377.0080120154,2804,7,1281.0872093023256,72,100,44,35.27903728130436,0.6323784722222222,40.36815068493147,8339.028876756916,115.81984551051272,0
2806,32.227033124018625,0,0,171,0.0,0.0,1.0,171,4900,3400,1500,0.6938775510204082,64,34,30,199.68179554440144,0.4006019951840385,0.7324405358812502,0.12909025920711023,1087693.789199941,4338.529765987316,1092032.3189659284,2805,8,1289.374269005848,73,98,43,35.000665962326806,0.6337043378995434,40.1886261261261,8372.94975183007,114.69794180589138,0
2807,31.87891912811954,0,1,170,0.0,0.005847953216374269,0.9941520467836258,171,4850,3300,1550,0.6804123711340206,64,33,31,197.81589127151517,0.40067939456484347,0.7307379900562307,0.1286515349095609,1077666.5174454674,3585.912528388744,1081252.429973856,2806,9,1290.374269005848,75,96,40,34.83721864951768,0.6348611111111111,39.98081140350875,8289.130685026757,110.52174246702343,0
2808,31.496846226441832,0,0,170,0.0,0.0,1.0,170,4200,2900,1300,0.6904761904761905,55,29,26,203.13426400943814,0.3999753451676529,0.7374061727067425,0.12830767022305173,1056389.070768884,4717.763279650349,1061106.8340485343,2807,10,1298.735294117647,76,94,38,35.742687385740425,0.6240405701754386,41.00378787878788,8157.563866412735,107.33636666332545,8
2809,31.724061733760177,0,0,170,0.0,0.0,1.0,170,4350,3400,950,0.7816091954022989,53,34,19,200.60395908428484,0.3997389488339715,0.7341335509026468,0.1270874938496715,1064875.547727239,4373.650161226073,1069249.1978884651,2808,11,1299.735294117647,79,91,39,35.70075757575758,0.6238132911392404,40.8984375,8219.753964063719,104.04751853245213,0
2810,31.80531844418548,1,0,171,0.005847953216374269,0.0,1.0,171,5350,3700,1650,0.6915887850467289,70,37,33,209.27083642258398,0.4009330925352597,0.7465802116601539,0.1324263518735446,1067269.4366510669,5119.6735392455175,1072389.1101903124,2809,0,1293.1286549707602,72,99,42,35.51753419627285,0.6265914351851851,40.938926940639256,8239.519925145332,114.43777673812961,8
2811,31.640199164680915,1,0,172,0.005813953488372093,0.0,1.0,172,4900,3000,1900,0.6122448979591837,68,30,38,206.5037520561515,0.40195895099505874,0.7452078266905486,0.1313890406508663,1063304.42411498,4615.27063152984,1067919.69474651,2810,0,1286.6046511627908,76,96,43,35.39307642802477,0.6266447368421053,40.74675324675325,8202.824361362902,107.93189949161713,0
2812,31.57114367224964,0,0,172,0.0,0.0,1.0,172,4950,3500,1450,0.7070707070707071,64,35,29,212.0933533330111,0.4021827825377397,0.7530353974035682,0.13541344866646055,1061980.511514292,5697.801572274413,1067678.3130865665,2811,1,1287.6046511627908,63,109,44,35.123828647925016,0.6349206349206349,40.624999999999986,8188.765389989722,129.98040301570987,0
2813,31.633358649958218,0,0,172,0.0,0.0,1.0,172,4300,3000,1300,0.6976744186046512,56,30,26,212.9059183071106,0.4021849075207398,0.7536737466041015,0.13661744266647977,1065520.1485129672,6671.109138776226,1072191.2576517435,2812,2,1288.6046511627908,64,108,42,34.922717543426366,0.6360677083333333,40.448717948717935,8210.478793184633,128.2887311435099,0
2814,31.174459335486226,0,0,172,0.0,0.0,1.0,172,4750,3000,1750,0.631578947368421,65,30,35,211.37873976804715,0.4023407396074165,0.7520603822768961,0.13599498036465138,1050807.5924791894,5273.676927389229,1056081.2694065787,2813,3,1289.6046511627908,65,107,44,34.868384394059134,0.6363782051282052,40.35669191919191,8094.239749496254,124.52676537686546,0
2815,30.85058694995981,0,0,172,0.0,0.0,1.0,172,4900,3300,1600,0.673469387755102,65,33,32,210.4705065985142,0.4023655310757514,0.7505952478919438,0.13579672412041113,1040686.5933190661,4506.766901229115,1045193.3602202953,2814,4,1290.6046511627908,67,105,44,34.790536290005484,0.6361940298507462,40.257352941176464,8013.213117700948,119.60019578658131,0
2816,30.689338631807146,0,0,172,0.0,0.0,1.0,172,4350,3000,1350,0.6896551724137931,57,30,27,207.8771147836863,0.4025036549707602,0.7478803083482624,0.1346274136149877,1036288.0338866747,4334.113313844131,1040622.1472005188,2815,5,1291.6046511627908,68,104,45,34.72464273265948,0.6369485294117647,40.1268115942029,7975.336280312923,117.28435706342533,0
2817,30.502555381375824,0,0,172,0.0,0.0,1.0,172,4300,3200,1100,0.7441860465116279,54,32,22,206.57182666581895,0.402228823836076,0.7461679626501161,0.13409896841416513,1030632.354768244,3879.92162907398,1034512.276397318,2816,6,1292.6046511627908,69,103,39,34.67469755948633,0.6372282608695652,40.04464285714285,7929.302677935312,114.91743011500452,0
2818,30.337126839748375,0,0,172,0.0,0.0,1.0,172,5150,3600,1550,0.6990291262135923,67,36,31,210.19123148180645,0.4026495704701029,0.7497435551002369,0.1370533410423296,1026251.4132768111,3591.809673319408,1029843.2229501306,2817,7,1293.6046511627908,70,102,41,34.424177900614794,0.6382440476190476,39.891431924882625,7890.946621800152,112.7278088828593,0
2819,30.671244551083248,1,0,173,0.005780346820809248,0.0,1.0,173,4200,3200,1000,0.7619047619047619,52,32,20,208.19424358110717,0.4032464040865708,0.7490496614609461,0.13635506091289745,1038777.0413628384,4453.4800751913335,1043230.5214380297,2818,0,1287.121387283237,73,100,42,34.31967431085146,0.6382705479452055,39.73817567567568,7982.554061162425,109.35005563236199,0
2820,30.986191612800244,0,0,173,0.0,0.0,1.0,173,4550,3500,1050,0.7692307692307693,56,35,21,195.21167454540196,0.403390632701528,0.719365741843585,0.11782065027131093,1026166.8117407729,913.9483365664473,1027080.7600773394,2819,1,1288.121387283237,76,97,39,37.616738505747115,0.6074561403508771,42.640692640692635,7974.584811173037,104.92874751543471,8
2821,30.987987398865872,0,1,172,0.0,0.005780346820809248,0.9942196531791907,173,5950,4200,1750,0.7058823529411765,77,42,35,196.60600159671566,0.4032604068647219,0.7203055698294774,0.1190856699497723,1027264.4504997277,-156.72876096028358,1027107.7217387675,2820,2,1289.121387283237,78,95,41,37.448151372388295,0.607905982905983,42.510548523206744,7979.0798777037435,102.2958958679967,0
2822,31.48997531879267,3,1,174,0.017142857142857144,0.005714285714285714,0.9942857142857143,175,5350,3900,1450,0.7289719626168224,68,39,29,195.6907285872085,0.40504378762999454,0.7228808021631361,0.11929607877335589,1045804.7887534387,580.8602142303603,1046385.6489676691,2821,0,1275.36,81,94,39,37.23301130389066,0.6090534979423868,42.27642276422764,8115.709086225423,100.19393933611633,0
2823,31.67477574798627,0,0,174,0.0,0.0,1.0,174,5050,3600,1450,0.7128712871287128,65,36,29,194.20351181573963,0.40488381170686333,0.7186672281520139,0.11887845792285989,1053162.792730545,1055.5825723884159,1054218.3753029334,2822,1,1282.051724137931,85,89,41,37.11895255988729,0.6090686274509804,42.1269379844961,8168.071410787579,96.09495777397152,0
2824,31.60445038270009,0,0,174,0.0,0.0,1.0,174,4250,3200,1050,0.7529411764705882,53,32,21,194.4874455383889,0.4049647863929307,0.7197344065073445,0.11918788234260055,1051160.4123508187,1837.5006898377565,1052997.9130406566,2823,2,1283.051724137931,86,88,36,37.06961917583521,0.6091327519379846,42.08572796934864,8151.238813382886,94.78184666724286,0
2825,31.55106079065321,1,0,175,0.005714285714285714,0.0,1.0,175,4250,2100,2150,0.49411764705882355,64,21,43,195.58666851015067,0.40591543513957307,0.7219688876215835,0.12037950973413378,1050652.74207618,1848.733916746638,1052501.4759929266,2824,0,1276.7142857142858,90,85,38,36.882438826051605,0.609375,41.92994505494504,8142.383991818592,90.4709332424288,0
2826,31.14972973299904,2,1,176,0.011299435028248588,0.005649717514124294,0.9943502824858758,177,4550,3000,1550,0.6593406593406593,61,30,31,199.0114464099891,0.4071782443074816,0.7329141607435747,0.12338709677419353,1039405.9122712547,1420.7348016394153,1040826.6470728941,2825,0,1263.276836158192,85,92,42,36.5255376344086,0.6137254901960785,41.66666666666667,8047.013514358101,94.67074722774237,0
2827,31.66350109368328,0,0,176,0.0,0.0,1.0,176,4400,3200,1200,0.7272727272727273,56,32,24,184.40270231307264,0.4071814123376623,0.7176117196577376,0.1130534132124443,1053244.070650942,-755.7894353494466,1052488.2812155925,2826,1,1271.4318181818182,84,92,39,37.31479941717743,0.6099950396825398,42.07107843137253,8166.932690180724,97.22538916881815,8
2828,31.66554710777201,0,1,175,0.0,0.005681818181818182,0.9943181818181818,176,5300,3800,1500,0.7169811320754716,68,38,30,187.47086241987364,0.4071672077922078,0.7235875590360832,0.11536415607357343,1054413.4219848134,-965.6412866835399,1053447.78069813,2827,2,1272.4318181818182,84,92,40,37.09833159211066,0.611359126984127,41.93627450980391,8171.729056316914,97.28248876567754,0
2829,31.84027302784574,0,0,175,0.0,0.0,1.0,175,4900,3700,1200,0.7551020408163265,61,37,24,189.576097464254,0.4067323481116585,0.7236397270740904,0.11698392997548068,1061053.6453822448,330.0818583572109,1061383.727240602,2828,3,1280.6914285714286,85,90,44,36.94207250320606,0.6120098039215687,41.836240310077514,8220.004594422271,96.7059364049679,0
2830,31.65547906719,0,0,175,0.0,0.0,1.0,175,5500,3800,1700,0.6909090909090909,72,38,34,193.76159640499588,0.4068253968253968,0.7296976192709101,0.12005112739491425,1056083.6910799756,425.69238418740406,1056509.383464163,2829,4,1281.6914285714286,85,90,44,36.68585294945138,0.6134803921568628,41.69089147286822,8176.898577845145,96.19880679817818,0
2831,31.9647530842382,1,0,176,0.005681818181818182,0.0,1.0,176,3700,2600,1100,0.7027027027027027,48,26,22,194.04041045738464,0.40783346861471864,0.7304531471958091,0.12101664580206474,1068345.942180141,2560.4570262234606,1070906.3992063645,2830,0,1275.403409090909,73,103,43,36.43871027749042,0.6208618721461188,41.45551801801804,8264.31052784638,113.2097332581696,0
2832,32.09666572227459,1,0,177,0.005649717514124294,0.0,1.0,177,4850,3300,1550,0.6804123711340206,64,33,31,188.91656609266158,0.4081934279233008,0.724623834694063,0.11837616022136606,1074146.399801875,334.80986627349284,1074481.2096681485,2831,0,1269.1920903954801,76,101,40,36.40037823328459,0.6211622807017544,41.287878787878824,8303.796472846121,109.26047990587001,0
2833,31.97212246316329,1,0,178,0.0056179775280898875,0.0,1.0,178,4800,3600,1200,0.75,60,36,24,189.39352506886948,0.40877597388857145,0.7182689819543737,0.11912904710416168,1071101.766911843,171.94786858599764,1071273.7147804291,2832,0,1263.056179775281,82,96,46,36.24969696969698,0.6200457317073171,41.152108433734966,8275.916488488307,100.92581083522325,8
2834,31.769261210239094,0,0,178,0.0,0.0,1.0,178,5200,3700,1500,0.7115384615384616,67,37,30,187.4843581560504,0.40906692376055354,0.715538569317804,0.11827940685844901,1065173.2822033307,-859.3341722268315,1064313.948031104,2833,1,1264.056179775281,83,95,42,36.19165629090449,0.6207329317269077,41.046626984127,8226.75734861379,99.1175584170336,0
2835,32.178676334278315,0,2,176,0.0,0.011235955056179775,0.9887640449438202,178,4850,3500,1350,0.7216494845360825,62,35,27,186.1448522625849,0.409086761251825,0.7142081492698649,0.11777659479134422,1079758.7691679446,-251.69268680020105,1079507.0764811444,2834,2,1265.056179775281,84,94,43,36.12142643139849,0.6214037698412698,40.943627450980415,8336.09116458719,99.23918053079987,0
2836,32.072918852410986,2,0,178,0.011235955056179775,0.0,1.0,178,4200,2900,1300,0.6904761904761905,55,29,26,186.4100969296832,0.41001118834507716,0.7139118056918892,0.11854140789249434,1077691.0017725811,378.49682013503934,1078069.4985927162,2835,0,1260.8426966292134,88,90,48,35.93305566842749,0.6218039772727273,40.76544943820227,8314.408703909823,94.48191708988435,0
2837,31.896568011003634,0,0,178,0.0,0.0,1.0,178,4900,3700,1200,0.7551020408163265,61,37,24,186.02365701558878,0.4101560020313591,0.7143787729410342,0.11861257993999207,1072544.053213892,-596.286582165566,1071947.7666317264,2836,1,1261.8426966292134,89,89,49,35.8471689130888,0.6224250936329587,40.671296296296326,8271.695634890679,92.9404003920301,0
2838,31.939597342105937,0,0,178,0.0,0.0,1.0,178,4450,2900,1550,0.651685393258427,60,29,31,187.31273087092706,0.4097070134789141,0.7174715138361392,0.11978395662564748,1074840.9546231916,216.27889247652547,1075057.2335156682,2837,2,1262.8426966292134,73,105,51,35.709215047929135,0.629851598173516,40.56869369369367,8286.131461359904,113.50865015561513,0
2839,31.849019675527035,1,0,179,0.00558659217877095,0.0,1.0,179,4150,2700,1450,0.6506024096385542,56,27,29,185.72433391990884,0.41023397777917264,0.7177829389241106,0.11928480415680653,1073049.319239803,-91.72598419555197,1072957.5932556074,2838,0,1256.782122905028,74,105,48,35.59557249866236,0.6309121621621622,40.416666666666636,8267.474690772156,111.7226309563805,0
2840,31.805580922827357,0,1,178,0.0,0.00558659217877095,0.994413407821229,179,4450,2900,1550,0.651685393258427,60,29,31,184.83104646313797,0.41050206097127195,0.7165487864754059,0.11898145345715634,1072242.2235776319,-613.2695508373363,1071628.9540267945,2839,1,1257.782122905028,75,104,52,35.53779581243949,0.63125,40.33717105263154,8258.727118735711,110.11636158314282,0
2841,31.31623531516357,1,0,179,0.00558659217877095,0.0,1.0,179,4500,3400,1100,0.7555555555555555,56,34,22,185.17411652111508,0.41091137823530643,0.7154346969606806,0.11997967904770339,1057587.117445597,-1132.447976580268,1056454.6694690166,2840,0,1258.608938547486,78,101,54,35.29828344326063,0.6322115384615384,40.11075949367085,8138.752611575248,104.34298219968267,0
2842,31.098956313474535,0,0,179,0.0,0.0,1.0,179,4950,3500,1450,0.7070707070707071,64,35,29,184.9741264494874,0.41081460674157305,0.7152115360890385,0.12026843774358495,1051226.8970403897,-1860.0446039503813,1049366.8524364394,2841,1,1259.608938547486,81,98,42,35.18032212885155,0.632201646090535,39.989837398373936,8086.044687807256,99.8277121951513,0
2843,30.869957135444768,1,0,180,0.005555555555555556,0.0,1.0,180,5800,4000,1800,0.6896551724137931,76,40,36,184.0650717111604,0.41082272915373474,0.7162228358132658,0.12025658473492096,1044827.3011171343,-3336.7575788198274,1041490.5435383144,2842,0,1253.6055555555556,86,94,43,35.033843380886616,0.6320251937984496,39.82279693486586,8031.659106240501,93.3913849562849,0
2844,31.28929295984508,0,0,180,0.0,0.0,1.0,180,5100,3600,1500,0.7058823529411765,66,36,30,185.46128050981144,0.41069664287192215,0.7178280249242224,0.1214634484616368,1059702.5839947725,-1793.240362555177,1057909.3436322173,2843,1,1254.6055555555556,86,94,43,34.912150557421256,0.6328730620155039,39.738984674329465,8143.383154551538,94.6905017971109,0
2845,31.48020763243002,0,1,179,0.0,0.005555555555555556,0.9944444444444445,180,3450,2500,950,0.7246376811594203,44,25,19,186.23681194488785,0.41053240740740743,0.7203344319256051,0.1223110684307321,1066953.383971727,291.1993449403926,1067244.5833166675,2844,2,1255.6055555555556,86,94,45,34.79439717942819,0.6338420542635659,39.64319923371644,8196.086146637721,95.30332728648513,0
2846,31.409790900701882,0,1,178,0.0,0.00558659217877095,0.994413407821229,179,6050,4600,1450,0.7603305785123967,75,46,29,184.37868333862318,0.40970958090096876,0.716097917898068,0.12139989711958839,1065283.6104827134,-2566.882103396316,1062716.728379317,2845,3,1263.5865921787708,74,105,47,34.75351518060293,0.6396396396396397,39.55555555555557,8180.505541249506,110.54737217904737,0
2847,31.521472872808122,0,0,178,0.0,0.0,1.0,178,4900,3400,1500,0.6938775510204082,64,34,30,184.9022079246863,0.40860537146363657,0.7159510021824202,0.12227984971381149,1070306.4736764592,-919.5939722272478,1069386.8797042319,2846,4,1271.629213483146,75,103,45,34.58669725976962,0.6406944444444445,39.405153508771946,8214.333384466887,109.52444512622516,0
2848,31.99157002349762,0,0,178,0.0,0.0,1.0,178,5900,4400,1500,0.7457627118644068,74,44,30,182.6867991833728,0.40878787638333436,0.7129861139549911,0.12152221523891678,1087931.7504490092,-1749.8461561012027,1086181.904292908,2847,5,1272.629213483146,79,99,46,34.441362108276394,0.640954641350211,39.20572916666668,8343.218177091609,105.61035667204568,0
2849,32.437460027433495,0,0,178,0.0,0.0,1.0,178,5600,4100,1500,0.7321428571428571,71,41,30,183.50098504478729,0.40880440762606063,0.7158578791697285,0.12271628374870218,1104629.6247890792,-659.8751483097685,1103969.7496407693,2848,6,1273.629213483146,81,97,48,34.235462097611624,0.6419753086419753,39.02439024390246,8465.385909598552,104.51093715553768,0
2850,32.88064610537327,0,1,177,0.0,0.0056179775280898875,0.9943820224719101,178,4550,3400,1150,0.7472527472527473,57,34,23,183.05365799339887,0.40833095283438076,0.7147927680175852,0.1227444783202202,1120499.2351232828,872.2967536247502,1121371.5318769075,2849,7,1274.629213483146,84,94,53,34.15491167128262,0.6417410714285714,38.93382352941178,8584.024558612391,102.19076855490941,0
2851,33.24944273362955,0,0,177,0.0,0.0,1.0,177,4500,2900,1600,0.6444444444444445,61,29,32,182.5029014414386,0.4078737587741825,0.7119955097241488,0.12276658589646078,1134005.242937584,1491.8494171826324,1135497.0923547666,2850,8,1281.7457627118645,87,90,43,34.05925187333818,0.6417624521072797,38.825757575757585,8683.898016983963,99.81491973544786,0
2852,32.814299377119,0,0,177,0.0,0.0,1.0,177,3900,2800,1100,0.717948717948718,50,28,22,184.039023377563,0.4071541688067111,0.7153746065838771,0.12409457701384818,1119852.4285479102,1919.3094553899396,1121771.7380033,2851,9,1282.7457627118645,91,86,43,33.937368177746976,0.6412545787545787,38.74547101449275,8572.88432775864,94.20752008525979,0
2853,33.027328980177906,0,0,177,0.0,0.0,1.0,177,4400,3100,1300,0.7045454545454546,57,31,26,183.03339953100433,0.40708060477657937,0.7176895220708868,0.11759337134047501,1112842.6337980872,937.474081419814,1113780.1078795071,2852,10,1283.7457627118645,75,102,46,35.654259063709944,0.6305555555555555,40.405701754385944,8573.706289536267,114.31608386048356,8
2854,32.502148097637146,0,1,176,0.0,0.005649717514124294,0.9943502824858758,177,4300,2800,1500,0.6511627906976745,58,28,30,182.37127859331176,0.40713811847286424,0.7165032540833758,0.11721392561370568,1095262.5209790356,248.88526925592214,1095511.4062482915,2853,11,1284.7457627118645,75,102,48,35.657491244742424,0.6306944444444444,40.391995614035075,8437.817805884635,112.50423741179513,0
2855,32.675832006928225,0,0,176,0.0,0.0,1.0,176,4750,3500,1250,0.7368421052631579,60,35,25,183.91028553907694,0.40662540584415585,0.7170835680906784,0.11869786193733757,1102352.3639085027,596.7876022176006,1102949.1515107204,2854,12,1292.534090909091,76,100,47,35.46907279134767,0.6317160087719298,40.246212121212096,8487.671135890478,111.67988336697996,0
2856,32.19515165403006,0,0,176,0.0,0.0,1.0,176,4850,3700,1150,0.7628865979381443,60,37,23,186.27769221296043,0.4065530303030303,0.718879609909205,0.12085696670776795,1087659.60619248,471.34427095822775,1088130.9504634384,2855,13,1293.534090909091,77,99,45,35.222076654336206,0.6331168831168832,40.06410256410254,8368.675638275061,108.68409919837741,0
2857,32.102609949928926,0,0,176,0.0,0.0,1.0,176,4250,3100,1150,0.7294117647058823,54,31,23,187.25692502225536,0.40626149891774893,0.7214052802645043,0.12163265129823883,1084867.58427061,1179.7935773670438,1086047.377847977,2856,14,1294.534090909091,77,99,48,35.15580854779882,0.6335227272727273,40.02403846153843,8345.906889626884,108.3884011639855,0
2858,32.24900162487448,0,0,176,0.0,0.0,1.0,176,6050,4800,1250,0.7933884297520661,73,48,25,190.4518483328603,0.4059577922077922,0.7246731824247536,0.12450443448525772,1091677.4455145553,332.3974563080501,1092009.8429708635,2857,15,1295.534090909091,80,96,39,34.84643486713122,0.6345052083333333,39.801954732510254,8391.127184620353,104.8890898077544,0
2859,32.37267461407673,0,0,176,0.0,0.0,1.0,176,4750,3800,950,0.8,57,38,19,192.3742916600419,0.40608766233766236,0.7280293168888774,0.12619315488970798,1096859.9909019412,2251.532759999961,1099111.523661941,2858,16,1296.534090909091,82,94,39,34.67591922990387,0.6349085365853658,39.68373493975901,8427.133745546877,102.76992372618142,0
2860,32.021849981851105,0,0,176,0.0,0.0,1.0,176,4550,2900,1650,0.6373626373626373,62,29,33,193.31433270778848,0.40602002164502166,0.729794738445364,0.1273369561442578,1086162.526067936,2244.1567878056626,1088406.6828557418,2859,17,1297.534090909091,73,103,41,34.50605982813598,0.6402682648401826,39.541103603603595,8340.37570684388,114.25172201156,0
2861,31.659071790820853,1,0,177,0.005649717514124294,0.0,1.0,177,4750,2900,1850,0.6105263157894737,66,29,37,192.03607728456342,0.4062379622496148,0.728568469252938,0.12705800261521702,1075112.8129175084,1142.0894462102733,1076254.9023637187,2860,0,1291.1977401129943,74,103,42,34.384215341433915,0.6413288288288288,39.38888888888889,8250.705876152271,111.49602535340907,0
2862,31.664265429662105,1,0,178,0.0056179775280898875,0.0,1.0,178,4750,3800,950,0.8,57,38,19,189.1880773934686,0.4070725946380584,0.7263836870578448,0.1258511993095682,1076810.935076614,393.9581046815083,1077204.8931812954,2861,0,1284.938202247191,76,102,42,34.270606390704415,0.6422697368421053,39.20454545454545,8257.896495576646,108.65653283653482,0
2863,31.38756412515169,1,0,179,0.00558659217877095,0.0,1.0,179,4250,2900,1350,0.6823529411764706,56,29,27,187.9303241994841,0.4075570690268449,0.7264929569195615,0.12565935731608724,1068834.1792140491,123.27076303711783,1068957.4499770862,2862,0,1278.7541899441342,78,101,44,34.12510947184047,0.6431623931623931,39.0295358649789,8191.227177808558,105.01573304882767,0
2864,31.505195771268504,0,0,179,0.0,0.0,1.0,179,5400,3900,1500,0.7222222222222222,69,39,30,187.88197617175405,0.40752699140041426,0.7262349743412913,0.12596936153825108,1073598.8796019694,-858.024176920248,1072740.855425049,2863,1,1279.7541899441342,78,101,37,34.03233749179248,0.6440972222222222,38.93723628691983,8224.833479368994,105.44658306883325,0
2865,31.200006866439175,0,1,178,0.0,0.00558659217877095,0.994413407821229,179,4550,3200,1350,0.7032967032967034,59,32,27,190.1347301718834,0.4073242943527295,0.7291580392878156,0.12772822918330992,1063736.057023377,100.63363524852593,1063836.6906586254,2864,2,1280.7541899441342,78,101,38,33.90634467784285,0.6447649572649572,38.871308016877634,8147.216982897688,104.45149978073958,0
2866,31.6669355535728,0,1,177,0.0,0.0056179775280898875,0.9943820224719101,178,5000,3600,1400,0.72,64,36,28,191.32895842661785,0.40681272350240166,0.7290509194265922,0.12878135703271712,1080200.808198156,734.7391048286968,1080935.5473029849,2865,4,1288.938202247191,78,100,38,33.80797028286806,0.6454326923076923,38.805379746835435,8271.233206496861,106.04145136534437,0
2867,31.403786344121738,0,0,177,0.0,0.0,1.0,177,6800,5100,1700,0.75,85,51,34,192.20161791516733,0.4063088512241055,0.7305024066967418,0.13013927909971712,1072867.186407088,-958.6381928927899,1071908.5482141953,2866,6,1297.1977401129943,81,96,39,33.58113225121899,0.6462191358024691,38.60518292682927,8208.78698682665,101.3430492200821,0
2868,31.45202754175534,0,0,177,0.0,0.0,1.0,177,3450,2300,1150,0.6666666666666666,46,23,23,202.75480862289461,0.40632356403013187,0.7454716971877859,0.1326157161510117,1064844.4929534807,4330.46827638498,1069174.9612298657,2867,7,1298.1977401129943,82,95,42,34.508134786662794,0.6338922764227642,39.78413654618472,8184.316504150992,99.8087378554999,8
2869,31.615513696659534,1,0,178,0.0056179775280898875,0.0,1.0,178,5100,3700,1400,0.7254901960784313,65,37,28,198.72255185512518,0.40663749232950336,0.7422315862357627,0.13051108094502184,1071539.2896553054,1887.8044106658008,1073427.0940659712,2868,0,1291.8988764044943,86,92,45,34.46932244960526,0.6338420542635659,39.64319923371646,8231.314000644848,95.71295349587034,0
2870,32.041185308470546,0,0,178,0.0,0.0,1.0,178,5700,4100,1600,0.7192982456140351,73,41,32,196.6022821808293,0.4063154637211959,0.7388469227654617,0.12989793644090528,1087690.505041069,1468.4871194986276,1089158.9921605675,2869,1,1292.8988764044943,70,108,43,34.3138841966967,0.6428571428571428,39.43661971830986,8348.759552207124,119.26799360295892,0
2871,31.866149822203887,0,1,177,0.0,0.0056179775280898875,0.9943820224719101,178,5200,3800,1400,0.7307692307692307,66,38,28,196.38591329076198,0.4060079826064877,0.7388024592760665,0.1302568605174898,1082845.2834858843,1731.1119899939044,1084576.3954758781,2870,2,1293.8988764044943,70,108,46,34.184886600258906,0.6441964285714286,39.304577464788736,8307.359392469793,118.67656274956846,0
2872,32.114974708946576,1,0,178,0.0056179775280898875,0.0,1.0,178,4050,2700,1350,0.6666666666666666,54,27,27,194.29441969692806,0.4067036173004084,0.7357092197273909,0.12954378486138743,1092790.2500893353,2814.6094983137127,1095604.8595876489,2871,0,1294.3202247191011,72,106,47,34.05808992451591,0.6449652777777778,39.12671232876713,8377.9390358014,116.36026438613057,0
2873,32.47223879843168,0,0,178,0.0,0.0,1.0,178,5900,4300,1600,0.7288135593220338,75,43,32,191.66132168669023,0.4063677024482109,0.7317583866136994,0.12842333479862264,1106373.8533786298,909.8150036292191,1107283.668382259,2872,1,1295.3202247191011,74,104,43,33.95517424847035,0.6456925675675675,38.95833333333336,8476.60733634066,114.54874778838729,0
2874,32.92844817304713,0,0,178,0.0,0.0,1.0,178,5350,4100,1250,0.7663551401869159,66,41,25,190.1567331944342,0.40633728496159466,0.7303803972766014,0.127939082923841,1123111.6988570201,1763.450333420683,1124875.1491904408,2873,2,1296.3202247191011,74,104,39,33.85292032260923,0.6471002252252251,38.819444444444464,8600.27038741882,116.21987010025431,0
2875,32.62308967857618,0,0,178,0.0,0.0,1.0,178,5100,3500,1600,0.6862745098039216,67,35,32,187.74427185731997,0.40627314373981677,0.7267842132359128,0.12674871062300447,1113680.4676640145,1117.425696660303,1114797.8933606748,2874,3,1297.3202247191011,76,102,40,33.79832168435581,0.6473410087719298,38.70400432900435,8524.282699427798,112.16161446615524,0
2876,32.20390235130374,1,0,179,0.00558659217877095,0.0,1.0,179,3850,3000,850,0.7792207792207793,47,30,17,186.2356033250395,0.406629893499048,0.7257249805148358,0.12618957865762984,1100403.7468037372,1336.8711374258037,1101740.617941163,2875,0,1291.0670391061453,78,101,42,33.71267527489157,0.6477029914529915,38.581223628692,8418.704747058957,107.9321121417815,0
2877,32.477443005734884,0,0,179,0.0,0.0,1.0,179,5850,4300,1550,0.7350427350427351,74,43,31,185.89340403190744,0.40632911723474147,0.7253451811469867,0.12626478123220347,1110445.0955055058,-365.1162411887299,1110079.979264317,2876,1,1292.0670391061453,73,106,44,33.63831395453158,0.6508276255707763,38.49943693693696,8492.869632848267,116.34067990203106,0
2878,32.060758539104064,0,1,178,0.0,0.00558659217877095,0.994413407821229,179,4900,3500,1400,0.7142857142857143,63,35,28,185.75626300047915,0.406195729500136,0.7260690953373059,0.12668457679228867,1097338.2126201324,67.48912478835564,1097405.7017449208,2877,2,1293.0670391061453,75,104,42,33.50342474723661,0.65125,38.363486842105274,8388.265073368417,111.84353431157889,0
2879,32.427096854509905,0,0,178,0.0,0.0,1.0,178,4600,3400,1200,0.7391304347826086,58,34,24,183.2262217147737,0.4059967413614338,0.7204924077461308,0.12545744480470228,1111005.2095053138,513.0573686180446,1111518.2668739317,2878,3,1301.0393258426966,76,102,46,33.43421619293714,0.6521381578947368,38.2305194805195,8488.42429835998,111.68979339947342,0
2880,32.0297317293654,1,1,178,0.00558659217877095,0.00558659217877095,0.994413407821229,179,4500,2700,1800,0.6,63,27,36,181.25873728341102,0.4067946665829724,0.720031145848433,0.12479682671689468,1098931.122461392,-461.8264762413128,1098469.2959851508,2879,0,1294.7653631284916,79,100,46,33.29874573350567,0.6526898734177216,38.046875,8390.28831941892,106.20618125846734,0
2881,32.21251268651789,0,0,178,0.0,0.0,1.0,178,4100,2500,1600,0.6097560975609756,57,25,32,180.60679846359665,0.40618718127764025,0.7169259423855416,0.12475950302003999,1106127.5744550165,254.83198292487168,1106382.4064379414,2880,1,1297.2865168539327,80,98,46,33.204211240880696,0.6533854166666666,37.937242798353914,8441.699891021895,105.5212486377737,0
2882,32.21825469754091,0,0,178,0.0,0.0,1.0,178,5000,3600,1400,0.72,64,36,28,181.36318170007766,0.40603707759368585,0.7192674390308298,0.12573579802176368,1107335.303359038,-434.02923479682113,1106901.2741242412,2881,2,1298.2865168539327,81,97,39,33.06255753670238,0.6541923868312758,37.81758130081301,8447.059942867723,104.28469065268794,0
2883,31.87517256405731,0,0,178,0.0,0.0,1.0,178,5250,3900,1350,0.7428571428571429,66,39,27,217.629226085563,0.40586449141962383,0.7625894846631573,0.14471977155521454,1083883.4979380844,6326.945364635714,1090210.44330272,2882,3,1299.2865168539327,70,108,39,33.54113924050632,0.6450892857142857,39.21654929577465,8312.51749304752,118.75024990067887,8
2884,31.672513359368903,0,1,177,0.0,0.0056179775280898875,0.9943820224719101,178,4850,3600,1250,0.7422680412371134,61,36,25,216.82107276037488,0.40597227512219897,0.7629991949945589,0.14461786631001464,1077840.704499589,6289.715562879868,1084130.4200624689,2883,4,1300.2865168539327,70,108,42,33.457288269036084,0.6461309523809524,39.113849765258216,8262.920078584186,118.04171540834551,0
2885,31.60639242732757,1,0,178,0.0056179775280898875,0.0,1.0,178,5250,3900,1350,0.7428571428571429,66,39,27,215.9142810648462,0.40593590638820115,0.7611099274802977,0.14500965390096274,1077520.740874237,5680.423219664351,1083201.1640939012,2884,0,1301.2359550561798,76,102,36,33.2419136186233,0.6455592105263157,38.879870129870135,8253.065295350078,108.59296441250102,0
2886,31.661368254344712,0,1,177,0.0,0.0056179775280898875,0.9943820224719101,178,4950,3500,1450,0.7070707070707071,64,35,29,216.05974994482455,0.4058109301931907,0.7628133953502942,0.1458348806640708,1080792.0580157563,6153.132359447684,1086945.190375204,2885,1,1302.2359550561798,79,99,39,33.065532549293216,0.6459651898734178,38.71093750000002,8272.769228645047,104.71859783094996,0
2887,31.738155632237216,0,0,177,0.0,0.0,1.0,177,5150,3300,1850,0.6407766990291263,70,33,37,214.7393432477146,0.40518532785481937,0.7603572595868424,0.14550737898465171,1084497.3371993466,6026.849188816735,1090524.1863881634,2886,2,1310.1694915254238,80,97,40,32.96653630460448,0.646875,38.580246913580254,8296.980808797834,103.71226010997293,0
2888,31.429078983842945,1,0,178,0.0056179775280898875,0.0,1.0,178,4650,3200,1450,0.6881720430107527,61,32,29,214.9040252111021,0.4062400812543643,0.7533150922810643,0.1371564625536143,1057094.29718133,5184.763898393923,1062279.0610797238,2887,0,1303.8033707865168,78,100,40,35.06439586510762,0.6268696581196581,40.63818565400845,8151.502948473011,104.5064480573463,7
2889,31.72208344332331,1,0,179,0.00558659217877095,0.0,1.0,179,4950,3600,1350,0.7272727272727273,63,36,27,212.9327412445058,0.4071464440399222,0.7522280973823365,0.13662422667834112,1068486.713142502,4753.160962552758,1073239.8741050547,2888,0,1297.513966480447,71,108,41,34.92474916387958,0.6320422535211268,40.45138888888887,8233.422699265298,115.96369998965208,0
2890,31.776686817952783,1,1,179,0.005555555555555556,0.005555555555555556,0.9944444444444445,180,3650,2000,1650,0.547945205479452,53,20,33,235.16192532538616,0.40796994620318644,0.7786136867853692,0.14408893291373137,1056836.4579019833,10055.539238858259,1066891.9971408416,2889,0,1291.3,70,110,40,36.027125168287924,0.615922619047619,42.09213615023473,8195.457417441172,117.07796310630245,8
2891,31.913440880702563,0,0,179,0.0,0.0,1.0,179,4850,3400,1450,0.7010309278350515,63,34,29,237.31122343316548,0.40718044483501764,0.7785381441540964,0.14597061784235915,1062537.9409639265,9780.435742861073,1072318.3767067876,2890,1,1299.508379888268,72,107,36,35.82828743640787,0.6163194444444444,41.95205479452054,8235.197843701833,114.37774782919213,0
2892,31.560139156977574,2,0,181,0.011049723756906077,0.0,1.0,181,4050,2800,1250,0.691358024691358,53,28,25,226.36625695843748,0.40932704112952734,0.7738263152906546,0.1393347581651009,1050978.3604405322,7331.20751944802,1058309.5679599803,2891,0,1286.1381215469614,71,110,39,36.08518331651533,0.6170774647887324,41.92708333333335,8144.817162647113,114.7157346851706,8
2893,32.009507027739524,0,0,181,0.0,0.0,1.0,181,3600,2500,1100,0.6944444444444444,47,25,22,226.95636438877318,0.40940505422549617,0.7750821978805973,0.1399224413761059,1066420.7852364688,8606.1968651781,1075026.982101647,2892,1,1287.1381215469614,71,110,41,36.010770466689095,0.6176643192488263,41.869212962962976,8262.639241738003,116.3752005878592,0
2894,32.23438711832125,0,0,181,0.0,0.0,1.0,181,4750,3200,1550,0.6736842105263158,63,32,31,231.53264684612233,0.40949713525680376,0.7790788678442999,0.14337677225611667,1075237.4261902887,8840.513454770226,1084077.939645059,2893,2,1288.1381215469614,71,110,43,35.72981431692153,0.6192781690140845,41.710069444444464,8325.817610292137,117.26503676467799,0
2895,31.94372025271193,0,0,181,0.0,0.0,1.0,181,5300,3800,1500,0.7169811320754716,68,38,30,232.34166608890322,0.4098283711888684,0.7804452938091375,0.14432208499383428,1066454.482655826,8056.362261646906,1074510.844917473,2894,3,1289.1381215469614,61,120,40,35.595741222366726,0.6263661202185793,41.59946236559141,8254.274487343924,135.31597520235943,0
2896,31.980442759368763,0,0,181,0.0,0.0,1.0,181,4250,3100,1150,0.7294117647058823,54,31,23,231.44339710145846,0.4102030898301616,0.779791302149323,0.14403419178838356,1068235.9116002386,8997.229657306574,1077233.1412575452,2895,4,1290.1381215469614,61,120,42,35.55019284104697,0.6270491803278688,41.532258064516135,8265.912826111053,135.5067676411648,0
2897,31.62010256879705,1,0,182,0.005494505494505495,0.0,1.0,182,5900,4200,1700,0.711864406779661,76,42,34,225.72981843236101,0.41082116548276765,0.77587775546253,0.1414259150170432,1058161.4341486462,5471.717680500264,1063633.1518291465,2896,0,1284.043956043956,63,119,43,35.45251389325784,0.6281415343915344,41.29231770833334,8180.363449398281,129.8470388793378,0
2898,31.432253403007852,0,0,182,0.0,0.0,1.0,182,4550,3000,1550,0.6593406593406593,61,30,31,224.08810722972862,0.4108123115374496,0.7745629095833424,0.14104160449105024,1053199.039156151,6251.875844134209,1059450.9150002853,2897,1,1285.043956043956,63,119,44,35.328578539243416,0.6297949735449735,41.12955729166667,8136.881353757174,129.1568468850345,0
2899,31.36286677459398,2,2,182,0.010869565217391304,0.010869565217391304,0.9891304347826086,184,4200,3400,800,0.8095238095238095,50,34,16,217.19850004827867,0.41242290825215805,0.7692089879430042,0.13727340708665878,1052067.6827768544,4701.5045296802655,1056769.1873065347,2898,0,1272.0652173913043,66,118,40,35.35676770708284,0.6294191919191919,40.98258706467662,8123.528614190549,123.08376688167499,0
2900,31.58130514871413,0,0,182,0.0,0.0,1.0,182,4950,3800,1150,0.7676767676767676,61,38,23,221.39522764219114,0.4113239430918989,0.770266570170302,0.14017993276921709,1059920.0996190812,5582.250347540232,1065502.3499666215,2899,1,1285.3406593406594,70,112,40,35.182484851916904,0.6278273809523809,40.91842723004696,8182.134208056694,116.88763154366706,0
2901,31.36897898063267,1,0,183,0.00546448087431694,0.0,1.0,183,6000,4600,1400,0.7666666666666667,74,46,28,227.22643164019985,0.4121254428631478,0.7744835179779617,0.14465807749286066,1054356.3264343822,5315.525146590976,1059671.8515809732,2900,0,1279.311475409836,71,112,42,34.834888771087925,0.6292546948356808,40.72627314814815,8133.152087846047,114.55143785698658,0
2902,31.39570639781438,1,0,184,0.005434782608695652,0.0,1.0,184,5050,3400,1650,0.6732673267326733,67,34,33,226.17797514582506,0.4127526827433278,0.775325050721001,0.1449429917895914,1057139.7925629695,5970.347545594055,1063110.1401085635,2901,0,1273.3532608695652,63,121,42,34.625355410603746,0.6362433862433863,40.494791666666664,8147.349329536985,129.3230052307458,0
2903,30.94823591157595,3,1,186,0.016042780748663103,0.0053475935828877,0.9946524064171123,187,4550,3100,1450,0.6813186813186813,60,31,29,205.0837113680793,0.41481585302742796,0.7612767780992948,0.13003569980984922,1039073.5725915883,669.4129303142154,1039742.9855219024,2902,0,1253.909090909091,76,111,39,35.554141651440005,0.6254111842105263,40.86850649350648,8019.662593157942,105.5218762257624,8
2904,31.057615443945597,0,0,186,0.0,0.0,1.0,186,5600,4400,1200,0.7857142857142857,68,44,24,199.0003121321431,0.413902814104427,0.7525561461173302,0.12672507884513498,1043972.5028927795,-1249.8292133923746,1042722.6736793872,2903,1,1261.5913978494623,79,107,40,35.55638904233412,0.6256592827004219,40.716145833333336,8052.738233532412,101.93339536116977,0
2905,31.455927149651163,0,0,186,0.0,0.0,1.0,186,4200,3000,1200,0.7142857142857143,54,30,24,198.54518475508468,0.41371936452581615,0.7521915619467117,0.12676346411286163,1058104.8932321607,616.3263034076649,1058721.2195355683,2904,2,1262.5913978494623,69,117,40,35.475234270414994,0.6313405797101449,40.62499999999999,8158.881104440758,118.24465368754721,0
2906,31.358805833914563,1,1,186,0.0053475935828877,0.0053475935828877,0.9946524064171123,187,5800,4200,1600,0.7241379310344828,74,42,32,198.83422014583323,0.4143115212849558,0.7523637445145728,0.12793449327346434,1057044.3042301484,-1164.6840217608237,1055879.6202083877,2905,0,1256.8342245989304,72,115,40,35.1912279255514,0.6325231481481481,40.3538812785388,8142.192222515805,113.08600309049729,0
2907,31.80018904919182,0,0,186,0.0,0.0,1.0,186,5400,3700,1700,0.6851851851851852,71,37,34,197.04709104577557,0.4138235009202751,0.7492778367005539,0.12731488214201114,1073124.5697307852,-308.7850409599673,1072815.7846898253,2906,1,1264.5537634408602,74,112,39,35.08921411387327,0.6330236486486487,40.20833333333332,8261.4241134046,111.64086639735947,0
2908,31.71701133255519,0,0,186,0.0,0.0,1.0,186,6000,4200,1800,0.7,78,42,36,199.24798720839138,0.4139112903225806,0.7527193474699736,0.12953167639969745,1072080.1941691444,-478.03583716348794,1071602.158331981,2907,2,1265.5537634408602,75,111,37,34.8139606396064,0.6347222222222222,39.99451754385964,8246.596833587852,109.95462444783801,0
2909,32.08092648208778,0,0,186,0.0,0.0,1.0,186,5450,3900,1550,0.7155963302752294,70,39,31,204.18602582654432,0.413529860505667,0.7609517739910885,0.12516897126864446,1067097.651287248,927.2857170366642,1068024.9370042845,2908,3,1266.5537634408602,73,113,36,36.80841701686408,0.6145833333333333,42.0748873873874,8274.476575609462,113.34899418643099,8
2910,31.865573268750055,0,0,186,0.0,0.0,1.0,186,5150,3600,1550,0.6990291262135923,67,36,31,203.27845224352495,0.4136679017727405,0.7604757747708424,0.124855478308289,1060512.9768903013,765.887305286954,1061278.8641955883,2909,4,1267.5537634408602,73,113,39,36.76001200349194,0.615296803652968,42.004504504504524,8221.174364719229,112.61882691396204,0
2911,32.265514243791586,1,0,187,0.0053475935828877,0.0,1.0,187,5650,4100,1550,0.7256637168141593,72,41,31,197.25824067683655,0.41421448833687924,0.7543087615032291,0.12183445042197583,1075495.3327435944,-619.9365613696709,1074875.3961822249,2910,0,1261.7700534759358,75,112,40,36.71059383515587,0.6163888888888889,41.80372807017545,8330.835489645679,111.07780652860905,0
2912,32.63217526010623,2,0,189,0.010582010582010581,0.0,1.0,189,4300,2700,1600,0.627906976744186,59,27,32,196.57690852647482,0.4154834609178581,0.7544235153387489,0.12212730475755895,1089490.7210964642,733.7435642844994,1090224.4646607486,2911,0,1249.4074074074074,70,119,42,36.51363103011036,0.6209821428571429,41.59330985915493,8432.372401060013,120.4624628722859,0
2913,32.5397000163385,0,0,189,0.0,0.0,1.0,189,6100,4900,1200,0.8032786885245902,73,49,24,193.56420076070316,0.41540723854553646,0.75104563303321,0.12073947056874441,1087611.522236658,-1795.4689920259075,1085816.0532446322,2912,1,1250.4074074074074,71,118,40,36.445043646130614,0.621919014084507,41.44965277777778,8413.150737731274,118.49508081311653,0
2914,32.50319910970297,1,0,190,0.005263157894736842,0.0,1.0,190,5350,3300,2050,0.616822429906542,74,33,41,193.23054829237824,0.4156397939292676,0.7525146324376839,0.12130295066656333,1088303.6126050293,-1291.2992455507942,1087012.3133594785,2913,0,1244.821052631579,74,116,46,36.22184503363386,0.6227477477477478,41.22222222222223,8411.105636277598,113.663589679427,0
2915,32.37279180655621,0,0,190,0.0,0.0,1.0,190,6100,4000,2100,0.6557377049180327,82,40,42,188.35605018197532,0.4158306646245243,0.7459997635030149,0.11870090366917473,1085087.4163714666,-3223.4440300211118,1081863.9723414455,2914,1,1245.821052631579,76,114,45,36.20813522127595,0.6232182017543859,41.08495670995672,8381.802792014088,110.28687884229063,0
2916,32.48305569366719,0,0,190,0.0,0.0,1.0,190,4800,2900,1900,0.6041666666666666,67,29,38,187.1120081352539,0.41594147405550913,0.7442859860817448,0.1181313709991815,1089324.881858237,-2034.8467687612533,1087290.0350894758,2915,2,1246.821052631579,78,112,39,36.17475349184529,0.6229967948717949,41.02056962025318,8412.443260539556,107.85183667358405,0
2917,32.01443872083164,1,0,191,0.005235602094240838,0.0,1.0,191,5750,4400,1350,0.7652173913043478,71,44,27,189.3052252279567,0.41654611003949665,0.747262357681183,0.12007206778623108,1074970.629813251,-3250.4885619527636,1071720.1412512984,2916,0,1241.2879581151833,80,111,41,35.950759267530174,0.623828125,40.85648148148149,8296.334293511825,103.70417866889781,0
2918,31.768254102026596,1,0,192,0.005208333333333333,0.0,1.0,192,5050,3700,1350,0.7326732673267327,64,37,27,185.66000887907813,0.41736826916084935,0.7431005151104437,0.11819877113814771,1067783.7139298131,-3801.0532381709622,1063982.6606916422,2917,0,1235.8177083333333,82,110,44,35.91170918243867,0.624364837398374,40.72540160642572,8236.701323968007,100.44757712156107,0
2919,31.46694565291864,1,1,192,0.0051813471502590676,0.0051813471502590676,0.9948186528497409,193,5450,4000,1450,0.7339449541284404,69,40,29,184.81733426736793,0.41775510938399535,0.7437087876257418,0.1179580798410482,1058376.6743230214,-4928.728880171184,1053447.9454428502,2918,0,1230.4093264248704,85,108,45,35.84363665374619,0.6241421568627451,40.63711240310079,8161.357888395708,96.01597515759656,0
2920,31.416733841939745,0,0,192,0.0,0.0,1.0,192,4600,2900,1700,0.6304347826086957,63,29,34,189.41782561345912,0.416832551628854,0.7487328412238163,0.12118551076440026,1057376.0643559897,-2942.8250067945824,1054433.239349195,2919,1,1237.78125,71,121,44,35.6382669752226,0.6310152582159625,40.55266203703701,8150.987962782133,114.80264736312863,0
2921,31.714878189613444,0,0,192,0.0,0.0,1.0,192,4450,3100,1350,0.6966292134831461,58,31,27,187.35232218382941,0.41677006071844097,0.7460922466875592,0.12020287083603692,1068224.4439778188,-2823.133961445472,1065401.3100163734,2920,2,1238.78125,72,120,44,35.591108178935976,0.6315104166666667,40.45376712328764,8231.477160257908,114.32607167024872,0
2922,31.73186133749477,0,1,191,0.0,0.005208333333333333,0.9947916666666666,192,5250,3700,1550,0.7047619047619048,68,37,31,186.84125006091676,0.4167814227021524,0.745817392260335,0.12051197034221728,1070321.6990394974,-3653.9511568276,1066667.7478826698,2921,3,1239.78125,75,117,44,35.41578715919084,0.6319444444444444,40.26864035087716,8241.759489384878,109.8901265251317,0
2923,31.516063048644057,0,0,191,0.0,0.0,1.0,191,5100,4000,1100,0.7843137254901961,62,40,22,187.1019174272526,0.4162384036006246,0.7441413586002297,0.12122875714960933,1064335.5415301176,-3472.1558787487434,1060863.3856513689,2922,4,1246.7486910994764,78,113,47,35.248181971926286,0.6322115384615384,40.110759493670855,8190.685689461605,105.00879089053339,0
2924,31.093642335137304,0,0,191,0.0,0.0,1.0,191,6050,5000,1050,0.8264462809917356,71,50,21,187.09634600842068,0.4160960319647286,0.7445256154992055,0.12154047978490375,1050798.7729211773,-4929.877839263394,1045868.8950819139,2923,5,1247.7486910994764,80,111,37,35.156456107373664,0.6322916666666667,40.020576131687214,8083.707220256307,101.04634025320384,0
2925,30.980692334151673,0,0,191,0.0,0.0,1.0,191,5150,3600,1550,0.6990291262135923,67,36,31,188.17711916421092,0.4158916597777165,0.7453698353744214,0.12278044879339421,1048206.4828833551,-3900.3047523524297,1044306.1781310027,2924,6,1248.7486910994764,83,108,39,34.97347293067006,0.6326556224899598,39.86855158730156,8059.052369710993,97.09701650254209,0
2926,30.72656111452754,2,0,193,0.010362694300518135,0.0,1.0,193,5500,3900,1600,0.7090909090909091,71,39,32,187.20137200291387,0.41740653785261944,0.7485321976821202,0.12320996178958489,1042003.3264550435,-5087.10953120305,1036916.2169238405,2925,0,1236.7979274611398,72,121,40,34.69376107245266,0.6404803240740741,39.56906392694065,8002.147073362496,111.14093157447911,0
2927,31.274165484887074,1,0,194,0.005154639175257732,0.0,1.0,194,5050,3200,1850,0.6336633663366337,69,32,37,182.60182765415513,0.41766098231932053,0.7428663382553296,0.1207812088941342,1061961.5090955258,-5066.777508158371,1056894.7315873674,2926,0,1231.4175257731958,78,116,44,34.640107434392476,0.6394230769230769,39.398734177215196,8150.087112912839,104.48829631939537,0
2928,30.997659406532264,0,2,192,0.0,0.010309278350515464,0.9896907216494846,194,5500,3900,1600,0.7090909090909091,71,39,32,185.557100512221,0.41754858625785657,0.746230633092984,0.12305527357917118,1053290.0887792124,-5210.909025573901,1048079.1797536386,2927,1,1232.4175257731958,79,115,46,34.4726058471938,0.6398997890295359,39.309895833333336,8080.783059611758,102.28839315964251,0
2929,30.858256496042678,0,0,192,0.0,0.0,1.0,192,5350,4100,1250,0.7663551401869159,66,41,25,193.843134233172,0.41667121146015124,0.7534685766111824,0.12877806042540632,1049039.406704057,-3080.1826940755473,1045959.2240099815,2928,2,1246.15625,77,115,44,34.19499573196757,0.6413690476190477,39.24946581196582,8046.306865454524,104.49749175914967,0
2930,30.842102810849134,0,0,192,0.0,0.0,1.0,192,4800,3500,1300,0.7291666666666666,61,35,26,196.85632948220587,0.4166047438554392,0.7562367303609334,0.1311182461217847,1049198.669688784,-1891.7201974904092,1047306.9494912936,2929,3,1247.15625,78,114,45,34.0266193172244,0.6418269230769231,39.161392405063296,8044.811152481789,103.1386045189973,0
2931,30.46017523183238,0,1,191,0.0,0.005208333333333333,0.9947916666666666,192,5000,3600,1400,0.72,64,36,28,197.40301727141176,0.4167376790648633,0.7587141764051188,0.12824773030973546,1029416.4335798781,-2758.0179965110765,1026658.415583367,2930,4,1248.15625,71,121,41,34.88522537562603,0.636443661971831,40.01736111111112,7919.116737789781,111.5368554618279,8
2932,30.882722083532492,0,0,191,0.0,0.0,1.0,191,5950,4200,1750,0.7058823529411765,77,42,35,196.52518350077426,0.4163991457701846,0.7566290960679969,0.1280680915147881,1044546.5003993143,-3094.061466786472,1041452.4389325279,2931,5,1255.1675392670156,72,119,43,34.80013624476508,0.6370081018518519,39.911529680365305,8032.239946012394,111.55888813906103,0
2933,31.213602446686117,0,0,191,0.0,0.0,1.0,191,5450,3800,1650,0.6972477064220184,71,38,33,197.21346521162758,0.4165575916230366,0.7583362101387812,0.12912721646339248,1057067.4366993427,-1956.4135692300233,1055111.0231301126,2932,6,1256.1675392670156,75,116,44,34.61528333684431,0.6372222222222222,39.747807017543856,8123.408487632613,108.31211316843485,0
2934,31.699523796306057,0,0,191,0.0,0.0,1.0,191,5700,3900,1800,0.6842105263157895,75,39,36,219.79695334316816,0.4164175163038486,0.780988792109663,0.14290283439639803,1071513.5158865433,3203.081251577868,1074716.5971381213,2933,7,1257.1675392670156,73,118,34,34.27664762781298,0.6357020547945205,39.99155405405406,8242.143919504091,112.90608108909714,8
2935,32.03534588410026,0,0,191,0.0,0.0,1.0,191,4750,3400,1350,0.7157894736842105,61,34,27,220.65337168869135,0.4163314044272986,0.7824214128332463,0.1436930222752407,1083334.0918497527,4858.264006390963,1088192.3558561436,2934,8,1258.1675392670156,73,118,37,34.19683130356335,0.6362728310502284,39.93524774774775,8331.264290663756,114.12690809128432,0
2936,31.827767554378035,0,0,191,0.0,0.0,1.0,191,5050,3200,1850,0.6336633663366337,69,32,37,223.10057691402764,0.41597317902085057,0.782691340688205,0.14568581306056594,1077099.9389977648,4810.323556893019,1081910.2625546579,2935,9,1259.1675392670156,76,115,38,34.0361915657012,0.635827850877193,39.84036796536797,8280.300295430792,108.95131967672096,0
2937,31.995840237523655,1,0,192,0.005208333333333333,0.0,1.0,192,5200,3700,1500,0.7115384615384616,67,37,30,222.4866770251985,0.41684561791012215,0.7831533376929776,0.14620231688440513,1084594.5950284302,4661.569473473373,1089256.1645019036,2936,0,1253.6041666666667,77,115,40,33.830364927937644,0.6375811688311688,39.62339743589744,8330.968177230227,108.19439191208086,0
2938,31.69713433884268,0,1,191,0.0,0.005208333333333333,0.9947916666666666,192,5800,3900,1900,0.6724137931034483,77,39,38,220.53952248439552,0.4168245982402559,0.7810374524677557,0.14548080369936509,1075558.5644206833,3240.6344402679038,1078799.1988609512,2937,1,1254.6041666666667,67,125,39,33.74617781959305,0.6439676616915423,39.49142156862745,8257.375406960156,123.24440905910681,0
2939,31.569483769499556,0,0,191,0.0,0.0,1.0,191,4950,3300,1650,0.6666666666666666,66,33,33,224.93082643658886,0.41638881234499864,0.7837635405889947,0.1489094584043628,1072235.174450077,5085.748784687169,1077320.923234764,2938,2,1248.502617801047,67,124,41,33.506475059754706,0.6452114427860697,39.368872549019606,8227.990147890094,122.80582310283722,0
2940,31.734056389738097,0,0,191,0.0,0.0,1.0,191,4750,3200,1550,0.6736842105263158,63,32,31,223.26384285758667,0.41656562873151465,0.7832401677902507,0.1483371246339517,1078838.593913457,5223.1300600387785,1084061.7239734957,2939,3,1249.502617801047,67,124,38,33.42463674460501,0.646455223880597,39.24632352941177,8274.771872949179,123.50405780521163,0
2941,31.467907107661745,0,1,190,0.0,0.005235602094240838,0.9947643979057592,191,6400,5000,1400,0.78125,78,50,28,223.52747681287775,0.4163417378524846,0.7847242162737149,0.14904749139088944,1070796.3157199707,3270.4797266822534,1074066.795446653,2940,4,1250.502617801047,67,124,41,33.29247406537484,0.6476990049751243,39.12377450980393,8209.228830322923,122.52580343765557,0
2942,31.319059783009404,0,0,190,0.0,0.0,1.0,190,4400,2800,1600,0.6363636363636364,60,28,32,205.8557535627336,0.415519121878771,0.7608677382077929,0.13751164337990696,1066232.0047465274,1497.9985619604045,1067730.0033084878,2941,5,1258.0052631578947,79,111,39,33.690951430472396,0.6424050632911392,39.06250000000002,8172.317162129073,103.44705268517814,8
2943,31.124962590820257,0,1,189,0.0,0.005263157894736842,0.9947368421052631,190,4900,3800,1100,0.7755102040816326,60,38,22,207.91111737478357,0.4156867864104706,0.7634437048779792,0.13940559129426391,1060656.0904990968,1204.4385852075002,1061860.5290843043,2942,6,1259.0052631578947,81,109,37,33.507645613352146,0.6428755144032922,38.935467479674806,8125.623808485125,100.31634331463117,0
2944,31.34609601299612,0,0,189,0.0,0.0,1.0,189,5100,3600,1500,0.7058823529411765,66,36,30,206.59741864144524,0.4149557675710158,0.7617552826797047,0.13911071090858643,1069360.6067465076,1285.4281901357099,1070646.0349366432,2943,17,1266.6349206349207,82,107,39,33.39619468601355,0.6439278455284553,38.79267068273093,8187.830024077426,99.8515856594808,0
2945,31.33910212033034,0,0,189,0.0,0.0,1.0,189,5750,3800,1950,0.6608695652173913,77,38,39,205.92866773519998,0.41443393748358287,0.7598839692672752,0.13915167498416273,1070098.8179482522,522.8047850188968,1070621.622733271,2944,18,1267.6349206349207,86,103,41,33.29190720547358,0.6436531007751938,38.67337164750956,8189.741892700267,95.22955689186357,0
2946,30.90108252869887,0,0,189,0.0,0.0,1.0,189,5200,3600,1600,0.6923076923076923,68,36,32,209.8793265902604,0.41418181732898046,0.7636236489612813,0.14223680533153635,1055937.5309650907,1323.891584066539,1057261.4225491572,2945,19,1268.6349206349207,93,96,41,33.08813919149957,0.6423611111111112,38.5749113475177,8078.3182395226795,86.86363698411483,0
2947,31.27180527169748,0,0,189,0.0,0.0,1.0,189,6000,4400,1600,0.7333333333333333,76,44,32,226.46518788810735,0.4142674209163571,0.778338384712441,0.1420669900167946,1046871.5258343132,3615.9913585556687,1050487.517192869,2946,20,1269.6349206349207,71,118,33,35.387254216755196,0.6239730046948357,41.247106481481495,8091.670099599412,113.96718450140017,8
2948,31.105886834162778,0,0,189,0.0,0.0,1.0,189,4800,3300,1500,0.6875,63,33,30,221.92799713894019,0.41392148861120487,0.7747610621038952,0.1397888598662916,1042481.9364862193,3671.1856435822056,1046153.1221298015,2947,21,1270.6349206349207,71,118,40,35.35676865046102,0.6254401408450705,41.102430555555564,8053.238496778707,113.42589432082686,0
2949,31.39282950352153,0,0,189,0.0,0.0,1.0,189,5200,4000,1200,0.7692307692307693,64,40,24,231.45433633669302,0.41410090434913127,0.7826538251167867,0.1465823643134057,1053659.935097548,5774.832200513254,1059434.7672980612,2948,22,1271.6349206349207,72,117,32,34.91364671109396,0.626880787037037,40.910388127853885,8133.556011635861,112.96605571716474,0
2950,31.358773930870186,0,0,189,0.0,0.0,1.0,189,4900,3400,1500,0.6938775510204082,64,34,30,230.6393531443678,0.4142580397013021,0.7833653333846029,0.14642092174628282,1053212.6292119238,5882.455904983411,1059095.0851169073,2949,23,1272.6349206349207,72,117,36,34.847170988639895,0.6277488425925926,40.824771689497716,8127.417393070706,112.88079712598203,0
2951,31.874452453324793,0,0,189,0.0,0.0,1.0,189,4750,3200,1550,0.6736842105263158,63,32,31,230.3255905647268,0.4141208394311231,0.7833443031128668,0.1465322928930197,1071149.939383734,6792.648474386106,1077942.5878581202,2950,24,1273.6349206349207,74,115,38,34.778809064609455,0.6275337837837838,40.75000000000001,8263.451798524467,111.66826754762793,0
2952,31.801054178835983,2,0,191,0.010471204188481676,0.0,1.0,191,5550,4300,1250,0.7747747747747747,68,43,25,226.0032342419592,0.41510057867181044,0.7813553461179314,0.1445428202623023,1070212.3207581665,4624.28916338766,1074836.609921554,2951,0,1261.2879581151833,68,123,40,34.701289884589286,0.6325061274509804,40.56461352657004,8250.318781148786,121.32821736983509,0
2953,31.71593890356529,0,0,191,0.0,0.0,1.0,191,4650,3200,1450,0.6881720430107527,61,32,29,228.15061749666924,0.41520965371544044,0.7826821254266221,0.14664457597542901,1068783.024641786,5918.7014083962595,1074701.7260501822,2952,1,1262.2879581151833,70,121,40,34.46724592634456,0.6331845238095238,40.39025821596244,8233.766709192894,117.62523870275564,0
2954,31.517427260666928,0,0,191,0.0,0.0,1.0,191,5850,4100,1750,0.7008547008547008,76,41,35,226.74761845035394,0.4152980619086985,0.7811491491818481,0.14615247751534263,1062895.5735478543,4151.807992679657,1067047.381540534,2953,2,1263.2879581151833,71,120,38,34.40343388483464,0.633656103286385,40.29224537037036,8185.320265570463,115.28620092352764,0
2955,31.098936595131843,2,1,192,0.010362694300518135,0.0051813471502590676,0.9948186528497409,193,5600,4200,1400,0.75,70,42,28,223.42949382420264,0.4165227403569372,0.7811860851312258,0.145080014014503,1050855.9341026018,2758.4418877405606,1053614.3759903423,2954,0,1251.1865284974094,75,118,37,34.22726533804328,0.6343055555555556,40.03563596491227,8084.615274120928,107.79487032161238,0
2956,31.164600500068218,1,0,193,0.0051813471502590676,0.0,1.0,193,4700,3200,1500,0.6808510638297872,62,32,30,221.69300945987683,0.4162056527058146,0.7802181838306002,0.14438962094386715,1053926.2662241214,3429.617141607172,1057355.8833657287,2955,0,1252.1813471502592,77,116,38,34.16499777481086,0.634469696969697,39.93055555555554,8104.9603383857675,105.25922517384113,0
2957,31.0321994101023,0,1,192,0.0,0.0051813471502590676,0.9948186528497409,193,5750,4200,1550,0.7304347826086957,73,42,31,216.73596115851927,0.41616517343120324,0.7745213854450581,0.1416871955450823,1050486.8514933682,1185.655488560099,1051672.5069819284,2956,1,1253.1813471502592,80,113,38,34.16252738924857,0.6345052083333333,39.80195473251027,8074.517626859516,100.93147033574395,0
2958,31.296124280007387,0,2,190,0.0,0.010416666666666666,0.9895833333333334,192,5700,4000,1700,0.7017543859649122,74,40,34,216.3304185643944,0.4155156977166958,0.774127716639827,0.14185045141769548,1060270.5481072236,1773.754292706849,1062044.3023999305,2957,2,1260.1145833333333,81,111,39,34.066531241358,0.6351594650205761,39.697662601626,8146.454301595885,100.5735098962455,0
2959,31.627390698393324,0,0,190,0.0,0.0,1.0,190,4200,2900,1300,0.6904761904761905,55,29,26,218.62597609883767,0.4150990903183886,0.7738721621108102,0.1437265958330326,1072225.606324673,4683.2739561797935,1076908.8802808528,2958,3,1271.3736842105263,81,109,41,33.91591049533286,0.6360596707818931,39.60873983739836,8235.496119609548,101.67279160011788,0
2960,32.13738234302834,0,0,190,0.0,0.0,1.0,190,6050,4700,1350,0.7768595041322314,74,47,27,217.8672443567459,0.4148264178965933,0.7732881137921608,0.14414465623043782,1091347.488256461,3503.7739804181692,1094851.2622368792,2959,4,1272.3736842105263,69,121,38,33.71204010354215,0.6438707729468599,39.38988095238095,8375.327038295458,121.38155127964431,0
2961,32.06698390009027,0,0,190,0.0,0.0,1.0,190,4450,2900,1550,0.651685393258427,60,29,31,220.3300928948945,0.4145873944119558,0.7762276145297891,0.14615535393508713,1089703.1272008508,5568.878248804013,1095272.0054496548,2960,5,1273.3736842105263,69,121,44,33.55660283121185,0.6447765700483092,39.300595238095234,8359.843615263106,121.15715384439284,0
2962,31.81248930423153,0,0,190,0.0,0.0,1.0,190,6000,3800,2200,0.6333333333333333,82,38,44,219.00527276609586,0.4144556994337696,0.774573034528069,0.14561305944702627,1081709.753986317,3380.0279451040205,1085089.781931421,2961,6,1274.3736842105263,71,119,41,33.51046000924645,0.644512910798122,39.221643518518526,8296.008676342217,116.84519262453827,0
2963,31.511828365046867,0,1,189,0.0,0.005263157894736842,0.9947368421052631,190,5250,3700,1550,0.7047619047619048,68,37,31,219.56087824351283,0.41424510349948945,0.7740203802920473,0.14666666666666675,1072794.6548740156,3858.7473198170846,1076653.4021938327,2962,7,1275.3736842105263,71,119,41,33.33333333333334,0.6461267605633803,39.06250000000001,8222.617714004431,115.81151709865397,0
2964,31.376818588410153,1,0,190,0.005263157894736842,0.0,1.0,190,5150,3800,1350,0.7378640776699029,65,38,27,217.45735215530482,0.41441334818527803,0.7712563531734347,0.14570805467946454,1069051.3796695222,3344.6164681823484,1072395.9961377045,2963,0,1275.3736842105263,74,116,35,33.281790369779216,0.6456925675675675,38.95833333333336,8190.657019016293,110.68455431103098,0
2965,30.93506733269694,0,0,190,0.0,0.0,1.0,190,6150,4600,1550,0.7479674796747967,77,46,31,217.515990142466,0.41418708809059684,0.7721364698638375,0.1463466259259067,1055122.1801797545,1751.1891486156192,1056873.36932837,2964,1,1276.3736842105263,74,116,37,33.13834972968184,0.6471002252252251,38.819444444444464,8079.638072102348,109.18429827165335,0
2966,30.97455932647107,1,0,191,0.005235602094240838,0.0,1.0,191,5350,4000,1350,0.7476635514018691,67,40,27,221.9235013603249,0.41403853219436026,0.7780784178678608,0.15031786111800488,1058301.0115632988,3422.3731958602466,1061723.384759159,2965,0,1270.6858638743456,80,111,39,32.791873698365066,0.6467447916666667,38.593106995884774,8096.963315704444,101.21204144630555,0
2967,31.180864278978962,0,0,191,0.0,0.0,1.0,191,4850,3100,1750,0.6391752577319587,66,31,35,223.012333137569,0.4143037567741343,0.779541519784736,0.15128674491224298,1065769.1137369552,4485.931328087589,1070255.0450650428,2966,1,1271.6858638743456,81,110,40,32.710823373173994,0.6468621399176955,38.54166666666667,8152.496806274718,100.64810871944097,0
2968,30.816371968005612,0,0,191,0.0,0.0,1.0,191,5800,4100,1700,0.7068965517241379,75,41,34,216.82213908160162,0.4140408285110682,0.7754919960316784,0.1438115934804401,1047172.7279851761,1410.046173932551,1048582.7741591088,2967,2,1272.6858638743456,70,121,38,33.652123548502075,0.6441964285714286,39.30457746478874,8033.687111201487,114.76695873144982,8
2969,30.90966369353265,0,0,191,0.0,0.0,1.0,191,5500,4500,1000,0.8181818181818182,65,45,20,213.4216459911921,0.4142360154312483,0.7704145427094562,0.14216406527330738,1051520.7617765272,1183.4583544519114,1052704.220130979,2968,3,1273.6858638743456,75,116,42,33.591519538297156,0.6431944444444444,39.15844298245615,8062.524804709728,107.50033072946304,0
2970,31.354075800361073,2,1,192,0.010362694300518135,0.0051813471502590676,0.9948186528497409,193,5650,4200,1450,0.7433628318584071,71,42,29,210.22625140326045,0.4155534866148532,0.7699055652566655,0.14092945001477838,1068407.6710036832,671.4679291184921,1069079.1389328018,2969,0,1261.4766839378237,77,116,38,33.45418968692449,0.6444805194805194,38.94230769230769,8185.22267288273,106.30159315432117,0
2971,31.21665324203226,0,1,191,0.0,0.005208333333333333,0.9947916666666666,192,5000,3300,1700,0.66,67,33,34,207.970242524134,0.414972594895288,0.7665273693854942,0.13980261576347364,1064486.8815445707,876.3189837168002,1065363.2005282876,2970,1,1269.046875,77,115,42,33.417657461859704,0.6454274891774892,38.84882478632479,8152.265680394523,105.87358026486393,0
2972,31.733341143296535,0,0,191,0.0,0.0,1.0,191,5400,4100,1300,0.7592592592592593,67,41,26,205.86048102539849,0.41467231560576834,0.7639091443442283,0.13886298829942215,1083072.5031138002,992.3652952779498,1084064.868409078,2971,2,1267.0785340314137,81,110,42,33.353744266705576,0.6449331275720165,38.73221544715448,8290.899736968771,102.35678687615767,0
2973,31.291468992694767,0,0,191,0.0,0.0,1.0,191,4000,2500,1500,0.625,55,25,30,204.31790056754105,0.4145035363277303,0.7626857038007684,0.13813447809319845,1068614.4375746027,1467.411680281325,1070081.849254884,2972,3,1268.0785340314137,81,110,43,33.31627011131095,0.645704732510288,38.65599593495936,8177.837799627932,100.96096048923373,0
2974,31.768224717962553,0,0,191,0.0,0.0,1.0,191,5600,4500,1100,0.8035714285714286,67,45,22,203.10355400961427,0.4144415357766143,0.7619630835129354,0.13808253065504905,1086454.6206951654,332.5589466711158,1086787.1796418366,2973,4,1269.0785340314137,70,121,39,33.156508283780255,0.6526785714285714,38.468309859154935,8308.397503262928,118.69139290375611,0
2975,32.089023306531345,1,0,192,0.005208333333333333,0.0,1.0,192,5250,3500,1750,0.6666666666666666,70,35,35,200.1811435860119,0.4146828643106457,0.7596718073888229,0.13643572812289773,1098127.5080027068,314.8840710479926,1098442.3920737547,2974,0,1263.4635416666667,72,120,45,33.14765826697213,0.6524884259259259,38.38470319634704,8394.97935647755,116.59693550663263,0
2976,31.845940803153447,1,0,193,0.0051813471502590676,0.0,1.0,193,5500,3600,1900,0.6545454545454545,74,36,38,198.31270519224918,0.4151846754461716,0.7572056845554953,0.13587772374295573,1091278.8137448088,-817.1092654555587,1090461.7044793533,2975,0,1257.9119170984457,74,119,45,33.01667197198792,0.6532939189189189,38.20833333333334,8337.001919425566,112.66218810034547,0
2977,32.00449226897535,0,0,193,0.0,0.0,1.0,193,5900,4300,1600,0.7288135593220338,75,43,32,200.9231593890583,0.41503850028785266,0.7584775390458194,0.13827304642003227,1097938.768648306,-379.7347574899859,1097559.033890816,2976,1,1258.9119170984457,75,118,45,32.799009732614714,0.6543055555555555,38.061951754385966,8383.194240027251,111.77592320036335,0
2978,31.718041160064228,0,0,193,0.0,0.0,1.0,193,5650,4100,1550,0.7256637168141593,72,41,31,203.429825779477,0.4148619656735751,0.7603243089976739,0.14042892820201272,1088959.3989422177,55.36416154793824,1089014.7631037657,2977,2,1259.9119170984457,76,117,43,32.62928067458268,0.6548793859649122,37.959956709956714,8311.39687865862,109.36048524550814,0
2979,32.03049353927782,0,2,191,0.0,0.010362694300518135,0.9896373056994818,193,4850,3200,1650,0.6597938144329897,65,32,33,203.4055500386807,0.414801246761658,0.7613684922044897,0.14094791220647138,1100745.2232601866,1329.5375179376274,1102074.7607781242,2978,3,1260.9119170984457,77,116,38,32.50126288353456,0.6557088744588744,37.833867521367516,8397.310612574272,109.05598198148405,0
2980,32.04593565755591,0,0,191,0.0,0.0,1.0,191,5700,4500,1200,0.7894736842105263,69,45,24,204.1104013818579,0.41478942775787636,0.761584831746942,0.14225598330830336,1102878.1035833496,1121.7784795319067,1103999.8820628815,2979,4,1252.0890052356021,79,112,43,32.2882545866627,0.6567774261603376,37.643229166666664,8407.46819744913,106.42364806897633,0
2981,32.42121682837537,0,2,189,0.0,0.010471204188481676,0.9895287958115183,191,4600,2900,1700,0.6304347826086957,63,29,34,203.5916404348651,0.4146229447965463,0.7606939580239525,0.14229375140001074,1116579.8302622926,2665.2638639167208,1119245.0941262094,2980,5,1253.0890052356021,81,110,44,32.207566957082925,0.6568930041152263,37.550813008130085,8508.921997894258,105.04841972708961,0
2982,32.29938315846133,0,0,189,0.0,0.0,1.0,189,5200,4100,1100,0.7884615384615384,63,41,22,204.47633579663238,0.4138182952456002,0.7603933068828719,0.14333123562431385,1113198.7125324614,2524.5587504331256,1115723.2712828945,2981,12,1267.2910052910054,68,121,47,32.086280259904555,0.6640625,37.45471014492753,8480.050913478262,124.70663108056269,0
2983,31.831506930971646,0,0,189,0.0,0.0,1.0,189,5700,4400,1300,0.7719298245614035,70,44,26,202.93768948455235,0.41371275657623174,0.7589668351868737,0.1426467468267778,1097830.4759588318,1058.2360473622707,1098888.712006194,2982,13,1268.2910052910054,68,121,46,32.03425878024946,0.6649816176470589,37.3641304347826,8360.095502386966,122.94258091745539,0
2984,31.386056179016858,0,0,189,0.0,0.0,1.0,189,5550,3900,1650,0.7027027027027027,72,39,33,202.73292575623086,0.41320734361514505,0.7599953683026492,0.14319212011615154,1083766.5678809385,593.0334286582051,1084359.6013095968,2983,14,1269.2910052910054,70,119,49,31.878884732767602,0.6654761904761906,37.20657276995305,8248.04927051862,117.82927529312315,0
2985,31.579686095767148,0,1,188,0.0,0.005291005291005291,0.9947089947089947,189,5600,3700,1900,0.6607142857142857,75,37,38,205.48771881610242,0.4132495590828924,0.7637891657262112,0.14563661569135014,1091379.5465714794,1453.0186775051575,1092832.5652489846,2984,15,1270.2910052910054,71,118,42,31.692530633208587,0.6660798122065728,37.09490740740741,8302.46029705268,116.93606052186873,0
2986,31.286053306098502,0,0,188,0.0,0.0,1.0,188,4350,2900,1450,0.6666666666666666,58,29,29,205.59195994994516,0.4130767152121971,0.7618619043766675,0.14613698774820458,1082012.510564766,2540.6145474742534,1084553.1251122402,2985,16,1277.6063829787233,74,114,49,31.592931453316417,0.6655405405405406,37.00000000000001,8228.232019503923,111.19232458789085,0
2987,30.847298167896195,0,0,188,0.0,0.0,1.0,188,4650,3400,1250,0.7311827956989247,59,34,25,207.7639103906115,0.4128936027989532,0.7622690344022796,0.14833987785754382,1068008.4830799531,2128.7237550073287,1070137.2068349605,2986,17,1278.6063829787233,75,113,39,31.388624841571588,0.6665277777777778,36.855811403508774,8117.287246785081,108.23049662380109,0
2988,31.000468709234845,0,0,188,0.0,0.0,1.0,188,5600,4300,1300,0.7678571428571429,69,43,26,195.36761605413128,0.41272471270906813,0.7465779981096048,0.1312365898341694,1056918.4284437434,-1902.473254253513,1055015.9551894898,2987,18,1279.6063829787233,87,101,37,33.77153218495012,0.6412835249042146,38.87310606060605,8095.056104707837,93.04662189319353,8
2989,30.96564162486527,0,0,188,0.0,0.0,1.0,188,5950,4500,1450,0.7563025210084033,74,45,29,195.99342170616276,0.4126921198847044,0.745695200395845,0.13227358729496605,1057007.625948837,-2116.691724156056,1054890.934224681,2988,19,1280.6063829787233,89,99,40,33.59426910299005,0.6422050561797753,38.71527777777777,8090.849070385782,90.90841652118857,0
2990,30.937018796209088,0,0,188,0.0,0.0,1.0,188,4750,2900,1850,0.6105263157894737,66,29,37,194.48564214150738,0.4127270830962946,0.7446107304563858,0.13157601976346783,1056693.8215298937,-1247.6447145591055,1055446.1768153345,2989,20,1281.6063829787233,90,98,43,33.55003357713254,0.6427083333333333,38.63324175824176,8085.908312429511,89.84342569366123,0
2991,31.038212868680752,0,1,187,0.0,0.005319148936170213,0.9946808510638298,188,5750,4500,1250,0.782608695652174,70,45,25,195.72896890841486,0.4125990821860659,0.7471033316839852,0.1328896683641348,1061121.736470386,-1811.5473268688002,1059310.189143517,2990,21,1282.6063829787233,73,115,42,33.39546547516513,0.6506849315068493,38.51351351351353,8116.073229851015,111.17908534042486,0
2992,31.39015275824756,0,1,186,0.0,0.0053475935828877,0.9946524064171123,187,4150,3200,950,0.7710843373493976,51,32,19,194.96061476241985,0.4126320127268894,0.744736452837631,0.13290743623518164,1074272.9378997213,338.18247911233175,1074611.1203788337,2991,22,1286.3957219251338,75,112,44,33.27657865325512,0.6511111111111111,38.37719298245616,8212.379877322262,109.49839836429683,0
2993,31.68866494250069,0,0,186,0.0,0.0,1.0,186,4750,2900,1850,0.6105263157894737,66,29,37,200.32807857433735,0.4121760873777003,0.7486027062321137,0.13716731494739715,1085705.3282119588,1549.4524597245736,1087254.7806716834,2992,23,1293.6075268817203,76,110,45,32.98654177433251,0.6521381578947368,38.2305194805195,8295.125360354315,109.14638632045153,0
2994,31.928676669739104,0,0,186,0.0,0.0,1.0,186,5400,3800,1600,0.7037037037037037,70,38,32,198.12169684243796,0.41178254867770997,0.7459443276890099,0.13616239248043352,1094964.9806830573,787.2639911952265,1095752.2446742526,2993,24,1294.6075268817203,78,108,42,32.91786241734636,0.6525106837606838,38.10654008438821,8361.911603564906,107.20399491749879,0
2995,32.24907768712578,0,0,186,0.0,0.0,1.0,186,5150,3500,1650,0.6796116504854369,68,35,33,199.7279561876129,0.41143502373341084,0.7449091597982747,0.13767475869993076,1106786.8355308098,1861.2545191850686,1108648.0900499949,2994,25,1295.6075268817203,79,107,43,32.775096085350356,0.6530854430379747,38.00781250000002,8449.006408107569,106.94944820389328,0
2996,31.98262450536423,0,0,186,0.0,0.0,1.0,186,6200,4600,1600,0.7419354838709677,78,46,32,200.43330977667733,0.41147801026833286,0.7525295258240803,0.13006842442954505,1080540.289316866,-84.74669303474184,1080455.5426238314,2995,26,1296.6075268817203,76,110,45,34.846690953248306,0.6336348684210527,40.05681818181816,8313.665176820476,109.39033127395362,8
2997,32.476107390572196,0,0,186,0.0,0.0,1.0,186,5150,3800,1350,0.7378640776699029,65,38,27,200.5102476639618,0.41144955439310277,0.7525273505559531,0.1306097795549519,1098316.0047859037,1694.7228265824251,1100010.727612486,2996,27,1297.6075268817203,78,108,39,34.71141333738927,0.6340811965811965,39.92616033755271,8446.185946356005,108.28443520969238,0
2998,32.02291093608029,0,1,185,0.0,0.005376344086021506,0.9946236559139785,186,5350,3900,1450,0.7289719626168224,68,39,29,200.06993980968062,0.41146590138525624,0.7517463700259408,0.1306339018757317,1083675.7113009575,812.1868666387027,1084487.8981675962,2997,28,1298.6075268817203,79,107,40,34.63880547213878,0.634493670886076,39.84374999999997,8330.960423214568,105.45519523056416,0
2999,32.21859700080651,0,1,184,0.0,0.005405405405405406,0.9945945945945946,185,4950,3400,1550,0.6868686868686869,65,34,31,201.88511754686112,0.41159175479827653,0.7530291457074321,0.13218345807550338,1091096.5761452045,2105.232106009922,1093201.8082512144,2998,29,1296.4,81,104,41,34.494384650428735,0.6346450617283951,39.74847560975606,8384.938983174743,103.51776522437954,0
3000,32.39007409006509,0,1,183,0.0,0.005434782608695652,0.9945652173913043,184,4150,2400,1750,0.5783132530120482,59,24,35,204.60446036873668,0.4109485131068346,0.7560819403777057,0.13405599460676051,1097103.3539270826,3944.4479397960367,1101047.8018668788,2999,30,1303.9239130434783,80,104,41,34.399447436467526,0.6352864583333333,39.7247942386831,8430.333198415923,105.37916498019904,0
3001,32.282597514233935,0,0,183,0.0,0.0,1.0,183,4300,2800,1500,0.6511627906976745,58,28,30,202.8084083496771,0.41056040953581935,0.753077819464985,0.133278741453777,1094331.517214152,3487.926642617578,1097819.4438567697,3000,31,1311.8032786885246,81,102,43,34.34074701988906,0.6359310699588477,39.62144308943087,8405.696154080893,103.77402659359127,0
3002,32.64949873320624,0,0,183,0.0,0.0,1.0,183,4200,2500,1700,0.5952380952380952,59,25,34,202.49708508002044,0.4103202125743109,0.7519394014365584,0.13367818724353153,1108091.0881723566,4077.043071609962,1112168.1312439665,3001,32,1312.8032786885246,70,113,44,34.19022412433835,0.6425595238095239,39.46596244131455,8506.305729229398,121.51865327470568,0
3003,32.19630943966982,0,1,182,0.0,0.00546448087431694,0.994535519125683,183,5200,3700,1500,0.7115384615384616,67,37,30,200.59821198994737,0.4101800976800977,0.7490179608763754,0.13296546214195804,1093880.59109633,2086.098140886157,1095966.689237216,3002,33,1313.8032786885246,72,111,44,34.09741989635791,0.6429398148148149,39.32648401826484,8392.725183274668,116.5656275454815,0
3004,32.23465929248251,0,0,182,0.0,0.0,1.0,182,6000,4600,1400,0.7666666666666667,74,46,28,199.9496911978932,0.4094488039584725,0.7449759601498382,0.13328182920010503,1096792.940946934,1460.6819700736933,1098253.6229170077,3003,38,1321.8406593406594,78,104,41,33.919033899447385,0.642094017094017,39.13502109704641,8408.893716277344,107.80632969586338,0
3005,32.5325546221868,1,0,183,0.00546448087431694,0.0,1.0,183,4800,3300,1500,0.6875,63,33,30,200.16341329066736,0.40999244380391925,0.7447801576539206,0.13395355674177015,1108070.8649090473,2959.0492976273185,1111029.9142066746,3004,0,1315.6120218579235,83,100,44,33.77624087360034,0.6414407630522088,39.000496031746025,8490.980619210868,102.30097131579359,0
3006,32.524492061465466,0,1,182,0.0,0.00546448087431694,0.994535519125683,183,4100,2800,1300,0.6829268292682927,54,28,26,198.71878137341824,0.40966342400768635,0.743229408693316,0.1334899052176793,1108882.6436818377,3371.1615277177075,1112253.8052095554,3005,1,1316.6120218579235,84,99,34,33.68345613541081,0.6423611111111112,38.87254901960784,8493.03770644246,101.1075917433626,0
3007,32.40212938901876,0,0,182,0.0,0.0,1.0,182,4850,3300,1550,0.6804123711340206,64,33,31,198.87873954859558,0.408579852467974,0.7426871374239783,0.13408276311502115,1105747.979563853,2731.95288681322,1108479.9324506663,3006,41,1324.8406593406594,84,98,36,33.554292929292934,0.6436011904761905,38.75000000000001,8465.056302881172,100.77447979620443,0
3008,32.5737176357025,0,0,182,0.0,0.0,1.0,182,5650,4000,1650,0.7079646017699115,73,40,33,201.5052359247463,0.4085931333859511,0.7477737822362402,0.1364082961278431,1112772.3669037758,2795.891664696697,1115568.2585684725,3007,42,1325.8406593406594,87,95,38,33.345598224798486,0.6439176245210728,38.61268939393939,8514.356449237477,97.8661660831894,0
3009,32.39125356935807,0,0,182,0.0,0.0,1.0,182,5150,3800,1350,0.7378640776699029,65,38,27,204.26219441658404,0.40868989435978387,0.7500634288482093,0.1389745820012652,1107975.1534230772,3713.487239449853,1111688.640662527,3008,43,1326.8406593406594,73,109,39,33.1005126204187,0.651398401826484,38.443130630630634,8472.154878550715,116.05691614453033,0
3010,32.16820471261544,1,0,183,0.00546448087431694,0.0,1.0,183,4850,3400,1450,0.7010309278350515,63,34,29,225.98391857665789,0.4091780259813047,0.7804652125792548,0.14401832282489654,1081527.836653245,7431.579715327151,1088959.416368572,3009,0,1320.5846994535518,80,103,41,34.829295609336775,0.6255208333333333,40.68930041152263,8341.559668533657,104.26949585667072,8
3011,32.36094865850813,1,0,184,0.005434782608695652,0.0,1.0,184,4700,3000,1700,0.6382978723404256,64,30,34,223.21124952450162,0.4102864892690267,0.778177545236177,0.14291530554010579,1089380.5907467697,7132.400573665033,1096512.9913204347,3010,0,1314.4021739130435,62,122,41,34.73403746893519,0.6365927419354839,40.52579365079364,8396.831469873781,135.4327656431255,0
3012,32.175039350371,0,0,184,0.0,0.0,1.0,184,5950,4500,1450,0.7563025210084033,74,45,29,221.876294564906,0.4100847885483488,0.7755642923219246,0.14268432547274068,1084402.6206729703,5370.647058278406,1089773.2677312486,3011,1,1315.4021739130435,65,119,43,34.61195542046606,0.6362179487179487,40.37247474747475,8353.525841439441,128.5157821759914,0
3013,31.815334819798096,1,1,184,0.005405405405405406,0.005405405405405406,0.9945945945945946,185,4650,2900,1750,0.6236559139784946,64,29,35,218.71899133702775,0.41088792596944773,0.7732807386375959,0.14131740010221427,1073635.6767100573,5314.90245469418,1078950.5791647516,3012,0,1309.2864864864864,69,116,44,34.52619620422349,0.6355676328502415,40.208333333333336,8265.358858393383,119.78780954193309,0
3014,31.979194401467126,0,1,183,0.0,0.005434782608695652,0.9945652173913043,184,4900,3600,1300,0.7346938775510204,62,36,26,216.6065515391791,0.4106886532826483,0.7695457977306235,0.1405478480138832,1080391.602951185,5103.979885428413,1085495.5828366135,3013,1,1314.7173913043478,71,113,44,34.43030973451327,0.6360035211267605,40.060763888888886,8312.647364166074,117.07954034036725,0
3015,32.146455132929475,0,0,183,0.0,0.0,1.0,183,5600,4000,1600,0.7142857142857143,72,40,32,220.82101808262038,0.41061795672451407,0.772460346845298,0.1440528334263111,1087595.1944290148,5832.775619115997,1093427.9700481307,3014,2,1308.6338797814208,74,109,34,34.13089326712584,0.636402027027027,39.87499999999999,8362.096641453261,113.0013059655846,0
3016,32.162929000018465,0,0,183,0.0,0.0,1.0,183,5000,3900,1100,0.78,61,39,22,222.65481670717935,0.4104465661842711,0.7731943271668706,0.14602919539893366,1089699.4465393545,6925.366107026606,1096624.812646381,3015,3,1309.6338797814208,77,106,38,33.894247212531646,0.6369047619047619,39.690170940170916,8372.326550058162,108.73151363711898,0
3017,32.5650895773694,1,0,184,0.005434782608695652,0.0,1.0,184,5550,4000,1550,0.7207207207207207,71,40,31,222.43370762326947,0.41128880573374516,0.7746805744309722,0.14647457926634433,1104502.56662031,6785.720194554606,1111288.2868148647,3016,0,1303.5108695652175,64,120,39,33.75802465337599,0.6451822916666667,39.55128205128205,8481.53583031102,132.5239973486097,0
3018,32.43897880357042,0,0,184,0.0,0.0,1.0,184,5900,4300,1600,0.7288135593220338,75,43,32,219.21605373451064,0.410945419537499,0.7714843446104698,0.14527179276335167,1102056.9314586592,5617.714301026197,1107674.6457596854,3017,1,1304.5108695652175,66,118,38,33.6203725794266,0.6461489898989898,39.33457711442785,8455.720127808776,128.1169716334663,0
3019,32.03655017916284,1,0,185,0.005405405405405406,0.0,1.0,185,5350,3400,1950,0.6355140186915887,73,34,39,213.18640164780345,0.41128329416372894,0.7651507795220385,0.14240851630073167,1090658.3837239565,4152.707250623522,1094811.09097458,3018,0,1298.454054054054,71,114,40,33.49966733200266,0.6461267605633803,39.06249999999997,8359.537312375236,117.73996214613008,0
3020,32.29357988331169,1,0,186,0.005376344086021506,0.0,1.0,186,5050,3800,1250,0.7524752475247525,63,38,25,209.73071279475965,0.412266904000775,0.7626602319871318,0.14078118670684125,1100795.1433978137,3924.1100131664275,1104719.25341098,3019,0,1292.467741935484,75,111,33,33.42191601049869,0.6458333333333333,38.89802631578946,8431.917444861363,112.42556593148484,0
3021,31.791459044051603,0,0,186,0.0,0.0,1.0,186,6100,4500,1600,0.7377049180327869,77,45,32,206.0142943185459,0.4123250266395428,0.758514170999679,0.13881659011936168,1084753.0977078904,1394.9287868294678,1086148.02649472,3020,1,1293.467741935484,77,109,35,33.386958318422685,0.6462391774891775,38.76869658119657,8304.92428366309,107.85615952809206,0
3022,31.419506041363604,0,1,185,0.0,0.005376344086021506,0.9946236559139785,186,6050,4500,1550,0.743801652892562,76,45,31,209.0560406986583,0.412252373341083,0.7619131588864314,0.1415938733783923,1073487.1592160503,1633.795049311576,1075120.954265362,3021,2,1294.467741935484,77,109,38,33.13025782500596,0.6479978354978355,38.59508547008547,8213.213291314789,106.66510767941284,0
3023,31.08399431570948,0,2,183,0.0,0.010810810810810811,0.9891891891891892,185,4650,3000,1650,0.6451612903225806,63,30,33,209.36175616260064,0.4114191637289463,0.7613653494131589,0.14202648864003445,1062458.0761089472,2837.6177326614634,1065295.6938416087,3022,3,1301.4594594594594,71,114,38,33.06772908366533,0.6514084507042254,38.541666666666664,8127.1693471282015,114.4671739032141,0
3024,31.04880076447027,0,1,182,0.0,0.00546448087431694,0.994535519125683,183,5600,4300,1300,0.7678571428571429,69,43,26,208.15739739026588,0.41078309213555114,0.7575863525387492,0.14181157808828515,1062413.854335345,2029.8605739613922,1064443.7149093065,3023,4,1305.655737704918,72,111,38,32.953553700976364,0.65234375,38.39897260273973,8122.398179438279,112.81108582553165,0
3025,30.697569479777798,0,0,182,0.0,0.0,1.0,182,4450,2800,1650,0.6292134831460674,61,28,33,207.47827625196254,0.4093419241899905,0.7557235555763298,0.1417111399696368,1051083.2373855659,2765.387658017977,1053848.6250435838,3024,5,1313.7582417582419,72,110,40,32.88392678626611,0.6532118055555556,38.31335616438357,8033.143931073717,111.57144348713496,0
3026,30.28042357093544,0,1,181,0.0,0.005494505494505495,0.9945054945054945,182,5000,3500,1500,0.7,65,35,30,205.0010587152936,0.409213541982879,0.7525569821907947,0.14042006220730496,1037556.6704915729,1140.043185577686,1038696.7136771507,3025,6,1314.7582417582419,73,109,40,32.851344750945536,0.6536815068493151,38.217905405405425,7926.87270761105,108.58729736453493,0
3027,30.736509864286624,0,0,181,0.0,0.0,1.0,181,5500,3800,1700,0.6909090909090909,72,38,34,206.7148922768177,0.4092451913239206,0.74266050895031,0.14141030274811017,1052835.9610610418,1827.3744551786958,1054663.3355162204,3026,7,1321.9558011049724,77,104,41,32.850687535078315,0.6513798701298701,38.261217948717956,8044.936656385612,104.47969683617679,8
3028,30.319039408113305,0,1,180,0.0,0.0055248618784530384,0.994475138121547,181,5250,3700,1550,0.7047619047619048,68,37,31,204.45306662597628,0.408981737262124,0.7405863670270421,0.14065587853105893,1040030.9311839902,1077.5026532876163,1041108.4338372778,3027,8,1322.9558011049724,79,102,40,32.71773712467687,0.6524261603375527,38.072916666666686,7941.377561635559,100.52376660298175,0
3029,30.16091252532567,0,0,180,0.0,0.0,1.0,180,5300,4000,1300,0.7547169811320755,66,40,26,200.2245219453284,0.4082628543347817,0.7337160400370071,0.13847989187946633,1035998.3023531436,186.45296496629362,1036184.7553181099,3028,9,1327.3722222222223,83,97,37,32.648877113298035,0.6526104417670683,37.89682539682542,7905.270921816569,95.24422797369361,0
3030,30.395911410445763,0,0,180,0.0,0.0,1.0,180,5150,3600,1550,0.6990291262135923,67,36,31,201.13825799268653,0.40792597765363126,0.7370699234611737,0.13964816497493604,1045084.0587976027,891.2774084955336,1045975.3362060982,3029,10,1328.3722222222223,84,96,39,32.49515141602021,0.6535218253968254,37.76960784313727,7970.731769126497,94.88966391817259,0
3031,30.16767861746692,0,1,179,0.0,0.005555555555555556,0.9944444444444445,180,3950,2600,1350,0.6582278481012658,53,26,27,201.83571162721157,0.40785485205876265,0.7388219232126909,0.1404451096121213,1037818.6341279024,1943.7725118373173,1039762.4066397398,3030,11,1329.3722222222223,84,96,40,32.401848564131356,0.654265873015873,37.69607843137256,7913.100405983632,94.20357626170991,0
3032,29.808865852968886,0,1,178,0.0,0.00558659217877095,0.994413407821229,179,5150,3900,1250,0.7572815533980582,64,39,25,202.59188037512024,0.4067907434143075,0.7396387017571393,0.14140139013697928,1026259.2135571686,632.3567653679711,1026891.5703225366,3031,12,1337.731843575419,86,93,44,32.27968911601873,0.6545542635658914,37.595785440613035,7821.972031054456,90.953163151796,0
3033,29.707556058539307,0,0,178,0.0,0.0,1.0,178,5450,4400,1050,0.8073394495412844,65,44,21,200.56419556092413,0.40645101991155125,0.735984777652426,0.1405188375539966,1023743.7980950449,15.270265083367121,1023759.0683601283,3032,13,1345.4606741573034,71,107,40,32.205674345126575,0.6622652582159625,37.471064814814795,7799.093059002479,109.84638111271097,0
3034,30.22561574315462,0,0,178,0.0,0.0,1.0,178,4550,3000,1550,0.6593406593406593,61,30,31,201.03528017011226,0.40588631266002245,0.7361284728494537,0.1414524256400554,1042707.5891866337,1774.202465527177,1044481.7916521609,3033,14,1346.4606741573034,73,105,43,32.050509110396575,0.6626712328767124,37.33108108108105,7939.329810913016,108.7579426152468,0
3035,30.001125190054132,1,0,179,0.00558659217877095,0.0,1.0,179,5500,4200,1300,0.7636363636363637,68,42,26,197.0422181769823,0.4066011235955056,0.7312372264634914,0.1396100833693187,1036750.0911273521,-443.29246981606684,1036306.798657536,3034,0,1339.9329608938547,78,101,42,31.924277761059233,0.6626602564102564,37.104430379746795,7887.16289608771,101.11747302676551,0
3036,30.213152008003778,1,0,180,0.005555555555555556,0.0,1.0,180,5500,4100,1400,0.7454545454545455,69,41,28,198.68198786008423,0.4064827746741155,0.7362336798515254,0.14181594405698617,1045981.0416059108,63.51852204424631,1046044.560127955,3035,0,1333.4833333333333,81,99,37,31.636815680216266,0.6638374485596708,36.86483739837394,7950.142666333618,98.14990946090886,0
3037,30.31369569122198,0,0,180,0.0,0.0,1.0,180,5150,3800,1350,0.7378640776699029,65,38,27,197.39512756478962,0.4060818849575833,0.7347948754629421,0.1411378527160302,1049901.4138487086,299.0847034233275,1050200.498552132,3036,1,1334.4833333333333,82,98,38,31.61449144056073,0.6639989837398375,36.809738955823256,7978.2694821863615,97.29596929495563,0
3038,30.39705980784967,0,0,180,0.0,0.0,1.0,180,4700,3000,1700,0.6382978723404256,64,30,34,197.0091961542093,0.40571203186426646,0.7343453618376836,0.1413807477812054,1053737.431516553,819.1928681348481,1054556.624384688,3037,2,1335.4833333333333,84,96,38,31.50375050420422,0.6644345238095238,36.69117647058819,8003.814056757954,95.28350067568992,0
3039,30.252710545787988,0,0,180,0.0,0.0,1.0,180,4800,3400,1400,0.7083333333333334,62,34,28,195.67313930259735,0.40566677012207736,0.7329871054744936,0.14081169092305496,1049443.8445776505,269.5943180586173,1049713.438895709,3038,3,1336.4833333333333,86,94,38,31.44802036456197,0.6646075581395349,36.602011494252835,7968.503104607061,92.65701284426815,0
3040,30.54563413491881,0,1,179,0.0,0.005555555555555556,0.9944444444444445,180,3900,2600,1300,0.6666666666666666,52,26,26,195.3589417842131,0.4055141733912684,0.7335991673031732,0.14085208834762494,1060094.5241129196,1519.788884387256,1061614.312997307,3039,4,1337.4833333333333,87,93,39,31.39428981144505,0.6648706896551724,36.541193181818144,8047.516322690338,92.50018761713032,0
3041,30.817365687332373,0,0,179,0.0,0.0,1.0,179,4050,2900,1150,0.7160493827160493,52,29,23,193.25407364589373,0.4046238465884125,0.7287300991454493,0.13969508752117424,1070197.895117433,1514.020567740813,1071711.9156851738,3040,5,1345.804469273743,77,102,40,31.36528326745716,0.6696428571428572,36.45833333333332,8121.659915515697,105.47610279890516,0
3042,30.967401727835604,0,0,179,0.0,0.0,1.0,179,4600,3400,1200,0.7391304347826086,58,34,24,193.38051005679256,0.40441722637206284,0.729732741755557,0.14047138054771008,1076683.7780787258,1241.9316349476421,1077925.7097136735,3041,6,1346.804469273743,79,100,38,31.202679570741985,0.6703586497890295,36.30208333333333,8166.039320209968,103.36758633177175,0
3043,30.930681361388295,0,0,179,0.0,0.0,1.0,179,5100,4200,900,0.8235294117647058,60,42,18,192.55266237365564,0.4042236833845961,0.7296042540025622,0.14025710975171954,1076125.6997111358,542.1737056183883,1076667.8734167542,3042,7,1347.804469273743,80,99,39,31.134721951378022,0.6708333333333334,36.21399176954732,8159.080968168673,101.98851210210842,0
3044,30.681068436356703,0,0,179,0.0,0.0,1.0,179,4850,3600,1250,0.7422680412371134,61,36,25,191.01609890527362,0.4042681459627979,0.7272146232708694,0.13929151481968804,1067725.6185522713,140.5564714149432,1067866.1750236861,3043,8,1348.804469273743,81,98,39,31.139453325629187,0.6707818930041152,36.17886178861788,8094.314396420917,99.92980736322119,0
3045,30.26322110476231,0,0,179,0.0,0.0,1.0,179,4800,3300,1500,0.6875,63,33,30,189.08808821783927,0.40397521603582115,0.7251247042334479,0.1384499469458788,1054220.4245037697,-731.8950740768132,1053488.529429693,3044,9,1349.804469273743,83,96,39,31.05811017148227,0.6713102409638554,36.04910714285713,7988.004231335116,96.24101483536285,0
3046,30.183537079210286,0,0,179,0.0,0.0,1.0,179,5950,4200,1750,0.7058823529411765,77,42,35,189.0984643947714,0.40347174272382985,0.7246519557941009,0.13905274263740947,1052527.0762549755,-1943.749229253231,1050583.3270257222,3045,10,1350.804469273743,85,94,46,30.919435781008715,0.6719362745098039,35.91327519379844,7971.071450315166,93.77731118017842,0
3047,30.038787205746992,0,0,179,0.0,0.0,1.0,179,5700,4500,1200,0.7894736842105263,69,45,24,189.17023162600674,0.40342466469985144,0.7253278869065485,0.13962564715252868,1048414.3794490311,-1834.2417999180766,1046580.137649113,3046,11,1351.804469273743,87,92,35,30.797491039426497,0.6724137931034483,35.79545454545454,7936.384119700193,91.22280597356544,0
3048,29.86287208509342,0,1,178,0.0,0.00558659217877095,0.994413407821229,179,5400,3600,1800,0.6666666666666666,72,36,36,187.57109605613115,0.40342466469985144,0.7241828351992825,0.13917650695407413,1043582.509212025,-2050.816984418649,1041531.6922276063,3047,12,1352.804469273743,87,92,39,30.670912808572886,0.6740900383141762,35.629734848484844,7894.85541132192,90.7454644979531,0
3049,29.66222224261313,0,0,178,0.0,0.0,1.0,178,6350,4400,1950,0.6929133858267716,83,44,39,188.24520322656497,0.40314146511775534,0.7241578005369411,0.14031469633642338,1037691.0900741777,-2881.925972518265,1034809.1641016594,3048,13,1346.2191011235955,88,90,43,30.50755899705015,0.6751893939393939,35.486891385767784,7846.046613799799,89.15962061136135,0
3050,29.365033171311023,0,0,178,0.0,0.0,1.0,178,4800,3500,1300,0.7291666666666666,61,35,26,188.89223524918881,0.40310311263463044,0.725956161737239,0.14148599932745679,1028478.9255025701,-1545.663371027173,1026933.2621315429,3049,14,1347.2191011235955,75,103,41,30.335102710167476,0.6819444444444445,35.334429824561404,7771.913247505699,103.62550996674264,0
3051,29.996685879904376,0,1,177,0.0,0.0056179775280898875,0.9943820224719101,178,5450,4000,1450,0.7339449541284404,69,40,29,189.0607246559773,0.4025443566304831,0.7242835500568103,0.14259664825747498,1052312.5215008662,-1259.806424097328,1051052.7150767688,3050,15,1348.2191011235955,76,102,40,30.111189138576794,0.6836622807017544,35.119047619047635,7945.5507241413725,104.54672005449174,0
3052,30.016725015860157,0,0,177,0.0,0.0,1.0,177,5700,4500,1200,0.7894736842105263,69,45,24,189.16388208212658,0.4013278976202705,0.7226202321724711,0.14337081560523188,1054213.9946851316,-1216.157644010801,1052997.8370411207,3051,16,1356.6440677966102,78,99,42,29.954912935323392,0.6842948717948718,34.968354430379755,7955.382025564218,101.9920772508233,0
3053,29.752003435733954,0,1,176,0.0,0.005649717514124294,0.9943502824858758,177,4500,3400,1100,0.7555555555555555,56,34,22,188.01069935657162,0.4012369457284712,0.7211437070582609,0.14283200891417178,1045488.6613136663,-587.3891234103585,1044901.2721902559,3052,17,1357.6440677966102,79,98,45,29.911591355599207,0.6845991561181435,34.895833333333336,7887.380077494063,99.84025414549447,0
3054,30.354083142603688,0,0,176,0.0,0.0,1.0,176,4500,3100,1400,0.6888888888888889,59,31,28,187.2574810170143,0.40098620129870133,0.7187539462740624,0.1427299901859153,1067463.7488769633,278.1145383359353,1067741.8634152992,3053,18,1365.784090909091,81,95,40,29.8280304481806,0.6847993827160495,34.79420731707318,8050.078680997706,99.38368741972477,0
3055,30.623514787657978,0,0,176,0.0,0.0,1.0,176,4800,3100,1700,0.6458333333333334,65,31,34,190.21131789899948,0.4002462121212121,0.7257116582750363,0.14565874300393164,1078101.3952447714,1013.4174436516905,1079114.812688423,3054,19,1366.784090909091,82,94,41,29.60386810449478,0.6858485772357723,34.65110441767069,8125.9158277541865,99.09653448480715,0
3056,30.98244607352254,0,0,176,0.0,0.0,1.0,176,5100,3900,1200,0.7647058823529411,63,39,24,189.42652453459118,0.39969426406926406,0.7242035728257177,0.14529570962397545,1091150.3254608691,1038.5627793681588,1092188.8882402373,3055,20,1367.784090909091,82,94,41,29.573540770164417,0.6863567073170731,34.600903614457835,8222.71319172668,100.27699014300829,0
3057,31.241808970630814,0,1,175,0.0,0.005681818181818182,0.9943181818181818,176,5100,4000,1100,0.7843137254901961,62,40,22,188.4652315550286,0.39928097943722946,0.7227247248267443,0.14492326426472865,1100923.9783875402,1197.1785022581626,1102121.1568897984,3056,21,1368.784090909091,83,93,42,29.520506352765356,0.6867469879518072,34.52380952380952,8293.956429107926,99.92718589286658,0
3058,31.314836943257717,0,0,175,0.0,0.0,1.0,175,5200,4000,1200,0.7692307692307693,64,40,24,190.36540737774803,0.39843459222769567,0.725638944959393,0.14685827143713218,1104317.3172165477,1844.7631932460986,1106162.0804097939,3057,22,1369.7714285714285,82,93,43,29.36957531937684,0.688135162601626,34.42520080321286,8316.43153308582,101.41989674494903,0
3059,31.185883251219824,0,0,175,0.0,0.0,1.0,175,4950,3100,1850,0.6262626262626263,68,31,37,188.6998168363543,0.39786808976464144,0.7232111119408557,0.14614686218945175,1100760.914195441,1592.6765778595327,1102353.5907733005,3058,23,1370.7714285714285,74,101,42,29.2919062554452,0.6928490990990991,34.30555555555556,8285.91592494216,111.97183682354269,0
3060,31.00204006130591,0,0,175,0.0,0.0,1.0,175,4150,2900,1250,0.6987951807228916,54,29,25,189.9043434859657,0.3978174603174603,0.7242896184926826,0.14760781295484288,1095167.6877978302,2445.420151657936,1097613.107949488,3059,24,1371.7714285714285,75,100,45,29.14910233933208,0.6934722222222223,34.196820175438596,8240.440829343544,109.87254439124726,0
3061,30.948861678513772,0,0,175,0.0,0.0,1.0,175,5450,3900,1550,0.7155963302752294,70,39,31,191.2783374418604,0.39754105090311986,0.725213726145663,0.14933080053344278,1094383.2298281395,1416.3609451560023,1095799.5907732956,3060,25,1372.7714285714285,76,99,44,28.977070403906815,0.6943530701754386,34.06385281385281,8230.42103458094,108.29501361290711,0
3062,30.69374031470794,0,0,175,0.0,0.0,1.0,175,4750,3600,1150,0.7578947368421053,59,36,23,190.8432087177063,0.3971811713191023,0.7250313022151795,0.14950010070253308,1086201.5501620588,1708.8378294146955,1087910.3879914735,3061,26,1373.7714285714285,77,98,47,28.88383071465624,0.6949404761904762,33.961004273504265,8165.731848414734,106.0484655638277,0
3063,30.779096189089476,0,0,175,0.0,0.0,1.0,175,5300,4000,1300,0.7547169811320755,66,40,26,188.5960860257925,0.3970128626163109,0.721523846804466,0.1480729239381144,1089777.1988119502,805.5428672171129,1090582.7416791674,3062,27,1374.7714285714285,79,96,45,28.874559622253745,0.6947521097046414,33.893229166666664,8190.525896047148,103.67754298793858,0
3064,30.549398811827018,0,0,175,0.0,0.0,1.0,175,4950,3200,1750,0.6464646464646465,67,32,35,188.15004294959016,0.3969006568144499,0.7212688475566305,0.14830053115448405,1082597.3140926647,788.146228729197,1083385.460321394,3063,28,1375.7714285714285,79,96,41,28.76703674720402,0.6959388185654009,33.776041666666664,8132.981876388209,102.9491376758001,0
3065,31.093520603376,0,1,174,0.0,0.005714285714285714,0.9942857142857143,175,4850,3200,1650,0.6597938144329897,65,32,33,187.40433473368805,0.3963574165298303,0.7195210274733248,0.14831223449252592,1102883.2379725252,1487.0199002352165,1104370.2578727603,3064,29,1376.7714285714285,80,95,43,28.663411552637083,0.6967447916666667,33.654835390946495,8281.608863381156,103.52011079226445,0
3066,31.07466924426999,0,0,174,0.0,0.0,1.0,174,3800,2500,1300,0.6578947368421053,51,25,26,186.74074998881923,0.39590392664939206,0.7171803576975986,0.14836151609541193,1103172.7292031194,2601.4605637207715,1105774.18976684,3065,30,1384.1494252873563,80,94,45,28.563183719433756,0.6979166666666667,33.53909465020577,8280.184500273606,103.50230625342007,0
3067,30.697556148095103,0,0,174,0.0,0.0,1.0,174,4600,3200,1400,0.6956521739130435,60,32,28,191.57135131299935,0.3955606493477731,0.7217521901406376,0.15279271032578548,1090731.8776412618,2390.5959439803573,1093122.4735852422,3066,31,1385.1494252873563,80,94,46,28.31650907745993,0.6990885416666667,33.42335390946502,8183.251561135078,102.29064451418847,0
3068,31.219215052041786,0,0,174,0.0,0.0,1.0,174,5800,4800,1000,0.8275862068965517,68,48,20,194.147693097142,0.39525543706951916,0.7241550017070666,0.15562632541913804,1110505.1525587495,2520.4027083543465,1113025.555267104,3067,32,1386.1494252873563,70,104,43,28.096236707004028,0.7053571428571428,33.27464788732395,8326.956127437224,118.95651610624607,0
3069,31.32172198063042,0,0,174,0.0,0.0,1.0,174,5000,3600,1400,0.72,64,36,28,194.63363027490124,0.3948415664518415,0.725001417850961,0.15654723258438735,1114990.862359812,3602.9438528865394,1118593.8062126986,3068,33,1387.1494252873563,71,103,48,27.980862206076374,0.7058392018779343,33.17418981481481,8357.44384387683,117.71047667432155,0
3070,31.800392322389925,0,1,173,0.0,0.005747126436781609,0.9942528735632183,174,4900,3800,1100,0.7755102040816326,60,38,22,192.89121958441103,0.3945612694616083,0.7224988829494745,0.15541966137275176,1132471.887428362,3988.7767022232783,1136460.6641305853,3069,34,1388.1494252873563,73,101,47,27.97434595706524,0.7053367579908676,33.12218468468468,8486.819229169347,116.25779765985406,0
3071,32.28544816945121,0,0,173,0.0,0.0,1.0,173,3650,2400,1250,0.6575342465753424,49,24,25,191.7092243661277,0.39403257606309094,0.719018838913662,0.1546711953765008,1150080.4181564853,5846.204984690414,1155926.6231411758,3070,35,1395.849710982659,74,99,49,27.966294619627416,0.7052364864864865,33.083333333333336,8617.524207229362,116.45302982742382,0
3072,32.7456496371875,0,0,173,0.0,0.0,1.0,173,5650,4400,1250,0.7787610619469026,69,44,25,191.13863341610914,0.3931980104852803,0.7181392788329197,0.1552045703338805,1168122.8150094005,4404.679704614968,1172527.4947140154,3071,36,1396.849710982659,75,98,50,27.789323344280223,0.7066666666666667,32.89473684210526,8746.535363617186,116.62047151489581,0
3073,32.21429717267731,0,0,173,0.0,0.0,1.0,173,4800,3800,1000,0.7916666666666666,58,38,20,191.2111690845048,0.3927009118609132,0.7188647883825068,0.15606641213808162,1150465.7471356068,4596.3801002956725,1155062.1272359025,3072,37,1397.849710982659,75,98,50,27.63373549070891,0.7081944444444445,32.743969298245624,8609.465194216513,114.79286925622017,0
3074,32.541059801556955,0,0,173,0.0,0.0,1.0,173,5450,3900,1550,0.7155963302752294,70,39,31,188.90786253344928,0.3921267979567146,0.7155959903012843,0.1548372528881689,1163202.3906858037,3897.615463650843,1167100.0061494545,3073,38,1398.849710982659,78,95,45,27.57031429792549,0.7080662393162394,32.62130801687765,8700.786005484897,111.54853853185766,0
3075,32.64610471959004,0,0,173,0.0,0.0,1.0,173,3700,2200,1500,0.5945945945945946,52,22,30,188.7498472600403,0.3916268987767173,0.7156867240372411,0.1550429393041612,1167506.1684159182,5773.322192732189,1173279.4906086505,3074,39,1399.849710982659,81,92,46,27.51047950410868,0.7074331275720165,32.55843495934961,8730.925338688176,107.7892017121997,0
3076,32.471671836872176,0,0,173,0.0,0.0,1.0,173,3950,2800,1150,0.7088607594936709,51,28,23,189.86451550115353,0.39137344849218086,0.7166784608653098,0.15630050693601683,1161819.6714117453,5567.665802460276,1167387.3372142054,3075,40,1400.849710982659,81,92,47,27.415946433659414,0.7080761316872428,32.494918699187004,8686.337214695848,107.23873104562776,0
3077,32.94159660865176,0,0,173,0.0,0.0,1.0,173,5000,3800,1200,0.76,62,38,24,189.84965978971317,0.3910597862615943,0.7174240041644528,0.15664066357262788,1179207.951151407,5174.445669484158,1184382.3968208912,3076,41,1401.849710982659,82,91,47,27.349906191369616,0.7083333333333333,32.429718875502026,8814.192265266804,107.49014957642443,0
3078,32.66333703858172,0,0,173,0.0,0.0,1.0,173,4650,3100,1550,0.6666666666666666,62,31,31,188.16607811461478,0.3907363220863019,0.7151927071363218,0.15579216281166586,1170124.7618415134,4785.557468103179,1174910.3193096167,3077,42,1402.849710982659,82,91,47,27.292663009502387,0.709349593495935,32.32931726907631,8743.017725387454,106.62216738277382,0
3079,32.623748660321205,0,1,172,0.0,0.005780346820809248,0.9942196531791907,173,5000,3600,1400,0.72,64,36,28,189.52293751358565,0.39015100595958235,0.7176045227533008,0.15751051573870423,1169658.5628400792,4735.425343473991,1174393.988183553,3078,43,1403.849710982659,72,101,48,27.145280471775198,0.7149884259259259,32.22031963470319,8735.976988578572,121.33301373025795,0
3080,32.91183166130589,0,2,170,0.0,0.011627906976744186,0.9883720930232558,172,4150,2700,1450,0.6506024096385542,56,27,29,186.38331267508192,0.38931105217824924,0.7113127251717983,0.15561277926717226,1181147.068034278,5479.220659337889,1186626.288693616,3079,44,1412.0523255813953,76,96,49,27.095325860095578,0.7143640350877193,32.08874458874459,8817.450138264374,116.01908076663649,0
3081,32.37940731843747,0,0,170,0.0,0.0,1.0,170,4750,3200,1550,0.6736842105263158,63,32,31,185.4953686511541,0.3886457245620141,0.7063523854729854,0.15527215290222596,1162681.1277410097,4384.392882811476,1167065.520623821,3080,45,1408.664705882353,78,92,47,27.043765990946643,0.7142094017094017,32.01476793248944,8677.202984439891,111.24619210820373,0
3082,32.78857432416563,0,0,170,0.0,0.0,1.0,170,5100,3600,1500,0.7058823529411765,66,36,30,185.0228107458609,0.3881265227984685,0.7060939889723516,0.1553982881872767,1178217.5866435624,4499.425910199221,1182717.0125537617,3081,46,1409.664705882353,80,90,45,26.95860916562729,0.7143229166666667,31.91872427983538,8790.002833867735,109.87503542334669,0
3083,32.7884932085961,0,0,170,0.0,0.0,1.0,170,4900,3600,1300,0.7346938775510204,62,36,26,183.22287705162532,0.38778860656688713,0.7036355327629558,0.15437360222858706,1179006.0838699883,4304.177349605673,1183310.261219594,3082,47,1410.664705882353,80,90,49,26.915192058696576,0.715234375,31.82870370370369,8792.932727351488,109.9116590918936,0
3084,32.34900678400428,0,0,170,0.0,0.0,1.0,170,3100,2000,1100,0.6451612903225806,42,20,22,181.56881808234544,0.3872396739760993,0.7000652597746908,0.15349270189821676,1164027.974714548,5170.236716741177,1169198.2114312893,3083,48,1411.664705882353,83,87,50,26.862750196459107,0.7149849397590362,31.73363095238094,8678.15059224159,104.5560312318264,0
3085,32.26137441892,0,0,170,0.0,0.0,1.0,170,3800,2700,1100,0.7105263157894737,49,27,22,181.28639078220118,0.386987324515605,0.7003414472360714,0.15358946451625902,1161411.3464556935,4309.614242489719,1165720.9606981832,3084,49,1412.664705882353,83,87,49,26.80719875527619,0.7156124497991968,31.67162698412697,8656.642109084678,104.2968928805383,0
3086,32.38383962484885,0,0,170,0.0,0.0,1.0,170,4250,3200,1050,0.7529411764705882,53,32,21,182.05706530970414,0.3864935027265344,0.7026359650519667,0.15495824867604735,1166958.0891567827,4240.593010260643,1171198.6821670434,3085,50,1413.664705882353,85,85,42,26.65320640077002,0.7161764705882353,31.540697674418595,8693.742992310412,102.27932932129896,0
3087,32.79537199889775,0,0,170,0.0,0.0,1.0,170,5350,4200,1150,0.7850467289719626,65,42,23,183.30744366989126,0.3859801021000116,0.7052280506248514,0.15642517421714697,1182427.668316408,3999.5586407260553,1186427.2269571342,3086,51,1414.664705882353,85,85,44,26.545632235754017,0.7169117647058824,31.468023255813943,8806.60607092491,103.60713024617542,0
3088,32.785331110746775,0,0,170,0.0,0.0,1.0,170,4550,3300,1250,0.7252747252747253,58,33,25,186.47899654003055,0.3855558939552152,0.7108624578655247,0.15971134722118424,1182966.3045225136,5569.673881605126,1188535.9784041187,3087,52,1415.664705882353,89,81,44,26.356276030446644,0.7165262172284644,31.365740740740726,8807.26313750497,98.95801278095472,0
3089,33.11732236775508,0,0,170,0.0,0.0,1.0,170,4500,3000,1500,0.6666666666666666,60,30,30,204.47545389874324,0.385186796612136,0.735954302565353,0.1619323519980196,1174846.271678625,9545.444932546628,1184391.7166111716,3088,53,1416.664705882353,82,88,37,28.18801828119108,0.6961382113821138,33.63453815261044,8821.310867635962,107.57696180043857,8
3090,33.487024058884785,0,0,170,0.0,0.0,1.0,170,4350,3000,1350,0.6896551724137931,57,30,27,204.9653022494792,0.3847988455737325,0.7370806972204815,0.162812918648227,1188767.9507083802,10381.236464287143,1199149.1871726674,3089,54,1417.664705882353,83,87,39,28.082726377189275,0.6966616465863453,33.54414682539681,8922.813565888562,107.50377790227184,0
3091,32.95684936317879,0,0,170,0.0,0.0,1.0,170,5300,3600,1700,0.6792452830188679,70,36,34,202.69821523473558,0.3842687666782689,0.7351486273067531,0.16162359156106845,1170937.629877232,8169.393545461038,1179107.0234226931,3090,55,1418.664705882353,84,86,40,28.028074046830938,0.6974206349206349,33.43137254901959,8785.262099851245,104.58645356965768,0
3092,32.869955559082264,0,1,169,0.0,0.0058823529411764705,0.9941176470588236,170,4400,3400,1000,0.7727272727272727,54,34,20,203.26381701369266,0.383771319178559,0.7358884458744421,0.16234554209380966,1168284.8931400678,9094.009347816711,1177378.9024878845,3091,56,1419.664705882353,85,85,40,27.962399297352945,0.6975490196078431,33.381782945736425,8763.728945815372,103.10269348018085,0
3093,32.653226307151925,0,1,168,0.0,0.005917159763313609,0.9940828402366864,169,4000,2900,1100,0.725,51,29,22,202.94189453124997,0.38346922842115155,0.7338202662721889,0.16235351562499994,1161003.6020320673,9323.254110798596,1170326.856142866,3092,57,1428.2366863905324,71,98,40,27.921549479166664,0.704225352112676,33.33333333333333,8707.527015240505,122.64122556676767,0
3094,32.66846096114403,0,1,167,0.0,0.005952380952380952,0.9940476190476191,168,4400,3100,1300,0.7045454545454546,57,31,26,201.24489133676227,0.38321274118429804,0.7297985877066284,0.1613844167206386,1162166.9078271058,8776.03061616923,1170942.9384432752,3093,58,1434.2619047619048,72,96,40,27.894020043153414,0.7044270833333333,33.26198630136985,8713.920387366776,121.02667204676078,0
3095,32.39861242435698,0,0,167,0.0,0.0,1.0,167,4000,3200,800,0.8,48,32,16,199.9199115497217,0.3826939494504966,0.724554326521059,0.16091584669479672,1153511.12527032,8721.968427132311,1162233.0936974525,3094,59,1443.0718562874251,74,93,39,27.81797047138223,0.7045326576576576,33.15277777777777,8645.479729294024,116.83080715262194,0
3096,31.971521819608355,0,0,167,0.0,0.0,1.0,167,5550,4000,1550,0.7207207207207207,71,40,31,199.3982202308593,0.3824113820551667,0.7240092358737658,0.16106119851885137,1139188.5954121826,6480.435686496257,1145669.031098679,3095,60,1444.0718562874251,76,91,41,27.72629182925387,0.7046326754385965,33.049242424242415,8534.821970594288,112.30028908676695,0
3097,31.900251244447222,0,0,167,0.0,0.0,1.0,167,4050,3100,950,0.7654320987654321,50,31,19,203.5632604658868,0.3821243056056562,0.727116518419664,0.16505085178046644,1137598.6565647325,8864.658326385623,1146463.314891118,3096,61,1445.0718562874251,78,89,40,27.501357756492535,0.7048611111111112,32.93776371308015,8519.35243545663,109.22246712123885,0
3098,32.13844588031779,0,1,166,0.0,0.005988023952095809,0.9940119760479041,167,4750,3000,1750,0.631578947368421,65,30,35,205.91915513552408,0.3818492533006277,0.729508134525374,0.16752772502262758,1146944.7214016072,9085.577603633363,1156030.2990052404,3097,62,1446.0718562874251,79,88,43,27.337175488189214,0.7054324894514767,32.83854166666665,8586.15406995257,108.68549455636165,0
3099,32.30137025263055,0,0,166,0.0,0.0,1.0,166,4800,3300,1500,0.6875,63,33,30,202.98849455875924,0.3814721005233053,0.7227492602665047,0.16572273717585245,1153641.7551462995,8835.200627454164,1162476.9557737536,3098,63,1438.6746987951808,81,85,41,27.311134480409383,0.7056327160493827,32.73628048780486,8632.984359058575,106.58005381553797,0
3100,32.11140019158543,0,0,166,0.0,0.0,1.0,166,3850,2300,1550,0.5974025974025974,54,23,31,202.83504962019018,0.38064911159790676,0.7235888729533222,0.16619991911955842,1147764.8049287545,9511.38623200622,1157276.1911607606,3099,64,1439.6746987951808,82,84,36,27.20733195644011,0.7063008130081301,32.6305220883534,8585.60830423612,104.70254029556244,0
3101,32.27729379056219,0,0,166,0.0,0.0,1.0,166,4100,2800,1300,0.6829268292682927,54,28,26,201.13346225349144,0.380398868200073,0.7209340585839057,0.1651660666505141,1154242.204601889,9131.346178136124,1163373.550780025,3100,65,1440.6746987951808,86,80,37,27.188078289159524,0.7054263565891472,32.56704980842912,8632.011902610117,100.37223142569903,0
3102,32.106276679997876,0,0,166,0.0,0.0,1.0,166,4300,3000,1300,0.6976744186046512,56,30,26,203.5462482920285,0.380070281124498,0.7241106195119693,0.16783927912670327,1149154.8804466971,9281.232924279851,1158436.1133709769,3101,66,1441.6746987951808,86,80,38,27.001383543661802,0.7066375968992248,32.44731800766283,8590.120434521448,99.88512133164475,0
3103,32.28669490931692,0,1,165,0.0,0.006024096385542169,0.9939759036144579,166,4900,3400,1500,0.6938775510204082,64,34,30,203.9952123880352,0.38001931970305464,0.7232766578434573,0.16865459374662387,1156272.4655249477,9074.80943663967,1165347.2749615875,3102,67,1442.6746987951808,91,75,38,26.91141889128626,0.7057005494505495,32.37092391304347,8640.858328481905,94.95448712617478,0
3104,32.52304268180826,0,0,165,0.0,0.0,1.0,165,4800,3400,1400,0.7083333333333334,62,34,28,200.72228413141067,0.37936221975856127,0.7161295672883805,0.16633916855766018,1165327.0119555353,8981.41991994936,1174308.4318754845,3103,68,1447.6666666666667,90,75,39,26.929840502864987,0.7067129629629629,32.303113553113555,8706.317263699271,96.73685848554746,0
3105,32.31296783442293,0,0,165,0.0,0.0,1.0,165,4900,3400,1500,0.6938775510204082,64,34,30,199.27685654992192,0.3791528085735403,0.7129830143928351,0.1659564752725463,1159025.513004169,8293.392178526274,1167318.9051826955,3104,69,1448.6666666666667,79,86,39,26.824056068708494,0.712289029535865,32.161458333333336,8654.658181693747,109.55263521131324,0
3106,32.53346361442841,0,0,165,0.0,0.0,1.0,165,4400,3000,1400,0.6818181818181818,58,30,28,196.838854815949,0.378640059127864,0.7098296289591974,0.1645628999061759,1167903.1798511727,8577.744891562064,1176480.9247427348,3105,70,1449.6666666666667,81,84,42,26.776013764440034,0.7125771604938271,32.050304878048784,8717.331656747197,107.62137847836047,0
3107,32.30071981274196,0,0,165,0.0,0.0,1.0,165,5150,3900,1250,0.7572815533980582,64,39,25,194.80297626562276,0.3782258561221976,0.7077749404153895,0.16356098950604203,1160609.3121131945,7068.0296562495605,1167677.341769444,3106,71,1450.6666666666667,82,83,38,26.705582865168548,0.7134146341463414,31.9277108433735,8658.927901608553,105.59668172693357,0
3108,32.15337106289974,0,0,165,0.0,0.0,1.0,165,3600,2600,1000,0.7222222222222222,46,26,20,194.64920832092866,0.37793945553091896,0.7080491861626179,0.163875310783772,1155980.5624223356,8402.140261977875,1164382.7026843135,3107,72,1451.6666666666667,84,81,43,26.6309812165806,0.7134176587301587,31.85049019607843,8621.910689060152,102.64179391738277,0
3109,31.76066619456992,0,0,165,0.0,0.0,1.0,165,3650,2500,1150,0.684931506849315,48,25,23,197.27947205261773,0.3773789726533629,0.7117555598937242,0.16651969937584438,1142488.3126230796,8427.898228113409,1150916.210851193,3108,73,1452.6666666666667,84,81,41,26.48547082743181,0.7141617063492063,31.776960784313722,8518.942414222442,101.41598112169574,0
3110,32.16819647155067,0,1,164,0.0,0.006060606060606061,0.9939393939393939,165,3750,2500,1250,0.6666666666666666,50,25,25,195.13433877507018,0.37731276176398126,0.7095165254560731,0.14817967194663892,1130280.0643967995,7361.290599342596,1137641.3549961422,3109,74,1453.6666666666667,77,88,45,29.73635600335854,0.6853354978354979,34.909188034188034,8527.49332211913,110.74666652102766,8
3111,31.705523138858613,0,0,164,0.0,0.0,1.0,164,4900,3200,1700,0.6530612244897959,66,32,34,194.76763327422796,0.3768228776996359,0.7077278619701122,0.14844112952044505,1114966.92980566,5731.894019456102,1120698.823825116,3110,75,1461.4329268292684,78,86,38,29.63164371302143,0.686030982905983,34.79694092827004,8408.401725894819,107.80002212685665,0
3112,31.301319968790636,0,0,164,0.0,0.0,1.0,164,3700,2500,1200,0.6756756756756757,49,25,24,194.22725096462804,0.3762375928974014,0.7068919232151973,0.14814137662331706,1100945.8343042436,6266.7365715744345,1107212.570875818,3111,76,1462.4329268292684,80,84,38,29.622244310835246,0.6854166666666667,34.77366255144033,8301.934452627811,103.77418065784764,0
3113,31.785747009029453,0,0,164,0.0,0.0,1.0,164,3500,2700,800,0.7714285714285715,43,27,16,191.68411816777856,0.376126147189386,0.7020842346727225,0.14652463948079397,1118555.8351874782,6581.877777867177,1125137.7129653455,3112,77,1463.4329268292684,84,80,38,29.620615453313608,0.6845238095238095,34.70588235294119,8432.571706513141,100.38775841087073,0
3114,31.833774104930885,0,0,164,0.0,0.0,1.0,164,4900,3800,1100,0.7755102040816326,60,38,22,182.1124904596822,0.37610354631153675,0.6947586363875127,0.13281816712583133,1107879.4896432222,2651.738597625841,1110531.228240848,3113,78,1464.4329268292684,76,88,48,31.369645848289082,0.6729714912280702,36.174242424242436,8398.56956972895,110.50749433853882,8
3115,32.0538532452054,0,0,164,0.0,0.0,1.0,164,4100,2800,1300,0.6829268292682927,54,28,26,182.05778558994646,0.3762843533343309,0.6940039556477369,0.13317455339611087,1116339.6483808197,3747.664870094459,1120087.3132509142,3114,79,1465.4329268292684,76,88,47,31.27466810190169,0.6739309210526316,36.07954545454547,8459.667518407936,111.31141471589389,0
3116,32.35076356137869,0,0,164,0.0,0.0,1.0,164,5100,3500,1600,0.6862745098039216,67,35,32,181.49107982766824,0.3762017432290887,0.6941640130174604,0.13315713962093215,1127488.8153545337,3025.83251846283,1130514.6478729965,3115,80,1466.4329268292684,76,88,50,31.193208990913448,0.674890350877193,35.984848484848506,8541.09174328829,112.38278609589857,0
3117,32.55859577434877,0,0,164,0.0,0.0,1.0,164,4850,4000,850,0.8247422680412371,57,40,17,179.65094295650823,0.37624304828170985,0.6913404283818168,0.1321972221682177,1135536.0336423535,3150.023840988788,1138686.0574833422,3116,81,1467.4329268292684,78,86,50,31.146613413213565,0.6749465811965811,35.891350210970494,8599.006768990124,110.24367652551442,0
3118,32.305245512990574,0,0,164,0.0,0.0,1.0,164,3200,2200,1000,0.6875,42,22,20,181.10512635497236,0.3758323357773455,0.6941260274172685,0.13376946653252142,1127712.7539764014,4846.912160202146,1132559.6661366036,3117,82,1468.4329268292684,78,86,41,30.987387095164486,0.6761485042735043,35.77267932489453,8535.928465649013,109.43498032883349,0
3119,32.15284055800285,0,0,164,0.0,0.0,1.0,164,4150,3000,1150,0.7228915662650602,53,30,23,182.12742721611227,0.37580272083395677,0.6947455288958941,0.1347663284799656,1122872.9365830391,3951.1918060942526,1126824.1283891334,3118,83,1469.4329268292684,79,85,41,30.902811991920025,0.676292194092827,35.71614583333336,8497.476625075373,107.56299525411865,0
3120,31.65418484884586,1,0,165,0.006060606060606061,0.0,1.0,165,5100,3600,1500,0.7058823529411765,66,36,30,180.2283017932812,0.3771279871889628,0.6935180131202969,0.13414991115603692,1107007.8435376058,1802.828742525347,1108810.6722801311,3119,0,1461.521212121212,81,84,45,30.764515986999044,0.6773405349794239,35.53099593495938,8371.55074146504,103.35247828969186,0
3121,32.09039172761776,0,0,165,0.0,0.0,1.0,165,3100,2000,1100,0.6451612903225806,42,20,22,178.80525676743235,0.3770032643508254,0.6915801594866051,0.133417203801796,1122913.6982611804,4056.5744290518633,1126970.2726902324,3120,1,1462.521212121212,82,83,45,30.724101396334454,0.6777184959349594,35.454317269076334,8489.374588685503,103.52895839860369,0
3122,32.34302324713959,0,1,164,0.0,0.006060606060606061,0.9939393939393939,165,3850,2800,1050,0.7272727272727273,49,28,21,181.0686118247517,0.3767261024882976,0.6933295166304867,0.13557023176112576,1132670.3461081467,4168.209444972758,1136838.5555531194,3121,2,1463.521212121212,74,91,49,30.555191113443506,0.6822916666666667,35.34722222222223,8559.670944086756,115.67122897414535,0
3123,32.704686100385395,0,0,164,0.0,0.0,1.0,164,4050,2800,1250,0.691358024691358,53,28,25,180.70614345784486,0.37647217442266445,0.6912856610857927,0.1355402750162563,1145816.8820880144,4561.229974203549,1150378.112062218,3122,3,1460.9329268292684,74,90,45,30.50822446088461,0.6828547297297297,35.29166666666667,8657.20294982287,116.9892290516604,0
3124,33.15225631887426,0,0,164,0.0,0.0,1.0,164,5500,3900,1600,0.7090909090909091,71,39,32,184.73255306225147,0.37656647463713905,0.6974619026360187,0.1390562806647434,1162472.89700811,4649.31722599598,1167122.214234106,3123,4,1461.9329268292684,74,90,46,30.288478348280606,0.6839808558558558,35.18055555555556,8779.36210044411,118.64002838437986,0
3125,33.43214474875834,0,0,164,0.0,0.0,1.0,164,4300,2900,1400,0.6744186046511628,57,29,28,183.97716245997984,0.37605444785276076,0.6957958124697139,0.1389027576572847,1173109.1603823304,6065.058916590098,1179174.2192989206,3124,5,1462.9329268292684,75,89,49,30.213938327814564,0.6844444444444444,35.08771929824561,8856.585714144745,118.08780952192993,0
3126,33.749518907111394,0,1,163,0.0,0.006097560975609756,0.9939024390243902,164,3550,2300,1250,0.647887323943662,48,23,25,185.77687080424005,0.3754800738191431,0.6994333265264441,0.1406104074696081,1184933.192151025,7676.6361099793885,1192609.8282610043,3125,6,1463.9329268292684,76,88,53,30.087936491729657,0.6847587719298245,35.010822510822514,8943.257255850904,117.67443757698557,0
3127,33.42459357238475,0,0,163,0.0,0.0,1.0,163,4200,3100,1100,0.7380952380952381,53,31,22,187.76616630509824,0.37569270872781435,0.6997673496969616,0.1423379425703202,1173952.2757609813,7285.703648957004,1181237.9794099382,3126,7,1470.0490797546013,77,86,51,29.98610131344687,0.6847943722943723,34.96260683760684,8858.767147937344,115.04892399918629,0
3128,32.85777399332907,0,1,162,0.0,0.006134969325153374,0.9938650306748467,163,4150,2700,1450,0.6506024096385542,56,27,29,188.1695582152914,0.3755301825342725,0.7013797196619593,0.14292213705774184,1154568.3514349088,6700.923323772771,1161269.2747586817,3127,8,1471.0490797546013,78,85,48,29.914096825002083,0.6849626068376069,34.90242616033755,8710.516167403479,111.6732841974805,0
3129,32.879434053723976,0,0,162,0.0,0.0,1.0,162,3500,2300,1200,0.6571428571428571,47,23,24,191.19725058147094,0.375291548449761,0.7046293568438313,0.14562166063359144,1156067.9909179856,8307.404269752693,1164375.3951877384,3128,9,1476.4197530864199,79,83,51,29.747495826377282,0.6853902953586498,34.81770833333333,8719.043671069556,110.36764140594374,0
3130,32.437124821863954,0,0,162,0.0,0.0,1.0,162,4250,2400,1850,0.5647058823529412,61,24,37,190.90784417542304,0.37479152288934897,0.7054311651642284,0.1459147060946569,1141448.1912801368,6932.282687045259,1148380.473967182,3129,10,1477.4197530864199,80,82,39,29.644755764538598,0.6860677083333333,34.70936213991769,8605.26553433937,107.56581917924214,0
3131,32.73493375960443,0,0,162,0.0,0.0,1.0,162,3900,3200,700,0.8205128205128205,46,32,14,191.87557788000365,0.374499974439588,0.7062589501592498,0.14697795916154724,1152515.0352409638,7927.897680450547,1160442.9329214143,3130,11,1478.4197530864199,81,81,39,29.550191887277204,0.6863425925925926,34.641768292682926,8686.48413750478,107.24054490746641,0
3132,33.175756361442346,0,0,162,0.0,0.0,1.0,162,4150,2800,1350,0.6746987951807228,55,28,27,193.81692056363408,0.3741229583620888,0.7100726058838174,0.14892757418690622,1168873.5318257757,8759.49369336226,1177633.025519138,3131,12,1479.4197530864199,84,78,40,29.40163196528322,0.6861359126984127,34.54656862745099,8806.618364524566,104.84069481576864,0
3133,33.53474033365239,0,0,162,0.0,0.0,1.0,162,4500,3400,1100,0.7555555555555555,56,34,22,194.62211106611434,0.37371958310967973,0.7111269614835936,0.14992318665642496,1182205.9325282075,9116.682860705023,1191322.6153889126,3132,13,1480.4197530864199,87,75,41,29.301890156918695,0.685823754789272,34.46969696969698,8904.489762837284,102.3504570441067,0
3134,33.49067582887958,0,0,162,0.0,0.0,1.0,162,4200,3200,1000,0.7619047619047619,52,32,20,195.1038015645541,0.37345838764920886,0.7126523776989568,0.1508347323282578,1181625.3088340478,9507.917955682384,1191133.2267897301,3133,14,1481.4197530864199,70,92,43,29.177597665598892,0.6943452380952381,34.360328638497634,8896.452120858135,127.09217315511621,0
3135,33.8205291841551,0,1,161,0.0,0.006172839506172839,0.9938271604938271,162,3250,1900,1350,0.5846153846153846,46,19,27,192.79775996766676,0.37334496332080874,0.7083482921451036,0.14960250351128537,1194269.855330184,10400.51058091369,1204670.3659110977,3134,15,1482.4197530864199,73,89,45,29.124677772480844,0.6939212328767124,34.2483108108108,8987.862759961467,123.12140767070503,0
3136,33.346911975733676,0,0,161,0.0,0.0,1.0,161,4350,3200,1150,0.735632183908046,55,32,23,192.84393674560067,0.37315929089026917,0.7067378345202691,0.1499861985792387,1178169.309442698,8890.561557154986,1187059.8709998531,3135,16,1479.9937888198758,73,88,44,29.051710442702806,0.694634703196347,34.17792792792792,8864.345238594498,121.42938683006162,0
3137,33.590116091536544,0,0,161,0.0,0.0,1.0,161,3850,3000,850,0.7792207792207793,47,30,17,193.11946566271052,0.37246215062111804,0.7038008327493319,0.15076816743437485,1187780.6725304811,9826.713760716242,1197607.3862911973,3136,17,1480.9937888198758,76,85,46,28.928108149353967,0.6943530701754386,34.06385281385281,8932.826056918624,117.53718495945559,0
3138,33.87383703925276,0,0,161,0.0,0.0,1.0,161,3700,2300,1400,0.6216216216216216,51,23,28,192.48889896572868,0.37257375776397517,0.7025642953328814,0.1506131802770839,1198422.737474711,10236.614646400249,1208659.3521211112,3137,18,1481.9937888198758,76,85,46,28.875934496262023,0.6950383771929824,33.99621212121212,9010.568962430008,118.56011792671063,0
3139,33.31162024268566,0,0,161,0.0,0.0,1.0,161,4300,3000,1300,0.6976744186046512,56,30,26,193.1355096332137,0.3721014492753623,0.703739878829059,0.15180090056218,1179732.6188144393,9069.652113130447,1188802.2709275698,3138,19,1482.9937888198758,78,83,45,28.720665708812273,0.6955128205128205,33.860759493670884,8865.529311423612,113.66063219773862,0
3140,33.357461777224835,0,0,161,0.0,0.0,1.0,161,4750,3400,1350,0.7157894736842105,61,34,27,198.65497978306274,0.37179736024844723,0.7097464011119863,0.15671670627330514,1182339.5963835262,10025.529723256812,1192365.126106783,3139,20,1483.9937888198758,79,82,47,28.460811163275967,0.6962025316455696,33.75,8881.424198186112,112.4230911162799,0
3141,33.48107126276646,0,0,161,0.0,0.0,1.0,161,3750,2700,1050,0.72,48,27,21,200.86450558834528,0.3716064958592133,0.7120385812322261,0.1589646455957283,1187569.3574904965,11758.106368839355,1199327.4638593358,3140,21,1484.9937888198758,80,81,35,28.30490641044211,0.6967447916666667,33.654835390946495,8917.521436768964,111.46901795961205,0
3142,33.66950610635114,0,0,161,0.0,0.0,1.0,161,4050,2700,1350,0.6666666666666666,54,27,27,198.01024262665857,0.3712296195652174,0.708537078302327,0.15726106925763578,1195199.817937038,11082.361187410155,1206282.179124448,3141,22,1485.9937888198758,81,80,38,28.273291617004368,0.6974022633744856,33.54928861788618,8971.26385392168,110.7563438755763,0
3143,33.16234362577409,0,0,161,0.0,0.0,1.0,161,4750,3400,1350,0.7157894736842105,61,34,27,196.4282630183766,0.3707848084886128,0.7060579209465929,0.15655958772124196,1178130.3897973252,9333.621215410105,1187464.0110127353,3142,23,1486.9937888198758,84,77,41,28.207706925352074,0.697296626984127,33.44362745098038,8839.634022110407,105.23373835845723,0
3144,32.74433932684084,0,0,161,0.0,0.0,1.0,161,5150,4100,1050,0.7961165048543689,62,41,21,199.2797851562499,0.37078642598343686,0.709918478260869,0.1594238281249999,1164243.1760654515,9052.025999190566,1173295.202064642,3143,24,1487.9937888198758,72,89,41,28.019205729166657,0.7037037037037037,33.33333333333333,8731.823820490885,121.27533084015118,0
3145,32.53856085539477,0,0,161,0.0,0.0,1.0,161,3750,2700,1050,0.72,48,27,21,197.55224413554762,0.3705567417184265,0.7072302960863535,0.15864449707020767,1157903.948471951,9799.30470280911,1167703.2531747601,3144,25,1488.9937888198758,73,88,42,27.950436189672164,0.704337899543379,33.22072072072072,8680.613813787188,118.91251799708476,0
3146,32.392569524078084,0,0,161,0.0,0.0,1.0,161,4200,3000,1200,0.7142857142857143,54,30,24,195.60369226539297,0.3703723473084886,0.7048490134328813,0.15751589870860258,1153416.0323761483,8722.486930174888,1162138.5193063233,3145,26,1489.9937888198758,74,87,43,27.91898702335103,0.7046734234234234,33.138888888888886,8644.317094939386,116.81509587755927,0
3147,32.40363153460568,0,0,161,0.0,0.0,1.0,161,4900,3600,1300,0.7346938775510204,62,36,26,207.86501080190203,0.3702025103519669,0.7315101740015901,0.15806790001952536,1138922.8424699157,10248.441790508277,1149171.284260424,3146,27,1490.9937888198758,69,92,44,29.35486473592634,0.6897644927536232,34.866071428571416,8591.302128751007,124.51162505436243,8
3148,32.18665693103532,0,0,161,0.0,0.0,1.0,161,4200,3000,1200,0.7142857142857143,54,30,24,204.2128256957344,0.3698984213250518,0.7264051464158061,0.15585185397265003,1132244.0993463807,9843.75338096932,1142087.85272735,3147,28,1491.9937888198758,73,88,39,29.33842585221746,0.6887842465753424,34.75506756756757,8537.347642898358,116.9499677109364,0
3149,32.569217039046215,0,0,161,0.0,0.0,1.0,161,3950,3200,750,0.810126582278481,47,32,15,203.1635984849575,0.3695700698757764,0.7251381433949529,0.15540696039953256,1146309.6891894906,10427.680286782066,1156737.3694762727,3148,29,1492.9937888198758,73,88,39,29.294443265421613,0.6894977168949772,34.68468468468469,8641.1120882875,118.37139846969178,0
3150,32.400823082456824,0,0,161,0.0,0.0,1.0,161,4000,2800,1200,0.7,52,28,24,204.71431930560863,0.36933391563146994,0.727635863799482,0.15688107103859072,1140866.9621023817,10510.360713009353,1151377.322815391,3149,30,1493.9937888198758,73,88,40,29.19584129004882,0.6900684931506849,34.62837837837838,8598.258963266837,117.78436935981968,0
3151,32.15137017191492,0,0,161,0.0,0.0,1.0,161,4050,2700,1350,0.6666666666666666,54,27,27,204.09194502234806,0.3692287784679089,0.7263203904377409,0.15676422840270554,1132684.0542026418,9984.338343603193,1142668.3925462451,3150,31,1494.9937888198758,73,88,40,29.140537996499976,0.6907819634703196,34.5579954954955,8534.324145999435,116.90854994519775,0
3152,32.340199707334186,0,0,161,0.0,0.0,1.0,161,3650,2700,950,0.7397260273972602,46,27,19,202.36848185217028,0.36899747670807453,0.7235111913652961,0.15587754375704244,1140072.9026597277,10292.964502409244,1150365.867162137,3151,32,1495.9937888198758,74,87,40,29.09877689437524,0.6911599099099099,34.47222222222222,8587.22136117799,116.04353190781067,0
3153,31.97362887505313,0,0,161,0.0,0.0,1.0,161,4850,3700,1150,0.7628865979381443,60,37,23,200.03732561762922,0.3684669384057971,0.7200926014386249,0.154505619637157,1127861.029517701,8072.860802613371,1135933.8903203143,3152,33,1496.9937888198758,76,85,41,29.075307290075024,0.6910635964912281,34.38852813852814,8492.562626255318,111.74424508230682,0
3154,32.447660439685684,0,0,161,0.0,0.0,1.0,161,3550,2400,1150,0.676056338028169,47,24,23,203.63710325295145,0.3682307841614907,0.7238259494396186,0.15767329994728502,1145227.1387692003,10892.147421125062,1156119.2861903254,3153,34,1497.9937888198758,67,94,41,28.903367158671596,0.6965174129353233,34.31372549019607,8620.89801877922,128.67011968327193,0
3155,32.15403072268759,0,0,161,0.0,0.0,1.0,161,4400,3100,1300,0.7045454545454546,57,31,26,201.5360572603972,0.36828416149068327,0.7208919395149773,0.15657396775676172,1135738.692296675,9178.459624710264,1144917.1519213852,3154,35,1498.9937888198758,69,92,41,28.854709049511946,0.6964070048309179,34.21130952380952,8546.177719314323,123.85764810600467,0
3156,31.9087318003115,0,0,161,0.0,0.0,1.0,161,4250,2900,1350,0.6823529411764706,56,29,27,200.8618973947797,0.3680852096273292,0.7200677570822231,0.15641677880063612,1127676.9546538445,8851.466552027587,1136528.421205872,3155,36,1499.9937888198758,70,91,43,28.800148998399656,0.696577380952381,34.14025821596244,8483.24719708692,121.18924567267027,0
3157,31.580189913690713,0,0,161,0.0,0.0,1.0,161,4550,3100,1450,0.6813186813186813,60,31,29,199.23102618464935,0.36811755952380953,0.7179021455329777,0.15572547556881755,1117010.6284359011,7758.6347524888415,1124769.26318839,3156,37,1500.9937888198758,71,90,41,28.72878590078327,0.6971830985915493,34.02777777777777,8399.453289544113,118.30215900766358,0
3158,31.521981380631622,0,0,161,0.0,0.0,1.0,161,3850,2600,1250,0.6753246753246753,51,26,25,199.25745332678386,0.3676436335403727,0.7183053490191431,0.1560454025456941,1115436.9933427158,8401.826927990822,1123838.8202707067,3157,38,1501.9937888198758,71,90,44,28.66905953157857,0.6977699530516432,33.969907407407405,8385.795625391398,118.10979754072392,0
3159,31.472435091963753,0,0,161,0.0,0.0,1.0,161,4000,2500,1500,0.625,55,25,30,200.71663597851233,0.3674705615942029,0.7201749183971524,0.15764636490127804,1114417.2059758618,8536.414532009392,1122953.620507871,3158,39,1502.9937888198758,73,88,44,28.5408952658027,0.6976312785388128,33.882319819819806,8375.371416294654,114.7311152917076,0
3160,31.813554262681837,0,1,160,0.0,0.006211180124223602,0.9937888198757764,161,5000,4000,1000,0.8,60,40,20,199.51624363804663,0.36737998188405796,0.7183311871938602,0.15731088440692093,1127479.0166041488,7790.0756347155175,1135269.0922388644,3159,40,1503.9937888198758,76,85,43,28.454437669376674,0.6973684210526316,33.76623376623375,8469.842368636044,111.44529432415847,0
3161,31.802652613613578,0,0,160,0.0,0.0,1.0,160,4850,3200,1650,0.6597938144329897,65,32,33,197.936834408471,0.36732344077568135,0.7144286456786453,0.15681254622431084,1128302.1990903586,7816.513108812391,1136118.712199171,3160,41,1507.1125,78,82,41,28.35084397584398,0.6979166666666667,33.62341772151898,8471.481910604178,108.60874244364331,0
3162,32.1293546733006,0,0,160,0.0,0.0,1.0,160,3550,2500,1050,0.704225352112676,46,25,21,199.1104007326107,0.3673357245807128,0.7160498407412774,0.15825725406906127,1140724.9082496096,9876.038721450115,1150600.9469710598,3161,42,1508.1125,80,80,41,28.220464745909958,0.698046875,33.526234567901234,8561.630120697808,107.02037650872259,0
3163,32.42831026752629,0,0,160,0.0,0.0,1.0,160,3800,2800,1000,0.7368421052631579,48,28,20,196.8377820543691,0.36728331367924527,0.7135448328267477,0.1568572360107998,1152005.930719643,9551.658463266707,1161557.5891829096,3162,43,1509.1125,80,80,41,28.202344767694306,0.698828125,33.44907407407407,8643.796128022332,108.04745160027915,0
3164,32.59155935410824,0,0,160,0.0,0.0,1.0,160,3700,2700,1000,0.7297297297297297,47,27,20,197.83454473330264,0.3670441889412998,0.7152383022823665,0.1579290068587988,1158259.039942684,10128.729970058572,1168387.7699127425,3163,44,1510.1125,81,79,42,28.122518304982478,0.6989454732510287,33.396849593495936,8689.01240046582,107.27175803044221,0
3165,32.39531467666362,0,0,160,0.0,0.0,1.0,160,4950,3500,1450,0.7070707070707071,64,35,29,206.14286172557587,0.36656593946540883,0.7223681144847212,0.1584106491518777,1141396.1754475923,10108.134793878828,1151504.310241471,3164,45,1511.1125,79,81,41,29.072090466146733,0.6881592827004219,34.544270833333336,8599.521879077362,108.85470733009318,8
3166,32.00247905764113,0,0,160,0.0,0.0,1.0,160,4050,2900,1150,0.7160493827160493,52,29,23,204.1107117511047,0.3665823178721174,0.7192500000000002,0.1570660484388102,1127914.1051320795,9993.870158523805,1137907.9752906032,3165,46,1512.1125,81,79,42,29.082934609250398,0.6877572016460906,34.5020325203252,8496.593144114573,104.89621165573547,0
3167,31.764739084568497,0,0,160,0.0,0.0,1.0,160,4750,3400,1350,0.7157894736842105,61,34,27,204.25734603306853,0.3662039766771488,0.7202317451795142,0.15777093742092646,1120502.010704985,9024.153386263324,1129526.1640912483,3166,47,1513.1125,83,77,44,28.962068334967377,0.6881275100401607,34.38740079365079,8437.11491136374,101.65198688390049,0
3168,32.1340263320677,0,0,160,0.0,0.0,1.0,160,4400,3200,1200,0.7272727272727273,56,32,24,201.07943641242235,0.3660623034591195,0.7156673699972773,0.1557496351629745,1134252.0059186686,9214.950819956943,1143466.9567386254,3167,48,1514.1125,71,89,41,28.96003493964968,0.6943955399061033,34.302662037037024,8537.925254462114,120.25246837270583,0
3169,32.56929410236464,0,0,160,0.0,0.0,1.0,160,3900,2600,1300,0.6666666666666666,52,26,26,199.2934174288129,0.36571180555555555,0.7127422685871638,0.15500234327535783,1150695.5357528205,9965.209148051457,1160660.744900872,3168,49,1515.1125,73,87,42,28.880269010802795,0.694634703196347,34.17792792792791,8657.637244215248,118.59777046870202,0
3170,32.71602128392566,0,0,160,0.0,0.0,1.0,160,4650,3500,1150,0.7526881720430108,58,35,23,196.44419646919152,0.36513282887840676,0.7093521516607497,0.15340593287080173,1156943.9813780957,8804.986156337138,1165748.967534433,3169,50,1516.1125,74,86,42,28.831231286122147,0.6953828828828829,34.055555555555536,8700.644104786179,117.57627168629972,0
3171,32.67621915925492,0,0,160,0.0,0.0,1.0,160,3750,2500,1250,0.6666666666666666,50,25,25,200.2780362055099,0.36504192872117397,0.7139874819699161,0.15701927458890735,1156572.1202032682,10577.198592870569,1167149.3187961387,3170,51,1517.1125,75,85,45,28.60773404766813,0.6961111111111111,33.93640350877192,8693.952389246904,115.91936518995873,0
3172,32.608959233893515,0,1,159,0.0,0.00625,0.99375,160,4450,3300,1150,0.7415730337078652,56,33,23,198.89336951021272,0.36502800707547167,0.7108902429726018,0.15632557963940966,1154846.3595636496,9488.256744043572,1164334.6163076933,3171,52,1518.1125,76,84,46,28.567601111506463,0.6964089912280702,33.860930735930744,8678.518060178416,114.19102710761074,0
3173,32.90269218056836,0,0,159,0.0,0.0,1.0,159,3600,2600,1000,0.7222222222222222,46,26,20,197.23555930068244,0.3644116710452989,0.7064878408473885,0.155364366239621,1165827.7974258491,10588.539534714124,1176416.3369605632,3172,53,1526.2704402515724,78,81,47,28.544318688394704,0.6961805555555556,33.7948312236287,8758.866725125206,112.29316314263085,0
3174,32.50254833238527,0,0,159,0.0,0.0,1.0,159,4750,3400,1350,0.7157894736842105,61,34,27,196.3491319530837,0.3642541066263301,0.704382834727608,0.15516740520496444,1152488.3530882245,8708.017542982556,1161196.370631207,3173,54,1527.2704402515724,79,80,35,28.469098376686865,0.6967299578059072,33.69791666666668,8655.496334556587,109.56324474122262,0
3175,32.22404747488351,0,0,159,0.0,0.0,1.0,159,3750,2800,950,0.7466666666666667,47,28,19,197.0204932168329,0.36414132367380514,0.7041757334576435,0.1558766664446841,1142907.5064817253,9485.240125650173,1152392.7466073753,3174,55,1528.2704402515724,81,78,35,28.41624534961366,0.6962448559670782,33.66361788617887,8582.436221524507,105.95600273487047,0
3176,32.19814696638051,0,0,159,0.0,0.0,1.0,159,4400,3400,1000,0.7727272727272727,54,34,20,198.25386957286958,0.3640102964201364,0.7055019675268848,0.15718646120274665,1142533.6303598261,9102.342667194825,1151635.973027021,3175,56,1529.2704402515724,81,78,36,28.31862055537012,0.6968878600823045,33.60010162601626,8577.583079674361,105.89608740338717,0
3177,32.571738592974164,0,0,159,0.0,0.0,1.0,159,3650,2400,1250,0.6575342465753424,49,24,25,199.478071295496,0.36419937372289896,0.7080315324522959,0.1583739511444799,1156144.9392639394,10675.112524483977,1166820.0517884234,3176,57,1530.2704402515724,82,77,37,28.244327994975684,0.696900406504065,33.55923694779118,8678.438884649147,105.8346205445018,0
3178,32.58315289930728,0,0,159,0.0,0.0,1.0,159,4850,3700,1150,0.7628865979381443,60,37,23,196.0624656663977,0.36418942228591145,0.702856550107718,0.15640227643536583,1157775.5210099884,8749.264667483287,1166524.7856774717,3177,58,1531.2704402515724,85,74,40,28.191450088600117,0.6971813725490197,33.41812015503876,8686.078151173124,102.18915471968381,0
3179,32.76146284822078,0,0,159,0.0,0.0,1.0,159,3150,1900,1250,0.6031746031746031,44,19,25,197.13678456159883,0.3642259108881989,0.7055056157563131,0.15758206002106231,1164642.8170307504,10968.788022440816,1175611.6050531913,3178,59,1532.2704402515724,86,73,41,28.100770842688192,0.6974321705426356,33.35727969348658,8735.605575070344,101.57680901244585,0
3180,33.1720093630459,0,0,159,0.0,0.0,1.0,159,4300,3000,1300,0.6976744186046512,56,30,26,194.60901967331452,0.3639887349733302,0.701608521516377,0.15605782115064107,1180071.9017334455,9830.527188074106,1189902.4289215195,3179,60,1533.2704402515724,73,86,41,28.07200687811143,0.7039098173515982,33.26295045045046,8848.203905128923,121.20827267299894,0
3181,33.19105179675432,0,0,159,0.0,0.0,1.0,159,4650,3700,950,0.7956989247311828,56,37,19,184.16662600418894,0.3638742934479739,0.6886351301934166,0.14141981059531927,1169236.205470159,6616.857392676007,1175853.062862835,3180,61,1534.2704402515724,86,73,44,29.67817297427339,0.6851986434108528,34.566570881226056,8810.01469447135,102.44203133106221,8
3182,33.228024977465616,0,0,159,0.0,0.0,1.0,159,4050,3000,1050,0.7407407407407407,51,30,21,184.52102954753911,0.3637581933497864,0.6878545325755325,0.14220577698720888,1171513.9323882274,7383.791386712675,1178897.72377494,3181,62,1535.2704402515724,89,70,44,29.55617363320693,0.6852762172284644,34.45601851851853,8823.502049282382,99.14047246384699,0
3183,32.85241046846709,0,0,159,0.0,0.0,1.0,159,3850,2900,950,0.7532467532467533,48,29,19,184.4410541296023,0.3637283390388239,0.6868331779266184,0.1425851926813806,1159094.4012229666,7106.918639456864,1166201.3198624235,3182,63,1536.2704402515724,77,82,44,29.462183483317407,0.6908820346320346,34.3616452991453,8726.860264800738,113.33584759481478,0
3184,33.01736681850881,0,0,159,0.0,0.0,1.0,159,3200,2300,900,0.71875,41,23,18,183.55799539763063,0.3638278534086989,0.6856865731868191,0.14233336980563485,1165722.5567901686,7795.5391428408075,1173518.0959330094,3183,64,1537.2704402515724,78,81,44,29.39181924940869,0.6913728632478633,34.26951476793249,8773.720905767517,112.48360135599381,0
3185,33.38785120566965,0,0,159,0.0,0.0,1.0,159,3950,2800,1150,0.7088607594936709,51,28,23,185.1046734807709,0.3637051190191864,0.6887616871189355,0.14419193743562378,1180035.2853690477,7936.009238805125,1187971.2946078528,3184,65,1538.2704402515724,80,79,44,29.209292670342784,0.6919270833333333,34.13065843621399,8876.806016281043,110.96007520351304,0
3186,33.20591761092079,0,0,159,0.0,0.0,1.0,159,4250,2900,1350,0.6823529411764706,56,29,27,184.2037470603338,0.36347291882281135,0.6874145033555699,0.14371737000424784,1174027.490826863,7202.052592429985,1181229.5434192931,3185,66,1539.2704402515724,81,78,42,29.184531202726163,0.6920010288065843,34.082825203252035,8830.023797629643,109.01263947690917,0
3187,32.728178903008384,0,0,159,0.0,0.0,1.0,159,4450,3100,1350,0.6966292134831461,58,31,27,186.6286872823527,0.36322413289812383,0.6897152011938474,0.14644989833616662,1158647.13490882,6997.358762298502,1165644.4936711185,3186,67,1540.2704402515724,84,75,45,28.943298177743,0.6925843253968254,33.9093137254902,8708.663584816444,103.67456648591005,0
3188,32.7388303403767,0,0,159,0.0,0.0,1.0,159,3800,2900,900,0.7631578947368421,47,29,18,183.70165590125916,0.36310471565427377,0.6857610086055981,0.14468337090236236,1159985.2445410765,7018.242048644592,1167003.4865897212,3187,68,1541.2704402515724,84,75,43,28.908863517785335,0.6937003968253967,33.799019607843135,8715.108733500769,103.75129444643773,0
3189,32.373286259837286,0,0,159,0.0,0.0,1.0,159,3900,2700,1200,0.6923076923076923,51,27,24,184.75660081161632,0.36302344558554256,0.6878869302467496,0.14575242952916406,1147455.956501998,6700.01242087026,1154155.9689228684,3188,69,1542.2704402515724,84,75,47,28.830855503390737,0.6941964285714286,33.75,8619.387466681676,102.61175555573423,0
3190,32.15490892366964,0,0,159,0.0,0.0,1.0,159,3700,3100,600,0.8378378378378378,43,31,12,190.70464742495636,0.3626187538147175,0.6927800792402803,0.14484840095866064,1129872.211918757,7594.376361844406,1137466.5882806014,3189,70,1543.2704402515724,80,79,46,29.846726334853347,0.6841145833333333,34.9022633744856,8524.193577064378,106.55241971330472,8
3191,32.073440297092,0,0,159,0.0,0.0,1.0,159,4100,3100,1000,0.7560975609756098,51,31,20,189.8045892642254,0.362389870764005,0.6914599654624305,0.14461170092992634,1127820.4265556105,6913.098565238369,1134733.5251208488,3190,71,1544.2704402515724,81,78,48,29.773424027591485,0.6846707818930041,34.8069105691057,8505.654721063198,105.00808297608886,0
3192,32.213619102066794,0,0,159,0.0,0.0,1.0,159,3900,2800,1100,0.717948717948718,50,28,22,188.9669134873927,0.362575630921105,0.690414361862012,0.1443309102942111,1133400.8540689046,7135.0522274751,1140535.9062963799,3191,72,1545.2704402515724,81,78,40,29.71797880151967,0.6854423868312758,34.730691056910565,8545.284477761152,105.49733923161915,0
3193,31.90903717713734,0,0,159,0.0,0.0,1.0,159,4750,3600,1150,0.7578947368421053,59,36,23,190.57296800414375,0.3624927022795425,0.6933891840859032,0.14620045228713266,1123828.3405850532,6284.260478493228,1130112.6010635465,3192,73,1546.2704402515724,84,75,41,29.53769758815473,0.6856398809523809,34.59558823529413,8468.7992419763,100.81903859495594,0
3194,31.751575111740873,0,0,159,0.0,0.0,1.0,159,4050,2500,1550,0.6172839506172839,56,25,31,189.08182930030597,0.3622356234906987,0.6910702590190099,0.1456553432302363,1119343.7041928265,6479.511040912223,1125823.2152337388,3193,74,1547.2704402515724,87,72,43,29.44900142653353,0.685823754789272,34.46969696969698,8431.005361110021,96.90810759896576,0
3195,32.21106933001899,0,1,158,0.0,0.006289308176100629,0.9937106918238994,159,3350,2300,1050,0.6865671641791045,44,23,21,189.1605786371783,0.36223894063636125,0.6917397952232194,0.14582915536585833,1135744.82758087,7817.629753876139,1143562.4573347461,3194,75,1548.2704402515724,87,72,44,29.422788327241403,0.6860632183908046,34.44602272727274,8553.777572794143,98.31928244590968,0
3196,31.803354610246924,0,0,158,0.0,0.0,1.0,158,4300,3400,900,0.7906976744186046,52,34,18,192.15229871860802,0.3614355733827837,0.6931386881330504,0.14895068433657127,1122779.5811998304,7248.9354963725955,1130028.516696203,3195,76,1557.2784810126582,75,83,43,29.17316801636837,0.6926388888888889,34.279057017543856,8450.817377040245,112.67756502720326,0
3197,32.279280920333626,0,0,158,0.0,0.0,1.0,158,4600,3400,1200,0.7391304347826086,58,34,24,192.97596135423964,0.3614683275551614,0.6939300817794742,0.14999530334840766,1140287.0707667011,7809.598740202828,1148096.669506904,3196,77,1558.2784810126582,75,83,44,29.06745775967271,0.6934722222222223,34.196820175438596,8579.935511074977,114.39914014766636,0
3198,32.10424830013124,0,0,158,0.0,0.0,1.0,158,3950,2500,1450,0.6329113924050633,54,25,29,192.80113368000124,0.3611349068773684,0.6919073276455687,0.15063544562282175,1135437.086516264,8232.711500530459,1143669.7980167943,3197,78,1559.2784810126582,80,78,47,28.91291120674371,0.6928385416666667,34.04063786008229,8538.425399884405,106.73031749855507,0
3199,32.22501053811938,0,0,158,0.0,0.0,1.0,158,4550,3400,1150,0.7472527472527473,57,34,23,191.67573557660114,0.36095097960170924,0.6907899446351686,0.15026825666329244,1140590.0213456473,7574.686266551538,1148164.7076121988,3198,79,1560.2784810126582,80,78,44,28.837989591892637,0.6938802083333333,33.93775720164608,8573.858577972598,107.17323222465748,0
3200,31.83378468149672,0,0,158,0.0,0.0,1.0,158,4050,2600,1450,0.6419753086419753,55,26,29,191.15840115139514,0.36054281222284934,0.6883279926148269,0.15034349928393456,1127558.4885077854,7458.4555735662,1135016.9440813516,3199,80,1561.2784810126582,81,77,47,28.753619383988813,0.6944444444444444,33.841463414634134,8472.83354480077,104.6028832691453,0
3201,31.38050372589726,0,0,158,0.0,0.0,1.0,158,3850,2600,1250,0.6753246753246753,51,26,25,193.02652089039162,0.36026734123464754,0.6902321480336273,0.15232815805205546,1112352.1557111358,7492.693324369336,1119844.8490355052,3200,81,1562.2784810126582,81,77,40,28.600310114503834,0.6954732510288066,33.73983739837397,8355.378024578304,103.15281511825066,0
3202,31.808455158382504,0,0,158,0.0,0.0,1.0,158,4300,3200,1100,0.7441860465116279,54,32,22,191.51993407334407,0.36006325754521756,0.6887385009914875,0.15173611798084022,1128520.1776873847,7326.822006225011,1135846.9996936098,3201,82,1563.2784810126582,82,76,44,28.520318021201412,0.696265243902439,33.62198795180721,8473.073051413974,103.33015916358505,0
3203,31.71890999583594,0,0,158,0.0,0.0,1.0,158,4000,2900,1100,0.725,51,29,22,191.74882033040186,0.3592200475691365,0.6864937372570621,0.152264530738626,1125918.4199914674,7578.70576432652,1133497.1257557939,3202,83,1564.2784810126582,84,74,44,28.444849446539706,0.6961805555555556,33.55392156862744,8451.379180508116,100.61165691081091,0
3204,31.68029586069856,0,0,158,0.0,0.0,1.0,158,4400,2700,1700,0.6136363636363636,61,27,34,194.87607168051142,0.3590352804429036,0.6909871392773255,0.1551394023609968,1125182.9356907562,7854.246085871815,1133037.181776628,3203,84,1565.2784810126582,85,73,44,28.284819426770905,0.6965686274509804,33.47868217054262,8443.474202020436,99.33499061200513,0
3205,31.836217731662376,0,1,157,0.0,0.006329113924050633,0.9936708860759493,158,3650,2400,1250,0.6575342465753424,49,24,25,195.34848070155857,0.35844402563895833,0.7028891515789555,0.14928691919991122,1120264.5851483159,8518.396938497033,1128782.9820868128,3204,85,1566.2784810126582,82,76,35,29.531530892231984,0.6852134146341464,34.713855421686745,8445.707459988438,102.99643243888339,8
3206,31.795236686627234,0,0,157,0.0,0.0,1.0,157,4250,3200,1050,0.7529411764705882,53,32,21,194.6365434046819,0.35845037835483695,0.6992915852094761,0.14935457139698105,1119883.775250774,7944.0614059593645,1127827.8366567334,3205,86,1571.9745222929937,87,70,37,29.42218208307319,0.6846264367816092,34.58806818181819,8438.835191614075,96.99810565073649,0
3207,31.65587336375516,0,0,157,0.0,0.0,1.0,157,3750,1900,1850,0.5066666666666667,56,19,37,195.00598830114993,0.35821390658174096,0.7012114884442164,0.14993646869988747,1115487.0096324123,8355.329350092601,1123842.338982505,3206,87,1572.9745222929937,88,69,39,29.350274079299282,0.6848958333333333,34.52715355805243,8403.774808481907,95.49744100547622,0
3208,31.658216081895766,0,0,157,0.0,0.0,1.0,157,3900,2600,1300,0.6666666666666666,52,26,26,196.3258231511476,0.35804548423975174,0.7039431040441482,0.15141835335136458,1116362.0961625627,8534.141492771292,1124896.237655334,3207,88,1573.9745222929937,89,68,40,29.219101837727905,0.6855102996254682,34.43287037037038,8407.381574063667,94.46496150633334,0
3209,31.240736896360602,0,0,157,0.0,0.0,1.0,157,3900,2700,1200,0.6923076923076923,51,27,24,195.26377808889342,0.3578787631335402,0.7014730603223471,0.15082891833471032,1102025.7351399171,7737.141718922228,1109762.8768588393,3208,89,1574.9745222929937,90,67,40,29.199976297190155,0.6856481481481482,34.3864468864469,8297.963128928044,92.19959032142272,0
3210,31.66656768264758,0,0,157,0.0,0.0,1.0,157,3650,2500,1150,0.684931506849315,48,25,23,197.61480108723205,0.3578175186455441,0.7049620264965493,0.15305146335217587,1117727.5214874495,9125.900365693366,1126853.4218531428,3209,90,1575.9745222929937,74,83,40,29.0550400766684,0.6928490990990991,34.30555555555555,8413.631107903435,113.69771767437074,0
3211,31.787244332684658,0,0,157,0.0,0.0,1.0,157,4350,3200,1150,0.735632183908046,55,32,23,196.40685147918427,0.3574823751973433,0.7019099959645039,0.15263903026123396,1122866.9495877312,8357.752439712443,1131224.7020274436,3210,91,1576.9745222929937,77,80,40,28.980922055301523,0.6925054112554112,34.201388888888886,8449.005394677115,109.72734278801448,0
3212,32.09844192117361,0,0,157,0.0,0.0,1.0,157,4200,2800,1400,0.6666666666666666,56,28,28,197.55882030328252,0.35729694049757743,0.703598826891656,0.15394123496743836,1134543.568059493,9227.817777702048,1143771.3858371952,3211,92,1577.9745222929937,77,80,40,28.868591675456667,0.6933170995670996,34.12126068376068,8534.293272017163,110.83497755866445,0
3213,31.798513587649932,0,1,156,0.0,0.006369426751592357,0.9936305732484076,157,4100,2600,1500,0.6341463414634146,56,26,30,195.19976844111426,0.35705026130981543,0.7001180840020964,0.15259646651154377,1124769.578579454,8410.952257663768,1133180.5308371177,3212,93,1578.9745222929937,79,78,41,28.831581158923644,0.6934335443037974,34.0234375,8457.659336652672,107.05897894497053,0
3214,31.627086788657987,0,0,156,0.0,0.0,1.0,156,4300,3000,1300,0.6976744186046512,56,30,26,193.06219017410544,0.35663082437275984,0.6942005666832329,0.15155489145729606,1119760.5696677405,7736.68561013165,1127497.255277872,3213,94,1581.8589743589744,82,74,41,28.760670659812277,0.6934705284552846,33.898092369477915,8416.028127257989,102.63448935680474,0
3215,31.66496948150456,0,0,156,0.0,0.0,1.0,156,4350,3100,1250,0.7126436781609196,56,31,25,195.5104744898548,0.35675144747725396,0.6974922828445012,0.1538283293420178,1121680.9890811327,8310.07648030034,1129991.065561433,3214,95,1582.8589743589744,83,73,44,28.62545036650519,0.6937751004016064,33.82936507936508,8428.285031634601,101.54560279077833,0
3216,31.94413931598021,0,0,156,0.0,0.0,1.0,156,3350,2200,1150,0.6567164179104478,45,22,23,196.48403884205584,0.35654724979321756,0.6987096865572282,0.1548773316329762,1132036.5948371491,9935.424454122263,1141972.0192912715,3215,96,1583.8589743589744,84,72,44,28.54360384827838,0.6939484126984127,33.77450980392157,8504.344148288654,101.2421922415316,0
3217,31.763817981702104,0,0,156,0.0,0.0,1.0,156,3900,2800,1100,0.717948717948718,50,28,22,193.14580334842404,0.3563206506754894,0.6927524809575738,0.15262385451104674,1126274.131563573,8407.024386279008,1134681.155949852,3216,97,1584.8589743589744,87,69,36,28.556816834837228,0.6936063218390804,33.70028409090909,8458.695704715354,97.22638741052131,0
3218,32.26583912924515,0,0,156,0.0,0.0,1.0,156,4350,3200,1150,0.735632183908046,55,32,23,193.81673518428713,0.3559889371381307,0.6939817944211613,0.15359571353740867,1144814.1918725565,8826.829812275353,1153641.0216848317,3217,98,1585.8589743589744,88,68,38,28.451230228470976,0.6941287878787878,33.61423220973783,8595.160329841057,97.67227647546656,0
3219,32.602333551893246,0,0,156,0.0,0.0,1.0,156,4000,2700,1300,0.675,53,27,26,194.04718880790531,0.35550213675213677,0.6943122279096887,0.15412983554428256,1157344.6279520951,9715.89430720711,1167060.5222593022,3218,99,1586.8589743589744,92,64,40,28.375684840332376,0.6935009057971014,33.54614695340502,8687.017393212245,94.4241021001331,0
3220,32.24979985123145,0,0,156,0.0,0.0,1.0,156,3800,2800,1000,0.7368421052631579,48,28,20,199.6582355037499,0.3554245933278191,0.7037003281079115,0.15913118611024465,1145706.740011516,10749.957223090425,1156456.6972346064,3219,100,1587.8589743589744,93,63,41,28.122141847509745,0.6942204301075269,33.4441489361702,8596.372845983138,92.43411662347461,0
3221,32.492533897476214,0,0,156,0.0,0.0,1.0,156,4000,2900,1100,0.725,51,29,22,201.35413377130465,0.3548051075268817,0.7067821618936716,0.1608476519840211,1154914.053743038,11309.343774347024,1166223.3975173852,3220,101,1588.8589743589744,95,61,42,28.008166476748595,0.6942982456140351,33.37673611111111,8663.265439765455,91.1922677870048,0
3222,32.665309042702155,0,0,156,0.0,0.0,1.0,156,3600,2600,1000,0.7222222222222222,46,26,20,201.02095390313295,0.3546112489660877,0.707129373934253,0.1610494063181934,1161806.1319932267,11909.475380757438,1173715.607373984,3221,102,1589.8589743589744,72,84,42,27.92910580849962,0.7041377314814814,33.290525114155244,8712.147421762915,121.00204752448492,0
3223,32.38880303059567,0,1,155,0.0,0.00641025641025641,0.9935897435897436,156,3300,1900,1400,0.5757575757575758,47,19,28,198.98426255076143,0.35472411772815,0.6881906365867678,0.15410295412054195,1143204.5734799018,10995.943799711069,1154200.5172796128,3222,103,1590.8589743589744,76,80,41,29.02049389002037,0.6918859649122807,34.3073593073593,8605.466606072743,113.22982376411504,7
3224,32.209396234529905,0,0,155,0.0,0.0,1.0,155,3650,2600,1050,0.7123287671232876,47,26,21,196.25758700093053,0.35454894567797796,0.6806241968290851,0.15244563318604054,1137647.5381122238,10004.392137490784,1147651.9302497145,3223,104,1595.6903225806452,78,77,39,29.00057465562004,0.6919070512820513,34.21677215189873,8560.71729825183,109.75278587502346,0
3225,32.34768020540936,0,0,155,0.0,0.0,1.0,155,4000,2900,1100,0.725,51,29,22,196.48562233243874,0.3543447144253596,0.6813522631208877,0.15280967542539917,1142850.6344940937,9910.743630318735,1152761.3781244124,3224,105,1596.6903225806452,79,76,39,28.95670054698342,0.6918512658227849,34.17968749999999,8598.670460851961,108.84392988420204,0
3226,32.55465786687385,0,0,155,0.0,0.0,1.0,155,3250,1800,1450,0.5538461538461539,47,18,29,198.33907730751824,0.35390483172741233,0.6817530864967922,0.1547643562477302,1151032.7958763253,11408.956536960475,1162441.752413286,3225,106,1597.6903225806452,80,75,37,28.80496985524069,0.6924479166666666,34.079218106995874,8656.960074218305,108.21200092772881,0
3227,32.15400818338173,0,0,155,0.0,0.0,1.0,155,4650,3700,950,0.7956989247311828,56,37,19,199.2194851165548,0.353534771679933,0.6836762204417726,0.15632315038642414,1138308.900956567,9704.662630431507,1148013.5635869985,3226,107,1598.6903225806452,82,73,39,28.609624092066763,0.6933434959349594,33.91064257028111,8555.839376305938,104.3395045890968,0
3228,32.34073232605069,0,1,154,0.0,0.0064516129032258064,0.9935483870967742,155,4500,3300,1200,0.7333333333333333,57,33,24,198.58175938640986,0.35365521575198994,0.682947399680762,0.15659487196623362,1146196.5764779034,10022.74655193213,1156219.3230298355,3227,108,1599.6903225806452,84,71,44,28.4752589182969,0.6940724206349207,33.76225490196077,8610.323649306965,102.50385296794006,0
3229,32.61896909075179,0,0,154,0.0,0.0,1.0,154,4400,3300,1100,0.75,55,33,22,197.548900585684,0.353217044393515,0.6797743945728503,0.1562275366640491,1156802.7457319328,10505.02212276866,1167307.7678547015,3228,109,1604.2987012987012,84,70,34,28.415278544696005,0.6949404761904762,33.67647058823528,8687.198974022245,103.41903540502673,0
3230,32.526305551787,0,0,154,0.0,0.0,1.0,154,3550,2900,650,0.8169014084507042,42,29,13,197.03643200233464,0.3531869818634525,0.6789438567797286,0.15628619985183323,1154285.6746216146,11137.266167769998,1165422.9407893845,3229,110,1605.2987012987012,85,69,36,28.338400772902908,0.6954656862745099,33.5876937984496,8665.408074267834,101.94597734432746,0
3231,32.02064544056709,0,0,154,0.0,0.0,1.0,154,4250,2700,1550,0.6352941176470588,58,27,31,199.65483650466575,0.35292968197379965,0.6816042888114562,0.15878243005150947,1137013.2374684415,10352.038406080308,1147365.2758745218,3230,111,1606.2987012987012,88,66,38,28.188271333831036,0.6951941287878788,33.50889513108613,8533.217182072436,96.96837706900496,0
3232,32.45247817679379,0,0,154,0.0,0.0,1.0,154,4500,3500,1000,0.7777777777777778,55,35,20,202.36302835653015,0.3528218105423988,0.6866693510354587,0.16145840402082312,1153180.1009100827,11372.203492130506,1164552.3044022133,3231,112,1607.2987012987012,91,63,38,28.017847030508943,0.6951694139194139,33.412590579710134,8651.42208641992,95.07057237824087,0
3233,32.68264480238825,0,0,154,0.0,0.0,1.0,154,3800,2600,1200,0.6842105263157895,50,26,24,205.13547647355975,0.35297035480859007,0.6906773352446478,0.1642583583752947,1162285.4104543952,13085.194294365843,1175370.604748761,3232,113,1608.2987012987012,76,78,41,27.83544266342025,0.7020285087719298,33.306277056277054,8716.256217996235,114.68758181573993,0
3234,33.10006416515259,0,0,154,0.0,0.0,1.0,154,4850,3600,1250,0.7422680412371134,61,36,25,204.5899687391888,0.3527440016410605,0.6918384944765741,0.1649924361441694,1178987.0433682709,12591.784469324582,1191578.8278375955,3233,114,1609.2987012987012,78,76,40,27.63540328689524,0.7032585470085471,33.09599156118143,8834.539805261305,113.26333083668341,0
3235,32.97288281631052,0,0,154,0.0,0.0,1.0,154,4200,3000,1200,0.7142857142857143,54,30,24,221.00379704863698,0.3525203010497128,0.7182789149115065,0.1577379032154,1141503.547075548,15455.323649636543,1156958.8707251844,3234,115,1610.2987012987012,78,76,43,31.051751352976535,0.6650641025641026,36.86708860759492,8676.25065245636,111.23398272379949,8
3236,33.3285085275118,0,0,154,0.0,0.0,1.0,154,4200,3200,1000,0.7619047619047619,52,32,20,223.57434416774055,0.35270509719039134,0.7212151032318135,0.16006796959669323,1154693.262150809,16631.95776005494,1171325.2199108638,3235,116,1611.2987012987012,80,74,36,30.881760222775913,0.665234375,36.76697530864196,8773.164108148605,109.66455135185757,0
3237,33.10027447461596,0,1,153,0.0,0.006493506493506494,0.9935064935064936,154,4800,3800,1000,0.7916666666666666,58,38,20,223.02750894041546,0.35299245961010667,0.7192722422681515,0.16030701245922038,1147892.3525126996,15602.31438253172,1163494.6668952312,3236,117,1612.2987012987012,85,69,38,30.76636733661409,0.6645833333333333,36.64001937984494,8717.287644156599,102.55632522537175,0
3238,33.372481867120314,1,0,154,0.006493506493506494,0.0,1.0,154,3900,2700,1200,0.6923076923076923,51,27,24,222.20736876689872,0.3538492417168888,0.7200091014107208,0.16038703076365513,1158513.2886832412,16786.03791195751,1175299.3265951988,3237,0,1596.3246753246754,87,67,41,30.650643905360855,0.6652298850574713,36.50568181818179,8793.45935561188,101.07424546680322,0
3239,32.829196754984686,0,0,154,0.0,0.0,1.0,154,3750,2700,1050,0.72,48,27,21,220.652536718853,0.35346108140225785,0.718603995503523,0.15964650914837655,1140316.847216299,15772.761000304128,1156089.608216603,3238,1,1597.3246753246754,70,84,41,30.613229427590692,0.6733630952380952,36.42899061032863,8652.824526163422,123.61177894519174,0
3240,32.6888805931504,0,0,154,0.0,0.0,1.0,154,4250,3300,950,0.7764705882352941,52,33,19,218.0601391006559,0.3533134213281272,0.7150873377692217,0.15834119901388627,1136436.8979739747,14512.317610264434,1150949.2155842392,3239,2,1598.3246753246754,71,83,41,30.56370935293902,0.6740023474178404,36.3136574074074,8619.611367053783,121.40297700075752,0
3241,32.28598960181233,0,1,153,0.0,0.006493506493506494,0.9935064935064936,154,4100,3000,1100,0.7317073170731707,52,30,22,222.64542936288058,0.35344251336898397,0.7192583732057407,0.16270242914979752,1124155.3092452032,15157.608299492058,1139312.9175446953,3240,3,1599.3246753246754,74,80,40,30.235745614035093,0.6745495495495495,36.111111111111114,8519.913922700487,115.13397192838497,0
3242,32.480477452256785,0,0,153,0.0,0.0,1.0,153,3950,1900,2050,0.4810126582278481,60,19,41,220.36911049599885,0.3532135076252723,0.7149099488709552,0.16158221722125005,1131843.033911608,15334.64852083864,1147177.6824324466,3241,4,1606.4575163398692,77,76,43,30.186623162012665,0.6742424242424243,36.0042735042735,8574.707241936585,111.35983431086474,0
3243,32.55003540768474,0,0,153,0.0,0.0,1.0,153,3950,2600,1350,0.6582278481012658,53,26,27,221.312324509487,0.3533532565072813,0.714485455639305,0.1628174783469689,1135176.5495872227,15695.712183561573,1150872.2617707844,3242,5,1607.4575163398692,79,74,44,30.053544429653748,0.6744462025316456,35.89843750000001,8596.515210599882,108.81664823544155,0
3244,32.95465312718884,0,0,153,0.0,0.0,1.0,153,4050,2700,1350,0.6666666666666666,54,27,27,220.63059983631655,0.353120341703933,0.7117994959680254,0.16276887494841727,1150053.2823986989,16097.389107870029,1166150.6715065688,3243,6,1608.4575163398692,81,72,45,29.981637976631216,0.6745113168724279,35.8104674796748,8706.274404041504,107.48486918569758,0
3245,32.986718472167475,0,0,153,0.0,0.0,1.0,153,4050,3000,1050,0.7407407407407407,51,30,21,219.02841264222997,0.35251297156289413,0.7095069515443493,0.16206255493394514,1151979.3925123967,15813.24354771019,1167792.6360601068,3244,7,1609.4575163398692,82,71,37,29.92934197612941,0.6750508130081301,35.717871485943775,8717.800170518356,106.31463622583361,0
3246,32.96448715829122,0,0,153,0.0,0.0,1.0,153,4050,3100,950,0.7654320987654321,50,31,19,221.149176315223,0.35251297156289413,0.7104594252208014,0.16398792995172481,1151798.657832485,16293.864892126654,1168092.5227246117,3245,8,1610.4575163398692,84,69,39,29.803420487382763,0.6749751984126984,35.64950980392157,8714.178339356615,103.74021832567398,0
3247,33.18299626704133,0,0,153,0.0,0.0,1.0,153,4400,3400,1000,0.7727272727272727,54,34,20,222.67856060072904,0.35209730822153423,0.7147684007570279,0.1655286439201314,1160110.7159642559,16666.356873680368,1176777.0728379362,3246,9,1611.4575163398692,86,67,41,29.684080446758735,0.6750242248062015,35.57231800766284,8774.502784454122,102.02910214481537,0
3248,32.81381680071733,0,0,153,0.0,0.0,1.0,153,4050,2800,1250,0.691358024691358,53,28,25,222.72007457565684,0.3523373896342163,0.715661109852878,0.16613870837144984,1148152.8897942342,16493.339447845647,1164646.22924208,3247,10,1612.4575163398692,89,64,44,29.571192101271734,0.6750936329588015,35.46296296296297,8680.469870337929,97.53336932963965,0
3249,33.26334407530742,0,0,153,0.0,0.0,1.0,153,4350,3300,1050,0.7586206896551724,54,33,21,219.14541530761053,0.35219584909987384,0.7105502235512036,0.16424684035447562,1165180.6968194537,16118.801542582245,1181299.498362036,3248,11,1613.4575163398692,71,82,45,29.51495171722694,0.6841255868544601,35.31539351851853,8804.295136830899,124.00415685677322,0
3250,32.89819230125382,0,0,153,0.0,0.0,1.0,153,4300,3000,1300,0.6976744186046512,56,30,26,215.78189444502033,0.352416222336888,0.7043204387435924,0.16205455183126063,1152940.1996547084,14856.724092662706,1167796.9237473712,3249,12,1614.4575163398692,75,78,43,29.539414647615114,0.6827777777777777,35.25219298245615,8709.72426659842,116.12965688797892,0
3251,33.304452716210534,0,0,153,0.0,0.0,1.0,153,3650,2700,950,0.7397260273972602,46,27,19,216.26671597579116,0.35249326338722625,0.7043095347789978,0.1630767939385025,1168285.6881380677,16282.261819027648,1184567.9499570953,3250,13,1615.4575163398692,78,75,45,29.398251858489324,0.6826923076923077,35.126582278481024,8821.46421628744,113.09569508060821,0
3252,32.76970455911376,0,0,153,0.0,0.0,1.0,153,4050,3200,850,0.7901234567901234,49,32,17,214.3349620038863,0.35232484806788217,0.7012295137262594,0.16187301918823663,1149947.9160473906,14644.808578493423,1164592.724625884,3251,14,1616.4575163398692,79,74,46,29.399922998787655,0.682753164556962,35.07812500000002,8681.41157499652,109.89128575944963,0
3253,32.913140685492955,0,0,153,0.0,0.0,1.0,153,3900,2900,1000,0.7435897435897436,49,29,20,214.96237069666716,0.3522388487558766,0.7016161274353119,0.16270373921380638,1155574.0159876703,15180.98599843598,1170755.0019861062,3252,15,1617.4575163398692,81,72,41,29.31387823585812,0.6826131687242798,35.010162601626035,8721.64779851864,107.67466417924246,0
3254,33.262035040025125,0,0,153,0.0,0.0,1.0,153,4750,3600,1150,0.7578947368421053,59,36,23,214.54970430765115,0.352416222336888,0.7023424656161028,0.16265861303324308,1168271.5433649695,14780.462835999719,1183052.0062009692,3253,16,1618.4575163398692,81,72,45,29.27291027607363,0.6831275720164609,34.95934959349595,8815.791400852226,108.83693087471883,0
3255,32.975738446583755,0,0,153,0.0,0.0,1.0,153,4100,3100,1000,0.7560975609756098,51,31,20,215.14496309339734,0.3519898090815274,0.7023580823933491,0.1637751778506987,1159313.1653195114,15184.077633271312,1174497.2429527827,3254,17,1619.4575163398692,83,70,42,29.128912765592617,0.683609437751004,34.833829365079374,8744.050287739365,105.35000346673934,0
3256,32.6703338513974,0,0,153,0.0,0.0,1.0,153,4450,3200,1250,0.7191011235955056,57,32,25,212.61251396525037,0.35170493636050915,0.6988294239644959,0.16226323174414353,1149260.0488738671,13819.413638180227,1163079.4625120473,3255,18,1620.4575163398692,84,69,34,29.11545924967661,0.6840277777777778,34.75490196078434,8665.645905387873,103.16245125461754,0
3257,32.721872539746045,0,0,153,0.0,0.0,1.0,153,3750,2600,1150,0.6933333333333334,49,26,23,213.76519764830763,0.35116744066047473,0.702181960617249,0.16381188231118657,1152162.9223125656,14908.46696224005,1167071.3892748056,3256,19,1621.4575163398692,85,68,35,28.95665974409299,0.6849264705882353,34.629360465116314,8683.424242651461,102.15793226648778,0
3258,32.93489877667232,0,0,153,0.0,0.0,1.0,153,3150,2100,1050,0.6666666666666666,42,21,21,189.4750086744061,0.351000816993464,0.6782095728025048,0.13919532760158895,1148204.2696305553,9761.202789647943,1157965.4724202033,3257,20,1622.4575163398692,82,71,47,30.940569550063387,0.6727642276422765,35.94377510040161,8696.665038418501,106.05689071242075,8
3259,32.861906040466934,0,0,153,0.0,0.0,1.0,153,3550,1900,1650,0.5352112676056338,52,19,33,188.04249472640214,0.3510402333447999,0.6753092421541618,0.13827876269659742,1145929.215619403,8946.677696988352,1154875.8933163914,3258,21,1623.4575163398692,83,70,45,30.946734911094385,0.6726907630522088,35.91269841269841,8678.41209124236,104.55918182219712,0
3260,33.087600916202625,0,0,153,0.0,0.0,1.0,153,3500,2300,1200,0.6571428571428571,47,23,24,186.71748722387568,0.3508109018461186,0.6719862574711042,0.13775686480398056,1154707.2720595107,9020.80806361761,1163728.0801231284,3259,22,1624.4575163398692,84,69,47,30.875912267680974,0.6733630952380952,35.80882352941176,8741.452212640883,104.06490729334385,0
3261,33.48590365745691,0,0,153,0.0,0.0,1.0,153,4350,3400,950,0.7816091954022989,53,34,19,188.019598016535,0.35071415262011235,0.6750675193953641,0.13940417207520733,1169982.742091124,9045.936970851151,1179028.679061975,3260,23,1625.4575163398692,87,66,37,30.683175114932247,0.6738505747126438,35.65340909090908,8851.88447535896,101.74579856734437,0
3262,33.286831453506046,1,0,154,0.006493506493506494,0.0,1.0,154,3400,2100,1300,0.6176470588235294,47,21,26,177.05052390176436,0.351885451150157,0.6610885307344483,0.12863712338256822,1157386.986083804,6783.194448644277,1164170.1805324482,3261,0,1615.8961038961038,82,72,43,31.626273082048378,0.6692073170731707,36.295180722891565,8777.897872754378,107.04753503358998,8
3263,33.05162733142982,0,1,153,0.0,0.006493506493506494,0.9935064935064936,154,3750,2400,1350,0.64,51,24,27,176.6188731317207,0.35183416801063855,0.6583328066662923,0.12883832198778075,1150320.8469793154,6083.674346682559,1156404.521325998,3262,1,1616.8961038961038,85,69,45,31.507858170354694,0.6693627450980393,36.16763565891472,8720.088984171543,102.58928216672405,0
3264,32.660341551539446,0,0,153,0.0,0.0,1.0,153,4350,3600,750,0.8275862068965517,51,36,15,175.97412727877648,0.35199339238619426,0.6555874775498094,0.1287724028859494,1137563.8536471473,5086.361273887673,1142650.2149210349,3263,2,1626.111111111111,87,66,37,31.423182864660394,0.6696599616858238,36.06770833333333,8620.118792313853,99.08182519900981,0
3265,32.99966035844147,0,0,153,0.0,0.0,1.0,153,4500,3700,800,0.8222222222222222,53,37,16,174.26271595852336,0.35202205882352944,0.6527765101104805,0.12783232793093985,1150057.8165696515,4982.4397249512385,1155040.2562946028,3264,3,1627.111111111111,88,65,43,31.389461512316963,0.6700994318181819,35.990168539325836,8712.2347694916,99.00266783513183,0
3266,32.61564530647101,0,0,153,0.0,0.0,1.0,153,3400,2600,800,0.7647058823529411,42,26,16,174.40128447657466,0.3519235179451898,0.6538835136397845,0.128240867157654,1137327.6032476379,5670.2789754104615,1142997.8822230482,3265,4,1628.111111111111,89,64,49,31.308664226965274,0.6705290262172285,35.914351851851855,8613.323830529509,96.77891944415178,0
3267,32.28181383416211,0,0,153,0.0,0.0,1.0,153,3600,2500,1100,0.6944444444444444,47,25,22,175.11952861543128,0.35186976837518635,0.656054956795221,0.1290248480948177,1126221.3156430125,5244.669182411002,1131465.9848254235,3266,5,1629.111111111111,90,63,47,31.225894869128087,0.6708333333333334,35.85164835164835,8527.187912512876,94.74653236125418,0
3268,32.466019709335754,0,0,153,0.0,0.0,1.0,153,3900,2800,1100,0.717948717948718,50,28,22,180.92874741160574,0.3519217262928563,0.6648704918493478,0.12384045948379924,1112238.3383149086,5747.1778748967245,1117985.5161898052,3267,6,1630.111111111111,86,67,42,33.50638855853386,0.6480135658914729,38.24233716475098,8498.229440678911,98.81662140324316,8
3269,32.60776378683712,0,0,153,0.0,0.0,1.0,153,4750,3500,1250,0.7368421052631579,60,35,25,180.49342038484443,0.35238218094255247,0.6658185326054094,0.12417037364870717,1118535.8130681522,5027.6709447229005,1123563.484012875,3268,7,1631.111111111111,88,65,40,33.34590091901636,0.6490293560606061,38.073501872659186,8540.83738044979,97.05497023238398,0
3270,32.342087613485496,0,0,153,0.0,0.0,1.0,153,4650,3500,1150,0.7526881720430108,58,35,23,179.6420843150608,0.35236963937621835,0.6639900571399209,0.12415264049329791,1110711.6961469306,4656.112833790297,1115367.8089807208,3269,8,1632.111111111111,88,65,44,33.21331279028224,0.6505681818181819,37.92134831460675,8476.170714433169,96.32012175492237,0
3271,32.05497618671279,0,0,153,0.0,0.0,1.0,153,3450,1700,1750,0.4927536231884058,52,17,35,179.02134926607812,0.35228005675954593,0.6645435152266428,0.12404443506350431,1101571.6188180638,5390.96750280579,1106962.5863208696,3270,9,1633.111111111111,89,64,41,33.14234654834963,0.6511001872659177,37.83564814814817,8403.67205561615,94.42328152377698,0
3272,32.31485553092397,0,0,153,0.0,0.0,1.0,153,2550,1700,850,0.6666666666666666,34,17,17,180.1431021263795,0.35207222508886593,0.6654539769242782,0.12512821606313693,1111188.8706308336,6884.602040749558,1118073.472671583,3271,10,1634.111111111111,89,64,41,33.030460175949635,0.6519194756554307,37.75462962962965,8474.421257172216,95.21821637272153,0
3273,32.31092710299121,0,0,153,0.0,0.0,1.0,153,3950,3200,750,0.810126582278481,47,32,15,177.43358851403704,0.3522424320605435,0.6614005404526366,0.12367972276864131,1112034.719435507,4912.462164328743,1116947.1815998356,3272,11,1635.111111111111,89,64,42,32.98372154579146,0.6530898876404494,37.63888888888891,8477.130735770937,95.24865995248244,0
3274,32.61879535154101,0,1,152,0.0,0.006535947712418301,0.9934640522875817,153,3600,3000,600,0.8333333333333334,42,30,12,177.56798050976505,0.35185185185185186,0.6598524315467929,0.12416903035284728,1123528.60887487,5700.541224571489,1129229.1500994414,3273,12,1636.111111111111,91,62,43,32.87341105503067,0.6535027472527473,37.533967391304365,8561.32580439399,94.0805033449889,0
3275,33.08483302243058,0,0,152,0.0,0.0,1.0,152,3150,2000,1150,0.6349206349206349,43,20,23,176.8559988646469,0.3520163457069827,0.6557759196109483,0.1237138130863088,1139679.2302516045,6761.821730288193,1146441.0519818927,3274,13,1645.5855263157894,91,61,43,32.880575446467084,0.6536172161172161,37.522644927536255,8684.019464741757,95.4287853268325,0
3276,33.2798282927303,0,0,152,0.0,0.0,1.0,152,4450,3200,1250,0.7191011235955056,57,32,25,176.9767913406097,0.3514871616126409,0.6556894756488083,0.12444116115524756,1147879.1432616555,5779.593524251094,1153658.7367859066,3275,14,1646.5855263157894,84,68,43,32.70469780390696,0.6577380952380952,37.35294117647059,8740.84901923769,104.05772641949632,0
3277,33.363351364430365,0,0,152,0.0,0.0,1.0,152,3350,2300,1050,0.6865671641791045,44,23,21,177.71196779628025,0.3510823312420123,0.6588981490573458,0.12533370360369203,1151619.2562470385,7181.304835949848,1158800.5610829883,3276,15,1647.5855263157894,84,68,47,32.585607120646735,0.6587301587301587,37.2549019607843,8766.057025164024,104.35782172814314,0
3278,33.757811096200506,0,0,152,0.0,0.0,1.0,152,3050,2200,850,0.7213114754098361,39,22,17,178.7781123221465,0.35106326972231905,0.6598359623947121,0.12638835245035218,1165928.5343318083,8238.500494073509,1174167.034825882,3277,16,1648.5855263157894,86,66,45,32.478019224636675,0.6587936046511628,37.17672413793103,8872.338498236311,103.16672672367804,0
3279,33.24015875830336,1,0,153,0.006535947712418301,0.0,1.0,153,3900,2900,1000,0.7435897435897436,49,29,20,177.71706007108648,0.3516547700951726,0.6607166442944434,0.12610838507760636,1149111.374160269,6343.339022001741,1155454.7131822708,3278,0,1638.8039215686274,88,65,43,32.38226653609899,0.6593276515151515,37.055243445692874,8740.325452528567,99.32188014237008,0
3280,33.66224246410424,0,0,153,0.0,0.0,1.0,153,4400,3100,1300,0.7045454545454546,57,31,26,177.4595671484672,0.3519396428161908,0.660530409553469,0.1264468953380766,1164888.7060066313,6344.129108814802,1171232.835115446,3279,1,1639.8039215686274,89,64,47,32.25271300777239,0.6603464419475655,36.92129629629628,8855.819111216273,99.50358551928397,0
3281,33.39556954314507,0,0,153,0.0,0.0,1.0,153,4250,3000,1250,0.7058823529411765,55,30,25,178.50056738675033,0.3516906031418416,0.6639419180161097,0.12764474535769393,1156677.5185057041,6443.518667352961,1163121.037173057,3280,2,1640.8039215686274,89,64,39,32.107519788918225,0.6615168539325842,36.80555555555553,8789.528372813793,98.75874576195272,0
3282,33.05787674442372,0,0,153,0.0,0.0,1.0,153,4150,3000,1150,0.7228915662650602,53,30,23,181.9602668777154,0.3516063954821695,0.6702352809026884,0.1306335762617502,1146089.2957889517,6958.542825489634,1153047.8386144412,3281,3,1641.8039215686274,89,64,42,31.886830981788332,0.6628043071161049,36.67824074074071,8704.858261717323,97.80739619907105,0
3283,33.24481655975566,0,1,152,0.0,0.006535947712418301,0.9934640522875817,153,4250,3100,1150,0.7294117647058823,54,31,23,182.55374670678037,0.35166910331384016,0.6707058726965665,0.13149012121950254,1153493.547472092,7264.913778624817,1160758.4612507168,3282,4,1642.8039215686274,90,63,46,31.763840003476307,0.6635416666666667,36.572802197802176,8757.588867784465,97.30654297538294,0
3284,33.315107230261155,0,0,152,0.0,0.0,1.0,152,3750,2400,1350,0.64,51,24,27,183.07604878955058,0.3506012547926107,0.6675076688660835,0.1320606530412931,1156347.2549486405,8189.897292927715,1164537.152241568,3283,22,1654.5855263157894,92,60,47,31.701951281724245,0.6633831521739131,36.52553763440858,8777.679966145017,95.40956484940236,0
3285,33.58481591234172,0,0,152,0.0,0.0,1.0,152,4050,3000,1050,0.7407407407407407,51,30,21,183.06900247700415,0.35019097827349827,0.6688943154437099,0.1325006108566851,1166662.670014182,8265.954245331111,1174928.624259513,3284,23,1655.5855263157894,76,76,47,31.592374940121804,0.6705043859649122,36.41774891774893,8852.361380358074,116.47843921523781,0
3286,33.721630410076315,0,0,152,0.0,0.0,1.0,152,4000,3000,1000,0.75,50,30,20,181.97544955643022,0.3500257784361566,0.667629499821788,0.13215594123524438,1172377.4529384759,8268.782809660606,1180646.2357481364,3285,24,1656.5855263157894,76,76,46,31.511004514672706,0.6716008771929824,36.30952380952383,8892.072780752324,117.00095764147794,0
3287,33.65331583686849,0,0,152,0.0,0.0,1.0,152,5100,4100,1000,0.803921568627451,61,41,20,191.86720904824912,0.3501846244336006,0.6819877519501778,0.12992957919081535,1149757.3650891432,8620.147344464558,1158377.5124336078,3286,25,1657.5855263157894,87,65,37,33.58545978052499,0.6440373563218391,38.60085227272727,8796.948077954155,101.11434572361098,8
3288,33.120158203966334,0,0,152,0.0,0.0,1.0,152,3600,2100,1500,0.5833333333333334,51,21,30,189.0742893358322,0.3500747937725108,0.6784660410216712,0.12857051674836611,1132748.6060291464,8834.727536223107,1141583.3335653695,3287,26,1658.5855263157894,77,75,41,33.51651858660129,0.6493506493506493,38.46153846153847,8662.195222575825,112.49604185163409,0
3289,32.85986910902386,0,1,151,0.0,0.006578947368421052,0.993421052631579,152,3900,3000,900,0.7692307692307693,48,30,18,186.6540431136634,0.35000217845939346,0.6724887912745645,0.12039002427154273,1108366.6535605234,7076.223427886187,1115442.8769884096,3288,27,1659.5855263157894,78,74,47,35.421002978305786,0.6306089743589743,40.268987341772124,8534.727079503511,109.4195779423527,8
3290,33.27039673120156,0,0,151,0.0,0.0,1.0,151,3450,2300,1150,0.6666666666666666,46,23,23,185.89496123230523,0.3499135393671817,0.6687762697858284,0.12024421236274299,1123075.6421337323,8104.82059107892,1131180.4627248112,3289,28,1667.476821192053,79,72,46,35.33914850079344,0.6311972573839663,40.16927083333331,8644.671442332312,109.42622078901661,0
3291,32.7326865714736,0,0,151,0.0,0.0,1.0,151,3500,2400,1100,0.6857142857142857,46,24,22,186.31300681932436,0.34980500367917583,0.6700617003240867,0.12082885681553632,1105694.6193925422,7501.057832594338,1113195.6772251364,3290,29,1668.476821192053,81,70,48,35.23608938957039,0.6313014403292181,40.078760162601604,8507.920476866322,105.03605526995459,0
3292,32.33189478623157,0,0,151,0.0,0.0,1.0,151,4900,3600,1300,0.7346938775510204,62,36,26,186.2067474785574,0.350424944812362,0.6704662995346695,0.1113278639180306,1067845.9946618716,4668.025894798211,1072514.0205566697,3291,30,1669.476821192053,81,70,37,38.202064386450495,0.6018518518518519,42.98780487804876,8309.691251461303,102.58878088223831,8
3293,32.56688330966845,2,0,153,0.013071895424836602,0.0,1.0,153,3950,2900,1050,0.7341772151898734,50,29,21,172.88403035576724,0.3542365411076711,0.6471153940356982,0.10183465200192654,1070996.948426216,2481.653788530636,1073478.6022147466,3292,0,1648.640522875817,83,70,41,39.10538860145386,0.5955070281124498,43.53918650793653,8352.129386498724,100.62806489757499,8
3294,32.21153726908417,1,0,154,0.006493506493506494,0.0,1.0,154,3600,2300,1300,0.6388888888888888,49,23,26,197.5730415234891,0.3561348781937017,0.6931271958189877,0.12131964450574491,1071948.9618212597,7957.643348994228,1079906.605170254,3293,0,1638.9285714285713,83,71,35,36.91677882458501,0.6109437751004017,42.013888888888864,8310.12923296158,100.12203895134435,8
3295,32.33233471830368,0,0,154,0.0,0.0,1.0,154,4550,3200,1350,0.7032967032967034,59,32,27,199.15872519680295,0.35640455677220384,0.6959060112440565,0.12258776190685103,1076693.1020943914,7536.565128261664,1084229.667222653,3294,1,1639.9285714285713,87,67,36,36.787336024217964,0.6103927203065134,41.92708333333331,8344.099923395484,95.90919452178717,0
3296,32.25157927499286,0,0,154,0.0,0.0,1.0,154,4700,3100,1600,0.6595744680851063,63,31,32,199.82057892906096,0.3570058073734544,0.6993373143923955,0.12336529948491812,1074905.1709197222,7457.634709403654,1082362.8056291258,3295,2,1640.9285714285713,88,66,37,36.65982894359063,0.6111505681818181,41.818820224719076,8326.750786833587,94.62216803219985,0
3297,32.101128524893475,1,1,154,0.0064516129032258064,0.0064516129032258064,0.9935483870967742,155,4400,3200,1200,0.7272727272727273,56,32,24,194.1245598119986,0.35817972350230415,0.6893393158302041,0.12268468017566402,1076819.3077627097,6407.414823299569,1083226.7225860092,3296,0,1631.3354838709677,86,69,36,35.95606249711086,0.6202761627906976,40.98419540229886,8314.699633369528,96.68255387638986,8
3298,32.57249947637973,0,1,153,0.0,0.006493506493506494,0.9935064935064936,154,2950,2200,750,0.7457627118644068,37,22,15,197.50941653195608,0.35770785586962056,0.6930163533866538,0.12498021895815063,1093004.808086468,9425.748382356316,1102430.5564688242,3297,4,1642.9285714285713,85,69,36,35.82324200486258,0.621078431372549,40.93992248062017,8438.234239350926,99.27334399236383,0
3299,32.31168334855688,0,0,153,0.0,0.0,1.0,153,4050,3000,1050,0.7407407407407407,51,30,21,196.2331375488499,0.35574690402476783,0.6888683992926103,0.12458884743780625,1085242.1765385477,7942.095460500731,1093184.2719990485,3298,5,1654.6339869281046,89,64,37,35.73582332276458,0.6209035580524345,40.82175925925928,8374.485245650922,94.0953398387744,0
3300,32.427339617247284,0,1,152,0.0,0.006535947712418301,0.9934640522875817,153,4950,3600,1350,0.7272727272727273,63,36,27,193.1191700092996,0.35596190230478153,0.6822269143500326,0.12306363624787559,1090215.798362453,6558.314022156811,1096774.1123846099,3299,6,1655.6339869281046,92,61,39,35.6844736728435,0.6212635869565217,40.692204301075286,8408.661956528858,91.39849952748759,0
3301,31.92227153590682,0,0,152,0.0,0.0,1.0,152,4400,3100,1300,0.7045454545454546,57,31,26,191.93072765091176,0.3553357732078541,0.6784714587964045,0.12281694074754444,1074446.7940766895,6443.871001865711,1080890.6650785552,3300,7,1666.342105263158,78,74,38,35.56616438820281,0.6278044871794872,40.54588607594937,8282.364675791649,106.18416251014933,0
3302,32.134006055767784,0,0,152,0.0,0.0,1.0,152,4950,3600,1350,0.7272727272727273,63,36,27,188.68994718875697,0.3557687420123155,0.6738431273368208,0.12122518376678061,1082736.8292180018,5510.311024893358,1088247.140242895,3301,8,1667.342105263158,80,72,39,35.50810792958816,0.6283854166666667,40.40637860082305,8341.78300207984,104.272287525998,0
3303,31.971948601153425,0,0,152,0.0,0.0,1.0,152,4450,2900,1550,0.651685393258427,60,29,31,187.01930286903195,0.35575966509817586,0.6719918604304693,0.12070831740596852,1078615.394948069,5494.379845398737,1084109.7747934677,3302,9,1668.342105263158,84,68,42,35.38717997106375,0.6284722222222222,40.24509803921569,8304.87037438785,98.86750445699822,0
3304,31.754459916297186,0,0,152,0.0,0.0,1.0,152,3450,2000,1450,0.5797101449275363,49,20,29,184.42316657701244,0.35602380329963984,0.6669470003680524,0.11922474150322257,1071741.2818894046,5680.784191470153,1077422.0660808748,3303,10,1669.342105263158,85,67,43,35.3974358974359,0.6286764705882353,40.1889534883721,8250.159462264732,97.06069955605567,0
3305,32.04618991037963,0,0,152,0.0,0.0,1.0,152,3400,2300,1100,0.6764705882352942,45,23,22,180.6871051965968,0.3561690339258743,0.6590980061215086,0.11436787161326611,1075427.3210897765,5063.169899408977,1080490.4909891854,3304,11,1670.342105263158,81,71,48,36.24881501095093,0.6226851851851851,40.92987804878052,8302.210328154088,102.49642380437145,8
3306,31.87566353248623,0,1,151,0.0,0.006578947368421052,0.993421052631579,152,3300,2500,800,0.7575757575757576,41,25,16,180.48350044774688,0.35611184936679446,0.6596856528054771,0.11444460446483133,1070229.2672730617,4931.744887814264,1075161.0121608758,3305,12,1671.342105263158,81,71,48,36.18942717780287,0.6233281893004115,40.86636178861792,8260.05666157512,101.97600816759407,0
3307,32.31674289054238,0,0,151,0.0,0.0,1.0,151,3050,2100,950,0.6885245901639344,40,21,19,186.86138320057097,0.35519315673289187,0.6652327129666233,0.11883079610389798,1085889.779425116,7332.173237348426,1093221.9526624645,3306,13,1683.1192052980132,81,70,49,35.9206297675634,0.6243569958847737,40.76473577235775,8377.639382206611,103.42764669390878,0
3308,32.58395587419594,0,0,151,0.0,0.0,1.0,151,3500,2500,1000,0.7142857142857143,45,25,20,188.57397532527312,0.3550662251655629,0.6671657455819169,0.12031124421416446,1095837.0549072016,7629.269950518332,1103466.32485772,3307,14,1684.1192052980132,82,69,51,35.75943624485846,0.6251270325203252,40.650100401606444,8450.645684491248,103.05665468891766,0
3309,32.06752118143416,0,1,150,0.0,0.006622516556291391,0.9933774834437086,151,4400,3000,1400,0.6818181818181818,58,30,28,188.51258031809397,0.35534216335540836,0.6643327786342903,0.12065203266187512,1079389.7403237524,6095.709023461193,1085485.4493472136,3308,15,1685.1192052980132,72,79,50,35.64822453207207,0.6306423611111112,40.5393835616438,8320.258813384873,115.55915018590102,0
3310,31.813479523565128,0,0,150,0.0,0.0,1.0,150,4050,3000,1050,0.7407407407407407,51,30,21,187.07350189301675,0.35602628635346756,0.6589788138699517,0.11997506531841186,1071427.7260543134,6037.147347650032,1077464.8734019634,3309,16,1675.3866666666668,72,78,50,35.61288120372406,0.6313657407407407,40.46803652968033,8256.614805573594,114.67520563296658,0
3311,31.39448795340267,0,0,150,0.0,0.0,1.0,150,3750,2900,850,0.7733333333333333,46,29,17,187.39053056942873,0.35603187919463086,0.6604309112894371,0.12047290859293831,1058014.4589033707,5902.378160805568,1063916.8370641763,3310,17,1676.3866666666668,72,78,53,35.51743248690042,0.6322337962962963,40.382420091324164,8150.5609849343955,113.2022359018666,0
3312,31.12265574600502,0,0,150,0.0,0.0,1.0,150,4650,3600,1050,0.7741935483870968,57,36,21,186.0201617974979,0.356412192393736,0.6574204355108884,0.12023818751154018,1050372.9294160337,4428.108455536265,1054801.0378715699,3311,18,1677.3866666666668,74,76,48,35.3615372964111,0.6331644144144144,40.19444444444442,8085.838866455086,109.26809278993359,0
3313,31.496841071050802,0,0,150,0.0,0.0,1.0,150,4150,2900,1250,0.6987951807228916,54,29,25,185.8134487555513,0.3561912751677852,0.6576201276438636,0.12027439996437264,1063403.7950726878,5368.945316439245,1068772.740389127,3312,19,1678.3866666666668,75,75,48,35.31683501239516,0.6331944444444444,40.14528508771927,8184.602657155261,109.12803542873681,0
3314,31.61511477449161,1,0,151,0.006622516556291391,0.0,1.0,151,4700,3300,1400,0.7021276595744681,61,33,28,186.6406390968673,0.35753679175864606,0.66153189715108,0.12171437644508663,1069523.19494135,5023.298526555004,1074546.493467905,3313,0,1668.2649006622516,78,73,41,35.03183031716258,0.6344818376068376,39.88660337552739,8223.51488866548,105.42967805981385,0
3315,31.494041613705626,0,0,151,0.0,0.0,1.0,151,3550,2600,950,0.7323943661971831,45,26,19,183.6197012658178,0.3578348050036792,0.6561875048670629,0.12011914009156596,1066311.9258179802,5409.175454974997,1071721.1012729553,3314,1,1669.2649006622516,79,72,43,35.00046910182637,0.6351529535864979,39.77864583333331,8195.422156899762,103.73952097341471,0
3316,31.0421973823444,0,0,151,0.0,0.0,1.0,151,4000,2700,1300,0.675,53,27,26,182.87086030406624,0.35793046357615893,0.6559837181475825,0.12012989739507064,1052176.0731815293,4282.468738811498,1056458.5419203409,3315,2,1670.2649006622516,80,71,48,34.873452369192265,0.6361979166666667,39.634773662551396,8082.308747465742,101.02885934332178,0
3317,31.588966772555395,0,0,151,0.0,0.0,1.0,151,3700,2500,1200,0.6756756756756757,49,25,24,184.04101967693722,0.35814385577630614,0.6547515768919143,0.12127831296659648,1071595.1993496907,5543.494633845381,1077138.693983536,3316,3,1671.2649006622516,73,78,45,34.73325587260417,0.6404109589041096,39.52702702702701,8228.072088391918,112.71331627934134,0
3318,31.241238455785926,1,0,152,0.006578947368421052,0.0,1.0,152,3250,2200,1050,0.676923076923077,43,22,21,183.77339877598283,0.3591880155687231,0.6562242270210226,0.12149247737262087,1060697.4296542876,5335.594344103378,1066033.023998391,3317,0,1661.2631578947369,74,78,48,34.6278381835625,0.6410472972972974,39.41666666666666,8140.9460542701945,110.01278451716479,0
3319,31.694950532699043,0,0,152,0.0,0.0,1.0,152,4450,3400,1050,0.7640449438202247,55,34,21,184.5450873555252,0.3591154002556059,0.6584394770494018,0.1223002189084918,1076790.1627532325,4893.2669297729935,1081683.4296830054,3318,1,1662.2631578947369,74,78,49,34.522858056265974,0.6418918918918919,39.33333333333332,8261.817105523523,111.64617710166924,0
3320,31.87975216243678,0,0,152,0.0,0.0,1.0,152,3500,2100,1400,0.6,49,21,28,182.64654058332636,0.35911903102126175,0.6554435394626188,0.12132219930367275,1083724.682278011,5687.712832568475,1089412.3951105794,3319,2,1663.2631578947369,75,77,51,34.491957527333916,0.6422222222222222,39.25438596491227,8312.505552880959,110.83340737174612,0
3321,32.271984792888546,0,0,152,0.0,0.0,1.0,152,3900,2800,1100,0.717948717948718,50,28,22,180.5449461285698,0.35928967700708725,0.6529067354480336,0.12030046039951113,1097951.9487788994,5345.935088808836,1103297.8838677083,3320,3,1664.2631578947369,78,74,51,34.43865945508771,0.6419604700854701,39.14820675105484,8418.205104927638,107.92570647343125,0
3322,31.770324939650983,0,0,152,0.0,0.0,1.0,152,4050,3000,1050,0.7407407407407407,51,30,21,184.76500680214855,0.35968543046357615,0.6653207539156363,0.11403896629022346,1058784.4926111046,4675.264795859535,1063459.7574069642,3321,4,1665.2631578947369,89,63,39,37.05860157207327,0.6107209737827715,41.82870370370367,8202.18597342414,92.1593929598218,8
3323,31.592423318233894,1,0,153,0.006535947712418301,0.0,1.0,153,4850,3500,1350,0.7216494845360825,62,35,27,183.17405243768252,0.36116127737644765,0.6675273181798613,0.11360966158314441,1054285.3522442996,3173.5440792558143,1057458.8963235554,3322,0,1655.3725490196077,78,75,45,36.92124313105022,0.6165865384615384,41.65348101265825,8161.792590640298,104.63836654667048,0
3324,31.643428308559393,0,0,153,0.0,0.0,1.0,153,3950,3200,750,0.810126582278481,47,32,15,182.82096843819227,0.3615249828001376,0.6688247531721887,0.11372496992564361,1056849.9779482265,4092.867292475666,1060942.8452407022,3323,1,1656.3725490196077,78,75,44,36.8229512099723,0.6176549145299146,41.54799578059074,8178.307466720423,104.85009572718491,0
3325,31.193231624625266,0,1,152,0.0,0.006535947712418301,0.9934640522875817,153,3550,2400,1150,0.676056338028169,47,24,23,183.12431746626663,0.36128490138745556,0.6697955224792651,0.11435601787613983,1042931.1131170422,4047.2096507786014,1046978.3227678208,3324,2,1657.3725490196077,80,73,46,36.674043498441755,0.6182291666666666,41.40946502057614,8066.274453548956,100.82843066936195,0
3326,31.70871777944393,1,0,153,0.006535947712418301,0.0,1.0,153,3350,2300,1050,0.6865671641791045,44,23,21,178.34157690889248,0.36335605148492145,0.6607736614242103,0.11182147048521136,1061350.5399828544,3906.585790729586,1065257.125773584,3325,0,1648.8954248366013,82,71,46,36.65074052515846,0.6189024390243902,41.26506024096388,8204.153184500761,100.0506485914727,0
3327,31.726752557980447,0,1,152,0.0,0.006535947712418301,0.9934640522875817,153,4350,3100,1250,0.7126436781609196,56,31,25,175.33909452595347,0.3635011753239307,0.6548930052865596,0.11026974751552421,1062831.2953155825,2321.175390896366,1065152.470706479,3326,1,1649.8954248366013,83,70,45,36.61972604161678,0.6196034136546185,41.15823412698415,8212.20865752394,98.94227298221614,0
3328,32.04109521392103,0,1,151,0.0,0.006578947368421052,0.993421052631579,152,4350,3300,1050,0.7586206896551724,54,33,21,179.39368990804044,0.36291408882305104,0.6617995100287828,0.11317519736132062,1074287.448126175,3794.077868249538,1078081.5259944245,3327,2,1661.6907894736842,83,69,48,36.401166874181925,0.6207329317269077,41.046626984126995,8297.149680767623,99.9656588044292,0
3329,32.146684249922366,0,0,151,0.0,0.0,1.0,151,3700,2600,1100,0.7027027027027027,48,26,22,176.68823871020274,0.3627630610743193,0.6533207466879085,0.11164063965399805,1078282.8820476783,4203.9806520731745,1082486.8626997515,3328,3,1673.0993377483444,87,64,39,36.41558315433482,0.6198515325670498,40.991950757575765,8326.249977184578,95.70402272625951,0
3330,32.38444423231141,0,0,151,0.0,0.0,1.0,151,3050,2200,850,0.7213114754098361,39,22,17,179.1891957119699,0.3630389992641648,0.6568885479942472,0.11353435645883253,1087078.0820392333,5708.529439344424,1092786.6114785778,3329,4,1674.0993377483444,88,63,41,36.251298671966744,0.6205018939393939,40.89419475655432,8390.99750017455,95.35224432016534,0
3331,32.347222923356355,0,1,150,0.0,0.006622516556291391,0.9933774834437086,151,4850,3500,1350,0.7216494845360825,62,35,27,175.74070877785434,0.3634105960264901,0.6486856521676931,0.11195369862981153,1087428.305447371,3171.084228884602,1090599.3896762556,3330,5,1675.0993377483444,92,59,44,36.14650827933768,0.6211503623188406,40.70340501792116,8387.524761152596,91.16874740383255,0
3332,32.04009939292939,0,0,150,0.0,0.0,1.0,150,4600,3400,1200,0.7391304347826086,58,34,24,174.48243039168358,0.3607270693512304,0.6433377409928669,0.1114406239026521,1077860.6728623733,3013.549964928486,1080874.2228273018,3331,9,1687.2333333333333,81,69,46,36.086437060254354,0.6259002057613169,40.612296747967484,8310.807793498803,102.60256535183707,0
3333,32.229952126905054,1,0,151,0.006622516556291391,0.0,1.0,151,2850,2100,750,0.7368421052631579,36,21,15,174.51126779329798,0.3614220014716703,0.6470876651585926,0.11189824826969362,1085400.657591409,4832.928963991357,1090233.5865554004,3332,0,1677.0529801324503,82,69,46,35.94538340022888,0.6269054878048781,40.474397590361455,8364.497741368874,102.00607001669358,0
3334,32.198478940916495,2,0,153,0.013071895424836602,0.0,1.0,153,4300,2800,1500,0.6511627906976745,58,28,30,171.68569724936646,0.3640888372893017,0.647254481387816,0.1108359862495462,1086322.0506872442,2401.191741920323,1088723.2424291645,3333,0,1656.1176470588234,85,68,44,35.777650843980204,0.6281862745098039,40.237403100775204,8363.9605058975,98.3995353635,0
3335,32.372929764799665,1,0,154,0.006493506493506494,0.0,1.0,154,4000,2700,1300,0.675,53,27,26,170.1973360986333,0.36554445010327363,0.6456097903788638,0.11022327047656824,1093133.6844925608,2409.6882200636614,1095543.3727126245,3334,0,1646.357142857143,89,65,46,35.70435094048308,0.6279260299625469,40.127314814814824,8412.840185289917,94.52629421674064,0
3336,32.73088087586798,0,1,153,0.0,0.006493506493506494,0.9935064935064936,154,4900,3500,1400,0.7142857142857143,63,35,28,191.49775404348534,0.3660113035113035,0.691631576200225,0.11201938056376516,1074219.6512450874,5442.130112562423,1079661.7813576497,3335,1,1647.357142857143,86,68,42,38.89167990777958,0.591812015503876,43.797892720306535,8385.72065351806,97.50837969207046,8
3337,32.39516640068034,1,0,154,0.006493506493506494,0.0,1.0,154,4200,3100,1100,0.7380952380952381,53,31,22,187.45229814110084,0.3677407831819597,0.6845955584193406,0.11011645051605323,1064509.5363881167,4908.95179781387,1069418.4881859305,3336,0,1645.5389610389611,75,79,42,38.83483033932138,0.5977777777777777,43.640350877192965,8304.813491753313,110.73084655671084,0
3338,32.67630852918357,0,0,154,0.0,0.0,1.0,154,4000,2800,1200,0.7,52,28,24,185.97597253175118,0.36808650227767875,0.6816272257894807,0.1095855389795539,1074707.331025383,5173.948214889424,1079881.2792402725,3337,1,1646.5389610389611,78,76,41,38.75604082052336,0.5976228632478633,43.525843881856524,8380.628655078406,107.44395711638983,0
3339,32.74020182621515,0,0,154,0.0,0.0,1.0,154,4200,2900,1300,0.6904761904761905,55,29,26,181.1518392387236,0.36821471012647483,0.6721146351473994,0.10716855806764307,1078050.7546329345,4058.175398890072,1082108.9300318246,3338,2,1647.5389610389611,83,71,41,38.729221030250365,0.5971385542168675,43.3779761904762,8401.85685257561,101.22719099488688,0
3340,32.60452755310074,2,0,156,0.01282051282051282,0.0,1.0,156,4850,3300,1550,0.6804123711340206,64,33,31,179.23483329573733,0.37172508271298593,0.6723589603385467,0.10671426075714188,1075563.8233050592,2505.7005138016275,1078069.5238188608,3339,0,1627.4038461538462,88,68,42,38.53758467754184,0.5977746212121212,43.14138576779026,8374.753764985351,95.16765642028808,0
3341,32.47450739886895,0,0,156,0.0,0.0,1.0,156,4100,2600,1500,0.6341463414634146,56,26,30,184.02879949019848,0.3725125792666115,0.6803255592662896,0.1099616647976423,1072377.0936860214,4169.653830365595,1076546.747516387,3340,1,1628.4038461538462,89,67,38,38.279889509397755,0.5987827715355805,43.009259259259274,8345.647711626038,93.77132260253975,0
3342,32.700254158366626,1,0,157,0.006369426751592357,0.0,1.0,157,4000,2800,1200,0.7,52,28,24,185.73463311097566,0.3740881376231695,0.6803376422329881,0.10634697974893144,1066465.7957604458,4215.926660194311,1070681.72242064,3341,0,1619.0254777070063,77,80,39,39.86112563619883,0.5871212121212122,44.604700854700866,8351.491192903386,108.46092458316086,8
3343,32.53146919095426,3,0,160,0.01875,0.0,1.0,160,3350,2400,950,0.7164179104477612,43,24,19,177.03261762284347,0.3785246331236897,0.6702520137408188,0.10200036568195761,1062930.884640771,2284.6873720239764,1065215.572012795,3342,0,1589.65,85,75,42,39.842207612729965,0.5863970588235294,44.36773255813953,8316.093232498653,97.8363909705724,0
3344,32.53571074127046,3,1,162,0.018404907975460124,0.006134969325153374,0.9938650306748467,163,3750,2500,1250,0.6666666666666666,50,25,25,176.9867241164568,0.382802835214219,0.6770038800615426,0.10283458794301975,1065706.0424938605,1373.16426642043,1067079.206760281,3343,0,1561.3742331288342,89,74,36,39.52096710982485,0.588249063670412,44.05092592592593,8327.485038570096,93.5672476243831,0
3345,32.46888181924936,3,3,162,0.01818181818181818,0.01818181818181818,0.9818181818181818,165,4250,3100,1150,0.7294117647058823,54,31,23,184.81591172780827,0.38447277654594725,0.6968164486526895,0.10847322592929058,1066661.4261550992,2177.2007959481243,1068838.6269510472,3344,0,1543.4060606060607,80,85,42,38.935505719446105,0.5953125,43.67283950617287,8322.65628113792,104.03320351422401,0
3346,32.20441409772676,0,0,162,0.0,0.0,1.0,162,4100,2700,1400,0.6585365853658537,55,27,28,186.74162572179537,0.3813948955857169,0.6962329690448863,0.10975948090931849,1058411.131835408,3029.883088198148,1061441.0149236063,3345,1,1572.9135802469136,79,83,42,38.83210597596073,0.5962552742616034,43.619791666666686,8256.574395628171,104.5135999446604,0
3347,32.09162800130558,1,0,163,0.006134969325153374,0.0,1.0,163,4550,3600,950,0.7912087912087912,55,36,19,191.635858398616,0.3828959327425585,0.7050786904041715,0.10975714302723863,1046705.1149178355,2967.246637500525,1049672.361555336,3346,0,1564.2576687116564,78,85,39,39.699384787472,0.5868055555555556,44.5938818565401,8196.398132717464,105.08202734253159,8
3348,32.033542557214865,4,0,167,0.023952095808383235,0.0,1.0,167,4050,3000,1050,0.7407407407407407,51,30,21,193.05002973390012,0.38858127119255464,0.7138582711876871,0.11145917698578138,1047301.0955536437,2986.301527395512,1050287.3970810391,3347,0,1527.7664670658683,82,85,46,39.353169734151344,0.5882876016260163,44.28965863453816,8191.308102450486,99.89400124939617,0
3349,31.91789588055185,6,2,171,0.03468208092485549,0.011560693641618497,0.9884393063583815,173,5600,4000,1600,0.7142857142857143,72,40,32,189.84920946125723,0.39495815969888426,0.7198575761787573,0.11092842238769329,1047188.6380223411,-438.41298292955753,1046750.2250394115,3348,0,1475.7456647398844,91,82,40,38.97741336633662,0.5897435897435898,43.84057971014493,8176.0697056341205,89.84691984213319,0
3350,32.14610548625642,3,0,174,0.017241379310344827,0.0,1.0,174,5250,4100,1150,0.780952380952381,64,41,23,186.0116298774666,0.39734347662392305,0.7155179802744542,0.10937393840239926,1056617.0543264677,-741.387913681092,1055875.6664127866,3349,0,1461.7586206896551,78,96,41,38.83571183680462,0.5968215811965811,43.604957805907176,8242.102072524485,105.66797528877545,0
3351,32.11402852202716,3,2,175,0.01694915254237288,0.011299435028248588,0.9887005649717514,177,4250,2800,1450,0.6588235294117647,57,28,29,205.95963329233828,0.40027927580893685,0.7383415878274788,0.12256930262558274,1059242.515539967,3982.2400136528313,1063224.75555362,3350,0,1437.9661016949153,80,97,44,37.86853678483209,0.6005208333333334,43.15843621399175,8248.217305065875,103.10271631332344,8
3352,31.675687063009107,2,2,175,0.011299435028248588,0.011299435028248588,0.9887005649717514,177,4150,2400,1750,0.5783132530120482,59,24,35,202.0733729907734,0.40089052602294123,0.7335366907696337,0.12077241976296366,1046069.5909064821,2726.562123510079,1048796.1530299922,3351,0,1436.406779661017,81,96,42,37.80723271217435,0.6017232510288066,43.000508130081286,8140.635479823862,100.50167259041804,0
3353,32.14291644589494,3,7,171,0.016853932584269662,0.03932584269662921,0.9606741573033708,178,4300,2900,1400,0.6744186046511628,57,29,28,203.9088114711493,0.40241871918576355,0.7383358178012667,0.12050753598262659,1058068.9693482309,3249.917198860306,1061318.8865470912,3352,0,1429.2865168539327,77,101,41,38.18416133173719,0.5991612554112554,43.41613247863248,8247.35381510389,107.10849110524532,8
3354,32.294434649101994,2,1,172,0.011560693641618497,0.005780346820809248,0.9942196531791907,173,3500,2500,1000,0.7142857142857143,45,25,20,205.0481098014143,0.3986352892413855,0.7320967299116246,0.12185877138793215,1064770.4122373536,5565.832080348316,1070336.244317702,3353,0,1468.0809248554913,78,95,41,37.94394522892594,0.6008279914529915,43.209388185654,8292.907631741298,106.31932861206792,0
3355,32.389292791588986,1,0,173,0.005780346820809248,0.0,1.0,173,4100,3200,900,0.7804878048780488,50,32,18,205.6225975012052,0.39841544562441183,0.7330122961427834,0.1230104416718517,1069927.1075265594,5300.238197312245,1075227.3457238716,3354,0,1469.057803468208,80,93,36,37.680325544937546,0.6024739583333334,42.96553497942385,8325.164545080828,104.06455681351035,0
3356,31.91119247992624,1,1,173,0.005747126436781609,0.005747126436781609,0.9942528735632183,174,3900,2500,1400,0.6410256410256411,53,25,28,205.53054875882253,0.3992342701481629,0.7331425289599762,0.12352325707516992,1055523.3637818887,4688.459237169824,1060211.8230190584,3355,0,1461.6091954022988,82,92,39,37.509860609609284,0.6034044715447154,42.79618473895581,8207.680455366535,100.0936640898358,0
3357,32.08858947829231,3,2,174,0.017045454545454544,0.011363636363636364,0.9886363636363636,176,4450,3100,1350,0.6966292134831461,58,31,27,201.8606421668254,0.4018628246753247,0.7332412524134195,0.12229461091222618,1063814.367916448,3298.45029078171,1067112.8182072297,3356,0,1445.9431818181818,75,101,40,37.30488502688025,0.6093055555555555,42.50274122807016,8262.723828518021,110.16965104690695,0
3358,32.478339269852945,1,0,175,0.005714285714285714,0.0,1.0,175,4250,2800,1450,0.6588235294117647,57,28,29,207.75209972524638,0.40074438970990695,0.7405407870138168,0.1263858890173195,1077996.7670281762,5541.218369426057,1083537.9853976022,3357,0,1455.08,75,100,42,36.99928183849346,0.6108333333333333,42.35197368421052,8367.980010892194,111.57306681189591,0
3359,32.297254391561424,0,3,172,0.0,0.017142857142857144,0.9828571428571429,175,5150,4100,1050,0.7961165048543689,62,41,21,215.3445372111873,0.40093869731800763,0.7458097786572531,0.13167313232941974,1073524.3811793576,6085.5222099989805,1079609.9033893566,3358,1,1456.08,76,99,45,36.6149194606223,0.6122532894736843,42.16720779220779,8327.291280421652,109.56962211081121,0
3360,32.04596487532628,0,0,172,0.0,0.0,1.0,172,4850,3500,1350,0.7216494845360825,62,35,27,223.02829233127835,0.3995435536515708,0.7487521925063243,0.1367285344562112,1065954.3779745752,8297.596924544057,1074251.9748991192,3359,2,1479.4476744186047,76,96,36,36.319998076855846,0.6132127192982456,42.072510822510836,8265.53525856295,108.75704287582829,0
3361,32.01015645228546,1,0,173,0.005780346820809248,0.0,1.0,173,3900,2800,1100,0.717948717948718,50,28,22,222.5423215390091,0.4007623112425505,0.7496621001069199,0.13685432007564396,1065688.514611877,8932.159215837048,1074620.673827714,3360,0,1471.8901734104047,77,96,37,36.21799848186869,0.6139069264069263,41.960470085470085,8259.885723438294,107.27124316153629,0
3362,32.228663717388706,1,0,174,0.005747126436781609,0.0,1.0,174,5000,3500,1500,0.7,65,35,30,222.37973653864333,0.4019811806524483,0.7541020507465706,0.13742071254768903,1074420.0456169583,7985.849335227414,1082405.8949521857,3361,0,1464.4252873563219,78,96,39,36.04316669219901,0.6152510683760684,41.785337552742625,8321.913522911722,106.69119901168874,0
3363,31.811230199740038,0,2,172,0.0,0.011494252873563218,0.9885057471264368,174,4200,2400,1800,0.5714285714285714,60,24,36,218.4347426473389,0.40199433038779264,0.7497977482863214,0.13554195860768792,1061723.4910751483,7383.459507127001,1069106.9505822754,3362,1,1465.4252873563219,69,105,40,35.993357140114426,0.6210748792270531,41.63690476190477,8218.847897736432,119.11373764835409,0
3364,31.729767877202665,0,0,172,0.0,0.0,1.0,172,5050,4100,950,0.8118811881188119,60,41,19,218.64958088069048,0.3994677625912326,0.7463653027005062,0.13600125741130453,1059709.5800824757,6891.011108057316,1066600.591190533,3363,2,1483.3255813953488,71,101,39,35.89994775339601,0.6208920187793427,41.55092592592594,8200.529128448356,115.50041025983599,0
3365,31.358024476077794,0,1,171,0.0,0.005813953488372093,0.9941860465116279,172,4550,3700,850,0.8131868131868132,54,37,17,216.79482868685045,0.39955630354957156,0.744651291134041,0.13527280632939878,1048206.6230751718,6499.155055600875,1054705.7781307728,3364,3,1484.3255813953488,72,100,38,35.83287343635027,0.6215277777777778,41.43835616438357,8107.98235597219,112.61086605516931,0
3366,31.007968956458047,0,0,171,0.0,0.0,1.0,171,4550,3200,1350,0.7032967032967034,59,32,27,215.66735845415175,0.3991357069143447,0.7429295280899721,0.13520932333241503,1037862.0354059136,6016.5927231685055,1043878.6281290821,3365,4,1493.8245614035088,75,96,38,35.68920953188183,0.6218055555555555,41.269188596491226,8022.716968079192,106.96955957438922,0
3367,31.07650429690866,2,3,170,0.011560693641618497,0.017341040462427744,0.9826589595375722,173,5050,3300,1750,0.6534653465346535,68,33,35,210.63624048205986,0.4015968768203612,0.7395129301361933,0.13285515110899904,1041881.3692919291,4241.594931190658,1046122.9642231197,3366,0,1477.5433526011561,79,94,35,35.60036078845476,0.6222310126582278,41.054687500000014,8047.11511657064,101.86221666545113,0
3368,31.30398693353853,1,0,171,0.005847953216374269,0.0,1.0,171,5250,3900,1350,0.7428571428571429,66,39,27,215.45472936868902,0.3991858731796812,0.7440119873461741,0.13640952161727254,1050593.751198419,5821.078468178257,1056414.829666597,3367,0,1495.625730994152,80,91,38,35.338797610774705,0.6231770833333333,40.92078189300412,8110.212458372785,101.3776557296598,0
3369,31.450401927027595,0,2,169,0.0,0.011695906432748537,0.9883040935672515,171,4250,2800,1450,0.6588235294117647,57,28,29,236.09862790398353,0.3990611741772732,0.7675919165075136,0.13900111271962967,1034130.9999645563,10381.382032921108,1044512.3819974774,3368,1,1496.625730994152,64,107,42,37.50312460942384,0.6044921875,43.5576923076923,8065.213648017538,126.01896325027403,8
3370,31.85382243579828,2,0,171,0.011695906432748537,0.0,1.0,171,3900,2700,1200,0.6923076923076923,51,27,24,229.92252175709086,0.3997520353170508,0.7604663622215999,0.1359112213137181,1048619.4711939464,10120.246636099551,1058739.717830046,3369,0,1497.5204678362572,66,105,41,37.508331313620914,0.6047979797979798,43.407960199004954,8173.437274260134,123.83995870091111,0
3371,31.693489137701388,1,0,172,0.005813953488372093,0.0,1.0,172,5350,4000,1350,0.7476635514018691,67,40,27,225.71869606575518,0.4003255473956208,0.7574707220957986,0.13396052925148902,1044546.5398119078,7404.736589267966,1051951.2764011757,3370,0,1489.8081395348838,67,105,44,37.46469769291962,0.6057213930348259,43.25980392156862,8136.992615623071,121.44765097944882,0
3372,32.1255643954996,3,3,172,0.017142857142857144,0.017142857142857144,0.9828571428571429,175,5100,4000,1100,0.7843137254901961,62,40,22,220.73172108740889,0.4037151067323481,0.756948907222462,0.13203770225046804,1061188.7255045373,6747.602755833982,1067936.3282603712,3371,0,1465.2514285714285,71,104,37,37.29525498142516,0.6065140845070423,42.96874999999999,8257.273973530746,116.2996334300105,0
3373,32.58743515303006,1,0,173,0.005780346820809248,0.0,1.0,173,5200,3700,1500,0.7115384615384616,67,37,30,223.59635080674585,0.40221719989245863,0.7584334826950574,0.13386800464551377,1076714.423643164,8349.883197519794,1085064.3068406838,3372,0,1483.179190751445,72,101,38,37.188800999167334,0.6063368055555556,42.93664383561642,8377.035449227082,116.34771457259836,0
3374,32.13639805452635,1,2,172,0.005747126436781609,0.011494252873563218,0.9885057471264368,174,5150,3600,1550,0.6990291262135923,67,36,31,220.5182825567319,0.40333352711890685,0.7572414773005669,0.13265022843027946,1063245.4706920907,6943.013026648499,1070188.4837187391,3373,0,1475.6494252873563,75,99,41,37.0906152315999,0.6066666666666667,42.76315789473682,8266.66555218403,110.22220736245373,0
3375,32.12592281445391,2,1,173,0.011494252873563218,0.005747126436781609,0.9942528735632183,174,4750,3600,1150,0.7578947368421053,59,36,23,220.58856587262525,0.4036006743737957,0.7591733182866183,0.13375487288530769,1065309.7598493882,7449.03042705754,1072758.7902764457,3374,0,1476.5919540229886,65,109,41,36.79080866580867,0.6149038461538461,42.471590909090914,8273.337792983666,127.2821198920564,0
3376,32.11450626718889,5,0,178,0.028089887640449437,0.0,1.0,178,5300,3700,1600,0.6981132075471698,69,37,32,202.84156716962505,0.40774111809390806,0.7448068170486193,0.11971194030938515,1056712.5055202553,1969.0441334935986,1058681.549653749,3375,0,1444.247191011236,69,109,46,38.26371164220662,0.602506038647343,43.46726190476188,8238.422225298584,119.39742355505194,8
3377,32.033703265431605,0,0,178,0.0,0.0,1.0,178,4250,2700,1550,0.6352941176470588,58,27,31,200.6954724787972,0.40805785670454303,0.7424537820874595,0.11879002289961162,1054940.4892593524,2494.3559857835353,1057434.845245136,3376,1,1445.247191011236,71,107,46,38.2087138508371,0.6025528169014085,43.35937499999997,8221.149627104847,115.79083981837813,0
3378,32.463585570843975,2,0,180,0.011111111111111112,0.0,1.0,180,4950,3600,1350,0.7272727272727273,63,36,27,196.66507928809736,0.4110955927995034,0.7399038404534095,0.11716137686006017,1071096.7617672898,1179.4659156372795,1072276.2276829272,3377,0,1430.1777777777777,75,105,51,38.0675754988795,0.6030555555555556,43.11951754385962,8339.261523694531,111.19015364926041,0
3379,32.55100103543294,0,2,178,0.0,0.011111111111111112,0.9888888888888889,180,5050,3500,1550,0.693069306930693,66,35,31,195.86493524355248,0.4109811452513967,0.7369906589536652,0.11714159551576704,1075186.1086578525,1068.2515094072005,1076254.3601672598,3378,1,1431.1777777777777,77,103,37,37.941217222626335,0.6036255411255411,42.975427350427324,8366.407130447884,108.65463805776473,0
3380,32.289471081732096,2,1,179,0.011111111111111112,0.005555555555555556,0.9944444444444445,180,4750,3400,1350,0.7157894736842105,61,34,27,193.01230193033751,0.41000931098696464,0.7340059918438031,0.11606917342962374,1068217.7266107097,485.8324751846653,1068703.5590858944,3379,0,1432.1555555555556,78,102,43,37.8094884150092,0.6052350427350428,42.7742616033755,8305.68304143492,106.48311591583231,0
3381,31.90224593519436,0,2,177,0.0,0.0111731843575419,0.9888268156424581,179,4750,3200,1550,0.6736842105263158,63,32,31,194.72370487178972,0.41001951122549324,0.7366329136659264,0.11750006113233555,1056437.0558045737,592.6674940225339,1057029.7232985962,3380,1,1438.4078212290503,69,110,43,37.63757179754055,0.6108091787439613,42.64880952380953,8210.080970286499,118.98668072878984,0
3382,31.855494880545606,0,0,177,0.0,0.0,1.0,177,5700,4200,1500,0.7368421052631579,72,42,30,197.71228678885166,0.40948547979797983,0.7378335323033247,0.11963638650244061,1055724.1313101745,645.9264439018489,1056370.0577540763,3381,2,1436.5254237288136,70,107,43,37.45678519869309,0.6113095238095239,42.54694835680752,8201.294368600582,117.16134812286546,0
3383,32.03071964862044,2,1,178,0.0111731843575419,0.00558659217877095,0.994413407821229,179,5800,4100,1700,0.7068965517241379,75,41,34,193.60956874020945,0.4114410060050635,0.7354561235452259,0.1184961101586956,1064950.2732974046,-363.08737142425844,1064587.1859259803,3382,0,1421.463687150838,75,104,44,37.140117288544,0.6130555555555556,42.13267543859649,8259.675979566136,110.12901306088182,0
3384,31.827147416895713,0,0,178,0.0,0.0,1.0,178,4500,3100,1400,0.6888888888888889,59,31,28,195.2740625621515,0.41076765801223053,0.7361548881601268,0.119966329110004,1059301.4369111431,1270.8190127128032,1060572.2559238558,3383,1,1430.3988764044943,78,100,37,36.958165107919804,0.6131143162393162,41.99630801687765,8211.521538850218,105.27591716474639,0
3385,31.705691801145342,0,0,178,0.0,0.0,1.0,178,4950,3200,1750,0.6464646464646465,67,32,35,197.63646538223102,0.4105157218730824,0.7380845750395093,0.12179187892805535,1056167.3946080012,1197.4381444571827,1057364.8327524585,3384,2,1431.3988764044943,80,98,38,36.784000132861685,0.6134114583333333,41.885288065843625,8183.705505925781,102.29631882407226,0
3386,31.918622303704023,0,1,177,0.0,0.0056179775280898875,0.9943820224719101,178,5050,3700,1350,0.7326732673267327,64,37,27,197.55790215843837,0.4101189720476523,0.7378121530911841,0.12218662316544023,1064338.0940346543,1403.680208959578,1065741.774243614,3385,3,1432.3988764044943,82,96,38,36.652674507135806,0.6139481707317074,41.754518072289166,8242.839999288648,100.52243901571522,0
3387,32.13593170977039,0,0,177,0.0,0.0,1.0,177,6150,4800,1350,0.7804878048780488,75,48,27,198.04588759810295,0.40924338726245507,0.737939594073973,0.12298405118746476,1072787.4529932942,942.2286664332692,1073729.6816597276,3386,4,1441.2542372881355,72,105,43,36.49227321257642,0.6197916666666667,41.609589041095916,8303.616601034908,115.32800834770705,0
3388,32.033241583549476,0,1,176,0.0,0.005649717514124294,0.9943502824858758,177,4850,3300,1550,0.6804123711340206,64,33,31,198.2047770644119,0.4092728128745078,0.7379764037103023,0.1235080520756588,1070381.6500282125,2180.9512635361702,1072562.6012917487,3387,5,1442.2542372881355,74,103,42,36.36224233958346,0.6200731981981982,41.48611111111114,8281.03785548072,111.90591696595567,0
3389,31.793013268920944,1,0,177,0.005649717514124294,0.0,1.0,177,5400,3600,1800,0.6666666666666666,72,36,36,199.6593356583578,0.4106170283341894,0.738076553045313,0.12513750597571638,1064054.2755068843,1689.6739504282823,1065743.9494573127,3388,0,1438.3559322033898,77,100,43,36.11378163767444,0.620806277056277,41.27938034188037,8225.508093734115,106.82478043810539,0
3390,31.544539153128913,0,1,176,0.0,0.005649717514124294,0.9943502824858758,177,4200,2900,1300,0.6904761904761905,55,29,26,201.30405367355067,0.41060365305598356,0.7398539650195266,0.12657266411312693,1056666.9936301506,2942.269840158945,1059609.2634703096,3389,1,1439.3559322033898,78,99,44,35.95517065715745,0.6215277777777778,41.165611814346015,8164.811492298586,104.67707041408444,0
3391,31.51488383293842,0,1,175,0.0,0.005681818181818182,0.9943181818181818,176,5700,4300,1400,0.7543859649122807,71,43,28,201.38208761534523,0.41103625541125544,0.7379988417929844,0.12689907887198046,1056307.098198737,1644.2657196342025,1057951.3639183713,3390,2,1442.7386363636363,80,96,44,35.87393831023693,0.621484375,41.08796296296299,8159.582770171738,101.99478462714673,0
3392,31.873358012505086,1,0,176,0.005681818181818182,0.0,1.0,176,4800,3600,1200,0.75,60,36,24,206.05018038915043,0.41184117965367967,0.7396734390836022,0.13092842599027257,1070757.7847957807,4125.966942051578,1074883.7517378323,3391,0,1440.9772727272727,92,84,39,35.45204606343447,0.6202445652173914,40.793010752688176,8261.797167623135,89.80214312633844,8
3393,31.390073202947075,0,0,176,0.0,0.0,1.0,176,3500,2100,1400,0.6,49,21,28,206.24939243586894,0.4117674512987013,0.7407247067918612,0.1314748578695663,1055438.6471712324,4836.715946480582,1060275.363117713,3392,1,1441.9772727272727,93,83,41,35.33195696765096,0.6210797491039426,40.68040780141845,8140.060982071877,87.52753744163309,0
3394,31.694386448932367,0,1,175,0.0,0.005681818181818182,0.9943181818181818,176,5150,3500,1650,0.6796116504854369,68,35,33,206.37168305909634,0.4114955357142857,0.7418863328309684,0.13221849113024636,1067127.2501512857,3694.9693303890986,1070822.2194816747,3393,2,1442.9772727272727,76,100,42,35.1479685816564,0.6291118421052632,40.50324675324674,8224.590379645817,108.2182944690239,0
3395,31.994008534760745,0,0,175,0.0,0.0,1.0,175,4650,3600,1050,0.7741935483870968,57,36,21,204.2475076523147,0.41079365079365077,0.7372801467479702,0.1312305046749664,1078042.3903246229,4387.494273469698,1082429.8845980926,3394,3,1452.12,79,96,42,35.10145499991641,0.6288238396624473,40.40364583333334,8305.527970801128,105.13326545317884,0
3396,31.53031028847083,0,0,175,0.0,0.0,1.0,175,4550,3400,1150,0.7472527472527473,57,34,23,206.79418844990565,0.4106308155446086,0.7394212822353525,0.13341061484286976,1063585.5530404835,4438.662257610349,1068024.2152980939,3395,4,1453.12,82,93,43,34.88979351887644,0.6290650406504066,40.26104417670684,8189.649871111879,99.87377891599853,0
3397,32.02914396300105,1,0,176,0.005681818181818182,0.0,1.0,176,5600,4500,1100,0.8035714285714286,67,45,22,208.09151858417437,0.4111471861471861,0.7424648394475977,0.1349952838215359,1082020.2845715873,4231.848831076727,1086252.133402664,3396,0,1445.8579545454545,85,91,43,34.658861447654566,0.6299019607843137,40.06782945736436,8325.404910925467,97.9459401285349,0
3398,31.609345671097522,0,0,176,0.0,0.0,1.0,176,3950,2600,1350,0.6582278481012658,53,26,27,208.5669698727137,0.41124797077922076,0.7450040808638871,0.13579360268691135,1068868.2594410912,5436.122812950214,1074304.3822540415,3397,1,1446.8579545454545,86,90,37,34.518588858195265,0.6308139534883721,39.9425287356322,8220.246503546956,95.58426166915065,0
3399,31.696919568285367,0,0,176,0.0,0.0,1.0,176,5450,4100,1350,0.7522935779816514,68,41,27,207.33632220580716,0.41109036796536796,0.7449136852306968,0.13552760302726588,1072957.6489537817,3842.618563333525,1076800.2675171152,3398,2,1447.8579545454545,88,88,39,34.410938929123006,0.6315104166666667,39.8057116104869,8247.357431209673,93.71997080920083,0
3400,31.79958195566705,0,2,174,0.0,0.011363636363636364,0.9886363636363636,176,4050,3000,1050,0.7407407407407407,51,30,21,207.57592877316898,0.41105316558441557,0.7465110502980459,0.13606425610761327,1077231.1111770582,5471.4496811863155,1082702.5608582445,3399,3,1448.8579545454545,90,86,40,34.30623964700882,0.6318287037037037,39.709249084249095,8277.137066047568,91.96818962275076,0
3401,32.095751908689145,0,0,174,0.0,0.0,1.0,174,4200,2800,1400,0.6666666666666666,56,28,28,208.9223356671067,0.4100475051491595,0.7458219840196554,0.13756473616237236,1088558.1018828016,6484.820230941545,1095042.9221137431,3400,4,1466.0804597701149,71,103,40,34.11310780283673,0.6411384976525822,39.55439814814815,8359.197422746278,117.73517496825744,0
3402,32.4950822630039,1,0,175,0.005714285714285714,0.0,1.0,175,5200,3500,1700,0.6730769230769231,69,35,34,204.17793866900695,0.41071428571428575,0.7416828577519261,0.13509149651569996,1103502.955759213,4862.191764414566,1108365.1475236276,3401,0,1458.6971428571428,74,101,39,34.06778494279829,0.6413288288288288,39.38888888888889,8468.579494208416,114.44026343524887,0
3403,32.13792196911595,0,0,175,0.0,0.0,1.0,175,5400,3900,1500,0.7222222222222222,69,39,30,204.26127319234192,0.4107211275314724,0.7421835307549594,0.13540763871889705,1091926.7425868122,4207.669334709806,1096134.411921522,3402,1,1459.6971428571428,75,100,41,33.99829337329334,0.6415277777777777,39.32291666666667,8377.619763303415,111.70159684404554,0
3404,31.904031204203225,1,1,175,0.005681818181818182,0.005681818181818182,0.9943181818181818,176,4950,3700,1250,0.7474747474747475,62,37,25,198.57046616786965,0.4115212391774892,0.7351147255300616,0.1322394806607301,1085279.8725849248,2950.9060443589083,1088230.7786292837,3403,0,1452.3977272727273,79,97,40,33.987287007454746,0.6413502109704641,39.166666666666664,8321.634805763002,105.337149440038,0
3405,32.0322660001918,0,1,174,0.0,0.005714285714285714,0.9942857142857143,175,4400,3000,1400,0.6818181818181818,58,30,28,199.270286087873,0.4107512315270936,0.7354125011678967,0.12687625651389084,1076686.6797513382,3510.332540210243,1080197.0122915485,3404,1,1461.36,85,90,40,35.55525709302687,0.6232843137254902,40.7218992248062,8305.265092055542,97.70900108300638,8
3406,32.24122027134504,0,1,173,0.0,0.005747126436781609,0.9942528735632183,174,4650,3700,950,0.7956989247311828,56,37,19,201.06642572607254,0.409388634199278,0.7383079500367995,0.12828570979830528,1084320.100205313,4154.0733782438465,1088474.173583557,3405,4,1470.7528735632184,86,88,40,35.434267423787766,0.6236676356589148,40.64894636015326,8361.794448007733,97.23016800008992,0
3407,31.770833118697354,2,0,175,0.011428571428571429,0.0,1.0,175,4300,3300,1000,0.7674418604651163,53,33,20,196.73977416906195,0.4108771209633279,0.734356810311217,0.12620927428414863,1070071.4721726207,2805.123955999258,1072876.59612862,3406,0,1448.1371428571429,74,101,42,35.35211644458712,0.6304898648648649,40.45833333333332,8245.854979015217,111.43047268939483,0
3408,31.693021872838628,0,0,175,0.0,0.0,1.0,175,4800,2800,2000,0.5833333333333334,68,28,40,195.4012982429757,0.4107744937055282,0.732334910512241,0.12580737890849042,1068496.7561964144,1957.1306658374178,1070453.8868622517,3407,1,1449.1371428571429,77,98,42,35.25723445107316,0.6304112554112554,40.33119658119657,8229.689066445948,106.87907878501231,0
3409,31.92358425853338,0,0,175,0.0,0.0,1.0,175,5450,4000,1450,0.7339449541284404,69,40,29,198.00004901480312,0.41061165845648606,0.7336367751060833,0.1278644817806589,1077139.3349607487,2204.7282235999796,1079344.0631843486,3408,2,1450.1371428571429,80,95,43,35.08281765676567,0.6302083333333333,40.22633744855966,8292.906404608695,103.6613300576087,0
3410,31.52410771301605,0,1,174,0.0,0.005714285714285714,0.9942857142857143,175,4400,2900,1500,0.6590909090909091,59,29,30,197.1769840239369,0.41062807881773394,0.7332215806792068,0.12780401133495217,1064712.64623133,2587.365687207816,1067300.0119185378,3409,3,1451.1371428571429,82,93,43,34.97322017802243,0.6307164634146342,40.09789156626507,8193.182061105063,99.91685440372028,0
3411,31.638171125386748,0,0,174,0.0,0.0,1.0,174,5500,4500,1000,0.8181818181818182,65,45,20,201.2531114705348,0.40994992027107835,0.7356852726431566,0.13090706680508363,1069571.8093374716,2750.9309140673986,1072322.740251539,3410,4,1441.2931034482758,84,90,40,34.74241603041444,0.6312003968253967,39.97549019607845,8226.699937971316,97.93690402346805,0
3412,31.527681432031024,0,0,174,0.0,0.0,1.0,174,5050,3600,1450,0.7128712871287128,65,36,29,198.75016049846317,0.40977482116359937,0.7325935244632609,0.1299947866182009,1067402.3321827354,2579.276967550749,1069981.6091502863,3411,5,1442.2931034482758,87,87,41,34.61277843485122,0.6320641762452107,39.78456439393941,8203.989357485103,94.2987282469552,0
3413,31.05462835904071,0,1,173,0.0,0.005747126436781609,0.9942528735632183,174,3800,2800,1000,0.7368421052631579,48,28,20,200.3027500173824,0.4098218833743051,0.7357147785939671,0.1312353059410671,1051864.9570733863,3538.2887097431044,1055403.2457831295,3412,6,1443.2931034482758,87,87,41,34.51200654902678,0.6326628352490422,39.725378787878796,8082.731633032534,92.90496129922452,0
3414,31.198192543111535,0,1,172,0.0,0.005780346820809248,0.9942196531791907,173,4450,3100,1350,0.6966292134831461,58,31,27,215.16089082194281,0.40904355424116146,0.7455191012590219,0.1321837723928707,1038367.9616981418,5633.235127987135,1044001.1968261289,3413,7,1452.6011560693642,78,95,30,36.445077596633794,0.6131143162393162,41.99630801687762,8049.24885932305,103.19549819644936,8
3415,31.06446683104956,0,0,172,0.0,0.0,1.0,172,5500,4300,1200,0.7818181818181819,67,43,24,214.33064689095139,0.40805411056711544,0.7451992481337011,0.13196268485676577,1034551.3504827429,4447.212038174668,1038998.5625209175,3414,8,1461.8023255813953,78,94,32,36.38568861867538,0.6139155982905983,41.917194092826996,8017.20476376756,102.78467645855845,0
3416,31.0018555314957,3,1,174,0.017142857142857144,0.005714285714285714,0.9942857142857143,175,4150,2900,1250,0.6987951807228916,54,29,25,211.36836628511927,0.409471811713191,0.7473271889400912,0.13104838709677413,1034471.6377002574,4580.916005799159,1039052.5537060566,3415,0,1437.7257142857143,78,97,35,36.20631720430108,0.6164529914529915,41.66666666666667,8008.812678969735,102.67708562781712,0
3417,30.859760127208705,0,0,174,0.0,0.0,1.0,174,4350,3100,1250,0.7126436781609196,56,31,25,214.989116794591,0.4088377294974863,0.7506117727041379,0.1337653396633514,1030740.4174882368,5169.594400056937,1035910.0118882938,3416,1,1446.6264367816093,73,101,35,35.983368280594725,0.6200057077625571,41.53997747747749,7976.014297518037,109.2604698290142,0
3418,30.494792018566663,2,2,174,0.011363636363636364,0.011363636363636364,0.9886363636363636,176,5050,3600,1450,0.7128712871287128,65,36,29,207.3709749572379,0.4099905303030303,0.744348886213124,0.12990797053826367,1020469.3144896935,2073.143331934628,1022542.4578216281,3417,0,1431.1761363636363,75,101,39,35.93184326710817,0.6215277777777778,41.296600877193,7889.106350746282,105.1880846766171,0
3419,30.586039306779142,1,0,175,0.005714285714285714,0.0,1.0,175,5800,4700,1100,0.8103448275862069,69,47,22,207.5618395650863,0.41045840175150516,0.7438324218346906,0.13053094011844657,1024610.3856558984,1734.0032968464693,1026344.3889527449,3418,0,1437.9257142857143,77,98,39,35.786640525573574,0.6220238095238095,41.159188034188055,7916.915248985004,102.8170811556494,0
3420,30.355356561141402,0,0,175,0.0,0.0,1.0,175,4200,3100,1100,0.7380952380952381,53,31,22,209.19675464111367,0.41045566502463054,0.7454754749656174,0.13168194561939708,1017143.0299526202,3356.6041743835417,1020499.6341270037,3419,1,1438.9257142857143,78,97,41,35.71049593371704,0.6219284188034189,41.126054852320685,7858.210909347193,100.74629370957939,0
3421,30.608325458076674,0,2,173,0.0,0.011428571428571429,0.9885714285714285,175,4200,2700,1500,0.6428571428571429,57,27,30,214.63729210439297,0.41047482211275316,0.7509110522702738,0.13585701226496005,1027174.5109942555,4893.991111692438,1032068.5021059479,3420,2,1439.9257142857143,81,94,32,35.36926710470402,0.6226851851851851,40.92987804878051,7929.702609146592,97.89756307588385,0
3422,31.1767167684819,0,2,171,0.0,0.011560693641618497,0.9884393063583815,173,4500,3300,1200,0.7333333333333333,57,33,24,212.8793836703828,0.4090057467401533,0.7465167325754454,0.13508405307183516,1046967.3125244287,5475.55124264772,1052442.8637670765,3421,4,1457.3236994219653,81,92,34,35.3239935133899,0.6235853909465021,40.84095528455286,8079.728135083872,99.74973006276386,0
3423,31.379458010727582,0,0,171,0.0,0.0,1.0,171,4350,2800,1550,0.6436781609195402,59,28,31,217.3854810416612,0.4079864694415778,0.7504958132413948,0.1384499854736553,1054826.2513718442,7310.782413968192,1062137.0337858123,3422,5,1474.888888888889,83,88,37,35.07525666778264,0.6241214859437751,40.711805555555564,8136.323010246832,98.02798807526304,0
3424,31.247267831900835,0,1,170,0.0,0.005847953216374269,0.9941520467836258,171,4500,3400,1100,0.7555555555555555,56,34,22,217.15330757417945,0.4079635362917096,0.7519160794570232,0.13881796039503402,1051442.8285399678,6964.857588521017,1058407.6861284887,3423,6,1475.888888888889,70,101,37,34.94761621988465,0.63125,40.58098591549296,8106.135413786246,115.80193448266066,0
3425,31.247451505595937,0,0,170,0.0,0.0,1.0,170,4150,3000,1150,0.7228915662650602,53,30,23,211.35953514622304,0.40840222183547975,0.7453219693445241,0.1371883964265315,1055763.0270165761,6479.1165229583985,1062242.1435395346,3424,7,1482.8764705882354,75,95,41,34.55503708390451,0.6341666666666667,40.04934210526314,8122.795576413517,108.30394101884688,8
3426,31.092060569251103,1,0,171,0.005847953216374269,0.0,1.0,171,4300,3000,1300,0.6976744186046512,56,30,26,209.60933820012184,0.40905572755417957,0.7443253070007085,0.1365023577395181,1051438.0110336107,5578.24513024131,1057016.256163852,3425,0,1475.1988304093568,79,92,34,34.483688396001234,0.6335706751054853,39.93489583333332,8085.959970698572,102.35392367972875,0
3427,31.291974382036894,0,0,171,0.0,0.0,1.0,171,4850,3200,1650,0.6597938144329897,65,32,33,208.13028315764882,0.4087432633872263,0.7428280147699631,0.13609216988148715,1059344.2007090307,5046.321690996483,1064390.5224000271,3426,1,1476.1988304093568,83,88,36,34.37847503534603,0.6334086345381527,39.79414682539681,8142.354891595694,98.10066134452644,0
3428,30.888828647466784,1,0,172,0.005813953488372093,0.0,1.0,172,4450,3000,1450,0.6741573033707865,59,30,29,211.84000000000037,0.4094070164105354,0.7496744186046516,0.13936842105263147,1047391.3793764478,5525.877961421311,1052917.2573378691,3427,0,1468.610465116279,66,106,38,34.06666666666666,0.6436237373737373,39.58333333333332,8043.965793611118,121.87826960016845,0
3429,31.095891572071025,1,0,173,0.005780346820809248,0.0,1.0,173,5150,4000,1150,0.7766990291262136,63,40,23,207.25299659960908,0.4103430120535914,0.745298384457159,0.13728772325088173,1056314.3255455848,4034.8618640833442,1060349.1874096682,3428,0,1461.1156069364163,70,103,39,33.94651300236405,0.64375,39.34859154929576,8105.187935290673,115.78839907558104,0
3430,31.279795484526666,0,0,173,0.0,0.0,1.0,173,4950,3400,1550,0.6868686868686869,65,34,31,208.0153102453514,0.41043403011157414,0.7455872553425611,0.1384017410030676,1063789.1257213317,4706.8850045105955,1068496.0107258423,3429,1,1462.1156069364163,72,101,37,33.77297970126389,0.6442418981481481,39.198059360730575,8157.831365163966,113.30321340505509,0
3431,31.209041706612627,0,0,173,0.0,0.0,1.0,173,4050,2800,1250,0.691358024691358,53,28,25,205.5253327276189,0.410408825110902,0.7428679138758589,0.13731825919581048,1062541.6131618517,5025.843716406203,1067567.456878258,3430,2,1463.1156069364163,76,97,42,33.69267026111601,0.6437774122807017,39.055735930735935,8143.820420439014,107.15553184788176,0
3432,31.110397874231495,0,1,172,0.0,0.005780346820809248,0.9942196531791907,173,4300,2600,1700,0.6046511627906976,60,26,34,202.21820476109662,0.41018478066048303,0.7382789942766046,0.1355690078153979,1060120.2778221017,3975.123882403955,1064095.4017045058,3431,3,1464.1156069364163,80,93,36,33.66122742200332,0.6432291666666667,38.94032921810699,8121.670226940554,101.52087783675692,0
3433,31.09036433637388,0,1,171,0.0,0.005813953488372093,0.9941860465116279,172,3350,2100,1250,0.6268656716417911,46,21,25,207.69580160184088,0.40925685094519243,0.7439756583114652,0.13973251573736434,1060405.240996783,6298.34331032408,1066703.584307107,3432,4,1473.5348837209303,81,91,37,33.39656290531778,0.6440329218106996,38.82113821138212,8120.1459699675825,100.24871567861213,0
3434,30.64564417428716,0,1,170,0.0,0.005847953216374269,0.9941520467836258,171,4600,3000,1600,0.6521739130434783,62,30,32,207.539382903224,0.40856696479761495,0.742187092311501,0.13996285912308346,1045885.9771998455,4612.506059038334,1050498.4832588837,3433,5,1482.6900584795321,83,88,37,33.31790709448768,0.6440763052208835,38.74007936507937,8006.478564780287,96.46359716602755,0
3435,30.672875610382203,0,1,169,0.0,0.0058823529411764705,0.9941176470588236,170,4650,3300,1350,0.7096774193548387,60,33,27,207.68977454973043,0.4081534980856248,0.7410537319443182,0.14048207490713938,1047619.8485654322,4865.986032475441,1052485.8345979077,3434,6,1492.3058823529411,84,86,38,33.21151982619842,0.6447172619047619,38.63970588235294,8016.671790963498,95.43656894004164,0
3436,31.060355077502365,0,0,169,0.0,0.0,1.0,169,4350,3300,1050,0.7586206896551724,54,33,21,208.72854175893968,0.40747687141917915,0.7407281049417285,0.1414936759244823,1061451.0469986505,6161.025837705551,1067612.072836356,3435,7,1502.094674556213,84,85,38,33.109306395412425,0.6454613095238095,38.56617647058823,8120.227388092615,96.66937366776922,0
3437,31.289587273674158,0,0,169,0.0,0.0,1.0,169,4350,3200,1150,0.735632183908046,55,32,23,210.61947000594606,0.4071642833662064,0.7435041340006605,0.14345136238801037,1070581.2307000083,6947.050281670127,1077528.2809816785,3436,8,1503.094674556213,69,100,37,32.89809573923429,0.6538345410628019,38.407738095238116,8185.113908986924,118.62483926068006,0
3438,31.541457817642303,0,0,169,0.0,0.0,1.0,169,4050,2300,1750,0.5679012345679012,58,23,35,204.92754205687189,0.4071261270780502,0.734350267599206,0.14019215294354273,1080417.2615822603,6431.450762374041,1086848.7123446343,3437,9,1504.094674556213,73,96,40,32.89636441862969,0.6532534246575342,38.26013513513515,8255.656906830567,113.09119050452831,0
3439,32.014570815691144,0,0,169,0.0,0.0,1.0,169,3750,2500,1250,0.6666666666666666,50,25,25,205.1626288596005,0.4069412158354466,0.7349467694140503,0.14086439200724482,1097639.433658436,7488.918349865995,1105128.352008302,3438,10,1505.094674556213,74,95,37,32.766477493723706,0.6539977477477478,38.13888888888892,8383.371085542314,113.28879845327451,0
3440,31.986764483700888,0,1,168,0.0,0.005917159763313609,0.9940828402366864,169,5050,4000,1050,0.7920792079207921,61,40,21,205.67966376962585,0.4070527496008265,0.7374424194391527,0.1418084032832456,1097845.1956941993,6310.886144296742,1104156.081838496,3439,11,1506.094674556213,76,93,45,32.61174506462883,0.6544682017543859,38.00054112554115,8380.514985874448,110.26993402466378,0
3441,32.423865514315445,0,0,168,0.0,0.0,1.0,168,5750,4400,1350,0.7652173913043478,71,44,27,209.5192300863715,0.406399255061306,0.7392270032121258,0.1450085842078744,1113923.1273490717,7327.663203516369,1121250.790552588,3440,12,1515.8630952380952,77,91,33,32.38188642075946,0.6553030303030303,37.87393162393164,8499.140388821937,110.37844660807711,0
3442,32.34886054705357,0,0,168,0.0,0.0,1.0,168,5650,4000,1650,0.7079646017699115,73,40,33,207.7907477843772,0.4062537128124703,0.7362214498510431,0.14430709173715042,1112309.0850450017,6975.507309771554,1119284.5923547733,3441,13,1516.8630952380952,79,89,34,32.311320754717,0.6555907172995781,37.76041666666667,8483.151711167442,107.38166722996762,0
3443,32.10112885937444,0,0,168,0.0,0.0,1.0,168,3550,2700,850,0.7605633802816901,44,27,17,205.71984377880403,0.40620396112536833,0.7332518514367887,0.1431057958292119,1104251.0275087927,8283.26977433862,1112534.2972831314,3442,14,1517.8630952380952,80,88,34,32.309848336275074,0.6557291666666667,37.70576131687243,8419.941155038608,105.2492644379826,0
3444,32.56683946895846,0,1,167,0.0,0.005952380952380952,0.9940476190476191,168,5550,4200,1350,0.7567567567567568,69,42,27,207.7667757057285,0.4056470392548237,0.7366209748810437,0.1449875175330249,1121160.7792353113,7437.992029888666,1128598.7712651999,3443,15,1518.8630952380952,81,87,34,32.14985960495742,0.6563786008230452,37.60162601626017,8545.485722444202,105.49982373387904,0
3445,32.97343636672898,0,0,167,0.0,0.0,1.0,167,4750,3200,1550,0.6736842105263158,63,32,31,207.74465883911353,0.40528431089627975,0.7354920899139632,0.14536498088698296,1135927.9741414222,9046.593890763059,1144974.5680321853,3444,16,1525.0898203592815,81,86,37,32.059669860781746,0.6572788065843622,37.51270325203252,8655.10817639382,106.85318736288667,0
3446,32.56551865368259,0,1,166,0.0,0.005988023952095809,0.9940119760479041,167,3850,2900,950,0.7532467532467533,48,29,19,202.9800765638328,0.4048860111103095,0.7286402041965545,0.14268173980616924,1123155.8531196073,8345.652211867073,1131501.5053314744,3445,17,1526.0898203592815,75,92,37,32.03192951327284,0.6613888888888889,37.36293859649124,8552.91212228437,114.03882829712492,0
3447,32.921555240224855,0,1,165,0.0,0.006024096385542169,0.9939759036144579,166,5750,4200,1550,0.7304347826086957,73,42,31,202.2124277012606,0.40419937325057803,0.7264625301770506,0.14256013338011994,1136264.9540841582,7003.378975443755,1143268.333059602,3446,18,1536.1024096385543,75,91,37,31.95420774862194,0.6623611111111112,37.26699561403509,8649.579117322779,115.32772156430372,0
3448,33.22661924742775,0,1,164,0.0,0.006060606060606061,0.9939393939393939,165,4300,3100,1200,0.7209302325581395,55,31,24,203.0460984330713,0.4033829145109633,0.7273969620123479,0.14383445176426524,1148155.2628139097,9325.689301952274,1157480.952115862,3447,19,1546.2363636363636,74,91,37,31.773254790081698,0.6644144144144144,37.11111111111111,8734.909015490437,118.03931102014104,0
3449,33.1107976856006,0,0,164,0.0,0.0,1.0,164,4750,3400,1350,0.7157894736842105,61,34,27,205.45178516651714,0.402679840640431,0.7293669440804278,0.14639907205865504,1145818.6098712808,9532.095775014277,1155350.705646295,3448,20,1552.1524390243903,78,86,40,31.514802191927274,0.6645299145299146,36.919831223628684,8710.79424344807,111.67684927497525,0
3450,33.12485066593422,0,0,164,0.0,0.0,1.0,164,4650,3300,1350,0.7096774193548387,60,33,27,208.412440151341,0.4024242169185495,0.7326980676239949,0.14893318628645213,1147109.4064824446,10364.374105112494,1157473.780587557,3449,21,1553.1524390243903,78,86,35,31.342690014529772,0.6654647435897436,36.827531645569614,8717.548713625793,111.76344504648452,0
3451,32.84401371713248,0,0,164,0.0,0.0,1.0,164,4400,3300,1100,0.75,55,33,22,209.82838626737956,0.40196986133971774,0.7346927697763628,0.15045141738746126,1138324.5220462072,10570.559501908232,1148895.0815481155,3450,22,1554.1524390243903,79,85,35,31.19436201780416,0.6661392405063291,36.71874999999999,8647.21298646377,109.45839223371861,0
3452,33.29884750477731,0,0,164,0.0,0.0,1.0,164,4700,3400,1300,0.723404255319149,60,34,26,214.53340885702366,0.40188491321262904,0.7402232058336216,0.1547699976731657,1155815.2465650258,12092.19697090309,1167907.4435359288,3451,23,1555.1524390243903,81,83,36,30.86936301689086,0.6673096707818931,36.52184959349592,8773.518751226924,108.31504631144351,0
3453,32.89528536507358,0,1,163,0.0,0.006097560975609756,0.9939024390243902,164,4150,2800,1350,0.6746987951807228,55,28,27,198.3497343759,0.4019114107935558,0.7223745435288509,0.13382658741370748,1122795.07375919,7591.220927741051,1130386.2946869312,3452,24,1556.1524390243903,73,91,46,33.54227277625126,0.6485445205479452,38.724662162162176,8594.726797031719,117.73598352098244,8
3454,33.211390087828036,0,1,162,0.0,0.006134969325153374,0.9938650306748467,163,4350,3000,1350,0.6896551724137931,57,30,27,200.3217790444399,0.4011099118887122,0.7233678369053091,0.13545161995813434,1134221.026012122,8491.834752071736,1142712.8607641936,3453,25,1566.3067484662577,75,88,46,33.41593245227608,0.6483333333333333,38.65131578947369,8679.75310025639,115.73004133675187,0
3455,32.707138666255325,0,0,162,0.0,0.0,1.0,162,4750,3500,1250,0.7368421052631579,60,35,25,200.56646210237724,0.40027285739846125,0.7223391320613541,0.13612915193757075,1118083.558793605,7700.012744413625,1125783.5715380188,3454,26,1576.2962962962963,60,102,47,33.28027037617553,0.6583333333333333,38.52459016393442,8552.112487324126,142.53520812206878,0
3456,32.25674858116492,0,0,162,0.0,0.0,1.0,162,4800,3600,1200,0.75,60,36,24,198.83092493157832,0.400351934923191,0.7203060829619652,0.13561640328091767,1104077.5446851135,6704.951881185336,1110782.4965662989,3455,27,1577.2962962962963,62,100,45,33.15757183181665,0.6586021505376345,38.359788359788354,8439.66252560107,136.1235891225979,0
3457,32.150288580190804,0,1,161,0.0,0.006172839506172839,0.9938271604938271,162,3950,2700,1250,0.6835443037974683,52,27,25,201.85777406068425,0.4001666219359456,0.7238894191479679,0.13822717469415008,1101546.6073641106,8121.1492373235005,1109667.7566014342,3456,28,1578.2962962962963,62,100,49,32.943432078490815,0.6599462365591398,38.22751322751322,8416.060992089617,135.7429192272519,0
3458,31.816991019159264,0,0,161,0.0,0.0,1.0,161,4800,3500,1300,0.7291666666666666,61,35,26,201.88184447652924,0.40006146480331267,0.7221547800849997,0.1387364635170497,1091114.538794894,7055.243125414165,1098169.7819203082,3457,29,1585.447204968944,64,97,48,32.82187002814834,0.6598307291666667,38.10897435897436,8332.58441081892,130.19663141904562,0
3459,31.5760041330107,0,0,161,0.0,0.0,1.0,161,3600,2500,1100,0.6944444444444444,47,25,22,203.62028380423916,0.39981075310559006,0.7236741066322887,0.1402688908279769,1083512.9852668531,8325.044313122897,1091838.029579976,3458,30,1586.447204968944,64,97,49,32.6945820843784,0.66064453125,38.028846153846146,8272.002236575718,129.2500349464956,0
3460,32.03729675728658,0,0,161,0.0,0.0,1.0,161,4950,3900,1050,0.7878787878787878,60,39,21,204.58765243330862,0.3994079968944099,0.7255691555234265,0.14139951033490283,1100257.5833402073,7869.823209503607,1108127.406549711,3459,31,1587.447204968944,66,95,49,32.557938344110276,0.6605113636363636,37.91977611940298,8396.341906678785,127.21730161634522,0
3461,31.812502240467413,0,0,161,0.0,0.0,1.0,161,4450,3200,1250,0.7191011235955056,57,32,25,206.15960594163144,0.3994047619047619,0.7271385092441847,0.1428427326350234,1093227.627465887,8425.875376574355,1101653.5028424615,3460,32,1588.447204968944,67,94,44,32.43226792879125,0.6607587064676617,37.83700980392157,8340.060712980378,124.47851810418474,0
3462,32.053838503683636,0,0,161,0.0,0.0,1.0,161,3550,2700,850,0.7605633802816901,44,27,17,205.25830379825493,0.3994872541407868,0.7260397943170076,0.14256465394959975,1102196.53618707,9496.998294013989,1111693.534481084,3461,33,1589.447204968944,68,93,46,32.37387983804426,0.6609987745098039,37.7566425120773,8405.90622958166,123.61626808208324,0
3463,32.010062664191686,0,0,161,0.0,0.0,1.0,161,4550,3000,1550,0.6593406593406593,61,30,31,207.22612895073325,0.39923977743271216,0.7290560704236726,0.14446832263860712,1101721.6235417326,8911.101445574019,1110632.7249873066,3462,34,1590.447204968944,69,92,47,32.19701803641315,0.6616847826086957,37.63392857142857,8398.354387386356,121.71528097661385,0
3464,31.857116182305102,0,0,161,0.0,0.0,1.0,161,4400,3200,1200,0.7272727272727273,56,32,24,211.43277567999982,0.3993060947204969,0.73399652173913,0.14807875930076217,1097717.7093390264,9818.700439728398,1107536.4097787547,3463,35,1591.447204968944,61,100,48,31.932733333333346,0.6682035519125683,37.48319892473119,8363.028231661932,137.09882346986774,0
3465,32.211688955320454,0,0,161,0.0,0.0,1.0,161,3900,2700,1200,0.6923076923076923,51,27,24,212.3330986501457,0.39914919772256724,0.7355355998939381,0.1490837432697444,1110632.350617428,11064.801693538808,1121697.152310967,3464,36,1592.447204968944,62,99,46,31.824943332074074,0.6683467741935484,37.40079365079366,8458.763954834663,136.43167669088166,0
3466,31.74852771538854,0,0,161,0.0,0.0,1.0,161,5050,3900,1150,0.7722772277227723,62,39,23,210.07954751035888,0.3989356884057971,0.7330443460826255,0.1480245645406696,1095628.0939521422,8783.810843420688,1104411.9047955628,3465,37,1593.447204968944,62,99,46,31.765949189166516,0.6695228494623655,37.28505291005292,8340.812778932035,134.52923836987154,0
3467,31.635602896514737,0,0,161,0.0,0.0,1.0,161,3650,2900,750,0.7945205479452054,44,29,15,209.50551280345704,0.3989615683229814,0.732480631254077,0.14795311795655028,1092342.1815981248,9920.341782512549,1102262.5233806374,3466,38,1594.447204968944,64,97,47,31.705975322193776,0.6689453125,37.211538461538474,8313.47141501683,129.89799085963796,0
3468,31.42898764447627,0,0,161,0.0,0.0,1.0,161,4600,3200,1400,0.6956521739130435,60,32,28,209.28011265889805,0.3988159937888199,0.7327776439922988,0.14823104352575883,1086002.2835127385,8655.736048273457,1094658.019561012,3467,39,1595.447204968944,64,97,47,31.613732422986267,0.669921875,37.11538461538463,8262.197328846,129.09683326321874,0
3469,31.778529343793895,0,0,161,0.0,0.0,1.0,161,4050,2800,1250,0.691358024691358,53,28,25,210.07816049109437,0.39856204710144927,0.7339269436814637,0.14909007168416488,1098615.9871477103,9909.045133219985,1108525.0322809303,3468,40,1596.447204968944,64,97,47,31.52730375426623,0.6705729166666667,37.05128205128207,8356.12354924636,130.56443045697438,0
3470,31.889482980502805,0,0,161,0.0,0.0,1.0,161,4750,3600,1150,0.7578947368421053,59,36,23,207.14541540780377,0.3986542443064182,0.7298695607456978,0.14755127282125122,1103453.7346732016,8765.076450434648,1112218.8111236363,3469,41,1597.447204968944,65,96,47,31.482481401487874,0.6711538461538462,36.93181818181819,8389.108306802742,129.0632047200422,0
3471,31.61553293454245,0,1,160,0.0,0.006211180124223602,0.9937888198757764,161,4350,2800,1550,0.6436781609195402,59,28,31,208.10835734100615,0.3987108566252588,0.7310177513382072,0.1485266495543347,1094499.5249572939,9004.89964987487,1103504.4246071687,3470,42,1598.447204968944,65,96,42,31.392704334612972,0.6717948717948719,36.86868686868688,8319.036696412446,127.98517994480686,0
3472,31.69901840177973,0,0,160,0.0,0.0,1.0,160,3950,2900,1050,0.7341772151898734,50,29,21,210.75804642319753,0.39782003406708594,0.7323329367582132,0.1512065441245164,1098798.1889377837,10366.111942775047,1109164.3008805588,3471,43,1608.975,68,92,44,31.150617319343308,0.6717218137254901,36.699879227053145,8346.355373572478,122.74052019959527,0
3473,31.446858199681998,0,0,160,0.0,0.0,1.0,160,4400,3300,1100,0.75,55,33,22,212.37039807911256,0.39727627096436063,0.7338672690321868,0.15282274574815488,1090859.6667778064,9933.260336410065,1100792.9271142164,3472,44,1609.975,71,89,45,31.009236881614104,0.6710680751173709,36.60300925925925,8283.007818047014,116.66208194432413,0
3474,31.52364887397702,0,0,160,0.0,0.0,1.0,160,4150,3100,1050,0.7469879518072289,52,31,21,212.44722623468107,0.397050248951782,0.7337824213189932,0.15317033198197177,1094032.8587344487,10334.849249546609,1104367.7079839953,3473,45,1610.975,74,86,45,30.944567452158793,0.6701858108108107,36.54166666666668,8305.167992923223,112.23199990436788,0
3475,31.802244580383864,1,0,161,0.006211180124223602,0.0,1.0,161,4700,3800,900,0.8085106382978723,56,38,18,211.7996370251806,0.3978260869565218,0.7352626639425077,0.15326702046312185,1104690.9215170408,9894.627240464335,1114585.5487575051,3474,0,1601.9627329192547,59,102,46,30.841072761603634,0.6804378531073446,36.423611111111114,8382.320785058826,142.07323364506485,0
3476,31.62065435171461,0,0,161,0.0,0.0,1.0,161,4550,3300,1250,0.7252747252747253,58,33,25,207.82908990360917,0.39797004399585917,0.7297394855596195,0.15116652134302214,1099747.8517875734,8961.919032092224,1108709.7708196656,3475,1,1602.9627329192547,62,99,44,30.778634568365607,0.6799395161290323,36.25992063492064,8339.633888296965,134.51022400478976,0
3477,31.394419820960163,0,0,161,0.0,0.0,1.0,161,4350,2700,1650,0.6206896551724138,60,27,33,205.8829824396983,0.39748803053830223,0.7277815666692031,0.15064954784035897,1093455.535607758,8474.777367224804,1101930.312974983,3476,2,1603.9627329192547,66,95,44,30.63577501570847,0.6792929292929293,36.06965174129355,8285.940156726085,125.5445478291831,0
3478,30.96065054910095,0,0,161,0.0,0.0,1.0,161,4000,2900,1100,0.725,51,29,22,204.4532467073407,0.39714835662525877,0.7257161311902729,0.1497932970774199,1078676.3633809215,7907.776927939578,1086584.1403088612,3477,3,1604.9627329192547,67,94,46,30.6324473847106,0.6791044776119404,36.029411764705905,8172.701137593612,121.9806139939345,0
3479,30.59812759352036,0,0,161,0.0,0.0,1.0,161,3900,2700,1200,0.6923076923076923,51,27,24,204.25322190204798,0.3970092520703934,0.7244000504136936,0.1503327773317771,1067215.4447134635,7496.438609270526,1074711.8833227342,3478,4,1605.9627329192547,68,93,42,30.490020958369062,0.6799938725490196,35.88466183574881,8081.434816555568,118.84462965522894,0
3480,30.285707416814827,0,0,161,0.0,0.0,1.0,161,4050,3000,1050,0.7407407407407407,51,30,21,206.44058231338974,0.3966242883022774,0.727108383709119,0.15245245028054671,1057164.1769395669,7398.317657652016,1064562.494597219,3479,5,1606.9627329192547,68,93,43,30.324391498114515,0.6810661764705883,35.77898550724639,8002.1203383015545,117.6782402691405,0
3481,30.728482300320874,0,0,161,0.0,0.0,1.0,161,4200,3200,1000,0.7619047619047619,52,32,20,219.20033109538932,0.3965466485507247,0.7385317396869857,0.14751135561027168,1048133.958151397,9550.262131821553,1057684.2202832184,3480,6,1607.9627329192547,76,85,40,33.08698485868684,0.6462445175438596,38.81222943722945,8025.903784798391,105.60399716839989,7
3482,30.943380346183464,0,0,161,0.0,0.0,1.0,161,3250,2000,1250,0.6153846153846154,45,20,25,219.63113634760307,0.39637195910973083,0.7402493026774035,0.14815704283203845,1056120.1396464503,10941.373278027917,1067061.5129244782,3481,7,1608.9627329192547,76,85,41,32.9927812009182,0.6470668859649122,38.73106060606061,8084.5441643106315,106.37558110935042,0
3483,31.28739909641078,0,0,161,0.0,0.0,1.0,161,4650,3300,1350,0.7096774193548387,60,33,27,223.90950912457856,0.39591097308488615,0.7439917775622318,0.15183421660847754,1069299.836241903,11035.280287983402,1080335.1165298864,3482,8,1609.9627329192547,76,85,42,32.70119700576078,0.6488486842105263,38.55519480519481,8179.927961813253,107.63063107649018,0
3484,31.123389451759476,0,0,161,0.0,0.0,1.0,161,4450,3500,950,0.7865168539325843,54,35,19,219.40542894856242,0.39621506211180124,0.7277741275878455,0.1477229185819261,1061740.8168845428,9940.33987215028,1071681.156756693,3483,9,1610.9627329192547,77,84,39,33.06443538354043,0.6459686147186148,38.795405982906004,8129.5723061827875,105.57886111925698,8
3485,30.956845264229035,0,0,161,0.0,0.0,1.0,161,3350,2100,1250,0.6268656716417911,46,21,25,220.65309045496457,0.39646900879917185,0.7303333781443284,0.14921749934861397,1057258.4749364527,11107.469980886459,1068365.9449173391,3484,10,1611.9627329192547,78,83,41,32.880320535459035,0.6470352564102564,38.647151898734194,8090.6596780364835,103.72640612867286,0
3486,31.36597374356671,0,0,161,0.0,0.0,1.0,161,4250,2400,1850,0.5647058823529412,61,24,37,222.90523912301921,0.3963978390269151,0.7334798784798011,0.1512841126541943,1072223.7030894032,11350.856186102486,1083574.5592755056,3485,11,1612.9627329192547,66,95,42,32.69772961509495,0.6543560606060606,38.526119402985074,8201.382873434464,124.26337687021916,0
3487,31.074520803332085,1,1,161,0.006172839506172839,0.006172839506172839,0.9938271604938271,162,3550,2300,1250,0.647887323943662,48,23,25,220.40491514280598,0.39725832630422003,0.7319401604717384,0.15005720882826712,1063115.738950456,10913.186846071334,1074028.9257965274,3486,0,1604.0,68,94,41,32.65556164752505,0.6542585784313726,38.42089371980676,8128.4453798208815,119.53596146795414,0
3488,31.123655187148255,0,0,161,0.0,0.0,1.0,161,3850,2600,1250,0.6753246753246753,51,26,25,218.6857019714598,0.3967650103519669,0.7286152693281502,0.14939474783856446,1065724.7717579226,10561.753964050873,1076286.5257219735,3487,1,1614.583850931677,70,91,44,32.58407149931787,0.6543154761904761,38.3069248826291,8144.845034817516,116.35492906882165,0
3489,31.281559554867126,0,0,161,0.0,0.0,1.0,161,3950,2700,1250,0.6835443037974683,52,27,25,219.9142097352296,0.3965401785714286,0.7266786883056169,0.15082611729628576,1072206.3725599246,11008.68341891862,1083215.0559788432,3488,2,1615.583850931677,73,88,42,32.41778673835127,0.654109589041096,38.17567567567568,8190.2731942641985,112.19552320909861,0
3490,31.42057980461254,0,0,161,0.0,0.0,1.0,161,3750,2500,1250,0.6666666666666666,50,25,25,205.21800318014726,0.3964900362318841,0.7110688187062384,0.13201463700790286,1059067.602710998,7517.94773222703,1066585.5504432248,3489,3,1616.583850931677,74,87,41,35.03285367854212,0.6314752252252251,40.36111111111109,8158.004428714223,110.24330309073274,8
3491,31.82400471468086,1,0,162,0.006172839506172839,0.0,1.0,162,3700,2600,1100,0.7027027027027027,48,26,22,200.63052753401334,0.3972623201186003,0.7062741334795637,0.12957055184567096,1073795.7600428413,6987.241960236192,1080783.0020030774,3490,0,1607.5987654320988,77,85,40,35.01246658441292,0.6314935064935066,40.22435897435896,8267.101224759197,107.36495097089866,0
3492,31.8147502017354,0,0,162,0.0,0.0,1.0,162,4850,3400,1450,0.7010309278350515,63,34,29,198.4770216708504,0.39718244383099455,0.7037519388003126,0.1285014830186956,1074204.5325823878,5390.983258455768,1079595.5158408436,3491,1,1608.5987654320988,78,84,42,34.97944996955549,0.6319444444444444,40.13713080168774,8267.472270250486,105.99323423398059,0
3493,31.703369231099536,0,1,161,0.0,0.006172839506172839,0.9938271604938271,162,5750,4400,1350,0.7652173913043478,71,44,27,199.41918802961723,0.3973405988804539,0.706148953982972,0.1296604809590275,1071657.6507133376,4591.819710195975,1076249.4704235336,3492,2,1609.5987654320988,81,81,33,34.80473584782749,0.632201646090535,39.989837398373965,8243.19818879753,101.76787887404359,0
3494,31.613980866256256,1,0,162,0.006172839506172839,0.0,1.0,162,4250,2800,1450,0.6588235294117647,57,28,29,201.47283236148886,0.398576285049715,0.7119706761840476,0.13177721470609077,1070327.6086439171,6478.386973637462,1076805.9956175545,3493,0,1606.469135802469,82,80,36,34.54149384264171,0.6338922764227642,39.78413654618471,8226.459328325196,100.32267473567312,0
3495,31.73930292292577,0,1,161,0.0,0.006172839506172839,0.9938271604938271,162,3700,2700,1000,0.7297297297297297,47,27,20,199.6623398971637,0.39822163433274543,0.7086306220135121,0.13074301177602904,1074897.5560930148,6823.312239854345,1081720.8683328691,3494,1,1607.469135802469,83,79,36,34.54822231222499,0.6339106425702812,39.74454365079362,8260.326766411656,99.52200923387537,0
3496,31.876009080668837,0,0,161,0.0,0.0,1.0,161,4600,3200,1400,0.6956521739130435,60,32,28,199.52872118646727,0.39695910973084886,0.7087242008227377,0.13103238978135218,1080350.4718612754,6312.1896167348295,1086662.6614780102,3495,2,1618.4285714285713,83,78,39,34.45051401127249,0.6349146586345382,39.64533730158726,8299.067592368967,99.98876617312008,0
3497,31.40044607200844,1,1,161,0.006172839506172839,0.006172839506172839,0.9938271604938271,162,3800,2500,1300,0.6578947368421053,51,25,26,197.02872435809886,0.39779749124555885,0.7081636875962356,0.13000193063266316,1065556.4610816909,5789.046051690815,1071345.5071333817,3496,0,1609.432098765432,72,90,41,34.35052308703511,0.6413483796296297,39.48344748858445,8180.335958000206,113.6157771944473,0
3498,31.105704988903454,0,0,161,0.0,0.0,1.0,161,4100,2900,1200,0.7073170731707317,53,29,24,198.44624594265719,0.39720496894409935,0.7046114869765063,0.13159184994201634,1056938.1305878568,5649.080841761949,1062587.2114296188,3497,1,1619.527950310559,76,85,40,34.13953035806953,0.6411732456140351,39.31277056277055,8108.860053249025,106.69552701643454,0
3499,31.47884373576827,0,1,160,0.0,0.006211180124223602,0.9937888198757764,161,4250,3300,950,0.7764705882352941,52,33,19,214.78306544614145,0.39743465320910976,0.7306603745655422,0.12874710608743015,1040445.7157608613,8244.024052284627,1048689.739813146,3498,2,1620.527950310559,84,77,43,37.369915792818546,0.6016865079365079,42.892156862745104,8093.457617358082,96.35068592092955,8
3500,31.646636458757598,1,0,161,0.006211180124223602,0.0,1.0,161,4200,3000,1200,0.7142857142857143,54,30,24,219.709873063124,0.3979878364389234,0.737119102965442,0.13227629864692386,1047295.114279692,9620.215323604307,1056915.3296032962,3499,0,1620.6397515527951,87,74,45,37.07957577988403,0.6022509578544062,42.732007575757585,8141.666628724429,93.58237504280953,0
3501,31.31607920108591,2,1,162,0.012269938650306749,0.006134969325153374,0.9938650306748467,163,3850,3000,850,0.7792207792207793,47,30,17,214.05763956868412,0.4000953066222323,0.7349890208029655,0.1300762767326907,1039091.511399344,8035.095245200165,1047126.6066445442,3500,0,1601.7423312883436,65,98,46,36.87839521300497,0.6157051282051282,42.39267676767678,8067.251337123201,124.11155903266463,0
3502,31.6896874103099,1,0,163,0.006134969325153374,0.0,1.0,163,4000,3100,900,0.775,49,31,18,209.32348471932107,0.40036986543462344,0.7286055646675498,0.12773894765660837,1052744.2591308001,7472.819367903849,1060217.078498704,3501,0,1601.8282208588957,70,93,47,36.84330354601859,0.6144345238095238,42.23884976525822,8168.370277460908,116.69100396372725,0
3503,31.26358492880416,0,0,163,0.0,0.0,1.0,163,3750,2200,1550,0.5866666666666667,53,22,31,207.91119973652027,0.40048032012926355,0.7266018775335312,0.12713189401147829,1039175.3345800679,6861.238109828301,1046036.5726898962,3502,1,1602.8282208588957,72,91,45,36.8054402567934,0.6141493055555556,42.16609589041096,8060.8121586552825,111.95572442576781,0
3504,31.747177311114708,1,1,163,0.006097560975609756,0.006097560975609756,0.9939024390243902,164,4700,3400,1300,0.723404255319149,60,34,26,204.94247806777486,0.4022449685769864,0.72504424376611,0.12603114453295808,1056933.3605798762,5822.108413948149,1062755.4689938244,3503,0,1594.0487804878048,77,87,37,36.672144015457285,0.6139069264069263,41.96047008547008,8192.026709473257,106.38995726588645,0
3505,32.09939507394348,1,0,164,0.006097560975609756,0.0,1.0,164,3750,2700,1050,0.72,48,27,21,201.61030890659333,0.40276790612998153,0.7214832171014587,0.12454618148341895,1070014.9379808402,6595.208436197363,1076610.1464170376,3504,0,1593.939024390244,79,85,40,36.59123382081021,0.6147151898734178,41.796875,8288.164118701818,104.91346985698503,0
3506,31.90043765414267,0,0,164,0.0,0.0,1.0,164,4600,3400,1200,0.7391304347826086,58,34,24,201.16986573302378,0.40271101426505057,0.7208240578958329,0.12483035105710516,1064704.4112759184,5437.28869234684,1070141.6999682651,3505,1,1594.939024390244,68,96,41,36.438977834911014,0.6216299019607843,41.636473429951685,8241.909571452243,121.2045525213565,0
3507,32.09663064652929,0,0,164,0.0,0.0,1.0,164,4250,3100,1150,0.7294117647058823,54,31,23,198.43070100388098,0.4025582635044142,0.7166768206143586,0.1233800493534544,1071853.8702896854,5487.742971061032,1077341.6132607465,3506,2,1595.939024390244,70,94,42,36.435802819566625,0.6212797619047619,41.56396713615023,8294.925892585292,118.49894132264703,0
3508,32.25141344895825,1,0,165,0.006060606060606061,0.0,1.0,165,3900,2400,1500,0.6153846153846154,54,24,30,196.17355579334674,0.4040758191672826,0.7134346183665714,0.12249178177851087,1078279.0421238183,5405.966766174807,1083685.0088899932,3507,0,1587.260606060606,73,92,42,36.34050081654871,0.6212899543378996,41.4132882882883,8339.78695182102,114.24365687426054,0
3509,31.812308807449902,0,1,164,0.0,0.006060606060606061,0.9939393939393939,165,4350,3300,1050,0.7586206896551724,54,33,21,197.59030544502235,0.40394493717664454,0.7121213769818295,0.123913592780108,1064872.3695760386,4731.69135289897,1069604.0609289375,3508,1,1588.260606060606,73,92,41,36.14596367625991,0.622859589041096,41.25844594594596,8231.166218887087,112.75570162859023,0
3510,32.251822168531874,0,0,164,0.0,0.0,1.0,164,4400,3200,1200,0.7272727272727273,56,32,24,198.11875879647562,0.40327447753005136,0.7116575018075433,0.1244418647240592,1080054.3830822553,5595.8067617900315,1085650.1898440453,3509,2,1598.7378048780488,73,91,43,36.074868552261805,0.6234303652968036,41.20213963963965,8346.702569938909,114.33839136902614,0
3511,32.228068322179894,0,0,164,0.0,0.0,1.0,164,3900,2700,1200,0.6923076923076923,51,27,24,197.09655920132445,0.40325733203651054,0.7106868366086871,0.12420912237583678,1080236.5022863145,5882.17954486141,1086118.681831176,3510,3,1599.7378048780488,76,88,44,35.98183029416377,0.6232182017543859,41.08495670995673,8344.33170479172,109.7938382209437,0
3512,32.2263470707276,0,1,163,0.0,0.006097560975609756,0.9939024390243902,164,4600,3100,1500,0.6739130434782609,61,31,30,196.48944999830857,0.4032892850017457,0.7098296496740089,0.12435689507433044,1081441.730352558,5098.378160438766,1086540.1085129967,3511,4,1600.7378048780488,80,84,36,35.843261355175,0.623046875,40.93364197530865,8348.762368053107,104.35952960066383,0
3513,32.44924990743216,1,0,164,0.006097560975609756,0.0,1.0,164,3950,2800,1150,0.7088607594936709,51,28,23,192.73019086723124,0.403552702129782,0.7042808319871601,0.12253747302117698,1090280.6082376584,5275.997944897153,1095556.6061825554,3512,0,1601.6402439024391,84,80,39,35.77595376542337,0.6231398809523809,40.77205882352943,8411.752246224454,100.13990769314826,0
3514,32.45076095541391,0,0,164,0.0,0.0,1.0,164,3700,2700,1000,0.7297297297297297,47,27,20,195.7749993199658,0.4035301012519328,0.7114419766208533,0.12495221082112962,1091468.0347505896,6236.430752212651,1097704.4655028023,3513,1,1602.6402439024391,86,78,40,35.55929354014711,0.6237887596899225,40.63697318007666,8416.527584006026,97.86659981402356,0
3515,32.79521468690308,0,0,164,0.0,0.0,1.0,164,3750,2600,1150,0.6933333333333334,49,26,23,195.7992970194075,0.40351763180208494,0.7134577126118089,0.12545658660873077,1104218.977909856,6691.059926047443,1110910.0378359035,3514,2,1603.6402439024391,74,90,42,35.419008242346365,0.6300675675675675,40.49999999999998,8510.3582112513,115.00484069258513,0
3516,32.989391995187326,1,0,165,0.006060606060606061,0.0,1.0,165,4350,3300,1050,0.7586206896551724,54,33,21,192.51530847733892,0.404309866962306,0.710335572980227,0.12390185841525589,1112088.1079152576,5468.797029856986,1117556.9049451146,3515,0,1594.9151515151516,77,88,41,35.34578640127549,0.630275974025974,40.34455128205126,8565.875381442625,111.2451348239302,0
3517,32.78312224033193,0,0,165,0.0,0.0,1.0,165,4600,3300,1300,0.717391304347826,59,33,26,193.94376679482002,0.4043883961566888,0.7140053463269382,0.12528131453742708,1106227.1121296072,5309.170611394071,1111536.2827410013,3516,1,1595.9151515151516,78,87,43,35.17790072073898,0.6311431623931624,40.21624472573838,8516.522605208547,109.18618724626343,0
3518,32.99898973440072,1,0,166,0.006024096385542169,0.0,1.0,166,4250,2800,1450,0.6588235294117647,57,28,29,190.2059092485734,0.4060781002799075,0.7096868412064676,0.12330839363833336,1114581.2589772406,4949.988359036999,1119531.2473362777,3517,0,1587.2951807228915,81,85,41,35.14784946236556,0.6311728395061729,40.091463414634134,8576.719130663576,105.88542136621699,0
3519,32.815300211228575,0,0,166,0.0,0.0,1.0,166,4000,2700,1300,0.675,53,27,26,190.2030325007613,0.40576472556894244,0.7094941206818601,0.12383569682003902,1109643.895706401,5011.526791863127,1114655.4224982641,3518,1,1588.2951807228915,83,83,38,34.996592516649955,0.6319026104417671,39.94295634920634,8533.849959445346,102.81746939090779,0
3520,32.98762424496404,0,1,165,0.0,0.006024096385542169,0.9939759036144579,166,4550,3100,1450,0.6813186813186813,60,31,29,191.25286002023608,0.4055540343190946,0.7114264048419361,0.12498639142362898,1116582.1092088372,4959.904366723478,1121542.0135755606,3519,2,1589.2951807228915,85,81,40,34.83732717285042,0.6324754901960784,39.813468992248055,8582.93551848439,100.97571198216929,0
3521,33.303828170442245,0,0,165,0.0,0.0,1.0,165,4400,3600,800,0.8181818181818182,52,36,16,195.07276666878923,0.40441303276669127,0.7155111867629711,0.1277582624007065,1127930.657123756,6605.710779135052,1134536.367902891,3520,5,1599.9151515151516,86,79,42,34.66200104276888,0.6328730620155039,39.73898467432949,8667.688133870919,100.78707132408046,0
3522,33.13656413564027,0,1,164,0.0,0.006060606060606061,0.9939393939393939,165,4050,2800,1250,0.691358024691358,53,28,25,192.7970437912289,0.4044561468341956,0.7129163980227813,0.12666558468434463,1123199.9908914547,6259.9275660413605,1129459.9184574962,3521,6,1600.9151515151516,87,78,42,34.61083833424255,0.6336206896551724,39.630681818181806,8627.744610884714,99.1694782860312,0
3523,33.556110745593855,1,0,165,0.006060606060606061,0.0,1.0,165,4350,2900,1450,0.6666666666666666,58,29,29,195.6706312767917,0.40530457009115545,0.7168800211601747,0.12966076883700509,1139991.6199321586,7262.575984475812,1147254.1959166345,3522,0,1588.709090909091,75,90,42,34.2362060504084,0.6413888888888889,39.33662280701756,8746.849152408275,116.62465536544366,0
3524,33.433873939401714,0,0,165,0.0,0.0,1.0,165,4700,3200,1500,0.6808510638297872,62,32,30,194.70244478955004,0.405230660261148,0.7162220792352232,0.12958325565064968,1137136.5812423227,6580.654485502355,1143717.235727825,3523,1,1589.709090909091,78,87,42,34.10968570947084,0.641559829059829,39.18776371308017,8719.96342987035,111.79440294705576,0
3525,33.594712834677274,0,1,164,0.0,0.006060606060606061,0.9939393939393939,165,3600,2300,1300,0.6388888888888888,49,23,26,194.81490009783812,0.40505974377925597,0.7158967658418687,0.1300366744890238,1143476.4953736207,7953.251842087768,1151429.7472157085,3524,2,1590.709090909091,79,86,47,34.00559769770765,0.6421413502109705,39.08854166666668,8765.245517985235,110.9524749112055,0
3526,33.63763836575006,0,0,164,0.0,0.0,1.0,164,4650,3500,1150,0.7526881720430108,58,35,23,198.0741261054912,0.404484014165295,0.7175384977973616,0.13277924257558277,1146212.8652309885,7957.022322299995,1154169.8875532884,3525,3,1600.5,82,82,46,33.772414787750606,0.6424034552845528,38.94327309236949,8781.331772665273,107.08941186177162,0
3527,33.613558162720715,1,2,163,0.006060606060606061,0.012121212121212121,0.9878787878787879,165,4100,2500,1600,0.6097560975609756,57,25,32,198.52017505505864,0.40532920670115796,0.7202798283816687,0.1335628871985097,1146472.0954933325,8419.568218615328,1154891.6637119479,3526,0,1591.7939393939394,85,80,40,33.635307007373754,0.6425245098039216,38.8202519379845,8779.18065240732,103.28447826361553,0
3528,33.58807632259956,0,0,163,0.0,0.0,1.0,163,4850,3800,1050,0.7835051546391752,59,38,21,199.5598636389718,0.40414583806710597,0.7193142031508195,0.1345999455501134,1146346.8906735522,8302.965837154745,1154649.856510707,3527,5,1611.276073619632,85,78,42,33.521673620769576,0.6433823529411764,38.73546511627907,8775.373138062909,103.23968397721069,0
3529,33.71079615468303,0,0,163,0.0,0.0,1.0,163,4100,3200,900,0.7804878048780488,50,32,18,198.5084007118669,0.40382551945264966,0.7188969982772597,0.13432853030192443,1151504.1669905488,9016.65012046911,1160520.8171110179,3528,6,1612.276073619632,86,77,44,33.43697511070393,0.6441375968992248,38.62547892720308,8811.143199913022,102.45515348736072,0
3530,33.909357863816794,0,1,162,0.0,0.006134969325153374,0.9938650306748467,163,4750,3600,1150,0.7578947368421053,59,36,23,197.31258733882544,0.40347522027821964,0.7176869363012199,0.1340936033923294,1159565.093420818,8409.357754129784,1167974.4511749477,3529,7,1613.276073619632,68,95,47,33.32118666897575,0.6536458333333333,38.48128019323672,8867.931858014777,130.41076261786438,0
3531,33.8799869782727,0,1,161,0.0,0.006172839506172839,0.9938271604938271,162,3450,2400,1050,0.6956521739130435,45,24,21,194.07166468143802,0.40309967921682893,0.7113051976997549,0.13252152416761598,1159975.997812986,9173.694577215678,1169149.6923902016,3530,8,1623.283950617284,70,92,45,33.24315990132317,0.6541666666666667,38.321596244131456,8865.660911744015,126.6522987392002,0
3532,33.45596818086108,1,1,161,0.006172839506172839,0.006172839506172839,0.9938271604938271,162,4400,3400,1000,0.7727272727272727,54,34,20,192.2714108892456,0.4029790660225443,0.7071387373969669,0.13192329450206064,1146859.6857114008,7301.665972745717,1154161.3516841466,3531,0,1617.7283950617284,73,89,45,33.127195222479074,0.6542522831050228,38.16159909909911,8760.057209068107,120.00078368586448,0
3533,33.028586276773474,0,0,161,0.0,0.0,1.0,161,5150,3900,1250,0.7572815533980582,64,39,25,193.43317821988902,0.40238256987577636,0.7078194423910416,0.13325477369376867,1133365.1299957116,6496.083835733525,1139861.2138314452,3532,1,1609.0745341614906,72,89,49,32.96055976178804,0.6561053240740741,38.02796803652967,8652.56585980712,120.17452583065445,0
3534,32.7692197318829,0,0,161,0.0,0.0,1.0,161,4250,3200,1050,0.7529411764705882,53,32,21,192.92864033342002,0.4021027432712216,0.7077682293882419,0.13316153651489077,1125009.7347261817,6959.31969651663,1131969.0544226984,3533,2,1610.0745341614906,73,88,50,32.90911227504702,0.65625,37.96452702702702,8586.697991399189,117.62599988218068,0
3535,32.72367151097349,0,0,161,0.0,0.0,1.0,161,3950,2900,1050,0.7341772151898734,50,29,21,192.33471800208142,0.40214156314699795,0.7064928070526955,0.13304124103142886,1124065.2829312643,7089.355841702891,1131154.638772967,3534,3,1611.0745341614906,76,85,53,32.851075268817205,0.6555646929824561,37.89231601731601,8577.125751151387,112.85691777830772,0
3536,32.62553519113932,0,1,160,0.0,0.006211180124223602,0.9937888198757764,161,4750,3600,1150,0.7578947368421053,59,36,23,172.53795047887328,0.40241006728778467,0.6705771696145166,0.11893237758086393,1119706.839433595,1688.3846426099435,1121395.224076205,3535,4,1612.0745341614906,79,82,48,33.48745299272736,0.6530854430379747,38.007812500000014,8547.635333084847,108.19791560866895,8
3537,32.151844458861426,0,0,160,0.0,0.0,1.0,160,4200,2900,1300,0.6904761904761905,55,29,26,174.278411828517,0.40158788653039834,0.6727427709047555,0.12041543408419376,1104107.9822535943,2284.4371268690056,1106392.4193804634,3536,14,1623.125,79,81,47,33.36236771500973,0.653876582278481,37.92968750000001,8426.04392478522,106.65878385804075,0
3538,31.65940064527253,0,1,159,0.0,0.00625,0.99375,160,4350,3100,1250,0.7126436781609196,56,31,25,174.9094350067783,0.4012324751048218,0.6746100647439679,0.12129433880674098,1088201.798054365,1717.3523342097778,1089919.1503885747,3537,15,1624.125,80,80,39,33.22266774573279,0.6546875,37.80864197530863,8300.821249431767,103.76026561789709,0
3539,32.04030452199259,0,0,159,0.0,0.0,1.0,159,4300,2800,1500,0.6511627906976745,58,28,30,175.1266969952953,0.40067304885492133,0.6734904911055497,0.1218146472470041,1102137.1078998407,2502.7262684894026,1104639.83416833,3538,16,1634.1572327044025,84,75,41,33.11490601006091,0.6541418650793651,37.70833333333334,8403.904873580994,100.04648659024993,0
3540,32.113837452702455,1,0,160,0.00625,0.0,1.0,160,3800,2500,1300,0.6578947368421053,51,25,26,176.6415269284474,0.40129471305031444,0.6786903567192768,0.12355888810866075,1106220.2001967744,3280.8850563702863,1109501.0852531446,3539,0,1624.9375,86,74,44,32.88752927044368,0.655281007751938,37.52394636015326,8429.11332181686,98.01294560252163,0
3541,32.51978590838711,0,0,160,0.0,0.0,1.0,160,4400,3000,1400,0.6818181818181818,58,30,28,176.4407443473023,0.4012635940775681,0.6786580930970649,0.12377039969891429,1121001.1358860196,3158.05496597998,1124159.1908519994,3540,1,1625.9375,74,86,46,32.797760733492034,0.6611768018018018,37.43055555555554,8538.702119417445,115.38786647861411,0
3542,32.36227630160315,0,0,160,0.0,0.0,1.0,160,4200,3300,900,0.7857142857142857,51,33,18,201.66420634396025,0.40109981001048217,0.7113028455284545,0.13000365503305625,1091430.0358037716,7820.474390065538,1099250.510193837,3541,2,1626.9375,73,87,43,35.04968383017162,0.6327054794520548,40.28716216216216,8404.898617181565,115.13559749563788,8
3543,32.21581154850071,2,0,162,0.012345679012345678,0.0,1.0,162,4400,3000,1400,0.6818181818181818,58,30,28,196.6500639799754,0.4025357526263323,0.7082000478273756,0.1275374940100717,1088245.7363315206,6000.718735105737,1094246.4550666264,3542,0,1607.8395061728395,77,85,46,34.96607879908887,0.6329816017316017,40.07745726495725,8373.615653959232,108.74825524622379,0
3544,32.381128310904614,0,0,162,0.0,0.0,1.0,162,3950,2400,1550,0.6075949367088608,55,24,31,195.5170609089975,0.4027681926232651,0.7067095074313889,0.12701844777405868,1094326.7266728345,6441.909054647039,1100768.6357274815,3543,1,1608.8395061728395,78,84,47,34.93537725482238,0.6331463675213675,40.01845991561179,8418.495607939114,107.92943087101428,0
3545,32.108828506174,0,0,162,0.0,0.0,1.0,162,4100,2900,1200,0.7073170731707317,53,29,24,194.39662331112754,0.40272905324233826,0.7048524300308772,0.12651735178546122,1085643.45740643,5709.084447925274,1091352.5418543553,3544,2,1609.8395061728395,80,82,37,34.901113528839645,0.6329427083333333,39.956275720164584,8349.699347007961,104.37124183759951,0
3546,32.252762989198835,0,1,161,0.0,0.006172839506172839,0.9938271604938271,162,4300,3400,900,0.7906976744186046,52,34,18,195.1187611811442,0.40290478107507094,0.7071217374008076,0.12760287697929057,1091912.6992211817,5910.530637999022,1097823.2298591807,3545,3,1610.8395061728395,80,82,40,34.711891700438215,0.6346354166666667,39.78909465020575,8392.520657451723,104.90650821814654,0
3547,32.68545644376721,0,0,161,0.0,0.0,1.0,161,4300,3000,1300,0.6976744186046512,56,30,26,197.3914801043613,0.4019959886128364,0.7097666511182599,0.12937835353990446,1107217.830482461,7211.073271374259,1114428.9037538352,3546,4,1621.8260869565217,80,81,42,34.57406949934125,0.6354166666666667,39.71193415637858,8507.634238964047,106.34542798705058,0
3548,32.63179671128801,0,0,161,0.0,0.0,1.0,161,3600,2300,1300,0.6388888888888888,49,23,26,196.90767330850693,0.4018746765010352,0.7092588282640229,0.12935319461958805,1106060.9128815464,7758.376178597594,1113819.289060144,3547,5,1622.8260869565217,81,80,43,34.50734289617488,0.6358024691358024,39.634146341463406,8496.205607146305,104.89142724871981,0
3549,33.05798818230607,0,0,161,0.0,0.0,1.0,161,3950,2900,1050,0.7341772151898734,50,29,21,226.78120452489506,0.40202995600414076,0.7401085175580544,0.14312500238917703,1108497.0344303227,14127.25853607678,1122624.2929663996,3548,6,1623.8260869565217,73,88,43,35.160340907031966,0.6251426940639269,41.033220720720735,8560.920729024312,117.27288669896318,8
3550,33.40729495372877,0,0,161,0.0,0.0,1.0,161,4350,3400,950,0.7816091954022989,53,34,19,226.95891307459917,0.4019717261904762,0.7407826411300129,0.14363064062718417,1121049.9302939288,14336.454736373267,1135386.385030302,3549,7,1624.8260869565217,76,85,37,35.05646214099218,0.6247258771929824,40.9361471861472,8654.622542801799,113.87661240528682,0
3551,33.074858675953614,1,0,162,0.006172839506172839,0.0,1.0,162,5700,4000,1700,0.7017543859649122,74,40,34,227.19376451279433,0.40290637860082307,0.740964311207607,0.1443583233372559,1111110.3533053657,12387.468791317788,1123497.8220966836,3550,0,1615.79012345679,79,83,40,34.90527829406742,0.6248681434599156,40.79427083333336,8573.19286018507,108.5214286099376,0
3552,33.22319337735785,0,1,161,0.0,0.006172839506172839,0.9938271604938271,162,3550,2300,1250,0.647887323943662,48,23,25,225.5990807675962,0.4029359328272372,0.7392968778091451,0.14371657371740076,1116878.5336357425,14443.354103457315,1131321.8877392,3551,1,1616.79012345679,79,83,41,34.85341133540894,0.6257911392405063,40.70312500000003,8614.670220269662,109.0464584844261,0
3553,33.304254387526946,0,0,161,0.0,0.0,1.0,161,4700,2900,1800,0.6170212765957447,65,29,36,221.42341715628953,0.40269312888198755,0.7320158620915684,0.14173049565113965,1121049.7704278694,12745.33419408229,1133795.1046219517,3552,2,1626.5962732919254,69,92,44,34.79056740842699,0.6322463768115942,40.53571428571426,8641.264575906494,125.23571849139847,0
3554,33.324701719264205,0,0,161,0.0,0.0,1.0,161,5050,3400,1650,0.6732673267326733,67,34,33,219.7578590392186,0.40293737060041407,0.7303639186279431,0.14139724197586967,1123310.8278766186,12121.276513947218,1135432.1043905658,3553,3,1627.5962732919254,72,89,41,34.64795376273172,0.6325231481481481,40.353881278538786,8652.62945895729,120.17540915218459,0
3555,33.70906025515865,0,0,161,0.0,0.0,1.0,161,4600,3300,1300,0.717391304347826,59,33,26,218.94977426540706,0.40288399327122154,0.7292789261199142,0.14120385477004546,1136974.0743639385,12988.043385520567,1149962.117749459,3554,4,1628.5962732919254,73,88,40,34.586370657416914,0.6328481735159817,40.27308558558556,8755.15020788187,119.93356449153247,0
3556,33.21992239597529,0,0,161,0.0,0.0,1.0,161,4750,3500,1250,0.7368421052631579,60,35,25,218.27221577423535,0.40267533643892345,0.7291850782309974,0.14145173463810723,1121933.850982011,12027.397521192452,1133961.2485032035,3555,5,1629.5962732919254,75,86,40,34.431362725450896,0.6336111111111111,40.104166666666636,8633.719414370586,115.11625885827448,0
3557,33.10727337129197,0,0,161,0.0,0.0,1.0,161,4400,3200,1200,0.7272727272727273,56,32,24,216.44488023532824,0.40270445134575567,0.7280689833379608,0.1407542357442156,1119163.7911733654,11847.454548846743,1131011.2457222121,3556,6,1630.5962732919254,77,84,43,34.35606060606058,0.6339285714285714,39.983974358974336,8608.421641814239,111.79768365992518,0
3558,32.9001452086815,0,0,161,0.0,0.0,1.0,161,4700,3200,1500,0.6808510638297872,62,32,30,217.31928498683632,0.4027820910973085,0.7294869260513257,0.14199152752848426,1113559.3889632416,11499.586039973656,1125058.9750032153,3557,7,1631.5962732919254,78,83,37,34.16647662004188,0.6351495726495726,39.82067510548521,8559.937569326194,109.74278935033581,0
3559,33.18485583373695,0,0,161,0.0,0.0,1.0,161,4050,2900,1150,0.7160493827160493,52,29,23,217.4273918091115,0.4028807582815735,0.730440500897213,0.14228892772419402,1123671.24078196,12613.381426825717,1136284.6222087857,3558,8,1632.5962732919254,79,82,37,34.10741685846758,0.6352848101265822,39.765624999999986,8635.840217357603,109.3144331311089,0
3560,32.63971003175348,0,0,161,0.0,0.0,1.0,161,4300,3200,1100,0.7441860465116279,54,32,22,218.84980528991284,0.40244565217391304,0.7331272449840747,0.14381863056490893,1106433.0960737767,11928.53352841203,1118361.6296021887,3559,9,1633.5962732919254,80,81,37,33.9235442287746,0.636328125,39.6219135802469,8498.665239363547,106.23331549204434,0
3561,32.906817147434786,1,0,162,0.006172839506172839,0.0,1.0,162,4950,4000,950,0.8080808080808081,59,40,19,213.06677362597918,0.40395355673133454,0.7279076781760467,0.14076788675729585,1117058.323636327,10251.602593847418,1127309.9262301743,3560,0,1624.5061728395062,71,91,37,33.886960947621674,0.64231220657277,39.438657407407405,8574.244456384555,120.76400642795147,0
3562,32.72984825286292,0,0,162,0.0,0.0,1.0,162,3750,2700,1050,0.72,48,27,21,213.40660644512096,0.4040917427088924,0.72673537365628,0.13545716873646624,1099209.3171091503,10765.706027424836,1109975.0231365752,3561,1,1625.5061728395062,85,77,36,35.30007127167361,0.6221813725490196,40.830910852713195,8482.564959623449,99.79488187792293,8
3563,33.054950349167925,2,0,164,0.012195121951219513,0.0,1.0,164,3850,2900,950,0.7532467532467533,48,29,19,187.24430135841664,0.4057730435433189,0.7015491100856976,0.12225951441637692,1118600.582662613,5240.3169199553695,1123840.8995825683,3562,0,1606.6707317073171,79,85,43,34.97247247247248,0.634493670886076,39.84374999999997,8599.451926775642,108.85382185791953,8
3564,32.616398784911176,0,0,164,0.0,0.0,1.0,164,4300,2900,1400,0.6744186046511628,57,29,28,187.61346862149765,0.40555560751159664,0.7016221928278925,0.12287083914831184,1104643.786901607,4349.210490359257,1108992.9973919662,3563,1,1607.6707317073171,79,85,43,34.85674738176238,0.635548523206751,39.739583333333314,8488.757537927097,107.45262706236831,0
3565,32.66512380972742,1,0,165,0.006060606060606061,0.0,1.0,165,4600,3300,1300,0.717391304347826,59,33,26,189.32782947113225,0.40586043360433605,0.7031259666006586,0.12485651377266963,1108322.4036900052,4367.255008971279,1112689.6586989765,3564,0,1598.9212121212122,75,90,44,34.56912729313553,0.6397222222222223,39.50109649122807,8509.228935412268,113.45638580549691,0
3566,32.4232987583496,1,0,166,0.006024096385542169,0.0,1.0,166,5300,3900,1400,0.7358490566037735,67,39,28,188.60411289271053,0.4064173360107095,0.703769297057429,0.12486758896876199,1101251.2081019895,3040.101435220478,1104291.30953721,3565,0,1590.2831325301204,76,90,44,34.45123533686288,0.640625,39.36688311688313,8450.585415021184,111.19191335554189,0
3567,32.10933636793052,1,0,167,0.005988023952095809,0.0,1.0,167,5150,3700,1450,0.7184466019417476,66,37,29,188.06704243432128,0.40684143760671426,0.7048805185899838,0.12498968926387254,1091682.2085292046,2511.888847251355,1094194.097376456,3566,0,1581.754491017964,77,90,45,34.332001775410575,0.641504329004329,39.23611111111113,8372.955420943035,108.73968079146799,0
3568,31.90938712509862,1,0,168,0.005952380952380952,0.0,1.0,168,3950,2700,1250,0.6835443037974683,52,27,25,195.2616625299097,0.4077425506130596,0.7204645675339267,0.12102089339805795,1064653.184407331,4027.190161027451,1068680.3745683585,3567,0,1573.3333333333333,84,84,40,36.63490124452454,0.6139632936507937,41.67892156862744,8242.867294239595,98.12937255047137,8
3569,31.723092142722496,0,0,168,0.0,0.0,1.0,168,4000,2700,1300,0.675,53,27,26,194.3064626040985,0.40758735505180116,0.7193224919764734,0.12075036884475178,1059220.9388400733,3562.6947484415423,1062783.6335885148,3568,1,1574.3333333333333,74,94,39,36.56213049553903,0.6190878378378378,41.58333333333334,8197.775727881897,110.7807530794851,0
3570,31.30197502103318,0,0,168,0.0,0.0,1.0,168,5550,4500,1050,0.8108108108108109,66,45,21,192.7395565343436,0.40775962955042294,0.7172235765894663,0.12046381888859044,1046814.8218656057,1202.5249079911596,1048017.3467735968,3569,2,1575.3333333333333,75,93,41,36.394184906460325,0.6206944444444444,41.37883771929826,8095.353161621134,107.93804215494845,0
3571,31.75159371277998,0,0,168,0.0,0.0,1.0,168,3750,2500,1250,0.6666666666666666,50,25,25,191.5572119727949,0.40791556767417547,0.7161355809384358,0.11998521338210862,1062487.1022584941,3355.413413138439,1065842.5156716325,3570,3,1576.3333333333333,76,92,45,36.34584880336073,0.6210252192982456,41.30140692640695,8214.092621340575,108.08016607027072,0
3572,31.28326312366855,0,1,167,0.0,0.005952380952380952,0.9940476190476191,168,4550,3100,1450,0.6813186813186813,60,31,29,187.15917233784904,0.40833288779583693,0.7094591357669817,0.11774444133153374,1048075.0245380723,1081.370828103582,1049156.3953661758,3571,4,1577.3333333333333,79,89,42,36.30114017437961,0.6213080168776371,41.14583333333336,8097.803006491345,102.5038355252069,0
3573,31.307809447501988,2,0,169,0.011834319526627219,0.0,1.0,169,4050,2700,1350,0.6666666666666666,54,27,27,184.1305663207859,0.409870444726214,0.7063553925102821,0.11647683173237389,1050474.4723504034,834.8918998819886,1051309.3642502853,3572,0,1568.8639053254437,82,87,38,36.18142693344965,0.6220782520325203,40.951305220883555,8110.247173768728,98.90545333864303,0
3574,30.855684334135578,0,0,169,0.0,0.0,1.0,169,4750,3800,950,0.8,57,38,19,187.25053293903233,0.40977358645627876,0.710442019989669,0.11871320195066831,1035930.138356202,245.69409896100933,1036175.832455163,3573,1,1569.8639053254437,83,86,40,36.02084928534965,0.6224899598393574,40.87301587301588,7995.540424678804,96.33181234552775,0
3575,31.008945884273686,0,0,169,0.0,0.0,1.0,169,4700,3200,1500,0.6808510638297872,62,32,30,190.35713277874373,0.40991300366300365,0.7161346518878455,0.12107079936264434,1041985.5347931681,1169.8757600307667,1043155.4105531989,3574,2,1570.8639053254437,84,85,40,35.82498187891968,0.6232638888888888,40.75980392156863,8038.765211224592,95.69958584791182,0
3576,31.421567171620445,1,0,170,0.0058823529411764705,0.0,1.0,170,4800,3000,1800,0.625,66,30,36,187.64051841222812,0.41105551688130876,0.7140866873065013,0.11967884654914211,1056656.3798916517,854.3101812915975,1057510.6900729432,3575,0,1562.6176470588234,86,84,42,35.79466759002769,0.623546511627907,40.66091954022989,8148.840336892959,94.75395740573208,0
3577,31.344853914127302,0,0,170,0.0,0.0,1.0,170,3950,2900,1050,0.7341772151898734,50,29,21,190.94957284740426,0.4109061376029702,0.7175526173772271,0.12243237317862903,1055578.824698821,2362.465136600696,1057941.2898354216,3576,1,1563.6176470588234,76,94,40,35.52059441896025,0.6293859649122807,40.47619047619045,8134.7358967615555,107.03599864159942,0
3578,31.81043732829851,0,0,170,0.0,0.0,1.0,170,4350,3300,1050,0.7586206896551724,54,33,21,192.81169713337943,0.4112411532660401,0.719262172341296,0.12418759359915676,1072565.6093008388,3010.639083238108,1075576.2483840769,3577,2,1564.6176470588234,77,93,43,35.3108661181109,0.6305465367965368,40.31784188034186,8260.603016142639,107.28055865120311,0
3579,32.137317320530194,0,0,170,0.0,0.0,1.0,170,4150,2900,1250,0.6987951807228916,54,29,25,192.10188003290938,0.4111613876319759,0.7183162477641465,0.12395070208870813,1084104.9740758091,3501.7207345980405,1087606.6948104072,3578,3,1565.6176470588234,78,92,44,35.26606680542161,0.6307425213675213,40.25580168776369,8347.481723327006,107.01899645291033,0
3580,32.098508270428184,0,0,170,0.0,0.0,1.0,170,3950,2600,1350,0.6582278481012658,53,26,27,194.8131210518019,0.4111795161851723,0.7220133106515061,0.1262250695572318,1084005.4206512037,4285.6958468261355,1088291.1164980298,3579,4,1566.6176470588234,78,92,44,35.04777608658884,0.6322115384615384,40.11075949367086,8342.056935787648,106.94944789471344,0
3581,32.54528533013337,0,0,170,0.0,0.0,1.0,170,4350,2800,1550,0.6436781609195402,59,28,31,195.76025087059054,0.4111033762617473,0.7227092349435391,0.12719638558844984,1099920.4675660222,4714.141333684143,1104634.6088997063,3580,5,1567.6176470588234,79,91,45,34.92350920685795,0.6327795358649789,40.013020833333314,8461.350419098562,107.10570150757674,0
3582,32.81663378685053,0,0,170,0.0,0.0,1.0,170,4500,3100,1400,0.6888888888888889,59,31,28,196.29937863704495,0.411003306648103,0.7226629988900168,0.1277888603436439,1109652.013620283,5064.800155401135,1114716.8137756842,3581,6,1568.6176470588234,82,88,35,34.84247060148317,0.6322408536585367,39.94728915662649,8534.054577024675,104.07383630517897,0
3583,32.731483540169435,0,1,169,0.0,0.0058823529411764705,0.9941176470588236,170,4400,3200,1200,0.7272727272727273,56,32,24,195.05992478965584,0.41085102680125307,0.7209621386091991,0.12736265677442124,1107654.259730779,4811.791319205161,1112466.0510499843,3582,7,1569.6176470588234,83,87,36,34.769144144144114,0.6329066265060241,39.84374999999997,8515.30001474713,102.59397608129072,0
3584,33.145542422436506,0,0,169,0.0,0.0,1.0,169,3850,2600,1250,0.6753246753246753,51,26,25,195.0048056291486,0.41052497182304876,0.717639487848095,0.12783648369021863,1122855.4266354945,6142.440844137507,1128997.867479632,3583,8,1578.5976331360946,84,85,38,34.630021971123654,0.6339285714285714,39.70588235294115,8627.5897187812,102.70940141406192,0
3585,32.60634606467069,0,0,169,0.0,0.0,1.0,169,4650,3400,1250,0.7311827956989247,59,34,25,195.0893927801157,0.4104163731567578,0.7151373448566445,0.12855069023231852,1106089.2117583593,4707.254536515039,1110796.4662948744,3584,9,1579.5976331360946,76,93,41,34.44771216370626,0.6389802631578947,39.52922077922078,8493.00036700716,111.75000482904159,0
3586,32.71125773626478,0,0,169,0.0,0.0,1.0,169,3950,2800,1150,0.7088607594936709,51,28,23,194.9115594949183,0.41049268573307035,0.7156709176728824,0.12863628556384993,1110109.1838819091,5524.622448010863,1115633.80632992,3585,10,1580.5976331360946,76,93,40,34.39717693079932,0.6395285087719298,39.47510822510823,8522.096881560985,112.1328537047498,0
3587,32.209729680956976,0,0,169,0.0,0.0,1.0,169,4200,3000,1200,0.7142857142857143,54,30,24,205.46784055722148,0.41067906452521835,0.7384504394514295,0.12465438690989392,1068253.9085031683,5898.364749391813,1074152.27325256,3586,11,1581.5976331360946,68,101,41,37.159901328643976,0.6133578431372548,42.45169082125606,8295.561418434922,121.99355027110178,8
3588,31.91404418828492,0,1,168,0.0,0.005917159763313609,0.9940828402366864,169,4100,2800,1300,0.6829268292682927,54,28,26,211.875044117554,0.41097697708274633,0.7469895121211338,0.12860891667121144,1058604.2690302471,6958.365240762949,1065562.63427101,3587,12,1582.5976331360946,67,102,44,36.97538757384723,0.6141169154228856,42.43259803921569,8220.017447638222,122.68682757668988,5
3589,31.72526616100434,1,2,167,0.005917159763313609,0.011834319526627219,0.9881656804733728,169,4600,3300,1300,0.717391304347826,59,33,26,208.30329687153528,0.4112191227575843,0.7425172619423934,0.12677580264782573,1053129.3691372434,5474.063924705619,1058603.433061949,3588,0,1583.5029585798816,69,100,44,36.96908990278181,0.6139794685990339,42.33630952380953,8174.4491603838,118.47027768672173,0
3590,32.00322579137156,1,0,168,0.005952380952380952,0.0,1.0,168,4150,2600,1550,0.6265060240963856,57,26,31,209.13053686335087,0.41090809452523525,0.7423566171289815,0.12777614025600845,1063523.242691646,6733.037342151161,1070256.2800337973,3589,0,1593.3035714285713,70,98,44,36.803342438728286,0.6148809523809524,42.194835680751176,8250.596883890576,117.86566976986536,0
3591,31.742085536971416,0,0,168,0.0,0.0,1.0,168,4950,3600,1350,0.7272727272727273,63,36,27,210.8241316229573,0.41081675933846595,0.7426173649671879,0.12930111602014804,1055970.955233719,5974.831931242748,1061945.7871649617,3590,1,1594.3035714285713,71,97,37,36.6192369173818,0.6157570422535211,42.057291666666664,8187.639511554732,115.3188663599258,0
3592,31.985045630449115,0,0,168,0.0,0.0,1.0,168,4750,3400,1350,0.7157894736842105,61,34,27,211.9309920481145,0.4108679961505561,0.7448249036456682,0.13056566022364774,1065393.128358049,6807.964522833139,1072201.0928808823,3591,2,1595.3035714285713,72,96,40,36.424931814831204,0.6168981481481481,41.89497716894977,8255.500932699257,114.65973517637856,0
3593,32.22381506704954,0,1,167,0.0,0.005952380952380952,0.9940476190476191,168,4950,3800,1150,0.7676767676767676,61,38,23,216.17185067610822,0.4110684880239521,0.750039463299131,0.133813628496497,1074770.96198972,7917.045581251927,1082688.0075709717,3592,3,1596.3035714285713,72,96,41,36.14053867403315,0.6186342592592593,41.723744292237456,8322.64630013697,115.59230972412459,0
3594,31.82397709085797,1,0,168,0.005952380952380952,0.0,1.0,168,4450,2700,1750,0.6067415730337079,62,27,35,214.6830384548437,0.4114865507081076,0.7485462769150146,0.13341078361871755,1062584.006528532,7573.752627013275,1070157.7591555452,3593,0,1597.2738095238096,62,106,41,36.03624138887115,0.6258400537634409,41.5839947089947,8223.82503229197,132.64233923051566,0
3595,32.23789760726965,0,0,168,0.0,0.0,1.0,168,4400,3200,1200,0.7272727272727273,56,32,24,216.6849167925532,0.4115964499572284,0.7492819968581741,0.13507940417319125,1077343.159873359,8688.802590837016,1086031.962464196,3594,1,1598.2738095238096,63,105,42,35.86942835557793,0.6263227513227514,41.471354166666664,8334.420012921075,132.29238115747737,0
3596,31.867566774274668,0,0,168,0.0,0.0,1.0,168,3950,2800,1150,0.7088607594936709,51,28,23,219.5457204403623,0.41183926789278585,0.7535504510174118,0.13723766710453816,1065771.9581295175,9247.134474536144,1075019.0926040537,3595,2,1599.2738095238096,63,105,43,35.69566813509546,0.6273148148148149,41.37369791666667,8241.790951224362,130.8220785908629,0
3597,31.51120776688384,1,1,168,0.005917159763313609,0.005917159763313609,0.9940828402366864,169,4000,3000,1000,0.75,50,30,20,214.2154049527872,0.41258834648257725,0.7486335714170553,0.1344926267176364,1055123.6452427933,7404.747788189232,1062528.3930309825,3596,0,1590.8047337278106,64,105,43,35.67443852695895,0.6282552083333333,41.21794871794872,8154.534984289113,127.41460912951739,0
3598,31.638143692966878,1,0,169,0.005917159763313609,0.0,1.0,169,4500,3100,1400,0.6888888888888889,59,31,28,213.39476909071826,0.4131254696158542,0.7463072021287787,0.13436555877917805,1060215.419623888,6948.884931411683,1067164.3045552997,3597,0,1591.5976331360946,67,102,43,35.59072978303748,0.6274875621890548,41.115196078431374,8190.634626396143,122.24827800591258,0
3599,31.86140098373138,0,1,168,0.0,0.005917159763313609,0.9940828402366864,169,4700,3300,1400,0.7021276595744681,61,33,28,211.2555586342996,0.41311666431858735,0.7429488992342501,0.1336314231361148,1069040.3130976763,6668.141709207093,1075708.4548068834,3598,1,1592.5976331360946,69,100,35,35.47985600490194,0.6280193236714976,40.95238095238094,8253.62006435706,119.61768209213129,0
3600,31.563695049646455,1,0,169,0.005917159763313609,0.0,1.0,169,4000,2300,1700,0.575,57,23,34,215.55311306706434,0.41255606039259884,0.7459306524329901,0.13711381728962427,1060664.2306526795,7925.89536721345,1068590.126019893,3599,0,1593.585798816568,71,98,37,35.16710614431609,0.6289612676056338,40.75520833333332,8182.723547375768,115.24962742782772,0
3601,31.81579702346428,1,1,169,0.0058823529411764705,0.0058823529411764705,0.9941176470588236,170,5150,3800,1350,0.7378640776699029,65,38,27,211.97709926419606,0.4132106392852999,0.7435548238157457,0.13540006321053474,1070340.3337706039,6227.527835632744,1076567.8616062365,3600,0,1585.2058823529412,65,105,40,35.110726599736374,0.6338141025641026,40.60921717171717,8252.724496222143,126.96499224957142,0
3602,31.601861972095346,0,0,169,0.0,0.0,1.0,169,6050,4200,1850,0.6942148760330579,79,42,37,212.11014720713115,0.4125164365548981,0.7430868688223242,0.13613614902566737,1064521.0906360338,5309.145047980866,1069830.2356840146,3601,1,1595.0650887573966,67,102,40,34.93567044381493,0.6343283582089552,40.441176470588225,8202.542114815898,122.42600171367013,0
3603,31.464770342279696,0,0,169,0.0,0.0,1.0,169,5150,4200,950,0.8155339805825242,61,42,19,213.23379205333103,0.41238435709589555,0.7446100799366229,0.13751916866733468,1061279.7247142084,6310.1400260251685,1067589.8647402336,3602,2,1596.0650887573966,67,102,41,34.73440725449719,0.6360385572139303,40.27267156862745,8172.260740706992,121.9740409060745,0
3604,31.305881199136817,1,2,168,0.0058823529411764705,0.011764705882352941,0.9882352941176471,170,5000,3800,1200,0.76,62,38,24,213.6545157951785,0.4133846733959856,0.746683012901304,0.1387480301526402,1057879.7297279036,6204.156284909792,1064083.8860128133,3603,0,1587.6705882352942,71,99,42,34.477491327656885,0.6362969483568075,40.031828703703695,8138.532686158684,114.62722093181245,0
3605,30.929374111056124,0,0,168,0.0,0.0,1.0,168,4600,2900,1700,0.6304347826086957,63,29,34,215.1870048460514,0.41247564395019487,0.7456239700731755,0.14003516383428405,1045738.6311002432,6805.872775654272,1052544.5038758975,3604,1,1600.8392857142858,71,97,36,34.36375690812657,0.6370305164319249,39.95949074074074,8042.890194909181,113.28014359027016,0
3606,30.856169803646665,0,0,168,0.0,0.0,1.0,168,3600,2400,1200,0.6666666666666666,48,24,24,218.8763171453695,0.4124192092006463,0.7492618752790348,0.14140660809403044,1041243.2739033703,8380.69860887111,1049623.9725122415,3605,2,1601.8392857142858,67,101,43,34.525239794013025,0.636660447761194,40.21139705882351,8016.081245405037,119.64300366276176,8
3607,30.591656593752045,1,1,168,0.005917159763313609,0.005917159763313609,0.9940828402366864,169,4800,3600,1200,0.75,60,36,24,216.20592868154162,0.41300366300366304,0.7477319925304711,0.1403530794551409,1033642.9416248478,6095.946423824052,1039738.8880486719,3606,0,1593.3550295857988,69,100,35,34.42425391646154,0.6372282608695652,40.04464285714285,7952.465015420433,115.25311616551352,0
3608,30.284094677694146,0,1,167,0.0,0.005952380952380952,0.9940476190476191,168,4600,3300,1300,0.717391304347826,59,33,26,216.7755646875351,0.4124355455755156,0.7475116407788656,0.14098764524613483,1023764.1349341902,6185.409691440902,1029949.5446256311,3607,4,1603.8392857142858,70,98,37,34.34285015704641,0.6373511904761905,39.979460093896705,7874.486648661558,112.49266640945083,0
3609,30.530825514079073,0,2,165,0.0,0.011976047904191617,0.9880239520958084,167,4450,2900,1550,0.651685393258427,60,29,31,217.96508541810817,0.41123175336074835,0.7483124962533223,0.14219928286711067,1032952.7766769733,7179.528040253542,1040132.3047172269,3608,5,1614.3353293413174,71,96,38,34.20281794586576,0.6379107981220657,39.87268518518517,7941.901660056996,111.85776985995768,0
3610,30.41303082298281,0,0,165,0.0,0.0,1.0,165,4350,3200,1150,0.735632183908046,55,32,23,221.9674140528222,0.4107461813254496,0.747146835762762,0.14518643338117831,1029676.2299262327,8360.91401367689,1038037.1439399096,3609,6,1628.2242424242424,72,93,38,34.00713789573736,0.6383101851851851,39.78310502283104,7913.98444760149,109.9164506611318,0
3611,30.004209445987073,1,1,165,0.006024096385542169,0.006024096385542169,0.9939759036144579,166,4200,3000,1200,0.7142857142857143,54,30,24,219.13143176777092,0.4123090848241451,0.7458035684448914,0.1440489510091923,1017178.3070662816,7179.147758110256,1024357.4548243919,3610,0,1619.4096385542168,74,92,37,33.905172107247,0.6390765765765766,39.61111111111111,7812.762759630069,105.57787513013606,0
3612,30.352476989148336,0,0,165,0.0,0.0,1.0,165,4200,3100,1100,0.7380952380952381,53,31,22,219.24836920050296,0.41131590293175657,0.7441391603663399,0.1450292487979021,1030679.7513828025,7994.97093173199,1038674.7223145345,3611,1,1630.1818181818182,66,99,40,33.68308276657518,0.6455176767676767,39.39676616915424,7909.953658148414,119.8477826992184,0
3613,29.993588150057306,0,0,165,0.0,0.0,1.0,165,4050,3100,950,0.7654320987654321,50,31,19,216.1791113479003,0.41138057403301304,0.7402885525152776,0.1434018118782227,1019244.8065874957,7017.887306809411,1026262.6938943052,3612,2,1631.1818181818182,69,96,43,33.66481867305971,0.6447765700483092,39.300595238095234,7819.310577393654,113.32334170135731,0
3614,30.390345020980803,1,0,166,0.006024096385542169,0.0,1.0,166,4100,2900,1200,0.7073170731707317,53,29,24,214.16441261236844,0.41196984909334305,0.7402982980173616,0.14269713079826304,1033926.411562627,6986.04852334472,1040912.4600859716,3613,0,1622.3493975903614,71,95,43,33.56281198003329,0.6452464788732395,39.14930555555555,7927.342603129093,111.65271272012806,0
3615,30.454760808800113,0,0,166,0.0,0.0,1.0,166,4450,3500,950,0.7865168539325843,54,35,19,215.05535104888335,0.411986582694414,0.7408970620256823,0.14377940779168846,1037037.6012890849,6954.0970792231565,1043991.698368308,3614,1,1623.3493975903614,71,95,42,33.42134198174222,0.6464201877934272,39.03356481481481,7947.670362690047,111.93901919281757,0
3616,30.66155543774555,0,0,166,0.0,0.0,1.0,166,4300,3400,900,0.7906976744186046,52,34,18,218.22825499405116,0.41162224656200563,0.7448367945682719,0.14629849487417193,1044818.4383413766,8101.78091696949,1052920.2192583461,3615,2,1624.3493975903614,72,94,35,33.24416962740276,0.6468460648148149,38.94121004566209,8004.468560695674,111.17317445410657,0
3617,30.946993623864163,0,0,166,0.0,0.0,1.0,166,4850,3300,1550,0.6804123711340206,64,33,31,219.59277652479125,0.4113750456370939,0.7460419757930199,0.14764830991758715,1055352.1165814872,8299.540298288746,1063651.656879776,3616,3,1625.3493975903614,72,94,36,33.10646832768731,0.6478587962962963,38.841324200913235,8082.075874771132,112.25105381626571,0
3618,31.016677605313802,1,0,167,0.005988023952095809,0.0,1.0,167,4050,2800,1250,0.691358024691358,53,28,25,215.48513577817877,0.4125018036216723,0.7430770435317295,0.14551821050002403,1058918.5755384262,8186.2426055868655,1067104.818144013,3617,0,1616.6107784431138,74,93,40,33.06369813259631,0.6483671171171171,38.69444444444446,8104.830173144114,109.52473206951505,0
3619,31.254573480077077,1,0,168,0.005952380952380952,0.0,1.0,168,3550,2600,950,0.7323943661971831,45,26,19,215.14395389562068,0.41267316557361466,0.7450845032936322,0.1457142173545421,1067846.3616699995,8798.137680547396,1076644.4993505469,3618,0,1607.982142857143,76,92,41,32.9718254584347,0.6484375,38.59577922077923,8170.077426346464,107.50101876771663,0
3620,31.155741387927055,0,0,168,0.0,0.0,1.0,168,4000,2600,1400,0.65,54,26,28,186.72148640676787,0.41274445157304435,0.7073414229138686,0.12017298444908145,1050274.873081969,1621.777087508497,1051896.6501694776,3619,1,1608.982142857143,77,91,43,35.49622614822819,0.630275974025974,40.34455128205125,8089.758010222481,105.0617923405517,8
3621,31.592264906328722,2,0,170,0.011764705882352941,0.0,1.0,170,3950,2800,1150,0.7088607594936709,51,28,23,179.56486376994337,0.4142193119851491,0.69853217739635,0.11621677249633029,1066593.5675106226,354.545729588021,1066948.1132402106,3620,0,1591.0411764705882,80,90,45,35.4831691906694,0.6309895833333333,40.14917695473247,8209.276037773532,102.61595047216915,0
3622,31.162185711555747,1,0,171,0.005847953216374269,0.0,1.0,171,4600,3000,1600,0.6521739130434783,62,30,32,179.15990554861892,0.41445075106065815,0.6991189060958136,0.1162749491671853,1052849.6410838286,-1074.3115493051127,1051775.3295345234,3621,0,1582.7309941520468,81,90,46,35.39615199791492,0.6315586419753086,40.05335365853655,8100.5056683887,100.00624281961358,0
3623,30.71343810028127,0,1,170,0.0,0.005847953216374269,0.9941520467836258,171,4600,3200,1400,0.6956521739130435,60,32,28,180.03229064253193,0.41433035202385043,0.7021223521391144,0.11732670412816992,1038835.9139546867,-1395.1981618021978,1037440.7157928845,3622,1,1583.7309941520468,82,89,36,35.227172199704,0.6326219512195121,39.90963855421684,7988.269216744781,97.41791727737538,0
3624,30.395353074396468,0,1,169,0.0,0.0058823529411764705,0.9941176470588236,170,5400,4000,1400,0.7407407407407407,68,40,28,180.7800406067981,0.41308736512356425,0.7035343454957292,0.11825088441686449,1029088.473523282,-2192.2687936950956,1026896.2047295868,3623,3,1594.0411764705882,83,87,40,35.07751937984494,0.6335341365461847,39.781746031745996,7909.4257057679615,95.29428561166219,0
3625,30.047766804677615,0,0,169,0.0,0.0,1.0,169,5300,3500,1800,0.660377358490566,71,35,36,182.47221240633075,0.41209084718700106,0.7048105390582358,0.11992212762769512,1018591.2522113924,-1927.0801342508762,1016664.1720771415,3624,4,1604.4556213017752,86,83,45,34.86802777394583,0.6340843023255813,39.619252873563184,7823.8599700828145,90.97511593119552,0
3626,30.288896712012427,1,0,170,0.0058823529411764705,0.0,1.0,170,4100,3100,1000,0.7560975609756098,51,31,20,181.33510943979633,0.4127704780136907,0.704015666721659,0.11948754952614098,1027475.5050066834,-836.5233705806936,1026638.9816361027,3625,0,1596.0117647058823,76,94,43,34.80597105363386,0.6389802631578947,39.52922077922078,7889.372528315575,103.8075332673102,0
3627,29.962258796463967,0,0,170,0.0,0.0,1.0,170,4850,3300,1550,0.6804123711340206,64,33,31,180.2941805846539,0.4126080461770507,0.7031691355875791,0.11922440098188103,1017345.5460117462,-2165.703682072827,1015179.8423296734,3626,1,1597.0117647058823,76,94,44,34.70913582169619,0.6402138157894737,39.40746753246754,7807.940898218168,102.73606445023904,0
3628,30.44604851832157,0,0,170,0.0,0.0,1.0,170,4850,3400,1450,0.7010309278350515,63,34,29,179.24826995431323,0.41246736860424643,0.7009715525554487,0.11884939638275129,1034496.1879672972,-1763.6696065059473,1032732.5183607913,3627,2,1598.0117647058823,77,93,44,34.64352800546446,0.6406926406926408,39.31623931623932,7936.790425716313,103.07520033397809,0
3629,30.306454362113197,0,0,170,0.0,0.0,1.0,170,5550,4500,1050,0.8108108108108109,66,45,21,175.91108070075506,0.4120815929922265,0.6949036857272848,0.11703145863371142,1030664.0943011515,-3288.9530664037616,1027375.1412347477,3628,3,1599.0117647058823,78,92,46,34.61320508283191,0.641426282051282,39.20094936708861,7903.894525688793,101.33198109857426,0
3630,30.184723979641355,1,1,170,0.005847953216374269,0.005847953216374269,0.9941520467836258,171,5400,3500,1900,0.6481481481481481,73,35,38,170.2985737747299,0.41267056530214424,0.6859022596563236,0.11394881403536901,1028059.332542059,-4584.592382457435,1023474.7401596016,3629,0,1590.654970760234,82,89,36,34.561333910367395,0.6417682926829269,39.00602409638553,7878.031122999737,96.0735502804846,0
3631,30.043713554277872,0,0,170,0.0,0.0,1.0,170,4500,3100,1400,0.6888888888888889,59,31,28,171.32577356807928,0.41219108945353294,0.6845075321605012,0.11484845040250126,1023748.7727524631,-3421.0899137625083,1020327.6828387006,3630,5,1601.0117647058823,82,88,37,34.47069852410944,0.6424034552845528,38.94327309236947,7843.1135246301865,95.64772591012422,0
3632,30.424172762485977,0,0,170,0.0,0.0,1.0,170,4250,2900,1350,0.6823529411764706,56,29,27,172.96821442121623,0.41209827126116716,0.6871037787862071,0.11612144888781545,1037111.7921501547,-2372.52503132009,1034739.2671188347,3631,6,1602.0117647058823,82,88,38,34.37675238324117,0.6429115853658536,38.89307228915662,7943.962278156629,96.87758875800766,0
3633,30.008676561008027,0,0,170,0.0,0.0,1.0,170,4000,2600,1400,0.65,54,26,28,174.02107753425753,0.4121736860424643,0.6884875802885568,0.11702629167979005,1023397.1133285592,-2381.4663186233083,1021015.6470099359,3632,7,1603.0117647058823,84,86,39,34.29097649101406,0.6427331349206349,38.835784313725476,7837.192477838715,93.29991045046089,0
3634,30.534935073471846,0,2,168,0.0,0.011764705882352941,0.9882352941176471,170,4000,2600,1400,0.65,54,26,28,174.34878859047697,0.41216715976331364,0.6900015178485206,0.11741688558628771,1041735.2541206921,-1674.9440824130315,1040060.3100382792,3633,8,1604.0117647058823,84,86,40,34.23254359214951,0.6432291666666667,38.78676470588235,7976.129180037388,94.95391880996891,0
3635,30.206118312744582,0,0,168,0.0,0.0,1.0,168,4750,3200,1550,0.6736842105263158,63,32,31,174.67098105405393,0.41085463002566297,0.6878333551569118,0.11777876410999526,1030845.1801129782,-2338.25221496474,1028506.9278980135,3634,14,1622.517857142857,86,82,41,34.18184769324776,0.6429263565891472,38.74521072796934,7891.493074522084,91.76154737816377,0
3636,30.074400391395862,0,1,167,0.0,0.005952380952380952,0.9940476190476191,168,3650,2900,750,0.7945205479452054,44,29,15,176.49015749399814,0.41035043009219657,0.6905121861828833,0.11934408791136931,1027102.7702783932,-995.294062208879,1026107.4762161843,3635,15,1623.517857142857,86,82,44,34.03684487813818,0.6438953488372092,38.64942528735633,7859.961826429485,91.39490495848239,0
3637,30.191430196770586,0,1,166,0.0,0.005988023952095809,0.9940119760479041,167,4600,3300,1300,0.717391304347826,59,33,26,179.67519775917884,0.40912301902219655,0.6936095734036318,0.12203519229391994,1032270.4193681062,-905.321651816595,1031365.0977162896,3636,16,1634.0239520958085,76,91,45,33.802595275047445,0.6493969298245614,38.50108225108229,7895.026321747586,103.88192528615245,0
3638,29.939592531767275,1,0,167,0.005988023952095809,0.0,1.0,167,3850,2900,950,0.7532467532467533,48,29,19,178.19518645348413,0.40986250390784695,0.6914081591296495,0.12151137827393764,1024701.631216212,-730.6203532472655,1023971.0108629647,3637,0,1615.7005988023952,77,90,48,33.70590024330901,0.6502976190476191,38.36805555555558,7833.153809960692,101.72927025922976,0
3639,30.15937409402423,0,1,166,0.0,0.005988023952095809,0.9940119760479041,167,4300,2800,1500,0.6511627906976745,58,28,30,175.93992738124814,0.4102337493687324,0.6881279971023462,0.12042629758751319,1033217.2156166029,-1343.1676230715357,1031874.0479935313,3638,1,1616.7005988023952,79,88,45,33.63682244772752,0.6507120253164558,38.24218750000003,7894.451789221022,99.9297694838104,0
3640,30.30475143571533,0,0,166,0.0,0.0,1.0,166,4550,3200,1350,0.7032967032967034,59,32,27,181.27964243883656,0.40938755020080325,0.6947806143266178,0.12437230739688111,1038817.4558256138,-86.70860974191828,1038730.7472158719,3639,2,1627.289156626506,79,87,48,33.41750998723624,0.651503164556962,38.16406250000002,7934.873002875045,100.44143041613981,0
3641,30.384206828638717,0,0,166,0.0,0.0,1.0,166,4000,2800,1200,0.7,52,28,24,180.71016318194907,0.40911600949251553,0.6949383449701596,0.12432642157653082,1042276.4724351483,469.99028289267926,1042746.462718041,3640,3,1628.289156626506,81,85,50,33.33833478830202,0.6516203703703703,38.071646341463435,7958.485271845858,98.2529045906896,0
3642,30.28618599788123,0,0,166,0.0,0.0,1.0,166,4500,3100,1400,0.6888888888888889,59,31,28,199.82280550155753,0.4088923877327492,0.7220321961824825,0.13132184189581028,1026666.77543861,3330.2870766756027,1029997.0625152856,3641,4,1629.289156626506,84,82,44,34.41711378861326,0.634796626984127,39.62009803921565,7885.914140894297,93.87993024874163,8
3643,29.924180330473114,0,1,165,0.0,0.006024096385542169,0.9939759036144579,166,5000,3700,1300,0.74,63,37,26,200.91278941311396,0.4087250517220397,0.7223701939036538,0.13272290264228187,1015778.9285978258,2616.595594330645,1018395.5241921565,3642,5,1630.289156626506,73,93,43,34.20763551233568,0.6412671232876712,39.442567567567565,7796.967594553165,106.80777526785158,0
3644,29.633497454199084,0,0,165,0.0,0.0,1.0,165,4650,3000,1650,0.6451612903225806,63,30,33,200.72509104842263,0.40753110372012813,0.7211764417057425,0.1328718291298371,1006455.1885266195,2754.1618706326144,1009209.3503972521,3643,23,1641.139393939394,73,92,41,34.14073048879286,0.641980593607306,39.37218468468468,7723.313701639864,105.79881783068306,0
3645,29.471842092018836,1,0,166,0.006024096385542169,0.0,1.0,166,4250,3100,1150,0.7294117647058823,54,31,23,199.6670960355672,0.40814698186686144,0.7205714879283716,0.1325215457358186,1001659.2131619018,2549.6772618616783,1004208.8904237634,3644,0,1632.2469879518073,75,91,44,34.0761136228227,0.6419444444444444,39.281798245614034,7683.845672620371,102.45127563493828,0
3646,29.68805436179128,0,0,166,0.0,0.0,1.0,166,5550,4000,1550,0.7207207207207207,71,40,31,198.42115659277252,0.40819490081538273,0.7189018481226668,0.13225562262628546,1010129.4360105096,1336.2102003220639,1011465.6462108317,3645,1,1633.2469879518073,76,90,41,33.960829054953415,0.6429550438596492,39.136904761904766,7744.517752413719,101.90154937386473,0
3647,29.687046887749325,0,1,165,0.0,0.006024096385542169,0.9939759036144579,166,4200,3300,900,0.7857142857142857,51,33,18,199.855940940986,0.40823217110867716,0.7187289637455172,0.1337966871795765,1011247.9045195499,3020.780296471111,1014268.684816021,3646,2,1634.2469879518073,76,90,38,33.771617255796286,0.6444627192982456,38.98809523809525,7748.672654927452,101.95621914378226,0
3648,29.515426059308172,0,0,165,0.0,0.0,1.0,165,4050,3300,750,0.8148148148148148,48,33,15,201.65708646494915,0.4074325572801183,0.7171581478131637,0.1353104699794128,1005996.9405143574,3523.2824033557345,1009520.2229177131,3647,3,1644.2666666666667,78,87,38,33.645817551302116,0.6443643162393162,38.910864978902964,7706.157059603946,98.79688537953777,0
3649,29.59123901443459,0,1,164,0.0,0.006060606060606061,0.9939393939393939,165,5500,4700,800,0.8545454545454545,63,47,16,204.41472822931215,0.4072308450357231,0.721707613166926,0.13789714232915867,1009979.3906534524,2790.932531526491,1012770.3231849789,3648,4,1645.2666666666667,82,83,39,33.38917443238226,0.6445630081300813,38.72991967871487,7731.305394107703,94.28421212326468,0
3650,29.2386265701891,0,0,164,0.0,0.0,1.0,164,3950,2800,1150,0.7088607594936709,51,28,23,206.47015079052375,0.4065360180058856,0.7226629923283421,0.13929297492813164,997961.4859363966,4459.8516968846325,1002421.3376332812,3649,29,1656.2743902439024,83,81,39,33.33318501115384,0.6442018072289157,38.72767857142858,7639.243839376431,92.03908240212569,0
3651,28.88148903009517,0,0,164,0.0,0.0,1.0,164,4150,3100,1050,0.7469879518072289,52,31,21,211.95141909464903,0.4063248166990872,0.7268037640987863,0.1433124909198634,986343.2498318119,4861.370303256208,991204.6201350681,3650,30,1657.2743902439024,84,80,39,33.11265200537685,0.644593253968254,38.65196078431373,7548.120527644738,89.85857771005641,0
3652,28.683415441576933,1,0,165,0.006060606060606061,0.0,1.0,165,4650,3400,1250,0.7311827956989247,59,34,25,209.33866679503683,0.40764042867701406,0.7345911223570234,0.13231043896630773,962194.5798538185,2634.906108801745,964829.4859626202,3651,0,1648.2242424242424,75,90,35,35.55909796451123,0.6247222222222222,40.9813596491228,7429.539268296602,99.06052357728802,8
3653,28.919464566808106,0,0,165,0.0,0.0,1.0,165,3600,2600,1000,0.7222222222222222,46,26,20,209.6082590465159,0.40738636363636366,0.7351478765730906,0.13290454160993123,970958.4562663091,4104.182324894866,975062.638591204,3652,1,1649.2242424242424,76,89,35,35.436896371704506,0.6254111842105263,40.8685064935065,7493.944044605124,98.60452690269899,0
3654,29.4022534064185,0,0,165,0.0,0.0,1.0,165,3900,2800,1100,0.717948717948718,50,28,22,211.13412009105735,0.4070691672825819,0.7371464356538984,0.13423198437905937,987889.514531019,4815.436679537799,992704.9512105568,3653,2,1650.2242424242424,76,89,35,35.300660160734786,0.6263706140350878,40.77380952380953,7621.834141961478,100.28729134159839,0
3655,29.2670216950006,0,0,165,0.0,0.0,1.0,165,5350,3700,1650,0.6915887850467289,70,37,33,213.3042714752314,0.4068027839369303,0.740962375934828,0.13613480960632535,984373.7837702108,3644.226561284502,988018.0103314953,3654,3,1651.2242424242424,77,88,37,35.106060020939545,0.6272997835497836,40.63835470085471,7590.742899821162,98.58107662105405,0
3656,29.110325679184264,0,0,165,0.0,0.0,1.0,165,4300,3300,1000,0.7674418604651163,53,33,20,213.9421129415919,0.40660107169253507,0.7411877941720866,0.13712397171759763,980230.4162319102,4642.513283654228,984872.9295155645,3655,4,1652.2242424242424,68,97,36,34.93710005817337,0.6332720588235294,40.48913043478261,7554.44593033179,111.09479309311456,0
3657,29.12306204902108,1,0,166,0.006024096385542169,0.0,1.0,166,4900,3300,1600,0.673469387755102,65,33,32,211.73752531404932,0.4069512900085189,0.7384374265865696,0.1364209827490018,982038.4377320975,3486.8777137339475,985525.3154458314,3656,0,1643.2650602409637,71,95,36,34.80803156917364,0.6335093896713615,40.30671296296297,7563.063712093881,106.52202411399833,0
3658,28.999542112392742,2,2,166,0.011904761904761904,0.011904761904761904,0.9880952380952381,168,3750,2800,950,0.7466666666666667,47,28,19,210.48108240529064,0.40833288779583693,0.7407314629258501,0.13640267548083185,979399.2764659214,3879.0039635013527,983278.2804294227,3657,0,1624.6904761904761,73,95,34,34.63385103540414,0.634560502283105,40.104166666666686,7536.860163585448,103.24465977514313,0
3659,29.319097740395463,0,0,166,0.0,0.0,1.0,166,4200,2900,1300,0.6904761904761905,55,29,26,218.54541481338714,0.40655957161981254,0.7472769867348177,0.1417743331994541,990463.4514792181,5892.249172205079,996355.7006514232,3658,2,1645.2650602409637,72,94,34,34.38780925193969,0.6354166666666667,40.068493150684944,7620.957255123365,105.84662854338006,0
3660,29.410822772719364,0,0,166,0.0,0.0,1.0,166,4250,2900,1350,0.6823529411764706,56,29,27,216.76263385598105,0.40660749056833395,0.7453121636519,0.14087283065869036,994042.7537994477,5644.265095804283,999687.0188952519,3659,3,1646.2650602409637,73,93,34,34.36992420140767,0.6355593607305936,40.00563063063064,7646.64831942748,104.74860711544493,0
3661,29.727732556476184,0,1,165,0.0,0.006024096385542169,0.9939759036144579,166,4700,3500,1200,0.7446808510638298,59,35,24,215.8106670041581,0.4067010466106851,0.744374024804155,0.14055842572705635,1005334.182817066,5492.368111166355,1010826.5509282324,3660,4,1647.2650602409637,74,92,34,34.317979528259876,0.6358389639639639,39.930555555555564,7731.274890555807,104.47668771021361,0
3662,29.50600757858913,0,1,164,0.0,0.006060606060606061,0.9939393939393939,165,3950,2800,1150,0.7088607594936709,51,28,23,216.51503868130922,0.40653178122690314,0.7436286546609345,0.14152008142756814,998780.459510185,6300.197964996791,1005080.6574751819,3661,5,1654.3030303030303,78,87,36,34.17393030287671,0.6352831196581197,39.8074894514768,7677.24218813687,98.42618189919064,0
3663,29.450510549429247,0,0,164,0.0,0.0,1.0,164,4250,3100,1150,0.7294117647058823,54,31,23,217.23386653994854,0.405462865978353,0.7438801706792377,0.14232342701629133,997522.1047839506,6289.1167562572045,1003811.2215402079,3662,6,1665.121951219512,79,85,36,34.072541981423115,0.6356803797468354,39.726562500000014,7665.185616829997,97.02766603582275,0
3664,29.83714702446437,0,1,163,0.0,0.006097560975609756,0.9939024390243902,164,4150,2600,1550,0.6265060240963856,57,26,31,214.1451018245543,0.40537869719187986,0.7402179629660468,0.14078083057086993,1011533.1158485407,6372.972418459001,1017906.0882669997,3663,7,1666.121951219512,81,83,35,34.032588545223916,0.6360596707818931,39.60873983739838,7769.33231335712,95.9176828809521,0
3665,30.007019797323604,0,0,163,0.0,0.0,1.0,163,5000,3600,1400,0.72,64,36,28,214.87315138733942,0.404900085839077,0.7399044260658294,0.14186966454952876,1018448.4979743934,6167.447657091963,1024615.9456314854,3664,8,1675.484662576687,67,96,36,33.862496080275946,0.6442786069651741,39.46078431372548,7818.005403077187,116.6866478071222,0
3666,29.75201932973799,0,0,163,0.0,0.0,1.0,163,4500,3600,900,0.8,54,36,18,211.84140824877414,0.40469337776767905,0.7364246555865064,0.14046320172982657,1010920.3748986059,5730.959169179778,1016651.3340677856,3665,9,1676.484662576687,69,94,38,33.793098527229134,0.6446256038647342,39.31547619047618,7755.890991344482,112.40421726586206,0
3667,29.747961327511437,0,0,163,0.0,0.0,1.0,163,4800,3200,1600,0.6666666666666666,64,32,32,220.65135842271644,0.40451980610467314,0.7467589005362054,0.13699023523506584,993006.9004732562,6421.664302511179,999428.5647757674,3666,10,1677.484662576687,63,100,39,35.91660104986875,0.624834656084656,41.61783854166668,7686.342546781338,122.00543725049742,8
3668,29.99359741567159,2,0,165,0.012121212121212121,0.0,1.0,165,4800,3500,1300,0.7291666666666666,61,35,26,219.4891749029116,0.4060467479674797,0.747737280957216,0.13771364559810245,1004127.4244325311,6279.019977216464,1010406.4444097476,3667,0,1658.139393939394,70,95,41,35.56172157018389,0.6245535714285715,41.2411971830986,7761.107359451305,110.87296227787579,0
3669,30.486227749188064,0,0,165,0.0,0.0,1.0,165,3250,2200,1050,0.676923076923077,43,22,21,192.46474739661858,0.4057834441980783,0.716026040330755,0.11967544819323601,1018086.6825329342,2939.1592363126065,1021025.8417692469,3668,1,1659.139393939394,69,96,44,36.58848918446861,0.6218297101449275,41.56250000000001,7878.784483930809,114.18528237580882,8
3670,30.2754825517296,2,0,167,0.011976047904191617,0.0,1.0,167,4000,3000,1000,0.75,50,30,20,187.22655885850156,0.4073314214943607,0.7114677679124506,0.11705696375682469,1012579.0144615048,516.336889992165,1013095.3513514969,3669,0,1640.2574850299402,72,95,44,36.52471264367816,0.6222511574074074,41.3670091324201,7830.238602313077,108.75331392101495,0
3671,30.58201988711121,1,1,167,0.005952380952380952,0.005952380952380952,0.9940476190476191,168,4550,3300,1250,0.7252747252747253,58,33,25,185.15528617745522,0.40842645067008837,0.7105922631653256,0.11657376817732618,1024798.4697162958,-200.62921309212197,1024597.8405032037,3670,0,1631.4880952380952,75,93,49,36.32509176902445,0.6233333333333333,41.11842105263159,7917.121595775195,105.5616212770026,0
3672,30.7701855139484,0,0,167,0.0,0.0,1.0,167,4050,2700,1350,0.6666666666666666,54,27,27,189.2619473700009,0.4086450592790323,0.7151865381890932,0.11963679452933026,1032232.8525495748,1622.4799625648566,1033855.3325121397,3671,1,1641.9461077844312,76,91,42,36.07440678261173,0.6243146929824561,40.97673160173161,7970.194021043983,104.87097396110505,0
3673,31.022350756915692,0,1,166,0.0,0.005988023952095809,0.9940119760479041,167,4350,2700,1650,0.6206896551724138,60,27,33,192.57045318989992,0.40867812567635814,0.7196628287595519,0.12201998474168632,1041372.337957695,2357.5086119877324,1043729.8465696827,3672,2,1642.9461077844312,77,90,42,35.90244132907261,0.6247294372294372,40.89209401709402,8038.13634329164,104.39138108170961,0
3674,30.60653342786532,0,1,165,0.0,0.006024096385542169,0.9939759036144579,166,4700,3500,1200,0.7446808510638298,59,35,24,199.39404089983563,0.4078784836314957,0.7268538692109909,0.12671937703753716,1028244.9204808284,3105.181945880418,1031350.1024267088,3673,3,1653.8253012048192,76,90,43,35.6187916427465,0.626233552631579,40.787337662337656,7933.601014763618,104.38948703636339,0
3675,30.955575385418843,0,0,165,0.0,0.0,1.0,165,3950,3000,950,0.759493670886076,49,30,19,197.9685317129559,0.4072939763488544,0.7228935095367426,0.12616138589003253,1040751.5506226663,4257.211270950238,1045008.7618936165,3674,4,1663.9333333333334,79,86,44,35.556584232990176,0.6259229957805907,40.690104166666664,8027.087028653857,101.60869656523869,0
3676,30.597654280979313,0,1,164,0.0,0.006060606060606061,0.9939393939393939,165,4000,3100,900,0.775,49,31,18,200.78666955730242,0.40760809312638585,0.7280563896164729,0.12262636514164918,1016692.8803942422,3827.6754833963532,1020520.5558776386,3675,5,1664.9333333333334,68,97,42,37.03406828297026,0.6158088235294117,42.21014492753625,7887.764862651044,115.99654209780947,8
3677,30.26167882722954,0,0,164,0.0,0.0,1.0,164,4350,3100,1250,0.7126436781609196,56,31,25,199.54485029574968,0.4068750311736246,0.7239643553518291,0.12218780338446396,1006270.2662804085,3009.209928397762,1009279.4762088063,3676,6,1675.5853658536585,71,93,40,36.96920289855076,0.6151701877934272,42.115162037037045,7804.028140847331,109.9158893077089,0
3678,30.209315272696358,4,0,168,0.023809523809523808,0.0,1.0,168,4150,3000,1150,0.7228915662650602,53,30,23,193.92563279517682,0.4104224586541203,0.7224935679511313,0.1197934303279231,1006997.3548472992,1306.5198523664321,1008303.8746996656,3677,0,1636.6666666666667,78,90,44,36.79133472917305,0.6151175213675213,41.798523206751064,7800.089816323069,100.0011514913214,0
3679,30.202781479055115,0,0,168,0.0,0.0,1.0,168,4350,3000,1350,0.6896551724137931,57,30,27,196.50641107376399,0.41033929165478567,0.7264023111008695,0.12174560221365838,1007604.9134517193,1650.165064537693,1009255.078516257,3678,1,1637.6666666666667,79,89,42,36.61680444937327,0.6157700421940928,41.69270833333334,7801.59868465491,98.75441372980899,0
3680,30.00052479779593,0,0,168,0.0,0.0,1.0,168,5150,3800,1350,0.7378640776699029,65,38,27,193.76808876776752,0.40993459509552327,0.7212956505756074,0.12057973930843391,1002082.7850467254,84.33320911710325,1002167.1182558425,3679,2,1638.6666666666667,70,98,43,36.526390229134726,0.621577380952381,41.53462441314554,7754.096909665074,110.77281299521535,0
3681,30.32115717754387,0,0,168,0.0,0.0,1.0,168,4250,2800,1450,0.6588235294117647,57,28,29,212.5974873196002,0.40965613416025093,0.7336929103043752,0.12567329957180678,998171.9089444292,4591.767950919177,1002763.6768953485,3680,3,1639.6666666666667,81,87,38,37.95190974800737,0.597608024691358,43.40701219512198,7780.196313887369,96.05180634428851,8
3682,30.559199068448336,0,0,168,0.0,0.0,1.0,168,3000,1600,1400,0.5333333333333333,44,16,28,210.0922608347326,0.40967172797262613,0.731551301540164,0.12444779038891246,1006605.9904096874,5696.02565899159,1012302.0160686789,3681,4,1640.6666666666667,81,87,36,37.938371277736564,0.5983796296296297,43.330792682926855,7843.605401143341,96.83463458201655,0
3683,30.635772151722552,1,0,169,0.005917159763313609,0.0,1.0,169,4750,3400,1350,0.7157894736842105,61,34,27,209.77910642684063,0.4105616605616606,0.7320871553145123,0.12472912761968087,1010220.2115446385,3834.6186544341026,1014054.8301990726,3682,0,1631.9526627218936,83,86,41,37.804668260176776,0.5990210843373494,43.19196428571432,7867.51246887437,94.78930685390807,0
3684,30.301487239928793,0,2,167,0.0,0.011834319526627219,0.9881656804733728,169,5050,3600,1450,0.7128712871287128,65,36,29,211.68388303126991,0.4106423757866065,0.7353900735613337,0.1265328473758354,1000725.032370234,3517.4721397453127,1004242.5045099794,3683,1,1632.9526627218936,86,83,31,37.55532261821571,0.5999273255813953,42.99568965517244,7787.612830520564,90.5536375641926,0
3685,30.695364086901535,0,0,167,0.0,0.0,1.0,167,4400,3500,900,0.7954545454545454,53,35,18,214.14623283469433,0.4088840391506144,0.7374925073878376,0.12826331728361645,1014319.186642639,5642.526542294881,1019961.7131849339,3684,7,1653.4670658682635,87,80,32,37.41616017435617,0.6003352490421456,42.921401515151544,7891.121179442873,90.70254229244681,0
3686,30.3796635624669,1,0,168,0.005952380952380952,0.0,1.0,168,5050,3600,1450,0.7128712871287128,65,36,29,214.58295964323486,0.40959672916072615,0.7400610250702659,0.12907361027626923,1005109.2426707058,4485.863211410457,1009595.1058821162,3685,0,1644.6190476190477,91,77,37,37.2451197235794,0.6006181318681318,42.764945652173935,7814.714407559905,85.8759825006583,0
3687,30.487031030719294,2,0,170,0.011764705882352941,0.0,1.0,170,4300,2900,1400,0.6744186046511628,57,29,28,202.34475104832754,0.41158849634528366,0.7261722610637293,0.12270491129609824,1010991.9820205852,2613.784182761803,1013605.766203347,3686,0,1626.2588235294118,77,93,39,37.25692283758553,0.6087662337662338,42.467948717948694,7851.387638840635,101.96607323169656,0
3688,30.46707651980828,0,0,170,0.0,0.0,1.0,170,4550,3100,1450,0.6813186813186813,60,31,29,199.7576274151353,0.41131656804733724,0.7225877121276547,0.12159346936075292,1011407.2084901393,1857.2608637106268,1013264.46935385,3687,1,1627.2588235294118,79,91,38,37.183588946721244,0.6093090717299579,42.330729166666636,7850.429391282297,99.37252394028224,0
3689,30.70557443253267,2,0,172,0.011627906976744186,0.0,1.0,172,4600,3300,1300,0.717391304347826,59,33,26,195.50468345919606,0.4136151910784714,0.7193044885064572,0.11963492975460781,1020841.6626270786,915.8652227730427,1021757.5278498516,3688,0,1609.3255813953488,85,87,43,37.097748054550856,0.6089460784313725,42.13905038759688,7917.768581567156,93.15021860667242,0
3690,30.47877526461065,0,1,171,0.0,0.005813953488372093,0.9941860465116279,172,4450,3500,950,0.7865168539325843,54,35,19,192.84961489049215,0.4137171902624779,0.7156101534087056,0.11826243249603886,1013908.8353572122,256.38568654081337,1014165.2210437531,3689,1,1610.3255813953488,86,86,32,37.08745300097474,0.609375,42.06178160919538,7861.640990487337,91.41443012194578,0
3691,30.519463505541907,1,1,171,0.005813953488372093,0.005813953488372093,0.9941860465116279,172,4550,3300,1250,0.7252747252747253,58,33,25,197.71432206265342,0.4133573598077882,0.7238203389258651,0.12194594763461561,1016899.2479525864,1261.1090829932655,1018160.3570355796,3690,0,1611.3139534883721,88,84,36,36.750015113045606,0.6107954545454546,41.85393258426964,7878.479483593486,89.52817594992598,0
3692,30.553790816373652,0,2,169,0.0,0.011695906432748537,0.9883040935672515,171,4900,3700,1200,0.7551020408163265,61,37,24,233.64984242945167,0.4136796238963421,0.7700641599287108,0.14107810113486588,1011965.2338113954,8189.103484823143,1020154.3372962185,3691,1,1605.9941520467837,62,109,39,36.6121140091653,0.615255376344086,42.62566137566137,7863.7617038305525,126.83486619081536,8
3693,30.27888764413845,1,2,168,0.0058823529411764705,0.011764705882352941,0.9882352941176471,170,4050,2700,1350,0.6666666666666666,54,27,27,234.48019212346952,0.41312072166144564,0.7697317551894372,0.14227049693871852,1004245.8720354659,9045.153002815372,1013291.0250382812,3692,0,1615.870588235294,63,107,39,36.40883046848667,0.6164021164021164,42.447916666666664,7798.39059376378,123.78397767879017,0
3694,30.08771642356096,1,0,169,0.005917159763313609,0.0,1.0,169,3750,2700,1050,0.72,48,27,21,231.61703271554316,0.41352024044331737,0.7653391601141968,0.14086871989748553,998578.16749984,8707.542418167348,1007285.7099180074,3693,0,1622.3491124260354,65,104,41,36.393755615453706,0.6160256410256411,42.36111111111109,7751.765828570186,119.25793582415672,0
3695,29.920457060925116,2,2,169,0.011695906432748537,0.011695906432748537,0.9883040935672515,171,5700,4300,1400,0.7543859649122807,71,43,28,230.66463788190237,0.4155630088292627,0.7674225755149775,0.14148410591100063,995399.1513759423,6020.676960016676,1001419.828335959,3694,0,1604.3625730994152,69,102,35,36.10365947463557,0.6168478260869565,42.05357142857141,7717.875040090378,111.8532614505852,0
3696,30.437394996257193,0,2,167,0.0,0.011834319526627219,0.9881656804733728,169,4200,3100,1100,0.7380952380952381,53,31,22,234.40522772838358,0.4136229689114304,0.7690706368726281,0.1442096380033061,1013446.0141276033,9511.408746400493,1022957.4228740038,3695,1,1623.2899408284025,70,99,36,35.89648833551271,0.6174107142857144,41.94542253521125,7854.509104887991,112.2072729269713,0
3697,30.179949400003967,2,0,169,0.011834319526627219,0.0,1.0,169,4750,4000,750,0.8421052631578947,55,40,15,204.92753986087982,0.4146091622053161,0.7375313162080293,0.1239822847115937,1000148.8788320884,2441.609846735547,1002590.4886788239,3696,0,1612.2899408284025,66,103,42,37.277059806349044,0.6134785353535354,42.55286069651743,7769.741637354905,117.72335814174099,8
3698,30.714696384528484,0,0,169,0.0,0.0,1.0,169,3900,2800,1100,0.717948717948718,50,28,22,214.8838318301233,0.4144022377195454,0.7415354205998239,0.12512562277390046,1006700.592340533,5564.736157558008,1012265.3284980911,3697,1,1613.2899408284025,75,94,34,38.4676124197002,0.5944444444444444,43.969298245614056,7863.905269503778,104.85207026005037,8
3699,30.668542848288947,5,0,174,0.028735632183908046,0.0,1.0,174,4950,3200,1750,0.6464646464646465,67,32,35,238.40075570113993,0.41749509999335593,0.7762095604331836,0.13779184261877608,1002994.1896857806,8072.914556988734,1011067.1042427693,3698,0,1567.9022988505747,70,104,40,38.151698982713796,0.594047619047619,44.24882629107983,7843.515829392245,112.05022613417493,8
3700,31.092935200755296,5,2,177,0.027932960893854747,0.0111731843575419,0.9888268156424581,179,5100,3800,1300,0.7450980392156863,64,38,26,229.9636942959936,0.4215392421484318,0.7753292453982303,0.13422509990511086,1019807.0404303342,6003.718897285107,1025810.7593276192,3699,0,1525.0782122905027,79,100,39,37.99038298593461,0.5936181434599156,43.880208333333364,7963.516085922692,100.804001087629,0
3701,30.934651260133215,2,1,178,0.0111731843575419,0.00558659217877095,0.994413407821229,179,4400,3000,1400,0.6818181818181818,58,30,28,231.51646036952704,0.4215143954135543,0.7775170108957645,0.13608393610651512,1016696.2530614864,6876.383555951024,1023572.6366174375,3700,0,1526.0502793296089,62,117,41,37.68205318371384,0.6051747311827957,43.617724867724846,7931.096270496414,127.92090758865184,0
3702,31.106740105468123,2,0,180,0.011111111111111112,0.0,1.0,180,4800,3200,1600,0.6666666666666666,64,32,32,231.58098481942955,0.42224614628595075,0.7767694473488185,0.13696890622695884,1024193.0630766808,6636.7276385050545,1030829.7907151858,3701,0,1518.4333333333334,65,115,40,37.444325706788014,0.6056089743589743,43.38699494949494,7982.394055789223,122.80606239675727,0
3703,30.795771646742548,5,3,182,0.02702702702702703,0.016216216216216217,0.9837837837837837,185,5300,3700,1600,0.6981132075471698,69,37,32,218.50696186121596,0.4251725910693302,0.7679475366538118,0.1305676968520401,1016951.7179032168,2142.2060477151317,1019093.923950932,3702,0,1478.3675675675677,72,113,37,37.39253655376645,0.6056134259259259,43.0079908675799,7914.267228279559,109.92037817054944,0
3704,31.340672859639213,0,1,181,0.0,0.005494505494505495,0.9945054945054945,182,4350,3100,1250,0.7126436781609196,56,31,25,226.39301196417193,0.4229814269524214,0.7737880664588042,0.13527996501243308,1034945.6889879294,6110.894349862464,1041056.5833377918,3703,1,1503.7362637362637,72,110,38,37.18987136775863,0.6056134259259259,43.007990867579906,8054.302485760588,111.8653123022304,0
3705,31.329251932285743,1,0,182,0.005494505494505495,0.0,1.0,182,4900,3500,1400,0.7142857142857143,63,35,28,231.02676262580252,0.42303138850100175,0.7795499239907191,0.13859329631807987,1035734.8308514957,6556.492982080882,1042291.3238335766,3704,0,1504.7197802197802,73,109,39,36.922626868122855,0.6065924657534247,42.86317567567568,8055.904350324658,110.3548541140364,0
3706,31.83268767899245,0,2,180,0.0,0.01098901098901099,0.989010989010989,182,4750,3400,1350,0.7157894736842105,61,34,27,238.03102320751321,0.42285241232064436,0.7859059226772238,0.143461941014258,1053777.332122599,9016.33931960518,1062793.6714422042,3705,1,1505.7197802197802,64,118,40,36.567586364391325,0.61328125,42.69230769230769,8190.795406633057,127.98117822864151,0
3707,31.53063244522341,0,1,179,0.0,0.005555555555555556,0.9944444444444445,180,5150,4100,1050,0.7961165048543689,62,41,21,240.55773288610527,0.42093420235878337,0.7864918252831576,0.14517537137985567,1044168.2972455042,9086.551667384634,1053254.848912889,3706,2,1523.3666666666666,64,116,40,36.453338730099446,0.61376953125,42.64423076923077,8114.590167273113,126.7904713636424,0
3708,31.112901265014425,2,2,179,0.011049723756906077,0.011049723756906077,0.988950276243094,181,4800,3500,1300,0.7291666666666666,61,35,26,237.80089880388948,0.4224805606711684,0.7851678964513527,0.14454735484887926,1032436.762923682,8102.878036285938,1040539.640959968,3707,0,1509.635359116022,66,115,42,36.25565781532893,0.6152146464646464,42.3818407960199,8015.248351388199,121.44315683921513,0
3709,30.836170905703256,1,0,180,0.005555555555555556,0.0,1.0,180,4500,3000,1500,0.6666666666666666,60,30,30,235.28453618413226,0.422899855162425,0.7821782983569212,0.14363544709846518,1024498.2609054788,7709.719627719306,1032207.9805331981,3708,0,1518.0333333333333,68,112,43,36.16020009760861,0.615655637254902,42.22524154589373,7948.786506867223,116.89391921863563,0
3710,31.370398897090986,2,1,181,0.01098901098901099,0.005494505494505495,0.9945054945054945,182,6000,4500,1500,0.75,75,45,30,230.26109268031104,0.424005954910651,0.7805127738206117,0.1416782958491803,1044548.8952035088,5703.7939935145705,1050252.6891970234,3709,0,1502.3406593406594,75,107,38,35.998689894483405,0.615,41.94078947368423,8095.4203732789465,107.93893831038595,0
3711,31.53191215887227,0,0,181,0.0,0.0,1.0,181,4300,3200,1100,0.7441860465116279,54,32,22,229.70604182954642,0.42341799672600783,0.7793902198290925,0.141540354156509,1050349.2099282464,7754.311910282044,1058103.5218385286,3710,1,1511.6408839779006,74,107,39,35.9599207203329,0.615990990990991,41.88888888888891,8138.7368827845185,109.98293084843944,0
3712,31.90944730761384,0,4,177,0.0,0.022099447513812154,0.9779005524861879,181,5200,3400,1800,0.6538461538461539,70,34,36,231.46857308317004,0.4234282279517086,0.7818430541017407,0.1432404061176926,1064198.7027491995,7865.711040463784,1072064.4137896632,3711,2,1512.6408839779006,76,105,39,35.75626822411959,0.6166392543859649,41.73430735930737,8241.115510682606,108.43573040371851,0
3713,31.4953588067787,1,0,178,0.0056179775280898875,0.0,1.0,178,5650,4200,1450,0.7433628318584071,71,42,29,231.50119057937678,0.42275082523963686,0.7783908122015017,0.14366312962642352,1051207.957201116,7421.178727714603,1058629.1359288306,3711,0,1513.8202247191011,62,116,40,35.65238491403215,0.6253360215053764,41.633597883597886,8137.342538272558,131.24746029471868,0
3714,31.384432003592426,1,0,179,0.00558659217877095,0.0,1.0,179,4700,3400,1300,0.723404255319149,60,34,26,231.49028035105076,0.42380160274517187,0.7797029831509035,0.14462093124370543,1049447.4488961438,8087.37683173272,1057534.8257278765,3712,0,1506.3575418994412,64,115,41,35.40775856726776,0.62646484375,41.394230769230774,8116.195180159803,126.81554968999693,0
3715,31.74133695104694,0,0,179,0.0,0.0,1.0,179,5450,4100,1350,0.7522935779816514,68,41,27,230.90999950613093,0.4237166007574331,0.7793648765378458,0.14488210646395022,1062643.82907195,7825.017209239453,1070468.8462811895,3713,1,1507.3575418994412,65,114,41,35.265515401036886,0.6274038461538461,41.240530303030305,8213.37151692574,126.35956179885753,0
3716,31.698859719278712,3,2,180,0.016483516483516484,0.01098901098901099,0.989010989010989,182,5200,4000,1200,0.7692307692307693,64,40,24,222.59683291200392,0.42508929836277903,0.7732352093780435,0.14078174061179344,1063537.7154586436,5748.025428712466,1069285.740887356,3714,0,1483.4945054945056,74,108,39,35.19214787410863,0.6254222972972974,40.958333333333336,8211.325453114829,110.96385747452472,0
3717,31.404097856604775,0,0,180,0.0,0.0,1.0,180,4800,3500,1300,0.7291666666666666,61,35,26,226.417986862308,0.4239725584523071,0.7752645430784184,0.14346560702838204,1054184.0607440695,6937.246563200976,1061121.3073072706,3715,1,1500.9777777777779,73,107,42,35.025794081961564,0.6265696347031964,40.89245495495495,8137.038699979213,111.46628356135908,0
3718,31.848115444916253,2,0,182,0.01098901098901099,0.0,1.0,182,5000,3300,1700,0.66,67,33,34,222.55989175399714,0.42402745734928055,0.7748732940417953,0.1423682621568031,1071852.4237148103,6310.271879645609,1078162.6955944558,3716,0,1485.4725274725274,61,121,41,34.783652808358156,0.6369535519125683,40.557795698924735,8262.745273864202,135.45484055515087,0
3719,32.31576851540083,0,0,182,0.0,0.0,1.0,182,4750,3400,1350,0.7157894736842105,61,34,27,250.04635843118837,0.4242823244895068,0.7989114652657023,0.14987374517493832,1068085.1432120344,12264.160110924546,1080349.303322959,3717,1,1486.4725274725274,66,116,33,36.46608111104393,0.6100063131313131,42.894900497512424,8308.548879651455,125.88710423714325,8
3720,32.204391804481624,1,0,183,0.00546448087431694,0.0,1.0,183,5650,4200,1450,0.7433628318584071,71,42,29,247.95744384429773,0.42524119778218133,0.7983021905366272,0.14972251013996055,1066645.4700851198,10646.536850081118,1077292.006935201,3718,0,1479.344262295082,61,122,32,36.24250658223992,0.6159494535519126,42.62432795698925,8288.626983414888,135.8791308756539,0
3721,31.91439433979351,0,0,183,0.0,0.0,1.0,183,5150,4100,1050,0.7961165048543689,62,41,21,247.93528116554845,0.42522743649792827,0.798762877479648,0.149915721310913,1057454.481822134,10686.05485406808,1068140.536676202,3719,1,1480.344262295082,61,122,34,36.19142409607102,0.6164617486338797,42.5739247311828,8215.597279474405,134.6819226143345,0
3722,32.251384124289785,0,2,181,0.0,0.01092896174863388,0.9890710382513661,183,5850,4800,1050,0.8205128205128205,69,48,21,249.86765423526626,0.42530875317760564,0.7993139362905333,0.1518780810766429,1070207.6014606156,11032.052584342739,1081239.6540449583,3720,2,1481.344262295082,63,120,34,35.945792266868835,0.6170634920634921,42.382812499999986,8308.510871081657,131.88112493780406,0
3723,32.542122677099535,1,0,182,0.005494505494505495,0.0,1.0,182,4800,3100,1700,0.6458333333333334,65,31,34,246.47626015014188,0.42559587051990366,0.7949304479972124,0.1505275458397599,1081297.6257770576,12102.838982151115,1093400.4647592087,3721,0,1488.3076923076924,66,116,38,35.85692961823772,0.6169507575757576,42.21082089552237,8389.007091246649,127.10616804919165,0
3724,32.62842332906838,0,0,182,0.0,0.0,1.0,182,4800,3300,1500,0.6875,63,33,30,246.9406062931273,0.42520692935057575,0.795695753177939,0.15154809803120417,1085650.3469345053,12418.230978869819,1098068.577913375,3722,1,1489.3076923076924,67,115,33,35.66409342834517,0.6181592039800995,42.03431372549017,8417.013616138302,125.6270688975866,0
3725,32.16544455479134,2,0,184,0.010869565217391304,0.0,1.0,184,5250,3400,1850,0.6476190476190476,71,34,37,245.26226278456483,0.42673004771521345,0.797004388403795,0.15193655808045847,1073051.051353841,10585.785787679457,1083636.8371415206,3723,0,1474.108695652174,69,115,37,35.36121673003801,0.6204710144927537,41.69642857142854,8308.449205090232,120.41230732014829,0
3726,32.03238115393093,1,0,185,0.005405405405405406,0.0,1.0,185,5500,4000,1500,0.7272727272727273,70,40,30,240.27287628133902,0.4270943497845672,0.7933818278645868,0.1494510676145484,1069816.2467826537,8909.565341394886,1078725.8121240486,3724,0,1467.1351351351352,62,123,39,35.34109568592326,0.6261760752688172,41.55092592592592,8278.739249621252,133.528052413246,0
3727,31.549253006898425,0,0,185,0.0,0.0,1.0,185,4700,3000,1700,0.6382978723404256,64,30,34,235.49719973373328,0.42713963963963963,0.7883371803523196,0.14684734026792118,1054410.1276961644,7962.126488667041,1062372.2541848314,3725,1,1468.1351351351352,65,120,40,35.37298038377794,0.6251602564102564,41.4614898989899,8156.696867203342,125.48764411082064,0
3728,31.92036900507884,1,1,185,0.005376344086021506,0.005376344086021506,0.9946236559139785,186,4900,3500,1400,0.7142857142857143,63,35,28,221.85615755112212,0.42819008524653684,0.774622687091433,0.13496899198313875,1059483.4762379122,4910.586605409771,1064394.062843322,3726,0,1461.236559139785,69,117,40,36.63509298833314,0.6138285024154589,42.351190476190474,8224.245073719268,119.19195759013432,8
3729,31.444583193566658,1,0,186,0.005376344086021506,0.0,1.0,186,5100,3500,1600,0.6862745098039216,67,35,32,219.0102647974454,0.42791702993315894,0.7712695717789091,0.13391866242385944,1045191.5650530409,3481.536285264702,1048673.1013383055,3727,0,1462.1290322580646,72,114,42,36.51926872913093,0.6141493055555556,42.166095890410965,8107.479647896077,112.60388399855663,0
3730,31.541836453006606,0,0,186,0.0,0.0,1.0,186,4600,3100,1500,0.6739130434782609,61,31,30,223.0330143752478,0.4284062288094546,0.7747682337182755,0.13693554621290369,1049624.1972674718,5020.169735552887,1054644.3670030248,3728,1,1463.1290322580646,73,113,37,36.264743729652054,0.6151541095890412,42.01858108108109,8137.2077234551425,111.46859895144031,0
3731,31.559548951443805,1,2,185,0.0053475935828877,0.0106951871657754,0.9893048128342246,187,4800,3200,1600,0.6666666666666666,64,32,32,217.129080316828,0.42915756234067426,0.7694379419359512,0.13395434745389628,1051628.6043491391,3467.830339439576,1055096.4346885788,3729,0,1456.2994652406417,75,112,39,36.239547385187144,0.6159722222222221,41.84484649122807,8147.260204227576,108.63013605636768,0
3732,31.532822222545256,1,1,185,0.005376344086021506,0.005376344086021506,0.9946236559139785,186,5000,3100,1900,0.62,69,31,38,218.19719042663826,0.42963104233265526,0.7712452306625037,0.1352822580645161,1052188.9637453505,3716.935137430435,1055905.898882781,3730,0,1464.8010752688172,78,108,41,36.0299059139785,0.6164529914529915,41.66666666666668,8145.979074157553,104.43562915586607,0
3733,31.83498558763648,0,0,185,0.0,0.0,1.0,185,5800,4100,1700,0.7068965517241379,75,41,34,236.02999435828502,0.4292437818253036,0.7880949934181869,0.14340964343683235,1056270.5864411723,7062.308111706349,1063332.8945528786,3731,1,1473.6162162162161,66,119,36,36.31719375540666,0.6150568181818181,42.397388059701484,8200.775438456902,124.25417330995306,8
3734,31.480919720757825,4,2,187,0.021164021164021163,0.010582010582010581,0.9894179894179894,189,5200,3700,1500,0.7115384615384616,67,37,30,228.76335790718596,0.4319568745543923,0.7874116273914369,0.14030347121180628,1047282.6944671,4915.981172875723,1052198.6756399756,3732,0,1443.4074074074074,71,118,34,36.15650765606597,0.6157570422535211,42.05729166666666,8120.273693596493,114.37005202248582,0
3735,31.788259639465462,0,0,187,0.0,0.0,1.0,187,4550,3400,1150,0.7472527472527473,57,34,23,241.51749165335994,0.43049805454928797,0.7984897880291217,0.1487088412999178,1058670.619308416,9187.494492495643,1067858.1138009117,3733,1,1459.8288770053475,66,121,37,35.682228915662655,0.619949494949495,41.91542288557215,8204.0595462551,124.30393251901666,8
3736,31.525833517829895,0,0,187,0.0,0.0,1.0,187,5200,3700,1500,0.7115384615384616,67,37,30,244.08637304733196,0.43032914534337685,0.8003355651461528,0.15068980700878176,1050708.558529549,8692.72823625371,1059401.2867658027,3734,2,1460.8288770053475,67,120,38,35.51802737233497,0.6203358208955223,41.81985294117648,8139.344333785328,121.48275125052729,0
3737,31.848145077483977,2,2,187,0.010582010582010581,0.010582010582010581,0.9894179894179894,189,5000,3400,1600,0.68,66,34,32,244.03137928486066,0.43147022402341556,0.8017897082181356,0.15181342011758098,1063710.7716630655,9115.761353820139,1072826.5330168856,3735,0,1446.3597883597884,59,130,39,35.23802926490675,0.6283545197740112,41.54513888888888,8231.30791264762,139.51369343470543,0
3738,32.03078870591976,2,0,189,0.010582010582010581,0.0,1.0,189,5500,3700,1800,0.6727272727272727,73,37,36,237.9784690909207,0.43134357762017334,0.7970535063558313,0.14947186991216257,1072639.4124672615,7753.017053108673,1080392.4295203702,3736,0,1437.4550264550264,62,127,41,35.044909063804404,0.6297043010752688,41.2037037037037,8289.44948454127,133.70079813776243,0
3739,32.16224713469099,0,2,187,0.0,0.010582010582010581,0.9894179894179894,189,5850,4400,1450,0.7521367521367521,73,44,29,236.9862668827949,0.43127439115914296,0.796175848287751,0.1494899531236457,1078311.925037587,7459.023529971742,1085770.9485675588,3737,1,1438.4550264550264,65,124,42,34.914403912963984,0.6293269230769231,41.051136363636374,8328.377347520147,128.12888226954072,0
3740,31.665328218315974,0,1,186,0.0,0.0053475935828877,0.9946524064171123,187,5100,3900,1200,0.7647058823529411,63,39,24,236.94057724659575,0.43064420294021816,0.7941921080230976,0.15003279606782777,1062759.5213310048,7862.170891696866,1070621.6922227016,3738,2,1454.5775401069518,67,120,39,34.77730394765369,0.6295087064676617,40.91605392156863,8203.978188670017,122.4474356517913,0
3741,31.79680734061016,0,1,185,0.0,0.005376344086021506,0.9946236559139785,186,4750,3000,1750,0.631578947368421,65,30,35,238.6131347674337,0.43012084665310474,0.7953823745086581,0.1516929336205705,1068326.6166324653,9033.352590031875,1077359.9692224972,3739,3,1463.3333333333333,68,118,40,34.590540251975256,0.6303615196078431,40.77596618357489,8242.496661316698,121.2131861958338,0
3742,31.644902002264587,0,0,185,0.0,0.0,1.0,185,4350,2800,1550,0.6436781609195402,59,28,31,238.60500541415198,0.42933925773599685,0.7952119057357709,0.15227466541660983,1064337.6638718338,9441.258810125033,1073778.9226819589,3740,4,1472.0648648648648,68,117,41,34.451639503298416,0.6317401960784313,40.6400966183575,8207.418725828904,120.69733420336624,0
3743,31.95638278493013,1,0,186,0.005376344086021506,0.0,1.0,186,6050,3900,2150,0.6446280991735537,82,39,43,232.60744166127088,0.4299937033808001,0.7908620492470098,0.14917411606153327,1076234.5648117964,6818.033749660691,1083052.5985614571,3741,0,1465.1451612903227,59,127,42,34.43185999063482,0.6393008474576272,40.46875000000001,8293.679969651412,140.57084694324428,0
3744,31.57571337884969,1,0,187,0.0053475935828877,0.0,1.0,187,5400,3600,1800,0.6666666666666666,72,36,36,228.5595813434758,0.43047409579667645,0.7881266264405615,0.14738152314217218,1064979.862215464,5882.270289439744,1070862.1325049037,3742,0,1458.3048128342245,62,125,42,34.34157754010694,0.6391129032258065,40.27777777777777,8200.914447006782,132.2728136613997,0
3745,31.67960149400038,0,1,186,0.0,0.0053475935828877,0.9946524064171123,187,5250,3900,1350,0.7428571428571429,66,39,27,227.98724524936145,0.430235706208192,0.7874962186955727,0.14740220315575342,1069242.782549015,6104.743299222311,1075347.5258482373,3743,1,1459.3048128342245,63,124,44,34.262108730606165,0.6393849206349207,40.18554687499999,8230.81833738163,130.64791011716872,0
3746,31.51545430951894,0,0,186,0.0,0.0,1.0,186,5950,4600,1350,0.773109243697479,73,46,27,229.02410845065245,0.42977211082049793,0.7876268343900199,0.14862836391976297,1064768.958904304,5621.552303797473,1070390.5112081016,3744,2,1467.9623655913979,63,123,43,34.101979107966514,0.640707671957672,40.055338541666664,8192.274101193469,130.03609684434076,0
3747,31.801530835270338,0,0,186,0.0,0.0,1.0,186,4900,3300,1600,0.673469387755102,65,33,32,233.1109886584329,0.42990349220187934,0.7902660406885755,0.15156483694824852,1074972.489822939,8017.579976648485,1082990.0697995876,3745,3,1468.9623655913979,63,123,38,33.92912102243089,0.6413690476190477,39.990234375,8268.70857899485,131.2493425237278,0
3748,32.08646038004856,0,0,186,0.0,0.0,1.0,186,5850,4500,1350,0.7692307692307693,72,45,27,235.17549662568578,0.4300167102586458,0.7922148189458642,0.1536610408987091,1086023.8945485977,8031.241749565594,1094055.1362981633,3746,4,1469.9623655913979,65,121,39,33.701281468001206,0.6418269230769231,39.82007575757576,8348.252830888583,128.43465893674744,0
3749,32.01356149709262,1,0,187,0.0053475935828877,0.0,1.0,187,5600,3900,1700,0.6964285714285714,73,39,34,228.49325023185798,0.43003684856151647,0.7846246396889807,0.14204056489356284,1069013.6021501815,5852.478499472281,1074866.080649654,3747,0,1463.096256684492,65,122,38,35.66706363747404,0.6240384615384615,41.571969696969695,8273.201640678575,127.28002524120885,8
3750,32.04719152273553,0,2,185,0.0,0.0106951871657754,0.9893048128342246,187,5650,4300,1350,0.7610619469026548,70,43,27,226.799696970627,0.43010992275698157,0.7834833344259535,0.14168777567858593,1071603.3399692997,5557.862555549591,1077161.2025248492,3748,1,1464.096256684492,68,119,40,35.52977232924693,0.6240808823529411,41.39492753623187,8287.566285997245,121.87597479407714,0
3751,32.06660211371024,1,0,186,0.005376344086021506,0.0,1.0,186,5800,3900,1900,0.6724137931034483,77,39,38,224.23242056506479,0.429789668700959,0.7801992917304656,0.1407808110441307,1073718.6642123095,5152.507016442459,1078871.171228752,3749,0,1472.483870967742,71,115,41,35.41544371144778,0.6242664319248826,41.21817129629627,8298.25393529992,116.8768159901397,0
3752,31.654322375974502,0,1,185,0.0,0.005376344086021506,0.9946236559139785,186,5150,3400,1750,0.6601941747572816,69,34,35,223.68367458388911,0.42967705608834644,0.7801790495017129,0.1410341889853795,1061149.691424041,5122.3724522574885,1066272.0638762985,3750,1,1473.483870967742,72,114,39,35.275450971747624,0.6252893518518519,41.06735159817349,8196.337526176214,113.83802119689186,0
3753,31.612418959578136,0,0,185,0.0,0.0,1.0,185,4600,3200,1400,0.6956521739130435,60,32,28,203.8438598382018,0.4296746474735605,0.7552441767886917,0.12370584091076557,1048531.7942668641,1147.3536212866297,1049679.1478881508,3751,2,1462.5567567567568,73,112,42,37.190693829589556,0.6108732876712328,42.44087837837838,8142.066859563647,111.53516245977599,8
3754,31.819405705310373,2,1,186,0.0106951871657754,0.0053475935828877,0.9946524064171123,187,5200,3800,1400,0.7307692307692307,66,38,28,196.59613306081417,0.4301674237632492,0.7492613631102187,0.12011967001410517,1057419.2683465765,-1023.0921638135455,1056396.176182763,3752,0,1447.903743315508,76,111,43,37.12590299277605,0.6119791666666667,42.19426406926407,8203.225304736206,107.9371750623185,0
3755,31.881863504929363,2,0,188,0.010638297872340425,0.0,1.0,188,5300,3700,1600,0.6981132075471698,69,37,32,194.31253095676988,0.43126943717525695,0.7475518224427009,0.11938923413669472,1061156.4440251458,-1660.8011240775072,1059495.6429010683,3753,0,1441.0744680851064,79,109,39,36.97877239465051,0.6127373417721519,41.99218750000001,8225.769861330427,104.12366913076491,0
3756,31.432799590293055,3,0,191,0.015706806282722512,0.0,1.0,191,5900,4600,1300,0.7796610169491526,72,46,26,192.1516406204384,0.4331829245889593,0.7496418278258226,0.1192782811901434,1049203.8692294694,-3778.751036448945,1045425.1181930205,3754,0,1419.4240837696334,71,120,43,36.65851251469849,0.6201584507042254,41.62326388888891,8121.504164974628,114.38738260527646,0
3757,31.567127248051264,0,0,191,0.0,0.0,1.0,191,5150,3700,1450,0.7184466019417476,66,37,29,195.48237339887123,0.43292918159272525,0.7518426325617573,0.12187713837717686,1054963.3920494737,-2104.6504546488195,1052858.741594825,3755,1,1420.4240837696334,72,119,44,36.4130284799647,0.6212384259259259,41.46689497716896,8161.147424089539,113.34926977902137,0
3758,31.417747324540894,1,0,192,0.005208333333333333,0.0,1.0,192,5650,3800,1850,0.672566371681416,75,38,37,193.80023841254888,0.43365283231529955,0.7493916852057836,0.12159370890629856,1051800.491008919,-3282.1628160069404,1048518.328192912,3756,0,1414.0208333333333,75,117,45,36.22703577166871,0.6220833333333333,41.24177631578949,8129.600489857591,108.39467319810122,0
3759,31.30826696027731,1,0,193,0.0051813471502590676,0.0,1.0,193,5150,3400,1750,0.6601941747572816,69,34,35,193.32292707301565,0.43442132628094415,0.7509049118978559,0.12189717830955211,1049562.2031157718,-3169.1125496908708,1046393.0905660809,3757,0,1407.6891191709844,77,116,37,36.05991154778482,0.6229707792207793,41.06570512820515,8106.784029017381,105.28290946775819,0
3760,31.16343621749932,1,1,193,0.005154639175257732,0.005154639175257732,0.9948453608247423,194,6300,4800,1500,0.7619047619047619,78,48,30,190.34867971643013,0.43458660506027097,0.7481348975520963,0.12076856144074363,1046477.7265122536,-5260.86928114797,1041216.8572311057,3758,0,1401.4278350515465,79,115,40,35.91339873385922,0.6243407172995781,40.846354166666686,8076.118112459537,102.22934319569033,0
3761,31.628156075681122,1,1,193,0.005154639175257732,0.005154639175257732,0.9948453608247423,194,5200,3400,1800,0.6538461538461539,70,34,36,191.00240951250717,0.43480861510246954,0.7486689336701895,0.12181709228908885,1063589.4310758177,-3370.371186496095,1060219.0598893217,3759,0,1400.3453608247423,82,112,43,35.709244741256946,0.625,40.66265060240966,8202.3621630005,100.02880686585975,0
3762,31.299452966592124,1,1,193,0.005154639175257732,0.005154639175257732,0.9948453608247423,194,5250,3200,2050,0.6095238095238096,73,32,41,197.4546044861458,0.4344875629863077,0.7584162622716197,0.12677795636227387,1054441.9594710441,-2409.1159878099957,1052032.843483234,3760,0,1401.3144329896907,73,121,44,35.30255784526388,0.6312785388127854,40.427927927927904,8124.463861260626,111.2940254967209,0
3763,31.537573213906136,0,1,192,0.0,0.0051813471502590676,0.9948186528497409,193,5100,3400,1700,0.6666666666666666,68,34,34,202.73387528460785,0.43365896660909614,0.7627895896611288,0.1303773917625277,1062924.9408749815,-601.8215199506603,1062323.1193550308,3761,1,1409.5440414507773,73,120,44,35.108074893370954,0.6318493150684932,40.37162162162161,8188.048991515797,112.16505467829859,0
3764,32.01741132026521,0,1,191,0.0,0.005208333333333333,0.9947916666666666,192,5100,3800,1300,0.7450980392156863,64,38,26,205.43829472899404,0.43304723858347877,0.7646754128050879,0.1324901075164157,1079916.388170958,871.2362471469905,1080787.624418105,3762,2,1417.84375,73,119,44,34.937300146333506,0.6328481735159817,40.27308558558557,8315.783449749591,113.91484177739166,0
3765,32.44539767094711,0,0,191,0.0,0.0,1.0,191,4800,3700,1100,0.7708333333333334,59,37,22,204.13599247208873,0.4320347662349591,0.7624016653165733,0.13193837468723127,1094993.9104244853,1705.53373107893,1096699.4441555643,3763,3,1426.219895287958,72,119,44,34.893401805166505,0.6341145833333333,40.19691780821916,8429.414317850049,117.07519885902846,0
3766,32.405288301569456,0,0,191,0.0,0.0,1.0,191,4650,3100,1550,0.6666666666666666,62,31,31,205.31104707682442,0.4319865435840911,0.7631524904992935,0.1333678061970266,1095113.9853904676,2117.7998017978744,1097231.7851922654,3764,4,1427.219895287958,75,116,46,34.68429284408826,0.6344444444444444,40.021929824561376,8424.664316120678,112.3288575482757,0
3767,32.82301098124862,0,1,190,0.0,0.005235602094240838,0.9947643979057592,191,5950,4600,1350,0.773109243697479,73,46,27,204.40153082859746,0.4320106549095251,0.7630107776627226,0.1332303953955067,1110238.4981743211,1236.889722334507,1111475.3878966556,3765,5,1428.219895287958,77,114,40,34.587440952967725,0.6347402597402597,39.90384615384613,8537.138913872783,110.87193394639978,0
3768,32.75193385552198,0,0,190,0.0,0.0,1.0,190,5600,4100,1500,0.7321428571428571,71,41,30,208.10250843852162,0.4317512531328321,0.7662724003685115,0.1359049603382773,1108403.2073311,2532.297561380604,1110935.5048924806,3766,6,1436.5631578947368,77,113,40,34.42301687113938,0.6354166666666667,39.837072649572626,8520.838988240108,110.66024660052088,0
3769,32.323858517099424,1,0,191,0.005235602094240838,0.0,1.0,191,4700,3000,1700,0.6382978723404256,64,30,34,208.16085042449816,0.43178446771378703,0.7667801228139968,0.13674317254037488,1095618.010081366,2712.9553437863146,1098330.9654251523,3767,0,1430.0366492146597,80,111,42,34.21498896901443,0.6361979166666667,39.63477366255141,8416.00873890418,105.20010923630225,0
3770,32.32470886738298,1,0,192,0.005208333333333333,0.0,1.0,192,4950,3900,1050,0.7878787878787878,60,39,21,206.35423407502978,0.4323189354275742,0.7646336526004078,0.13633307981259277,1097298.013893327,1936.4182418016576,1099234.4321351286,3768,0,1423.5833333333333,71,121,42,34.061863779381824,0.64231220657277,39.4386574074074,8422.569541399973,118.62774001971793,0
3771,32.26458422664658,0,0,192,0.0,0.0,1.0,192,6000,4500,1500,0.75,75,45,30,207.81504772609895,0.43211214732402564,0.7659681748116536,0.1380372361722645,1096800.3982087548,1186.3254199512612,1097986.723628706,3769,1,1424.5833333333333,72,120,43,33.83646637114869,0.6436631944444444,39.25513698630136,8412.824594370879,116.84478603292888,0
3772,32.40838300753945,0,0,192,0.0,0.0,1.0,192,5000,3200,1800,0.64,68,32,36,207.7433039817344,0.43182525723531123,0.7643277694956154,0.13846113326419238,1102671.2381251303,2414.5132427489834,1105085.7513678793,3770,2,1425.5833333333333,74,118,42,33.71967397863201,0.6438626126126126,39.13888888888889,8454.086800661207,114.24441622515145,0
3773,31.899288230263263,1,0,193,0.0051813471502590676,0.0,1.0,193,5100,3500,1600,0.6862745098039216,67,35,32,207.82147040350574,0.43222982333045484,0.7644233076568387,0.13893394981713664,1086207.7449044278,1447.4581419428405,1087655.2030463705,3771,0,1419.1917098445597,77,116,48,33.61239402623543,0.6435335497835497,39.035790598290596,8324.572533487903,108.11133160373899,0
3774,32.37170935454485,1,2,192,0.005154639175257732,0.010309278350515464,0.9896907216494846,194,5150,3300,1850,0.6407766990291263,70,33,37,209.33642373679507,0.43278159108309744,0.7687766353475323,0.1410365099623725,1104514.1143811245,2293.006934271783,1106807.1213153964,3772,0,1412.8711340206185,80,114,39,33.30471865307931,0.644921875,38.77314814814816,8456.359723750922,105.70449654688653,0
3775,31.938157593425693,0,0,192,0.0,0.0,1.0,192,5750,4100,1650,0.7130434782608696,74,41,33,215.12379806744372,0.43160199425538104,0.7711149700971842,0.1450910590999421,1090023.2260665116,2747.987274631412,1092771.213341143,3773,1,1428.0833333333333,79,113,39,33.11658983304266,0.645701476793249,38.736979166666686,8344.259532709504,105.6235383887279,0
3776,32.1896106702071,0,0,192,0.0,0.0,1.0,192,5600,3400,2200,0.6071428571428571,78,34,44,196.6430529220545,0.431021964986911,0.75739510698449,0.12797937473887455,1088374.8129848754,-1195.7308102371198,1087179.0821746383,3774,2,1429.0833333333333,80,112,37,34.84269653660384,0.6329427083333333,39.956275720164584,8370.706241798516,104.63382802248145,7
3777,32.28367660142161,0,1,191,0.0,0.005208333333333333,0.9947916666666666,192,5300,3400,1900,0.6415094339622641,72,34,38,195.40665433041104,0.430874259198662,0.7561886486421305,0.12767019700358442,1092684.6569657892,-996.4293888286402,1091688.2275769606,3775,3,1430.0833333333333,82,110,40,34.73773173829851,0.6335111788617886,39.82178714859436,8399.50928243057,102.4330400296411,0
3778,32.75120486530311,0,1,190,0.0,0.005235602094240838,0.9947643979057592,191,6750,5100,1650,0.7555555555555555,84,51,33,191.67441054689291,0.4305490493248829,0.7510896905473388,0.12582903611699275,1109907.1100756067,-2401.8417828909837,1107505.2682927158,3776,4,1434.6858638743456,83,108,43,34.66764313613412,0.634789156626506,39.65773809523806,8526.522754739155,102.7291898161344,0
3779,32.24819115480117,0,0,190,0.0,0.0,1.0,190,4850,3700,1150,0.7628865979381443,60,37,23,193.5472328393576,0.4306646245242736,0.7509660900457891,0.12724501873610403,1093284.1229131168,-529.5766605927183,1092754.546252524,3777,5,1442.0,86,104,43,34.56745064680277,0.6342054263565892,39.60727969348657,8397.19421976306,97.64179325305884,0
3780,32.279570164270346,1,0,191,0.005235602094240838,0.0,1.0,191,5150,3800,1350,0.7378640776699029,65,38,27,189.69379323411792,0.43095205290713695,0.7472426260473473,0.12524797900616014,1095586.4139971784,-1784.8114626220631,1093801.6025345563,3778,0,1435.4450261780105,75,116,43,34.51769556525855,0.6401388888888888,39.45997807017544,8410.119918484312,112.1349322464575,0
3781,32.361467719555854,1,1,191,0.005208333333333333,0.005208333333333333,0.9947916666666666,192,5900,4100,1800,0.6949152542372882,77,41,36,189.70642750247808,0.4310003772178592,0.748601246941933,0.12619163189794608,1100510.7969810874,-2545.20565536231,1097965.5913257252,3779,0,1428.9635416666667,79,113,43,34.25829422337608,0.640954641350211,39.205729166666686,8439.685377018075,106.83146046858323,0
3782,32.6756001420314,0,0,191,0.0,0.0,1.0,191,5800,4400,1400,0.7586206896551724,72,44,28,189.50491408339485,0.430880867089189,0.7476501719826891,0.12656532938617815,1112359.4980135763,-1840.4817798176673,1110519.0162337585,3780,1,1437.0209424083769,80,111,42,34.12415804172826,0.6419270833333333,39.06893004115227,8526.079306607757,106.57599133259696,0
3783,32.82487111914246,0,2,189,0.0,0.010471204188481676,0.9895287958115183,191,5500,3600,1900,0.6545454545454545,74,36,38,203.73600567890756,0.4307981996877009,0.7650646455035184,0.13581423227487532,1116893.3661873636,1810.2786392568541,1118703.6448266206,3781,2,1438.0209424083769,73,118,46,33.81808043744156,0.644406392694064,39.1328828828829,8562.929498591659,117.3004040902967,6
3784,32.40488240479486,0,1,188,0.0,0.005291005291005291,0.9947089947089947,189,3500,2500,1000,0.7142857142857143,45,25,20,199.4465903988255,0.4303808304251567,0.7535997664238374,0.13193651975226048,1100386.0934687,2593.6508929231745,1102979.7443616232,3782,3,1443.994708994709,71,118,43,34.19758183904217,0.6427523474178404,39.39525462962964,8444.866127858386,118.94177644870966,8
3785,32.7807116881105,0,0,188,0.0,0.0,1.0,188,4550,3200,1350,0.7032967032967034,59,32,27,200.94790324560546,0.429872686502067,0.7548037069313664,0.133211159701226,1113766.3402031267,2611.8021538700714,1116378.1423569967,3783,4,1452.3510638297873,71,117,43,34.08466533466533,0.6434859154929577,39.32291666666667,8545.180312447566,120.35465228799389,0
3786,32.98210518090444,0,1,187,0.0,0.005319148936170213,0.9946808510638298,188,4850,3600,1250,0.7422680412371134,61,36,25,200.69067927827598,0.42964038855387415,0.7542875705280601,0.1333607808411356,1121314.4827965365,2557.4730474012676,1123871.9558439378,3784,5,1453.3510638297873,72,116,46,34.00767483856846,0.6438078703703703,39.24086757990869,8600.385132360872,119.44979350501211,0
3787,33.18960454407362,1,0,188,0.005319148936170213,0.0,1.0,188,5200,3400,1800,0.6538461538461539,70,34,36,199.75205187031173,0.4294874985777677,0.7531090899823871,0.13329812768681426,1129612.4962148524,2328.482787452537,1131940.979002305,3785,0,1453.159574468085,74,114,42,33.885635702244734,0.6442849099099099,39.097222222222236,8659.260018894796,117.01702728236211,0
3788,32.95576227715206,0,0,188,0.0,0.0,1.0,188,4350,2900,1450,0.6666666666666666,58,29,29,197.48925303086403,0.42933875677930744,0.749469146812757,0.13192282102461741,1121952.2145355174,2364.7009569886545,1124316.915492506,3786,1,1454.159574468085,77,111,46,33.90926480372587,0.643262987012987,39.06250000000001,8599.394219194384,111.68044440512188,0
3789,33.04197767574352,0,0,188,0.0,0.0,1.0,188,5050,3200,1850,0.6336633663366337,69,32,37,197.06594161387164,0.42911001441195434,0.7495501283301385,0.13229873877412007,1126347.2559513738,1742.9365156515714,1128090.1924670255,3787,2,1455.159574468085,79,109,37,33.74770400106384,0.6441191983122363,38.893229166666664,8627.484092860472,109.2086594032971,0
3790,32.56240362113159,0,0,188,0.0,0.0,1.0,188,5100,3600,1500,0.7058823529411765,66,36,30,199.8440671410047,0.42880423445974136,0.7537672333425596,0.13457777210190347,1110885.1859191987,1700.7627361569052,1112585.9486553555,3788,3,1456.159574468085,79,109,39,33.568916886828475,0.6451740506329113,38.78906250000001,8505.655977129201,107.66653135606585,0
3791,32.92004663499947,0,1,187,0.0,0.005319148936170213,0.9946808510638298,188,4150,3000,1150,0.7228915662650602,53,30,23,201.29524914213854,0.42852630655743923,0.7559045098238821,0.13571195829260363,1123422.310205795,3477.9147649426623,1126900.2249707377,3789,4,1457.159574468085,79,109,40,33.491161616161634,0.6455696202531646,38.750000000000014,8600.362183393647,108.86534409359047,0
3792,32.8079004584224,0,0,187,0.0,0.0,1.0,187,5150,3800,1350,0.7378640776699029,65,38,27,203.93188508757285,0.4274672723439327,0.7588778131570859,0.13792038937220472,1120499.2583571633,3151.1051992008643,1123650.363556364,3790,5,1465.8609625668448,80,107,41,33.31467631091213,0.6462239583333333,38.64454732510289,8574.523675623976,107.18154594529969,0
3793,33.1366208183583,0,0,187,0.0,0.0,1.0,187,4600,2900,1700,0.6304347826086957,63,29,34,211.622115139023,0.4274732620320856,0.7623889541034452,0.13699747453736705,1118804.6586115027,5352.76165655158,1124157.4202680544,3791,6,1466.8609625668448,70,117,46,34.6416506699789,0.6357142857142857,40.14084507042252,8610.8542830804,123.01220404400571,8
3794,33.09395640524632,1,0,188,0.005319148936170213,0.0,1.0,188,5900,4100,1800,0.6949152542372882,77,41,36,220.27773713243369,0.42765104107406987,0.7657577409783691,0.13895715898805433,1109564.6093744019,5382.476271045294,1114947.0856454473,3792,0,1460.0531914893618,80,108,40,35.345277115613875,0.621875,41.049382716049394,8569.700439506705,107.12125549383381,8
3795,33.237472453666626,0,1,187,0.0,0.005319148936170213,0.9946808510638298,188,5050,3800,1250,0.7524752475247525,63,38,25,219.0627963617063,0.42723326032540676,0.7651742448347265,0.13870803265436232,1115514.5600435708,6223.547781068795,1121738.1078246397,3793,1,1461.0531914893618,81,107,36,35.241633978916425,0.6228137860082305,40.91717479674798,8611.258265911243,106.31183044334868,0
3796,33.284385148169925,0,0,187,0.0,0.0,1.0,187,4950,3400,1550,0.6868686868686869,65,34,31,222.1727649221448,0.4270132539819447,0.7692902828112758,0.14113365801592398,1118075.1677717513,7331.170282928646,1125406.33805468,3794,2,1469.7860962566845,81,106,36,35.04419068156576,0.6239711934156378,40.802845528455315,8627.217918740665,106.50886319432921,0
3797,32.788894247213335,1,0,188,0.005319148936170213,0.0,1.0,188,4600,3500,1100,0.7608695652173914,57,35,22,220.97306083128,0.4274151875450374,0.7719789809251476,0.1412623164456064,1103322.5375063773,6560.911639383536,1109883.4491457609,3795,0,1462.962765957447,69,119,40,34.84788189066712,0.6317934782608696,40.580357142857125,8506.083235292668,123.27656862742997,0
3798,32.71919117933576,0,0,188,0.0,0.0,1.0,188,5700,4300,1400,0.7543859649122807,71,43,28,219.97907828212666,0.42718466738726435,0.7717812322017703,0.1413662794484887,1102536.6027755425,5206.9971301740325,1107743.5999057165,3796,1,1463.962765957447,72,116,39,34.68595980138877,0.6320891203703703,40.39668949771688,8494.010347112628,117.97236593211983,0
3799,32.38366308595035,0,0,188,0.0,0.0,1.0,188,4500,3200,1300,0.7111111111111111,58,32,26,223.58344402850017,0.42714022262676826,0.7757967032967055,0.14409414593904676,1092070.2254124493,6733.764423738908,1098803.9898361883,3797,2,1464.962765957447,72,116,41,34.49027014652014,0.6331018518518519,40.296803652968016,8410.140812846643,116.8075112895367,0
3800,32.727841537391384,0,1,187,0.0,0.005319148936170213,0.9946808510638298,188,4600,3200,1400,0.6956521739130435,60,32,28,219.93584005892134,0.42727592729548297,0.7720748859626583,0.14218409106716243,1104596.5614380294,6388.074533213461,1110984.6359712428,3798,3,1465.962765957447,73,115,42,34.47444284914483,0.6337043378995434,40.1886261261261,8503.065473756038,116.48034895556216,0
3801,32.41305501776813,0,0,187,0.0,0.0,1.0,187,5050,3500,1550,0.693069306930693,66,35,31,220.8882521007951,0.42693778391121845,0.7700289827158597,0.14323071169802748,1094854.5304752379,5918.1007082621145,1100772.6311835,3799,4,1474.6363636363637,76,111,41,34.34263259251549,0.6333607456140351,40.08387445887444,8424.675677169582,110.85099575223134,0
3802,32.127342520444174,0,0,187,0.0,0.0,1.0,187,4450,3200,1250,0.7191011235955056,57,32,25,219.10734903132416,0.4265867881854599,0.7689448704118966,0.14259960427300847,1086269.441579565,5751.923535646689,1092021.3651152116,3800,5,1475.6363636363637,80,107,36,34.25852661424589,0.6329427083333333,39.956275720164584,8354.513800230152,104.4314225028769,0
3803,32.147172637108206,1,1,187,0.005319148936170213,0.005319148936170213,0.9946808510638298,188,5400,4100,1300,0.7592592592592593,67,41,26,217.77909820973625,0.426796516478932,0.7696523439926746,0.1424621494573479,1088418.9521628586,4406.979575282379,1092825.931738141,3801,0,1468.781914893617,84,104,37,34.112351260556956,0.6331845238095238,39.77941176470586,8365.356173729797,99.58757349678329,0
3804,32.191605863082735,0,0,187,0.0,0.0,1.0,187,5100,3500,1600,0.6862745098039216,67,35,32,220.9789343576927,0.4260129760604144,0.7742551384146743,0.1451189467262973,1091046.76486132,5719.67028669213,1096766.4351480121,3802,1,1477.4598930481284,83,104,37,33.89204770977214,0.6349146586345382,39.645337301587276,8381.23468620308,100.97873115907326,0
3805,32.58470791060078,0,1,186,0.0,0.0053475935828877,0.9946524064171123,187,4700,3300,1400,0.7021276595744681,61,33,28,213.6233539013435,0.42604172656354816,0.7650678949319998,0.14100994922381505,1105864.854163496,5147.711821605129,1111012.5659851013,3803,2,1478.4598930481284,72,115,37,33.90363128491618,0.6414930555555556,39.469178082191775,8489.320733900515,117.90723241528492,0
3806,32.31924948854552,0,0,186,0.0,0.0,1.0,186,4150,2900,1250,0.6987951807228916,54,29,25,210.01455716636488,0.4255521650682941,0.7588587582919608,0.13898764836173183,1097603.2434709438,4752.531824383071,1102355.775295327,3804,3,1486.3655913978494,76,110,38,33.907020503503745,0.6404879385964912,39.380411255411246,8423.029510238479,110.82933566103262,0
3807,32.38538701063561,0,0,186,0.0,0.0,1.0,186,5500,3900,1600,0.7090909090909091,71,39,32,210.78179783374242,0.42534389227937613,0.7591833798273819,0.14015729903765528,1101214.2459317967,3723.183711526423,1104937.4296433232,3805,4,1487.3655913978494,79,107,37,33.72195592836696,0.6408227848101266,39.218749999999986,8445.501706367284,106.90508489072512,0
3808,31.92213176066654,0,0,186,0.0,0.0,1.0,186,4950,3400,1550,0.6868686868686869,65,34,31,209.08021737935087,0.42510716361522816,0.7568732215285512,0.13943376575760494,1086292.7260402367,3274.463859619855,1089567.1898998565,3806,5,1488.3655913978494,82,104,42,33.66446978079247,0.640625,39.11897590361444,8327.8784250624,101.55949298856585,0
3809,32.255273437703494,0,0,186,0.0,0.0,1.0,186,6100,4600,1500,0.7540983606557377,76,46,30,206.99024361796387,0.42480989053569695,0.7560536533344946,0.13875617329994325,1099108.3554630033,2200.9412519650605,1101309.2967149683,3807,6,1489.3655913978494,82,104,34,33.53965354229768,0.6424034552845528,38.94327309236946,8420.456109157452,102.6884891360665,0
3810,31.95577376891134,0,0,186,0.0,0.0,1.0,186,4300,2800,1500,0.6511627906976745,58,28,30,207.99070995263438,0.42506296619199846,0.7587839855985044,0.1399210230590439,1089901.9753820165,3837.8971276964144,1093739.8725097128,3808,7,1490.3655913978494,84,102,36,33.391301457707705,0.6428571428571428,38.82352941176468,8346.096207880306,99.35828818905127,0
3811,31.75622283494966,0,0,186,0.0,0.0,1.0,186,5550,3600,1950,0.6486486486486487,75,36,39,210.42288992682256,0.4248316865252349,0.7624862482919144,0.14181425053967944,1083604.245671266,2853.027382224276,1086457.2730534903,3809,8,1491.3655913978494,84,102,36,33.26521477381119,0.6434771825396826,38.76225490196077,8295.924046233082,98.76100055039383,0
3812,31.986684290508276,0,1,185,0.0,0.005376344086021506,0.9946236559139785,186,5800,4500,1300,0.7758620689655172,71,45,26,211.28986408150087,0.4247390535696987,0.7637480585216516,0.1429734705868513,1092603.2541812803,3171.19861419342,1095774.4527954736,3810,9,1492.3655913978494,85,101,36,33.103895376677926,0.6444852941176471,38.62645348837208,8360.473114157885,98.35850722538689,0
3813,31.670976029875675,0,0,185,0.0,0.0,1.0,185,5100,3700,1400,0.7254901960784313,65,37,28,208.8772193088524,0.4246168723070897,0.7602126101083728,0.1416467099837123,1082420.9499915745,3118.6156311770856,1085539.5656227516,3811,10,1501.1567567567567,85,100,38,33.09276310709597,0.6452205882352942,38.55377906976743,8280.25699618294,97.41478819038753,0
3814,31.28228230854509,0,0,185,0.0,0.0,1.0,185,6000,4300,1700,0.7166666666666667,77,43,34,208.02123100375377,0.4245360849980415,0.7603291958321541,0.14149307879729067,1069965.9990605647,1515.1288513481527,1071481.1279119127,3812,11,1502.1567567567567,69,116,38,33.011635184342296,0.6533816425120773,38.45238095238097,8181.806456175461,118.5769051619632,0
3815,31.745271108405525,0,0,185,0.0,0.0,1.0,185,5100,3600,1500,0.7058823529411765,66,36,30,202.65593635891926,0.4246511457109283,0.753097713097713,0.13840462369259085,1086930.8583227047,1954.598170158465,1088885.4564928631,3813,12,1503.1567567567567,73,112,38,33.01326878249956,0.6526826484018264,38.316441441441455,8307.215511053786,113.79747275416145,0
3816,31.653363930713155,0,0,185,0.0,0.0,1.0,185,4300,3000,1300,0.6976744186046512,56,30,26,202.31690335906475,0.4245801508029769,0.7527138216463303,0.1384645866014657,1084367.1068046526,2577.159030629268,1086944.265835282,3814,13,1504.1567567567567,73,112,42,32.95033387111231,0.6533961187214612,38.24605855855857,8285.392768744558,113.49853107869257,0
3817,31.82797194463719,0,0,185,0.0,0.0,1.0,185,3950,2500,1450,0.6329113924050633,54,25,29,202.58596713254266,0.42463156090873483,0.7531856507719841,0.13892135563534297,1090894.5319896496,3249.9847605453347,1094144.516750195,3815,14,1505.1567567567567,74,111,39,32.87646101886726,0.6535754504504505,38.18055555555557,8333.181932338313,112.61056665322045,0
3818,32.259598107524546,0,1,184,0.0,0.005405405405405406,0.9945945945945946,185,4700,3000,1700,0.6382978723404256,64,30,34,200.8148832000159,0.4244479533881708,0.751163553675064,0.13825554926940603,1106806.191151578,2752.631200231865,1109558.8223518098,3816,15,1506.1567567567567,75,110,40,32.7878645179294,0.6544444444444444,38.048245614035096,8450.458320052232,112.67277760069642,0
3819,32.05671786689088,0,0,184,0.0,0.0,1.0,184,4650,3500,1150,0.7526881720430108,58,35,23,202.3450324818577,0.4238845826403738,0.7521913070763011,0.13988581746630813,1100996.7484518266,3106.2445655809042,1104102.9930174076,3817,16,1514.8858695652175,75,109,36,32.60794721612103,0.6558333333333333,37.911184210526315,8401.707223830694,112.02276298440925,0
3820,32.47579086316115,0,0,184,0.0,0.0,1.0,184,5350,3700,1650,0.6915887850467289,70,37,33,203.24768547362444,0.4235275847390512,0.7541750796428413,0.1408776875707742,1116126.3707000108,3220.0203081708178,1119346.3910081817,3818,17,1515.8858695652175,76,108,36,32.49602253181973,0.65625,37.82467532467533,8514.351013637235,112.03093438996362,0
3821,32.55688551159588,0,0,184,0.0,0.0,1.0,184,4700,3500,1200,0.7446808510638298,59,35,24,200.7499960878626,0.4230388007840342,0.7517370977189866,0.1396265357405515,1119884.1785939897,3463.3488943206685,1123347.5274883104,3819,18,1516.8858695652175,78,106,37,32.44551829881359,0.656517094017094,37.71097046413503,8539.313905546771,109.47838340444578,0
3822,32.99390855782304,0,1,183,0.0,0.005434782608695652,0.9945652173913043,184,4900,3400,1500,0.6938775510204082,64,34,30,200.61355406132296,0.4225803338085056,0.7524025553386802,0.1399903884085926,1135852.391194943,3873.4770173340585,1139725.868212277,3820,19,1517.8858695652175,80,104,39,32.3388387897798,0.6567708333333333,37.60288065843623,8657.506561391765,108.21883201739706,0
3823,33.13609893040392,0,0,183,0.0,0.0,1.0,183,5400,3900,1500,0.7222222222222222,69,39,30,201.9544519629379,0.4223663403991273,0.7535101791890597,0.14125873007644657,1141421.1776426467,4103.017677942438,1145524.1953205892,3821,20,1526.6502732240438,81,102,41,32.22461523569839,0.6571502057613169,37.525406504065046,8697.38409679887,107.3751123061589,0
3824,33.27169466376647,0,0,183,0.0,0.0,1.0,183,4450,2800,1650,0.6292134831460674,61,28,33,201.63048375294377,0.4220773534298124,0.7539951593071588,0.14145749775485822,1146954.6298752767,5202.203372886124,1152156.8332481629,3822,21,1527.6502732240438,70,113,42,32.132363897114985,0.6632440476190475,37.426643192488264,8736.26055453974,124.80372220771058,0
3825,33.23244150671201,0,0,183,0.0,0.0,1.0,183,4750,3300,1450,0.6947368421052632,62,33,29,204.90537945605328,0.42174082747853237,0.7576723321759158,0.1443239674229253,1146729.0588017465,5644.190585410876,1152373.2493871574,3823,22,1528.6502732240438,71,112,40,31.914537210412306,0.6640258215962441,37.2974537037037,8730.247003455966,122.96122540078827,0
3826,33.62001274069271,0,1,182,0.0,0.00546448087431694,0.994535519125683,183,4800,3500,1300,0.7291666666666666,61,35,26,200.29707385531253,0.4216757741347905,0.7520473145431983,0.1416034330159996,1161173.538658058,5115.932406285594,1166289.4710643436,3824,23,1529.6502732240438,73,110,43,31.91195570671095,0.6642408675799087,37.176238738738746,8836.138202160402,121.04298907069044,0
3827,33.747694750968634,0,0,182,0.0,0.0,1.0,182,4800,3700,1100,0.7708333333333334,59,37,22,196.83379993397395,0.4213270040272803,0.7459837542104446,0.13982868644660224,1166976.4698990583,4740.08260075322,1171716.5524998116,3825,24,1537.9285714285713,77,105,42,31.84288035750555,0.663961038961039,37.01923076923077,8874.994725374923,115.25967175811589,0
3828,33.50537857003117,0,0,182,0.0,0.0,1.0,182,4100,2800,1300,0.6829268292682927,54,28,26,195.08751773290382,0.4212213891081294,0.7439425551680543,0.13898265896599407,1159409.3896635692,4737.259973137409,1164146.6496367066,3826,25,1538.9285714285713,79,103,45,31.7948591038078,0.6640295358649789,36.927083333333336,8814.357664438934,111.57414765112574,0
3829,33.537828270614746,0,1,181,0.0,0.005494505494505495,0.9945054945054945,182,5600,4000,1600,0.7142857142857143,72,40,32,197.1148768532752,0.4212049460668245,0.7464405344582994,0.14069736592483617,1161081.5229872477,3773.288284048933,1164854.8112712966,3827,26,1539.9285714285713,81,101,45,31.678051881175364,0.6638374485596708,36.864837398373986,8824.981895293631,108.95039376905717,0
3830,33.58486816240366,0,0,181,0.0,0.0,1.0,181,4800,3700,1100,0.7708333333333334,59,37,22,197.75359011105297,0.4211325966850829,0.7462246074724448,0.1415591740269359,1163529.847848782,5018.440922692712,1168548.2887714747,3828,27,1547.6298342541436,82,99,41,31.56666189885886,0.6643800813008129,36.77208835341365,8840.474709315435,107.8106671867736,0
3831,33.186085530911775,0,0,181,0.0,0.0,1.0,181,4250,3200,1050,0.7529411764705882,53,32,21,198.68524105574036,0.4210315633312871,0.7472030688537721,0.1425955251010475,1150444.8095225384,5265.280860262011,1155710.0903828004,3829,28,1548.6298342541436,85,96,41,31.456857491144923,0.6640931372549019,36.688468992248055,8738.278989298566,102.80328222704195,0
3832,33.22964882089038,0,0,181,0.0,0.0,1.0,181,5150,3300,1850,0.6407766990291263,70,33,37,197.37316582958016,0.42061336198076527,0.7459435137565313,0.14188547872511517,1152415.0931232485,4141.163055905043,1156556.2561791537,3830,29,1549.6298342541436,87,94,41,31.437789338846684,0.6639128352490422,36.63589015151514,8751.496882291522,100.59191818725887,0
3833,32.97910956908244,0,0,181,0.0,0.0,1.0,181,4250,3100,1150,0.7294117647058823,54,31,23,217.92450592024701,0.42023096992019643,0.7696117120881498,0.1472179959207958,1126020.1023887517,8627.474893866976,1134647.5772826187,3831,30,1550.6298342541436,73,108,40,32.98768225238814,0.648972602739726,38.682432432432435,8618.020693136923,118.05507798817703,8
3834,33.26621118850715,0,1,180,0.0,0.0055248618784530384,0.994475138121547,181,4950,3700,1250,0.7474747474747475,62,37,25,217.3633461590995,0.4197104563126663,0.7692145460508006,0.1471542908981249,1136450.7675108206,8254.548314245687,1144705.3158250663,3832,31,1551.6298342541436,75,106,40,32.92854115323443,0.6487499999999999,38.61019736842105,8695.448376864293,115.93931169152391,0
3835,32.74360955125821,1,0,181,0.0055248618784530384,0.0,1.0,181,4250,3100,1150,0.7294117647058823,54,31,23,217.06529833357087,0.419743707796194,0.7690419320822601,0.14760991446983285,1119880.9183089412,8167.45712616072,1128048.3754351018,3833,0,1547.4088397790056,63,118,43,32.78316686373349,0.6569113756613756,38.460286458333336,8563.754262356257,135.9326073389882,0
3836,32.908236414242616,0,1,180,0.0,0.0055248618784530384,0.994475138121547,181,6200,4800,1400,0.7741935483870968,76,48,28,217.79400646308406,0.41965290566809904,0.770302468198063,0.14900560244157562,1127256.7745142484,6701.953846822367,1133958.7283610706,3834,1,1548.4088397790056,65,116,43,32.556982633863946,0.6576923076923077,38.257575757575765,8613.481576606702,132.51510117856466,0
3837,32.63837847992726,0,0,180,0.0,0.0,1.0,180,4900,3900,1000,0.7959183673469388,59,39,20,217.56803981660224,0.41961255948686116,0.768397639611887,0.1495681856350808,1119381.4624789516,7808.3261197175325,1127189.788598669,3835,2,1550.6722222222222,67,113,43,32.39926351601647,0.6581156716417911,38.097426470588246,8548.075319719946,127.58321372716338,0
3838,32.531458072336235,0,0,180,0.0,0.0,1.0,180,5500,4100,1400,0.7454545454545455,69,41,28,215.95615483446173,0.4195032847092903,0.7668996415770597,0.14924358471044066,1117203.6024529794,6753.398830591016,1123957.0012835704,3836,3,1551.6722222222222,68,112,45,32.2629848310292,0.6593137254901961,37.922705314009676,8525.756523788637,125.37877240865643,0
3839,32.053241395893565,0,0,180,0.0,0.0,1.0,180,4150,3100,1050,0.7469879518072289,52,31,21,215.07503225428485,0.4194922925719015,0.7658198505061964,0.14886234550723934,1101206.3512246201,7218.3983016519105,1108424.749526272,3837,4,1552.6722222222222,69,111,42,32.23430551613209,0.6592693236714976,37.872023809523824,8402.051297450409,121.76885938333926,0
3840,31.766017196573543,0,0,180,0.0,0.0,1.0,180,5000,3200,1800,0.64,68,32,36,216.64719904875136,0.4192226619077178,0.7679831417624523,0.15039182239596416,1092147.6171143588,6322.144439118849,1098469.7615534777,3838,5,1553.6722222222222,71,109,42,32.09385057471266,0.6591842723004695,37.77488425925927,8329.847535993873,117.32179628160384,0
3841,32.239167896469894,0,0,180,0.0,0.0,1.0,180,4350,3100,1250,0.7126436781609196,56,31,25,213.9560096711196,0.4191748137802607,0.7652075656207877,0.1488743944813914,1109072.929575775,7108.563689258523,1116181.4932650335,3839,6,1554.6722222222222,73,107,42,32.08494329362098,0.6589611872146119,37.69707207207209,8456.42813320415,115.84148127676917,0
3842,32.15447862104403,0,0,180,0.0,0.0,1.0,180,4800,3000,1800,0.625,66,30,36,214.10815677430563,0.4190681253879578,0.7651551592823542,0.1498139403495087,1107708.0892446833,6633.867446433753,1114341.956691117,3840,7,1555.6722222222222,76,104,44,31.893478671683077,0.6594024122807017,37.51352813852816,8440.115647783023,111.05415326030293,0
3843,31.832356535704903,0,0,180,0.0,0.0,1.0,180,4200,2600,1600,0.6190476190476191,58,26,32,211.85072815660357,0.4186536571487689,0.7616221723937471,0.1486373422681646,1097354.9856859457,6295.090552769339,1103650.076238715,3841,8,1556.6722222222222,68,112,43,31.861836179305833,0.6643688725490196,37.42451690821255,8358.396395312719,122.91759404871645,0
3844,31.72001024908901,1,1,180,0.0055248618784530384,0.0055248618784530384,0.994475138121547,181,4350,3100,1250,0.7126436781609196,56,31,25,209.5420120804402,0.41866175567833025,0.7594094130428786,0.1477505497321186,1094836.8778469735,5332.864456784329,1100169.742303758,3842,0,1549.0662983425414,69,112,44,31.756437849267467,0.6654589371980677,37.26190476190476,8334.055073778502,120.7834068663551,0
3845,31.557747715532045,0,0,180,0.0,0.0,1.0,180,5150,3400,1750,0.6601941747572816,69,34,35,208.66336625097617,0.41760423132629837,0.7568040303407675,0.14780461219686214,1090470.4725372212,4358.247919381771,1094828.720456603,3843,1,1557.888888888889,69,111,44,31.627608589003337,0.6669685990338164,37.113095238095234,8296.118618193283,120.23360316222148,0
3846,31.356342963158138,0,0,180,0.0,0.0,1.0,180,5350,4500,850,0.8411214953271028,62,45,17,207.4376126086718,0.4173468859921374,0.7552109899252997,0.14731667679249352,1084203.397916805,3630.912889214269,1087834.3108060192,3844,2,1558.888888888889,72,108,43,31.574104219798528,0.6662326388888888,37.02910958904109,8245.805429053089,114.52507540351513,0
3847,30.956605883902455,0,1,179,0.0,0.005555555555555556,0.9944444444444445,180,4050,2700,1350,0.6666666666666666,54,27,27,206.12423738232755,0.4166815383819574,0.7542342197727707,0.14686450142730978,1071246.8674099203,4111.988718615639,1075358.856128536,3845,3,1559.888888888889,73,107,41,31.500202882265864,0.6668093607305936,36.922860360360374,8143.97532888873,111.56130587518808,0
3848,31.30227873252863,0,0,179,0.0,0.0,1.0,179,4800,3800,1000,0.7916666666666666,58,38,20,240.51323769235626,0.4162599648484087,0.7790297223176088,0.16353733566939488,1070555.3950806858,10896.548839975225,1081451.943920661,3846,4,1569.268156424581,66,113,35,32.17364165973132,0.6549873737373737,38.46393034825872,8186.674950848855,124.04052955831598,8
3849,31.24411144288175,0,0,179,0.0,0.0,1.0,179,4750,3500,1250,0.7368421052631579,60,35,25,237.49713632820996,0.41620504048710066,0.7758391333522567,0.16229604308124573,1069934.068857893,10271.255482747973,1080205.324340641,3847,5,1570.268156424581,67,112,37,32.081187075626346,0.6560945273631841,38.29656862745099,8176.691174788489,122.0401667878879,0
3850,31.223621244318217,0,0,179,0.0,0.0,1.0,179,5400,3900,1500,0.7222222222222222,69,39,30,237.04610643162223,0.4161684242462285,0.7765907454855527,0.16270537063935508,1070437.3033066583,9548.598985601928,1079985.9022922602,3848,6,1571.268156424581,68,111,37,31.94208225233016,0.657015931372549,38.149154589371996,8175.931619606003,120.23428852361769,0
3851,30.838319977412258,0,0,179,0.0,0.0,1.0,179,4900,3300,1600,0.673469387755102,65,33,32,237.75754298547076,0.4158336471868265,0.7782197676575819,0.16386092030457583,1058323.7649024413,9624.891605267581,1067948.6565077088,3849,7,1572.268156424581,70,109,40,31.784570943234208,0.6572916666666666,38.01349765258217,8079.223589152758,115.4174798450394,0
3852,31.300904536331384,0,2,177,0.0,0.0111731843575419,0.9888268156424581,179,4200,3200,1000,0.7619047619047619,52,32,20,237.28303387909423,0.41560218023559936,0.7776327468281725,0.1639842436808086,1074946.9671872926,11013.335526666488,1085960.302713959,3850,8,1573.268156424581,73,106,36,31.703638056361218,0.6566780821917808,37.922297297297305,8203.269153398353,112.37355004655278,0
3853,30.900283632709794,0,0,177,0.0,0.0,1.0,177,5300,3800,1500,0.7169811320754716,68,38,30,239.17146561354537,0.4154227657935285,0.7767939603867349,0.1658735829482927,1062134.3167735948,10106.444244236709,1072240.7610178315,3851,9,1580.6214689265537,74,103,38,31.53461260020485,0.6573761261261262,37.80555555555557,8101.882700254139,109.48490135478566,0
3854,30.739602248767415,0,1,176,0.0,0.005649717514124294,0.9943502824858758,177,4500,2800,1700,0.6222222222222222,62,28,34,238.38201914271536,0.415192711008389,0.7779335147210664,0.16594485686417276,1057604.9314711972,10522.799803879567,1068127.7312750767,3852,10,1581.6214689265537,79,98,38,31.429109169727656,0.6563818565400844,37.68229166666668,8063.542016974878,102.07015211360604,0
3855,30.856854690819343,0,0,176,0.0,0.0,1.0,176,4150,2800,1350,0.6746987951807228,55,28,27,237.50346505766862,0.4140699404761905,0.7771686423628967,0.16585740938226803,1062482.3593469434,11118.648381509258,1073601.0077284528,3853,11,1590.5681818181818,79,97,39,31.345514538056968,0.6574367088607596,37.578125,8097.5136645673565,102.50017296920704,0
3856,31.236048978403232,0,0,176,0.0,0.0,1.0,176,5500,3900,1600,0.7090909090909091,71,39,32,236.44218320804703,0.4140137987012987,0.7777538165398181,0.16615842617553483,1077230.9698523385,10240.56846624174,1087471.5383185802,3854,12,1591.5681818181818,64,112,40,31.1621562525425,0.6673177083333333,37.37179487179487,8203.467478494742,128.17917935148034,0
3857,31.178685846437926,0,0,176,0.0,0.0,1.0,176,4950,3300,1650,0.6666666666666666,66,33,33,231.8688283157068,0.4136059253246753,0.7737422327815786,0.16396573115257718,1076923.1308876215,9790.98090899904,1086714.1117966205,3855,13,1592.5681818181818,68,108,40,31.0736166953858,0.6669730392156863,37.16787439613526,8194.7602745544,120.51118050815296,0
3858,31.49929267474867,0,1,175,0.0,0.005681818181818182,0.9943181818181818,176,4750,3700,1050,0.7789473684210526,58,37,21,234.05104970100038,0.41343005952380957,0.7761579743552807,0.165939564450934,1088697.0373846018,11012.13688124705,1099709.174265849,3856,14,1593.5681818181818,69,107,40,30.929741151611196,0.6672705314009661,37.083333333333336,8281.689032402675,120.02447873047356,0
3859,32.017405667925296,0,1,174,0.0,0.005714285714285714,0.9942857142857143,175,5250,4000,1250,0.7619047619047619,65,40,25,233.48585189968546,0.4128598795840175,0.7752288268481542,0.1659947283376931,1107356.0893758205,11460.395976843682,1118816.4853526643,3857,15,1603.5428571428572,69,106,41,30.853230734412143,0.6681763285024155,36.99404761904763,8420.768270460014,122.04011986173933,0
3860,31.837394834085504,0,0,174,0.0,0.0,1.0,174,4550,2900,1650,0.6373626373626373,62,29,33,235.341692105836,0.4127425088034018,0.7754191440973697,0.16773240154379368,1101807.7545166495,12510.260264656004,1114318.0147813056,3858,16,1612.816091954023,70,104,42,30.721614989962085,0.668452380952381,36.913145539906104,8376.000061103596,119.65714373005137,0
3861,31.75372550188887,0,0,174,0.0,0.0,1.0,174,4700,3600,1100,0.7659574468085106,58,36,22,233.71165401996547,0.4125390339512325,0.7740475527091064,0.16720079125384282,1099932.0849844138,11913.389378267217,1111845.474362681,3859,17,1613.816091954023,71,103,38,30.6395889444658,0.6691607981220657,36.791087962962955,8357.863542474872,117.7163879221813,0
3862,32.00697837872206,0,0,174,0.0,0.0,1.0,174,4250,2800,1450,0.6588235294117647,57,28,29,231.17509418996633,0.4124317597944766,0.7714412983210286,0.1657024276536472,1109223.9431805327,12234.989908505117,1121458.933089038,3860,18,1614.816091954023,72,102,39,30.64329268292681,0.6692708333333333,36.72945205479452,8426.494735836503,117.03464910884031,0
3863,31.890779568676955,0,0,174,0.0,0.0,1.0,174,4650,3300,1350,0.7096774193548387,60,33,27,231.4738810715416,0.4123874659491064,0.7648701224835162,0.151392335452827,1079684.481516552,10533.751453870183,1090218.2329704221,3861,19,1615.816091954023,71,103,35,33.76260239445495,0.6387910798122065,39.785879629629626,8298.431153388643,116.87931201955836,8
3864,31.815852593985856,0,0,174,0.0,0.0,1.0,174,4700,3300,1400,0.7021276595744681,61,33,28,231.08356210219532,0.41236324275241953,0.763844197533923,0.15161601736984426,1078050.8946152949,10323.96817103194,1088374.8627863268,3862,20,1616.816091954023,77,97,36,33.661175379195946,0.6370400432900433,39.676816239316224,8282.404041326967,107.56368884840217,0
3865,32.292031602137975,0,0,174,0.0,0.0,1.0,174,5350,3800,1550,0.7102803738317757,69,38,31,228.79999999999973,0.4123625506610857,0.7616091954022994,0.15052631578947379,1094971.774703574,9955.908410435673,1104927.6831140097,3863,21,1617.816091954023,73,101,38,33.62500000000002,0.6398401826484018,39.58333333333334,8409.38322972345,115.19703054415685,0
3866,31.906602514218488,0,0,174,0.0,0.0,1.0,174,3950,2800,1150,0.7088607594936709,51,28,23,233.8609953964962,0.4122891889796913,0.7661547896378864,0.15427459995526355,1082677.716395876,11889.217689989033,1094566.934085865,3864,22,1618.816091954023,66,108,38,33.397738123657234,0.6445707070707071,39.49004975124379,8311.987433585908,125.93920353918043,0
3867,31.707432536574434,0,0,174,0.0,0.0,1.0,174,5100,4000,1100,0.7843137254901961,62,40,22,233.70481997735413,0.4120116603547937,0.7645752301654378,0.154648778773813,1076793.9181396873,10430.38575830919,1087224.3038979964,3865,23,1619.816091954023,67,107,38,33.293474108035035,0.6450559701492538,39.384191176470594,8263.458176236853,123.33519666025153,0
3868,31.30105618524228,0,0,174,0.0,0.0,1.0,174,4500,3200,1300,0.7111111111111111,58,32,26,232.93017435874023,0.4116566175004983,0.7620756211355812,0.154600465456397,1063831.9370227912,10259.71171582312,1074091.6487386143,3866,24,1620.816091954023,68,106,37,33.208478093032234,0.6455269607843137,39.28140096618358,8160.767516895158,120.0112870131641,0
3869,31.35594189149439,0,0,174,0.0,0.0,1.0,174,4750,3700,1050,0.7789473684210526,58,37,21,217.62922608556335,0.41152858060372516,0.7565808235122939,0.14471977155521434,1066227.5760294774,6858.4564404761695,1073086.0324699536,3867,25,1621.816091954023,70,104,39,33.5411392405063,0.6450892857142857,39.216549295774634,8177.110726545056,116.81586752207224,8
3870,31.661620199645203,0,0,174,0.0,0.0,1.0,174,4500,3400,1100,0.7555555555555555,56,34,22,214.8973600316314,0.4111479303700751,0.7526217465409322,0.1432545998599352,1077312.7923449785,7002.335000648265,1084315.1273456267,3868,26,1622.816091954023,73,101,42,33.52691740412983,0.644406392694064,39.13288288288289,8259.475584738537,113.14350116080188,0
3871,31.45021557478854,0,0,174,0.0,0.0,1.0,174,4200,3100,1100,0.7380952380952381,53,31,22,214.88818002352548,0.4108171107124665,0.7524316855279625,0.14371920744039163,1071034.5639494176,7030.533637876167,1078065.0975872937,3869,27,1623.816091954023,75,99,42,33.413259545191956,0.6445833333333333,39.02138157894737,8207.833809752588,109.43778413003452,0
3872,31.613269467972124,0,0,174,0.0,0.0,1.0,174,4600,3300,1300,0.717391304347826,59,33,26,211.08300525877826,0.4108074214337918,0.7473928675496615,0.14169036169946886,1077608.1845721332,6092.954818188463,1083701.1393903217,3870,28,1624.816091954023,78,96,37,33.38625307208027,0.6444978632478633,38.89767932489452,8254.298022214987,105.82433361814086,0
3873,31.96660212859977,1,0,175,0.005714285714285714,0.0,1.0,175,4600,3000,1600,0.6521739130434783,62,30,32,208.54759613210751,0.41172961138478376,0.7462218135404792,0.1406851541243753,1091052.9742724046,5907.295007459329,1096960.269279864,3871,0,1616.5257142857142,82,93,40,33.2811949594902,0.6445630081300813,38.729919678714865,8351.916705737842,101.85264275290051,0
3874,31.99632441139684,0,0,175,0.0,0.0,1.0,175,4200,2800,1400,0.6666666666666666,56,28,28,206.99811970301315,0.41153119868637106,0.7450699814964192,0.14006097492713984,1092915.6594697076,6046.297300841565,1098961.9567705493,3872,1,1617.5257142857142,83,92,41,33.21813074283186,0.6452058232931727,38.62847222222222,8362.928194680195,100.75817102024331,0
3875,31.52717079310887,0,1,174,0.0,0.005714285714285714,0.9942857142857143,175,5200,3600,1600,0.6923076923076923,68,36,32,211.50682667309457,0.41119047619047616,0.7500253704801412,0.14366726389012316,1077963.7506476466,5399.338433622038,1083363.0890812688,3873,2,1618.5257142857142,71,104,41,32.96732365145226,0.6518485915492958,38.49826388888888,8244.409897069469,116.11844925449955,0
3876,31.390525083314515,0,0,174,0.0,0.0,1.0,174,4750,3800,950,0.8,57,38,19,210.4156881331074,0.4109140034992138,0.7474446050230388,0.14352280349835128,1074437.7954111414,5665.713615530872,1080103.5090266722,3874,3,1627.5747126436781,73,101,42,32.85332714621332,0.6522545662100456,38.358671171171174,8213.058695433097,112.50765336209723,0
3877,31.747099106094005,0,1,173,0.0,0.005747126436781609,0.9942528735632183,174,4250,2900,1350,0.6823529411764706,56,29,27,207.07121847506608,0.41070776028170886,0.743457863554692,0.1417016769564665,1087545.4926247543,5989.874060974674,1093535.366685729,3875,4,1628.5747126436781,74,100,43,32.82991085641516,0.6528716216216216,38.24999999999999,8309.80319102009,112.2946377164877,0
3878,32.221641257154936,0,0,173,0.0,0.0,1.0,173,4600,3400,1200,0.7391304347826086,58,34,24,205.95066312211043,0.41004195232334095,0.7407781213430684,0.1415098985222347,1104946.3160720207,6312.885301873059,1111259.2013738938,3876,5,1637.971098265896,77,96,41,32.72076321604622,0.6528679653679654,38.11431623931623,8438.386552521459,109.58943574703193,0
3879,31.98642153270703,0,1,172,0.0,0.005780346820809248,0.9942196531791907,173,4750,3300,1450,0.6947368421052632,62,33,29,195.3789868236795,0.41010636510283643,0.7283329276747221,0.13071349839432012,1089386.5492665998,3218.6480510105443,1092605.1973176103,3877,6,1638.971098265896,79,94,45,33.91122863034657,0.6429324894514767,39.010416666666664,8348.122828145568,105.67244086260213,7
3880,32.05162616958322,0,0,172,0.0,0.0,1.0,172,4200,3400,800,0.8095238095238095,50,34,16,192.02390350774408,0.40936168343986584,0.7211647360424314,0.12872346815548094,1092169.0122145142,3344.511403125442,1095513.5236176397,3878,7,1648.8081395348838,82,90,36,33.930359918593666,0.6424034552845528,38.943273092369466,8367.29261989832,102.04015390119903,0
3881,32.324153532411565,0,0,172,0.0,0.0,1.0,172,4600,3100,1500,0.6739130434782609,61,31,30,190.10673279687492,0.4092370177705245,0.718624913457367,0.12787728838821394,1102437.8191327336,2916.1703814071757,1105353.9895141409,3879,8,1649.8081395348838,83,89,38,33.861808160422925,0.6431977911646587,38.82688492063492,8442.199870363576,101.71325145016357,0
3882,32.3180160373783,0,1,171,0.0,0.005813953488372093,0.9941860465116279,172,5300,3800,1500,0.7169811320754716,68,38,30,189.49374816375357,0.4090223944875108,0.7193647923056863,0.1281785610619894,1103818.5936623418,2133.3445211839717,1105951.9381835258,3880,9,1650.8081395348838,85,87,39,33.685930114004975,0.6443627450980391,38.63856589147286,8446.683019071548,99.37274140084175,0
3883,31.956529326172646,0,0,171,0.0,0.0,1.0,171,4250,2600,1650,0.611764705882353,59,26,33,193.4274402156664,0.408875128998968,0.7228570917610033,0.1310279665641713,1091876.7498967834,3789.784952707048,1095666.5348494905,3881,10,1651.06432748538,85,86,39,33.53373181354831,0.6448529411764705,38.590116279069754,8353.752615279254,98.2794425326971,0
3884,32.07364363216496,0,0,171,0.0,0.0,1.0,171,4300,3000,1300,0.6976744186046512,56,30,26,193.47684584779705,0.40883929595229906,0.7240175857184172,0.13163651675935245,1097110.9885602766,3953.114722320162,1101064.1032825967,3882,11,1652.06432748538,73,98,40,33.38261082108961,0.651398401826484,38.44313063063063,8389.081817697868,114.91892900955983,0
3885,32.172288995889154,0,1,170,0.0,0.005847953216374269,0.9941520467836258,171,4650,3500,1150,0.7526881720430108,58,35,23,191.75265116547465,0.40839209952987043,0.7218814639453852,0.1307378860807593,1101077.5950950973,3376.909599677854,1104454.5046947752,3883,12,1653.06432748538,73,98,41,33.355975824097,0.6521118721461188,38.37274774774774,8417.14756865982,115.30339135150439,0
3886,32.27658240067821,0,0,170,0.0,0.0,1.0,170,4350,2500,1850,0.5747126436781609,62,25,37,189.94734869031447,0.4078953474881077,0.7174682897761135,0.12995407717327456,1105619.7515824602,3651.9080945464916,1109271.6596770068,3884,13,1646.1470588235295,76,94,45,33.28584780511336,0.6518640350877193,38.25757575757576,8448.150923813879,111.15988057649841,0
3887,32.4508767611842,0,1,169,0.0,0.0058823529411764705,0.9941176470588236,170,4300,3000,1300,0.6976744186046512,56,30,26,189.17760048010473,0.40777497389488343,0.7156752144854717,0.12970685204188387,1112201.0969850207,3780.706955793291,1115981.803940814,3885,14,1647.1470588235295,78,92,44,33.23271303384368,0.6517094017094017,38.18565400843882,8496.105076082187,108.92442405233574,0
3888,32.03114014879129,0,0,169,0.0,0.0,1.0,169,5050,3900,1150,0.7722772277227723,62,39,23,195.0806487129396,0.40709824363670516,0.7153879348457324,0.12337549472605282,1074677.6169500647,3079.761334379361,1077757.378284444,3886,44,1657.810650887574,80,89,38,35.905980572241795,0.6227864583333333,40.95936213991773,8297.366975528674,103.71708719410842,8
3889,32.35395636794369,0,0,169,0.0,0.0,1.0,169,4250,3000,1250,0.7058823529411765,55,30,25,196.72372038514968,0.4069397482859021,0.7159725608067098,0.1248323676384907,1086501.0257373624,4698.104797067482,1091199.13053443,3887,45,1658.810650887574,81,88,42,35.74268213976437,0.6235853909465021,40.84095528455288,8384.82042508163,103.51630154421767,0
3890,32.68593883056433,0,1,168,0.0,0.005917159763313609,0.9940828402366864,169,5250,4300,950,0.819047619047619,62,43,19,197.89278574117296,0.40696469662815815,0.7181751484754866,0.12600318362908336,1098667.740469293,4433.683953085954,1103101.424422379,3888,46,1659.810650887574,86,83,45,35.58983683521901,0.6229408914728682,40.72078544061305,8474.784547124946,98.54400636191798,0
3891,32.7875558953602,0,0,168,0.0,0.0,1.0,168,4650,3400,1250,0.7311827956989247,59,34,25,197.9049670351151,0.4064133637486931,0.7162061012314069,0.12645744800461622,1103140.5304371621,5413.398062252831,1108553.928499415,3889,47,1669.6666666666667,72,96,46,35.462736307461,0.6300636574074074,40.59646118721459,8505.208028278377,118.12788928164413,0
3892,32.38150365080134,0,0,168,0.0,0.0,1.0,168,4050,2300,1750,0.5679012345679012,58,23,35,198.24229406437613,0.40624554462503565,0.7152882715331879,0.12702803931445075,1090303.469913718,5578.852220408655,1095882.3221341267,3890,48,1670.6666666666667,73,95,41,35.353889792966264,0.6305650684931507,40.498310810810786,8403.054895868785,115.11034103929842,0
3893,31.86363570673324,0,0,168,0.0,0.0,1.0,168,4450,3100,1350,0.6966292134831461,58,31,27,193.81001371742187,0.4064460364984317,0.7080834803057037,0.1245921516754848,1073806.8800946933,3572.9052322026405,1077379.785326896,3891,49,1671.6666666666667,77,91,45,35.35300925925924,0.6298701298701299,40.384615384615365,8272.290039248006,107.43233817205203,0
3894,32.27708238526258,0,0,168,0.0,0.0,1.0,168,4750,3600,1150,0.7578947368421053,59,36,23,195.98310362192646,0.4062388615625891,0.7086935342722758,0.12640717665830656,1088709.199399291,4323.72156800288,1093032.920967294,3892,50,1672.6666666666667,78,90,42,35.17869834500966,0.6306089743589743,40.26898734177213,8383.35929357724,107.4789653022723,0
3895,32.51324346736268,0,0,168,0.0,0.0,1.0,168,4900,3600,1300,0.7346938775510204,62,36,26,194.02764609741902,0.40567228637962166,0.705490000612736,0.12557727793223689,1097686.932039151,4096.322315090608,1101783.2543542415,3893,51,1673.6666666666667,80,88,43,35.10735260153747,0.6309895833333333,40.149176954732496,8448.593074865326,105.60741343581658,0
3896,32.47420206156232,0,0,168,0.0,0.0,1.0,168,4000,2700,1300,0.675,53,27,26,194.0223118828423,0.4055980301302158,0.7061677733015896,0.12582854273961414,1096963.1353091625,4967.064712586891,1101930.2000217494,3894,52,1674.6666666666667,81,87,48,35.035708176530974,0.6313014403292181,40.07876016260162,8440.734862571455,104.2066032416229,0
3897,32.89348883829933,0,0,168,0.0,0.0,1.0,168,4050,2800,1250,0.691358024691358,53,28,25,193.7997998688163,0.4058438183157495,0.7071394098179835,0.1261159501658874,1112143.4154096036,5456.634266360372,1117600.049675964,3895,53,1675.6666666666667,82,86,38,34.9202662483913,0.6321138211382114,39.95983935742971,8553.628121605909,104.31253806836474,0
3898,32.35481062041869,1,0,169,0.005917159763313609,0.0,1.0,169,3500,2300,1200,0.6571428571428571,47,23,24,193.1272382931931,0.40670640790833096,0.7083503150373258,0.12597783528000323,1094623.755010157,4980.332555047138,1099604.0875652041,3896,0,1666.7455621301774,84,85,40,34.85377602939789,0.6321924603174602,39.87745098039215,8416.215811629963,100.19304537654719,0
3899,32.146371389910634,1,2,168,0.0058823529411764705,0.011764705882352941,0.9882352941176471,170,4400,3300,1100,0.75,55,33,22,191.93787768826382,0.4074754901960784,0.7086797832302296,0.1258888333136147,1089151.02119624,3409.8670980822503,1092560.8882943224,3897,0,1657.9352941176471,88,82,42,34.69230999805164,0.6326941287878788,39.688670411985015,8368.064677937751,95.09164406747445,0
3900,32.56838159792708,0,1,167,0.0,0.005952380952380952,0.9940476190476191,168,4950,3000,1950,0.6060606060606061,69,30,39,195.5366678533272,0.40680395162056837,0.706056266846359,0.12638345605154175,1099151.5752184014,4434.8872967887455,1103586.4625151902,3898,1,1676.107142857143,84,84,38,35.11595911949686,0.628968253968254,40.19607843137258,8461.393258285054,100.73087212244111,8
3901,32.07271454260899,1,1,167,0.005952380952380952,0.005952380952380952,0.9940476190476191,168,4950,3900,1050,0.7878787878787878,60,39,21,194.580244548543,0.40740245699078037,0.7068801803240865,0.12640648816555508,1083896.1508619129,3630.955619987235,1087527.1064819002,3899,0,1676.2559523809523,85,83,39,34.960670580196286,0.6303921568627451,40.01937984496125,8338.284216843042,98.09746137462402,0
3902,31.61978284216488,1,1,167,0.005952380952380952,0.005952380952380952,0.9940476190476191,168,4450,3400,1050,0.7640449438202247,55,34,21,198.02395711861277,0.4071960246174318,0.7126898833358539,0.12924201010261657,1069910.4877848893,4323.5817107738485,1074234.069495663,3900,0,1677.232142857143,86,82,34,34.70729583774413,0.6316618217054264,39.85871647509579,8225.610893339526,95.64663829464565,0
3903,31.821631099793546,0,1,166,0.0,0.005988023952095809,0.9940119760479041,167,4600,3400,1200,0.7391304347826086,58,34,24,201.24592506979846,0.40608692254046125,0.7143377766979639,0.13154654984494893,1077179.2008732436,5355.584949136661,1082534.7858223803,3901,1,1688.2694610778442,88,79,36,34.56940758400433,0.6315104166666667,39.80571161048691,8279.80665940443,94.08871203868671,0
3904,31.883849344975186,0,0,166,0.0,0.0,1.0,166,3850,2600,1250,0.6753246753246753,51,26,25,201.0840695258554,0.4058270962638433,0.7142651631116439,0.13171504431773787,1079882.0132591154,6379.4139667836935,1086261.4272258992,3902,2,1698.132530120482,89,77,38,34.5002575562177,0.6319054307116105,39.73379629629632,8298.288428477572,93.2391958255907,0
3905,32.281362842393264,0,0,166,0.0,0.0,1.0,166,4950,3500,1450,0.7070707070707071,64,35,29,202.31182733930333,0.40543309602044547,0.7166358846999186,0.13288090458918353,1094134.1482485933,6121.255777301426,1100255.4040258948,3903,3,1699.132530120482,91,75,39,34.37255381604695,0.6322115384615384,39.639945652173935,8404.777384067473,92.36019103370849,0
3906,32.323038880685786,1,1,166,0.005988023952095809,0.005988023952095809,0.9940119760479041,167,4400,3400,1000,0.7727272727272727,54,34,20,201.88458733002298,0.4060553591611957,0.7149170707193835,0.13313320594612732,1096706.5242408204,6481.62881370036,1103188.1530545207,3904,0,1689.9520958083833,76,91,38,34.24311470018004,0.6392543859649122,39.5021645021645,8420.081665131018,110.79054822540813,0
3907,32.25320444070243,0,0,166,0.0,0.0,1.0,166,3850,2600,1250,0.6753246753246753,51,26,25,203.60397795043122,0.4060157295850067,0.7161656334074167,0.13453228882686988,1094905.455777863,7535.421255200604,1102440.8770330637,3905,1,1700.120481927711,76,90,41,34.12930706263086,0.6399396929824561,39.43452380952381,8404.07157376041,110.57988912842644,0
3908,31.758079771712616,0,0,166,0.0,0.0,1.0,166,4650,3600,1050,0.7741935483870968,57,36,21,206.98154212656274,0.4060545211147621,0.7189367392190518,0.13738321693415617,1079375.9164629716,6832.178344755421,1086208.094807727,3906,2,1701.120481927711,78,88,41,33.88364183482523,0.640625,39.28006329113923,8279.964548075837,106.15339164199791,0
3909,31.496965550004198,0,0,166,0.0,0.0,1.0,166,4600,3600,1000,0.782608695652174,56,36,20,204.44573557004222,0.4056285749056833,0.7159465889033858,0.13637062095505756,1071881.0255637658,6028.300942990674,1077909.3265067565,3907,3,1702.120481927711,83,83,42,33.77836137782424,0.6403112449799198,39.11210317460315,8217.177098722508,99.0021337195483,0
3910,31.48379375682237,0,0,166,0.0,0.0,1.0,166,4550,3100,1450,0.6813186813186813,60,31,29,204.75253978196858,0.4051896981866861,0.7169404255860103,0.13704023993574133,1072381.305750702,6164.55919343158,1078545.8649441337,3908,4,1703.120481927711,86,80,47,33.652537578176336,0.6403827519379846,38.996647509578516,8217.375719647564,95.55088046101818,0
3911,31.553995214434313,0,0,166,0.0,0.0,1.0,166,3550,2400,1150,0.676056338028169,47,24,23,205.91967001724538,0.4054346172569064,0.7196465615840839,0.13822812176629226,1075595.0974823094,7547.237509144406,1083142.334991454,3909,5,1704.120481927711,87,79,35,33.52015141898629,0.641044061302682,38.896780303030276,8238.849744791503,94.69942235392533,0
3912,31.756059992820592,0,0,166,0.0,0.0,1.0,166,3900,2900,1000,0.7435897435897436,49,29,20,210.1867434839277,0.4053768102713886,0.7259998455982852,0.14150037871284407,1083292.5727508527,8438.747621365157,1091731.3203722178,3910,6,1705.120481927711,88,78,37,33.3090618512046,0.6416903409090908,38.79915730337076,8294.709630849384,94.25806398692481,0
3913,31.688261708168138,0,0,166,0.0,0.0,1.0,166,3500,2300,1200,0.6571428571428571,47,23,24,210.93365415392992,0.40525739320920046,0.7280830965056266,0.14235656928325613,1081674.156291334,8932.296478079505,1090606.4527694134,3911,7,1706.120481927711,89,77,37,33.203903654485025,0.6422050561797753,38.71527777777774,8279.658658123697,93.02987256318761,0
3914,31.231099945452257,0,0,166,0.0,0.0,1.0,166,4450,3200,1250,0.7191011235955056,57,32,25,215.22748516520357,0.4049782463186078,0.732759069858681,0.14562121242416595,1066762.399612072,8269.317707460112,1075031.717319532,3912,8,1707.120481927711,93,73,37,33.00492523813559,0.6418010752688172,38.63031914893613,8162.862625370419,87.77271640183245,0
3915,31.404138151982664,0,1,165,0.0,0.006024096385542169,0.9939759036144579,166,4850,3500,1350,0.7216494845360825,62,35,27,213.82002357704965,0.40498052817329927,0.7315852557516895,0.14517254232336507,1073631.8405049955,7862.797089969828,1081494.6375949653,3913,9,1708.120481927711,73,93,39,32.92240884295148,0.6506849315068493,38.51351351351351,8211.757746498157,112.48983214381036,0
3916,31.555391635473008,0,0,165,0.0,0.0,1.0,165,4500,3100,1400,0.6888888888888889,59,31,28,214.02004095904573,0.40409429662478447,0.7289779011079607,0.1459403627716208,1080003.385090383,8728.473742590337,1088731.8588329733,3914,14,1719.418181818182,77,88,38,32.768607608936094,0.6502976190476191,38.36805555555556,8255.898471294766,107.21946066616579,0
3917,31.3656255102854,0,0,165,0.0,0.0,1.0,165,4350,3200,1150,0.735632183908046,55,32,23,216.1721096379173,0.4039587952697709,0.7302004530495361,0.14798099036317033,1074572.7957420547,9108.53364301504,1083681.3293850697,3915,15,1720.418181818182,78,87,37,32.579840822083405,0.6511752136752137,38.23839662447258,8210.316424448662,105.26046698011105,0
3918,31.251571454521443,0,0,165,0.0,0.0,1.0,165,4050,3000,1050,0.7407407407407407,51,30,21,218.4706845197346,0.4038818058635132,0.7348921236534527,0.1500286236017267,1071528.4447507004,9769.510561410556,1081297.955312111,3916,16,1721.418181818182,78,87,36,32.41188318227594,0.6522435897435898,38.13291139240507,8183.758031207766,104.91997475907392,0
3919,31.414543667336762,0,0,165,0.0,0.0,1.0,165,4200,2800,1400,0.6666666666666666,56,28,28,207.8917358640194,0.40409737620103475,0.7326151049633118,0.1309622133300073,1052858.3453708275,6576.109807612326,1059434.4551784398,3917,17,1722.418181818182,76,89,43,35.7161363082175,0.6230811403508771,41.098484848484865,8133.272953266963,107.01674938509161,8
3920,31.25609449938079,0,0,165,0.0,0.0,1.0,165,3550,2400,1150,0.676056338028169,47,24,23,206.18240566723242,0.4039033628972653,0.7299737367565045,0.1300260142097987,1047858.3496214515,6659.991064689613,1054518.340686141,3918,18,1723.418181818182,78,87,38,35.72124197983502,0.6225961538461539,41.0601265822785,8093.449153202045,103.76216863079544,0
3921,31.257900547810955,0,0,165,0.0,0.0,1.0,165,4300,3100,1200,0.7209302325581395,55,31,24,203.44688196430477,0.40393107908351816,0.7262925277299301,0.1287935924417369,1049017.1037406393,5383.851776651945,1054400.9555172913,3919,19,1724.418181818182,79,86,40,35.65366847598467,0.6235495780590717,40.924479166666686,8098.1568645807,102.50831474152785,0
3922,31.135067312525887,1,0,166,0.006024096385542169,0.0,1.0,166,5000,3700,1300,0.74,63,37,26,206.01322225147857,0.4045872885481319,0.7321748151310035,0.13125005195614567,1046703.8892816198,4926.968194812349,1051630.857476432,3920,0,1715.0240963855422,82,84,42,35.35838455705596,0.6246189024390244,40.70030120481928,8073.313576105656,98.45504361104457,0
3923,30.77862951251449,1,0,167,0.005988023952095809,0.0,1.0,167,4700,3200,1500,0.6808510638297872,62,32,30,202.97006753167264,0.4056765986100089,0.7309194365678409,0.13007733893116744,1036376.5506399375,3970.6836943258877,1040347.2343342634,3921,0,1705.748502994012,70,97,43,35.22574155736468,0.6321428571428571,40.492957746478865,7987.271109409558,114.10387299156513,0
3924,30.725001831644917,0,0,167,0.0,0.0,1.0,167,3650,2500,1150,0.684931506849315,48,25,23,203.12693345834953,0.40541056441334195,0.729181556645986,0.1306564855857894,1035594.629776726,5021.432290496041,1040616.0620672221,3922,1,1706.748502994012,71,96,43,35.09068873286526,0.6329225352112676,40.364583333333314,7977.298652643185,112.35631905131247,0
3925,31.194361497325833,0,0,167,0.0,0.0,1.0,167,4350,3200,1150,0.735632183908046,55,32,23,215.20259292383165,0.4053278984200274,0.7420437869904766,0.13725143148697802,1049001.8171886005,7399.582208159949,1056401.3993967604,3923,2,1707.748502994012,82,85,40,35.08164359917409,0.625,40.66265060240966,8089.863026866792,98.65686618130235,8
3926,31.720717380451912,0,1,166,0.0,0.005988023952095809,0.9940119760479041,167,5200,4000,1200,0.7692307692307693,64,40,24,211.10810598729708,0.4052226871558089,0.7371245121594396,0.1351277876649958,1067746.5564423788,6481.990641001464,1074228.5470833802,3924,3,1708.748502994012,69,98,39,35.05821289286531,0.6322463768115942,40.535714285714256,8230.393277463621,119.2810619922264,0
3927,31.82886545336478,0,0,166,0.0,0.0,1.0,166,4300,2800,1500,0.6511627906976745,58,28,30,212.16412882953364,0.4049911768285262,0.738961610129278,0.13648377273341517,1072830.967364623,8023.249514452129,1080854.2168790752,3925,4,1697.0361445783133,70,96,42,34.852305475504316,0.6334821428571429,40.36091549295774,8264.017487209438,118.05739267442054,0
3928,31.86432072728262,1,0,167,0.005988023952095809,0.0,1.0,167,4850,3500,1350,0.7216494845360825,62,35,27,212.92661584435,0.4053474376548109,0.7405247424509418,0.13752914798924937,1075192.939008175,7537.438776549998,1082730.3777847248,3926,0,1687.868263473054,71,96,40,34.68849780946015,0.6343896713615024,40.21990740740739,8277.71618893351,116.58755195680999,0
3929,31.635099925676663,1,0,168,0.005952380952380952,0.0,1.0,168,5100,3900,1200,0.7647058823529411,63,39,24,209.66641351624438,0.4062648512498812,0.7398830147043656,0.13637176022788963,1069451.6360966961,6145.617793894789,1075597.253890591,3927,0,1678.8154761904761,73,95,36,34.52567850440305,0.6358447488584476,39.97747747747748,8225.838482926514,112.68271894419883,0
3930,31.203813143227645,0,0,168,0.0,0.0,1.0,168,3800,2300,1500,0.6052631578947368,53,23,30,204.89548791933717,0.4063042070620664,0.7341303729006543,0.13404056779527596,1056492.5416872257,5894.110962428955,1062386.6526496545,3928,1,1679.8154761904761,74,94,39,34.44594185881012,0.6373873873873874,39.77777777777778,8119.925597937687,109.72872429645523,0
3931,31.57984308511035,1,0,169,0.005917159763313609,0.0,1.0,169,4000,2800,1200,0.7,52,28,24,205.4088745437757,0.4068942542500235,0.7365927675058925,0.1348718454655394,1070266.388019258,6168.442845013498,1076434.8308642714,3929,0,1670.8698224852071,76,93,41,34.30317398458473,0.6377467105263157,39.65097402597402,8221.78138762105,108.1813340476454,0
3932,31.918157854757247,1,0,170,0.0058823529411764705,0.0,1.0,170,4300,2700,1600,0.627906976744186,59,27,32,205.78923014026617,0.4073942742777585,0.738038579289372,0.1356259502230768,1082796.2983851496,6265.563328681916,1089061.8617138315,3930,0,1662.035294117647,68,102,42,34.16260963641281,0.6430759803921569,39.52294685990338,8313.94769966759,122.2639367598175,0
3933,31.498966995195545,0,1,169,0.0,0.0058823529411764705,0.9941176470588236,170,4850,3600,1250,0.7422680412371134,61,36,25,230.5331051467227,0.40716948021812277,0.7572438668015389,0.1530771725870456,1070682.332865616,10515.54456424962,1081197.8774298658,3931,1,1663.035294117647,68,102,41,33.25552950031844,0.6456801470588236,39.26630434782609,8212.842073883205,120.77708932181183,8
3934,31.71753166114718,0,0,169,0.0,0.0,1.0,169,4400,2900,1500,0.6590909090909091,59,29,30,232.3183864283599,0.4058831126138818,0.7578407093029853,0.1547141594725036,1078935.7150385177,11931.320875535497,1090867.0359140532,3932,3,1673.8698224852071,69,100,40,33.10702875399364,0.6461352657004831,39.16666666666667,8272.989508282564,119.8983986707618,0
3935,31.7744649256269,0,1,168,0.0,0.005917159763313609,0.9940828402366864,169,3550,2000,1550,0.5633802816901409,51,20,31,227.71286653697067,0.40579065699258005,0.7541786170703342,0.14677463796068832,1071563.9269023866,11451.778694511217,1083015.7055968978,3933,4,1674.8698224852071,71,98,39,34.37836564351103,0.633656103286385,40.29224537037038,8252.07494039251,116.2264076111621,8
3936,32.0169458566695,0,1,167,0.0,0.005952380952380952,0.9940476190476191,168,4850,3400,1450,0.7010309278350515,63,34,29,226.55497440770992,0.4047128956372968,0.748860090077361,0.14679081326632437,1081249.5344745503,10542.49212224609,1091792.0265967965,3934,7,1685.8154761904761,76,92,40,34.22301459233424,0.6330866228070176,40.11093073593074,8320.854259367941,109.48492446536765,0
3937,32.357104389203755,0,0,167,0.0,0.0,1.0,167,4400,3100,1300,0.7045454545454546,57,31,26,223.38026355101863,0.4044771901979174,0.7447372216688302,0.14532031779491714,1093917.3146456769,11071.90760971463,1104989.2222553915,3935,8,1678.994011976048,77,90,33,34.16207650694193,0.6340638528138528,39.970619658119645,8413.797803982156,109.2701013504176,0
3938,31.891072775295115,0,0,167,0.0,0.0,1.0,167,4350,2900,1450,0.6666666666666666,58,29,29,221.80177453914808,0.4043524396989154,0.7434946629801733,0.14480969595160062,1079186.8748767423,10123.112781403572,1089309.9876581458,3936,9,1679.994011976048,78,89,35,34.07680773779353,0.6348824786324787,39.84704641350209,8296.556775534935,106.36611250685814,0
3939,31.65291876541643,0,0,167,0.0,0.0,1.0,167,4200,3100,1100,0.7380952380952381,53,31,22,222.22359694774758,0.40456737128153336,0.7459186079641718,0.14559997988428047,1072134.729996538,10050.727222486132,1082185.4572190242,3937,10,1680.994011976048,80,87,40,33.940864996623645,0.6352864583333333,39.724794238683096,8238.46994461493,102.98087430768662,0
3940,31.281501603709966,0,0,167,0.0,0.0,1.0,167,4450,3200,1250,0.7191011235955056,57,32,25,221.99747754775362,0.4045252867758459,0.7461409790686166,0.14578466830415082,1060195.1767837908,9222.13099085899,1069417.3077746497,3938,11,1681.994011976048,82,85,40,33.86629308267051,0.6352896341463414,39.64608433734938,8144.2614303333285,99.3202613455284,0
3941,31.392358996073266,0,0,167,0.0,0.0,1.0,167,4500,2900,1600,0.6444444444444445,61,29,32,209.06242655160756,0.4045207777216651,0.7325041546862228,0.1282626238573375,1044432.3777819322,5770.313453631154,1050202.6912355635,3939,12,1682.994011976048,76,91,38,36.6525942241801,0.6134868421052632,42.04545454545454,8097.801695577978,106.55002231023654,8
3942,31.35532368094469,1,1,167,0.005952380952380952,0.005952380952380952,0.9940476190476191,168,4050,2700,1350,0.6666666666666666,54,27,27,214.80127623922627,0.40550298213097613,0.7430705530424644,0.13259170834691186,1044984.9096618664,7242.818449220239,1052227.7281110866,3940,0,1673.970238095238,78,90,42,36.27926029962548,0.6148504273504274,41.82489451476793,8095.163998851476,103.78415383142918,0
3943,30.97640945398551,0,2,165,0.0,0.011976047904191617,0.9880239520958084,167,4100,3100,1000,0.7560975609756098,51,31,20,220.01166917070827,0.4050979366568069,0.747381942775599,0.13600209830833807,1032767.7882830991,7944.192993181089,1040711.9812762801,3941,1,1684.874251497006,77,90,43,36.09222003861533,0.6158008658008658,41.77350427350427,7998.929663491773,103.88220342197107,0
3944,30.905605194033093,2,0,167,0.011976047904191617,0.0,1.0,167,4850,3300,1550,0.6804123711340206,64,33,31,213.68312015248526,0.4056300050501407,0.7389988849028875,0.13277547348222551,1031890.0937261728,5849.498976369858,1037739.5927025427,3942,0,1685.688622754491,65,102,46,36.0659189926505,0.6238782051282051,41.587752525252526,7986.386897757322,122.86749073472804,0
3945,31.299908153001393,1,0,168,0.005952380952380952,0.0,1.0,168,4150,2800,1350,0.6746987951807228,55,28,27,210.8992427332759,0.4067415763710674,0.7371778834125584,0.13175434091980348,1046615.4606307177,6396.081615991397,1053011.542246709,3943,0,1676.6488095238096,68,100,46,35.9409661412726,0.6240808823529411,41.394927536231876,8094.315016016199,119.0340443531794,0
3946,31.412863408517744,1,0,169,0.005917159763313609,0.0,1.0,169,4600,3400,1200,0.7391304347826086,58,34,24,210.64297530000076,0.40755171644594723,0.7357779283887722,0.13235659238291897,1052064.0955449427,5921.9822583780315,1057986.0778033207,3944,0,1667.7218934911243,71,98,42,35.73756917658893,0.6245598591549295,41.1892361111111,8129.987174695782,114.50686161543355,0
3947,30.971410651352198,1,0,170,0.0058823529411764705,0.0,1.0,170,4750,2800,1950,0.5894736842105263,67,28,39,208.93694371859382,0.40903164520245966,0.7359150182770342,0.13205513239484326,1038943.1172750089,4664.719924181606,1043607.8371991905,3945,0,1658.9058823529413,72,98,35,35.569886697517255,0.6261574074074074,40.98173515981733,8022.161046565957,111.41890342452717,0
3948,31.508057361622164,0,0,170,0.0,0.0,1.0,170,3750,2500,1250,0.6666666666666666,50,25,25,209.82544597062207,0.40900191437521755,0.7361825747358608,0.13289907634326417,1057558.893125562,6630.553278053545,1064189.4464036156,3946,1,1659.9058823529413,73,97,36,35.47009127458437,0.6264269406392694,40.90653153153152,8163.531866526124,111.82920365104279,0
3949,31.038371411404437,0,0,170,0.0,0.0,1.0,170,5050,3800,1250,0.7524752475247525,63,38,25,209.19644469518528,0.40902584406543685,0.7366515837104082,0.1330000754229974,1042861.6215773489,4582.5887086074135,1047444.2102859563,3947,2,1660.9058823529413,76,94,38,35.35088978185997,0.6263706140350878,40.773809523809526,8045.9587795634725,105.86787867846674,0
3950,30.96596531048682,0,2,168,0.0,0.011764705882352941,0.9882352941176471,170,4500,3300,1200,0.7333333333333333,57,33,24,210.43034213254683,0.4090722531616197,0.737728321712658,0.13409337759297407,1041080.5006810208,5314.985189166093,1046395.4858701868,3948,3,1661.9058823529413,76,94,39,35.23602705898721,0.6271929824561404,40.692640692640694,8029.702693065636,105.65398280349521,0
3951,31.392354505982567,0,0,168,0.0,0.0,1.0,168,4950,3400,1550,0.6868686868686869,65,34,31,211.6545630753632,0.4075301777397586,0.7380159213061555,0.135194043689996,1056094.9698980686,6155.463883973005,1062250.4337820415,3949,4,1682.6190476190477,65,103,43,35.119092891187506,0.6338141025641026,40.60921717171718,8142.887410129801,125.27519092507386,0
3952,31.448539493577357,1,1,168,0.005917159763313609,0.005917159763313609,0.9940828402366864,169,3750,2500,1250,0.6666666666666666,50,25,25,211.6838480276334,0.40822532168686015,0.7393847741964752,0.13569227309052442,1058998.06373692,7284.557037128842,1066282.6207740488,3950,0,1673.6568047337278,66,103,44,34.99156282450676,0.634469696969697,40.48507462686567,8161.365379769792,123.6570512086332,0
3953,31.43365741146297,1,1,168,0.005917159763313609,0.005917159763313609,0.9940828402366864,169,4750,3600,1150,0.7578947368421053,59,36,23,210.41056972321158,0.4085247017939326,0.7383926928715141,0.13534150839615633,1059480.0608286865,6035.16064186945,1065515.221470556,3951,0,1664.0473372781064,67,102,45,34.901579739217645,0.6351057213930349,40.36458333333334,8161.290739382461,121.8103095430218,0
3954,31.447157222751322,0,1,167,0.0,0.005952380952380952,0.9940476190476191,168,4750,3900,850,0.8210526315789474,56,39,17,207.37073096945971,0.40866778348065774,0.7328112674886871,0.13377628145217688,1060767.2493906664,5644.41597892115,1066411.6653695875,3952,1,1673.702380952381,68,100,46,34.87648939261844,0.6355698529411764,40.262681159420296,8168.000302195611,120.11765150287663,0
3955,31.659988989007736,0,0,167,0.0,0.0,1.0,167,4150,2700,1450,0.6506024096385542,56,27,29,205.25890377452643,0.4084361397686555,0.729259227636464,0.13290456939616455,1069005.4657237406,6334.578004686482,1075340.043728427,3953,2,1683.1377245508982,69,98,42,34.79994607646643,0.636322463768116,40.13392857142858,8227.356960045281,119.23705739196059,0
3956,32.148302592621164,1,0,168,0.005952380952380952,0.0,1.0,168,4750,3200,1550,0.6736842105263158,63,32,31,201.87221251196414,0.4093977224123182,0.727109492979678,0.13149831827173192,1087232.928818268,5546.42337128136,1092779.3521895495,3954,0,1674.1130952380952,72,96,42,34.67562365119423,0.6368634259259259,39.92579908675799,8360.944107493056,116.12422371518134,0
3957,31.662277854577596,0,1,167,0.0,0.005952380952380952,0.9940476190476191,168,4650,3100,1550,0.6666666666666666,62,31,31,202.96066297568032,0.4092291607261667,0.7295953309150023,0.1325739609292623,1071584.5603886992,5247.90256219866,1076832.4629508979,3955,1,1675.1130952380952,75,93,43,34.5496171811892,0.6363888888888889,39.83004385964912,8237.573440729057,109.83431254305408,0
3958,31.894121273753996,1,0,168,0.005952380952380952,0.0,1.0,168,4550,2900,1650,0.6373626373626373,62,29,33,220.440988273544,0.4092180222887558,0.7494462048528596,0.14368502970600822,1078818.7995242642,9413.176467041212,1088231.9759913054,3956,0,1676.0833333333333,77,91,38,34.170260833846775,0.6347402597402597,39.90384615384614,8295.538273606171,107.73426329358664,7
3959,31.741397570809244,1,0,169,0.005917159763313609,0.0,1.0,169,4400,2900,1500,0.6590909090909091,59,29,30,219.34046550754547,0.41016542218465296,0.7507726455835035,0.1437109641115954,1075131.6479374503,8963.975228098607,1084095.623165549,3957,0,1667.1597633136096,80,89,41,34.01590575950717,0.6352864583333333,39.7247942386831,8261.498783894078,103.26873479867598,0
3960,32.042909517123334,0,0,169,0.0,0.0,1.0,169,5250,3400,1850,0.6476190476190476,71,34,37,219.58885931130655,0.4098000023480793,0.7517616570557282,0.14425555653173977,1086105.5777667214,8649.33698268807,1094754.9147494095,3958,1,1668.1597633136096,82,87,42,33.916176612358996,0.6354166666666667,39.63353413654617,8342.899106955785,101.74267203604616,0
3961,32.22358683231502,0,0,169,0.0,0.0,1.0,169,5200,3800,1400,0.7307692307692307,66,38,28,221.93027072540292,0.40974717056447824,0.7537317391746938,0.14654499636539878,1093710.7178370943,9545.503140972474,1103256.2209780668,3959,2,1669.1597633136096,65,104,40,33.67483442371375,0.6455128205128204,39.45707070707073,8395.627705616465,129.16350316333023,0
3962,32.33411514120218,0,0,169,0.0,0.0,1.0,169,3900,2700,1200,0.6923076923076923,51,27,24,221.13239092384953,0.4094874142951066,0.7537556635823262,0.1465417259379161,1098494.3739974464,10882.537467690745,1109376.911465137,3960,3,1670.1597633136096,66,103,42,33.57042029504154,0.6461489898989898,39.33457711442788,8428.385796912293,127.70281510473171,0
3963,32.01399053451354,0,0,169,0.0,0.0,1.0,169,4550,3500,1050,0.7692307692307693,56,35,21,220.62017620536076,0.409386153376538,0.7530944933382697,0.14662455958427117,1088440.5547993963,9676.38939778086,1098116.9441971772,3961,4,1671.1597633136096,68,101,42,33.48313359964491,0.6459865196078431,39.23611111111112,8348.092670631855,122.76606868576258,0
3964,32.31078211430835,0,0,169,0.0,0.0,1.0,169,4300,3100,1200,0.7209302325581395,55,31,24,222.58740435848188,0.4093744129801822,0.7545550149426592,0.14833598386408603,1099314.1668596307,10838.697395158568,1110152.8642547892,3962,5,1672.1597633136096,70,99,40,33.336848518935135,0.6458333333333333,39.14319248826292,8428.48747054583,120.40696386494042,0
3965,32.01989983574248,0,0,169,0.0,0.0,1.0,169,4950,3400,1550,0.6868686868686869,65,34,31,223.44852293028362,0.40892974546820704,0.7562059654261357,0.149546173908446,1090628.1086657066,9989.847989520391,1100617.9566552269,3963,6,1673.1597633136096,72,97,41,33.16624296101907,0.6462673611111112,38.99828767123289,8357.248685724424,116.07289841283922,0
3966,32.0636054421627,0,0,169,0.0,0.0,1.0,169,4650,3800,850,0.8172043010752689,55,38,17,222.27137268953922,0.4089561613600075,0.7549597439130846,0.14932327900949263,1093191.7691879028,10147.047030060374,1103338.8162179631,3964,7,1674.1597633136096,72,97,41,33.06568761384334,0.6475694444444444,38.86986301369864,8372.773681386692,116.28852335259295,0
3967,31.61688111943601,0,0,169,0.0,0.0,1.0,169,4750,3600,1150,0.7578947368421053,59,36,23,224.19673893210174,0.4085026885507655,0.7568961421251106,0.15084149107757383,1078377.240251349,9803.732120590605,1088180.9723719396,3965,8,1675.1597633136096,74,95,41,32.96386156164142,0.6471002252252251,38.81944444444446,8257.714575708284,111.5907375095714,0
3968,31.71264447836666,0,1,168,0.0,0.005917159763313609,0.9940828402366864,169,4650,3300,1350,0.7096774193548387,60,33,27,228.59901139261177,0.40802867004790083,0.7602166273803015,0.15457184217142989,1083036.5143611769,11066.215297013043,1094102.72965819,3966,9,1676.1597633136096,75,94,42,32.67691070554508,0.6483333333333333,38.651315789473685,8288.057907257338,110.50743876343118,0
3969,31.352046118117162,0,0,168,0.0,0.0,1.0,168,4250,2900,1350,0.6823529411764706,56,29,27,229.5953599077036,0.406961374869309,0.759982305334965,0.1555113510629917,1071193.250602245,11338.19998054529,1082531.4505827904,3967,10,1687.0654761904761,79,89,42,32.59198379491269,0.6471518987341772,38.593750000000014,8195.620805564098,103.7420355134696,0
3970,31.54396141640942,0,0,168,0.0,0.0,1.0,168,4250,3400,850,0.8,51,34,17,228.790518120756,0.40698216661914266,0.7602202109979042,0.15543603241399798,1078588.9950144624,11504.187001740851,1090093.1820162032,3968,11,1688.0654761904761,62,106,40,32.50900986342942,0.657258064516129,38.49206349206349,8248.996259291185,133.04832676276106,0
3971,31.745198375084293,0,0,168,0.0,0.0,1.0,168,4000,2700,1300,0.675,53,27,26,223.19332685722023,0.4067831598707347,0.7579944733905617,0.14745633081558512,1077622.206788103,10503.617085651262,1088125.8238737544,3969,12,1689.0654761904761,64,104,39,33.62355720934047,0.6463216145833333,39.43910256410257,8271.557377892568,129.24308402957138,8
3972,32.151052761452526,0,0,168,0.0,0.0,1.0,168,4450,3200,1250,0.7191011235955056,57,32,25,224.01902618592518,0.4067475168710199,0.7591974039815759,0.14827926018973198,1091936.4089133278,10872.906196344215,1102809.315109672,3970,13,1690.0654761904761,64,104,39,33.53650413002931,0.64697265625,39.375000000000014,8379.368125953595,130.92762696802492,0
3973,32.24497417028361,0,0,168,0.0,0.0,1.0,168,4000,2900,1100,0.725,51,29,22,220.4185778787708,0.40636806743655546,0.7390280396919167,0.14328311494897358,1089902.5194137685,10446.952671134099,1100349.4720849027,3971,14,1691.0654761904761,77,91,44,34.266387162497615,0.6337932900432901,39.997329059829035,8383.7794086705,108.88025206065585,8
3974,32.39809812909562,0,1,167,0.0,0.005952380952380952,0.9940476190476191,168,4750,3200,1550,0.6736842105263158,63,32,31,222.22061982470368,0.40629232606216137,0.741548590790083,0.14501291301726554,1096203.449984191,10369.802021892809,1106573.2520060837,3972,15,1692.0654761904761,77,91,38,34.083018892140274,0.6351461038961039,39.86378205128203,8427.918716034315,109.45348981862747,0
3975,32.62973534992714,0,0,167,0.0,0.0,1.0,167,4150,2900,1250,0.6987951807228916,54,29,25,220.46867946924704,0.40591257244547047,0.7383452453710269,0.1443509695201798,1105019.9522945865,11174.457933911128,1116194.4102284976,3973,16,1701.8922155688622,81,86,40,34.010744618538574,0.6346450617283951,39.74847560975607,8491.93836526869,104.83874525023074,0
3976,32.98313742210634,1,0,168,0.005952380952380952,0.0,1.0,168,4050,2900,1150,0.7160493827160493,52,29,23,217.14283341081565,0.4065039563729684,0.7367013097590485,0.142804965148684,1118298.2856285258,10916.091667966793,1129214.3772964925,3974,0,1692.7559523809523,82,86,44,33.941394766012785,0.6357977642276422,39.59588353413652,8588.944758675689,104.74322876433767,0
3977,33.12232388321687,0,1,167,0.0,0.005952380952380952,0.9940476190476191,168,4100,2800,1300,0.6829268292682927,54,28,26,213.49892092288974,0.40655742087254065,0.7328788779626634,0.14110400995196867,1124479.9871569476,10315.052771478717,1134795.0399284263,3975,1,1693.7559523809523,72,96,44,33.86315097749303,0.6419270833333333,39.426369863013704,8630.804172822835,119.87228017809493,0
3978,33.36006287361446,0,0,167,0.0,0.0,1.0,167,4300,3000,1300,0.6976744186046512,56,30,26,216.69941691036485,0.40568862275449097,0.7315980718371449,0.14372607969638043,1133601.51381033,11430.15741028139,1145031.6712206115,3976,2,1704.7125748502995,74,93,46,33.656322145267275,0.6421734234234234,39.30555555555557,8696.783057468701,117.52409537119867,0
3979,33.510590601471925,1,1,167,0.005952380952380952,0.005952380952380952,0.9940476190476191,168,3900,2600,1300,0.6666666666666666,52,26,26,215.73956435188637,0.40598639031460887,0.7302923954658072,0.14365024176404473,1139882.306029239,11683.542423034363,1151565.8484522733,3977,0,1695.5595238095239,75,93,44,33.54506043089863,0.6430555555555555,39.17214912280702,8740.495328207386,116.53993770943181,0
3980,33.499028723398006,1,0,168,0.005952380952380952,0.0,1.0,168,4150,2700,1450,0.6506024096385542,56,27,29,212.82625313096474,0.40553565488071475,0.7250210490864697,0.1424719540320412,1141081.2864369724,10820.410942048522,1151901.697379021,3978,0,1696.3511904761904,78,90,46,33.43500042098173,0.6435630341880342,38.989978902953595,8743.5821938247,112.09720761313719,0
3981,33.27375270576868,0,0,168,0.0,0.0,1.0,168,4150,2700,1450,0.6506024096385542,56,27,29,211.06835672249832,0.4055772383803821,0.7231351317122592,0.1417173252279636,1134285.7982568403,10132.367898347844,1144418.166155188,3979,1,1697.3511904761904,80,88,40,33.377659574468076,0.64375,38.8888888888889,8688.146539839629,108.60183174799536,0
3982,33.22410383361826,0,0,168,0.0,0.0,1.0,168,4050,2900,1150,0.7160493827160493,52,29,23,212.78830594089013,0.4054851606311187,0.7271256368235834,0.14325300901443294,1133374.3722841414,10583.762535032718,1143958.1348191742,3980,2,1698.3511904761904,80,88,42,33.240813680600056,0.6446614583333333,38.79886831275722,8678.1735206356,108.47716900794501,0
3983,32.894042659785754,0,1,167,0.0,0.005952380952380952,0.9940476190476191,168,4650,3400,1250,0.7311827956989247,59,34,25,211.12312313947706,0.40535595475715236,0.72531185753181,0.1424665484492385,1122796.9185676838,9159.678419878444,1131956.5969875623,3981,3,1699.3511904761904,81,87,43,33.20327693504475,0.6450617283950617,38.71951219512197,8594.571512023345,106.10582113609068,0
3984,32.692424889799305,0,1,166,0.0,0.005988023952095809,0.9940119760479041,167,3800,2600,1200,0.6842105263157895,50,26,24,216.22288665542203,0.40548120626217443,0.7287793595407959,0.14641060802472428,1116904.6742203308,11100.070555771035,1128004.7447761018,3982,4,1706.8922155688622,83,84,44,32.95168374527571,0.6454568273092369,38.603670634920654,8545.679864237154,102.95999836430306,0
3985,33.13451767594154,1,1,166,0.005988023952095809,0.005988023952095809,0.9940119760479041,167,5000,4100,900,0.82,59,41,18,215.39340645386505,0.4056450352307433,0.7281532552425025,0.14611822978356848,1132545.4362532555,10388.563895673666,1142934.0001489292,3983,0,1707.8562874251497,84,83,45,32.910026560425,0.6457093253968254,38.54166666666668,8663.295767355581,103.13447342089978,0
3986,32.90512635769002,1,0,167,0.005988023952095809,0.0,1.0,167,4750,3500,1250,0.7368421052631579,60,35,25,215.77932134235516,0.4065543611572036,0.7287327159038857,0.1473948778111977,1126697.1789587655,10473.590526813648,1137170.769485579,3984,0,1705.0359281437127,71,96,43,32.66346012089049,0.653755868544601,38.31018518518518,8610.936423001975,121.28079469016866,0
3987,32.71421850814953,0,1,166,0.0,0.005988023952095809,0.9940119760479041,167,4450,2900,1550,0.651685393258427,60,29,31,215.79074404800411,0.40625375754515064,0.7304204685291571,0.1481858697499086,1121673.9170044826,10559.369825927402,1132233.28683041,3985,1,1706.0359281437127,73,94,43,32.482608091884856,0.6545376712328768,38.13344594594595,8566.759669300483,117.3528721821984,0
3988,33.05802358880036,0,0,166,0.0,0.0,1.0,166,4500,3400,1100,0.7555555555555555,56,34,22,214.31296022011423,0.4054802543507363,0.7268691721359544,0.1474269499570334,1133962.2919059563,10904.56311127025,1144866.8550172267,3986,2,1717.2469879518073,75,91,44,32.46227978370837,0.6541666666666667,38.07565789473685,8658.701079796818,115.44934773062424,0
3989,33.49033985969768,0,0,166,0.0,0.0,1.0,166,4350,2800,1550,0.6436781609195402,59,28,31,210.78689356127242,0.4053395399780942,0.7222956955478244,0.14559208772801327,1149975.7845555719,10929.964659431356,1160905.749215003,3987,3,1718.2469879518073,77,89,48,32.416838658716856,0.6546266233766234,37.94070512820514,8776.454848649159,113.97993309933972,0
3990,33.62554142900315,0,0,166,0.0,0.0,1.0,166,5550,3900,1650,0.7027027027027027,72,39,33,211.81512003635447,0.40486947791164657,0.7209266146828075,0.1468701534797538,1155748.2787229207,10210.992077901277,1165959.270800822,3988,4,1719.2469879518073,79,87,37,32.25897232154683,0.6550632911392404,37.812500000000014,8816.196643416797,111.59742586603541,0
3991,33.605465106008104,0,0,166,0.0,0.0,1.0,166,4700,3200,1500,0.6808510638297872,62,32,30,211.16306189099956,0.4047842886698308,0.7209220491381372,0.14679032241756262,1155797.0721827107,10912.329737351187,1166709.401920062,3989,5,1720.2469879518073,81,85,40,32.19045658561789,0.6550925925925926,37.72865853658539,8813.75041385479,108.81173350438013,0
3992,33.37588433156821,0,0,166,0.0,0.0,1.0,166,5200,3800,1400,0.7307692307692307,66,38,28,210.73323780289445,0.40423512230741143,0.7196756781378815,0.1470684469627066,1149034.5154476508,10027.95275751296,1159062.4682051637,3990,6,1721.2469879518073,83,83,43,32.06954946439824,0.6556224899598393,37.59920634920636,8757.858537400622,105.51636792048942,0
3993,33.443748136007535,0,1,165,0.0,0.006024096385542169,0.9939759036144579,166,4550,3300,1250,0.7252747252747253,58,33,25,210.8488461869096,0.40400921869295364,0.7202909232071859,0.1473190225478855,1151703.7698475902,10817.082204295879,1162520.852051886,3991,7,1722.2469879518073,84,82,43,32.02778426336677,0.6556299603174602,37.56127450980394,8776.934636428985,104.48731710034505,0
3994,33.84222441898475,0,0,165,0.0,0.0,1.0,165,4900,3800,1100,0.7755102040816326,60,38,22,210.20913987832847,0.4030841956146834,0.7200643828777618,0.14747142171054373,1166613.097093659,11146.54714216994,1177759.644235829,3992,8,1733.6363636363637,71,94,45,31.90815150513344,0.6627053990610329,37.42766203703702,8886.031987560053,125.15538010647961,0
3995,33.68892172867024,0,0,165,0.0,0.0,1.0,165,5000,3700,1300,0.74,63,37,26,209.0870124655175,0.40335211874846016,0.7194114228611985,0.14706399077007098,1162077.128081299,10595.046993005122,1172672.175074304,3993,9,1734.6363636363637,72,93,41,31.85122055015303,0.6630497685185186,37.34303652968034,8848.629883841735,122.89763727557965,0
3996,33.3611714988778,0,0,165,0.0,0.0,1.0,165,4300,3200,1100,0.7441860465116279,54,32,22,207.43313117149847,0.4028778640059128,0.717040633752507,0.14642518375625702,1151798.442950622,10484.231499940495,1162282.6744505623,3994,10,1735.6363636363637,75,90,46,31.775071284512162,0.6627777777777778,37.22587719298243,8766.452576432022,116.88603435242696,0
3997,33.15061437025489,0,0,165,0.0,0.0,1.0,165,4350,3100,1250,0.7126436781609196,56,31,25,209.8568391767844,0.4026530549396403,0.7224974586365815,0.14886049365839268,1145912.4822532549,10745.514299777882,1156657.9965530327,3995,11,1736.6363636363637,76,89,45,31.54927282705626,0.6639254385964912,37.06709956709955,8716.387187503662,114.68930509873239,0
3998,32.65509477387766,0,1,164,0.0,0.006060606060606061,0.9939393939393939,165,4950,3900,1050,0.7878787878787878,60,39,21,207.29724726340675,0.4025545084996305,0.7192392993349643,0.14747458392032212,1129597.1521371973,8882.476030924736,1138479.6281681221,3996,12,1737.6363636363637,76,89,46,31.519912907815986,0.6648848684210527,36.972402597402585,8589.191121327123,113.0156726490411,0
3999,32.63591069345236,0,0,164,0.0,0.0,1.0,164,4050,2900,1150,0.7160493827160493,52,29,23,205.12177492212714,0.4021163773754302,0.7137623073914392,0.14613118267019132,1129322.6017166837,9479.731304759709,1138802.3330214433,3997,13,1732.3170731707316,79,85,50,31.530884973272627,0.6640295358649789,36.92708333333331,8585.624214199297,108.67878752151009,0
4000,32.28992431901923,0,0,164,0.0,0.0,1.0,164,3700,2600,1100,0.7027027027027027,48,26,22,203.56304954713596,0.40180464112923336,0.7125941180256132,0.1455667844874792,1118382.7688821869,9032.281398925232,1127415.050281112,3998,14,1733.3170731707316,80,84,39,31.447889182058027,0.66484375,36.80555555555553,8498.528692297356,106.23160865371695,0
4001,32.3587601811307,0,1,163,0.0,0.006097560975609756,0.9939024390243902,164,3600,2800,800,0.7777777777777778,44,28,16,203.05815064948433,0.40147342136764924,0.7124737642035193,0.14559701440186312,1121506.3583406978,9146.201413259589,1130652.5597539574,3999,15,1734.3170731707316,83,81,40,31.372609627431558,0.6645331325301205,36.71874999999997,8519.454828938238,102.64403408359323,0
4002,32.5840186642457,0,0,163,0.0,0.0,1.0,163,4300,3200,1100,0.7441860465116279,54,32,22,210.0275366794984,0.4006759827311974,0.7331260355559546,0.14035986597605488,1109423.0318534723,9701.877303137015,1119124.9091566093,4000,16,1745.3496932515338,69,94,45,33.566900471411195,0.6473429951690821,39.047619047619044,8502.877251431722,123.23010509321337,8
4003,32.59760342644481,1,1,163,0.006097560975609756,0.006097560975609756,0.9939024390243902,164,4250,3100,1150,0.7294117647058823,54,31,23,206.89963135055632,0.40149524290488303,0.7312488692992118,0.13883807841306542,1111069.7071845597,8925.98256425112,1119995.6897488108,4001,0,1735.7012195121952,70,94,37,33.5064761744212,0.6482142857142856,38.908450704225345,8510.958781939715,121.58512545628165,0
4004,32.47838641213443,0,0,163,0.0,0.0,1.0,163,4400,3300,1100,0.75,55,33,22,210.68021714429995,0.4005134565376556,0.7354373750603149,0.1416203876574221,1107503.965617857,9665.835192908653,1117169.8008107657,4002,18,1747.3496932515338,70,93,37,33.34784644194755,0.6488095238095238,38.84976525821596,8481.738235563273,121.16768907947532,0
4005,32.242632279532586,0,0,163,0.0,0.0,1.0,163,4250,2900,1350,0.6823529411764706,56,29,27,209.6617739798083,0.4003667095862051,0.7349748771618128,0.14163614163614163,1100874.2375118146,9312.249113079362,1110186.486624894,4003,19,1748.3496932515338,73,90,41,33.20360195360196,0.648972602739726,38.68243243243244,8425.566239263017,115.41871560634269,0
4006,32.49068439797642,0,0,163,0.0,0.0,1.0,163,5500,4100,1400,0.7454545454545455,69,41,28,211.57078476654158,0.4005008331439824,0.7385271949527226,0.14366425308788067,1110815.6125746476,8903.226176668995,1119718.8387513165,4004,20,1749.3496932515338,63,100,42,32.976731399643164,0.656415343915344,38.509114583333336,8496.017831020334,134.85742588921164,0
4007,32.024192907503235,0,0,163,0.0,0.0,1.0,163,5150,3800,1350,0.7378640776699029,65,38,27,208.67087046687755,0.4002736120578656,0.7349061929486596,0.14217748626596535,1095821.1363523211,7983.190079728325,1103804.3264320495,4005,21,1750.3496932515338,63,100,41,32.93625178871401,0.6575727513227514,38.395182291666664,8377.68314782388,132.97909758450604,0
4008,31.906199288822343,0,0,163,0.0,0.0,1.0,163,4400,3300,1100,0.75,55,33,22,216.25821584673912,0.40013159887904265,0.7430842211046951,0.14356087985851268,1084450.28712025,9904.256853421604,1094354.5439736717,4006,22,1751.3496932515338,70,93,40,33.63684748560388,0.6444940476190476,39.27523474178402,8318.736319860023,118.83909028371461,8
4009,31.952031754223626,0,0,163,0.0,0.0,1.0,163,4150,3000,1150,0.7228915662650602,53,30,23,216.3163962641806,0.3996976697215279,0.7420928827998352,0.14396229130685062,1086725.0098731471,10265.287573182912,1096990.29744633,4007,23,1752.3496932515338,73,90,39,33.547423719055814,0.6438356164383562,39.18918918918917,8333.435308871802,114.156648066737,0
4010,31.77685127926692,0,0,163,0.0,0.0,1.0,163,4350,3500,850,0.8045977011494253,52,35,17,214.4865175462749,0.39907912343154334,0.740646596442325,0.14324771436693387,1081759.5641904527,9454.568349117046,1091214.1325395696,4008,24,1753.3496932515338,74,89,41,33.472835826191876,0.6445664414414414,39.06944444444443,8291.551458105349,112.0479926770993,0
4011,31.444892034651758,0,1,162,0.0,0.006134969325153374,0.9938650306748467,163,4900,3600,1300,0.7346938775510204,62,36,26,217.05721666976575,0.39933159130500645,0.7431777322299253,0.14531235039647653,1071126.451146172,8999.145237430292,1080125.5963836021,4009,25,1754.3496932515338,76,87,40,33.32264348156597,0.6444627192982456,38.988095238095234,8207.491164996893,107.99330480259069,0
4012,31.02060602120227,0,0,162,0.0,0.0,1.0,162,4150,3100,1050,0.7469879518072289,52,31,21,216.5616481875041,0.3990435613322087,0.741296311686072,0.1454989565963282,1057652.9251997862,9259.412138320198,1066912.3373381065,4010,26,1765.9876543209878,79,83,40,33.21205227291614,0.6443829113924051,38.8671875,8100.498095770988,102.5379505793796,0
4013,31.45815509878913,1,0,163,0.006134969325153374,0.0,1.0,163,3200,2000,1200,0.625,44,20,24,218.27026692381054,0.4002578328157742,0.7450344195485514,0.14716762272012027,1073555.2575046348,11065.038522599445,1084620.2960272343,4011,0,1756.1472392638036,80,83,42,33.04506112068259,0.6451822916666667,38.747427983539104,8218.52393045143,102.73154913064289,0
4014,31.1543918928893,0,0,163,0.0,0.0,1.0,163,4200,3200,1000,0.7619047619047619,52,32,20,217.81288362439903,0.39986335176348814,0.7458871918020751,0.14770368889205165,1064760.8087075704,9583.724422968735,1074344.533130539,4012,1,1757.1472392638036,81,82,42,32.85974725879858,0.6467335390946503,38.554369918699194,8145.179618236232,100.55777306464485,0
4015,30.93988192207298,0,0,163,0.0,0.0,1.0,163,5500,4300,1200,0.7818181818181819,67,43,24,221.53866454361136,0.39991857911080814,0.7495987990619888,0.15099608978104048,1058809.4170057033,8813.4448499287,1067622.861855632,4013,2,1758.1472392638036,65,98,41,32.58802887709138,0.6564102564102564,38.38383838383839,8094.3731493100095,124.52881768169246,0
4016,30.60600246620543,0,0,163,0.0,0.0,1.0,163,4000,2600,1400,0.65,54,26,28,217.58076193631302,0.3999753843823373,0.7447361739998932,0.1490529892516991,1048741.610909765,9037.199755212776,1057778.8106649776,4014,3,1759.1472392638036,69,94,40,32.51833219645293,0.6557971014492754,38.21428571428573,8012.214217045954,116.1190466238544,0
4017,30.28835519152991,0,1,162,0.0,0.006134969325153374,0.9938650306748467,163,4200,3300,900,0.7857142857142857,51,33,18,216.92016151102163,0.39990437779292587,0.744061768587412,0.14907702215916968,1038702.9286625492,8263.121409490492,1046966.0500720397,4015,4,1760.1472392638036,71,92,41,32.4266655618164,0.6558098591549295,38.10763888888891,7932.288855281782,111.72237824340539,0
4018,30.12653163460179,1,0,163,0.006134969325153374,0.0,1.0,163,3450,2500,950,0.7246376811594203,44,25,19,212.28689164183515,0.4000779494559317,0.7369175340586658,0.1356536132049701,1013623.037718607,6985.776794767466,1020608.8145133745,4016,0,1760.7852760736196,68,95,41,35.08797454848782,0.6321997549019608,40.594806763285014,7814.978760225866,114.92615823861567,8
4019,30.360299840194298,2,0,165,0.012121212121212121,0.0,1.0,165,4950,3400,1550,0.6868686868686869,65,34,31,202.31122947153372,0.40181079083518106,0.7241863225764484,0.12715243714003524,1016880.3659792534,3195.2634133453766,1020075.6293925988,4017,0,1740.430303030303,74,91,41,35.94434755388608,0.623170045045045,41.18055555555557,7857.835937805875,106.18697213251183,8
4020,30.228859757372845,0,1,164,0.0,0.006060606060606061,0.9939393939393939,165,4650,3600,1050,0.7741935483870968,57,36,21,230.37080085250912,0.4019462921901946,0.7574765076018068,0.14570337529775873,1014226.7738996758,9079.646829864905,1023306.4207295408,4018,1,1741.430303030303,68,97,34,34.98953416088739,0.6285232843137255,40.957125603864725,7830.570721267501,115.1554517833456,8
4021,30.478188087531198,1,1,164,0.006060606060606061,0.006060606060606061,0.9939393939393939,165,3950,2700,1250,0.6835443037974683,52,27,25,227.6710446709736,0.40165681202266573,0.7550571300501525,0.14458442982206632,1023729.728805604,9664.72336358086,1033394.4521691849,4019,0,1742.418181818182,71,94,36,34.91214299004559,0.6283744131455399,40.8130787037037,7899.547737096662,111.2612357337558,0
4022,30.971635937642468,0,0,164,0.0,0.0,1.0,164,4000,2800,1200,0.7,52,28,24,225.54437264874144,0.40098711282358224,0.7517073421996201,0.1435645393640216,1040956.3746236385,10156.370493839244,1051112.7451174776,4020,1,1754.0243902439024,77,87,39,34.88419010336183,0.6263528138528138,40.7318376068376,8029.959135862578,104.28518358263088,0
4023,30.916541781892317,0,0,164,0.0,0.0,1.0,164,4900,3900,1000,0.7959183673469388,59,39,20,241.3367249613296,0.4011842859993017,0.7616751614376729,0.14715592667114494,1026826.2267138564,11862.175731904503,1038688.4024457609,4021,2,1755.0243902439024,70,94,35,36.04817745393829,0.6141369047619047,42.26819248826292,7968.176195459265,113.83108850656093,8
4024,31.39075574297174,2,0,166,0.012048192771084338,0.0,1.0,166,3500,2200,1300,0.6285714285714286,48,22,26,239.57202537212552,0.40309723743458686,0.7630627651439128,0.14660704607178118,1043633.3803036279,13305.07253305981,1056938.4528366877,4022,0,1734.867469879518,72,94,38,35.95989430579385,0.6144386574074074,42.13755707762559,8094.496961062283,112.42356890364282,0
4025,31.89557479151604,1,0,167,0.005988023952095809,0.0,1.0,167,4400,3100,1300,0.7045454545454546,57,31,26,239.54971393078884,0.40371816607748356,0.7656736424943491,0.1475740714267206,1062399.2047116044,13099.48511379271,1075498.6898253972,4023,0,1725.4730538922156,76,91,33,35.71378653668084,0.6149945175438596,41.896645021645035,8232.354862653368,108.32045871912327,0
4026,31.908903337703126,0,2,165,0.0,0.011976047904191617,0.9880239520958084,167,5600,3900,1700,0.6964285714285714,73,39,34,209.58537376370253,0.40401576365341607,0.7413259200630788,0.12765269021243558,1059451.5297705317,5409.10897029676,1064860.6387408285,4024,1,1726.4730538922156,72,95,40,36.90795909703376,0.6127025462962963,42.30878995433791,8222.643912322816,114.20338767115021,8
4027,32.07986832623497,0,2,163,0.0,0.012121212121212121,0.9878787878787879,165,4400,3300,1100,0.75,55,33,22,210.22344658708246,0.40337521557033756,0.7397367615549424,0.12846988402543966,1066130.8779074086,7425.14153332159,1073556.0194407303,4025,2,1744.2545454545455,71,94,42,36.76767676767674,0.6144366197183099,42.18750000000001,8270.591052857473,116.48719792757005,0
4028,31.5949182667328,0,0,163,0.0,0.0,1.0,163,4200,3000,1200,0.7142857142857143,54,30,24,211.36269542871395,0.4012424575222803,0.7375778004043991,0.129568372978934,1050931.7146394658,7625.551983543615,1058557.2666230095,4026,3,1766.5889570552147,73,90,40,36.62331268533175,0.6145833333333333,42.0748873873874,8149.122851933378,111.63181988949833,0
4029,31.481905168467506,0,0,163,0.0,0.0,1.0,163,4400,2900,1500,0.6590909090909091,59,29,30,208.5745069472466,0.40125665884016254,0.7342566661944663,0.12827228614938466,1048119.2256255437,6722.190141355715,1054841.4157668995,4027,4,1767.5889570552147,74,89,40,36.57624199364878,0.6152871621621622,41.95833333333335,8123.643279513339,109.77896323666674,0
4030,31.30695598683672,1,0,164,0.006097560975609756,0.0,1.0,164,4250,3000,1250,0.7058823529411765,55,30,25,204.3713423855066,0.4022480859394484,0.7308832360193673,0.12642413888980375,1043995.8862770539,5622.568144677879,1049618.4544217316,4028,0,1757.8048780487804,76,88,43,36.469901344508465,0.6165021929824561,41.74783549783552,8085.089147574628,106.38275194177143,0
4031,31.628597606561506,1,0,165,0.006060606060606061,0.0,1.0,165,4400,3500,900,0.7954545454545454,53,35,18,203.06625710207032,0.40306417836905645,0.7309532028031946,0.1262728389150138,1056248.4304876274,5497.68306981163,1061746.113557439,4029,0,1748.1454545454546,68,97,43,36.31296610004476,0.6223958333333333,41.56099033816424,8174.063442432435,120.20681532988876,0
4032,32.0277629564007,1,0,166,0.006024096385542169,0.0,1.0,166,3950,2700,1250,0.6835443037974683,52,27,25,201.60582828163376,0.40437811853474503,0.7309160702180497,0.12614515864619671,1071414.587204058,6050.685057259602,1077465.2722613176,4030,0,1738.6084337349398,69,97,45,36.12453495953668,0.6240942028985508,41.3392857142857,8284.324043276112,120.0626672938567,0
4033,31.630670108117606,0,0,166,0.0,0.0,1.0,166,4350,3400,950,0.7816091954022989,53,34,19,198.75174748079368,0.40432715711330164,0.7274143344737887,0.12480534260639743,1059173.616068736,4552.521415842269,1063726.1374845782,4031,1,1739.6084337349398,70,96,46,36.0683948447569,0.6248511904761904,41.21185446009388,8185.642459464259,116.937749420918,0
4034,31.74037589685143,0,0,166,0.0,0.0,1.0,166,4450,3100,1350,0.6966292134831461,58,31,27,200.11795519078055,0.4043705123524401,0.728733246859723,0.12625700669579729,1064221.7908101433,4943.977729279131,1069165.7685394224,4032,2,1740.6084337349398,71,95,42,35.86239687505819,0.6260269953051643,41.04456018518517,8219.343000256673,115.7653943698123,0
4035,32.004381062334815,0,0,166,0.0,0.0,1.0,166,3800,2900,900,0.7631578947368421,47,29,18,203.54424592959677,0.40430053547523426,0.7327325721044691,0.12883940656985796,1074033.0493117557,6722.64942512525,1080755.698736881,4033,3,1741.6084337349398,71,95,43,35.65557463561735,0.6272007042253521,40.928819444444436,8291.412784768923,116.78046175730879,0
4036,32.39619987800649,0,1,165,0.0,0.006024096385542169,0.9939759036144579,166,3850,2800,1050,0.7272727272727273,49,28,21,205.3914467150502,0.4043986552269685,0.7353657250885137,0.1297287067665714,1086542.2224119124,7583.295795633837,1094125.5182075463,4034,4,1742.6084337349398,73,93,39,35.6855331811511,0.6254280821917808,41.00506756756758,8390.451598471902,114.93769312975208,8
4037,32.338428019478435,0,0,165,0.0,0.0,1.0,165,3700,2100,1600,0.5675675675675675,53,21,32,205.59141876014354,0.4031611850209411,0.7335933549294784,0.13020311790819455,1085397.7327637246,7929.691959587644,1093327.4247233123,4035,6,1754.1454545454546,72,93,39,35.58372803877291,0.626880787037037,40.91038812785389,8378.550764122027,116.36876061280593,0
4038,31.824202596828478,0,0,165,0.0,0.0,1.0,165,4300,3100,1200,0.7209302325581395,55,31,24,204.5618549502906,0.4028593865484109,0.7329173577653156,0.13008325693247774,1069331.208518003,6448.87511413581,1075780.083632139,4036,7,1755.1454545454546,73,92,41,35.46282218360848,0.6278538812785388,40.76576576576577,8249.922790303968,113.01264096306805,0
4039,32.05009283869965,0,0,165,0.0,0.0,1.0,165,4250,3400,850,0.8,51,34,17,206.60957081337364,0.4032920670115792,0.7350614579530239,0.13191226444238494,1078091.2576455192,7298.79440795829,1085390.0520534776,4037,8,1756.1454545454546,76,89,41,35.26606425702813,0.6278782894736843,40.62500000000001,8312.992830037738,109.38148460575971,0
4040,31.716671311698814,0,0,165,0.0,0.0,1.0,165,4500,3500,1000,0.7777777777777778,55,35,20,206.892930348894,0.403219696969697,0.7353187166196256,0.13267146199738666,1068136.286709392,6697.96927385839,1074834.2559832504,4038,9,1757.1454545454546,67,98,39,35.10235902884347,0.6340174129353233,40.471813725490186,8231.370180189953,122.8562713461187,0
4041,31.74204776163626,1,0,166,0.006024096385542169,0.0,1.0,166,4100,3000,1100,0.7317073170731707,52,30,22,202.58290161821358,0.4042503346720214,0.7308765146546079,0.1304454477209529,1070181.0624975234,6060.076979522157,1076241.1394770455,4039,0,1747.55421686747,69,97,43,35.0668576886342,0.6343599033816425,40.32738095238095,8242.54067619869,119.45711124925639,0
4042,31.82567563124799,0,1,165,0.0,0.006024096385542169,0.9939759036144579,166,4000,2900,1100,0.725,51,29,22,218.96617934918817,0.4043545393695996,0.7520381757978789,0.1335385290960544,1057072.7215183997,9092.635025026593,1066165.3565434262,4040,1,1748.55421686747,62,104,41,36.61831216320243,0.6189516129032258,42.261904761904766,8202.689016863333,132.3014357558602,8
4043,31.561398947450765,1,0,166,0.006024096385542169,0.0,1.0,166,3750,2600,1150,0.6933333333333334,49,26,23,216.0116116211791,0.4052163198247536,0.7476490686186363,0.13242046589694484,1049821.7543682214,8404.737815210778,1058226.4921834322,4041,0,1747.710843373494,68,98,38,36.502780216564254,0.6171875,42.07427536231885,8140.496694100204,119.71318667794418,0
4044,31.90988629608367,0,0,166,0.0,0.0,1.0,166,4000,3200,800,0.8,48,32,16,214.19530393338266,0.4051699221126932,0.745705302002041,0.13157922339111344,1062029.6000349035,8296.350593145096,1070325.9506280485,4042,1,1748.710843373494,71,95,38,36.47317005925342,0.616343896713615,41.999421296296305,8232.76913075899,115.95449479942239,0
4045,31.460731579788185,1,0,167,0.005988023952095809,0.0,1.0,167,4800,3500,1300,0.7291666666666666,61,35,26,212.11476544394222,0.40533391049226847,0.7452234104077382,0.13074112450237227,1048068.0603272228,6262.142157119422,1054330.2024843423,4043,0,1739.2335329341317,73,94,39,36.402662649288324,0.6165810502283104,41.877815315315324,8120.712767153396,111.24264064593693,0
4046,31.241378421318622,0,0,167,0.0,0.0,1.0,167,3850,2800,1050,0.7272727272727273,49,28,21,213.83536744099513,0.40543611572036653,0.7466046822018606,0.1321684558332113,1041567.5003732129,7294.793831381166,1048862.294204594,4044,1,1740.2335329341317,74,93,40,36.256073400745855,0.6171171171171171,41.77777777777779,8067.218161238309,109.01646163835554,0
4047,31.725205046009293,0,0,167,0.0,0.0,1.0,167,3750,2700,1050,0.72,48,27,21,214.69373877177875,0.405189620758483,0.7476272248540476,0.13290699124229335,1058159.1277152516,8286.027868934438,1066445.155584186,4045,2,1741.2335329341317,75,92,41,36.176413358805625,0.6172222222222222,41.721491228070185,8193.93864976701,109.25251533022679,0
4048,31.39439857183713,0,0,167,0.0,0.0,1.0,167,4000,2600,1400,0.65,54,26,28,213.22580828692182,0.40564052617656254,0.7458143831492099,0.1322573070662109,1047696.1311957245,7279.170882657974,1054975.3020783823,4046,3,1742.2335329341317,66,101,41,36.142454514453085,0.6226325757575757,41.65111940298509,8110.707728050672,122.88951103107078,0
4049,31.794664679718867,1,0,168,0.005952380952380952,0.0,1.0,168,4900,3900,1000,0.7959183673469388,59,39,20,212.14722873859859,0.40645568981085445,0.7461354313025119,0.1323215420048072,1062688.3683296868,6589.278470777381,1069277.6468004643,4047,0,1732.857142857143,67,101,42,35.96718608049927,0.6240671641791045,41.452205882352956,8220.440417651611,122.69314056196434,0
4050,32.07259322608808,0,0,168,0.0,0.0,1.0,168,3950,2300,1650,0.5822784810126582,56,23,33,219.30322192957354,0.4063532161866743,0.7502459483249635,0.1323977219482918,1062228.4051859141,9040.022336476715,1071268.4275223908,4048,1,1733.857142857143,66,102,38,36.986403084853634,0.6126893939393939,42.63059701492538,8254.504170781443,125.06824501184005,8
4051,32.23981766959963,0,1,167,0.0,0.005952380952380952,0.9940476190476191,168,4650,3400,1250,0.7311827956989247,59,34,25,216.9447541382474,0.40683810949529514,0.7475904462956242,0.13164493762103305,1069315.406032871,8146.473571608145,1077461.879604479,4049,2,1734.857142857143,66,102,39,36.856488188659476,0.6145833333333333,42.44402985074626,8303.557517328776,125.81147753528448,0
4052,32.09497171693878,1,0,168,0.005952380952380952,0.0,1.0,168,4750,3300,1450,0.6947368421052632,62,33,29,212.97277174777471,0.40650989687292083,0.7447592561614804,0.13028563543882482,1066945.1333056425,7096.0524685803175,1074041.185774223,4050,0,1735.8392857142858,68,100,40,36.65825039032005,0.616421568627451,42.149758454106276,8275.696209621285,121.70141484737184,0
4053,32.573424420294444,1,0,169,0.005917159763313609,0.0,1.0,169,4200,2700,1500,0.6428571428571429,57,27,30,208.98619630643094,0.40747540386963466,0.7419369488932195,0.12857146578642242,1084567.4259999467,7331.92419951713,1091899.3501994638,4051,0,1726.5621301775147,70,99,41,36.55243807682832,0.6174107142857144,41.94542253521127,8405.721275360323,120.08173250514749,0
4054,32.06612396566199,1,1,169,0.0058823529411764705,0.0058823529411764705,0.9941176470588236,170,4500,2800,1700,0.6222222222222222,62,28,34,208.3035396998996,0.40874013806706117,0.7427794662665577,0.12894579441342052,1069517.8294776024,6056.8699304679285,1075574.6994080704,4052,0,1717.4,73,97,45,36.34297107768331,0.6181506849315068,41.722972972973,8281.943166131337,113.45127624837448,0
4055,32.24434998548453,0,0,169,0.0,0.0,1.0,169,4850,3400,1450,0.7010309278350515,63,34,29,207.33640091216907,0.4092790222597915,0.7400333904984728,0.12890485068644358,1076757.78843777,6000.2169017666565,1082758.0053395366,4053,1,1721.6449704142012,62,107,43,36.20921305182342,0.626008064516129,41.5674603174603,8332.989257161398,134.40305253486127,0
4056,32.277941815573676,0,1,168,0.0,0.005917159763313609,0.9940828402366864,169,5200,4300,900,0.8269230769230769,61,43,18,207.44834589954624,0.40957399971823044,0.7411156417077982,0.1294265898199255,1078923.7783036535,5764.190632156229,1084687.9689358098,4054,2,1722.6449704142012,64,105,47,36.078571133424234,0.6259765625,41.442307692307686,8345.71014827668,130.40172106682311,0
4057,31.83166200032584,1,0,169,0.005917159763313609,0.0,1.0,169,4300,3100,1200,0.7209302325581395,55,31,24,202.37861818287283,0.40992034141072603,0.7344702557915523,0.12684680170173912,1065359.2689523387,5021.187343777789,1070380.4562961166,4055,0,1723.5502958579882,66,103,46,36.04200468721831,0.6264204545454546,41.27798507462685,8235.551731147698,124.78108683557117,0
4058,32.01250719368289,0,0,169,0.0,0.0,1.0,169,4650,3600,1050,0.7741935483870968,57,36,21,200.03806269556804,0.41006269371653986,0.7315533883696781,0.12590105107979113,1072633.6415147737,4463.511126141343,1077097.152640915,4056,1,1724.5502958579882,67,102,45,35.95213967295895,0.6273320895522387,41.13051470588234,8287.061260202901,123.68748149556569,0
4059,32.278106514253096,3,1,171,0.01744186046511628,0.005813953488372093,0.9941860465116279,172,4200,3300,900,0.7857142857142857,51,33,18,193.55188426852197,0.41191732966136274,0.7273126951881372,0.12268950019335201,1083640.830622454,3348.144927456299,1086988.9755499102,4057,0,1695.453488372093,73,99,41,35.86303056642037,0.6267123287671232,40.878378378378365,8363.955302848666,114.57473017600913,0
4060,32.29622963517944,0,1,170,0.0,0.005847953216374269,0.9941520467836258,171,4250,2500,1750,0.5882352941176471,60,25,35,192.2249737325318,0.41095917899323475,0.7239299899808476,0.12229282071204549,1085323.8802047821,3275.27087273047,1088599.1510775127,4058,1,1706.3684210526317,74,97,44,35.76656755598419,0.6275337837837838,40.74999999999998,8372.797532920209,113.14591260702986,0
4061,32.68837936104667,0,0,170,0.0,0.0,1.0,170,4600,3100,1500,0.6739130434782609,61,31,30,193.25225844397113,0.41004756932358744,0.7240038560411333,0.12323791563066275,1099208.5007317571,3884.9050534443923,1103093.4057852016,4059,2,1717.3882352941177,74,96,45,35.65499143101972,0.6283783783783784,40.66666666666664,8477.186380964707,114.55657271573929,0
4062,32.632285473832624,0,0,170,0.0,0.0,1.0,170,3750,2600,1150,0.6933333333333334,49,26,23,191.11098516653016,0.40987063464439033,0.7209980827475069,0.12223019806572318,1098193.5647717777,4225.370813415581,1102418.9355851933,4060,3,1718.3882352941177,67,103,46,35.60561328924581,0.6330845771144278,40.56372549019608,8465.998572071521,126.35818764285852,0
4063,32.98289105173587,1,1,170,0.005847953216374269,0.005847953216374269,0.9941520467836258,171,4150,2900,1250,0.6987951807228916,54,29,25,189.03040559606652,0.41070978098841876,0.7199200830010428,0.12145986834708603,1111378.8456372414,3666.8787923392197,1115045.7244295806,4061,0,1709.3333333333333,69,102,46,35.49459014044136,0.6336050724637681,40.401785714285715,8562.299619010906,124.09129882624502,0
4064,32.74145529174161,0,0,170,0.0,0.0,1.0,170,3950,2400,1550,0.6075949367088608,55,24,31,189.43337671307057,0.4102404571295974,0.7192137088619528,0.12208239624802504,1104129.0739395958,3881.779760690784,1108010.8537002867,4062,1,1720.1941176470589,69,101,47,35.37798915119564,0.6346618357487923,40.29761904761906,8503.033895111257,123.23237529146749,0
4065,32.65014453914088,0,0,170,0.0,0.0,1.0,170,5700,4100,1600,0.7192982456140351,73,41,32,187.27089647372733,0.40947833275321965,0.7162976549194275,0.12115941284827635,1102199.775557297,1581.9880123513017,1103781.7635696484,4063,2,1721.1941176470589,71,99,44,35.29602821083888,0.6349765258215962,40.162037037037045,8483.747047496701,119.4893950351648,0
4066,32.65683013445894,0,0,170,0.0,0.0,1.0,170,4950,3200,1750,0.6464646464646465,67,32,35,187.7106305845491,0.4092143810186797,0.7173919501924613,0.12177125522536167,1103219.3751577046,2467.200916789096,1105686.5760744936,4064,3,1722.1941176470589,72,98,49,35.18930244473723,0.6354166666666667,40.068493150684944,8488.539065772062,117.89637591350086,0
4067,32.13765072345425,0,0,170,0.0,0.0,1.0,170,5200,4100,1100,0.7884615384615384,63,41,22,187.85032970395008,0.40921220559229604,0.7179526886313863,0.12244598414082469,1087065.1147311644,1641.1080423826156,1088706.222773547,4065,4,1723.1941176470589,74,96,43,35.01684288282514,0.6361204954954955,39.9027777777778,8358.913681918497,112.9582929988986,0
4068,32.095267976475284,0,0,170,0.0,0.0,1.0,170,4950,3900,1050,0.7878787878787878,60,39,21,192.8232079402278,0.4089250493096647,0.7246189314897853,0.1260021671714062,1086353.2183512186,2944.822503734612,1089298.0408549532,4066,5,1724.1941176470589,75,95,43,34.79939287783808,0.6365277777777778,39.816337719298254,8350.664363999886,111.34219151999848,0
4069,31.93716072889855,0,0,170,0.0,0.0,1.0,170,3900,2100,1800,0.5384615384615384,57,21,36,196.0277725472692,0.40858785822021115,0.7284276035971282,0.1284019100689929,1081685.0980387463,4508.064073222087,1086193.1621119683,4067,6,1725.1941176470589,75,95,44,34.63216642968738,0.637361111111111,39.73410087719299,8312.153852536409,110.82871803381877,0
4070,32.241848379282345,1,0,171,0.005847953216374269,0.0,1.0,171,4050,2800,1250,0.691358024691358,53,28,25,196.19911637108916,0.4092205595688568,0.730531279160918,0.12892991517403987,1092938.0334232952,4636.695281201329,1097574.7287044965,4068,0,1716.0994152046783,78,93,46,34.514314410627804,0.6371527777777778,39.62289029535865,8395.039292532812,107.6287088786258,0
4071,32.49036328390733,0,0,171,0.0,0.0,1.0,171,4800,3300,1500,0.6875,63,33,30,195.09191200648854,0.4092893590184612,0.7291888748571516,0.12858260793692838,1102223.1351123843,4006.9637773723853,1106230.0988897567,4069,1,1717.0994152046783,66,105,47,34.43941247861205,0.6442550505050505,39.521144278606975,8463.052650164565,128.22807045703888,0
4072,32.72251047965235,0,0,171,0.0,0.0,1.0,171,5050,3700,1350,0.7326732673267327,64,37,27,194.35832688023908,0.40919475977525516,0.7277822640389886,0.12849706562610802,1111005.010252161,3936.614989634718,1114941.6252417956,4070,2,1718.0994152046783,67,104,46,34.35013863578466,0.6447450248756219,39.41482843137256,8527.00100749645,127.26867175367836,0
4073,32.49673366663068,0,0,171,0.0,0.0,1.0,171,4250,2900,1350,0.6823529411764706,56,29,27,195.5768409963485,0.4090313610824447,0.7297236528882514,0.1298083029979613,1104469.539905973,4751.732718300373,1109221.2726242733,4071,3,1719.0994152046783,68,103,46,34.18234896738082,0.6455269607843137,39.28140096618359,8472.502874739044,124.5956305108683,0
4074,32.10536172123866,0,0,171,0.0,0.0,1.0,171,4800,3500,1300,0.7291666666666666,61,35,26,195.4890785607239,0.4088550624928334,0.7302731258072344,0.13013053854667003,1092003.923828639,3694.9681707913132,1095698.8919994305,4072,4,1720.0994152046783,69,102,47,34.08283172628897,0.6459842995169083,39.181547619047635,8373.67075726417,121.3575472067271,0
4075,32.20470836391299,0,0,171,0.0,0.0,1.0,171,5800,4600,1200,0.7931034482758621,70,46,24,194.88449072779287,0.4086973970874899,0.7292322749423323,0.13001672294836464,1096018.491556256,2719.4011110370457,1098737.892667293,4073,5,1721.0994152046783,71,100,48,34.02148145067378,0.6456866197183099,39.105902777777786,8402.018314908048,118.33828612546546,0
4076,32.650563303772394,1,0,172,0.005813953488372093,0.0,1.0,172,4700,3300,1400,0.7021276595744681,61,33,28,192.4175723151428,0.4093772666485335,0.7271142219211744,0.12869486979519357,1111921.7789871101,3690.6578634071448,1115612.4368505173,4074,0,1712.0872093023256,73,99,49,33.998561668464575,0.6455479452054795,39.02027027027029,8521.135186541998,116.72787926769861,0
4077,32.90620380302595,0,0,172,0.0,0.0,1.0,172,4900,3900,1000,0.7959183673469388,59,39,20,191.4311511643708,0.40910031053084905,0.7255831655693328,0.12844564982494222,1121559.970316229,3640.303243502851,1125200.2735597317,4075,1,1713.0872093023256,75,97,42,33.91368969499711,0.6456944444444445,38.91173245614036,8591.423742377245,114.55231656502993,0
4078,32.45348362585956,0,2,170,0.0,0.011627906976744186,0.9883720930232558,172,4100,3200,900,0.7804878048780488,50,32,18,192.06392604001852,0.4089473117548393,0.7263749612046355,0.12921204683744975,1106889.1390935048,4018.6947490712455,1110907.833842576,4076,2,1714.0872093023256,77,95,45,33.805830393209604,0.645698051948052,38.82211538461541,8476.13220180208,110.0796389844426,0
4079,32.30380647489341,0,0,170,0.0,0.0,1.0,170,3600,2400,1200,0.6666666666666666,48,24,24,195.10652466060367,0.40800411880728626,0.7283943095622496,0.13145523346811855,1102209.9705375992,5409.671359571726,1107619.6418971708,4077,9,1733.0117647058823,76,94,45,33.67490937338169,0.6466557017543859,38.77164502164504,8438.67022497559,111.03513453915251,0
4080,32.443809781354915,1,0,171,0.005847953216374269,0.0,1.0,171,4000,2900,1100,0.725,51,29,22,194.0517619528039,0.4084952987042771,0.7284467625310251,0.13118265120090122,1107943.0373777791,4799.659709300246,1112742.6970870793,4078,0,1723.8713450292398,79,92,46,33.587483184694364,0.6464926160337553,38.65885416666669,8478.902423458068,107.32787877795023,0
4081,32.75314211436013,0,1,170,0.0,0.005847953216374269,0.9941520467836258,171,4600,2800,1800,0.6086956521739131,64,28,36,194.45359999157807,0.4083333333333334,0.7296015603085999,0.1317598692889279,1119175.4418975792,4725.538739830096,1123900.9806374093,4079,1,1724.8713450292398,79,92,46,33.49733733459514,0.6472837552742616,38.580729166666686,8562.302529036619,108.38357631691922,0
4082,32.85500299344528,0,0,170,0.0,0.0,1.0,170,4850,3400,1450,0.7010309278350515,63,34,29,192.60598227256511,0.4077597459101984,0.7256282039625992,0.1309627256988313,1123659.43101368,4434.705690044189,1128094.1367037243,4080,2,1735.7235294117647,66,104,48,33.42658918876077,0.6549873737373737,38.4639303482587,8592.768351301855,130.1934598682099,0
4083,33.063819408349744,1,0,171,0.005847953216374269,0.0,1.0,171,4550,3200,1350,0.7032967032967034,59,32,27,188.9748124808491,0.40823730076826054,0.721884808325959,0.12893846052971533,1131801.9311844802,4026.411542209907,1135828.34272669,4081,0,1726.5672514619882,69,102,46,33.40365457165066,0.6544384057971014,38.34821428571428,8651.207390729349,125.37981725694708,0
4084,33.11971365443188,1,0,172,0.005813953488372093,0.0,1.0,172,4700,3300,1400,0.7021276595744681,61,33,28,188.94806830414666,0.4086186477174849,0.7231355252606266,0.12951531227393287,1135048.1727408217,3793.0319343057963,1138841.2046751275,4082,0,1717.5232558139535,71,101,49,33.24767904509284,0.6549295774647887,38.194444444444436,8670.925033139434,122.1257046921047,0
4085,32.58182114230724,0,0,172,0.0,0.0,1.0,172,3900,2400,1500,0.6153846153846154,54,24,30,190.00103781935857,0.40804702729044834,0.7249556726198125,0.13046353507323166,1117107.7131139245,4150.324969531135,1121258.0380834555,4083,1,1718.5232558139535,71,101,47,33.161141804788215,0.6555164319248826,38.13657407407407,8531.987307230327,120.1688353131032,0
4086,32.536604565171984,0,0,172,0.0,0.0,1.0,172,4600,3600,1000,0.782608695652174,56,36,20,194.03374781511062,0.40785861213110297,0.7301803287701365,0.13375393016054965,1116663.7440447847,4334.090261252586,1120997.8343060373,4084,2,1719.5232558139535,73,99,47,32.923203667884536,0.6558219178082192,38.00675675675676,8524.370554152321,116.77219937194961,0
4087,32.46201314161069,0,0,172,0.0,0.0,1.0,172,3900,2600,1300,0.6666666666666666,52,26,26,220.06569833488467,0.40761778072442084,0.7523040775510437,0.13756447270380615,1085656.3420744129,9483.14421406022,1095139.486288473,4085,3,1720.5232558139535,70,102,39,35.68175156947281,0.6232142857142857,41.373239436619706,8395.54530018062,119.93636143115171,7
4088,31.96067494367367,0,1,171,0.0,0.005813953488372093,0.9941860465116279,172,4700,3700,1000,0.7872340425531915,57,37,20,222.29525917904806,0.407900403463439,0.7546382611643345,0.13968286518338893,1070420.8319275994,8489.89525279935,1078910.7271803988,4086,4,1721.5232558139535,73,99,39,35.43479640306029,0.6235730593607306,41.18806306306305,8271.804187983973,113.31238613676675,0
4089,32.280237085846714,1,2,170,0.005813953488372093,0.011627906976744186,0.9883720930232558,172,5200,3900,1300,0.75,65,39,26,225.07097555360082,0.40880281291083004,0.755802729639939,0.14217898211800656,1082695.2919778437,9136.657118548837,1091831.9490963926,4087,0,1702.3953488372092,74,98,33,35.17066173316172,0.625,41.00000000000001,8360.581405234314,112.9808298004637,0
4090,32.113761091779764,0,0,170,0.0,0.0,1.0,170,5250,3900,1350,0.7428571428571429,66,39,27,224.08565004966624,0.40772203851954986,0.7520525018419311,0.1419355434741619,1077898.1743426917,9058.302616986135,1086956.4769596779,4088,6,1720.0058823529412,77,93,36,35.09951162311222,0.6245941558441559,40.90544871794872,8320.500520053683,108.0584483123855,0
4091,32.44612494661183,0,0,170,0.0,0.0,1.0,170,4700,3600,1100,0.7659574468085106,58,36,22,224.2974470278574,0.40788737092470123,0.7538119065442652,0.14250046315429465,1089952.2926028478,10194.703322596075,1100146.995925444,4089,7,1721.0058823529412,77,93,37,34.984790131725845,0.6256764069264069,40.79861111111113,8410.080650224252,109.22182662628899,0
4092,32.50996140780638,1,0,171,0.005847953216374269,0.0,1.0,171,4200,2900,1300,0.6904761904761905,55,29,26,224.67379558394194,0.4091632266941865,0.7553958524155102,0.14344557718051695,1093560.1764569266,10738.863108804693,1104299.0395657313,4090,0,1711.93567251462,80,91,39,34.797523427041526,0.626171875,40.62500000000001,8432.271240149796,105.40339050187245,0
4093,32.22300511571322,1,0,172,0.005813953488372093,0.0,1.0,172,5700,4000,1700,0.7017543859649122,74,40,34,219.72186011189984,0.41022159322725416,0.7513774263156827,0.1411433643769659,1085697.2879119334,7610.285523690865,1093307.5734356241,4091,0,1702.9767441860465,72,100,41,34.70722020668427,0.6319444444444444,40.410958904109584,8364.738999215951,116.17693054466599,0
4094,32.26692899697607,1,0,173,0.005780346820809248,0.0,1.0,173,4750,3500,1250,0.7368421052631579,60,35,25,216.15306976747374,0.4110361495720751,0.7480465331032666,0.13963753525469297,1088829.1511611617,7720.752695159485,1096549.9038563212,4092,0,1694.1271676300578,75,98,41,34.59845766944531,0.6325000000000001,40.21381578947368,8382.502360316383,111.76669813755177,0
4095,32.6823474962697,0,0,173,0.0,0.0,1.0,173,6250,5000,1250,0.8,75,50,25,218.16360398644656,0.4110879598512345,0.7513833473533118,0.14209090381378062,1105253.5221206292,7375.2183409098,1112628.740461539,4093,1,1695.1271676300578,77,96,33,34.25678682688026,0.634469696969697,39.930555555555536,8499.679956495092,110.38545398045575,0
4096,33.100436744170636,0,0,173,0.0,0.0,1.0,173,5650,4600,1050,0.8141592920353983,67,46,21,222.43774705868427,0.4114044226374513,0.7563297053118618,0.14544686880238783,1120565.7070845661,9601.222263022319,1130166.9293475884,4094,2,1696.1271676300578,78,95,35,34.00634691395558,0.6354166666666667,39.794303797468345,8612.922187624757,110.42207932852253,0
4097,33.16511535234987,0,1,172,0.0,0.005780346820809248,0.9942196531791907,173,4900,3900,1000,0.7959183673469388,59,39,20,220.65520661436773,0.411058554017117,0.7548948490353131,0.14478370678835062,1123789.5994171065,10094.005250091712,1133883.6046671981,4095,3,1697.1271676300578,79,94,36,33.930261008019464,0.636207805907173,39.67447916666666,8633.725927598036,109.28766996959538,0
4098,32.90503893296306,1,0,173,0.005780346820809248,0.0,1.0,173,4750,3500,1250,0.7368421052631579,60,35,25,216.8983309907865,0.41131060402383834,0.7516574738326673,0.14301034395284737,1116404.794731995,9079.267337496152,1125484.0620694913,4096,0,1698.1040462427745,68,105,39,33.85781898966485,0.6432291666666667,39.50785024154589,8571.504329533162,126.05153425784061,0
4099,32.52879624525787,0,0,173,0.0,0.0,1.0,173,4500,3000,1500,0.6666666666666666,60,30,30,218.28084570883982,0.41108375901778915,0.7533925174594067,0.14443013566392118,1104663.20903193,9125.363898186159,1113788.5729301162,4097,1,1699.1040462427745,68,105,39,33.69839637760917,0.6444546568627452,39.387077294685994,8477.424661562305,124.66800972885743,0
4100,32.98764530555725,0,0,173,0.0,0.0,1.0,173,5000,3500,1500,0.7,65,35,30,220.22100649154106,0.41100394318232736,0.7555053828283922,0.14627416511542,1121373.0809475651,9789.981707758609,1131163.0626553237,4098,2,1700.1040462427745,69,104,40,33.5138207206179,0.6452294685990339,39.25595238095238,8601.332158392464,124.65698780278935,0
4101,33.156120505172424,0,0,173,0.0,0.0,1.0,173,4850,3400,1450,0.7010309278350515,63,34,29,216.5532961805532,0.4109941412376215,0.751126971146918,0.14447799825091373,1128407.9196680554,9422.090888071787,1137830.0105561272,4099,3,1701.1040462427745,73,100,42,33.45495665623542,0.6446917808219178,39.10472972972974,8650.275020310635,118.49691808644705,0
4102,32.872936796774404,0,0,173,0.0,0.0,1.0,173,4150,2900,1250,0.6987951807228916,54,29,25,219.10236422348845,0.41062026706098487,0.7533213774342686,0.14690789757370987,1120219.4642374904,10338.546612720686,1130558.0108502111,4100,4,1702.1040462427745,73,100,41,33.215832704266845,0.6464041095890412,38.93581081081081,8581.946591117365,117.56091220708718,0
4103,33.128460092576674,0,1,172,0.0,0.005780346820809248,0.9942196531791907,173,4250,2800,1450,0.6588235294117647,57,28,29,217.37980302818178,0.41048163955728817,0.7515491472796729,0.1461778718949563,1129779.3618256273,10268.243027791836,1140047.6048534191,4101,5,1703.1040462427745,73,100,33,33.16012459799852,0.6474029680365296,38.83727477477476,8651.918920292412,118.51943726427962,0
4104,32.75820228141171,2,0,174,0.011494252873563218,0.0,1.0,174,4750,3000,1750,0.631578947368421,65,30,35,216.02952407764047,0.4117452051912387,0.7509198723344308,0.14620959765119895,1119013.856271818,8798.006161337325,1127811.8624331553,4102,0,1691.2241379310344,79,95,37,32.9732074657102,0.6468881856540085,38.61979166666667,8562.345736940882,108.38412325241623,0
4105,33.12566731739636,0,0,174,0.0,0.0,1.0,174,5100,4000,1100,0.7843137254901961,62,40,22,222.4065303511288,0.41136040240958516,0.7571739783148135,0.15128960554642162,1133039.1149996647,10499.059663837943,1143538.1746635027,4103,1,1692.2241379310344,67,107,39,32.63270664948655,0.654539800995025,38.449754901960794,8664.02640590115,129.3138269537485,0
4106,33.132869355894705,0,1,173,0.0,0.005747126436781609,0.9942528735632183,174,3900,2500,1400,0.6410256410256411,53,25,28,222.57395931094965,0.4114649082010055,0.7585513992354844,0.15208197022685557,1134582.5422742595,11805.705719813153,1146388.2479940727,4104,2,1693.2241379310344,68,106,41,32.475362945870614,0.655484068627451,38.300120772946876,8670.867908883409,127.51276336593249,0
4107,33.10249278017132,0,0,173,0.0,0.0,1.0,173,4450,3100,1350,0.6966292134831461,58,31,27,223.84419241056742,0.41028139982972617,0.7598177729081357,0.1533655527693269,1134327.1650663232,11732.5096387281,1146059.6747050514,4105,3,1703.9653179190752,68,105,42,32.349513676643035,0.6564031862745099,38.20954106280195,8665.916776886368,127.43995260127012,0
4108,32.550796266995974,0,0,173,0.0,0.0,1.0,173,4900,3400,1500,0.6938775510204082,64,34,30,225.53874140170066,0.41016097593762607,0.7621415521695674,0.1553358373879318,1116903.8677844878,10881.018521360971,1127784.8863058488,4106,4,1704.9653179190752,69,104,43,32.12740475649475,0.6576086956521738,38.035714285714285,8527.146093514835,123.58182744224399,0
4109,32.63541841608122,1,0,174,0.005747126436781609,0.0,1.0,174,4450,3200,1250,0.7191011235955056,57,32,25,226.88506475054302,0.4109852889066064,0.7639541781809436,0.15690605682748424,1120971.9478385346,11616.358593777737,1132588.3064323124,4107,0,1696.16091954023,72,102,44,31.952875471835068,0.6574074074074074,37.89954337899544,8553.758068872441,118.80219540100613,0
4110,32.89367424299834,0,1,173,0.0,0.005747126436781609,0.9942528735632183,174,3750,2400,1350,0.64,51,24,27,229.05765723485106,0.41039493499878194,0.7660305727499241,0.15863669582315507,1130253.2707377172,13228.633255442004,1143481.903993159,4108,1,1697.16091954023,73,101,38,31.847211781130877,0.6573915525114156,37.85191441441442,8623.013730677918,118.12347576271121,0
4111,32.73267174236623,0,0,173,0.0,0.0,1.0,173,4750,3300,1450,0.6947368421052632,62,33,29,237.82490308541387,0.40977449926065335,0.7725823401392977,0.16511175836798847,1125414.4936075315,14180.318574626297,1139594.8121821578,4109,7,1707.9653179190752,72,101,38,31.5346628938347,0.6587094907407407,37.77111872146119,8583.451892258347,119.21460961469926,0
4112,32.58953449067655,0,0,173,0.0,0.0,1.0,173,5150,3600,1550,0.6990291262135923,67,36,31,236.15629964432884,0.40950284536452036,0.7707451672255954,0.16446221226351687,1121366.7108522432,13213.562595839541,1134580.2734480829,4110,8,1708.9653179190752,73,100,38,31.473805179938463,0.6592465753424658,37.66891891891892,8549.247814868357,117.11298376531995,0
4113,32.33403602111415,0,0,173,0.0,0.0,1.0,173,4750,3300,1450,0.6947368421052632,62,33,29,239.10024639501597,0.40933481202670613,0.7752469195503093,0.1674587691402984,1114155.945295731,13928.99220853634,1128084.9375042673,4111,9,1709.9653179190752,59,114,39,31.205842316425308,0.6696680790960452,37.4826388888889,8488.245810334516,143.86857305651722,0
4114,31.87239352405907,0,0,173,0.0,0.0,1.0,173,5350,3500,1850,0.6542056074766355,72,35,37,237.6643877428505,0.40902675090738,0.7747784450942221,0.1670602506163186,1099246.8204800666,12300.364513534201,1111547.1849936007,4112,10,1710.9653179190752,60,113,38,31.121451018638943,0.6701388888888888,37.36338797814209,8370.857452186308,139.5142908697718,0
4115,31.638041242324903,0,0,173,0.0,0.0,1.0,173,4150,2800,1350,0.6746987951807228,55,28,27,225.88955833234223,0.409404825917462,0.7516578680717065,0.1510228262860936,1077330.3591320699,9921.535800473592,1087251.8949325434,4113,11,1711.9653179190752,71,102,46,33.13860553646006,0.6464201877934272,39.03356481481483,8256.466839251432,116.28826534156947,8
4116,31.565188634062174,0,0,173,0.0,0.0,1.0,173,5050,3600,1450,0.7128712871287128,65,36,29,225.43573543162148,0.40943983286283997,0.7521946072641383,0.15148830227252919,1076270.6500066572,8875.973101544256,1085146.6231082014,4114,12,1712.9653179190752,74,99,38,32.97410736446478,0.646677927927928,38.86111111111113,8242.89828746722,111.39051739820567,0
4117,31.788899264667943,1,0,174,0.005747126436781609,0.0,1.0,174,4900,3800,1100,0.7755102040816326,60,38,22,224.74155602377192,0.4100122084911302,0.7532057339541487,0.15187080907060982,1085469.9358973752,9090.04048212013,1094559.9763794953,4115,0,1704.1149425287356,79,95,39,32.79874605547254,0.6463607594936709,38.67187500000001,8307.333440649569,105.15611950189327,0
4118,32.29097148657175,0,0,174,0.0,0.0,1.0,174,5050,3500,1550,0.693069306930693,66,35,31,228.3147263810696,0.41006549952384114,0.7560895955229707,0.15482375518424624,1103602.90463591,10543.759041060726,1114146.6636769706,4116,1,1705.1149425287356,79,95,41,32.58550600129491,0.6475474683544304,38.55468750000003,8442.32313123541,106.86484976247354,0
4119,31.988453666655648,0,0,174,0.0,0.0,1.0,174,4850,3200,1650,0.6597938144329897,65,32,33,228.09828492902975,0.4100115163997962,0.7574068948614954,0.15518099659552703,1094177.0495590374,10265.981682624435,1104443.0312416619,4117,2,1706.1149425287356,64,110,40,32.47949982639951,0.6564127604166667,38.44551282051282,8366.723594446901,130.73005616323283,0
4120,32.25085107447889,0,0,174,0.0,0.0,1.0,174,5150,3700,1450,0.7184466019417476,66,37,29,226.0974185423103,0.4099132394303811,0.7568218543248268,0.15497950325536536,1105271.3185678546,10029.79838340944,1115301.116951264,4118,3,1707.1149425287356,65,109,42,32.2750884173298,0.6583333333333333,38.19444444444444,8443.451982693425,129.89926127220653,0
4121,32.231053019718175,0,0,174,0.0,0.0,1.0,174,5250,3800,1450,0.7238095238095238,67,38,29,227.7821531005898,0.409655781454167,0.7590771522649014,0.1566620777841467,1105540.9477604604,10314.499484348868,1115855.4472448092,4119,4,1708.1149425287356,67,107,40,32.116085702031434,0.6582711442786069,38.08210784313726,8441.889468920675,125.99835028239814,0
4122,31.88293688069659,1,0,175,0.005714285714285714,0.0,1.0,175,3450,2300,1150,0.6666666666666666,46,23,23,226.69871148251175,0.41050082101806235,0.7593765635286367,0.15666758086530275,1094931.922838866,11193.931213727972,1106125.854052594,4120,0,1699.3485714285714,68,107,43,31.981446812596005,0.6593137254901961,37.92270531400966,8355.793844337151,122.87932124025222,0
4123,31.585177392608536,0,2,173,0.0,0.011428571428571429,0.9885714285714285,175,4550,3100,1450,0.6813186813186813,60,31,29,227.93595658632728,0.41038724685276406,0.7616280201070214,0.158119352561066,1085741.8717325842,9945.922427839094,1095687.7941604233,4121,1,1700.3485714285714,69,106,36,31.82108399545969,0.6600241545893719,37.79761904761904,8281.70871514525,120.02476398761233,0
4124,31.92688874072899,1,1,173,0.005747126436781609,0.005747126436781609,0.9942528735632183,174,3950,2200,1750,0.5569620253164557,57,22,35,232.18221745404827,0.4100578865191682,0.766986123589898,0.14903045445579888,1075492.4809273374,11192.045815372858,1086684.5267427103,4122,0,1710.3218390804598,66,108,41,34.41187481281822,0.6349431818181819,40.43843283582089,8286.993276219988,125.56050418515133,8
4125,31.866724618503152,0,0,173,0.0,0.0,1.0,173,4800,3400,1400,0.7083333333333334,62,34,28,230.13513710798367,0.4095854617556123,0.7635283405874613,0.1482432393025318,1074494.8107939623,10055.802120777069,1084550.6129147394,4123,1,1721.1676300578035,66,107,42,34.3377686643118,0.6362058080808081,40.314054726368155,8275.3405053305,125.38394705046211,0
4126,31.850407537403555,0,0,173,0.0,0.0,1.0,173,5400,3700,1700,0.6851851851851852,71,37,34,228.6489557542097,0.40974649370435096,0.7617080163412324,0.14785965805438875,1075065.5136618572,9162.521413229271,1084228.0350750864,4124,2,1722.1676300578035,69,104,43,34.237781596028995,0.6358695652173914,40.17857142857142,8275.41838695038,119.93359981087507,0
4127,31.885210994154683,0,0,173,0.0,0.0,1.0,173,5950,4200,1750,0.7058823529411765,77,42,35,217.65900462657322,0.4094650378635121,0.7508893327552904,0.1344310628094407,1062810.65787752,5716.061980026618,1068526.7198575465,4125,3,1723.1676300578035,82,91,37,36.184866086618364,0.6134400406504066,41.80471887550199,8232.61101634966,100.39769532133731,8
4128,31.81410874139557,1,0,174,0.005747126436781609,0.0,1.0,174,4750,3500,1250,0.7368421052631579,60,35,25,216.38925550607337,0.41016377649325625,0.7517261320575261,0.13411606080145277,1061475.4027288395,6388.374426900178,1067863.7771557397,4126,0,1714.2586206896551,85,89,40,36.088985401916155,0.6136029411764705,41.678779069767415,8218.259412884418,96.68540485746374,0
4129,32.07645260198141,0,0,174,0.0,0.0,1.0,174,4600,2800,1800,0.6086956521739131,64,28,36,215.37906438137915,0.410371403893429,0.7507357653068543,0.13386333239285916,1071058.4148369625,6736.711857077839,1077795.1266940404,4127,1,1715.2586206896551,70,104,40,36.01278339199879,0.6211309523809524,41.5786384976526,8289.240553569589,118.41772219385128,0
4130,31.816806213617514,2,0,176,0.011363636363636364,0.0,1.0,176,4950,3700,1250,0.7474747474747475,62,37,25,210.45643204230163,0.4116524621212121,0.74579463563143,0.1316887859914567,1064370.4095180905,4650.719751716411,1069021.129269807,4128,0,1696.7556818181818,75,101,38,35.894005228204044,0.6211111111111112,41.33771929824563,8229.807659860098,109.73076879813465,0
4131,31.714978325141182,0,0,176,0.0,0.0,1.0,176,4850,3400,1450,0.7010309278350515,63,34,29,206.76752021496412,0.4118269751082251,0.7409267342777976,0.12980820131907025,1061927.9244570758,3864.4407174029875,1065792.3651744789,4129,1,1697.7556818181818,76,100,43,35.86951313015144,0.6218475877192983,41.220238095238116,8207.194539794767,107.98940183940483,0
4132,31.437070629846495,1,0,177,0.005649717514124294,0.0,1.0,177,4500,3100,1400,0.6888888888888889,59,31,28,204.3957144153845,0.4124146657250471,0.7392912792501587,0.12877707178186093,1053651.8742403314,3172.3855160925496,1056824.259756424,4130,0,1689.1581920903955,79,98,40,35.801817206464186,0.6218354430379747,41.09375000000002,8139.254067758746,103.02853250327526,0
4133,30.9863413770605,1,1,177,0.0056179775280898875,0.0056179775280898875,0.9943820224719101,178,4700,3500,1200,0.7446808510638298,59,35,24,203.12966844421805,0.41298482828667554,0.738836167996088,0.12854085272917182,1039788.9603559325,1942.3973538121481,1041731.3577097446,4131,0,1680.6629213483145,82,96,32,35.67645254012855,0.6222052845528455,40.93875502008035,8027.360174514166,97.894636274563,0
4134,30.934080061449727,0,2,175,0.0,0.011299435028248588,0.9887005649717514,177,3950,2700,1250,0.6835443037974683,52,27,25,207.54714435252603,0.4122247367745249,0.7418649935736583,0.13144233061404548,1038263.9617486193,3747.744069013569,1042011.7058176328,4132,1,1691.1525423728813,83,94,33,35.53288382073746,0.6221134538152611,40.91021825396828,8014.70405163535,96.56269941729337,0
4135,30.55426878517837,0,1,174,0.0,0.005714285714285714,0.9942857142857143,175,4850,3500,1350,0.7216494845360825,62,35,27,207.3574680762569,0.41116858237547893,0.7399941908769727,0.13165425074586598,1026221.8470392042,2708.9527773182563,1028930.7998165225,4133,2,1711.1371428571429,84,91,34,35.446809935852,0.6226438492063492,40.82107843137258,7919.022433060578,94.2740765840545,0
4136,31.07736840621205,0,0,174,0.0,0.0,1.0,174,4650,4000,650,0.8602150537634409,53,40,13,240.44434434507122,0.41076866431909287,0.7751959599714957,0.14623746188855993,1031423.6267359758,10149.995534509479,1041573.6222704854,4134,3,1721.942528735632,65,109,41,36.166329739442936,0.6160256410256411,42.361111111111114,8006.738665767143,123.18059485795605,8
4137,31.364492508690816,2,1,175,0.011363636363636364,0.005681818181818182,0.9943181818181818,176,5000,3900,1100,0.78,61,39,22,208.23404431111155,0.41267789502164504,0.7368863824589873,0.12536727753622423,1037958.0088715475,3027.638802486181,1040985.6476740337,4135,0,1703.3636363636363,87,89,39,37.37481212232749,0.6022509578544062,42.73200757575757,8069.0800211160695,92.74804621972494,7
4138,31.544844751741014,3,0,178,0.016853932584269662,0.0,1.0,178,4150,2700,1450,0.6506024096385542,56,27,29,205.53939604686394,0.4151894348166487,0.7359763418454912,0.12463178963648813,1046045.8241073856,3250.725384875086,1049296.5494922607,4136,0,1681.0786516853932,78,100,43,37.177755875275224,0.6083066239316239,42.47099156118142,8123.712590272298,104.15016141374741,0
4139,31.939524253814486,0,2,176,0.0,0.011235955056179775,0.9887640449438202,178,5400,3900,1500,0.7222222222222222,69,39,30,202.05972617445988,0.41529060602213336,0.742853967178122,0.12182624741745798,1057423.4563637136,1732.5388086606085,1059155.9951723742,4137,1,1682.0786516853932,70,108,43,37.479569340707364,0.6099702380952381,42.67899061032864,8218.710620417438,117.41015172024912,8
4140,31.49810799539411,1,0,177,0.005649717514124294,0.0,1.0,177,4850,3300,1550,0.6804123711340206,64,33,31,199.4723621798434,0.41443032015065917,0.7382888539170571,0.12113341286795623,1044936.7179039672,1437.1990897514775,1046373.9169937187,4138,0,1692.5593220338983,74,103,43,37.27859107085084,0.6106418918918919,42.41666666666667,8113.387651146948,109.64037366414794,0
4141,31.447016036017086,0,1,176,0.0,0.005649717514124294,0.9943502824858758,177,4600,3000,1600,0.6521739130434783,62,30,32,199.02220958569035,0.4145399974319466,0.7379620378419272,0.12098387617634655,1043543.7672707805,1537.677272321208,1045081.4445431017,4139,1,1693.5593220338983,75,102,42,37.25216358090377,0.6105555555555555,42.37938596491228,8101.399580769967,108.01866107693289,0
4142,31.501507710327946,2,0,178,0.011235955056179775,0.0,1.0,178,4300,3200,1100,0.7441860465116279,54,32,22,198.22534778916312,0.41494609492371826,0.7391378105280564,0.12122701266282453,1047126.7790909591,1613.4139929303165,1048740.1930838893,4140,0,1685.0168539325844,77,101,46,37.04976390255696,0.6118777056277056,42.160790598290596,8122.323842992802,105.48472523367276,0
4143,31.71064687816613,0,0,178,0.0,0.0,1.0,178,3250,2200,1050,0.676923076923077,43,22,21,197.43721156412232,0.41491369368797476,0.7380415119681096,0.12094188603140198,1054561.1078087084,2791.9209099446216,1057353.0287186531,4141,1,1686.0168539325844,78,100,48,37.00992296811354,0.6120459401709402,42.10179324894514,8178.118964794972,104.84767903583298,0
4144,31.56155240996809,0,0,178,0.0,0.0,1.0,178,5000,3900,1100,0.78,61,39,22,200.8018655505337,0.4149064199411752,0.743048822940443,0.12350997428555154,1050813.3195075712,1601.0549804937677,1052414.374488065,4142,2,1687.0168539325844,79,99,38,36.77149561005146,0.6131329113924051,41.95312499999999,8144.359969540969,103.09316417140468,0
4145,31.817875812207575,0,0,178,0.0,0.0,1.0,178,5700,3800,1900,0.6666666666666666,76,38,38,223.439616229126,0.414943449924882,0.770357090391401,0.13660093999379955,1057542.5939971027,5959.382269733478,1063501.9762668363,4143,3,1688.0168539325844,71,107,42,36.41215653816656,0.6145833333333333,42.17303240740741,8203.50643589919,115.54234416759422,8
4146,32.0365250306406,3,2,179,0.016574585635359115,0.011049723756906077,0.988950276243094,181,4750,3300,1450,0.6947368421052632,62,33,29,221.77273607784983,0.4172460098219766,0.772815396606368,0.1367574012190752,1067387.9105443093,6393.507475566223,1073781.4180198754,4144,0,1661.0220994475137,74,107,38,36.13629434341264,0.6162725225225225,41.86111111111112,8269.872975270664,111.75504020636032,0
4147,32.5216910205205,1,0,180,0.005555555555555556,0.0,1.0,180,5300,3700,1600,0.6981132075471698,69,37,32,222.43173838256703,0.4164901458721291,0.7635547838694228,0.1333608081923987,1074980.6754367296,6521.964073011173,1081502.6395097408,4145,0,1671.1722222222222,76,104,42,37.16512767897853,0.6049890350877193,42.88419913419911,8361.840632251187,110.02421884541036,8
4148,32.17110928517619,1,1,180,0.0055248618784530384,0.0055248618784530384,0.994475138121547,181,4750,3100,1650,0.6526315789473685,64,31,33,220.35024939763113,0.4169339574381011,0.7634523422628718,0.13280481020072404,1064978.3038429779,5983.646970973332,1070961.9508139512,4146,0,1662.9337016574586,65,116,46,37.022774438242465,0.6126602564102563,42.69255050505051,8277.866077591987,127.3517858091075,0
4149,32.22796422798546,1,0,181,0.0055248618784530384,0.0,1.0,181,5100,3600,1500,0.7058823529411765,66,36,30,218.90052551396965,0.41761177614078165,0.7620853434708081,0.13260535857945763,1068406.1183333867,5474.932153103831,1073881.0504864906,4147,0,1663.8176795580112,66,115,46,36.869666505655495,0.6139520202020202,42.50621890547264,8298.500366043163,125.73485403095701,0
4150,32.483961302101676,0,2,179,0.0,0.011049723756906077,0.988950276243094,181,5300,3500,1800,0.660377358490566,71,35,36,222.00064513044194,0.41747237569060774,0.7660997260893185,0.1349821709979676,1078021.428256468,6364.290507475415,1084385.7187639433,4148,1,1664.8176795580112,67,114,43,36.651950291354495,0.6147388059701493,42.371323529411775,8368.799956782284,124.90746204152663,0
4151,32.04222374563915,0,0,179,0.0,0.0,1.0,179,4900,3800,1100,0.7755102040816326,60,38,22,221.1143015875034,0.4165738183415981,0.7627871819247747,0.1350699633533822,1064756.8850702886,6386.5950005606355,1071143.4800708492,4149,2,1682.1284916201118,69,110,46,36.50210690371738,0.6153381642512077,42.20238095238096,8260.408990616877,119.71607232778084,0
4152,32.504069896512796,2,2,179,0.011049723756906077,0.011049723756906077,0.988950276243094,181,5000,3600,1400,0.72,64,36,28,219.20422158125808,0.41827169019848576,0.7610862081092231,0.13454838123977367,1081562.6684913703,6216.6205675999845,1087779.2890589703,4150,0,1664.5303867403316,71,110,38,36.373509150730015,0.616050469483568,42.028356481481495,8385.12833224424,118.10039904569352,0
4153,32.67442124622442,0,0,179,0.0,0.0,1.0,179,5050,3200,1850,0.6336633663366337,69,32,37,224.61013613347689,0.41682882430481455,0.7644642570816678,0.13852139310440056,1088672.5857465023,8055.37953786155,1096727.9652843638,4151,1,1684.0614525139665,70,109,41,36.05924978687129,0.6183035714285714,41.857394366197205,8434.660238076907,120.49514625824153,0
4154,33.03713970691779,0,0,179,0.0,0.0,1.0,179,5000,3900,1100,0.78,61,39,22,225.40055421968825,0.41701059778628674,0.7646365953686598,0.1393493205065245,1101508.7885211203,8856.13828210384,1110364.9268032243,4152,2,1685.0614525139665,70,109,41,35.94883339961743,0.6191964285714286,41.76936619718312,8531.201525549635,121.87430750785194,0
4155,32.637730827030694,0,1,178,0.0,0.00558659217877095,0.994413407821229,179,4850,3100,1750,0.6391752577319587,66,31,35,224.99987518402042,0.4169988282802921,0.7647057734291525,0.13938903971872532,1088817.0061948907,8346.73809841806,1097163.7442933088,4153,3,1686.0614525139665,72,107,42,35.8833508267963,0.6189236111111112,41.69520547945207,8430.482354893154,117.09003270684937,0
4156,32.51351956186359,1,1,178,0.00558659217877095,0.00558659217877095,0.994413407821229,179,5150,3300,1850,0.6407766990291263,70,33,37,225.53800164609024,0.41754153327893206,0.7620303745085866,0.1404929412247242,1086328.7162248471,8051.681557623045,1094380.39778247,4154,0,1674.2905027932961,67,112,43,35.667962962962974,0.6236007462686567,41.49816176470589,8404.804574240952,125.444844391656,0
4157,32.328306860323565,0,0,178,0.0,0.0,1.0,178,5100,3800,1300,0.7450980392156863,64,38,26,225.86574403078143,0.41797263484204067,0.7610520117041739,0.14134344989859074,1081508.2624547954,8155.133674958045,1089663.3961297534,4155,1,1674.6179775280898,68,110,42,35.49217442901054,0.6246936274509804,41.33454106280194,8362.216330688181,122.97376956894384,0
4158,32.52594754564625,2,0,180,0.011111111111111112,0.0,1.0,180,4450,2900,1550,0.651685393258427,60,29,31,221.75974010373852,0.4197412321539416,0.7694036483830875,0.1305030379330604,1069362.7027003244,6978.319005490948,1076341.0217058153,4156,0,1657.0,64,116,42,37.88721538237195,0.6043294270833333,43.57371794871794,8340.507799325072,130.32043436445426,8
4159,32.01549802964105,4,1,183,0.021739130434782608,0.005434782608695652,0.9945652173913043,184,5600,4400,1200,0.7857142857142857,68,44,24,217.11671309077687,0.4231798675457353,0.7694571831731203,0.12896209584789442,1055411.0759285726,3429.4767530420863,1058840.5526816146,4157,0,1621.9565217391305,69,115,46,37.65424273157535,0.6049214975845411,43.22916666666664,8220.646108652572,119.13979867612424,0
4160,32.470653248615385,2,1,184,0.010810810810810811,0.005405405405405406,0.9945945945945946,185,4900,4000,900,0.8163265306122449,58,40,18,217.41498454928046,0.4240660497453976,0.7692967288059334,0.12987984155535454,1072176.7338781427,4721.4576060424915,1076898.1914841852,4158,0,1613.7513513513513,73,112,36,37.43084465381243,0.6050228310502284,43.01801801801799,8344.372828078795,114.30647709696979,0
4161,32.710419975141576,0,1,183,0.0,0.005434782608695652,0.9945652173913043,184,5150,3400,1750,0.6601941747572816,69,34,35,216.6630485737292,0.42304003821176844,0.7667169694103693,0.1297487911573701,1080853.7208958797,4886.21244631155,1085739.9333421912,4159,1,1623.5,75,109,36,37.357823274329945,0.605,42.927631578947334,8408.945135056874,112.11926846742499,0
4162,32.71011311493083,3,0,186,0.016129032258064516,0.0,1.0,186,4950,3500,1450,0.7070707070707071,64,35,29,216.41273453417065,0.42458042720139494,0.7699766904178378,0.1304830229973448,1082942.5398250695,4722.511277384639,1087665.051102454,4160,0,1607.016129032258,68,118,39,37.109367360907406,0.6110600490196079,42.67814009661836,8417.027144383996,123.77981094682346,0
4163,33.01363804461306,0,3,183,0.0,0.016129032258064516,0.9838709677419355,186,6100,4400,1700,0.7213114754098361,78,44,34,203.56396151753347,0.4242970793374019,0.7598160798330451,0.12056321948685748,1087408.373139697,971.4312447303896,1088379.8043844274,4161,1,1608.016129032258,72,114,39,38.11143696373303,0.6022858796296297,43.336187214611854,8473.406214447095,117.68619742287632,8
4164,33.277330098851,0,0,183,0.0,0.0,1.0,183,4700,3200,1500,0.6808510638297872,62,32,30,202.44781894370607,0.4222750155127204,0.7542004459669733,0.12029368499556993,1097125.2828484417,3122.1241241325843,1100247.4069725743,4162,2,1635.2896174863388,75,108,44,38.01691353082462,0.6020833333333333,43.21546052631577,8545.10388434719,113.93471845796255,0
4165,33.681142334625214,2,1,184,0.010810810810810811,0.005405405405405406,0.9945945945945946,185,5700,4300,1400,0.7543859649122807,71,43,28,200.2062761427474,0.4244993634939287,0.7552748665148001,0.11974903163088556,1112544.865931578,1847.6929299784533,1114392.5588615565,4163,0,1618.6,78,107,40,37.82618546828779,0.6032318376068376,42.9720464135021,8656.995088724247,110.98711652210572,0
4166,33.137958161445674,0,1,183,0.0,0.005434782608695652,0.9945652173913043,184,5300,3800,1500,0.7169811320754716,68,38,30,199.10013045347813,0.42369896848024075,0.7527473918768361,0.11935128038659264,1095296.1848082368,1514.722656103174,1096810.9074643399,4164,1,1628.3641304347825,79,105,41,37.771573989668774,0.6036392405063291,42.890624999999986,8520.079711665408,107.84911027424567,0
4167,32.72976173934877,2,1,184,0.010810810810810811,0.005405405405405406,0.9945945945945946,185,4600,3100,1500,0.6739130434782609,61,31,30,201.22728270803646,0.42433778887583234,0.7581001511816023,0.1213317166150828,1083604.6107996646,2010.1622722233374,1085614.773071888,4165,0,1620.5189189189189,65,120,45,37.498722194962355,0.6128205128205129,42.67676767676769,8422.128083938513,129.57120129136175,0
4168,32.30251786204693,0,0,184,0.0,0.0,1.0,184,5050,3700,1350,0.7326732673267327,64,37,27,198.0315958755079,0.42472850835511206,0.752590207828636,0.11964701309983775,1070075.6921735404,531.7594057431297,1070607.4515792835,4166,1,1628.054347826087,68,116,45,37.50537634408599,0.6118259803921569,42.60265700483093,8314.582269744904,122.27326867271917,0
4169,32.22074009931478,0,1,183,0.0,0.005434782608695652,0.9945652173913043,184,5300,3300,2000,0.6226415094339622,73,33,40,197.34488003632129,0.4247087095113646,0.75137159345396,0.11978625636845,1068770.4578809065,83.27555937445368,1068853.733440281,4167,2,1629.054347826087,71,113,46,37.350505064689465,0.6119424882629108,42.43344907407408,8298.98489566121,116.8871112064959,0
4170,32.20594098583012,0,0,183,0.0,0.0,1.0,183,5150,3500,1650,0.6796116504854369,68,35,33,198.29614258009022,0.4242866650653536,0.7514540163143504,0.1208992365800493,1069619.5716395727,670.2870168592221,1070289.858656432,4168,3,1638.9016393442623,73,110,45,37.161311832068,0.6125856164383562,42.27195945945947,8300.374064042302,113.70375430194935,0
4171,32.14965821759501,1,0,184,0.005434782608695652,0.0,1.0,184,5750,4100,1650,0.7130434782608696,74,41,33,197.13700274164597,0.4250236348697236,0.7505516250858568,0.12103735467369839,1069853.7262784026,-368.44860589866175,1069485.2776725038,4169,0,1630.9891304347825,79,105,40,36.932453860260104,0.6124736286919832,42.01822916666668,8294.025758661619,104.98766783115974,0
4172,32.11680197566737,1,0,185,0.005405405405405406,0.0,1.0,185,5300,3800,1500,0.7169811320754716,68,38,30,195.65303667796715,0.4253745593419507,0.750537814567332,0.12083403131205432,1070516.1807317256,-410.0516853874374,1070106.1290463381,4170,0,1623.1675675675676,81,104,45,36.75476629766296,0.6138117283950617,41.80640243902441,8292.352644251065,102.37472400309956,0
4173,32.04949512762828,0,0,185,0.0,0.0,1.0,185,5150,3900,1250,0.7572815533980582,64,39,25,196.7111957636349,0.4251285252643948,0.7518068025326756,0.12187767737524724,1069226.415805414,-84.23864097011119,1069142.177164444,4171,1,1624.1675675675676,84,101,46,36.609952715311394,0.6138392857142857,41.691176470588246,8278.66738112931,98.55556406106321,0
4174,32.2717588270244,0,0,185,0.0,0.0,1.0,185,3700,2300,1400,0.6216216216216216,51,23,28,195.70875924227818,0.4252313454759107,0.7491695859728094,0.12192901360324396,1078293.7012070094,1506.304472397625,1079800.005679407,4172,2,1625.1675675675676,71,114,45,36.43384822028208,0.6214788732394366,41.493055555555564,8342.473766222127,117.4996305101708,0
4175,32.6369976610975,0,0,185,0.0,0.0,1.0,185,6000,4300,1700,0.7166666666666667,77,43,34,195.7423348246979,0.42517503916960436,0.7493674208306733,0.12233220952975304,1091440.6515505856,-271.7717085795416,1091168.8798420061,4173,3,1626.1675675675676,72,113,48,36.31901530199365,0.6221064814814814,41.3812785388128,8440.53860744483,117.2297028811782,0
4176,32.421183426553064,0,0,185,0.0,0.0,1.0,185,4850,3200,1650,0.6597938144329897,65,32,33,197.13811709173197,0.4250893556600079,0.7504805872148526,0.12390428568328005,1085914.6584329293,965.034217156177,1086879.6926500855,4174,4,1627.1675675675676,76,109,46,36.07731810579136,0.6222587719298245,41.17965367965371,8391.261922576014,110.41134108652649,0
4177,32.81004145657604,1,1,185,0.005376344086021506,0.005376344086021506,0.9946236559139785,186,6900,5600,1300,0.8115942028985508,82,56,26,195.2572435589191,0.42586699602828637,0.7503734919655567,0.12348890620516369,1100814.7588368815,-1111.5889041065957,1099703.169932775,4175,0,1619.4139784946237,77,109,41,35.90090177175164,0.6240530303030303,40.95886752136754,8499.150295582378,110.37857526730362,0
4178,32.981816934974894,0,1,184,0.0,0.005405405405405406,0.9945945945945946,185,5250,3600,1650,0.6857142857142857,69,36,33,193.0513322756301,0.4253635428907168,0.7460780093530976,0.12227844915049021,1107034.462861921,492.8955861062623,1107527.3584480272,4176,6,1629.1675675675676,77,108,41,35.903593886913065,0.6245941558441559,40.90544871794874,8545.409059234127,110.97933843161204,0
4179,33.311506023084796,0,0,184,0.0,0.0,1.0,184,4600,3700,900,0.8043478260869565,55,37,18,197.11035387167425,0.42546910885404293,0.7508890104443022,0.12542870744451692,1119509.9985954333,2733.4023972050727,1122243.4009926384,4177,7,1625.3532608695652,79,105,43,35.63194758341287,0.6253955696202531,40.74218750000003,8636.268182625612,109.31985041298243,0
4180,33.68903305602062,0,0,184,0.0,0.0,1.0,184,4850,3300,1550,0.6804123711340206,64,33,31,198.72301519351393,0.42531195553179696,0.7516151900817787,0.12703844238608436,1133611.556317242,3404.941305914764,1137016.4976231568,4178,8,1626.3532608695652,69,115,45,35.42509177995751,0.6317934782608696,40.58035714285713,8739.596923595325,126.6608249796424,0
4181,33.53471658561998,0,0,184,0.0,0.0,1.0,184,5300,3900,1400,0.7358490566037735,67,39,28,198.4794812678613,0.4252061554605211,0.7505584690697831,0.12741288035526127,1129690.151176336,2744.0630397781856,1132434.2142161143,4179,9,1627.3532608695652,70,114,44,35.28242520159769,0.6327380952380952,40.43427230046948,8704.46311374396,124.34947305348513,0
4182,33.54100740945984,0,1,183,0.0,0.005434782608695652,0.9945652173913043,184,3800,2200,1600,0.5789473684210527,54,22,32,197.5680903652384,0.4250081670230459,0.7491622733101748,0.1271476386648722,1130668.5829571104,4076.806554161247,1134745.3895112716,4180,10,1628.3532608695652,70,114,46,35.216314461144385,0.6336309523809525,40.34624413145539,8709.048549480916,124.4149792782988,0
4183,33.30073030844793,0,0,183,0.0,0.0,1.0,183,5150,3600,1550,0.6990291262135923,67,36,31,196.3508920914406,0.4251711403350748,0.7461403728069149,0.12673687730510233,1123457.0166256183,2368.3574881657482,1125825.3741137842,4181,11,1622.808743169399,70,113,48,35.143203426527336,0.6346726190476191,40.24354460093897,8650.079667122523,123.57256667317891,0
4184,33.49525098542926,0,0,183,0.0,0.0,1.0,183,4850,3600,1250,0.7422680412371134,61,36,25,176.18240997798728,0.42524495085970493,0.7204238359093977,0.10885215924586031,1116585.6981917843,-2105.4481491231154,1114480.250042661,4182,12,1623.808743169399,82,101,46,37.24300087489062,0.6135670731707317,41.79216867469883,8648.736116644443,105.47239166639564,7
4185,33.482055550064906,1,1,183,0.005434782608695652,0.005434782608695652,0.9945652173913043,184,4650,3200,1450,0.6881720430107527,61,32,29,175.92351716961434,0.42602285776510657,0.7219495091164085,0.10907258064516147,1117231.0897087697,-2140.5554414382477,1115090.5342673315,4183,0,1615.9782608695652,84,100,48,37.12197580645166,0.6140873015873016,41.666666666666686,8649.531017100153,102.9706073464304,0
4186,33.79444242953178,1,2,182,0.005434782608695652,0.010869565217391304,0.9891304347826086,184,5150,3700,1450,0.7184466019417476,66,37,29,177.5774370409511,0.4258353874633722,0.7236790074487578,0.11058822124819391,1129044.6200804184,-1851.4300122488012,1127193.1900681697,4184,0,1616.4728260869565,71,113,48,36.91727999477622,0.6213321596244131,41.50752314814816,8735.60912743701,123.03674827376071,0
4187,33.67138161004227,1,0,183,0.00546448087431694,0.0,1.0,183,4750,3400,1350,0.7157894736842105,61,34,27,199.91555034830128,0.42591424968474145,0.7511206145561116,0.12076167288135686,1115359.7420277074,3245.551332761532,1118605.293360469,4185,0,1603.2349726775956,73,110,40,37.46416689454018,0.6091609589041096,42.609797297297284,8666.683737888798,118.72169503957257,8
4188,34.008822089843974,0,2,181,0.0,0.01092896174863388,0.9890710382513661,183,3350,2100,1250,0.6268656716417911,46,21,25,200.982394403075,0.4255677155267319,0.7518259147258031,0.1217716860206865,1127498.7298473564,5371.478882229424,1132870.2087295859,4186,1,1604.2349726775956,74,109,40,37.324703344120806,0.6097972972972974,42.49999999999999,8757.271688134808,118.34150929911902,0
4189,34.334710351337165,3,0,184,0.016304347826086956,0.0,1.0,184,5100,3600,1500,0.7058823529411765,66,36,30,201.7762261988974,0.4265549516908213,0.754169224473092,0.12310616946741662,1140542.319833464,4126.865023226232,1144669.1848566902,4187,0,1596.4728260869565,78,106,41,37.04598935952526,0.6105769230769231,42.24683544303796,8849.880247203797,113.46000316927945,0
4190,34.52489547458389,2,0,186,0.010752688172043012,0.0,1.0,186,5350,4000,1350,0.7476635514018691,67,40,27,200.65993482794664,0.4277753560011624,0.7569564392294608,0.12308369947336201,1148590.2539200515,3545.2090991221858,1152135.4630191736,4188,0,1580.2956989247311,80,106,42,36.87649566257852,0.61171875,42.052469135802454,8905.61154101338,111.32014426266726,0
4191,34.89004194505043,0,0,186,0.0,0.0,1.0,186,5350,4000,1350,0.7476635514018691,67,40,27,198.75802834994505,0.42795941102392715,0.7547396299754219,0.12236266981689303,1161924.029536902,3638.3458406354184,1165562.3753775374,4189,1,1581.2956989247311,81,105,36,36.79119905493208,0.6126543209876543,41.92073170731706,9004.396495879593,111.16538883801967,0
4192,34.52531881756019,0,0,186,0.0,0.0,1.0,186,4950,3400,1550,0.6868686868686869,65,34,31,196.79596162868052,0.4281047176208466,0.7522746473277215,0.12133391303293412,1150252.4804143435,3123.008599782867,1153375.4890141264,4190,2,1582.2956989247311,82,104,36,36.78752593024762,0.6128048780487805,41.867469879518055,8912.107899593047,108.684242677964,0
4193,34.09913710710989,1,2,185,0.0053475935828877,0.0106951871657754,0.9893048128342246,187,5600,4400,1200,0.7857142857142857,68,44,24,197.52692484717065,0.4288796408103808,0.7550555408035147,0.12242536257528597,1137715.206410266,1945.8772148164694,1139661.0836250824,4191,0,1574.8288770053475,85,102,40,36.576239430455864,0.6136029411764705,41.67877906976742,8808.530730175979,103.62977329618798,0
4194,33.847664362264595,0,0,185,0.0,0.0,1.0,185,5350,4100,1250,0.7663551401869159,66,41,25,199.97359531496795,0.4274419800235018,0.7550088796692895,0.12428008960720857,1130179.497341736,2851.2114869378324,1133030.708828674,4192,1,1592.8108108108108,72,113,41,36.41335357997424,0.6200810185185186,41.58105022831049,8746.87787672102,121.48441495445861,0
4195,33.27419992191273,2,0,187,0.0106951871657754,0.0,1.0,187,6250,4900,1350,0.784,76,49,27,197.18608760319634,0.42873948210760354,0.7533660242688927,0.12340217546967078,1113167.076176149,250.21211997284627,1113417.2882961219,4193,0,1576.764705882353,77,110,41,36.23224181251831,0.6202651515151515,41.33279914529915,8606.944154480876,111.77849551273864,0
4196,33.61020809391896,0,0,187,0.0,0.0,1.0,187,5150,3300,1850,0.6407766990291263,70,33,37,197.9520342334809,0.4288233377417438,0.7539725486926381,0.12428044222221055,1125403.200917475,2005.170590897079,1127408.371508372,4194,1,1577.764705882353,78,109,39,36.09571911410034,0.6209935897435898,41.218354430379755,8697.704958481738,111.50903792925305,0
4197,33.82982860330579,2,0,189,0.010582010582010581,0.0,1.0,189,4850,3600,1250,0.7422680412371134,61,36,25,194.26683761376538,0.42964792299898685,0.752626685914235,0.12261064246421764,1134393.346783093,1425.0016179295021,1135818.3484010224,4195,0,1562.0582010582011,81,108,40,36.00060499035287,0.6216563786008231,41.03150406504066,8760.85983113559,108.15876334735297,0
4198,33.90978990275838,0,1,188,0.0,0.005291005291005291,0.9947089947089947,189,4750,3400,1350,0.7157894736842105,61,34,27,192.5950777502273,0.42954824758902777,0.750800082857132,0.12201581426662403,1138248.917273293,1294.227744272528,1139543.1450175655,4196,1,1563.0582010582011,83,106,38,35.90763696116908,0.6222389558232932,40.89781746031747,8786.100573266809,105.85663341285313,0
4199,33.70444580310724,1,0,189,0.005291005291005291,0.0,1.0,189,5500,3600,1900,0.6545454545454545,74,36,38,192.1592335167928,0.4291272655634358,0.750511904192489,0.12229750670123607,1132764.4087576533,234.2281083949565,1132998.6368660482,4197,0,1564.037037037037,83,106,40,35.75462165781798,0.6238704819277108,40.73660714285716,8738.328973283318,105.2810719672689,0
4200,33.42334509151029,0,2,187,0.0,0.010582010582010581,0.9894179894179894,189,4750,2500,2250,0.5263157894736842,70,25,45,190.54010732667396,0.42901820893842174,0.7492035933249119,0.12189672746053176,1124894.5431882136,317.5053980543448,1125212.048586268,4198,1,1565.037037037037,73,116,43,35.6111420071257,0.6299942922374429,40.55461711711711,8671.532564493591,118.78811732183001,0
4201,33.72097368864598,1,0,188,0.005319148936170213,0.0,1.0,188,4950,3400,1550,0.6868686868686869,65,34,31,190.43766827943395,0.42861638127204466,0.7478605700992178,0.12217431202979102,1135773.748310193,708.820864237015,1136482.5691744299,4199,0,1571.6648936170213,73,115,44,35.51338720757855,0.6309931506849316,40.456081081081074,8752.073660912909,119.8914200125056,0
4202,33.68648551840191,2,0,190,0.010526315789473684,0.0,1.0,190,5650,4200,1450,0.7433628318584071,71,42,29,189.25233404699284,0.42959424023020515,0.7486948357329171,0.12192329048583343,1135891.8086994386,-655.9647957544075,1135235.843903684,4200,0,1556.1105263157895,75,115,46,35.39506034376593,0.6315277777777778,40.30975877192981,8748.051550399645,116.64068733866193,0
4203,33.58116156095289,0,0,190,0.0,0.0,1.0,190,5300,3900,1400,0.7358490566037735,67,39,28,189.71342083873458,0.4292943005662304,0.7489097066177186,0.12276008515751499,1133679.435998075,-285.1592124558797,1133394.276785619,4201,1,1557.1105263157895,79,111,43,35.22666533039351,0.6313291139240507,40.15624999999998,8725.854949353794,110.45386011840246,0
4204,33.77752546194197,0,0,190,0.0,0.0,1.0,190,5150,3400,1750,0.6601941747572816,69,34,35,191.04276104930943,0.42910865125777403,0.7503820759933866,0.12398693369337141,1141211.8485038786,454.05249607321275,1141665.9009999519,4202,2,1558.1105263157895,81,109,48,35.08726115427847,0.6315586419753086,40.05335365853657,8780.354465545162,108.39943784623657,0
4205,34.10496600808589,1,1,190,0.005235602094240838,0.005235602094240838,0.9947643979057592,191,5100,3700,1400,0.7254901960784313,65,37,28,195.63384633108055,0.4293848167539267,0.7575389075922221,0.12759998633833108,1153803.7226470602,1844.612034512496,1155648.3346815726,4203,0,1550.9476439790576,83,108,38,34.792143401983196,0.6325301204819277,39.880952380952365,8871.351277103253,106.88375032654521,0
4206,33.932998183069486,0,0,190,0.0,0.0,1.0,190,5300,3800,1500,0.7169811320754716,68,38,30,196.40372025402624,0.428324863083635,0.7571910159706721,0.12843363696192547,1148774.1123825153,1824.701880688388,1150598.8142632036,4204,4,1560.1105263157895,84,106,39,34.68107819589001,0.6330605158730158,39.79166666666665,8829.648902219493,105.1148678835654,0
4207,33.49245371623493,0,0,190,0.0,0.0,1.0,190,4900,3900,1000,0.7959183673469388,59,39,20,195.12867163822543,0.4281740230205142,0.7566455915726065,0.1280999227528562,1135034.9596059727,1395.5727861717355,1136430.5323921444,4205,5,1561.1105263157895,84,106,43,34.576821690830315,0.6344246031746033,39.65686274509801,8719.530474849122,103.80393422439431,0
4208,33.503672584204075,1,4,187,0.005235602094240838,0.020942408376963352,0.9790575916230366,191,4900,3900,1000,0.7959183673469388,59,39,20,195.71552639986518,0.4287257738587306,0.7587009197312826,0.12925667658368217,1137208.9556553096,1413.8898765440713,1138622.8455318536,4206,0,1553.931937172775,70,121,46,34.35194830790021,0.6427083333333333,39.451291079812215,8729.338635899083,124.70483765570118,0
4209,33.49976654752038,2,3,186,0.010582010582010581,0.015873015873015872,0.9841269841269842,189,5150,3500,1650,0.6796116504854369,68,35,33,197.34386137470733,0.4278666647904237,0.7581904279523726,0.13089223862512817,1138357.2978303386,1979.5649555834652,1140336.8627859221,4207,0,1559.3439153439153,70,119,47,34.15991333220778,0.6441964285714286,39.30457746478874,8733.235794936787,124.76051135623982,0
4210,33.73672212852344,0,1,185,0.0,0.005376344086021506,0.9946236559139785,186,5200,3900,1300,0.75,65,39,26,207.75700249656097,0.42693560495979854,0.7659643282887878,0.13588063443284165,1142180.148370515,5059.184787307089,1147239.3331578223,4208,1,1583.6774193548388,71,115,41,34.37974906408686,0.6387910798122065,39.785879629629626,8778.77147285333,123.64466863173705,8
4211,33.6945208021767,0,1,184,0.0,0.005405405405405406,0.9945945945945946,185,5100,3600,1500,0.7058823529411765,66,36,30,208.19424358110754,0.42593517430473954,0.7657169419947292,0.13635506091289754,1141169.689763617,5416.992071604672,1146586.6818352216,4209,2,1593.2324324324325,73,112,41,34.31967431085151,0.6382705479452055,39.73817567567568,8769.397453708405,120.1287322425809,0
4212,34.09478517608045,2,0,186,0.010752688172043012,0.0,1.0,186,4100,2700,1400,0.6585365853658537,55,27,28,200.26797317514124,0.4270391359101036,0.7573622107352391,0.13204523794944817,1156770.6004992109,5032.820718113553,1161803.4212173244,4210,0,1584.263440860215,68,118,43,34.291026755529764,0.6432291666666667,39.50785024154589,8881.42388606986,130.609174795145,0
4213,34.34097359069385,0,0,186,0.0,0.0,1.0,186,4600,3000,1600,0.6521739130434783,62,30,32,200.7377455291512,0.427023394362104,0.7582937739069775,0.13264676446528093,1165798.6366444235,5003.958012191787,1170802.5946566153,4211,1,1585.263440860215,68,118,45,34.201791232135974,0.6439950980392157,39.43236714975844,8948.146198299723,131.59038526911357,0
4214,34.031417303283405,0,1,185,0.0,0.005376344086021506,0.9946236559139785,186,4350,3000,1350,0.6896551724137931,57,30,27,202.2659015869351,0.42695316284025964,0.7602557779820209,0.1341293236790782,1156361.0991268968,5228.4840549922465,1161589.583181889,4212,2,1586.263440860215,68,118,45,34.03875665971742,0.6452205882352942,39.311594202898554,8871.595923808854,130.4646459383655,0
4215,33.43688840665036,0,0,185,0.0,0.0,1.0,185,5250,3900,1350,0.7428571428571429,66,39,27,202.0780554618926,0.426843419506463,0.7586279188015803,0.13442042387771264,1137080.7954434066,3705.8152092532055,1140786.6106526598,4213,3,1591.945945945946,68,117,44,33.935841775205034,0.6462928921568627,39.205917874396135,8720.142621148627,128.2373914874798,0
4216,32.96431536042206,0,0,185,0.0,0.0,1.0,185,4550,3200,1350,0.7032967032967034,59,32,27,206.61918146053256,0.42675283979631806,0.7641875707120362,0.13796118536667876,1122115.4005851327,4820.113114631561,1126935.5136997642,4214,4,1592.945945945946,69,116,43,33.68621915516522,0.6470410628019323,39.077380952380956,8601.135498952995,124.65413766598544,0
4217,32.67431718750708,0,0,185,0.0,0.0,1.0,185,5850,4100,1750,0.7008547008547008,76,41,35,207.54097989103872,0.42641132980806895,0.7654034335292885,0.1391857397250915,1113512.8065455046,3369.90779833508,1116882.7143438398,4215,5,1593.945945945946,69,116,37,33.510269417844675,0.6485507246376812,38.92857142857144,8530.330665738476,123.62798066287647,0
4218,32.93803313159827,0,1,184,0.0,0.005405405405405406,0.9945945945945946,185,4900,3400,1500,0.6938775510204082,64,34,30,209.83783205089816,0.42632319819819825,0.7680467120305325,0.141176609454652,1123430.2049072941,5247.6317316486575,1128677.8366389428,4216,6,1594.945945945946,70,115,37,33.33988690409316,0.6491071428571429,38.82042253521127,8602.74157583206,122.8963082261723,0
4219,32.97760971163247,0,0,184,0.0,0.0,1.0,184,4250,2600,1650,0.611764705882353,59,26,33,211.25076089143263,0.42543446087748477,0.7683419521654835,0.14270957515242125,1125968.8921025523,6522.3570393492455,1132491.2491419015,4217,7,1604.3260869565217,73,111,37,33.16207893413776,0.648972602739726,38.682432432432414,8617.62875403634,118.04970895940191,0
4220,32.91133329775969,0,0,184,0.0,0.0,1.0,184,4500,3000,1500,0.6666666666666666,60,30,30,211.17699139884158,0.4252550338560228,0.7686613008374716,0.14314107796522696,1124681.0741369969,6201.353103893498,1130882.4272408905,4218,8,1605.3260869565217,75,109,39,33.048259410716156,0.6491666666666667,38.5690789473684,8604.040177103416,114.72053569471221,0
4221,32.930610790640586,0,0,184,0.0,0.0,1.0,184,6000,4500,1500,0.75,75,45,30,210.7603633125151,0.4247965668804942,0.7685913546117129,0.14354938131127942,1126733.4051923584,4694.148366937533,1131427.553559296,4219,9,1606.3260869565217,61,123,38,32.89391993149219,0.6588114754098361,38.407258064516114,8614.408770333868,141.2198159071126,0
4222,32.933193248650944,0,0,184,0.0,0.0,1.0,184,4850,3300,1550,0.6804123711340206,64,33,31,208.06961081116452,0.4243343876217629,0.7656733792493875,0.14223460921545103,1127873.0646123365,5285.221919656826,1133158.2865319932,4220,10,1607.3260869565217,64,120,44,32.839767926030255,0.6580403645833333,38.28525641025641,8619.102226662151,134.6734722915961,0
4223,33.18780737972565,0,0,184,0.0,0.0,1.0,184,5400,4100,1300,0.7592592592592593,67,41,26,206.53149340288775,0.4242267314088857,0.7635570219786074,0.14179515135307486,1137846.007976129,4800.2070579647425,1142646.2150340937,4221,11,1608.3260869565217,64,120,43,32.732813137494894,0.6595052083333333,38.141025641025635,8690.525201678145,135.78945627622102,0
4224,33.49393811471799,0,0,184,0.0,0.0,1.0,184,5750,4000,1750,0.6956521739130435,75,40,35,203.1986737632665,0.42382332996752986,0.7597421469051113,0.14004407404637523,1149462.3653715109,4163.845636855654,1153626.2110083664,4222,12,1609.3260869565217,68,116,42,32.68974972148592,0.6583946078431373,38.01328502415459,8774.96681827923,129.0436296805769,0
4225,33.10896143069712,0,0,184,0.0,0.0,1.0,184,4400,3000,1400,0.6818181818181818,58,30,28,200.85440741645002,0.42372062346558964,0.7448246905193245,0.12854682074652776,1114434.581977005,3567.8195134780162,1118002.401490483,4223,13,1610.3260869565217,73,111,39,35.32918294270835,0.6301369863013699,40.54054054054053,8590.433236072746,117.67716761743488,8
4226,32.74765954553604,0,0,184,0.0,0.0,1.0,184,4000,2900,1100,0.725,51,29,22,200.56558212144876,0.42338218698028035,0.7448478761047548,0.12876572189171248,1103208.009433666,3453.111322621544,1106661.1207562876,4224,14,1611.3260869565217,74,110,38,35.22448588296144,0.6307713963963963,40.43055555555555,8500.291795090583,114.86880804176464,0
4227,32.64583990788472,0,0,184,0.0,0.0,1.0,184,4150,2600,1550,0.6265060240963856,57,26,31,199.88584870927784,0.4234292092341807,0.7453573887675873,0.12875868294709045,1100767.0396866212,3055.550791791905,1103822.590478413,4225,15,1612.3260869565217,76,108,42,35.12309422101826,0.6310307017543859,40.31385281385281,8477.672387334344,111.5483208859782,0
4228,32.465787616024514,1,0,185,0.005405405405405406,0.0,1.0,185,5350,3900,1450,0.7289719626168224,68,39,29,200.29439150503384,0.4237857422640032,0.7455569454960442,0.129481649941443,1095741.4652345756,1544.1740051987063,1097285.6392397743,4226,0,1604.6054054054055,78,107,43,34.986022296657204,0.6314102564102564,40.189873417721515,8434.940390112688,108.14026141170113,0
4229,32.151100234474804,0,0,185,0.0,0.0,1.0,185,5100,3500,1600,0.6862745098039216,67,35,32,201.48913970127552,0.42372943595769685,0.7490288726146892,0.13060021153080612,1085891.6933371893,1659.0766198540136,1087550.7699570432,4227,1,1605.6054054054055,78,107,45,34.86082221433038,0.6323450854700854,40.097573839662424,8356.148954664139,107.13011480338639,0
4230,32.57014362671508,0,1,184,0.0,0.005405405405405406,0.9945945945945946,185,5600,4300,1300,0.7678571428571429,69,43,26,201.79208136605877,0.42343811202506854,0.74946399136932,0.13113566406228197,1100805.514215013,1826.7671785362177,1102632.2813935492,4228,2,1606.6054054054055,80,105,45,34.76127763763169,0.632421875,40.0077160493827,8467.986030109254,105.84982537636567,0
4231,32.53981974554412,0,1,183,0.0,0.005434782608695652,0.9945652173913043,184,5550,4100,1450,0.7387387387387387,70,41,29,199.98181821422824,0.42287731646471843,0.7455230161955071,0.1302490276890926,1100433.5103847133,1663.3388461199925,1102096.8492308334,4229,3,1613.5326086956522,80,104,34,34.729639519359154,0.633203125,39.93055555555554,8462.612843545992,105.7826605443249,0
4232,32.01958984227455,0,0,183,0.0,0.0,1.0,183,4650,3300,1350,0.7096774193548387,60,33,27,201.48080962404222,0.4225014511899758,0.7459852924900061,0.13161346425595127,1083690.9327709074,2418.5853033831454,1086109.5180742906,4230,4,1622.950819672131,84,99,37,34.58647354372742,0.6326884920634921,39.82843137254902,8330.586916072165,99.17365376276386,0
4233,31.93833196403267,0,1,182,0.0,0.00546448087431694,0.994535519125683,183,4700,2800,1900,0.5957446808510638,66,28,38,204.81697479632487,0.42247142656978726,0.7516967943337725,0.13423322927637296,1081883.2293699842,3017.610024487534,1084900.8393944718,4231,5,1623.950819672131,86,97,37,34.38396047042947,0.6331153100775193,39.71503831417623,8313.06751156733,96.66357571589919,0
4234,32.02743265198257,0,0,182,0.0,0.0,1.0,182,4600,3400,1200,0.7391304347826086,58,34,24,207.24743000436638,0.42193602898022786,0.7548348619999428,0.13625519229217545,1085806.5843110522,4006.124816057068,1089812.7091271093,4232,22,1633.8461538461538,89,93,39,34.209892731205734,0.6331928838951311,39.60648148148149,8339.735877364647,93.70489749847917,0
4235,31.998865977173672,0,0,182,0.0,0.0,1.0,182,4900,3000,1900,0.6122448979591837,68,30,38,203.35639992720724,0.42171910731993606,0.7502357711295762,0.13428877057037536,1086101.4229522164,2873.1350654760217,1088974.5580176923,4233,23,1634.8461538461538,72,110,41,34.1565574967596,0.6416377314814814,39.45490867579909,8337.147458293588,115.79371469852205,0
4236,32.22427129376999,0,1,181,0.0,0.005494505494505495,0.9945054945054945,182,5600,4300,1300,0.7678571428571429,69,43,26,198.14852507280608,0.4212833667253557,0.7430282883342205,0.1313424124399003,1094832.1612891378,1387.8755923430422,1096220.0368814808,4234,24,1635.8461538461538,76,106,39,34.16108775753803,0.6410361842105263,39.326298701298704,8400.020069800516,110.52657986579625,0
4237,32.507476662662306,0,0,181,0.0,0.0,1.0,181,5000,3800,1200,0.76,62,38,24,199.2751502212432,0.42076427255985266,0.7433478141262246,0.13266660553403176,1105715.5225984831,2868.3253735545163,1108583.8479720377,4235,25,1645.6298342541436,76,105,43,33.979944674965445,0.6425438596491229,39.17748917748917,8478.681683659737,111.56160110078602,0
4238,32.774622465246466,0,0,181,0.0,0.0,1.0,181,4900,3200,1700,0.6530612244897959,66,32,34,199.97308451554085,0.4204049007571107,0.7460087304295424,0.13379233107453617,1116242.3476708997,3543.6850661235403,1119786.0327370232,4236,26,1646.6298342541436,77,104,46,33.78996529021474,0.6438041125541125,39.009081196581185,8553.878830639816,111.08933546285476,0
4239,32.86858707336888,0,0,181,0.0,0.0,1.0,181,4250,2900,1350,0.6823529411764706,56,29,27,204.90710784482206,0.42009796398608557,0.7512721177682142,0.13761577832284175,1120548.4027630205,5471.666482061003,1126020.0692450814,4237,27,1647.6298342541436,79,102,37,33.52967820218743,0.6442510548523206,38.88020833333333,8582.638608975762,108.6409950503261,0
4240,33.03277120006445,0,0,181,0.0,0.0,1.0,181,4900,3300,1600,0.673469387755102,65,33,32,205.2558334896712,0.4198895027624309,0.752476034712968,0.13855947617489509,1127641.8855440682,5191.015019042563,1132832.9005631108,4238,28,1648.6298342541436,81,100,41,33.343613771533214,0.6451903292181069,38.706808943089435,8631.238196317667,106.55849625083539,0
4241,32.77583983700435,0,0,181,0.0,0.0,1.0,181,5700,4200,1500,0.7368421052631579,72,42,30,207.1727232189102,0.41989206056885614,0.7563695262110259,0.12994337565300912,1097172.6417525278,3560.848806631372,1100733.490559159,4239,29,1649.6298342541436,72,109,39,35.892318792624856,0.6234085648148149,41.25285388127853,8480.65501946916,117.786875270405,8
4242,32.40321646196236,0,1,180,0.0,0.0055248618784530384,0.994475138121547,181,4500,2900,1600,0.6444444444444445,61,29,32,206.65660763358844,0.4197219664415797,0.7563355272957797,0.12982787989783096,1085177.6636017512,4151.826927936076,1089329.4905296874,4240,30,1650.6298342541436,72,109,42,35.84741596368381,0.6239872685185186,41.19577625570775,8386.089283256406,116.47346226745009,0
4243,32.49780310166456,0,2,178,0.0,0.011111111111111112,0.9888888888888889,180,4700,3300,1400,0.7021276595744681,61,33,28,203.08109289730558,0.4196946772191186,0.7504933628190174,0.12817610818770617,1089732.9672583728,3560.8323914108655,1093293.7996497836,4241,31,1659.7055555555555,76,104,44,35.771670236291804,0.623766447368421,41.030844155844164,8415.928636027678,110.73590310562734,0
4244,32.3949582722809,0,0,178,0.0,0.0,1.0,178,5000,4000,1000,0.8,60,40,20,203.05433177016272,0.41840972089972284,0.7482173585919825,0.12851716091384616,1087112.3858153124,3548.5758121590934,1090660.9616274715,4242,32,1671.7865168539327,77,101,41,35.671673368043024,0.6243235930735931,40.93215811965812,8392.491927403536,108.99340165459138,0
4245,32.40452313660255,2,0,180,0.011111111111111112,0.0,1.0,180,5500,3600,1900,0.6545454545454545,74,36,38,200.43251249676817,0.4195375543140906,0.749247909021787,0.12782802172706575,1089689.2361200077,2181.830287243332,1091871.066407251,4243,0,1654.2,80,100,43,35.46563522761084,0.62578125,40.663580246913575,8403.673014052543,105.0459126756568,0
4246,32.49037659438811,1,0,181,0.0055248618784530384,0.0,1.0,181,5000,3800,1200,0.76,62,38,24,197.74401431205303,0.42003401882545527,0.7471952724062962,0.12668112129219586,1093904.855777568,2062.627491380669,1095967.4832689485,4244,0,1646.0552486187846,69,112,44,35.374612914325034,0.6325483091787439,40.50595238095237,8431.05933114492,122.18926566876695,0
4247,32.31560084097002,0,0,181,0.0,0.0,1.0,181,4750,3100,1650,0.6526315789473685,64,31,33,194.5404219509493,0.41995472682627377,0.7428259244873789,0.1250185057065918,1088936.8435964177,1418.4466062362767,1090355.290202654,4245,1,1647.0552486187846,72,109,45,35.34635574121912,0.6320891203703703,40.396689497716885,8389.236959186164,116.51717998869672,0
4248,32.382059862808056,0,0,181,0.0,0.0,1.0,181,4850,3600,1250,0.7422680412371134,61,36,25,193.09074441739733,0.41989333947206875,0.7405690566367791,0.12441112126521303,1091942.5602696573,1118.8003647011637,1093061.3606343584,4246,2,1648.0552486187846,74,107,46,35.29109619567157,0.6320382882882882,40.30555555555554,8409.441046038648,113.64109521673849,0
4249,32.42111964898099,0,0,181,0.0,0.0,1.0,181,5750,4400,1350,0.7652173913043478,71,44,27,192.92009620418656,0.4198792715367301,0.7407871504243331,0.12475499554537342,1094329.094784498,273.61484897291757,1094602.709633471,4247,3,1649.0552486187846,76,105,42,35.16609392898052,0.6324013157894737,40.178571428571416,8423.701623083422,110.83817925109766,0
4250,32.43196530119767,0,0,181,0.0,0.0,1.0,181,4700,3200,1500,0.6808510638297872,62,32,30,192.15301444409272,0.4198971761817066,0.7400266208470934,0.12462093036072518,1095547.3807246902,1202.5463345156804,1096749.927059206,4248,4,1650.0552486187846,77,104,45,35.082967254106094,0.6329816017316017,40.07745726495725,8429.798886981946,109.47790762314214,0
4251,32.88717626950115,1,1,181,0.005494505494505495,0.005494505494505495,0.9945054945054945,182,5150,3600,1550,0.6990291262135923,67,36,31,192.8099869046632,0.4204966304413818,0.7422028387349835,0.1255939293826804,1112218.0258430317,1339.3485995848655,1113557.3744426165,4249,0,1641.9835164835165,78,104,37,34.91167697559655,0.6340811965811965,39.92616033755273,8553.094208064847,109.65505394954933,0
4252,32.38776624169227,0,0,181,0.0,0.0,1.0,181,4200,3000,1200,0.7142857142857143,54,30,24,193.09263269018123,0.41985753018211586,0.7411102878807878,0.12593573370067698,1095693.5361110126,1914.0699018578039,1097607.6060128703,4250,6,1652.0552486187846,79,102,38,34.860141245765966,0.6340981012658228,39.882812499999986,8424.614664196402,106.6406919518532,0
4253,32.502797691662614,0,0,181,0.0,0.0,1.0,181,4700,3200,1500,0.6808510638297872,62,32,30,193.45204529191187,0.4200595968897074,0.7417719359760448,0.12672195775863349,1100859.3156709808,1692.6972390408018,1102552.0129100217,4251,7,1653.0552486187846,83,98,39,34.69720792833999,0.6340361445783133,39.73214285714283,8459.433506356765,101.9208856187562,0
4254,32.576409784929496,0,0,181,0.0,0.0,1.0,181,4650,3500,1150,0.7526881720430108,58,35,23,194.8762399022929,0.4198997339881318,0.7432178728255434,0.1279309499846377,1103983.4714396961,2178.0295656894104,1106161.5010053855,4252,8,1654.0552486187846,83,98,39,34.584285986472274,0.634789156626506,39.657738095238074,8481.016208144907,102.18091817042057,0
4255,32.49540525609435,0,1,180,0.0,0.0055248618784530384,0.994475138121547,181,5900,4800,1100,0.8135593220338984,70,48,22,194.87661693363057,0.4197628913443831,0.7424818653037946,0.12831486335759848,1102109.3725233437,855.0692016391899,1102964.4417249828,4253,9,1655.0552486187846,72,109,40,34.47932646650597,0.640625,39.55479452054795,8463.272499061573,117.54545137585518,0
4256,32.57496886648226,0,1,179,0.0,0.005555555555555556,0.9944444444444445,180,4900,3500,1400,0.7142857142857143,63,35,28,196.72893358606078,0.41907523794744467,0.7426230049400055,0.13001247017535122,1105879.6584723613,2611.705177157143,1108491.3636495185,4254,11,1665.2,73,107,41,34.30229548196569,0.6414098173515982,39.42849099099101,8488.108793460813,116.27546292412073,0
4257,32.84399408276495,1,0,180,0.005555555555555556,0.0,1.0,180,4650,3300,1350,0.7096774193548387,60,33,27,195.50797169065683,0.41910239499275814,0.741021497738948,0.12977636649848084,1116302.9380144258,2999.2246407046714,1119302.1626551305,4255,0,1665.8222222222223,74,106,42,34.180450493643036,0.642454954954955,39.27777777777781,8563.159123912068,115.71836653935227,0
4258,32.57188297165261,0,1,179,0.0,0.005555555555555556,0.9944444444444445,180,5100,3400,1700,0.6666666666666666,68,34,34,197.55702821746982,0.4189969997930892,0.743169848776785,0.13154339562555825,1107951.6178927356,2676.725807925389,1110628.343700661,4256,1,1666.8222222222223,75,105,40,34.01931161324223,0.6430555555555555,39.17214912280702,8495.6542345196,113.27538979359466,0
4259,32.27593507901712,0,0,179,0.0,0.0,1.0,179,5450,3900,1550,0.7155963302752294,70,39,31,196.03793377129458,0.4184203230598624,0.7402559209014863,0.13118238205101465,1099307.828632327,1851.2070607380579,1101159.035693065,4257,2,1666.8491620111731,78,101,43,33.88663652285206,0.6434294871794872,39.003164556962034,8423.916916588429,107.99893482805678,0
4260,32.513570366871015,0,1,178,0.0,0.00558659217877095,0.994413407821229,179,3600,2600,1000,0.7222222222222222,46,26,20,194.48754789261534,0.41849094009582993,0.7384158911180028,0.13043580144591976,1108044.048953449,3700.154007592328,1111744.2029610411,4258,3,1667.8491620111731,80,99,40,33.84993350081277,0.643359375,38.927469135802475,8488.40010311021,106.10500128887763,0
4261,32.51778561094711,0,0,178,0.0,0.0,1.0,178,4550,3100,1450,0.6813186813186813,60,31,29,194.01599570016154,0.4185413095918238,0.7370556988589156,0.13052908611241262,1109090.5823550026,2886.26273145567,1111976.8450864584,4259,4,1657.4101123595506,81,97,40,33.75385051880672,0.6440329218106996,38.82113821138212,8492.958233753483,104.8513362191788,0
4262,32.46193875588861,0,0,178,0.0,0.0,1.0,178,4950,3100,1850,0.6262626262626263,68,31,37,195.54309555082193,0.4181736547535919,0.7390458770390835,0.13196966762510604,1108083.5086105757,2785.6158805055525,1110869.1244910813,4260,5,1658.4101123595506,83,95,42,33.60603543743077,0.6443273092369478,38.71527777777777,8481.80865062713,102.1904656702064,0
4263,32.8512987719436,0,0,178,0.0,0.0,1.0,178,5300,4000,1300,0.7547169811320755,66,40,26,196.0279495560339,0.41792171861444377,0.7404962085959557,0.13288415150552507,1122654.4381008106,3114.329512176728,1125768.7676129874,4261,6,1659.4101123595506,84,94,45,33.441342833481784,0.6454613095238095,38.56617647058824,8588.440645856293,102.24334102209873,0
4264,32.52152871504607,0,1,177,0.0,0.0056179775280898875,0.9943820224719101,178,4750,3800,950,0.8,57,38,19,196.60064237055997,0.4175712562686473,0.7406115591741547,0.13372495705514548,1112352.660824424,3387.8495321365936,1115740.5103565606,4262,7,1660.4101123595506,69,109,43,33.31033796085572,0.6533816425120773,38.45238095238095,8505.928403209067,123.27432468418938,0
4265,32.751190654450795,0,0,177,0.0,0.0,1.0,177,4450,3100,1350,0.6966292134831461,58,31,27,196.70362227404988,0.41697697312104093,0.7399173691459926,0.13435187072192908,1121399.1232755114,4266.653912647298,1125665.7771881588,4263,20,1670.7514124293784,72,105,42,33.16588509006306,0.6532118055555556,38.313356164383556,8570.549163983624,119.03540505532811,0
4266,32.948866311944194,0,0,177,0.0,0.0,1.0,177,4300,2700,1600,0.627906976744186,59,27,32,196.07886276808028,0.4168432203389831,0.7391813138882124,0.13457134327508613,1129552.5041903423,4596.274091695894,1134148.7782820382,4264,21,1671.7514124293784,74,103,43,33.018507222546376,0.6538569819819819,38.15277777777778,8627.569119153943,116.58877188045868,0
4267,32.53364227131779,0,0,177,0.0,0.0,1.0,177,4550,3500,1050,0.7692307692307693,56,35,21,195.2066479974418,0.41654361410717344,0.7380811808781278,0.1344210510361356,1116264.539349051,3630.4518009474104,1119894.9911499983,4265,22,1672.7514124293784,74,103,42,32.92806585016702,0.6549831081081081,38.04166666666667,8522.4587066573,115.16836090077433,0
4268,32.50943844940364,1,1,177,0.0056179775280898875,0.0056179775280898875,0.9943820224719101,178,4900,3900,1000,0.7959183673469388,59,39,20,197.96724580621753,0.4172803063966652,0.7427234210154214,0.13695816473171066,1116749.188637573,3715.9522261816724,1120465.1408637548,4266,0,1664.3483146067415,77,101,36,32.69831312307874,0.655167748917749,37.887286324786324,8521.137132030515,110.6641185977989,0
4269,32.20724468245868,0,0,177,0.0,0.0,1.0,177,3950,2900,1050,0.7341772151898734,50,29,21,197.09068096716018,0.4163122217942133,0.7400217631113246,0.13657208464759352,1106819.3718312543,4278.756740373297,1111098.1285716277,4267,24,1674.7514124293784,77,100,36,32.66681736369347,0.6557088744588744,37.83386752136752,8443.648776193199,109.65777631419738,0
4270,31.88367384340659,0,0,177,0.0,0.0,1.0,177,4600,3600,1000,0.782608695652174,56,36,20,195.71929099760806,0.41599121511727444,0.7384725704879387,0.135801598771055,1096065.6909197487,2904.23998272334,1098969.930902472,4268,25,1675.7514124293784,78,99,38,32.65813051057695,0.655715811965812,37.790084388185655,8360.215427874258,107.182249075311,0
4271,31.41540456317115,0,1,176,0.0,0.005649717514124294,0.9943502824858758,177,5400,3300,2100,0.6111111111111112,75,33,42,197.52796398440364,0.41584542458483137,0.7408281414539926,0.13751451909057538,1080874.652273244,1900.5938771767346,1082775.2461504207,4269,26,1676.7514124293784,80,97,40,32.4984884138968,0.6559895833333333,37.68004115226337,8240.887632196043,103.01109540245054,0
4272,31.730078308719673,0,0,176,0.0,0.0,1.0,176,4900,3300,1600,0.673469387755102,65,33,32,200.219173242873,0.4151190476190476,0.7437394856613762,0.1399927639594856,1092886.779372138,3663.377482791294,1096550.1568549292,4270,27,1686.8181818181818,82,94,41,32.282651142032876,0.6566310975609756,37.53765060240965,8327.95089947611,101.5603768228794,0
4273,31.660701392972936,0,0,176,0.0,0.0,1.0,176,5200,3400,1800,0.6538461538461539,70,34,36,197.54359962883953,0.4144791666666667,0.7400919626310576,0.1390884054799201,1092395.8038861423,2759.1598638216665,1095154.963749964,4271,28,1687.8181818181818,70,106,41,32.119985106581,0.6644345238095238,37.30927230046948,8316.972688397595,118.81389554853706,0
4274,31.78953904594628,0,0,176,0.0,0.0,1.0,176,4000,2700,1300,0.675,53,27,26,195.27042833406992,0.4142431006493506,0.7371412764569261,0.13804976022057627,1097952.3366334487,3679.524612961295,1101631.86124641,4272,29,1688.8181818181818,73,103,40,32.044067894952974,0.6642408675799087,37.17623873873874,8355.04622081733,114.45268795640179,0
4275,31.84527720299041,0,0,176,0.0,0.0,1.0,176,4350,3500,850,0.8045977011494253,52,35,17,196.33606383174416,0.4140875270562771,0.7375958936116362,0.1391036543293496,1100466.5924610724,3662.2558284278302,1104128.8482895002,4273,30,1689.8181818181818,73,103,41,31.94429570928823,0.6649543378995434,37.10585585585586,8371.93689531319,114.68406705908481,0
4276,31.660575460551275,0,0,176,0.0,0.0,1.0,176,5550,3900,1650,0.7027027027027027,72,39,33,195.5494559356927,0.41351393398268393,0.7358798379837992,0.13908799330637306,1095138.652455932,2080.7535323810603,1097219.405988313,4274,31,1690.8181818181818,75,101,42,31.835808580858096,0.6652777777777779,36.97916666666667,8327.390941447087,111.0318792192945,0
4277,31.555747913174848,0,0,176,0.0,0.0,1.0,176,3700,2700,1000,0.7297297297297297,47,27,20,194.24178146989846,0.41340097402597403,0.7334113518701368,0.13855726207530586,1092288.6988468058,3533.6205486883064,1095822.3193954942,4275,32,1691.8181818181818,77,99,37,31.774904409027823,0.6653138528138528,36.88568376068377,8302.769035595253,107.82816929344484,0
4278,31.646795086641514,0,1,175,0.0,0.005681818181818182,0.9943181818181818,176,3900,2500,1400,0.6410256410256411,53,25,28,192.74577265377064,0.412830762987013,0.7319422429617082,0.13773766116708255,1095924.527932817,3146.9639813260187,1099071.491914143,4276,33,1692.8181818181818,78,98,37,31.75499357015218,0.6654647435897436,36.82753164556963,8328.565178458326,106.77647664690161,0
4279,32.11989551007759,0,0,175,0.0,0.0,1.0,175,4600,3000,1600,0.6521739130434783,62,30,32,194.38067411040373,0.41208401751505197,0.7315819084390516,0.13907346573092447,1112636.9011457295,3655.0221769635746,1116291.923322693,4277,34,1703.0285714285715,81,94,37,31.672297297297312,0.6646090534979423,36.78861788617887,8454.322090559057,104.3743467970254,0
4280,32.50090981578121,0,0,175,0.0,0.0,1.0,175,5350,4100,1250,0.7663551401869159,66,41,25,198.99220552707595,0.4118650793650794,0.7389180809062144,0.14310459234106426,1127248.4516818505,4512.7311154307845,1131761.1827972813,4278,35,1704.0285714285715,81,94,38,31.38248806250907,0.6662808641975309,36.62347560975611,8559.976666801262,105.67872428149705,0
4281,32.059977775086715,0,0,175,0.0,0.0,1.0,175,5300,4000,1300,0.7547169811320755,66,40,26,204.1900357762186,0.4114969896004379,0.7462902315076225,0.1476002258610955,1113350.2156062995,5167.004071222294,1118517.2196775218,4279,36,1705.0285714285715,84,91,40,31.077075098814262,0.6667906746031746,36.45833333333334,8449.13997614267,100.58499971598415,0
4282,32.310883450855606,0,1,174,0.0,0.005714285714285714,0.9942857142857143,175,3950,2700,1250,0.6835443037974683,52,27,25,204.0194900221977,0.41111111111111115,0.7454575228344076,0.14801914635401356,1123063.1100590932,6875.352595399876,1129938.462654493,4280,37,1706.0285714285715,70,105,39,30.961804203067885,0.6742559523809524,36.34096244131455,8519.056433323443,121.7008061903349,0
4283,32.006383868622606,0,0,174,0.0,0.0,1.0,174,4300,3000,1300,0.6976744186046512,56,30,26,210.46359595243214,0.410493211968197,0.7497189839244078,0.14230093951547992,1093051.7965002388,6909.522330741291,1099961.3188309802,4281,38,1716.0632183908046,83,91,40,33.15287663107948,0.6449548192771084,38.65327380952381,8364.76364126019,100.78028483446012,8
4284,31.64500286446225,0,0,174,0.0,0.0,1.0,174,4750,3600,1150,0.7578947368421053,59,36,23,211.10530335391422,0.4105153588908821,0.7510059895984877,0.14305267888010478,1081329.3130921435,6104.8705331593455,1087434.1836253027,4282,39,1717.0632183908046,84,90,40,33.059683417713615,0.6453373015873016,38.57843137254902,8272.6862880479,98.4843605719988,0
4285,31.314645123024487,0,0,174,0.0,0.0,1.0,174,3800,2100,1700,0.5526315789473685,55,21,34,209.82245460167465,0.41029042920736164,0.7503060158232562,0.1427237544552035,1071083.5213293836,6347.4747057476,1077430.9960351312,4283,40,1718.0632183908046,68,106,41,32.96320346320348,0.6539522058823529,38.45108695652176,8190.311394269364,120.44575579807889,0
4286,31.056824643402713,0,0,174,0.0,0.0,1.0,174,4050,2700,1350,0.6666666666666666,54,27,27,208.75025710321984,0.40991739197838456,0.7485877890883532,0.14248223633509163,1063197.9194360194,5538.567806775695,1068736.487242795,4284,41,1719.0632183908046,70,104,43,32.87403046444257,0.6540178571428572,38.33626760563382,8126.444652510129,116.09206646443042,0
4287,31.5117964783592,0,0,174,0.0,0.0,1.0,174,4500,2900,1600,0.6444444444444445,61,29,32,224.19409434233154,0.4095132106393817,0.7622618600525224,0.13703603232563932,1047313.105537152,7660.282637751667,1054973.3881749038,4285,42,1720.0632183908046,68,106,42,36.399778467424,0.6161151960784313,42.179951690821284,8124.372890359638,119.4760719170535,8
4288,31.864242032976176,0,0,174,0.0,0.0,1.0,174,5100,3900,1200,0.7647058823529411,63,39,24,231.77024431094202,0.41015685557991716,0.7683882274109579,0.1331457633008762,1040222.4606065685,8318.52276650279,1048540.9833730713,4286,43,1721.0632183908046,69,105,38,38.556954069846455,0.5922403381642511,44.47916666666667,8141.977677801107,117.99967648987112,8
4289,31.69002845392855,4,4,174,0.02247191011235955,0.02247191011235955,0.9775280898876404,178,4750,4100,650,0.8631578947368421,54,41,13,223.94795655348693,0.4136678992361243,0.7653049027404397,0.12991237882687254,1037517.642741997,6119.9911960525205,1043637.6339380495,4287,0,1683.3651685393259,74,104,34,38.38053173397019,0.5934684684684685,44.111111111111136,8109.126169933108,109.58278608017713,0
4290,31.48524335526899,1,0,175,0.005714285714285714,0.0,1.0,175,3750,2600,1150,0.6933333333333334,49,26,23,228.7289559845806,0.41176245210727974,0.7665838974947405,0.13294470130756456,1031403.5670684831,8432.372218869372,1039835.9392873525,4288,0,1712.4914285714285,75,100,35,38.183232931726906,0.59375,44.037828947368425,8059.031245335103,107.45374993780138,0
4291,31.930716732120104,3,0,178,0.016853932584269662,0.0,1.0,178,4900,3800,1100,0.7755102040816326,60,38,22,221.38620784377466,0.4147490425104213,0.7636737205701365,0.12998401829831518,1049091.5660603205,5950.880698195946,1055042.4467585164,4289,0,1684.612359550562,68,110,36,37.9843934040047,0.6011029411764706,43.65942028985505,8185.138437672042,120.36968290694179,0
4292,32.43013680473559,1,1,178,0.00558659217877095,0.00558659217877095,0.994413407821229,179,5050,3400,1650,0.6732673267326733,67,34,33,209.25692030353179,0.4159997279936392,0.7510157179556909,0.12440438888374815,1069354.418253804,3903.962455353229,1073258.3807091573,4290,0,1676.195530726257,78,101,41,37.8224053535976,0.6009615384615384,43.196202531645575,8328.182283874357,106.77156774197894,8
4293,32.906351684590746,1,1,178,0.00558659217877095,0.00558659217877095,0.994413407821229,179,5100,3400,1700,0.6666666666666666,68,34,34,210.62819576333175,0.4158467244157094,0.7531481201872279,0.12569747166521358,1086246.0324123395,4858.808392417597,1091104.840804757,4291,0,1677.1787709497207,80,99,34,37.6435810810811,0.6015625,43.05555555555554,8455.104252290643,105.68880315363303,0
4294,32.92914989431929,1,1,178,0.00558659217877095,0.00558659217877095,0.994413407821229,179,4400,3000,1400,0.6818181818181818,58,30,28,200.2280500559835,0.4158611093674806,0.7441937586413487,0.12040840938631625,1089379.9266731793,3424.8836975798317,1092804.810370759,4292,0,1678.173184357542,78,101,42,37.62388080103887,0.6052350427350428,42.7742616033755,8470.22489633934,108.59262687614537,8
4295,32.41692307199274,1,0,179,0.00558659217877095,0.0,1.0,179,4750,3500,1250,0.7368421052631579,60,35,25,200.05012753057053,0.41604419057184105,0.7448789571694594,0.12091080035023836,1073977.132140184,2419.852449912247,1076396.9845900964,4293,0,1679.1564245810057,69,110,42,37.43978109222648,0.6114130434782609,42.58928571428573,8344.463322906737,120.93425105661937,0
4296,32.07647679850683,4,1,182,0.02185792349726776,0.00546448087431694,0.994535519125683,183,4500,3100,1400,0.6888888888888889,59,31,28,196.6434884910295,0.4199631197582017,0.7458861829978414,0.12010200032517326,1065845.886284087,818.3306545434407,1066664.2169386304,4294,0,1643.431693989071,74,109,49,37.139028069608294,0.6127533783783784,42.20833333333335,8269.048414681782,111.74389749569976,0
4297,31.73529930476414,1,1,182,0.00546448087431694,0.00546448087431694,0.994535519125683,183,5150,4000,1150,0.7766990291262136,63,40,23,195.37163077151797,0.42010823875577974,0.7450023143752025,0.1197558093764963,1055576.9074418398,-504.0436376662874,1055072.8638041734,4295,0,1644.3989071038252,75,108,38,37.03878378857124,0.6136111111111111,42.07785087719299,8185.236599740316,109.13648799653754,0
4298,31.55108981313592,0,1,181,0.0,0.005494505494505495,0.9945054945054945,182,4400,2800,1600,0.6363636363636364,60,28,32,198.6826435553224,0.41929628842612265,0.7479269376114159,0.1221554359102713,1050342.2305921374,936.9542023680315,1051279.1847945054,4296,2,1654.434065934066,75,107,38,36.84155777470875,0.6147222222222222,41.96820175438597,8141.184441092357,108.54912588123142,0
4299,31.779839722776288,0,0,181,0.0,0.0,1.0,181,5550,4200,1350,0.7567567567567568,69,42,27,192.5654797918074,0.4182243707796194,0.7401109362579057,0.11227852657910638,1042016.2106190776,-1618.729690259157,1040397.4809288183,4297,3,1664.5635359116022,85,96,38,38.988348626746145,0.5909313725490196,43.91957364341086,8138.194905752629,95.7434694794427,8
4300,31.80810263052809,4,2,183,0.021621621621621623,0.010810810810810811,0.9891891891891892,185,4100,2900,1200,0.7073170731707317,53,29,24,185.12959623384748,0.4218982569526048,0.7363965869783409,0.10864040957688903,1044906.23779115,-2411.3860190995815,1042494.8517720504,4298,0,1629.5513513513513,72,113,41,38.93338621982223,0.5988136574074074,43.678652968036495,8153.095712787817,113.23744045538635,0
4301,31.69587148654899,1,1,183,0.005434782608695652,0.005434782608695652,0.9945652173913043,184,4850,3600,1250,0.7422680412371134,61,36,25,183.2728348893823,0.42126618555476364,0.7319562893593303,0.10789914225237016,1042198.9373433982,-3448.649246874998,1038750.2880965233,4299,0,1639.3152173913043,75,109,44,38.85823089257081,0.5986111111111111,43.5581140350877,8128.1490613120595,108.37532081749413,0
4302,32.192851432339836,5,0,188,0.026595744680851064,0.0,1.0,188,5550,4000,1550,0.7207207207207207,71,40,31,176.97033727616716,0.42474316854401334,0.7268585047113802,0.1052053178775401,1061517.0142154568,-5578.595193980159,1055938.4190214765,4300,0,1605.3563829787233,82,106,49,38.6531538135731,0.599339430894309,43.19779116465863,8267.19535653285,100.81945556747377,0
4303,32.51669068337623,2,5,185,0.010526315789473684,0.02631578947368421,0.9736842105263158,190,5700,4100,1600,0.7192982456140351,73,41,32,175.83903170271617,0.4256404901141743,0.7279071151980914,0.10506270728348382,1073754.330353172,-5938.415652820162,1067815.914700352,4301,0,1589.4473684210527,85,105,40,38.49227624075032,0.6001225490196078,43.011143410852696,8356.427158783794,98.31090775039758,0
4304,32.536619982105826,1,0,186,0.005376344086021506,0.0,1.0,186,4700,3400,1300,0.723404255319149,60,34,26,181.04342696842116,0.4227877070619006,0.7311220841596853,0.10811475197808651,1074248.4600299697,-3002.875476125278,1071245.5845538445,4302,0,1624.5698924731182,83,103,41,38.378494675546065,0.6006526104417671,43.03075396825395,8360.910705223121,100.73386391835086,0
4305,32.476742648081455,1,1,186,0.0053475935828877,0.0053475935828877,0.9946524064171123,187,5250,3700,1550,0.7047619047619048,68,37,31,181.78233456326782,0.42345777509439747,0.7331023446908627,0.10922371511365052,1074154.4344797058,-3597.5398437587096,1070556.894635947,4303,0,1616.8770053475937,85,102,46,38.12988603183572,0.6022058823529413,42.805232558139515,8352.848272642412,98.26880320755778,0
4306,32.78230662217276,1,2,185,0.0053475935828877,0.0106951871657754,0.9893048128342246,187,4600,3500,1100,0.7608695652173914,57,35,22,185.50249075626235,0.42328886588848635,0.7373993761871951,0.11205527067982357,1085909.2591043254,-1712.2255401720386,1084197.0335641534,4304,0,1617.7967914438502,73,114,48,37.83514492753622,0.6091609589041096,42.6097972972973,8437.844546543207,115.58691159648228,0
4307,33.230725746127,0,0,185,0.0,0.0,1.0,185,5800,4400,1400,0.7586206896551724,72,44,28,190.1370825796352,0.42166323932628286,0.7417154463263969,0.1151286415458708,1101507.0498780205,-912.532619058321,1100594.5172589622,4305,1,1636.2270270270271,72,113,44,37.62723527673098,0.6105324074074074,42.522831050228326,8556.15318725911,118.8354609341543,0
4308,33.07449915211333,3,0,188,0.015957446808510637,0.0,1.0,188,4850,3200,1650,0.6597938144329897,65,32,33,187.63452993572554,0.42414820135017256,0.7423314904785832,0.11434541891476636,1098321.0932732478,-1233.4075890361137,1097087.6856842118,4306,0,1611.1010638297873,76,112,45,37.45341207349081,0.6110197368421053,42.28896103896106,8523.66353960719,112.1534676264104,0
4309,32.62378937453201,0,0,188,0.0,0.0,1.0,188,5250,3500,1750,0.6666666666666666,70,35,35,192.81976972481544,0.4241683496415975,0.7480000513522953,0.11790028845637698,1084378.0364553516,-1032.0953432061378,1083345.9411121455,4307,1,1612.1010638297873,76,112,50,37.195681830106494,0.6122532894736843,42.167207792207805,8411.482706834524,110.67740403729637,0
4310,32.3175495155302,1,0,189,0.005291005291005291,0.0,1.0,189,5750,4400,1350,0.7652173913043478,71,44,27,193.3060626654613,0.4247063679687793,0.750955387144709,0.1188994273713262,1075983.558845455,-1951.1709493626886,1074032.3878960924,4308,0,1604.5661375661375,79,110,42,36.96492246106236,0.6131329113924051,41.953125000000014,8339.442660140372,105.56256531823256,0
4311,32.32497266864577,1,2,188,0.005263157894736842,0.010526315789473684,0.9894736842105263,190,5100,3700,1400,0.7254901960784313,65,37,28,194.29467334581082,0.42495532813515274,0.7522554585483958,0.12004758719307099,1077586.1894861634,-1226.1486623655437,1076360.040823798,4309,0,1597.1157894736841,83,107,45,36.77380494989272,0.6132028112449799,41.790674603174615,8346.609386241882,100.56155887038412,0
4312,32.704795444686056,1,0,189,0.005291005291005291,0.0,1.0,189,4800,3900,900,0.8125,57,39,18,192.6714491077288,0.4237506566850538,0.749411680139922,0.11941502399176204,1091190.662779282,-551.7427498982997,1090638.9200293839,4310,0,1606.5291005291006,83,106,46,36.70196061958945,0.6143323293172691,41.67906746031748,8448.333257790919,101.78714768422793,0
4313,33.05896046583946,2,1,190,0.010471204188481676,0.005235602094240838,0.9947643979057592,191,5850,4100,1750,0.7008547008547008,76,41,35,189.33573822271111,0.425251446679526,0.7483048388837896,0.11848752650066549,1105961.8098598642,-2170.3808568109166,1103791.4290030533,4311,0,1590.696335078534,74,117,45,36.435848904639215,0.6216216216216216,41.33333333333337,8551.2511071639,115.55744739410676,0
4314,33.405703870806796,0,0,190,0.0,0.0,1.0,190,4100,2300,1800,0.5609756097560976,59,23,36,189.51417318125402,0.424458716235032,0.7475051943584436,0.11879575752512331,1118071.5648475378,278.0816339107432,1118349.6464814486,4312,1,1600.0263157894738,76,114,46,36.3711328976035,0.6212993421052632,41.27435064935068,8642.912425990067,113.72253192092194,0
4315,33.78213365660552,0,1,189,0.0,0.005263157894736842,0.9947368421052631,190,4900,4000,900,0.8163265306122449,58,40,18,192.09173176545764,0.4243919985148055,0.7508999090452455,0.12093855863180938,1132027.6101120801,590.6288065485141,1132618.2389186285,4313,2,1601.0263157894738,77,113,45,36.14623635113056,0.6224296536796536,41.119123931623946,8745.54835648105,113.57855008416946,0
4316,34.132606494561266,0,0,189,0.0,0.0,1.0,189,6200,4600,1600,0.7419354838709677,78,46,32,192.45669116687048,0.4238819936958235,0.7511082842937826,0.12144248937249573,1144479.9784040444,52.56595007485612,1144532.5443541193,4314,3,1610.4391534391534,77,112,47,36.05511792412286,0.6232413419913421,41.038995726495735,8839.01405630394,114.79239034160962,0
4317,34.03200331442376,1,1,189,0.005263157894736842,0.005263157894736842,0.9947368421052631,190,4950,3400,1550,0.6868686868686869,65,34,31,193.67888241113104,0.42410598254896503,0.7536253275268874,0.12266735127120608,1142262.1551938374,1296.4115276945477,1143558.5667215318,4315,0,1602.957894736842,80,110,40,35.88985539617146,0.6233072916666667,40.9079218106996,8817.422463679237,110.21778079599046,0
4318,34.352542958723646,0,0,189,0.0,0.0,1.0,189,5850,4500,1350,0.7692307692307693,72,45,27,196.02540863993804,0.4238233611017299,0.7548015354706805,0.12450803396255981,1153916.6904902402,1589.3981579590868,1155506.0886481993,4316,5,1612.4391534391534,79,110,41,35.7264560099133,0.6247362869198312,40.807291666666686,8903.928647608807,112.70795756466845,0
4319,33.93344206913911,0,0,189,0.0,0.0,1.0,189,5000,3600,1400,0.72,64,36,28,212.40976664954675,0.4235618597320725,0.7717194017004281,0.12732179649245243,1121568.8765853015,4846.436671375221,1126415.3132566768,4317,6,1613.4391534391534,78,111,41,37.43172726806501,0.6040331196581197,42.89293248945145,8724.527780935356,111.852920268402,7
4320,34.04751604731929,1,1,189,0.005263157894736842,0.005263157894736842,0.9947368421052631,190,6250,4900,1350,0.784,76,49,27,212.55906787901552,0.42454631950245986,0.7743527561119492,0.12833453496755584,1127657.8307320368,3688.779477374829,1131346.6102094117,4318,0,1605.9421052631578,64,126,43,37.15753424657533,0.6139322916666667,42.628205128205124,8762.870316024795,136.91984868788742,0
4321,33.86981976051355,0,0,189,0.0,0.0,1.0,189,6100,4800,1300,0.7868852459016393,74,48,26,210.59141859294024,0.42383391496866674,0.7697641125305001,0.1281683800680758,1124318.444994646,3454.363256326198,1127772.808250972,4319,1,1615.3121693121693,69,120,41,36.91013331408217,0.6139794685990339,42.33630952380952,8727.022755257314,126.4785906559031,0
4322,34.17219952539105,0,0,189,0.0,0.0,1.0,189,3950,2200,1750,0.5569620253164557,57,22,35,209.22215499920094,0.4237330669068258,0.7690144279617972,0.1279874477588219,1135989.82559887,5784.84787379232,1141774.6734726622,4320,2,1616.3121693121693,70,119,44,36.75604551920345,0.6153273809523809,42.15082159624413,8811.27357187129,125.87533674101843,0
4323,34.04653880912052,0,0,189,0.0,0.0,1.0,189,5000,3900,1100,0.78,61,39,22,221.9525754580888,0.42361345641487486,0.7801486024524535,0.1278373461886373,1112319.835651819,6576.45045120783,1118896.2861030267,4321,3,1617.3121693121693,70,119,40,38.70733608831238,0.5927083333333334,44.380868544600936,8702.946679449919,124.3278097064274,8
4324,33.86470913783274,1,0,190,0.005263157894736842,0.0,1.0,190,4650,2700,1950,0.5806451612903226,66,27,39,219.1407913013469,0.4246037547572635,0.7782205839881147,0.126634578876558,1107457.3735620661,5887.817034980525,1113345.1905970466,4322,0,1609.7947368421053,71,119,41,38.65197950255512,0.593456572769953,44.25636574074074,8660.68378804209,121.98146180340972,0
4325,33.694339306688846,1,1,190,0.005235602094240838,0.005235602094240838,0.9947643979057592,191,5150,3400,1750,0.6601941747572816,69,34,35,215.81963262464484,0.425001148158354,0.7764818761472949,0.12534992223950242,1103533.4275308787,4282.835783746033,1107816.2633146248,4323,0,1602.3612565445026,75,116,36,38.54166666666667,0.5934722222222222,44.065241228070185,8623.552602436985,114.98070136582646,0
4326,33.62056464169186,5,1,194,0.02564102564102564,0.005128205128205128,0.9948717948717949,195,5300,3400,1900,0.6415094339622641,72,34,38,208.1781041475801,0.4282227509031633,0.7740180072332685,0.12198146075282261,1103959.6360991772,1664.0448197155188,1105623.6809188926,4324,0,1570.4666666666667,69,126,43,38.40024533999186,0.5997886473429952,43.73511904761902,8615.769995454933,124.86623181818744,0
4327,33.42560713967433,3,0,197,0.015228426395939087,0.0,1.0,197,5200,3900,1300,0.75,65,39,26,203.98788544054304,0.42958579370834626,0.7718051206384899,0.12044329038868633,1099998.73910304,277.2833553782134,1100276.0224584183,4325,0,1555.497461928934,72,125,46,38.2170402506628,0.6011284722222222,43.4503424657534,8575.328064557654,119.10177867441186,0
4328,33.55162782750559,0,0,197,0.0,0.0,1.0,197,5500,3900,1600,0.7090909090909091,71,39,32,205.7747339589338,0.4297681636106219,0.7734568327456834,0.12180795290711915,1104959.3949560127,574.545106499434,1105533.9400625122,4326,1,1556.497461928934,73,124,48,38.0747678075179,0.6015981735159817,43.35585585585584,8610.82880843299,117.95655901963,0
4329,33.63894394451872,1,1,197,0.005050505050505051,0.005050505050505051,0.9949494949494949,198,5250,3700,1550,0.7047619047619048,68,37,31,202.8069488420296,0.43021105727324005,0.7702110816417345,0.12054945345543654,1109159.708421277,139.05924868676448,1109298.7676699639,4327,0,1549.6313131313132,77,121,46,37.994424653734846,0.6013257575757576,43.20245726495725,8638.398145154219,112.18698889810673,0
4330,33.188139121909394,3,2,198,0.015,0.01,0.99,200,4450,3000,1450,0.6741573033707865,59,30,29,202.34667517841416,0.43277324120603017,0.7706415132105688,0.12092392215207555,1095986.600499531,-96.15106976570405,1095890.4494297653,4328,0,1534.265,80,120,38,37.80388894448888,0.6020833333333333,43.004115226337426,8529.215177626455,106.61518972033068,0
4331,32.73333024000553,0,1,197,0.0,0.005050505050505051,0.9949494949494949,198,5600,3700,1900,0.6607142857142857,75,37,38,204.59068954187148,0.43050428139260627,0.7720794740804764,0.1225215064092859,1081616.4426570544,-942.2692353940656,1080674.1734216604,4329,1,1550.7626262626263,80,118,38,37.66747957311985,0.6028645833333333,42.92695473251025,8414.856886544525,105.18571108180656,0
4332,32.61058730571305,1,0,198,0.005050505050505051,0.0,1.0,198,6050,4500,1550,0.743801652892562,76,45,31,207.58267197415393,0.4309443846245877,0.7770855689806666,0.12475293438589069,1078648.1913249888,-868.2652649345346,1077779.9260600542,4330,0,1551.7474747474748,81,117,41,37.458172815725774,0.6037808641975309,42.79725609756095,8387.532535299364,103.5497843864119,0
4333,32.886359954932864,1,0,199,0.005025125628140704,0.0,1.0,199,5800,4000,1800,0.6896551724137931,76,40,36,205.71544029580411,0.4317071468453378,0.7770450270436617,0.1244059992848037,1089706.3844624509,-766.1142654315918,1088940.2701970192,4331,0,1544.9447236180904,66,133,44,37.27264262994727,0.6133207070707071,42.568407960199,8465.987999592322,128.2725454483685,0
4334,32.86296953442986,0,1,198,0.0,0.005025125628140704,0.9949748743718593,199,7050,5400,1650,0.7659574468085106,87,54,33,204.09250937884272,0.4314501801938988,0.7744159293048383,0.1240950299408755,1090602.9501912221,-2333.2214319008226,1088269.7287593214,4332,1,1545.9447236180904,70,129,45,37.11287490508731,0.6130952380952381,42.37089201877935,8466.457526769214,120.94939323956021,0
4335,32.83607157594447,0,1,197,0.0,0.005050505050505051,0.9949494949494949,198,5700,4300,1400,0.7543859649122807,71,43,28,207.68644241014897,0.43117137961681107,0.7765941420236402,0.1266375471648419,1090579.2670569983,-0.2943717327534614,1090578.9726852656,4333,2,1554.7121212121212,70,128,43,36.915452268457926,0.6141369047619047,42.26819248826292,8462.900078852963,120.89857255504232,0
4336,32.610744252320735,1,0,198,0.005050505050505051,0.0,1.0,198,6200,5000,1200,0.8064516129032258,74,50,24,201.14944570519697,0.43177652156078555,0.7687900057171426,0.12323141066644022,1084532.9581584034,-2169.3593234838554,1082363.5988349195,4334,0,1552.79797979798,74,124,47,36.90952214263917,0.6138795045045045,42.09722222222222,8410.401528074215,113.6540747037056,0
4337,32.376433957767865,0,0,198,0.0,0.0,1.0,198,5650,3400,2250,0.6017699115044248,79,34,45,198.20818476441633,0.43185503512280166,0.7648450054797475,0.12176890270911533,1077583.3147810001,-2532.833448967221,1075050.481332033,4335,1,1553.79797979798,78,120,39,36.882463671828404,0.6131143162393162,41.99630801687763,8353.239494351821,107.09281403015156,0
4338,32.11341751386654,0,0,198,0.0,0.0,1.0,198,4850,3300,1550,0.6804123711340206,64,33,31,201.92081297525,0.4317567596438155,0.7687629546096146,0.12452093637026687,1069962.5950456182,-1240.4565910561755,1068722.138454562,4336,2,1554.79797979798,80,118,40,36.647175310118065,0.613671875,41.85956790123456,8289.771473197557,103.62214341496947,0
4339,31.755748226557177,0,0,198,0.0,0.0,1.0,198,5350,4100,1250,0.7663551401869159,66,41,25,201.84077247309887,0.4316654275410621,0.7685990381362435,0.12500848086187993,1059314.958105548,-2187.410112733593,1057127.5479928146,4337,3,1555.79797979798,81,117,42,36.491325677470115,0.6148405349794239,41.704776422764226,8202.358088040992,101.2636800992715,0
4340,31.605602809254812,0,0,198,0.0,0.0,1.0,198,5700,3700,2000,0.6491228070175439,77,37,40,200.29856198133874,0.4318406142644721,0.7673075314157578,0.12448205070288464,1055316.6656890293,-3024.3178855090496,1052292.3478035203,4338,4,1556.79797979798,72,126,42,36.40495582551077,0.6200810185185186,41.58105022831052,8167.486684868822,113.43731506762252,0
4341,31.194781291254426,0,0,198,0.0,0.0,1.0,198,6700,5100,1600,0.7611940298507462,83,51,32,197.86233816991134,0.4318838768394606,0.7649249560176812,0.12334258414918806,1042476.7449648997,-5046.622750696988,1037430.1222142028,4339,5,1557.79797979798,74,124,42,36.35693116292397,0.6202139639639639,41.47222222222225,8064.717485491865,108.98266872286304,0
4342,30.878573345943316,3,0,201,0.014925373134328358,0.0,1.0,201,6100,4100,2000,0.6721311475409836,81,41,40,194.1211092827034,0.4330876865671642,0.7655008079700536,0.12217024617973891,1034623.555725214,-6131.54553452093,1028492.0101906931,4340,0,1535.5323383084576,77,124,46,36.1073135919659,0.6222943722943723,41.132478632478666,7993.459745429635,103.8111655250602,0
4343,30.83895440088241,0,1,200,0.0,0.004975124378109453,0.9950248756218906,201,4650,3300,1350,0.7096774193548387,60,33,27,194.01098593418726,0.4328016169154229,0.7663925788572405,0.12244138058314474,1034084.354514833,-4725.254968291627,1029359.0995465413,4341,1,1536.5323383084576,78,123,37,36.00952562797016,0.6228632478632479,41.03375527426163,7986.248212464861,102.38779759570335,0
4344,30.531031371620777,0,0,200,0.0,0.0,1.0,200,6200,4300,1900,0.6935483870967742,81,43,38,196.63419391335322,0.4321367252931323,0.7683604662847927,0.12471044382611848,1025138.3570096322,-5884.54910394988,1019253.8079056822,4342,2,1545.21,79,121,39,35.76378420929217,0.6242088607594937,40.859375000000036,7911.8305515365055,100.1497538169178,0
4345,30.290312664270058,0,1,199,0.0,0.005,0.995,200,5500,3700,1800,0.6727272727272727,73,37,36,197.4535394892067,0.4317954355108878,0.7678915779283626,0.12575185344781312,1018206.2162620004,-5290.315733830621,1012915.9005281697,4343,3,1546.21,82,118,39,35.59313488222011,0.6244918699186992,40.71285140562253,7853.888800750842,95.77913171647369,0
4346,29.941047185964756,1,0,200,0.005,0.0,1.0,200,5450,4000,1450,0.7339449541284404,69,40,29,203.93446676798976,0.43175094221105526,0.7753828841043446,0.13088575122641724,1008569.4594378915,-4313.585018210765,1004255.8744196807,4344,0,1546.24,73,127,39,35.148722363830316,0.6311358447488584,40.44200450450451,7771.438190625067,106.45805740582284,0
4347,29.84495047247857,1,0,201,0.004975124378109453,0.0,1.0,201,4150,2500,1650,0.6024096385542169,58,25,33,197.0808502992837,0.43204187396351573,0.7703827975176516,0.12249484775581124,996556.4723740576,-5069.560610653153,991486.9117634045,4345,0,1539.5422885572139,69,132,43,36.48436600253369,0.6216787439613527,41.577380952380956,7712.610266444394,111.77696038325209,8
4348,29.641838802164123,1,0,202,0.0049504950495049506,0.0,1.0,202,5750,3900,1850,0.6782608695652174,76,39,37,194.3215038030669,0.4324704858545556,0.7676544172702877,0.12168754896185852,991824.1006057028,-7603.449852435056,984220.6507532678,4346,0,1532.9158415841584,72,130,43,36.28302719399854,0.6228298611111112,41.30993150684932,7668.049309994776,106.50068486103856,0
4349,29.980628246659084,1,0,203,0.0049261083743842365,0.0,1.0,203,5200,3900,1300,0.75,65,39,26,191.38952320500474,0.4330240290038856,0.7652947378632122,0.12038226608071805,1004379.2947929167,-7354.465130520931,997024.8296623958,4347,0,1526.35960591133,74,129,47,36.19871313337272,0.6234515765765766,41.152777777777786,7760.402342124806,104.87030192060548,0
4350,30.174656435394876,4,3,204,0.01932367149758454,0.014492753623188406,0.9855072463768116,207,6700,4700,2000,0.7014925373134329,87,47,40,187.30509487793154,0.43449337898472556,0.7640999239746398,0.11902022359267327,1013697.8697605965,-10125.844865386767,1003572.0248952098,4348,0,1497.8454106280194,80,127,38,35.937086558179544,0.6244791666666667,40.79218106995886,7821.50688158206,97.76883601977575,0
4351,30.62810311449148,1,1,204,0.004878048780487805,0.004878048780487805,0.9951219512195122,205,5400,3700,1700,0.6851851851851852,71,37,34,187.8011669423623,0.43341602901323134,0.7634026562002805,0.11946619515276416,1029237.42777116,-7741.60200076406,1021495.8257703959,4349,0,1513.448780487805,80,125,41,35.88492319394152,0.6248697916666667,40.75360082304528,7940.225446052425,99.25281807565531,0
4352,31.15518188678669,1,0,205,0.004878048780487805,0.0,1.0,205,5750,4300,1450,0.7478260869565218,72,43,29,188.8638451136114,0.43377271640363463,0.7652990726046094,0.12077852859692424,1048449.8036375481,-7147.147735280549,1041302.6559022676,4350,0,1514.2487804878049,72,133,42,35.6681884018114,0.6303530092592593,40.56792237442921,8082.653565691587,112.25907730127204,0
4353,30.75611536441871,1,0,206,0.0048543689320388345,0.0,1.0,206,6000,4300,1700,0.7166666666666667,77,43,34,188.37585774779123,0.43387204988554745,0.765426968468987,0.12120341393742357,1036724.3419946881,-8141.232565747274,1028583.1094289409,4351,0,1507.893203883495,76,130,46,35.46334166970598,0.6306195175438596,40.35443722943722,7985.688882430818,105.07485371619498,0
4354,30.705846261707737,0,0,206,0.0,0.0,1.0,206,6000,4500,1500,0.75,75,45,30,189.00575948299758,0.43372306417238926,0.7654618375681683,0.12210989834681939,1036173.73035737,-8031.439427495123,1028142.2909298749,4352,1,1508.893203883495,77,129,40,35.30084262924311,0.6316287878787878,40.21100427350425,7977.04096326118,103.59793458780753,0
4355,31.203522825753883,1,0,207,0.004830917874396135,0.0,1.0,207,5850,4300,1550,0.7350427350427351,74,43,31,242.8492974322242,0.4344669965448775,0.81040102144157,0.14619794084905108,1032611.9683548777,2903.818207017255,1035515.7865618949,4353,0,1502.5990338164252,79,128,39,36.486697371528805,0.6052215189873418,42.73437499999998,8027.5938019692885,101.61511141733277,8
4356,31.324073092622886,2,0,209,0.009569377990430622,0.0,1.0,209,5650,3300,2350,0.584070796460177,80,33,47,230.18350961867193,0.4354747500306711,0.8111311937211994,0.13599095600011085,1031016.7161617547,14.609240326215968,1031031.3254020809,4354,0,1489.2105263157894,67,142,38,37.522451589149604,0.6040111940298507,43.42830882352942,8036.870407909647,119.95328967029324,8
4357,30.872116087038542,0,1,208,0.0,0.004784688995215311,0.9952153110047847,209,6600,4400,2200,0.6666666666666666,88,44,44,225.59032998160785,0.4354479128327813,0.8061846425691486,0.13394284329821288,1017604.0871449672,-2487.6716380668663,1015116.4155069003,4355,1,1490.2105263157894,71,138,37,37.451458932026135,0.6037265258215962,43.24363425925925,7926.612329234251,111.64242717231339,0
4358,31.07458885004889,2,3,207,0.009523809523809525,0.014285714285714285,0.9857142857142858,210,5350,3600,1750,0.6728971962616822,71,36,35,219.67837661772333,0.43559894053315107,0.8008804923511106,0.13100700322593664,1025573.7804497941,-2290.7233618175774,1023283.0570879766,4356,0,1483.9571428571428,80,130,34,37.437326892915564,0.6013020833333333,43.08127572016461,7983.643724874963,99.79554656093703,0
4359,30.730778120648818,1,1,207,0.004807692307692308,0.004807692307692308,0.9951923076923077,208,4150,2900,1250,0.6987951807228916,54,29,25,223.66387846729134,0.4344608378236096,0.8035897205632156,0.1334927411850567,1014464.5676380784,-370.18404688479404,1014094.3835911936,4357,0,1499.2067307692307,78,130,35,37.30414293289543,0.6024305555555556,43.05116033755274,7896.237780024823,101.23381769262593,0
4360,30.606015284936376,0,3,204,0.0,0.014492753623188406,0.9855072463768116,207,5700,3900,1800,0.6842105263157895,75,39,36,225.9654398109092,0.4340693056923534,0.8048153997295064,0.1352384109604779,1011144.0758925632,-1403.2768357481873,1009740.799056815,4358,1,1507.4057971014493,81,126,36,37.141246602421546,0.6022376543209876,42.94969512195123,7867.28556009514,97.1269822233968,0
4361,30.619889666640812,1,2,203,0.004878048780487805,0.00975609756097561,0.9902439024390244,205,6450,4900,1550,0.7596899224806202,80,49,31,227.80808591458788,0.4343904431691376,0.8064314437463669,0.1373034567407285,1013635.4318666867,-1267.1304902486645,1012368.301376438,4359,0,1520.239024390244,61,144,37,36.82983730547396,0.615266393442623,42.69153225806451,7878.756892550466,129.15994905820435,0
4362,30.591922437277812,1,0,204,0.004901960784313725,0.0,1.0,204,5400,4100,1300,0.7592592592592593,67,41,26,227.99767490228197,0.43410474822112755,0.8048295171263775,0.13848716234016156,1014939.0589402311,80.74912117656368,1015019.8080614076,4360,0,1527.3235294117646,65,139,38,36.53543236729775,0.6155448717948717,42.40845959595959,7880.22042453931,121.23416037752786,0
4363,30.164608417142325,0,0,204,0.0,0.0,1.0,204,5450,3900,1550,0.7155963302752294,70,39,31,227.5751194548884,0.4343497456453846,0.8043557371496926,0.138530626406432,1001375.4580059446,-672.372105020725,1000703.0859009239,4361,1,1528.3235294117646,65,139,40,36.465607007227725,0.6163461538461539,42.32954545454545,7772.5283620307055,119.577359415857,0
4364,29.816018851185977,1,2,203,0.004878048780487805,0.00975609756097561,0.9902439024390244,205,5850,3800,2050,0.6495726495726496,79,38,41,225.28391292727923,0.43469831021839633,0.8022782621916016,0.13773003088842786,991009.3059274389,-2198.3091626638375,988810.996764775,4362,0,1521.8634146341462,69,136,35,36.36418292354457,0.6156400966183575,42.17261904761905,7687.386050828107,111.41139204098705,0
4365,29.79873055798788,2,0,205,0.00975609756097561,0.0,1.0,205,6250,4700,1550,0.752,78,47,31,223.4202558028046,0.4346743982145704,0.8009288916484549,0.13730106278384618,991877.030820576,-2928.916009828154,988948.1148107479,4363,0,1522.668292682927,71,134,40,36.220374939254604,0.6164906103286385,41.9849537037037,7688.520844490099,108.28902597873379,0
4366,29.69310279231465,1,1,205,0.0048543689320388345,0.0048543689320388345,0.9951456310679612,206,6200,5000,1200,0.8064516129032258,74,50,24,222.9619512095939,0.4352267345488989,0.7997037664899185,0.1330236213876722,980103.390061634,-3694.847152944116,976408.5429086899,4364,0,1516.2718446601941,72,134,34,37.3363971268836,0.6050347222222222,43.06506849315068,7629.195332169201,105.96104628012779,8
4367,30.001917743577202,0,2,203,0.0,0.00975609756097561,0.9902439024390244,205,6000,4500,1500,0.75,75,45,30,224.01346983113828,0.435305077315479,0.7991048545128532,0.1342005957720424,991462.1209534553,-2579.826015815557,988882.2949376397,4365,1,1514.9219512195123,75,130,35,37.15485107781982,0.6051388888888889,42.91392543859648,7713.075262010354,102.84100349347139,0
4368,29.72151380618012,3,0,206,0.014563106796116505,0.0,1.0,206,5100,3500,1600,0.6862745098039216,67,35,32,238.50766325906528,0.4354812929197253,0.8133696105923829,0.13933471122860178,975077.3526954389,212.6841776450583,975290.0368730839,4366,0,1507.9514563106795,74,132,38,37.737782175712546,0.5961430180180181,43.847222222222236,7613.248321213642,102.88173407045463,8
4369,30.288110228844218,2,0,208,0.009615384615384616,0.0,1.0,208,6050,4500,1550,0.743801652892562,76,45,31,237.44281823039515,0.4368927482038895,0.8148604554290471,0.13993970351025423,996217.5967716858,-341.05725036393414,995876.5395213218,4367,0,1494.4423076923076,62,146,39,37.428549939831505,0.6061827956989247,43.51851851851852,7768.33938276838,125.2957964962642,0
4370,30.83369346028353,1,0,209,0.004784688995215311,0.0,1.0,209,6900,4800,2100,0.6956521739130435,90,48,42,236.34683405075438,0.43734951999754634,0.8141149502114626,0.14008545586740073,1015827.4607666793,-682.4791411956121,1015144.9816254836,4368,0,1488.2870813397128,65,144,44,37.24124856533859,0.6064102564102565,43.30808080808082,7914.759950095524,121.76553769377729,0
4371,30.774421809747814,2,0,211,0.009478672985781991,0.0,1.0,211,5300,3600,1700,0.6792452830188679,70,36,34,231.939870750178,0.439116452268111,0.8126922109877652,0.13847241459273152,1015989.9274411122,-370.2855091651618,1015619.6419319471,4369,0,1475.170616113744,68,143,38,37.08054266298494,0.6073835784313726,43.04045893719806,7907.781304705866,116.29090153979215,0
4372,30.94697360138168,0,0,211,0.0,0.0,1.0,211,6500,4400,2100,0.676923076923077,86,44,42,234.15296246131396,0.4390703753855412,0.8140947920639461,0.14028651864253322,1022717.2600736165,-805.5447586890314,1021911.7153149275,4370,1,1476.170616113744,71,140,39,36.8910617145001,0.6071009389671361,42.91087962962962,7956.130221304263,112.05817213104595,0
4373,30.999779719535073,1,0,212,0.0047169811320754715,0.0,1.0,212,5750,3700,2050,0.6434782608695652,78,37,41,203.29844059082825,0.4394770522221229,0.7917232839607997,0.11995897414143754,1019977.2716290301,-6678.042247946206,1013299.2293810839,4371,0,1470.2028301886792,67,145,46,38.259136510211384,0.603544776119403,43.47426470588234,7952.241286509385,118.69016845536395,8
4374,31.089589358301808,1,1,212,0.004694835680751174,0.004694835680751174,0.9953051643192489,213,5850,4300,1550,0.7350427350427351,74,43,31,200.98827808384317,0.43977083148787904,0.7897989696121273,0.11938219409076445,1024887.9128615836,-7251.908633001328,1017636.0042285823,4372,0,1464.2957746478874,69,144,45,38.06837390128465,0.6049214975845411,43.22916666666666,7982.899767522273,115.69419952930829,0
4375,30.98190440984426,1,2,211,0.004694835680751174,0.009389671361502348,0.9906103286384976,213,6700,5500,1200,0.8208955223880597,79,55,24,201.72211772206887,0.4400347314494936,0.7904620295028715,0.12039808332188559,1022757.4620783722,-8037.439766700449,1014720.0223116718,4373,0,1465.2723004694835,72,141,39,37.8675653912367,0.6051793981481481,43.05079908675798,7960.775580879917,110.56632751222106,0
4376,30.943732772732464,2,1,212,0.009389671361502348,0.004694835680751174,0.9953051643192489,213,4500,2600,1900,0.5777777777777777,64,26,38,201.6520058487242,0.4400900950778044,0.7910350002344817,0.12096435237663145,1022972.8161551901,-5843.095938717599,1017129.7202164725,4374,0,1466.1924882629107,72,141,43,37.68012393636702,0.6070601851851851,42.86529680365297,7956.707542303633,110.50982697643934,0
4377,31.362049620202928,0,2,210,0.0,0.009433962264150943,0.9905660377358491,212,6550,4700,1850,0.7175572519083969,84,47,37,199.9886917840594,0.4398123826343557,0.7883415465515828,0.12053454931049172,1038199.5273199967,-7424.36694408903,1030775.1603759077,4375,1,1473.872641509434,63,149,45,37.54618940687798,0.6139219576719577,42.69205729166667,8069.704466891088,128.09054709350931,0
4378,31.059507859709335,1,0,211,0.004739336492890996,0.0,1.0,211,6050,4200,1850,0.6942148760330579,79,42,37,199.22985288555725,0.4397182727751448,0.786363749393689,0.1206129752314061,1029485.4486119977,-7229.153105041889,1022256.2955069557,4376,0,1481.5118483412323,63,148,45,37.39971184440651,0.6155753968253967,42.529296875000014,7996.9133273558555,126.93513218025167,0
4379,31.394035551218103,2,0,213,0.009389671361502348,0.0,1.0,213,6150,4500,1650,0.7317073170731707,78,45,33,201.21762286786407,0.44071293589630023,0.7898267830949115,0.12301987601682071,1043465.9031619086,-6757.254284418096,1036708.6488774905,4377,0,1468.5915492957747,65,148,47,36.983757753836116,0.617948717948718,42.1717171717172,8094.270277220683,124.52723503416435,0
4380,31.21406530197594,1,1,213,0.004672897196261682,0.004672897196261682,0.9953271028037384,214,5900,3900,2000,0.6610169491525424,79,39,40,199.0946455839962,0.4412345699325757,0.7884492018968312,0.12225398485033909,1038754.6739903219,-7337.901266635144,1031416.7727236868,4378,0,1462.7242990654206,71,143,39,36.877523553162874,0.6161971830985915,42.01388888888892,8052.795319225108,113.41965238345223,0
4381,31.011826818597765,3,1,215,0.013888888888888888,0.004629629629629629,0.9953703703703703,216,6700,4400,2300,0.6567164179104478,90,44,46,196.9046313615334,0.44144056847545216,0.788739867297997,0.12171828491069775,1033948.6195660748,-9182.145643514974,1024766.4739225599,4379,0,1450.1666666666667,77,139,43,36.68890497862366,0.6158008658008658,41.77350427350429,8008.075365443492,104.0009787719934,0
4382,31.455988479795586,0,0,215,0.0,0.0,1.0,215,6000,4600,1400,0.7666666666666667,74,46,28,195.5368869431098,0.44129084257045564,0.7862132427177739,0.12144979834632906,1050146.141569378,-7931.538528441142,1042214.603040937,4380,1,1457.5488372093023,64,151,42,36.54994108161748,0.6243489583333333,41.6025641025641,8128.14676679846,127.00229323122593,0
4383,31.58975543836365,1,1,215,0.004629629629629629,0.004629629629629629,0.9953703703703703,216,7000,5100,1900,0.7285714285714285,89,51,38,194.67143473975,0.44162494616709735,0.7858031272210386,0.12173453719059033,1056590.4074496026,-9062.405889905802,1047528.0015596969,4381,0,1451.7962962962963,67,149,46,36.32531785516862,0.625,41.36029411764706,8170.365055473829,121.94574709662432,0
4384,31.59466267765312,0,3,212,0.0,0.013953488372093023,0.986046511627907,215,6700,5100,1600,0.7611940298507462,83,51,32,204.00730609581055,0.4416041802506701,0.7925959902772719,0.1252243130553789,1051311.500939395,-6804.954565162184,1044506.5463742329,4382,1,1459.5162790697675,77,138,36,36.76441088160689,0.6132305194805194,42.02724358974359,8150.562218806429,105.85145738709647,8
4385,31.646881731455306,0,1,211,0.0,0.0047169811320754715,0.9952830188679245,212,5900,3900,2000,0.6610169491525424,79,39,40,204.21191554281424,0.4415593609347521,0.790263755006321,0.12587988226743607,1054292.3769633977,-5240.186831623601,1049052.1901317742,4383,4,1475.8207547169811,79,133,39,36.60377993005113,0.6139240506329113,41.875,8168.851346931896,103.40318160673286,0
4386,31.400371087298087,0,1,210,0.0,0.004739336492890996,0.995260663507109,211,6700,5000,1700,0.746268656716418,84,50,34,207.9433702812567,0.4413243812532912,0.7926151334224445,0.12850498523052678,1046818.9453436733,-5364.188086193131,1041454.7572574802,4384,5,1483.7962085308056,79,132,39,36.41442060410471,0.6148470464135021,41.78385416666667,8108.082799898555,102.63395949238678,0
4387,31.0194802723852,0,1,209,0.0,0.004761904761904762,0.9952380952380953,210,6050,4600,1450,0.7603305785123967,75,46,29,207.46618106139385,0.4409950064555328,0.7920122887864809,0.12862903225806452,1035059.7410334107,-5102.021671480448,1029957.7193619302,4385,6,1491.4238095238095,79,131,40,36.30712365591396,0.6160337552742616,41.66666666666667,8013.365737032857,101.43500932952983,0
4388,31.402854365973607,0,0,209,0.0,0.0,1.0,209,6550,4800,1750,0.732824427480916,83,48,35,205.2534847795749,0.44036966323150534,0.7883864030109322,0.12788424334569026,1049280.9159143514,-5276.287099174846,1044004.6288151765,4386,7,1499.4736842105262,70,139,39,36.18461502080968,0.6220238095238095,41.49061032863851,8117.932716086515,115.9704673726645,0
4389,31.757088508325864,1,0,210,0.004761904761904762,0.0,1.0,210,5900,4100,1800,0.6949152542372882,77,41,36,202.9582090618017,0.44110940229361284,0.7849226804123708,0.1270125566386767,1062408.6960883194,-4775.086750045873,1057633.6093382735,4387,0,1493.3285714285714,74,136,41,36.08348099226805,0.6216216216216216,41.33333333333336,8214.500227487008,111.00675983090551,0
4390,31.76545116365874,2,1,211,0.009433962264150943,0.0047169811320754715,0.9952830188679245,212,5150,3700,1450,0.7184466019417476,66,37,29,200.8704902345624,0.44180620137709026,0.785320801422172,0.12675169788930754,1065108.3112440258,-4760.234273500878,1060348.0769705249,4388,0,1480.2311320754718,77,135,36,35.83723333849037,0.6232413419913421,41.03899572649575,8226.013134542072,106.83133940963731,0
4391,31.655734833462027,1,0,212,0.0047169811320754715,0.0,1.0,212,5600,3600,2000,0.6428571428571429,76,36,40,199.42606907408623,0.4418411316283645,0.783912048261022,0.12637606202434376,1062661.7933355486,-5615.507159974073,1057046.2861755746,4389,0,1480.9292452830189,78,134,40,35.72135853985381,0.6243322649572649,40.888713080168806,8202.358191091345,105.15843834732495,0
4392,31.678400281288376,0,1,211,0.0,0.0047169811320754715,0.9952830188679245,212,5650,4200,1450,0.7433628318584071,71,42,29,201.83052284405485,0.4416254955438314,0.78608263058909,0.12810059715204436,1063877.275557822,-5105.418646450715,1058771.8569113715,4390,1,1481.9292452830189,79,133,40,35.60255894962489,0.6244725738396624,40.83333333333337,8209.985406233998,103.92386590169617,0
4393,31.27880225041789,1,0,212,0.0047169811320754715,0.0,1.0,212,4850,3300,1550,0.6804123711340206,64,33,31,202.3617012264647,0.44155703225133386,0.7858182680563712,0.12868791638917149,1051013.4573719164,-4713.025750861592,1046300.4316210548,4391,0,1482.9103773584907,81,131,41,35.51880686365794,0.6243569958847737,40.76473577235777,8108.568566111361,100.10578476680693,0
4394,31.713441255893976,1,0,213,0.004694835680751174,0.0,1.0,213,5850,4100,1750,0.7008547008547008,76,41,35,202.7272185889027,0.44181190391826847,0.7861614815035942,0.12948686505452175,1066886.083293326,-5192.630356547166,1061693.4529367788,4392,0,1476.943661971831,71,142,43,35.35200187777716,0.6304284037558685,40.6105324074074,8226.132642895274,115.86102313937006,0
4395,32.00516414264883,0,1,212,0.0,0.004694835680751174,0.9953051643192489,213,6350,4800,1550,0.7559055118110236,79,48,31,202.67958471001083,0.4415563085009006,0.7854813008651764,0.13002805090059763,1077982.669753654,-5252.984033948185,1072729.6857197057,4393,1,1477.943661971831,73,140,42,35.19565571103156,0.6309931506849316,40.45608108108108,8306.745727226335,113.79103735926486,0
4396,31.717291540327974,0,0,212,0.0,0.0,1.0,212,6400,4200,2200,0.65625,86,42,44,229.29513627895503,0.4413418619034844,0.8060625091078153,0.13885378074442745,1051372.6549195563,-585.0727620506386,1050787.5821575057,4394,2,1474.0849056603774,65,147,42,36.61502390584773,0.614423076923077,42.5189393939394,8166.601865355287,125.64002869777366,8
4397,32.14845648003446,0,1,211,0.0,0.0047169811320754715,0.9952830188679245,212,5400,3800,1600,0.7037037037037037,70,38,32,273.13894964853847,0.44137958657486065,0.8359820885140434,0.16265409460409638,1060575.9824280536,10136.921972572854,1070712.9044006264,4395,3,1475.0849056603774,65,147,40,36.11847158218126,0.6081730769230769,43.13446969696969,8257.830322167923,127.04354341796805,8
4398,32.58574818820868,1,1,211,0.0047169811320754715,0.0047169811320754715,0.9952830188679245,212,5100,3600,1500,0.7058823529411765,66,36,30,272.5675925545336,0.44142150287638976,0.835969453620278,0.163128590454342,1076547.8202524565,11186.409527208272,1087734.2297796647,4396,0,1475.995283018868,68,144,37,35.94352596855975,0.6083026960784313,42.94987922705313,8376.170507255854,123.17897804788021,0
4399,32.59861833195972,1,0,212,0.0047169811320754715,0.0,1.0,212,6200,4400,1800,0.7096774193548387,80,44,36,273.0860922960008,0.44124126277981457,0.8365713528677994,0.16415383726917035,1078317.311535382,10294.692172465247,1088612.003707847,4397,0,1476.882075471698,76,136,38,35.76544118936166,0.6059484649122807,42.78950216450216,8384.706849912736,110.32509013043074,0
4400,32.31516420571725,0,1,211,0.0,0.0047169811320754715,0.9952830188679245,212,5700,4000,1700,0.7017543859649122,74,40,34,273.5824473614896,0.4411816484843065,0.8362903085347109,0.16514623258430622,1070223.671436312,10458.882251149149,1080682.553687461,4398,1,1477.882075471698,56,156,39,35.59418566119908,0.6196056547619048,42.63523391812866,8316.784676701696,148.51401208395887,0
4401,32.41857804580069,0,1,210,0.0,0.004739336492890996,0.995260663507109,211,5250,3900,1350,0.7428571428571429,66,39,27,271.59157836900033,0.44072350109079966,0.8340517101268372,0.1641710287155899,1074069.8473782267,10891.665025600845,1084961.5124038276,4399,2,1485.5402843601896,58,153,38,35.5935642432556,0.6185344827586207,42.58474576271187,8345.036509671161,143.87993982191657,0
4402,32.50387443975848,0,2,208,0.0,0.009523809523809525,0.9904761904761905,210,5250,3400,1850,0.6476190476190476,71,34,37,268.23268033845795,0.4406333067517278,0.830554689458272,0.16284211591241196,1078214.0085170965,10592.446696602638,1088806.4552136993,4400,3,1493.5809523809523,62,148,37,35.51830573030343,0.617271505376344,42.42724867724867,8372.112368097829,135.0340704531908,0
4403,32.866931636662784,1,0,209,0.004784688995215311,0.0,1.0,209,6000,4200,1800,0.7,78,42,36,262.299765330068,0.440961998527788,0.8241070997051856,0.1602943010350418,1092287.8586525219,9501.369799487942,1101789.2284520098,4401,0,1501.3540669856459,67,142,38,35.42508417508418,0.6166044776119404,42.18750000000001,8473.50581257714,126.47023600861402,0
4404,32.90425684224452,2,1,210,0.009478672985781991,0.004739336492890996,0.995260663507109,211,6050,4300,1750,0.7107438016528925,78,43,35,258.1253683371714,0.4417052207928985,0.8224470719428008,0.15871964138179265,1095422.6864322005,8301.276884041108,1103723.9633162415,4402,0,1488.1137440758293,69,142,36,35.30372933487123,0.6177536231884058,41.964285714285715,8490.473417329167,123.05033938158213,0
4405,32.55937649444619,1,0,211,0.004739336492890996,0.0,1.0,211,6100,4300,1800,0.7049180327868853,79,43,36,256.04069427278563,0.44149928533814786,0.8219475764181181,0.15837230536508856,1085732.7967878734,7298.355816860038,1093031.1526047334,4403,0,1489.1090047393366,73,138,38,35.13890402994293,0.617865296803653,41.751126126126124,8408.422313726209,115.18386731131793,0
4406,32.78070193951862,0,0,211,0.0,0.0,1.0,211,6250,4300,1950,0.688,82,43,39,254.37177575716888,0.4413290829760024,0.8199739844929708,0.15813412705705868,1094642.6992368419,7239.2414448991185,1101881.940681741,4404,1,1490.1090047393366,64,147,40,34.99679606432676,0.6246744791666667,41.57051282051282,8471.499991613411,132.36718736895955,0
4407,32.92434284373991,1,1,211,0.0047169811320754715,0.0047169811320754715,0.9952830188679245,212,5650,3900,1750,0.6902654867256637,74,39,35,255.2099672742568,0.4417638193388775,0.8225935401343143,0.15975106980846784,1101532.431285503,8174.411147981043,1109706.842433484,4405,0,1484.0754716981132,66,146,40,34.72297351444483,0.6259469696969697,41.32462686567163,8516.716670306954,129.0411616713175,0
4408,33.29292968613081,1,0,212,0.0047169811320754715,0.0,1.0,212,6000,3900,2100,0.65,81,39,42,252.21256371079193,0.44134372485021905,0.8211888310782927,0.1588345074675453,1115720.4778415558,7879.744420209531,1123600.2222617653,4406,0,1484.872641509434,70,142,42,34.579602553931004,0.6258928571428571,41.10915492957745,8619.234701312529,123.1319243044647,0
4409,33.323954732873084,1,1,212,0.004694835680751174,0.004694835680751174,0.9953051643192489,213,5650,4200,1450,0.7433628318584071,71,42,29,253.18229844245334,0.4419558493518765,0.8220493650014478,0.16006270732039807,1117941.8639153857,8358.618126227495,1126300.4820416132,4407,0,1478.8967136150234,74,139,36,34.41409740840036,0.6252815315315315,40.972222222222214,8631.829941223354,116.64635055707235,0
4410,32.83682825680059,0,1,211,0.0,0.0047169811320754715,0.9952830188679245,212,6050,4500,1550,0.743801652892562,76,45,31,251.15407426329705,0.44148391159199973,0.8197917571235087,0.1590474192897514,1102105.1299163504,6909.638728994085,1109014.7686453445,4408,2,1486.872641509434,75,137,37,34.40574908744643,0.6254166666666667,40.9128289473684,8507.600939395536,113.43467919194048,0
4411,32.57391141341373,1,2,210,0.0047169811320754715,0.009433962264150943,0.9905660377358491,212,6250,4700,1550,0.752,78,47,31,250.92333964420584,0.44211545053503826,0.8219410656912722,0.16028156560889073,1095853.2617619722,6345.032040261966,1102198.293802234,4409,0,1486.1367924528302,61,151,39,34.09945322451799,0.636441256830601,40.60819892473118,8449.405549591631,138.51484507527263,0
4412,32.22704501108568,0,1,209,0.0,0.004761904761904762,0.9952380952380953,210,5850,4100,1750,0.7008547008547008,76,41,35,249.29600212708377,0.44133439659755447,0.8191067471764832,0.15990643804981797,1085404.4441543715,6267.3977237307945,1091671.8418781024,4410,1,1496.252380952381,63,147,38,33.99206697604415,0.6365740740740741,40.46223958333333,8364.135087024279,132.76404900038537,0
4413,32.61385448103635,0,0,209,0.0,0.0,1.0,209,6050,4400,1650,0.7272727272727273,77,44,33,250.0430243783021,0.4409696662986136,0.8195247940700325,0.1609841166638994,1099534.586305789,7136.190673688843,1106670.7769794778,4411,2,1503.8755980861245,63,146,38,33.83921482595794,0.6378968253968254,40.33203124999999,8468.773346198781,134.424973749187,0
4414,32.43782492264315,0,1,208,0.0,0.004784688995215311,0.9952153110047847,209,6650,5100,1550,0.7669172932330827,82,51,31,251.4630383598672,0.44065912158017423,0.8192698815684865,0.162739287089499,1095121.0010112622,6626.490857198254,1101747.4918684606,4412,3,1504.8755980861245,65,144,36,33.61728620019438,0.6384615384615384,40.151515151515156,8428.919657929247,129.67568704506536,0
4415,32.46256571608255,0,0,208,0.0,0.0,1.0,208,5100,2600,2500,0.5098039215686274,76,26,50,250.3877078147429,0.4401264245014245,0.8186289669856657,0.1630297854658313,1097733.425477391,8271.791239382015,1106005.216716773,4413,4,1513.0,66,142,35,33.429360714214525,0.6399936868686869,39.94092039800995,8442.184961643547,127.91189335823556,0
4416,32.5324769226751,1,3,206,0.004784688995215311,0.014354066985645933,0.9856459330143541,209,4950,3300,1650,0.6666666666666666,66,33,33,256.0821281063785,0.44011375138019876,0.8223868350776544,0.16750354679025992,1101438.408539379,9661.738327373418,1111100.1468667525,4414,0,1506.755980861244,67,142,36,33.11876974549166,0.6410136815920398,39.78247549019608,8465.520610990836,126.3510538953856,0
4417,32.17476392696727,1,0,207,0.004830917874396135,0.0,1.0,207,4950,2900,2050,0.5858585858585859,70,29,41,254.95826981525593,0.43977963822835076,0.8193966142677629,0.16744136790685116,1090489.5028809973,9255.86338124764,1099745.366262245,4415,0,1501.0772946859904,68,139,38,33.005721133402936,0.6418504901960784,39.64371980676329,8376.901852120753,123.18973311942284,0
4418,31.790417199322967,0,1,206,0.0,0.004830917874396135,0.9951690821256038,207,5950,4400,1550,0.7394957983193278,75,44,31,254.82521372027153,0.4395578303081469,0.8191010703798434,0.16797662047275058,1078519.262483146,7616.780312739478,1086136.0427958856,4416,1,1502.0772946859904,61,146,37,32.87834322325421,0.6475409836065573,39.51612903225807,8280.890931759139,135.7523103567072,0
4419,31.634286494997983,0,1,205,0.0,0.0048543689320388345,0.9951456310679612,206,5050,3300,1750,0.6534653465346535,68,33,35,252.51932230695564,0.4394545741573921,0.8167629539245607,0.16747834308035286,1074949.3091479396,8039.094212073678,1082988.4033600132,4417,2,1508.6796116504854,63,143,39,32.72362958107012,0.6483134920634921,39.306640625000014,8246.84841781225,130.9023558382897,0
4420,31.261241792188194,0,1,204,0.0,0.004878048780487805,0.9951219512195122,205,5650,3700,1950,0.6548672566371682,76,37,39,254.7301043638951,0.4392495616132632,0.8175064164822146,0.16934795568955766,1062936.377984011,7502.378899209735,1070438.7568832207,4418,3,1516.6195121951218,63,142,38,32.582542753713646,0.6491402116402116,39.22526041666668,8152.142187409517,129.3990823398336,0
4421,30.829059625712794,1,0,205,0.004878048780487805,0.0,1.0,205,5600,4000,1600,0.7142857142857143,72,40,32,251.5951474655631,0.4392017376056114,0.8163333215335049,0.16830005495512002,1049931.274002673,6231.522742282047,1056162.7967449552,4419,0,1515.3073170731707,65,140,42,32.448899371069196,0.65,39.01515151515153,8045.917455347045,123.7833454668776,0
4422,30.91941893086926,1,1,205,0.0048543689320388345,0.0048543689320388345,0.9951456310679612,206,6750,5100,1650,0.7555555555555555,84,51,33,251.80454954140495,0.438990350461757,0.8162993808458576,0.16927302683682513,1054357.5442102016,5148.405295086557,1059505.9495052882,4420,0,1508.9466019417475,67,139,37,32.27211403097137,0.650497512437811,38.848039215686285,8074.666880108161,120.51741612101733,0
4423,31.464903015964193,0,0,205,0.0,0.0,1.0,205,5250,3500,1750,0.6666666666666666,70,35,35,259.100105215551,0.43852024549657265,0.8197662244039747,0.1744934831807103,1073462.2051872483,9376.834061786787,1082839.039249035,4421,1,1517.3024390243902,67,138,37,32.01872703104231,0.6511194029850746,38.78676470588236,8219.049115015667,122.6723748509801,0
4424,31.264277998051256,1,0,206,0.0048543689320388345,0.0,1.0,206,6100,4100,2000,0.6721311475409836,81,41,40,260.54382055125564,0.43864699265924695,0.8190523696479759,0.17659301401304034,1068380.370904849,8371.980727503524,1076752.3516323525,4422,0,1510.9320388349515,70,136,42,31.75963858802403,0.6516369047619048,38.57100938967137,8173.3886391912565,116.76269484558938,0
4425,31.34483833792004,0,0,206,0.0,0.0,1.0,206,6450,5000,1450,0.7751937984496124,79,50,29,262.1749362621208,0.4386006196227011,0.8193006564823277,0.1783977564960864,1072213.638784227,8571.50848152627,1080785.1472657532,4423,1,1511.9320388349515,60,146,38,31.581739243977278,0.6592013888888889,38.439207650273225,8198.580751740461,136.64301252900768,0
4426,31.830719853996726,0,0,206,0.0,0.0,1.0,206,4650,3100,1550,0.6666666666666666,62,31,31,260.84867709508455,0.4385448733128108,0.8184259907335445,0.17818092414259395,1089908.6626769167,11010.246562749233,1100918.9092396658,4424,2,1512.9320388349515,62,144,41,31.48404098481499,0.659106182795699,38.31018518518518,8329.775184014648,134.35121264539757,0
4427,31.840095029938098,0,0,206,0.0,0.0,1.0,206,5900,4200,1700,0.711864406779661,76,42,34,236.62743653445023,0.43855720656721126,0.804058241261298,0.14855419210592427,1066117.2674633265,3354.5192089921698,1069471.7866723186,4425,3,1513.9320388349515,69,137,38,35.096798926586175,0.6253019323671498,41.22023809523811,8239.572210872404,119.41409001264354,8
4428,32.318638197839235,0,2,204,0.0,0.009708737864077669,0.9902912621359223,206,7000,4900,2100,0.7,91,49,42,236.41465419939678,0.4385626331991475,0.8032621447264447,0.14876248782789508,1082824.2960552354,2999.1063021209834,1085823.4023573564,4426,4,1514.9320388349515,70,136,37,35.018632396282044,0.6255952380952381,41.13849765258218,8366.051237715355,119.51501768164793,0
4429,32.44504433332529,0,0,204,0.0,0.0,1.0,204,5300,3700,1600,0.6981132075471698,69,37,32,237.83371690273952,0.43823951994590943,0.8031046677195854,0.15027617889051453,1088292.0514787564,5666.508735780241,1093958.5602145365,4427,7,1526.514705882353,70,134,33,34.831695366489186,0.6270833333333333,40.991784037558695,8403.533049596923,120.0504721370989,0
4430,31.953479064638884,0,0,204,0.0,0.0,1.0,204,5750,4000,1750,0.6956521739130435,75,40,35,239.46958266218962,0.43823297997359867,0.8052901226569913,0.15184244487239432,1072831.8469184476,4832.118929653528,1077663.965848101,4428,8,1527.514705882353,72,132,36,34.66214665932452,0.6273148148148149,40.86757990867581,8280.182360357358,115.00253278274107,0
4431,31.558322972568146,0,0,204,0.0,0.0,1.0,204,5950,4500,1450,0.7563025210084033,74,45,29,240.249117105943,0.4380211854856885,0.8064054168276789,0.15296054227356978,1060742.845117246,4218.506403172997,1064961.3515204191,4429,9,1528.514705882353,73,131,36,34.494441880666706,0.6282819634703196,40.723536036036045,8182.330388960221,112.08671765698934,0
4432,31.565704124504848,0,1,203,0.0,0.004901960784313725,0.9950980392156863,204,6500,5200,1300,0.8,78,52,26,242.09286946984682,0.43780033565150195,0.8075242145050789,0.1545669858922871,1061797.5376646207,4110.722537849271,1065908.26020247,4430,10,1529.514705882353,74,130,36,34.34571619812585,0.6288006756756757,40.62500000000001,8187.354507293461,110.63992577423596,0
4433,31.47189589721839,1,0,204,0.004901960784313725,0.0,1.0,204,4700,3300,1400,0.7021276595744681,61,33,28,238.8657989932634,0.43763079944621525,0.8054032048138797,0.15320521246320357,1059950.6259923594,5137.190634214741,1065087.8166265741,4431,0,1530.436274509804,64,140,37,34.26533395080784,0.6359049479166667,40.46474358974358,8168.066571401448,127.62604017814762,0
4434,31.908521905694233,0,3,201,0.0,0.014705882352941176,0.9852941176470589,204,5350,3700,1650,0.6915887850467289,70,37,33,240.260212506107,0.4374788708586883,0.8049402159210493,0.15471629261694606,1075812.4092878953,5544.983614443333,1081357.3929023386,4432,1,1531.436274509804,65,139,40,34.08617222796249,0.636698717948718,40.325126262626256,8285.84139700736,127.47448303088245,0
4435,32.21079811971774,1,0,202,0.0049504950495049506,0.0,1.0,202,6350,4400,1950,0.6929133858267716,83,44,39,237.86788090112617,0.4370258854243633,0.8007779513717121,0.15391661526579642,1087410.488215618,4982.005700301667,1092392.4939159197,4433,0,1542.8069306930693,68,134,43,33.97617456813077,0.6366421568627452,40.15700483091788,8369.7502602141,123.08456265020735,0
4436,32.46162708502561,0,0,202,0.0,0.0,1.0,202,5950,4000,1950,0.6722689075630253,79,40,39,219.91344554276378,0.4370305034234767,0.79301011222432,0.1365903080096893,1083719.001687062,1314.8759322333872,1085033.8776192954,4434,1,1543.8069306930693,64,138,41,35.920057057802026,0.6243489583333333,41.602564102564116,8388.001203829404,131.06251880983444,8
4437,32.30264650739621,0,0,202,0.0,0.0,1.0,202,5550,3900,1650,0.7027027027027027,72,39,33,220.2378894513232,0.4372531936029424,0.7933451638308326,0.13733219897609955,1079589.3526017962,1603.2960982282139,1081192.6487000245,4435,2,1544.8069306930693,65,137,41,35.7674923183363,0.6251602564102564,41.46148989898991,8351.478100341836,128.48427846679746,0
4438,32.06307692283931,0,0,202,0.0,0.0,1.0,202,5450,3600,1850,0.6605504587155964,73,36,37,220.03456227173353,0.43726140337914393,0.7903574175014392,0.12464381929324181,1042344.3317367415,20.35575402347331,1042364.6874907649,4436,3,1545.8069306930693,79,123,38,39.40242599874042,0.5821466244725738,45.01302083333334,8175.667127343282,103.48945730814282,8
4439,31.62754940564489,1,0,203,0.0049261083743842365,0.0,1.0,203,5800,4300,1500,0.7413793103448276,73,43,30,219.90685004215055,0.43756401502219183,0.7941545634391365,0.12539808117895074,1030222.5982925262,-1089.3987134499666,1029133.1995790763,4437,0,1539.1871921182267,66,137,41,39.14768228056287,0.5910669191919191,44.76057213930349,8072.597614932727,122.31208507473829,0
4440,31.919891394119745,3,0,206,0.014563106796116505,0.0,1.0,206,5500,3700,1800,0.6727272727272727,73,37,36,218.52858508482768,0.43896321730207594,0.7960568976159332,0.12610980731319182,1043439.6806702645,-1095.720592352322,1042343.9600779122,4438,0,1517.7572815533981,70,136,40,38.719899969397915,0.593452380952381,44.30751173708922,8161.676455644392,116.59537793777703,0
4441,32.12493295911841,0,0,206,0.0,0.0,1.0,206,6100,3900,2200,0.639344262295082,83,39,44,218.9223171190489,0.4390342568474228,0.7961579257704701,0.12691548878957878,1051557.6063031836,-1258.1144487892325,1050299.4918543943,4439,1,1518.7572815533981,72,134,37,38.5338241035079,0.5941840277777778,44.13527397260275,8219.63717023335,114.1616273643521,0
4442,32.079807118064664,2,2,206,0.009615384615384616,0.009615384615384616,0.9903846153846154,208,6300,4800,1500,0.7619047619047619,78,48,30,204.67134469661104,0.44029142279821626,0.7844994420810363,0.11697020373075792,1045647.4531170076,-5097.185938390939,1040550.2671786167,4440,0,1505.1442307692307,71,137,39,39.45017376851009,0.5892018779342723,44.67592592592594,8190.747048894783,115.36263449147582,7
4443,31.95382999091688,2,0,208,0.009615384615384616,0.0,1.0,208,4700,3200,1500,0.6808510638297872,62,32,30,204.86617002964638,0.44046948547627895,0.7843138709021271,0.11768135184740967,1043124.1130860613,-3559.831617297353,1039564.281468764,4441,0,1505.9423076923076,73,135,44,39.24728220949026,0.5901826484018264,44.48198198198199,8164.779307363794,111.8462918816958,0
4444,32.26097914184883,2,1,209,0.009523809523809525,0.004761904761904762,0.9952380952380953,210,4600,3300,1300,0.717391304347826,59,33,26,203.62265485586397,0.44111414900888585,0.7808542465107073,0.12061606714268816,1062663.210975939,-3323.5391526844933,1059339.6718232546,4442,0,1492.5904761904762,76,134,45,38.10425780495095,0.6004660087719298,43.330627705627705,8280.405265940168,108.95270086763378,8
4445,32.08173518968639,2,1,210,0.009478672985781991,0.004739336492890996,0.995260663507109,211,5500,3700,1800,0.6727272727272727,73,37,36,199.45980347881704,0.44203528172722484,0.7765253608769564,0.1187692466169328,1058351.8984817616,-5480.267663478627,1052871.630818283,4443,0,1486.5071090047393,84,127,46,38.01387563613233,0.5992063492063492,43.13725490196081,8240.602568331275,98.10241152775328,0
4446,31.89260161566248,0,4,206,0.0,0.01904761904761905,0.9809523809523809,210,6150,4700,1450,0.7642276422764228,76,47,29,201.1368710022221,0.44144926710716187,0.7805986244262959,0.12078219069635907,1054658.0995684809,-5723.873975129219,1048934.2255933515,4444,1,1494.5761904761905,87,123,37,37.65400135014879,0.6012931034482758,42.82670454545454,8201.925458118869,94.27500526573412,7
4447,31.880116088959664,2,2,206,0.009615384615384616,0.009615384615384616,0.9903846153846154,208,5950,4500,1450,0.7563025210084033,74,45,29,201.3763579690742,0.4409620610367893,0.7808194902209926,0.12179117915253279,1056386.7011011122,-5003.73870505887,1051382.9623960534,4445,0,1509.5,72,136,39,37.381519871404,0.6100983796296297,42.565639269406375,8207.037305378408,113.98662924136677,0
4448,32.11844386819622,3,2,207,0.014354066985645933,0.009569377990430622,0.9904306220095693,209,5100,3900,1200,0.7647058823529411,63,39,24,200.5514433760146,0.4421907588026009,0.778717558432886,0.12227007212188268,1066703.3037824733,-4114.222554492535,1062589.0812279808,4446,0,1503.1244019138755,78,131,43,37.10445871278009,0.610309829059829,42.27320675105483,8277.783542296405,106.12543002944109,0
4449,32.104297361825616,0,0,207,0.0,0.0,1.0,207,5700,3700,2000,0.6491228070175439,77,37,40,206.05516902460627,0.44141828088113444,0.7827247700553719,0.12631291636760636,1067870.6030562872,-3091.9484781657866,1064778.6545781214,4447,1,1517.951690821256,78,129,36,36.760752688172026,0.6123130341880342,42.075421940928265,8280.487350931835,106.16009424271583,0
4450,31.92738103493855,2,0,209,0.009569377990430622,0.0,1.0,209,5100,3900,1200,0.7647058823529411,63,39,24,200.6657292015639,0.44228564746656857,0.777804064330168,0.12351536499301144,1063207.8143369292,-4230.125728656274,1058977.688608273,4448,0,1504.4162679425838,83,126,38,36.74844433232423,0.6118222891566265,41.92708333333331,8239.592345214547,99.27219693029575,0
4451,31.817619926871757,1,3,207,0.004761904761904762,0.014285714285714285,0.9857142857142858,210,5300,3200,2100,0.6037735849056604,74,32,42,197.80221089931317,0.44283008658008655,0.7754129430557373,0.12215892420041426,1060537.9917486785,-5344.648097879412,1055193.343650799,4449,0,1498.247619047619,88,122,39,36.70000377757629,0.6112689393939394,41.807116104868875,8215.083047598104,93.35321644997845,0
4452,32.19259615089196,2,1,208,0.009569377990430622,0.004784688995215311,0.9952153110047847,209,5650,4000,1650,0.7079646017699115,73,40,33,199.4538020278063,0.44159267267819896,0.7784571995098328,0.12358501130430945,1074020.0269130315,-4606.524435638227,1069413.5024773933,4450,0,1506.358851674641,93,116,42,36.53671528671525,0.6108870967741935,41.68882978723401,8315.707183923805,89.4162062787506,0
4453,32.63293750533231,0,0,208,0.0,0.0,1.0,208,5750,4100,1650,0.7130434782608696,74,41,33,198.05392076788056,0.4414783460299765,0.776873414262055,0.12326405405414882,1090053.4298261865,-4172.128875289309,1085881.3009508972,4451,1,1513.3846153846155,75,133,37,36.41049775515256,0.6191666666666666,41.52960526315791,8434.648238425982,112.46197651234642,0
4454,32.77673847785287,0,0,208,0.0,0.0,1.0,208,6250,4800,1450,0.768,77,48,29,195.61773573370942,0.44125383221850617,0.7738582010098556,0.12214595991653748,1095845.5786310192,-4976.633838880504,1090868.9447921386,4452,2,1514.3846153846155,77,131,41,36.35450558625558,0.6194534632034632,41.41292735042736,8475.640853988609,110.07325784400791,0
4455,32.94503586426629,1,0,209,0.004784688995215311,0.0,1.0,209,5450,3600,1850,0.6605504587155964,73,36,37,189.40906825500952,0.4416981045270519,0.7669578692574843,0.11888662338965203,1103053.3944412698,-5464.336864670393,1097589.0575765993,4453,0,1508.133971291866,82,127,42,36.32602211552451,0.6192835365853658,41.22740963855424,8525.27227014699,103.96673500179256,0
4456,32.594296778766015,0,0,209,0.0,0.0,1.0,209,5800,3600,2200,0.6206896551724138,80,36,44,187.63593643132066,0.4414134385351491,0.7650659297462481,0.11824145311328993,1092497.660034279,-6601.635702088045,1085896.024332191,4454,1,1509.133971291866,87,122,45,36.22850279644617,0.6188936781609196,41.08664772727274,8439.098643962503,97.00113383864947,0
4457,32.53762754927435,2,1,210,0.009478672985781991,0.004739336492890996,0.995260663507109,211,5450,3700,1750,0.6788990825688074,72,37,35,186.25737947291617,0.44182182351613636,0.7667819752823026,0.1182164184001576,1092733.2896504796,-6944.072201376299,1085789.2174491032,4455,0,1495.8199052132702,89,122,39,36.00616291532693,0.6207865168539326,40.83333333333335,8432.668473186981,94.74908396839304,0
4458,32.51687556646578,0,1,209,0.0,0.004761904761904762,0.9952380952380953,210,5750,4400,1350,0.7652173913043478,71,44,27,187.22157206660444,0.4414445203918888,0.7666404444874313,0.1192951949708266,1093200.5531805058,-6815.854769892647,1086384.698410613,4456,1,1503.942857142857,88,122,39,35.840479951854405,0.6225142045454546,40.69522471910114,8431.781111599406,95.81569444999326,0
4459,32.28920789095626,0,1,208,0.0,0.004784688995215311,0.9952153110047847,209,5350,3800,1550,0.7102803738317757,69,38,31,189.0750173675769,0.44077222119985277,0.7688600135333219,0.12095305859245867,1086708.5582788202,-6056.112093987683,1080652.4461848326,4457,2,1512.1244019138755,75,134,41,35.65104029091162,0.6290277777777777,40.5564692982456,8377.226098792617,111.69634798390156,0
4460,32.388241379256776,0,1,207,0.0,0.004807692307692308,0.9951923076923077,208,6250,4300,1950,0.688,82,43,39,212.47363280594448,0.44091802923324663,0.7904665975214094,0.1294044953153403,1075349.4561717417,-2153.3189022587285,1073196.137269483,4458,3,1519.0865384615386,75,133,41,36.83564039146857,0.6112500000000001,42.31085526315789,8346.098220551065,111.28130960734752,8
4461,31.91769061635064,1,0,208,0.004807692307692308,0.0,1.0,208,4900,3300,1600,0.673469387755102,65,33,32,242.02924338916918,0.44082270763656634,0.8159901045271634,0.14131662946596465,1046964.3690981625,4179.198821649399,1051143.567919812,4459,0,1520.0384615384614,79,129,38,37.66802441834847,0.59375,43.8671875,8175.167866070752,103.4831375451994,8
4462,31.4658457941353,4,4,208,0.018867924528301886,0.018867924528301886,0.9811320754716981,212,6450,4700,1750,0.7286821705426356,82,47,35,209.8819483435738,0.4425895704790009,0.7918583619696338,0.1294388792804173,1048405.7523484266,-4841.711608500547,1043564.040739926,4460,0,1492.3396226415093,81,131,36,36.439264389875845,0.6132973251028806,41.85721544715446,8122.681051608497,100.28001298282095,8
4463,31.33729462305891,0,0,208,0.0,0.0,1.0,208,5550,4100,1450,0.7387387387387387,70,41,29,215.59922583738853,0.44037561547751763,0.7955314431815508,0.13337733535221408,1045024.2217903968,-2088.717360134157,1042935.5044302627,4461,2,1522.0384615384614,78,130,39,36.17783961332924,0.6156517094017093,41.7457805907173,8092.988561276799,103.75626360611281,0
4464,31.52256930907791,2,2,208,0.009523809523809525,0.009523809523809525,0.9904761904761905,210,6800,5000,1800,0.7352941176470589,86,50,36,215.70612522892904,0.4412593984962406,0.7967092438910044,0.13423861300971962,1052937.7512749475,-3374.9755130436947,1049562.775761904,4462,0,1508.5333333333333,69,141,40,35.957440938837394,0.6221316425120773,41.5327380952381,8147.552177520463,118.08046634087628,0
4465,31.13435264244858,0,0,208,0.0,0.0,1.0,208,5350,3500,1850,0.6542056074766355,72,35,37,212.55821294460415,0.4404080344977084,0.7915002444496835,0.13254426144762282,1040545.4985092175,-2714.701669865673,1037830.7968393519,4463,1,1523.8798076923076,70,138,41,35.965814512162865,0.6223214285714286,41.461267605633815,8049.436066097862,114.99194380139802,0
4466,31.53262286324392,0,1,207,0.0,0.004807692307692308,0.9951923076923077,208,5250,3300,1950,0.6285714285714286,72,33,39,214.8964588759539,0.44034658351913786,0.7937156074810581,0.13448140665884473,1054894.6523606332,-1511.3749441036962,1053383.2774165296,4464,2,1524.8798076923076,71,137,40,35.77526940358335,0.6230927230046948,41.33391203703705,8156.420199246823,114.87915773587075,0
4467,31.998097336801514,1,0,208,0.004807692307692308,0.0,1.0,208,6100,4900,1200,0.8032786885245902,73,49,24,213.09956662212898,0.4405338396506875,0.7928014580892175,0.13440555886681266,1072771.816037539,-1978.5581835931534,1070793.2578539457,4465,0,1525.8509615384614,74,134,42,35.537460666523636,0.6244369369369369,41.055555555555564,8285.729538157348,111.9693180832074,0
4468,31.798529208284656,0,0,208,0.0,0.0,1.0,208,7000,5000,2000,0.7142857142857143,90,50,40,213.00555206557976,0.44029626145794626,0.7930148958854717,0.13488924457941898,1067256.6147428586,-3133.683116211135,1064122.9316266475,4466,1,1526.8509615384614,75,133,35,35.394128357050924,0.6254166666666667,40.912828947368425,8238.590976208958,109.8478796827861,0
4469,32.10489181795504,0,1,207,0.0,0.004807692307692308,0.9951923076923077,208,6200,4900,1300,0.7903225806451613,75,49,26,214.41547063825428,0.44010513439861265,0.7934441298971762,0.136257573276568,1078565.3969555201,-1547.7785595293954,1077017.6183959907,4467,2,1527.8509615384614,75,133,35,35.23159898477159,0.6266666666666667,40.78947368421053,8321.925905443608,110.95901207258144,0
4470,31.685362094776266,1,1,207,0.004807692307692308,0.004807692307692308,0.9951923076923077,208,6550,4500,2050,0.6870229007633588,86,45,41,215.96425864098921,0.4398501370308436,0.7962426629595294,0.13788487282463185,1065822.5560103233,-2114.0843696772536,1063708.471640646,4468,0,1528.7163461538462,81,127,38,35.02342704149933,0.6257716049382716,40.62500000000001,8218.390793332614,101.4616147325014,0
4471,31.511418943179926,1,0,208,0.004807692307692308,0.0,1.0,208,5650,4200,1450,0.7433628318584071,71,42,29,220.055734985984,0.4393725613154961,0.7988965209454653,0.14122501872392804,1061452.691989647,-534.2495422732754,1060918.4424473736,4469,0,1529.6826923076924,68,140,40,34.73215843657303,0.6337316176470589,40.443840579710155,8178.982878775573,120.27915998199373,0
4472,31.344587861323255,0,0,208,0.0,0.0,1.0,208,5550,3700,1850,0.6666666666666666,74,37,37,219.72231614539288,0.4390406292580205,0.79727757819104,0.14160574199171944,1057029.6213965612,-699.4006704919293,1056330.2207260693,4470,1,1530.6826923076924,72,136,39,34.59054487179489,0.6331018518518519,40.296803652968045,8140.289655766044,113.05957855230616,0
4473,30.932134914221926,1,0,209,0.004784688995215311,0.0,1.0,209,5450,3600,1850,0.6605504587155964,73,36,37,219.47703021272963,0.4389482502146976,0.7974993048297556,0.14223251698201608,1044668.582597683,-1393.848386983599,1043274.7342106993,4471,0,1524.3540669856459,73,136,42,34.40005010020042,0.634560502283105,40.10416666666668,8039.132980310827,110.1251093193264,0
4474,31.0449693406307,0,1,208,0.0,0.004784688995215311,0.9952153110047847,209,5550,3800,1750,0.6846846846846847,73,38,35,220.1889729234909,0.43893291467304624,0.7978536624261596,0.14323759385245322,1049544.1893580058,-1130.3885814884925,1048413.8007765173,4472,1,1525.3540669856459,74,135,34,34.24669729017555,0.6354166666666667,39.97222222222223,8072.554388823461,109.08857282193866,0
4475,30.986582261959757,0,1,207,0.0,0.004807692307692308,0.9951923076923077,208,6000,4100,1900,0.6833333333333333,79,41,38,221.85899556430624,0.4386496655518395,0.7993089306488428,0.14463133489604402,1048163.7750366762,-1091.0875366941973,1047072.687499982,4473,4,1533.6826923076924,75,133,35,34.12799046213838,0.6356944444444445,39.898574561403514,8059.65421580607,107.4620562107476,0
4476,31.409208428566,0,1,206,0.0,0.004830917874396135,0.9951690821256038,207,6100,4100,2000,0.6721311475409836,81,41,40,228.41526912404822,0.4378810796866939,0.8035618413975014,0.14943805305269375,1063467.6861992283,1082.451549585007,1064550.1377488133,4474,6,1542.072463768116,75,132,36,33.83128796657187,0.6369444444444444,39.77521929824561,8173.454375339269,108.97939167119026,0
4477,31.39188966687181,0,0,206,0.0,0.0,1.0,206,6400,4200,2200,0.65625,86,42,44,231.9854967916644,0.43701357644644406,0.8052185104953951,0.15225751644992613,1063777.2061066749,1756.1767268609824,1065533.3828335358,4475,10,1550.5291262135922,75,131,37,33.62618897195607,0.6380555555555556,39.66557017543859,8172.389697540591,108.96519596720789,0
4478,31.912389760430816,0,1,205,0.0,0.0048543689320388345,0.9951456310679612,206,5050,3600,1450,0.7128712871287128,65,36,29,238.52399580899277,0.43665887204988557,0.8060634513892413,0.1503489090699932,1069718.6739766274,4780.714501680655,1074499.388478308,4476,11,1551.5291262135922,75,131,43,34.90137499338308,0.62375,41.07730263157896,8262.842036243157,110.17122714990876,8
4479,31.44550635882604,0,0,205,0.0,0.0,1.0,205,6300,4700,1600,0.746031746031746,79,47,32,235.0387637222853,0.43623465646421167,0.8028318566035035,0.14863019312266632,1054997.712521124,2293.071616160989,1057290.7841372848,4477,12,1559.9609756097561,76,129,35,34.87483462154449,0.6244517543859649,40.96320346320348,8145.5432326677965,107.17820042983942,0
4480,31.875013225078103,2,1,206,0.00966183574879227,0.004830917874396135,0.9951690821256038,207,6450,5400,1050,0.8372093023255814,75,54,21,232.94422233150073,0.43690883792192364,0.8030559266794921,0.14850567003694648,1071771.4229743457,2082.5921283773914,1073854.0151027231,4478,0,1545.87922705314,79,128,38,34.63630581776797,0.626054852320675,40.677083333333364,8265.921398315902,104.63191643437851,0
4481,32.135697065009865,0,0,206,0.0,0.0,1.0,206,5900,4100,1800,0.6949152542372882,77,41,36,235.28294801357285,0.43637076722708973,0.8044883995028684,0.15048157128239664,1081481.5819305277,3790.834963799206,1085272.416894327,4479,1,1554.2475728155339,67,139,39,34.45963234136356,0.6330845771144278,40.56372549019607,8337.165525321781,124.43530634808629,0
4482,32.03194174295176,1,0,207,0.004830917874396135,0.0,1.0,207,5400,3900,1500,0.7222222222222222,69,39,30,236.74874947362844,0.4363059503150259,0.8062025287726633,0.15270556811946434,1080449.9840740087,4359.036519664581,1084809.0205936732,4480,0,1547.7342995169083,69,138,36,34.118731140903705,0.634963768115942,40.26785714285714,8319.724868772015,120.5757227358263,0
4483,31.967090649037118,0,0,207,0.0,0.0,1.0,207,5950,4600,1350,0.773109243697479,73,46,27,237.09207791628094,0.4362952019136063,0.8050439516693033,0.15339242504958184,1079141.3219120577,3821.1716754902563,1082962.493587548,4481,1,1548.7342995169083,71,136,39,34.0014847809948,0.6349765258215962,40.162037037037024,8306.263716098154,116.98962980419935,0
4484,32.2134811949882,0,0,207,0.0,0.0,1.0,207,6600,5200,1400,0.7878787878787878,80,52,28,236.02505592264237,0.4361730609883839,0.8051254286229941,0.15339137167104763,1088768.505525618,3395.329480698706,1092163.835006317,4482,2,1549.7342995169083,73,134,40,33.869112073632905,0.6355593607305936,40.005630630630606,8375.323728482934,114.73046203401279,0
4485,32.245042212624966,0,0,207,0.0,0.0,1.0,207,5900,4400,1500,0.7457627118644068,74,44,30,232.91807301289987,0.4362854306395885,0.803970374359384,0.1520665188429631,1091163.6478356153,3530.3468391195265,1094693.9946747348,4483,3,1550.7342995169083,74,133,36,33.7877938533269,0.6366835585585586,39.84722222222221,8388.637301176052,113.3599635294061,0
4486,31.93875623739273,0,0,207,0.0,0.0,1.0,207,5900,3900,2000,0.6610169491525424,79,39,40,185.28643744700298,0.4360704626111971,0.7614111490244007,0.11980575414184941,1078016.7275228198,-7351.624209804349,1070665.1033130153,4484,4,1551.7342995169083,79,128,47,35.3682219103939,0.6310654008438819,40.18229166666664,8298.254452616273,105.04119560273763,8
4487,31.880112997148565,0,0,207,0.0,0.0,1.0,207,5700,3900,1800,0.6842105263157895,75,39,36,186.7064197895677,0.43586917436643063,0.7639289577010258,0.12130582817184957,1077421.4689013166,-6867.6989874039955,1070553.7699139128,4485,5,1552.7342995169083,81,126,47,35.16116160135509,0.6319444444444444,40.015243902438996,8288.343401926282,102.3252271842751,0
4488,31.544085278963955,0,0,207,0.0,0.0,1.0,207,5650,3900,1750,0.6902654867256637,74,39,35,185.7189923174732,0.43562293826118226,0.7618713301722142,0.1209310443684898,1066692.6822204418,-7428.981989119511,1059263.7002313223,4486,6,1553.7342995169083,84,123,39,35.10889370592022,0.6315724206349207,39.93872549019606,8203.395020893271,97.6594645344437,0
4489,31.534550941847144,0,0,207,0.0,0.0,1.0,207,6750,4900,1850,0.725925925925926,86,49,37,185.87746949221403,0.4353698622641215,0.7628667044503834,0.1214309016025771,1067298.3567212413,-8472.656451891715,1058825.7002693496,4487,7,1554.7342995169083,85,122,42,34.989525139664785,0.6323529411764706,39.82558139534882,8204.483457253787,96.52333479122103,0
4490,31.368490648119163,0,1,206,0.0,0.004830917874396135,0.9951690821256038,207,5950,4300,1650,0.7226890756302521,76,43,33,187.20126310235037,0.4353210058940325,0.765439792940751,0.12259657239500649,1062370.0672689907,-7574.596305023746,1054795.470963967,4488,8,1555.7342995169083,85,122,45,34.86870937466062,0.6332107843137256,39.74079457364338,8163.938451503501,96.0463347235706,0
4491,31.759640094604883,0,0,206,0.0,0.0,1.0,206,5450,3600,1850,0.6605504587155964,73,36,37,186.3530747920425,0.4348162838424501,0.7635062367388932,0.12234484475477472,1076325.1394130194,-6534.7001588823205,1069790.439254137,4489,9,1564.0388349514562,86,120,47,34.80356650110371,0.6337209302325582,39.655172413793075,8268.458024629817,96.1448607515095,0
4492,32.2299507775676,0,1,205,0.0,0.0048543689320388345,0.9951456310679612,206,4750,3100,1650,0.6526315789473685,64,31,33,189.2424351888684,0.43464411161101907,0.7682996448422827,0.12476789590710644,1093482.4982957924,-4563.34183721905,1088919.1564585734,4490,10,1565.0388349514562,70,136,47,34.580399887355654,0.6421130952380952,39.509976525821614,8395.580634620244,119.93686620886064,0
4493,32.01587313357036,0,0,205,0.0,0.0,1.0,205,5950,4700,1250,0.7899159663865546,72,47,25,189.9832104799507,0.43456081619639725,0.7667156060428502,0.12617637173611113,1088308.7041193622,-5597.923679625568,1082710.7804397366,4491,11,1559.809756097561,73,132,47,34.30594171210569,0.6431221461187215,39.25957207207209,8347.832461333423,114.35386933333456,0
4494,31.559664077404317,0,1,204,0.0,0.004878048780487805,0.9951219512195122,205,6450,4100,2350,0.6356589147286822,88,41,47,178.36482359530282,0.43419615813805196,0.7536635091121531,0.11173428604533402,1056096.816957916,-9775.895508747843,1046320.921449168,4492,12,1560.809756097561,78,127,43,36.68312521236832,0.6201923076923077,41.2974683544304,8164.564994708292,104.67391018856785,7
4495,31.9439223950775,0,0,204,0.0,0.0,1.0,204,6450,5000,1450,0.7751937984496124,79,50,29,180.9508844108023,0.4337998848964873,0.7558712081985841,0.11388048537420663,1070316.5898060757,-8515.053295007005,1061801.5365110687,4493,13,1566.7549019607843,79,125,47,36.44858784769377,0.6214398734177216,41.13281250000003,8269.233348132047,104.67383984977275,0
4496,31.488778234708324,1,0,205,0.004878048780487805,0.0,1.0,205,6000,4400,1600,0.7333333333333333,76,44,32,176.4031017060103,0.4344522158456879,0.7503938166236594,0.11160087203629893,1056578.2258393979,-9723.264753378888,1046854.961086019,4494,0,1560.1073170731706,83,122,43,36.377652784426374,0.6217369477911647,40.94742063492067,8157.2492227562525,98.28011111754522,0
4497,31.245748018714032,0,0,205,0.0,0.0,1.0,205,4900,3500,1400,0.7142857142857143,63,35,28,175.54466894642184,0.4346225888729476,0.7489944777894524,0.11122388179605126,1048851.0866579756,-9075.956643705807,1039775.1300142697,4495,1,1561.1073170731706,84,121,44,36.346150814296315,0.6218998015873016,40.89460784313729,8095.941793623499,96.3802594478988,0
4498,31.06442399230279,0,1,204,0.0,0.004878048780487805,0.9951219512195122,205,5750,3500,2250,0.6086956521739131,80,35,45,179.86357071262194,0.4343864578351666,0.7498914226639455,0.1106222981803557,1034238.6842791195,-9545.627455286896,1024693.0568238326,4496,2,1562.1073170731706,89,116,40,37.314747327502396,0.6094335205992509,41.956018518518505,8015.987649402638,90.06727695958021,8
4499,30.746462809647905,0,1,203,0.0,0.004901960784313725,0.9950980392156863,204,5350,4000,1350,0.7476635514018691,67,40,27,184.47466849759826,0.434117828165749,0.7583497464369358,0.10895553061528956,1011921.7766833558,-8815.213140167492,1003106.5635431883,4497,3,1556.421568627451,76,128,42,38.70594955620002,0.5993695175438596,43.43885281385281,7888.347770359468,103.794049609993,8
4500,30.71316789956808,3,2,204,0.014563106796116505,0.009708737864077669,0.9902912621359223,206,6500,4500,2000,0.6923076923076923,85,45,40,179.48262945027915,0.4351833214934091,0.7531378428891737,0.10678726626098065,1012967.9797360762,-11337.968689606281,1001630.0110464699,4498,0,1541.868932038835,83,123,35,38.55745940160626,0.5992720883534137,43.1671626984127,7888.1500541661135,95.0379524598327,0
4501,30.666454253138287,3,2,205,0.014492753623188406,0.00966183574879227,0.9903381642512077,207,5050,3900,1150,0.7722772277227723,62,39,23,184.0075803960954,0.43609586792364335,0.7588260696826783,0.11011580595743518,1013111.3720685932,-9165.965550777924,1003945.4065178152,4499,0,1535.4057971014493,84,123,37,38.2235796583234,0.6010664682539683,42.95343137254902,7882.7068377399,93.84174806833214,0
4502,31.176830362594355,3,1,207,0.014423076923076924,0.004807692307692308,0.9951923076923077,208,6350,5100,1250,0.8031496062992126,76,51,25,198.0817865194124,0.43707129474792517,0.7782482724990154,0.11978616356076054,1033051.9269420025,-7024.245748801237,1026027.6811932012,4500,0,1529.0096153846155,74,134,37,37.47021400953153,0.6090934684684685,42.56944444444445,8025.868760703986,108.45768595545927,0
4503,30.83977361377452,0,0,207,0.0,0.0,1.0,207,5150,3500,1650,0.6796116504854369,68,35,33,197.7711070948713,0.4367241608429873,0.7751963961337631,0.12015139794497531,1023219.8116997033,-6077.337007748869,1017142.4746919544,4501,1,1537.2125603864733,77,130,41,37.30661473724229,0.6094426406926408,42.40117521367521,7944.289439584612,103.17259012447549,0
4504,30.74253602913415,2,0,209,0.009569377990430622,0.0,1.0,209,6800,5300,1500,0.7794117647058824,83,53,30,181.01658139629586,0.43724025426328056,0.7535813506178985,0.11122211129537565,1023240.6031170349,-11555.296815574475,1011685.3063014604,4502,0,1523.4928229665072,92,117,36,37.32110556399678,0.6081295289855073,41.9914874551971,7931.835992731831,86.21560861665033,8
4505,31.232869570270072,2,0,211,0.009478672985781991,0.0,1.0,211,5750,4100,1650,0.7130434782608696,74,41,33,178.27841211019532,0.43783946437974874,0.7525716762705852,0.11020599857010313,1041322.6831668881,-10820.929110136083,1030501.754056752,4503,0,1510.0426540284361,97,114,39,37.16932850360857,0.6088917525773196,41.77295918367345,8065.171485333071,83.14609778693888,0
4506,31.38598464628154,0,0,211,0.0,0.0,1.0,211,5600,3700,1900,0.6607142857142857,75,37,38,178.8501560874087,0.43774072820281346,0.7547775569484791,0.11088709677419371,1047289.2793429395,-10338.429784168977,1036950.8495587705,4504,1,1511.0426540284361,79,132,43,37.04637096774195,0.6160337552742616,41.66666666666668,8108.046033622758,102.63349409649061,0
4507,31.08473707562164,0,0,211,0.0,0.0,1.0,211,6100,4000,2100,0.6557377049180327,82,40,42,182.79943590295073,0.4373975024448958,0.7597096783808759,0.11398082473948712,1038870.0350436798,-10319.028723507243,1028551.0063201726,4505,2,1512.0426540284361,81,130,41,36.73738043763104,0.617283950617284,41.463414634146346,8036.541780526581,99.21656519168619,0
4508,31.07248384498857,1,0,212,0.0047169811320754715,0.0,1.0,212,4800,3300,1500,0.6875,63,33,30,184.74250799141254,0.4376746512563712,0.7638816042999064,0.11571246785861433,1039751.9198008566,-8782.724529420611,1030969.195271436,4506,0,1505.9056603773586,82,130,44,36.523472242436014,0.6185213414634146,41.302710843373504,8038.367338061637,98.02886997636143,0
4509,31.380001339617195,0,0,212,0.0,0.0,1.0,212,5850,4300,1550,0.7350427350427351,74,43,31,183.9114165742411,0.4380188306655936,0.7642408407622554,0.11551743287168582,1050857.3248991563,-9597.068152075492,1041260.2567470808,4507,1,1506.9056603773586,82,130,43,36.44272424551024,0.6195376016260163,41.20230923694781,8121.071882834469,99.03746198578621,0
4510,31.192171843161887,0,0,212,0.0,0.0,1.0,212,6100,4500,1600,0.7377049180327869,77,45,32,181.54262840182983,0.43800718724850224,0.7595917914998185,0.11455460287126724,1045883.574153385,-10525.50938917888,1035358.0647642062,4508,2,1507.9056603773586,87,125,34,36.33805861559331,0.6193726053639848,41.03929924242425,8077.546678655937,92.84536412248204,0
4511,31.455028607869696,0,1,211,0.0,0.0047169811320754715,0.9952830188679245,212,5200,3800,1400,0.7307692307692307,66,38,28,179.57667875427944,0.4382344667501267,0.7572309943360864,0.1135416486905496,1055275.8493990821,-9699.41355906213,1045576.43584002,4509,3,1508.9056603773586,87,125,34,36.31667085561094,0.6200909961685823,40.96827651515154,8147.850272561757,93.65345140875583,0
4512,31.107099278118437,0,0,211,0.0,0.0,1.0,211,4850,3700,1150,0.7628865979381443,60,37,23,181.63304603233354,0.43831621906266455,0.7603683420370284,0.11523549871770628,1044577.6589755455,-9104.035596589347,1035473.6233789562,4510,4,1515.7962085308056,88,123,38,36.140310270075,0.6209753787878788,40.847378277153574,8061.486332117298,91.60779922860566,0
4513,31.480155198505834,0,1,210,0.0,0.004739336492890996,0.995260663507109,211,6000,4200,1800,0.7,78,42,36,180.90096366680345,0.43817798841495526,0.7599749651543983,0.11512295380976273,1057985.418006803,-9921.883667428465,1048063.5343393744,4511,5,1516.7962085308056,90,121,40,36.04942087215036,0.6214120370370371,40.73946886446888,8161.561756993627,90.6840195221514,0
4514,31.07288416826624,1,1,210,0.004739336492890996,0.004739336492890996,0.995260663507109,211,5700,3900,1800,0.6842105263157895,75,39,36,180.32509265115445,0.43836887835703003,0.7598150895252163,0.11539046660477283,1045857.9283669253,-10181.11443345803,1035676.8139334673,4512,0,1514.3222748815165,78,133,41,35.867277362741625,0.6278044871794872,40.54588607594937,8061.987628942179,103.35881575566896,0
4515,31.264497699984467,0,1,209,0.0,0.004761904761904762,0.9952380952380953,210,6750,5000,1750,0.7407407407407407,85,50,35,182.444622498626,0.43741930584035843,0.761063543662081,0.11723138798149298,1053484.1665020268,-10309.495786851661,1043174.6707151752,4513,1,1522.4761904761904,78,132,39,35.664596877962886,0.6292735042735043,40.40084388185654,8116.237219373599,104.05432332530255,0
4516,30.848744716224086,0,0,209,0.0,0.0,1.0,209,5700,3400,2300,0.5964912280701754,80,34,46,184.10835767846814,0.4366555867378236,0.7630519785913363,0.11865831848282361,1040319.9416475687,-9193.680816621423,1031126.2608309473,4514,2,1530.6985645933014,78,131,42,35.51397914974278,0.6303418803418803,40.295358649789016,8011.562182631154,102.71233567475839,0
4517,30.904354441282926,1,0,210,0.004761904761904762,0.0,1.0,210,5400,4100,1300,0.7592592592592593,67,41,26,181.54460221441235,0.43722943722943725,0.7608936467083391,0.11741124017733585,1043162.3313146518,-9523.901903284723,1033638.429411367,4515,0,1524.404761904762,80,130,44,35.45791262456283,0.6307291666666667,40.17489711934155,8029.727072166632,100.37158840208289,0
4518,30.62009200113586,2,3,209,0.009433962264150943,0.014150943396226415,0.9858490566037735,212,6550,4800,1750,0.732824427480916,83,48,35,177.85427224767466,0.4380178991922263,0.7586297066532603,0.11562143573799435,1034997.6818190914,-12134.248104407092,1022863.4337146843,4516,0,1511.0141509433963,85,127,37,35.3708577906146,0.6306372549019608,39.995155038759684,7961.372273454223,93.66320321710852,0
4519,30.36879333947699,0,0,209,0.0,0.0,1.0,209,6750,4200,2550,0.6222222222222222,93,42,51,184.5694379587687,0.4371760366826156,0.7647005394128876,0.12052367266769219,1027723.5233248518,-10612.729384585557,1017110.7939402662,4517,1,1517.8755980861245,84,125,38,35.03894044310454,0.6325644841269842,39.84068627450978,7900.724433869508,94.0562432603513,0
4520,30.03942805931275,1,1,209,0.004761904761904762,0.004761904761904762,0.9952380952380953,210,6250,4700,1550,0.752,78,47,31,184.97331510183872,0.4375754727728412,0.7662360758856028,0.12135455090356542,1017840.3779174963,-10595.338210418686,1007245.0397070776,4518,0,1511.642857142857,86,124,42,34.86387713488484,0.6334786821705427,39.67911877394634,7819.890383926896,90.92895795263833,0
4521,30.192696522206138,0,0,209,0.0,0.0,1.0,209,5400,3900,1500,0.7222222222222222,69,39,30,185.29669492181566,0.4374856229297019,0.7654674815198161,0.12195567957127357,1023897.3214288991,-9255.042079985156,1014642.2793489139,4519,1,1518.090909090909,73,136,39,34.743561158856295,0.6399828767123288,39.569256756756744,7863.106395795794,107.713786243778,0
4522,30.062047573527412,0,1,208,0.0,0.004784688995215311,0.9952153110047847,209,5700,3800,1900,0.6666666666666666,76,38,38,225.813667501269,0.43774345172371487,0.8035153083216866,0.13921649724044402,1001536.7937521922,-2267.8606930707756,999268.9330591214,4520,2,1519.090909090909,76,133,36,36.04065125866922,0.6152686403508771,41.86958874458877,7759.928703334423,102.10432504387398,8
4523,29.829176418155836,1,0,209,0.004784688995215311,0.0,1.0,209,5950,4600,1350,0.773109243697479,73,46,27,245.42395999950557,0.43726325757575757,0.8155293398131107,0.1513310214684242,993823.5832600704,1031.6238689169713,994855.2071289874,4521,0,1520.0765550239234,73,136,40,35.52845639291817,0.6167237442922374,41.86373873873874,7699.992077085331,105.47934352171687,8
4524,30.10142653799725,0,0,209,0.0,0.0,1.0,209,6650,5100,1550,0.7669172932330827,82,51,31,245.61383917505083,0.4372460050913998,0.8167729848413099,0.15194115233420066,1003803.0765574989,859.5854818026492,1004662.6620393016,4522,1,1521.0765550239234,77,132,43,35.40373875271485,0.6160714285714286,41.746794871794854,7773.789882368964,100.95831016063589,0
4525,29.893964873182057,0,0,209,0.0,0.0,1.0,209,5250,3400,1850,0.6476190476190476,71,34,37,243.68962226599325,0.43717507821126245,0.8165155627633758,0.1511583429440978,997633.2329947721,1572.5731416996805,999205.8061364718,4523,2,1522.0765550239234,61,148,39,35.35414092475774,0.625853825136612,41.649865591397855,7723.1098429926315,126.60835808184642,0
4526,29.67660020226704,1,1,209,0.004761904761904762,0.004761904761904762,0.9952380952380953,210,6100,4500,1600,0.7377049180327869,77,45,32,239.38199346167815,0.43775110123794336,0.8144214483413881,0.1496183815059866,992463.1563640089,-584.4382384626424,991878.7181255462,4524,0,1515.8238095238096,64,146,37,35.187265047300386,0.6266276041666667,41.37820512820514,7675.0156100029935,119.92211890629677,0
4527,30.264620952762694,0,0,209,0.0,0.0,1.0,209,6000,4300,1700,0.7166666666666667,77,43,34,241.75713797640566,0.4379226858667648,0.8150901376079538,0.1518599742926512,1013521.4686150611,1205.2099060041528,1014726.6785210653,4525,1,1523.8564593301435,66,143,43,34.943580039248666,0.627209595959596,41.20024875621891,7832.476374062326,118.67388445548978,0
4528,29.872452452438182,0,1,208,0.0,0.004784688995215311,0.9952153110047847,209,5650,4200,1450,0.7433628318584071,71,42,29,239.2840062352375,0.43760159796344006,0.8134956250026533,0.15099276317307514,1001638.3441268445,485.20715630002906,1002123.5512831446,4526,2,1524.8564593301435,67,142,36,34.842070886325516,0.6282649253731343,41.038602941176464,7735.812020656659,115.45988090532327,0
4529,30.291944632305714,2,0,210,0.009523809523809525,0.0,1.0,210,5500,4000,1500,0.7272727272727273,70,40,30,233.28197469538034,0.4388428457507405,0.8094722518988631,0.14833024920481924,1017814.8061229718,-12.43043068780571,1017802.375692284,4527,0,1517.7,71,139,40,34.72229973583362,0.6288145539906103,40.76967592592591,7852.590623866482,110.59986794178144,0
4530,30.44378450077327,0,0,210,0.0,0.0,1.0,210,5200,4000,1200,0.7692307692307693,64,40,24,233.36828064306897,0.43875977823346246,0.8108985393332038,0.14887569324983352,1023833.4069512632,586.0483690300598,1024419.4553202932,4528,1,1518.7,72,138,42,34.601215038972946,0.6294849537037037,40.65353881278537,7895.48777542168,109.65955243641223,0
4531,30.590082976807132,0,1,209,0.0,0.004761904761904762,0.9952380952380953,210,4850,3200,1650,0.6597938144329897,65,32,33,268.81764732444645,0.43878778385357337,0.8257050937764701,0.1643430289183179,1016733.9860402426,7813.2076164290065,1024547.1936566716,4529,2,1519.7,71,139,37,35.24218852290367,0.6145833333333333,42.17303240740741,7886.948332315983,111.08377932839413,8
4532,30.273381186653303,0,1,208,0.0,0.004784688995215311,0.9952153110047847,209,5950,4300,1650,0.7226890756302521,76,43,33,273.55586010540657,0.43807795822598455,0.8313006965966554,0.16341935206977887,999626.5193111047,6940.738454864498,1006567.2577659691,4530,3,1527.9617224880383,63,146,32,35.9876733802014,0.6106150793650793,43.01757812499999,7779.726815691211,123.48772723319384,8
4533,30.713286682284163,1,0,209,0.004784688995215311,0.0,1.0,209,6000,4500,1500,0.75,75,45,30,269.62082446865315,0.43850831186357503,0.8304887643443073,0.16209105849098265,1015989.289431968,6986.373973593481,1022975.6634055615,4531,0,1527.2105263157894,67,142,37,35.849872451511686,0.6105410447761195,42.784926470588225,7899.920292313605,117.90925809423291,0
4534,31.149456027287247,0,1,208,0.0,0.004784688995215311,0.9952153110047847,209,4900,3300,1600,0.673469387755102,65,33,32,270.3103564023657,0.4384335510980248,0.8317204290114837,0.16308956464687735,1031470.8848264219,9063.452499218762,1040534.3373256406,4532,1,1528.2105263157894,56,153,37,35.697166595654025,0.6194196428571428,42.65350877192983,8016.2032122854425,143.14648593366863,0
4535,31.11588362099499,0,2,206,0.0,0.009615384615384616,0.9903846153846154,208,5300,3600,1700,0.6792452830188679,70,36,34,271.8957353490847,0.4384861188529667,0.8323615100645476,0.16437439176511676,1030944.6126568688,9161.888712503534,1040106.5013693722,4533,2,1529.3557692307693,56,152,36,35.581280467603776,0.6201636904761905,42.58040935672516,8009.838024220341,143.0328218610775,0
4536,31.32123444689573,1,0,207,0.004830917874396135,0.0,1.0,207,5950,4500,1450,0.7563025210084033,74,45,29,266.74966149175026,0.43903018151118617,0.8277840948313473,0.1619270858384458,1038956.9608703632,8078.283523333532,1047035.2443936967,4534,0,1535.584541062802,59,148,39,35.55989934393814,0.6193502824858756,42.430555555555564,8067.392955801148,136.7354738271381,0
4537,31.361882883431846,0,1,206,0.0,0.004830917874396135,0.9951690821256038,207,5650,4100,1550,0.7256637168141593,72,41,31,260.781965875331,0.4390243187467755,0.8236826544387541,0.15904026932960347,1041668.0945173895,7279.650695571047,1048947.7452129605,4535,1,1536.584541062802,62,145,39,35.54056004618936,0.6189516129032258,42.261904761904766,8083.151957455956,130.37341866864446,0
4538,31.80975029197996,0,1,205,0.0,0.0048543689320388345,0.9951456310679612,206,5550,3900,1650,0.7027027027027027,72,39,33,234.07558400689285,0.43862479280132605,0.8070211326336327,0.1402180925555853,1051182.4677867666,2461.2300089987966,1053643.6977957655,4536,2,1544.9466019417475,74,132,35,36.8989735278228,0.6055743243243243,42.916666666666664,8177.756637563176,110.5102248319348,8
4539,31.802573492308067,1,0,206,0.0048543689320388345,0.0,1.0,206,6700,4800,1900,0.7164179104477612,86,48,38,234.88337786228146,0.4388023916646933,0.8095790259816822,0.14150291300483853,1052649.3089150568,1549.9650764732032,1054199.27399153,4537,0,1545.9320388349515,82,124,40,36.66497975708503,0.6042936991869918,42.70833333333335,8182.537138125139,99.78703826981877,0
4540,31.868811532768373,0,0,206,0.0,0.0,1.0,206,5950,4300,1650,0.7226890756302521,76,43,33,232.24025807686914,0.4390263635646065,0.8068703962060222,0.14051569323998042,1056136.2774886335,1905.4723296605134,1058041.749818294,4538,1,1546.9320388349515,65,141,38,36.57149133562204,0.6141025641025641,42.55050505050503,8204.609433751817,126.22476051925872,0
4541,32.147743431230865,0,0,206,0.0,0.0,1.0,206,5900,3900,2000,0.6610169491525424,79,39,40,235.76075752839236,0.4388778711816244,0.8086246001418609,0.14348673169082937,1067153.6240894408,3218.5893628988742,1070372.2134523396,4539,2,1547.9320388349515,69,137,39,36.26161083838674,0.6139794685990339,42.336309523809504,8283.306212972615,120.0479161300379,0
4542,32.632056257055304,2,2,206,0.009615384615384616,0.009615384615384616,0.9903846153846154,208,6850,5100,1750,0.7445255474452555,86,51,35,229.68389557458346,0.43997352285395763,0.8049834496072636,0.14065866006031874,1085124.8455003912,1397.1403398594912,1086521.9858402507,4540,0,1534.0384615384614,74,134,43,36.187818648571,0.6137387387387387,42.11111111111111,8415.444730291701,113.722226085023,0
4543,32.697578792483874,0,0,206,0.0,0.0,1.0,206,4550,2900,1650,0.6373626373626373,62,29,33,228.39776831026245,0.4392454021627595,0.8025280144183178,0.1401936599006877,1088006.4973382403,3949.651179823816,1091956.148518064,4541,1,1547.5242718446602,74,132,34,36.13574979361831,0.6145833333333333,42.02777777777777,8435.067062383256,113.98739273490887,0
4544,32.18640624652489,2,2,206,0.009615384615384616,0.009615384615384616,0.9903846153846154,208,6400,4600,1800,0.71875,82,46,36,225.58522658287896,0.43999626455468843,0.8025643645279934,0.13904459683836373,1072244.326277604,376.4958591078366,1072620.822136712,4542,0,1533.6346153846155,78,130,37,36.05477795940607,0.6143162393162394,41.87763713080168,8308.031232620913,106.51322093103735,0
4545,32.668591545816575,0,0,206,0.0,0.0,1.0,206,4650,3100,1550,0.6666666666666666,62,31,31,228.21914563096814,0.43862775278238214,0.8029087035075326,0.14070966079428956,1088397.4509288827,3828.6272715826417,1092226.0782004653,4543,1,1549.504854368932,77,129,37,35.97589761498267,0.6148538961038961,41.866987179487175,8432.841960324356,109.51742805616047,0
4546,32.51676043009061,0,0,206,0.0,0.0,1.0,206,6100,4000,2100,0.6557377049180327,82,40,42,232.27332978568572,0.4385562199068593,0.8068796996954113,0.14358714932206043,1084135.1562719536,3063.1365370023077,1087198.292808956,4544,2,1550.504854368932,78,128,39,35.77420768654683,0.6153846153846154,41.77215189873418,8396.7330730867,107.65042401393205,0
4547,32.09940483118983,2,0,208,0.009615384615384616,0.0,1.0,208,5200,3900,1300,0.75,65,39,26,229.16939503666248,0.43962659095131923,0.807298547289401,0.1426581695309282,1072291.069059674,2347.2591199246144,1074638.3281795986,4545,0,1536.5865384615386,64,144,40,35.598921197842394,0.6251627604166667,41.52243589743592,8296.975969908073,129.64024952981364,0
4548,32.14996546515637,1,1,208,0.004784688995215311,0.004784688995215311,0.9952153110047847,209,6100,4700,1400,0.7704918032786885,75,47,28,223.21698274136685,0.4400524092135934,0.8033337800094051,0.1396832046639278,1075536.3389301684,115.59528093789231,1075651.9342111063,4546,0,1530.2296650717703,65,144,43,35.56139026176094,0.6264423076923077,41.33522727272728,8316.06351023436,127.93943861899015,0
4549,32.10037564938609,0,0,208,0.0,0.0,1.0,208,5500,3900,1600,0.7090909090909091,71,39,32,219.21825670614516,0.4398651368760064,0.7984511677572412,0.1376162768687071,1074814.190453355,23.778622842253753,1074837.9690761971,4547,1,1538.0432692307693,67,141,43,35.54954961621183,0.6263992537313433,41.22242647058823,8306.857319930741,123.98294507359316,0
4550,32.44823669891097,0,0,208,0.0,0.0,1.0,208,6250,4300,1950,0.688,82,43,39,220.39041184964628,0.43961449430199434,0.8005169236150349,0.13909408112100208,1088056.0537305526,109.42435943542841,1088165.478089988,4548,2,1539.0432692307693,68,140,41,35.325215693132805,0.6277573529411764,41.03260869565218,8403.035210342987,123.57404721092628,0
4551,31.935652377548116,0,1,207,0.0,0.004807692307692308,0.9951923076923077,208,6150,4000,2150,0.6504065040650406,83,40,43,219.08520585403872,0.4393788515731451,0.7991696753919704,0.13887467180995697,1072143.9578122396,-771.8240595083271,1071372.1337527314,4549,3,1540.0432692307693,73,135,38,35.20140699695785,0.6267123287671232,40.878378378378386,8275.218031614679,113.3591511180093,0
4552,32.389244472049484,1,0,208,0.004807692307692308,0.0,1.0,208,5050,3100,1950,0.6138613861386139,70,31,39,219.54929060511026,0.4394828827573393,0.7997139311468433,0.13995810946489426,1089044.9869554453,1169.810864624032,1090214.7978200694,4550,0,1540.4711538461538,76,132,43,34.985740866329316,0.6273300438596492,40.679112554112564,8399.2076201937,110.51588973939079,0
4553,32.85273584251279,0,0,208,0.0,0.0,1.0,208,6000,4500,1500,0.75,75,45,30,222.61209420871074,0.4395738495602626,0.8004682279148838,0.13499963437989324,1089451.840392614,905.0311458667766,1090356.8715384807,4551,1,1541.4711538461538,68,140,40,36.733786661977085,0.6132046568627452,42.466787439613526,8460.670602920072,124.42162651353047,8
4554,32.95018757146569,0,1,207,0.0,0.004807692307692308,0.9951923076923077,208,5950,3900,2050,0.6554621848739496,80,39,41,224.64808463764427,0.4394398186857426,0.8016487561459846,0.13694755993802776,1094296.4084855954,1616.3184384285796,1095912.726924024,4552,2,1542.4711538461538,69,139,41,36.487083068691426,0.6145833333333333,42.27678571428572,8492.02825223535,123.07287322080218,0
4555,33.069587699986116,0,0,207,0.0,0.0,1.0,207,4950,3300,1650,0.6666666666666666,66,33,33,227.01355545164128,0.43912984850616765,0.8033305910801982,0.13917461026794647,1100009.8563027885,3593.4297022292776,1103603.2860050178,4553,3,1550.072463768116,71,136,43,36.21643856106503,0.6156103286384976,42.07175925925928,8529.580577479106,120.13493771097332,0
4556,33.248853811219426,1,2,206,0.004807692307692308,0.009615384615384616,0.9903846153846154,208,5650,4200,1450,0.7433628318584071,71,42,29,224.95281994221736,0.4395394950761799,0.8032989133854953,0.13854584997113145,1107395.1212235624,2572.3310618991463,1109967.4522854616,4554,0,1543.6153846153845,73,135,39,36.10007044814112,0.6162956621004566,41.905968468468494,8581.33072394021,117.55247567041383,0
4557,32.96100125524342,0,1,205,0.0,0.0048543689320388345,0.9951456310679612,206,5550,4000,1550,0.7207207207207207,71,40,31,227.49444367102635,0.43932778830215485,0.8032882249132709,0.14049505339441018,1098646.2376291277,3237.182924141186,1101883.4205532689,4555,5,1558.8349514563106,73,133,39,35.93369498055466,0.6172945205479452,41.80743243243245,8510.285543689155,116.57925402313911,0
4558,32.86922552460599,0,0,205,0.0,0.0,1.0,205,6750,5200,1550,0.7703703703703704,83,52,31,228.16355117646694,0.4394567989797545,0.8021027946669139,0.14135339531465213,1096549.3921098858,2288.520668837782,1098837.9127787235,4556,6,1565.3268292682926,75,130,41,35.80047932364076,0.6174999999999999,41.69407894736844,8490.315573420065,113.20420764560086,0
4559,33.29641011885908,0,0,205,0.0,0.0,1.0,205,5900,4500,1400,0.7627118644067796,73,45,28,228.11023755957171,0.4396062490036665,0.8023651331808401,0.14174975505805593,1111736.5706746841,3819.6986480533105,1115556.2693227374,4557,7,1566.3268292682926,63,142,43,35.69058228884551,0.625165343915344,41.58528645833334,8604.282282830838,136.57590925128315,0
4560,33.36481433697952,0,1,204,0.0,0.004878048780487805,0.9951219512195122,205,6500,4700,1800,0.7230769230769231,83,47,36,230.94610877328728,0.439769647696477,0.8044331059248122,0.1443457902162401,1115806.6868403698,4038.242493799624,1119844.9293341695,4558,8,1567.3268292682926,64,141,43,35.40543541124468,0.6266276041666667,41.37820512820514,8628.868169393863,134.82606514677911,0
4561,33.737747097003925,0,0,204,0.0,0.0,1.0,204,5400,3900,1500,0.7222222222222222,69,39,30,228.940254354216,0.43954751440806206,0.8021552609678211,0.14371935030865027,1129638.161554658,5523.929606910617,1135162.0911615686,4559,9,1575.6274509803923,67,137,40,35.29796612008921,0.6263992537313433,41.222426470588246,8730.572330111654,130.307049703159,0
4562,33.81090203658287,0,0,204,0.0,0.0,1.0,204,5200,3500,1700,0.6730769230769231,69,35,34,229.87153153402454,0.43919485897807403,0.8026581594895694,0.14476491953780837,1133078.8888856852,6092.515907404585,1139171.4047930897,4560,10,1576.6274509803923,70,134,44,35.157991423929865,0.6258928571428571,41.10915492957746,8753.333000844192,125.04761429777416,0
4563,33.23454652954093,2,2,204,0.009708737864077669,0.009708737864077669,0.9902912621359223,206,5850,4200,1650,0.717948717948718,75,42,33,230.28908703405563,0.43974563896124397,0.8046276267202861,0.14572667741733272,1115229.0713322957,4315.016934190307,1119544.088266486,4561,0,1562.3106796116506,72,134,37,34.97303314054896,0.6265914351851851,40.93892694063926,8609.777286584113,119.580240091446,0
4564,32.82592648526788,0,0,204,0.0,0.0,1.0,204,5150,3100,2050,0.6019417475728155,72,31,41,235.56874257380298,0.4388029637142213,0.8083559151605018,0.1493233269042206,1102032.2467409922,5970.870128111743,1108003.1168691039,4562,12,1578.6274509803923,73,131,39,34.774282920469346,0.6267123287671232,40.87837837837838,8505.90730209475,116.519278110887,0
4565,32.84091591264927,0,1,203,0.0,0.004901960784313725,0.9950980392156863,204,5300,3900,1400,0.7358490566037735,67,39,28,235.03272145176226,0.4388769157088122,0.8088565320796577,0.14957956681750362,1103733.6845803608,5782.706328980568,1109516.3909093414,4563,13,1579.6274509803923,73,131,40,34.64409816483872,0.6281392694063928,40.73761261261261,8514.414263501882,116.6358118287929,0
4566,33.27158570658003,0,1,202,0.0,0.0049261083743842365,0.9950738916256158,203,5750,4200,1550,0.7304347826086957,73,42,31,232.68846771917285,0.43866852818286756,0.8063083759982457,0.14850468379932197,1119061.1841963958,5728.526446932379,1124789.7106433283,4564,14,1587.6305418719212,75,128,40,34.60366793496453,0.6281944444444445,40.63870614035087,8629.361517620782,115.05815356827709,0
4567,33.35324391343063,1,0,203,0.0049261083743842365,0.0,1.0,203,5450,3600,1850,0.6605504587155964,73,36,37,228.88430775686632,0.43877623599798404,0.8031565001220704,0.1468939437108454,1123500.2369050118,5380.3147977356875,1128880.5517027476,4565,0,1588.320197044335,62,141,41,34.50227205164137,0.6374327956989247,40.44312169312168,8657.063871577922,139.6300624448052,0
4568,33.6331448315217,1,0,204,0.004901960784313725,0.0,1.0,204,4750,3500,1250,0.7368421052631579,60,35,25,226.51882711069595,0.4391883190057632,0.8009029232764648,0.14604388293647874,1134327.2629968715,5839.296234747262,1140166.5592316187,4566,0,1581.5294117647059,66,138,42,34.399880275366634,0.6365214646464646,40.28296019900496,8735.100814840918,132.35001234607452,0
4569,33.71325416764512,0,0,204,0.0,0.0,1.0,204,7100,5400,1700,0.7605633802816901,88,54,34,225.87214610429865,0.4393759659036028,0.8008290105864586,0.14628153209328004,1138396.701749103,3526.421228424815,1141923.1229775278,4567,1,1582.5294117647059,68,136,42,34.257000116184514,0.6369485294117647,40.126811594202884,8761.170852080932,128.84074782471959,0
4570,34.112660472482865,0,0,204,0.0,0.0,1.0,204,6550,4500,2050,0.6870229007633588,86,45,41,225.78537125471215,0.4390741210277214,0.8003980285201029,0.14644259855459027,1152340.7705489225,4686.3377380657585,1157027.1082869882,4568,2,1583.5294117647059,71,133,41,34.206510445656605,0.635856807511737,40.075231481481474,8866.725376860906,124.88345601212544,0
4571,34.37913789665024,0,0,204,0.0,0.0,1.0,204,5450,3900,1550,0.7155963302752294,70,39,31,226.95298590540767,0.4390746241025146,0.8012842862846257,0.1475315860214921,1162040.3706810628,6495.706373738667,1168536.0770548014,4569,3,1584.5294117647059,72,132,42,34.096303715493086,0.6361400462962963,39.99714611872145,8938.67396710706,124.14824954315363,0
4572,34.32423496017951,1,1,204,0.004878048780487805,0.004878048780487805,0.9951219512195122,205,5350,3800,1550,0.7102803738317757,69,38,31,225.42928153440243,0.43949764865295715,0.8011876082455431,0.1471181339072943,1161398.95897588,6012.6665793469165,1167411.6255552268,4570,0,1577.7951219512195,74,131,38,33.99681882897312,0.6365427927927928,39.8611111111111,8929.068344502226,120.66308573651656,0
4573,34.563967869167875,0,1,203,0.0,0.004901960784313725,0.9950980392156863,204,6100,4700,1400,0.7704918032786885,75,47,28,226.39141367125302,0.4386102860684504,0.8009058479479205,0.1484223021818499,1170927.9388697858,6117.606277579544,1177045.5451473652,4571,5,1586.5294117647059,77,127,39,33.810636960648466,0.6367694805194806,39.70352564102564,8996.878976201278,116.8425841065101,0
4574,34.19060997605839,1,0,204,0.004901960784313725,0.0,1.0,204,4950,3700,1250,0.7474747474747475,62,37,25,222.59877283264927,0.4383351041566052,0.7978533660091707,0.146712031472785,1159903.3531853901,5888.612604708385,1165791.9657900985,4572,0,1587.5,66,138,44,33.72291691536348,0.6442550505050505,39.52114427860695,8905.930962980097,134.93834792394088,0
4575,34.330559360290565,0,0,204,0.0,0.0,1.0,204,5400,3600,1800,0.6666666666666666,72,36,36,223.48046320783357,0.4381077143501078,0.7984519911532473,0.1478830463070738,1165876.0917602836,5910.105805905305,1171786.1975661889,4573,1,1588.5,67,137,42,33.55993700895394,0.6450559701492538,39.38419117647058,8947.086495046296,133.53860440367606,0
4576,34.46170915797268,0,2,202,0.0,0.00980392156862745,0.9901960784313726,204,6550,4900,1650,0.7480916030534351,82,49,33,224.93856004744276,0.43799200714768666,0.7987249451552687,0.14916432622500891,1170982.0817794672,5329.804663365864,1176311.886442833,4574,2,1589.5,68,136,43,33.447706740792206,0.6452205882352942,39.31159420289854,8983.768021435246,132.11423560934185,0
4577,34.279301703025126,0,0,202,0.0,0.0,1.0,202,4350,3100,1250,0.7126436781609196,56,31,25,224.81985168051972,0.4373106620363529,0.7971037654946602,0.14982372424586354,1166289.3785385415,7691.001019920027,1173980.3795584615,4575,3,1603.6930693069307,70,132,44,33.27861361079863,0.6458333333333333,39.14319248826291,8941.989205982789,127.74270294261127,0
4578,34.531201185975405,0,0,202,0.0,0.0,1.0,202,6850,4800,2050,0.7007299270072993,89,48,41,222.00284167727813,0.4368555325681822,0.7943294329432946,0.14855086290274822,1176108.253163543,4969.874864481178,1181078.1280280242,4576,4,1604.6930693069307,71,131,45,33.21045824094604,0.6467136150234742,39.004629629629626,9012.483642867415,126.93638933616077,0
4579,34.877199720271044,0,0,202,0.0,0.0,1.0,202,4700,3000,1700,0.6382978723404256,64,30,34,222.34612889774453,0.43653586440733627,0.7955447412766514,0.14926885070301316,1188903.7845692623,7769.630826170562,1196673.4153954329,4577,5,1605.6930693069307,73,129,46,33.08798093338365,0.646832191780822,38.893581081081074,9106.660720879874,124.74877699835444,0
4580,34.894093939819264,0,1,201,0.0,0.0049504950495049506,0.995049504950495,202,5700,3900,1800,0.6842105263157895,75,39,36,220.56817318480648,0.4364404257589938,0.7943679677516537,0.14865733312950538,1190688.2617649368,6425.58694601686,1197113.8487109537,4578,6,1606.6930693069307,75,127,38,32.99886323889471,0.6472222222222221,38.7609649122807,9115.699431098614,121.54265908131485,0
4581,34.646392616820584,0,0,201,0.0,0.0,1.0,201,6100,4300,1800,0.7049180327868853,79,43,36,222.09319204528924,0.43630078772802655,0.7919838558212946,0.14179796107506948,1165424.798521863,5466.5827184918635,1170891.3812403549,4579,7,1614.8308457711444,85,116,40,34.864457831325325,0.6242647058823529,40.62500000000001,8986.40808498786,105.7224480586807,8
4582,34.75594277935609,2,0,203,0.009852216748768473,0.0,1.0,203,4850,3700,1150,0.7628865979381443,60,37,23,216.77823208277084,0.43684867255198423,0.7884250928656054,0.13939344458345598,1171359.3098164045,5335.04006313891,1176694.3498795433,4580,0,1599.911330049261,70,133,42,34.7474947257384,0.6333333333333333,40.37558685446009,9023.491247410277,128.90701782014682,0
4583,34.98620254856864,0,0,203,0.0,0.0,1.0,203,6600,4800,1800,0.7272727272727273,84,48,36,214.5035512501825,0.43670336861272335,0.7863405841378472,0.13853848144279715,1180513.0849623305,3444.849804345562,1183957.934766676,4581,1,1600.911330049261,74,129,42,34.64989663530083,0.6328828828828829,40.222222222222214,9088.637950950364,122.81943176959952,0
4584,34.98517766524303,1,0,204,0.004901960784313725,0.0,1.0,204,4000,2700,1300,0.675,53,27,26,213.1568916236016,0.4365391271451109,0.785193887470222,0.1383494129861078,1182037.4401515836,5591.885305085714,1187629.3254566693,4582,0,1594.0588235294117,77,127,46,34.50975040671288,0.6332521645021645,40.050747863247835,9094.370769951252,118.10871129806822,0
4585,34.64172104705939,0,1,203,0.0,0.004901960784313725,0.9950980392156863,204,6050,4000,2050,0.6611570247933884,81,40,41,212.14243636216196,0.4363006696931646,0.7850695344216989,0.13830800616091773,1171828.5726123215,2868.9136785541114,1174697.4862908756,4583,1,1595.0588235294117,79,125,40,34.377920170871676,0.6339662447257384,39.89583333333331,9010.455984844442,114.05640487144863,0
4586,34.315075218195894,0,1,202,0.0,0.0049261083743842365,0.9950738916256158,203,5800,4300,1500,0.7413793103448276,73,43,30,213.07902371732686,0.4356313710188753,0.7857831790123473,0.1394699064331587,1162000.398737218,3119.5821044139147,1165119.980841632,4584,2,1603.8620689655172,82,121,42,34.213847093621375,0.6341463414634146,39.759036144578296,8930.188249554545,108.90473475066518,0
4587,34.409137591988184,0,1,201,0.0,0.0049504950495049506,0.995049504950495,202,5150,4000,1150,0.7766990291262136,63,40,23,210.28044113338478,0.4355388897098665,0.7830281148415599,0.1382414002736195,1166534.587432522,3509.8815285319433,1170044.468961054,4585,3,1611.6633663366338,82,120,45,34.132908392776756,0.6356707317073171,39.60843373493973,8959.849231407688,109.26645404155718,0
4588,33.83714317463833,0,0,201,0.0,0.0,1.0,201,6050,4400,1650,0.7272727272727273,77,44,33,210.50507288623683,0.4352363184079602,0.7810071363708435,0.13920294507093578,1148915.9569697417,2120.527452415199,1151036.4844221568,4586,4,1619.592039800995,70,131,43,33.921667980332515,0.643154761904762,39.40727699530516,8817.713278578718,125.96733255112454,0
4589,33.429578714677355,0,1,200,0.0,0.004975124378109453,0.9950248756218906,201,5150,3200,1950,0.6213592233009708,71,32,39,207.25526787203077,0.43524564676616917,0.777833250124812,0.13791770815537494,1136947.3831981602,1777.6668922279741,1138725.0500903882,4587,5,1620.592039800995,71,130,44,33.78733982359794,0.644806338028169,39.19270833333334,8718.677886132673,122.79828008637567,0
4590,33.65440691436234,0,1,199,0.0,0.005,0.995,200,6050,4000,2050,0.6611570247933884,81,40,41,206.03200457340904,0.43496440536013403,0.7754618538901474,0.13745850153936542,1145366.186251299,1146.4182647912012,1146512.6045160901,4588,6,1619.6,73,127,43,33.729452177979226,0.6446917808219178,39.10472972972974,8780.275587708242,120.27774777682524,0
4591,33.75973044989825,0,2,197,0.0,0.010050251256281407,0.9899497487437185,199,5800,4500,1300,0.7758620689655172,71,45,26,200.73335022262262,0.43488591949647226,0.7725524097215077,0.12643451292104363,1131412.5342379287,-177.55430371063903,1131234.979934218,4589,7,1628.3065326633166,73,126,46,35.906689502682305,0.6244292237442922,41.1036036036036,8740.27255679235,119.72976105194999,8
4592,33.9888257430932,0,0,197,0.0,0.0,1.0,197,5850,4600,1250,0.7863247863247863,71,46,25,204.7762670958992,0.43471049587347627,0.7664919394243672,0.12965483865452013,1140714.3369286587,1468.2447478052081,1142182.5816764638,4590,8,1643.527918781726,84,113,38,35.61375605064409,0.6216517857142857,40.91911764705884,8805.854963660995,104.83160671024994,8
4593,33.561677447460895,2,0,199,0.010050251256281407,0.0,1.0,199,5550,3500,2050,0.6306306306306306,76,35,41,201.38856824647132,0.43575410723651925,0.7685589305961116,0.12287933495680399,1114888.1816029178,-444.8530704153677,1114443.3285325025,4591,0,1628.0,82,117,41,37.053064238647096,0.6089939024390244,42.243975903614455,8650.724540862839,105.49664074222974,8
4594,33.66662292429993,1,1,199,0.005,0.005,0.995,200,5000,3400,1600,0.68,66,34,32,200.47385596868344,0.4362657035175879,0.7691312612869503,0.12269839666355527,1119343.222887347,-120.18959107207547,1119223.033296275,4592,0,1620.855,84,116,41,36.96278078763107,0.609375,42.132352941176464,8681.532837905856,103.35158140364113,0
4595,33.25899116056464,0,0,199,0.0,0.0,1.0,199,5850,4500,1350,0.7692307692307693,72,45,27,201.26607274840475,0.43614114342757554,0.7692786975256334,0.12351751694909383,1106631.3234936746,-1104.5319080117897,1105526.7915856629,4593,1,1629.9497487437186,84,115,38,36.84233966745842,0.6103670634920635,42.03431372549019,8579.678479532906,102.13902951824888,0
4596,32.82980965532624,0,1,198,0.0,0.005025125628140704,0.9949748743718593,199,4500,3200,1300,0.7111111111111111,58,32,26,199.01073591613616,0.4360512579733686,0.766142136272145,0.12238743918390652,1092986.7418373227,-796.78083207493,1092189.961005248,4594,2,1630.9497487437186,88,111,40,36.82398209884943,0.6097301136363636,41.95926966292134,8471.428060287644,96.26622795781414,0
4597,32.72360743388528,1,0,199,0.005025125628140704,0.0,1.0,199,4650,2700,1950,0.5806451612903226,66,27,39,199.35822213188902,0.4360195336954131,0.7686283717002498,0.12324807161066789,1091052.4180406872,-947.9459373421355,1090104.472103345,4595,0,1631.8743718592964,90,109,41,36.621655067452735,0.6109953703703703,41.769688644688635,8450.227336321152,93.8914148480128,0
4598,32.33646374687952,0,0,199,0.0,0.0,1.0,199,5400,3900,1500,0.7222222222222222,69,39,30,196.74458750052705,0.43593493562086527,0.7667500718172477,0.12203017323388321,1079124.1227883447,-2737.6339200276307,1076386.488868317,4596,1,1632.8743718592964,72,127,41,36.56954800699624,0.6193576388888888,41.652397260273986,8354.047890086407,116.02844291786677,0
4599,32.47353994902513,2,0,201,0.009950248756218905,0.0,1.0,201,5650,3700,1950,0.6548672566371682,76,37,39,192.51805816278335,0.4367910447761194,0.7643199322760692,0.12014069359050372,1085534.4399017692,-4053.003512257091,1081481.4363895121,4597,0,1617.6169154228855,75,126,42,36.45579335630355,0.6201388888888889,41.433662280701775,8396.564297400804,111.95419063201072,0
4600,32.5673128476796,0,1,200,0.0,0.004975124378109453,0.9950248756218906,201,5050,3900,1150,0.7722772277227723,62,39,23,190.7328532181503,0.43698072139303484,0.7619844701725009,0.11927423856234881,1089293.6302951449,-3697.1835802896967,1085596.4467148553,4598,1,1618.6169154228855,77,124,43,36.42638465775117,0.6199945887445888,41.35950854700857,8423.225800227237,109.392542860094,0
4601,32.5785226298184,0,0,200,0.0,0.0,1.0,200,5600,4100,1500,0.7321428571428571,71,41,30,190.8021552592983,0.43693833752093797,0.7601883697813108,0.11966768590452313,1090548.1348180862,-3984.2130925400693,1086563.921725546,4599,2,1623.29,80,120,43,36.3182364148443,0.6197916666666667,41.25514403292183,8429.525145472602,105.36906431840752,0
4602,32.1981446693267,0,0,200,0.0,0.0,1.0,200,6500,4900,1600,0.7538461538461538,81,49,32,189.6851823264809,0.4370854271356784,0.7586298513321226,0.11950459663048027,1079149.6117899143,-5560.261826015429,1073589.3499638988,4600,3,1624.29,81,119,47,36.183976497718504,0.6210133744855967,41.09502032520328,8336.25999117826,102.91679001454642,0
4603,32.19476242684548,3,1,202,0.014778325123152709,0.0049261083743842365,0.9950738916256158,203,5350,4000,1350,0.7476635514018691,67,40,27,186.02492885462107,0.4376402233819441,0.7577535073743109,0.11801343863848875,1081080.347971764,-5728.421036484508,1075351.9269352795,4601,0,1601.270935960591,87,116,44,36.02906751016307,0.6212883141762452,40.849905303030326,8343.27573166351,95.89972105360357,0
4604,32.5676020633036,0,0,202,0.0,0.0,1.0,202,5050,3400,1650,0.6732673267326733,67,34,33,189.2669023239211,0.4370443574208167,0.7618033746017754,0.12027181158123135,1094099.6514320015,-4034.6296279565354,1090065.021804045,4602,1,1610.1980198019803,87,115,44,35.884745943312936,0.6218869731800767,40.7907196969697,8441.82469202443,97.03246772441872,0
4605,32.3666568700553,0,0,202,0.0,0.0,1.0,202,4300,3100,1200,0.7209302325581395,55,31,24,189.68370836927974,0.4368893978950134,0.7609795743181766,0.12086934024442508,1088163.231767804,-3418.6325774364022,1084744.5991903674,4603,2,1611.1980198019803,90,112,44,35.775062905575396,0.621875,40.69368131868133,8392.878640995485,93.25420712217205,0
4606,32.19111801608134,0,0,202,0.0,0.0,1.0,202,5700,3800,1900,0.6666666666666666,76,38,38,193.43387656783082,0.43631573978293353,0.7652109620445058,0.12384740002691205,1083657.9095232254,-4176.769937506492,1079481.139585719,4604,3,1612.1980198019803,73,129,42,35.50736676974268,0.6302796803652968,40.526463963963934,8352.743220585897,114.42114000802599,0
4607,31.895426104406347,0,0,202,0.0,0.0,1.0,202,6000,4300,1700,0.7166666666666667,77,43,34,193.42954442925864,0.4362736646799008,0.7643780579175243,0.12438366197949323,1074962.2084722533,-4814.109947308787,1070148.0985249444,4605,4,1613.1980198019803,78,124,42,35.352547824614845,0.6295405982905983,40.37447257383964,8280.866824838566,106.16495929280212,0
4608,31.422123024489967,0,0,202,0.0,0.0,1.0,202,5500,3800,1700,0.6909090909090909,72,38,34,192.21149887266094,0.435924749191337,0.7628080580335288,0.1241263515737761,1060219.442264115,-5142.726373696011,1055076.715890419,4606,5,1614.1980198019803,80,122,42,35.233188943894376,0.6302083333333333,40.22633744855964,8162.639983213621,102.03299979017027,0
4609,31.186364077522523,1,0,203,0.0049261083743842365,0.0,1.0,203,6200,4600,1600,0.7419354838709677,78,46,32,191.52238143927173,0.43604797671885415,0.76354053990302,0.12443482725511433,1053975.5049519714,-6428.020262588216,1047547.4846893832,4607,0,1607.2413793103449,81,122,39,35.03595393986775,0.6319444444444444,40.015243902438996,8107.979258264358,100.09850936128836,0
4610,30.921106501423147,2,0,205,0.00975609756097561,0.0,1.0,205,5650,4600,1050,0.8141592920353983,67,46,21,189.15420840060662,0.43673880121154157,0.76294418030544,0.12352822262805116,1046438.6657395697,-7062.344508449223,1039376.3212311205,4608,0,1592.551219512195,85,120,42,34.91661428992661,0.6322303921568627,39.83769379844959,8044.506377713941,94.64125150251695,0
4611,30.68229010262469,2,0,207,0.00966183574879227,0.0,1.0,207,5250,3700,1550,0.7047619047619048,68,37,31,191.04095121558245,0.43721565592608225,0.7665058125330715,0.1257370501491373,1040502.0018682597,-6894.301564274258,1033607.7003039855,4609,0,1578.1545893719806,72,135,43,34.593766551604475,0.6404803240740741,39.56906392694062,7990.61753229167,110.98079905960653,0
4612,31.17217773291424,0,0,207,0.0,0.0,1.0,207,5750,4200,1550,0.7304347826086957,73,42,31,187.85598364987874,0.43701925331832464,0.765132450981725,0.12017018193586969,1049107.1823001916,-7733.787662969004,1041373.3946372226,4610,1,1579.1545893719806,76,131,39,35.683574060555486,0.6285635964912281,40.557359307359306,8087.392107167605,106.41305404167902,8
4613,31.49653621286705,0,1,206,0.0,0.004830917874396135,0.9951690821256038,207,6100,4300,1800,0.7049180327868853,79,43,36,187.00058027382167,0.43685998155183464,0.7628415093946346,0.11997047205014831,1060854.1832858166,-7823.930427928031,1053030.2528578886,4611,2,1580.1545893719806,79,128,40,35.60223624140872,0.6282964135021096,40.455729166666686,8174.745525144305,103.47779145752286,0
4614,31.807728772222763,0,0,206,0.0,0.0,1.0,206,6300,4800,1500,0.7619047619047619,78,48,30,186.59720972269534,0.4360959823190465,0.760722360496267,0.12008964001045036,1072245.607661043,-7484.392294606549,1064761.2153664364,4612,3,1588.8106796116506,81,125,41,35.500448467058085,0.6286008230452675,40.345528455284565,8259.01900538917,101.96319759739715,0
4615,32.17976270898933,0,0,206,0.0,0.0,1.0,206,5450,3700,1750,0.6788990825688074,72,37,35,187.19923092648054,0.4356963848764701,0.7624098703859798,0.12081267485143098,1085597.88903546,-6005.382015429977,1079592.5070200302,4613,4,1589.8106796116506,82,124,40,35.38596575993302,0.6291920731707317,40.248493975903635,8358.741827158086,101.93587594095227,0
4616,32.39218216557544,0,0,206,0.0,0.0,1.0,206,4950,2800,2150,0.5656565656565656,71,28,43,184.21722875805966,0.43544330649617174,0.7590343526411532,0.11921210041372443,1093561.0955710895,-5859.441099253087,1087701.6544718365,4614,5,1590.8106796116506,83,123,44,35.366954598962856,0.6297690763052208,40.153769841269856,8416.986422339665,101.40947496794777,0
4617,32.867320143029,0,1,205,0.0,0.0048543689320388345,0.9951456310679612,206,6100,4800,1300,0.7868852459016393,74,48,26,182.65405395424918,0.435448733128108,0.7573539933176392,0.11859404364397977,1110588.031041474,-6729.318771441191,1103858.7122700328,4615,6,1591.8106796116506,86,120,44,35.290008597396216,0.6298449612403101,40.03831417624523,8544.243952890929,99.35167387082475,0
4618,32.63795382588583,0,0,205,0.0,0.0,1.0,205,5650,4200,1450,0.7433628318584071,71,42,29,181.6126644485819,0.4350510122748286,0.7552850020212913,0.1182442167812713,1103650.5867785627,-6562.615262980693,1097087.971515582,4616,7,1597.8292682926829,86,119,39,35.21955570902395,0.6308139534883721,39.942528735632195,8487.743739203092,98.69469464189642,0
4619,32.25457422366003,0,0,205,0.0,0.0,1.0,205,5550,3500,2050,0.6306306306306306,76,35,41,181.67067290244478,0.4346186035389766,0.755370896955778,0.1187284184897238,1091779.5075285889,-6881.136441236018,1084898.3710873527,4617,8,1598.8292682926829,90,115,39,35.08542308256344,0.630787037037037,39.81227106227108,8392.244415107569,93.24716016786188,0
4620,32.60991298540736,0,0,205,0.0,0.0,1.0,205,4850,3400,1450,0.7010309278350515,63,34,29,181.42358415732215,0.434644508209788,0.755198945422906,0.11893096395576952,1104704.5760424417,-5766.107275876839,1098938.4687665647,4618,9,1599.8292682926829,92,113,40,34.9842039961559,0.6312273550724637,39.70654121863801,8488.147041530978,92.26246784272801,0
4621,32.55768336580391,1,0,206,0.0048543689320388345,0.0,1.0,206,5800,4000,1800,0.6896551724137931,76,40,36,182.34839162422062,0.4350303891388429,0.7584209639280299,0.12044624478027918,1105141.995924241,-6695.8269053668355,1098446.1690188742,4619,0,1593.0582524271845,75,131,38,34.69511660529548,0.6402777777777777,39.44627192982456,8483.025778288544,113.10701037718059,0
4622,32.217984210004516,0,0,206,0.0,0.0,1.0,206,5450,3700,1750,0.6788990825688074,72,37,35,183.38467713350406,0.4347264977504144,0.7597364454493059,0.12170074027950743,1094959.4250963929,-6490.243870882092,1088469.1812255108,4620,1,1594.0582524271845,76,130,42,34.50461377473364,0.6414473684210527,39.28571428571429,8399.688740465479,110.52222026928261,0
4623,32.416440740488746,0,0,206,0.0,0.0,1.0,206,5750,4300,1450,0.7478260869565218,72,43,29,181.3948862429869,0.43438807324966455,0.7573210392680991,0.12091998907127811,1102993.245846755,-6934.533128568921,1096058.7127181862,4621,2,1595.0582524271845,80,126,42,34.40124065401363,0.6412760416666667,39.1332304526749,8456.37217619361,105.70465220242014,0
4624,32.689922538597834,1,0,207,0.004830917874396135,0.0,1.0,207,6500,4400,2100,0.676923076923077,86,44,42,191.5298751931127,0.434717141159733,0.7681891940525725,0.12353744820216217,1102640.4733066787,-5662.2815529397685,1096978.191753739,4622,0,1588.3478260869565,72,135,47,35.293626158297585,0.6333912037037037,40.268264840182624,8490.610303189982,117.92514309986086,8
4625,32.801537174734406,0,0,207,0.0,0.0,1.0,207,5050,3300,1750,0.6534653465346535,68,33,35,192.88980247119866,0.43437710082391384,0.7692500766935333,0.12477809213800727,1107271.0121386845,-3733.742637297224,1103537.2695013874,4623,1,1589.3478260869565,74,133,51,35.1547466324567,0.6334459459459459,40.16666666666665,8522.93274256845,115.17476679146553,0
4626,32.734531203238404,0,0,207,0.0,0.0,1.0,207,6750,4800,1950,0.7111111111111111,87,48,39,195.34742673507668,0.43444452261463656,0.770887420990942,0.1266452394248627,1105657.3810449832,-4952.535152443901,1100704.8458925392,4624,2,1590.3478260869565,75,132,47,35.01319455430752,0.63375,40.090460526315766,8508.016929920579,113.44022573227438,0
4627,32.25754985726779,0,0,207,0.0,0.0,1.0,207,6000,4400,1600,0.7333333333333333,76,44,32,197.5066535929415,0.4341973093819865,0.772860513759557,0.1284386955729638,1090439.5957755893,-4326.184898625127,1086113.4108769642,4625,3,1591.3478260869565,77,130,37,34.84848484848484,0.6339285714285714,39.98397435897432,8387.479910803915,108.92831052992098,0
4628,32.622679614291066,0,0,207,0.0,0.0,1.0,207,5750,4200,1550,0.7304347826086957,73,42,31,198.18751743218326,0.4341210934446477,0.7737598901331699,0.1292444679796577,1103608.5991620657,-3405.710303052581,1100202.888859013,4626,4,1592.3478260869565,78,129,38,34.73148054274176,0.6344818376068376,39.88660337552739,8485.596001465103,108.78969232647567,0
4629,32.31690387280519,0,1,206,0.0,0.004830917874396135,0.9951690821256038,207,5750,4000,1750,0.6956521739130435,75,40,35,201.21625200929515,0.4337458765223645,0.7781361874634924,0.1318292907706906,1094610.0889217209,-3099.3320991223654,1091510.7568225984,4627,5,1593.3478260869565,79,128,41,34.48943794086745,0.6356803797468354,39.72656249999997,8411.231660332,106.47128683964556,0
4630,32.093292201331685,0,0,206,0.0,0.0,1.0,206,5850,4000,1850,0.6837606837606838,77,40,37,188.34857729046485,0.43320161417633596,0.7601659054568588,0.12306485519751487,1086255.1298132143,-6131.07834504257,1080124.0514681716,4628,6,1601.9126213592233,87,119,40,34.919623900515575,0.6317049808429118,39.820075757575744,8350.030333632425,95.97736015669454,8
4631,31.70197410126542,0,0,206,0.0,0.0,1.0,206,6800,5100,1700,0.75,85,51,34,201.40305229250134,0.43286318967558607,0.7781192874842577,0.12600871596310986,1060493.8898718096,-5282.658728453836,1055211.2311433558,4629,7,1602.9126213592233,76,130,41,36.132540097629004,0.6206140350877193,41.34199134199135,8199.969491561105,107.8943354152777,8
4632,31.922572110091767,0,1,205,0.0,0.0048543689320388345,0.9951456310679612,206,6350,4800,1550,0.7559055118110236,79,48,31,201.66406314901093,0.43271124398137184,0.7770893522394975,0.12659101677269274,1068848.1549883264,-4440.347635145978,1064407.8073531804,4630,8,1603.9126213592233,79,127,40,36.00537553252158,0.6205168776371308,41.22395833333334,8260.796850468298,104.56704874010504,0
4633,32.16824557336339,0,0,205,0.0,0.0,1.0,205,6000,4800,1200,0.8,72,48,24,203.28932454656652,0.43228220149848556,0.7757447386928431,0.12832288810089995,1078717.3785920998,-3141.654545873602,1075575.7240462261,4631,9,1612.5756097560975,82,123,35,35.76195380017773,0.6213160569105691,41.02660642570283,8330.719721465328,101.59414294469912,0
4634,32.12256250791314,0,0,205,0.0,0.0,1.0,205,5500,4000,1500,0.7272727272727273,70,40,30,203.09915835307518,0.4319733381157341,0.7757974811224269,0.12858023079734748,1078050.6936588585,-2709.7622911870894,1075340.9313676714,4632,10,1613.5756097560975,83,122,35,35.660779245644285,0.6219879518072289,40.922619047619065,8322.229364029326,100.26782366300394,0
4635,32.59192250720833,1,1,205,0.0048543689320388345,0.0048543689320388345,0.9951456310679612,206,6700,5100,1600,0.7611940298507462,83,51,32,203.1565702796373,0.4323116465387955,0.7759122055617551,0.12927179553354542,1095316.7326999228,-3395.841842956891,1091920.890856966,4633,0,1606.7378640776699,87,119,36,35.476402459440536,0.6223659003831418,40.743371212121225,8449.671954934662,97.12266614867427,0
4636,32.27793259362841,2,0,207,0.00966183574879227,0.0,1.0,207,5800,4100,1700,0.7068965517241379,75,41,34,201.60064464892196,0.4327697262479871,0.7764205285178769,0.1291225520732191,1086685.693233544,-3384.692742671463,1083301.0004908727,4634,0,1599.5458937198068,74,133,38,35.28263216114469,0.6299268018018018,40.51388888888888,8375.675203427198,113.18480004631348,0
4637,32.034098936791295,1,1,207,0.004807692307692308,0.004807692307692308,0.9951923076923077,208,5400,3500,1900,0.6481481481481481,73,35,38,200.08109510507964,0.4329647242351047,0.7766569164165662,0.128596403881415,1079490.1264188301,-3802.8866702001174,1075687.23974863,4635,0,1592.8509615384614,75,133,40,35.19773023247629,0.6306944444444444,40.391995614035075,8316.308497282915,110.88411329710553,0
4638,32.2686380544578,1,0,208,0.004807692307692308,0.0,1.0,208,5850,4500,1350,0.7692307692307693,72,45,27,198.7291051848939,0.43275133934101323,0.7746060244632806,0.12842110723050013,1088976.9971876044,-4167.715156395077,1084809.2820312094,4636,0,1592.2259615384614,78,130,40,35.04013771168519,0.6312767094017093,40.203059071729946,8383.293454469667,107.47812121114958,0
4639,31.943668617128697,0,3,205,0.0,0.014423076923076924,0.9855769230769231,208,5900,4300,1600,0.7288135593220338,75,43,32,208.19322811692004,0.4323119890375325,0.7893473499875223,0.13023367852604287,1068526.2681568076,-3008.0133809415443,1065518.2547758662,4637,1,1593.2259615384614,71,137,45,35.96342804937166,0.6229460093896714,41.34837962962964,8262.281648394512,116.37016406189453,7
4640,32.02669946580205,0,1,204,0.0,0.004878048780487805,0.9951219512195122,205,5550,4000,1550,0.7207207207207207,71,40,31,207.58862628880763,0.43072393591582975,0.7860389166789374,0.13049340415631827,1072748.7950329306,-2011.9102572280322,1070736.8847757026,4638,2,1617.5024390243902,73,132,43,35.80105282717863,0.6237157534246576,41.17398648648649,8289.342948728927,113.55264313327297,0
4641,31.653725231228645,1,0,205,0.004878048780487805,0.0,1.0,205,4600,3000,1600,0.6521739130434783,62,30,32,194.54345542197956,0.4303523035230352,0.7651129271520574,0.12157391987697169,1058536.5367130616,-4413.728891485172,1054122.8078215765,4639,0,1618.4878048780488,69,136,49,36.3527221550914,0.6236413043478262,41.38392857142857,8186.162065379796,118.64002993304052,8
4642,31.986324326130386,0,0,205,0.0,0.0,1.0,205,5600,4100,1500,0.7321428571428571,71,41,30,194.9329725310938,0.43031842818428184,0.7651626352491809,0.12236446718073368,1070979.787028714,-4846.145318754856,1066133.6417099591,4640,1,1619.4878048780488,72,133,50,36.17992372024632,0.6236979166666667,41.22431506849316,8277.282985935737,114.9622636935519,0
4643,32.14663555610505,2,1,206,0.00966183574879227,0.004830917874396135,0.9951690821256038,207,5350,3800,1550,0.7102803738317757,69,38,31,188.32335136830883,0.4315629739067899,0.7583465955177613,0.1188162686846468,1077844.8187425334,-6153.330295887514,1071691.488446646,4641,0,1604.8309178743962,76,131,52,36.16763312785152,0.6236293859649122,41.044372294372316,8324.552189055279,109.53358143493789,0
4644,32.17732129012174,0,1,205,0.0,0.0048543689320388345,0.9951456310679612,206,4500,3300,1200,0.7333333333333333,57,33,24,201.69225312707766,0.43126578656563264,0.7739320235391778,0.12254702884638749,1067630.805616356,-2633.4274614724363,1064997.3781548836,4642,1,1613.5291262135922,76,130,44,37.20153695340124,0.6099232456140351,42.39718614718612,8288.968506581348,109.06537508659669,8
4645,31.855850213433982,1,0,206,0.0048543689320388345,0.0,1.0,206,5350,3200,2150,0.5981308411214953,75,32,43,203.49907127091222,0.43143598547635964,0.7770657097760396,0.12422324711167347,1058356.9256627734,-3475.0697108979834,1054881.8559518754,4643,0,1614.5194174757282,77,129,42,36.98191897212722,0.6112012987012987,42.227564102564074,8211.56010710066,106.64363775455404,0
4646,31.742681592413792,1,0,207,0.004830917874396135,0.0,1.0,207,6100,4400,1700,0.7213114754098361,78,44,34,202.9320519636438,0.43159424198364676,0.777643149539625,0.12466878328437939,1056484.8972350482,-4621.0703870987,1051863.8268479495,4644,0,1607.7149758454107,81,126,36,36.76124240932215,0.6118827160493827,41.99695121951218,8189.70862731098,101.10751391741951,0
4647,32.19284645745549,0,0,207,0.0,0.0,1.0,207,6500,4900,1600,0.7538461538461538,81,49,32,201.76902848308004,0.43158642496443256,0.7751671563343272,0.12448677012288342,1072751.9561512016,-4610.3760008099125,1068141.5801503917,4645,1,1608.7149758454107,82,125,37,36.633548047318044,0.6130589430894309,41.842369477911625,8310.82896121806,101.35157269778122,0
4648,31.704287923901198,0,0,207,0.0,0.0,1.0,207,5850,4300,1550,0.7350427350427351,74,43,31,202.99022442865737,0.43134996013320204,0.7777239098916362,0.12563932393051175,1057408.645264155,-4321.276357005734,1053087.3689071492,4646,2,1609.7149758454107,84,123,38,36.48527085804667,0.6134672619047619,41.727941176470566,8188.331715639861,97.4801394719031,0
4649,31.35190547569858,2,1,208,0.009569377990430622,0.004784688995215311,0.9952153110047847,209,5650,4000,1650,0.7079646017699115,73,40,33,201.0199909605988,0.432196778002699,0.777989753088576,0.12507380732048667,1047178.4617204737,-5349.239018163233,1041829.2227023105,4647,0,1595.3014354066986,73,136,39,36.3444143383621,0.6200057077625571,41.539977477477485,8103.214195373068,111.0029341831927,0
4650,30.99021555981963,1,1,208,0.004784688995215311,0.004784688995215311,0.9952153110047847,209,6400,4800,1600,0.75,80,48,32,201.17548249137656,0.43199070666175926,0.7778227167367249,0.1257363424686913,1036388.8208022234,-6500.795785288688,1029888.0250169347,4648,0,1594.8277511961724,75,134,39,36.17601400886816,0.6206944444444444,41.378837719298254,8014.725567410061,106.86300756546747,0
4651,30.75874045738989,1,0,209,0.004784688995215311,0.0,1.0,209,6650,4600,2050,0.6917293233082706,87,46,41,199.79868887162112,0.432118183351736,0.7755793647001679,0.12553292782241385,1030134.6649669912,-7286.088915677403,1022848.5760513138,4649,0,1591.401913875598,78,131,39,36.021032878201204,0.6212606837606838,41.19198312236289,7960.60861943108,102.05908486450103,0
4652,30.696216301192578,1,0,210,0.004761904761904762,0.0,1.0,210,6150,4500,1650,0.7317073170731707,78,45,33,201.41846366118597,0.4324680071390598,0.7775196767550658,0.12729116023219247,1029685.0467186916,-6670.483967004601,1023014.562751687,4650,0,1584.8190476190475,80,130,36,35.76804362577166,0.6225260416666667,40.98508230452677,7950.777938815894,99.38472423519868,0
4653,30.63538150036387,1,0,211,0.004739336492890996,0.0,1.0,211,5800,4000,1800,0.6896551724137931,76,40,36,198.049028425585,0.432518054615211,0.7745406599148457,0.12564749836180633,1028730.7195509864,-7252.17609627456,1021478.5434547119,4651,0,1578.303317535545,83,128,37,35.71573834816729,0.6227409638554218,40.848214285714306,7939.213821857744,95.65317857659932,0
4654,30.875597311654797,0,2,209,0.0,0.009478672985781991,0.990521327014218,211,5500,4100,1400,0.7454545454545455,69,41,28,200.86747564458557,0.4323356277740164,0.7796925185913157,0.1279476151647548,1037927.9231073998,-6002.807636877555,1031925.1154705223,4652,1,1579.303317535545,88,123,39,35.49857437332614,0.6223958333333333,40.70692883895133,8005.828450870837,90.97532330535041,0
4655,30.496813236870533,0,0,209,0.0,0.0,1.0,209,5750,4200,1550,0.7304347826086957,73,42,31,205.15045274598003,0.4313351122561649,0.7818914310181524,0.13076517478730335,1025384.801681298,-5478.36873924671,1019906.4329420512,4653,2,1595.3732057416269,89,120,40,35.36296771553969,0.6223080524344569,40.68287037037039,7908.34607143621,88.85782102737315,0
4656,30.763896792667136,0,0,209,0.0,0.0,1.0,209,6750,5000,1750,0.7407407407407407,85,50,35,204.7183436187484,0.4309018832045148,0.7809399633041445,0.13086210040062046,1035163.5816711369,-6166.605237167129,1028996.9764339698,4654,3,1596.3732057416269,73,136,36,35.27202371262685,0.629708904109589,40.582770270270245,7980.684881644968,109.32445043349271,0
4657,31.19437890193031,1,0,210,0.004761904761904762,0.0,1.0,210,6850,5000,1850,0.7299270072992701,87,50,37,199.51160905741156,0.43141518569150145,0.7754706758770158,0.12819792947527114,1051121.453234309,-6907.813510091672,1044213.6397242175,4655,0,1589.7666666666667,78,132,41,35.221539347148855,0.6292735042735043,40.40084388185653,8098.034438570702,103.82095434065003,0
4658,31.709492926286106,0,0,210,0.0,0.0,1.0,210,5750,4000,1750,0.6956521739130435,75,40,35,193.57444233441726,0.43110475051264524,0.7678122732653618,0.12507115522850712,1070063.9515150029,-6322.593464664024,1063741.358050339,4656,1,1590.7666666666667,84,126,42,35.1794306335205,0.628844246031746,40.20833333333334,8237.862016474763,98.06978591041384,0
4659,31.271634727751074,0,0,210,0.0,0.0,1.0,210,6100,3700,2400,0.6065573770491803,85,37,48,193.81370824827934,0.4310525366446419,0.7660411213510738,0.1259193887487291,1056848.0314623865,-7133.672793476005,1049714.3586689106,4657,2,1591.7666666666667,88,122,35,34.97754693197675,0.6293797348484849,40.016385767790275,8130.112619470247,92.387643403071,0
4660,31.593316461374428,0,0,210,0.0,0.0,1.0,210,5950,4100,1850,0.6890756302521008,78,41,37,193.18918776443604,0.4311094972279183,0.7657182286108566,0.12589589825517025,1068584.8907804824,-6662.190578553914,1061922.7002019286,4658,3,1592.7666666666667,88,122,35,34.88641136411364,0.6304450757575757,39.91104868913858,8217.072546871066,93.37582439626212,0
4661,31.944549672651146,0,1,209,0.0,0.004761904761904762,0.9952380952380953,210,5100,3800,1300,0.7450980392156863,64,38,26,198.04045289295297,0.4309490582516898,0.7719154505398944,0.12945125869636098,1081340.0601851947,-4270.184949926179,1077069.8752352686,4659,4,1593.7666666666667,88,122,38,34.65281213920506,0.6315104166666667,39.805711610486895,8311.789369998925,94.45215193180597,0
4662,31.91576931750292,0,2,207,0.0,0.009569377990430622,0.9904306220095693,209,5400,4300,1100,0.7962962962962963,65,43,22,200.50156382598237,0.4307427769598822,0.7739041879114996,0.13128940489781754,1080866.979716346,-3856.896055801106,1077010.0836605448,4660,5,1602.153110047847,89,120,39,34.5272243470011,0.6317883895131087,39.74537037037038,8306.226723071448,93.3283901468702,0
4663,31.442996405599125,1,0,208,0.004807692307692308,0.0,1.0,208,6000,4400,1600,0.7333333333333333,76,44,32,198.90610247013706,0.4301278180354267,0.7714025577903725,0.13077213927718734,1065994.8801567587,-5193.4226269795545,1060801.457529779,4661,0,1610.6682692307693,90,118,41,34.42683605884766,0.6328703703703704,39.60622710622711,8187.560465139304,90.97289405710337,0
4664,31.700068676930567,0,0,208,0.0,0.0,1.0,208,6050,4200,1850,0.6942148760330579,79,42,37,199.08428445047025,0.4300407221602874,0.7703179889462002,0.13167458258399564,1076404.6327756038,-4790.95078093958,1071613.6819946642,4662,1,1611.6682692307693,79,129,39,34.21292595183374,0.6389767932489452,39.401041666666664,8261.004876303225,104.56968197852183,0
4665,31.33306904824129,0,1,207,0.0,0.004807692307692308,0.9951923076923077,208,5800,4200,1600,0.7241379310344828,74,42,32,198.76916296254188,0.42966766149510716,0.7703975383298405,0.1320543187871517,1065188.6526388833,-5054.668623554379,1060133.984015329,4663,2,1612.6682692307693,83,125,39,34.06557640176914,0.6389307228915663,39.24851190476189,8170.144380919726,98.43547446891236,0
4666,31.00483021253514,0,0,207,0.0,0.0,1.0,207,5800,4400,1400,0.7586206896551724,72,44,28,201.23421585211568,0.4293869111830277,0.773544896991327,0.13408177796798382,1054832.1455588534,-4746.336066571878,1050085.8094922816,4664,3,1620.888888888889,83,124,42,33.90009706045477,0.6399347389558233,39.14930555555555,8087.631492071873,97.44134327797438,0
4667,31.068874089833578,0,0,207,0.0,0.0,1.0,207,6000,4300,1700,0.7166666666666667,77,43,34,201.2483465757567,0.4293380548129387,0.7731596073303031,0.13469489428937392,1058248.5713761966,-4805.844948876774,1053442.7264273197,4665,4,1621.888888888889,86,121,43,33.74399819563591,0.6403827519379846,38.99664750957854,8109.080295549333,94.29163134359689,0
4668,31.54645811698292,0,0,207,0.0,0.0,1.0,207,7000,4900,2100,0.7,91,49,42,206.31613367947367,0.42925695323859103,0.7787428603370135,0.13877679557873981,1075906.1148326446,-4004.642037125146,1071901.4727955195,4666,5,1622.888888888889,90,117,36,33.43943577606358,0.6407407407407407,38.82783882783882,8239.056643739466,91.5450738193274,0
4669,31.275291812836336,0,2,205,0.0,0.00966183574879227,0.9903381642512077,207,6000,4500,1500,0.75,75,45,30,208.91782777455342,0.4290068086237356,0.7814569616966378,0.1411720609399178,1067920.993817526,-2778.453147360342,1065142.5406701656,4667,6,1623.888888888889,94,113,37,33.21366382746609,0.6410682624113475,38.67324561403507,8173.070501922406,86.94755853108943,0
4670,30.989398271441967,0,0,205,0.0,0.0,1.0,205,5350,4100,1250,0.7663551401869159,66,41,25,205.98908389327016,0.42835664753706365,0.7767671505173828,0.13960462857176312,1058963.7455362317,-2723.0056361614843,1056240.7399000702,4668,7,1638.8048780487804,96,109,37,33.18879053017854,0.6414930555555556,38.57388316151201,8101.438053264367,84.38997972150382,0
4671,31.445417970432036,0,0,205,0.0,0.0,1.0,205,6500,5200,1300,0.8,78,52,26,206.07726384762046,0.42807269249163077,0.7737885182833457,0.14046811408402538,1076129.5983312058,-3146.8313660933345,1072982.7669651124,4669,8,1639.8048780487804,77,128,36,32.99004594180707,0.6501623376623377,38.38141025641026,8226.705903322174,106.84033640678147,0
4672,31.46882656010695,0,1,204,0.0,0.004878048780487805,0.9951219512195122,205,5050,3000,2050,0.594059405940594,71,30,41,203.18658496001567,0.4279720628088634,0.7713523979890211,0.13909172705607706,1078108.4191777771,-2238.566418125286,1075869.8527596518,4670,9,1640.8048780487804,78,127,38,32.9197519981194,0.6511752136752137,38.23839662447258,8237.33049671999,105.60680123999987,0
4673,31.306742394905037,0,0,204,0.0,0.0,1.0,204,5400,4100,1300,0.7592592592592593,67,41,26,202.91783141815955,0.42752855452525834,0.7717417917270111,0.1394033569628531,1073528.2024706039,-2632.397037685895,1070895.805432918,4671,10,1648.3578431372548,78,126,39,32.805708003960845,0.6523771367521367,38.11972573839664,8198.618284615135,105.11049082839916,0
4674,31.804243583099375,0,0,204,0.0,0.0,1.0,204,5150,3600,1550,0.6990291262135923,67,36,31,204.22198419819026,0.42728255095141504,0.773545004482906,0.14071733979683537,1091411.6569982094,-1371.949166158196,1090039.7078320512,4672,11,1649.3578431372548,79,125,39,32.6706428098078,0.6529535864978904,38.020833333333336,8332.049230364064,105.46897759954511,0
4675,31.981936600887835,0,0,204,0.0,0.0,1.0,204,6700,4400,2300,0.6567164179104478,90,44,46,205.27884445121913,0.4270249766573296,0.7736934289234247,0.14197557775919406,1098548.7258273086,-2398.2373977621164,1096150.4884295466,4673,12,1650.3578431372548,83,121,35,32.51640171587183,0.6526104417670683,37.8968253968254,8382.567113050169,100.99478449458034,0
4676,31.66133636159264,0,0,204,0.0,0.0,1.0,204,4650,3100,1550,0.6666666666666666,62,31,31,203.0001501794924,0.4267543224186226,0.7714588445439621,0.14079923905592645,1088316.7458334006,-1264.3074305927003,1087052.438402808,4674,13,1651.3578431372548,85,119,37,32.480203184428944,0.6528186274509804,37.802810077519375,8301.513423200033,97.66486380235332,0
4677,31.344640934617658,0,0,204,0.0,0.0,1.0,204,7050,5400,1650,0.7659574468085106,87,54,33,202.20139271020707,0.42679305917769406,0.7721932010925394,0.14077866992934054,1078460.394430974,-4236.761252651493,1074223.6331783226,4675,14,1652.3578431372548,87,117,39,32.37336048313102,0.6533764367816092,37.67755681818183,8222.402790625756,94.51037690374433,0
4678,31.807252290695775,0,1,203,0.0,0.004901960784313725,0.9950980392156863,204,4650,3400,1250,0.7311827956989247,59,34,25,201.39443732780703,0.4266104430277858,0.7715073853787138,0.1403815838052505,1094699.906454362,-1356.7056593640182,1093343.2007949979,4676,15,1653.3578431372548,89,115,39,32.355082053996846,0.6530898876404494,37.6388888888889,8344.986052378408,93.76388822897088,0
4679,31.48041417172672,0,0,203,0.0,0.0,1.0,203,4800,3200,1600,0.6666666666666666,64,32,32,201.98296939832997,0.42583402428912837,0.7721850840323339,0.14118883520581252,1084216.1037692253,-1601.3623782404256,1082614.741390985,4677,16,1662.3743842364531,89,114,41,32.245178455929945,0.6540262172284644,37.54629629629632,8262.151293496301,92.83316060108204,0
4680,31.994273003256858,0,1,202,0.0,0.0049261083743842365,0.9950738916256158,203,5150,3700,1450,0.7184466019417476,66,37,29,213.46042221343495,0.42578321871596025,0.7838590703972652,0.14253406024823423,1089104.6687534372,746.1484853463917,1089850.8172387837,4678,17,1663.3743842364531,75,128,42,33.50651582006973,0.6440277777777778,39.07620614035088,8348.067093791122,111.30756125054829,8
4681,32.1758073212803,0,0,202,0.0,0.0,1.0,202,5850,3900,1950,0.6666666666666666,78,39,39,222.58125559554017,0.4251247885982628,0.7935046341960801,0.14832515603971727,1094708.9388298467,2482.338023281819,1097191.2768531286,4679,18,1671.9752475247524,75,127,40,33.33858764186632,0.6433333333333333,39.14473684210527,8393.2286861103,111.909715814804,8
4682,32.40964079312915,1,0,203,0.0049261083743842365,0.0,1.0,203,6150,4500,1650,0.7317073170731707,78,45,33,222.3423248571158,0.4254854980571949,0.7928989153200803,0.14895945061242136,1104199.0880017066,2352.0384662811857,1106551.126467988,4680,0,1664.7339901477833,83,120,43,33.159342834520984,0.6418172690763052,38.963293650793645,8460.105886599298,101.9289865855337,0
4683,32.1736052154201,0,1,202,0.0,0.0049261083743842365,0.9950738916256158,203,5050,3600,1450,0.7128712871287128,65,36,29,222.4412362089903,0.42507498902599616,0.7936895869629812,0.14926332401362288,1096610.733584658,3136.2894437236523,1099747.0230283816,4681,1,1665.7339901477833,84,119,35,33.10158022373464,0.6419890873015873,38.909313725490186,8400.228665619159,100.0027222097519,0
4684,31.975923682218493,0,1,201,0.0,0.0049504950495049506,0.995049504950495,202,6100,4500,1600,0.7377049180327869,77,45,32,223.22290352766242,0.4241047239052263,0.7950229111007536,0.15035671769876513,1090943.3391052247,2204.70794784626,1093148.047053071,4682,21,1674.9752475247524,86,116,36,32.950126812424536,0.642562984496124,38.78113026819923,8352.714642899424,97.12458887092353,0
4685,31.81961374117345,0,0,201,0.0,0.0,1.0,201,5900,4700,1200,0.7966101694915254,71,47,24,221.67096107009806,0.4240288142620232,0.793964071343912,0.14975030401851935,1086433.5615796729,2066.154346835022,1088499.715926508,4683,22,1677.8009950248756,88,113,37,32.889457458085104,0.642874053030303,38.6821161048689,8315.034129203856,94.48902419549836,0
4686,32.16415763852649,0,1,200,0.0,0.004975124378109453,0.9950248756218906,201,5350,3400,1950,0.6355140186915887,73,34,39,222.60731414590163,0.42373445273631843,0.7947585833421285,0.1506100804753436,1098624.8888572953,3362.3871524722713,1101987.2760097675,4684,23,1678.8009950248756,92,109,37,32.81301335618884,0.6420969202898551,38.631272401433684,8406.704956261352,91.37722778544948,0
4687,32.512672862381216,0,1,199,0.0,0.005,0.995,200,5950,4500,1450,0.7563025210084033,74,45,29,224.12250142543039,0.4237180695142379,0.7946632535024214,0.15193852180572068,1111100.217562888,3854.512018906815,1114954.729581795,4685,24,1683.75,92,108,37,32.70470059837482,0.642776268115942,38.56406810035842,8499.980928324807,92.39109704700877,0
4688,32.18445266006317,0,0,199,0.0,0.0,1.0,199,5800,4400,1400,0.7586206896551724,72,44,28,222.34180153766255,0.4235053635179263,0.7929296753885997,0.15184002252581782,1101951.1216604814,3401.959519288029,1105353.0811797695,4686,25,1691.9698492462312,69,130,37,32.5001777082741,0.6547403381642511,38.318452380952394,8422.077381357334,122.05909248343963,0
4689,31.731720901202713,0,0,199,0.0,0.0,1.0,199,5450,3900,1550,0.7155963302752294,70,39,31,219.8470846884194,0.4233805813579683,0.7908026622586302,0.1507606173401419,1087600.3631820672,2571.153830328997,1090171.5170123961,4687,26,1692.9698492462312,71,128,35,32.42393997163434,0.6550762910798122,38.17997685185187,8307.999900883515,117.01408311103542,0
4690,31.56000133773608,1,0,200,0.005,0.0,1.0,200,5600,4200,1400,0.75,70,42,28,215.2560756323587,0.42315745393634846,0.7873170731707309,0.14816531337322272,1082743.0412646835,1013.4035961763625,1083756.4448608598,4688,0,1685.5,74,126,43,32.41704224107458,0.6548423423423424,38.05555555555557,8266.967017079238,111.71577050107078,0
4691,31.806679258081324,0,1,199,0.0,0.005,0.995,200,4800,3000,1800,0.625,66,30,36,213.09005823902137,0.42329093383584593,0.7843224774643784,0.14744803023822894,1092659.925970104,1766.9934520830147,1094426.9194221871,4689,1,1686.5,81,119,38,32.2956043423476,0.6535493827160495,37.881097560975626,8337.131857358398,102.92755379454812,0
4692,31.594165138450034,0,0,199,0.0,0.0,1.0,199,5600,4100,1500,0.7321428571428571,71,41,30,214.6226212629208,0.42325791414987396,0.7850200110323096,0.1490655460047144,1086384.4185627862,1232.5343222280094,1087616.9528850142,4690,2,1693.1909547738694,84,115,39,32.1290325093073,0.6536458333333333,37.75735294117648,8285.337497520759,98.63497020858047,0
4693,32.004738454814515,0,0,199,0.0,0.0,1.0,199,5550,4000,1550,0.7207207207207207,71,40,31,217.94385877859204,0.422931154086933,0.788048116827635,0.15200578361788905,1101657.587927098,2669.9011531096476,1104327.4890802077,4691,3,1694.1909547738694,86,113,40,31.90131498889601,0.654312015503876,37.61973180076629,8397.411859420574,97.64432394675086,0
4694,31.96271871840268,0,0,199,0.0,0.0,1.0,199,6000,4400,1600,0.7333333333333333,76,44,32,218.5151899582401,0.4224267380674416,0.7884466075302989,0.15285034139224063,1101016.9203497763,2317.784299493672,1103334.70464927,4692,4,1695.1909547738694,87,112,41,31.788167824178448,0.6549329501915708,37.52367424242425,8389.45697042925,96.43053988999138,0
4695,31.96841615440569,0,0,199,0.0,0.0,1.0,199,6050,4100,1950,0.6776859504132231,80,41,39,216.53238038762876,0.42209997800450066,0.7864102636085464,0.15211654666163837,1102397.000416151,1890.9293264581493,1104287.9297426092,4693,5,1696.1909547738694,70,129,40,31.69611266294225,0.6636904761904762,37.38262910798121,8395.461402051938,119.93516288645627,0
4696,32.36828122612101,0,1,198,0.0,0.005025125628140704,0.9949748743718593,199,5300,3900,1400,0.7358490566037735,67,39,28,216.7271009979213,0.42197731079640627,0.7867502831106103,0.15259531039590138,1116809.5789017805,3308.580480418274,1120118.1593821987,4694,6,1697.1909547738694,70,129,40,31.61605231313412,0.6644345238095238,37.30927230046947,8502.847349672758,121.46924785246797,0
4697,32.68570737695929,0,0,198,0.0,0.0,1.0,198,4900,3600,1300,0.7346938775510204,62,36,26,226.4466740544172,0.4217566955511118,0.7891852238585892,0.15724836338873624,1123864.6024571566,6399.080262782925,1130263.6827199396,4695,7,1701.989898989899,82,116,38,31.825297120523285,0.6543445121951219,37.76355421686749,8571.383730441374,104.52906988343139,8
4698,32.45709627762892,0,1,197,0.0,0.005050505050505051,0.9949494949494949,198,5500,3900,1600,0.7090909090909091,71,39,32,261.625674809147,0.42180690150233296,0.8148899937660592,0.1676591543069554,1092878.357039219,12085.00752893974,1104963.3645681588,4696,8,1702.989898989899,63,135,34,33.705469141997,0.6362433862433863,40.49479166666668,8422.785531421177,133.6950084352568,8
4699,32.54091269556331,0,0,197,0.0,0.0,1.0,197,5100,3700,1400,0.7254901960784313,65,37,28,259.6701925490334,0.42138346455333403,0.8114422930788168,0.16704515468293002,1096833.2435190806,12462.979907756224,1109296.2234268368,4697,9,1712.243654822335,66,131,38,33.61863772455091,0.6357323232323233,40.36069651741294,8448.899906963743,128.0136349539961,0
4700,32.153443169212494,0,0,197,0.0,0.0,1.0,197,5800,4500,1300,0.7758620689655172,71,45,26,259.18665361231456,0.4211287941572568,0.8101898175592668,0.16705837400122361,1084339.3588413196,11009.257959641,1095348.6168009606,4698,10,1713.243654822335,68,129,34,33.56161231568138,0.6352634803921569,40.292874396135275,8350.478303743419,122.80115152563852,0
4701,31.916773767711398,0,1,196,0.0,0.005076142131979695,0.9949238578680203,197,6000,4600,1400,0.7666666666666667,74,46,28,257.1856855609843,0.42113203149280015,0.8072496242450409,0.16622576418206764,1077153.4770657024,10005.69109070821,1087159.1681564106,4699,11,1714.243654822335,72,125,36,33.515154427784196,0.6341145833333333,40.19691780821918,8292.076198469207,115.16772497873899,0
4702,32.330618906298106,0,0,196,0.0,0.0,1.0,196,5500,3900,1600,0.7090909090909091,71,39,32,208.00108474231973,0.4207504796790511,0.764029022116413,0.12464526049393157,1068509.2246674038,-249.78444240049066,1068259.4402250033,4700,12,1723.7091836734694,90,106,36,37.555283466904164,0.599537037037037,42.90293040293044,8312.107379068959,92.35674865632177,8
4703,32.11085419668314,0,0,196,0.0,0.0,1.0,196,6500,5000,1500,0.7692307692307693,80,50,30,207.3199029611003,0.4207172291993721,0.7643655128166367,0.12470688557895974,1062390.6032101286,-1649.0566471376678,1060741.5465629909,4701,13,1724.7091836734694,92,104,38,37.431329646724144,0.6003170289855073,42.76433691756276,8260.056871427354,89.7832268633408,0
4704,31.899492901788452,2,0,198,0.010101010101010102,0.0,1.0,198,5300,3700,1600,0.6981132075471698,69,37,32,202.25236721920407,0.4217903442205473,0.7601753849512904,0.1222847000687675,1056939.7793821064,-2146.2855223654005,1054793.493859741,4702,0,1708.2777777777778,78,120,40,37.37002509860164,0.6072382478632479,42.57647679324893,8211.679851287092,105.27794681137297,0
4705,31.762480803670837,1,1,198,0.005025125628140704,0.005025125628140704,0.9949748743718593,199,6050,4200,1850,0.6942148760330579,79,42,37,205.83746050659505,0.4219551038018375,0.7663655572685895,0.1252905099810526,1054401.4028777785,-2442.9385754094,1051958.4643023692,4703,0,1700.6884422110552,82,117,38,37.02805107723281,0.608104674796748,42.33182730923695,8184.1803888073055,99.80707791228421,0
4706,32.191373806611146,0,2,196,0.0,0.010101010101010102,0.98989898989899,198,5700,4100,1600,0.7192982456140351,73,41,32,201.71780903155505,0.42181437898442975,0.7599735109005819,0.1231263028197831,1069480.6642682094,-2153.340720440983,1067327.3235477684,4704,1,1710.20202020202,84,114,42,37.03072010395868,0.6083829365079365,42.23039215686274,8297.957802061985,98.78521192930934,0
4707,32.37220471453684,3,2,197,0.01507537688442211,0.010050251256281407,0.9899497487437185,199,5900,4300,1600,0.7288135593220338,75,43,32,197.4283968160999,0.42376867502495646,0.7574037504462716,0.1212177360061407,1077263.1376496907,-3163.5331569482664,1074099.6044927426,4705,0,1685.3819095477386,88,111,32,36.9244888546109,0.6091382575757576,42.01779026217227,8351.452906341492,94.90287393569878,0
4708,31.966797072539315,0,0,197,0.0,0.0,1.0,197,5200,3900,1300,0.75,65,39,26,201.65365621573008,0.4225305604475293,0.7612628753210446,0.12414338007449804,1064568.1427476695,-1665.1883448289645,1062902.9544028405,4706,1,1703.492385786802,89,108,35,36.717044876969524,0.6097846441947565,41.921296296296276,8249.94955004024,92.69606236000271,0
4709,31.52551543863751,1,0,198,0.005050505050505051,0.0,1.0,198,5650,4200,1450,0.7433628318584071,71,42,29,202.47469273951415,0.4231085174930353,0.7664934153885419,0.12521808004346008,1051207.5904560117,-2681.4132233951727,1048526.1772326166,4707,0,1695.8838383838383,91,107,37,36.528484157605504,0.6108058608058609,41.75724637681157,8141.235916264025,89.46413094795632,0
4710,31.179474036198478,0,3,195,0.0,0.015151515151515152,0.9848484848484849,198,4950,3100,1850,0.6262626262626263,68,31,37,202.59721876155706,0.4229002162060538,0.7676898786260848,0.12566024822466576,1040513.360758611,-2388.9774052129,1038124.3833533981,4708,1,1696.8838383838383,72,126,38,36.418346681395555,0.6193576388888888,41.65239726027398,8055.142371937416,111.87697738801967,0
4711,31.58692698024632,0,1,194,0.0,0.005128205128205128,0.9948717948717949,195,6100,4500,1600,0.7377049180327869,77,45,32,221.12359296043354,0.42221671512908626,0.7817663817663825,0.13088126177928294,1040227.1609570513,903.7534651705537,1041130.9144222218,4709,2,1720.625641025641,71,124,36,37.68444529003887,0.6025528169014085,43.35937499999998,8106.4886820397305,114.17589693013704,7
4712,31.813440283335527,2,0,196,0.01020408163265306,0.0,1.0,196,4550,3300,1250,0.7252747252747253,58,33,25,223.1488954078274,0.4237026862026862,0.7845466989952485,0.13289885911886457,1049555.18696498,3091.4161281578945,1052646.603093138,4710,0,1712.5204081632653,73,123,32,37.3986190267426,0.6038812785388128,43.130630630630606,8171.898343050436,111.94381291849912,0
4713,32.07620061689874,2,2,196,0.010101010101010102,0.010101010101010102,0.98989898989899,198,5950,4300,1650,0.7226890756302521,76,43,33,220.0027810845557,0.4245773086191868,0.7838923303011698,0.13185597144471675,1060143.7487996917,1096.9146170676363,1061240.6634167593,4711,0,1696.2121212121212,76,122,36,37.24140577041126,0.6048519736842105,42.89772727272726,8246.864079060584,108.51136946132347,0
4714,32.29542315845568,0,1,195,0.0,0.00510204081632653,0.9948979591836735,196,5150,3700,1450,0.7184466019417476,66,37,29,222.84535450429584,0.4239692351299494,0.7844194577284009,0.1341021285206861,1068625.1836246368,3277.631575409898,1071902.8152000466,4712,1,1714.234693877551,76,120,37,37.016196886832105,0.606359649122807,42.74891774891774,8308.032559269368,109.31621788512327,0
4715,32.314606829215826,1,0,196,0.00510204081632653,0.0,1.0,196,5400,3700,1700,0.6851851851851852,71,37,34,223.43450529424686,0.42459717861503576,0.7848391783898034,0.13537502379592622,1071330.1995348474,3274.42662797112,1074604.6261628186,4713,0,1714.642857142857,69,127,37,36.74656148867316,0.6123188405797102,42.50000000000001,8321.011258523087,120.594366065552,0
4716,32.44819221921019,1,0,197,0.005076142131979695,0.0,1.0,197,4950,3100,1850,0.6262626262626263,68,31,37,220.90778983307766,0.4249984892434131,0.7831514804009196,0.13460170999950677,1077476.5226431517,3254.59144282572,1080731.1140859774,4714,0,1706.9340101522844,72,125,36,36.60160575858251,0.6128472222222222,42.294520547945204,8362.076933203994,116.13995740561103,0
4717,31.937906415699945,0,0,197,0.0,0.0,1.0,197,5950,4200,1750,0.7058823529411765,77,42,35,223.19802421522442,0.42480316999896406,0.7852627588095291,0.13680245126111146,1062294.355693618,2070.400265160053,1064364.755958778,4715,1,1707.9340101522844,72,125,32,36.32376671277085,0.6150173611111112,42.08047945205479,8237.409510042462,114.40846541725642,0
4718,31.785552957083972,0,0,197,0.0,0.0,1.0,197,5650,4000,1650,0.7079646017699115,73,40,33,220.7875460465351,0.4249725905590663,0.784236873534311,0.1358605910259132,1058397.0366999854,1686.1768951828863,1060083.2135951682,4716,2,1708.9340101522844,72,125,34,36.240093078978916,0.6164641203703703,41.93778538812786,8202.650188768037,113.92569706622274,0
4719,31.374157126317996,1,0,198,0.005050505050505051,0.0,1.0,198,5750,4000,1750,0.6956521739130435,75,40,35,221.9081870380975,0.42545057170691686,0.7877505969568781,0.13737032776832442,1046444.3891615653,1092.9154470065305,1047537.3046085719,4717,0,1701.29797979798,74,124,37,35.990826880332705,0.6176801801801801,41.72222222222223,8103.247582236256,109.50334570589534,0
4720,31.794202712732556,1,1,198,0.005025125628140704,0.005025125628140704,0.9949748743718593,199,5250,4000,1250,0.7619047619047619,65,40,25,217.80446989637034,0.42610252440654456,0.7856478287873176,0.13551542549479353,1061948.0342783625,1209.4057326982947,1063157.4400110608,4718,0,1693.7437185929648,65,134,39,35.91103851164308,0.6243589743589744,41.54040404040405,8217.516786990358,126.42333518446705,0
4721,32.01209743036583,1,1,198,0.005025125628140704,0.005025125628140704,0.9949748743718593,199,5500,4100,1400,0.7454545454545455,69,41,28,219.35399189099934,0.4265445493460569,0.7860493084786531,0.1368288404031255,1069982.220698431,1640.9742725195406,1071623.1949709505,4719,0,1694.7035175879396,66,133,40,35.77758568851475,0.6246843434343434,41.44900497512439,8276.75964345437,125.40544914324803,0
4722,32.51141132979467,1,0,199,0.005025125628140704,0.0,1.0,199,5150,3500,1650,0.6796116504854369,68,35,33,218.11004871354186,0.4267793090029271,0.7838344212497246,0.13646847989647226,1087586.4516616736,2492.706790423193,1090079.1584520969,4720,0,1695.6381909547738,66,133,42,35.698543407264935,0.6257891414141414,41.34017412935324,8409.395993373666,127.41509080869191,0
4723,32.38084804372722,0,1,198,0.0,0.005025125628140704,0.9949748743718593,199,5200,3400,1800,0.6538461538461539,70,34,36,219.59389953173294,0.4268776542645889,0.7853048232364166,0.13791829204609501,1084348.260230683,2623.2525829011834,1086971.5128135842,4721,1,1696.6381909547738,69,130,40,35.522384662564946,0.6254528985507246,41.205357142857146,8379.990004887804,121.44913050562036,0
4724,32.018970714437835,1,1,198,0.005025125628140704,0.005025125628140704,0.9949748743718593,199,5750,4100,1650,0.7130434782608696,74,41,33,217.81943376291062,0.42747089826235557,0.7843507079634102,0.13770618439587415,1074162.6583065747,1244.7004003203047,1075407.358706895,4722,0,1696.4120603015076,71,128,35,35.33009383378018,0.6267605633802817,40.97222222222223,8293.802830892588,116.81412437876884,0
4725,32.10193757758723,0,2,196,0.0,0.010101010101010102,0.98989898989899,198,5000,4000,1000,0.8,60,40,20,242.75541828301658,0.4269898648071237,0.8011855568673751,0.14378590159840146,1057402.1549861876,6738.020485406776,1064140.1754715943,4723,3,1705.979797979798,69,129,42,37.102610930735906,0.6038647342995169,43.333333333333314,8239.497311580682,119.41300451566207,8
4726,31.94210850255856,2,0,198,0.010101010101010102,0.0,1.0,198,5550,3900,1650,0.7027027027027027,72,39,33,237.44701423676602,0.42665498043036115,0.7961036463821627,0.14122331104059227,1053390.480341439,4874.88487650116,1058265.36521794,4724,0,1706.9242424242425,74,124,42,37.08245452742776,0.6028997747747749,43.180555555555536,8203.354560011205,110.85614270285411,0
4727,31.903561320528425,1,1,198,0.005025125628140704,0.005025125628140704,0.9949748743718593,199,5200,4000,1200,0.7692307692307693,64,40,24,230.35766272717294,0.42726997783530446,0.7907363900454176,0.13777077616056985,1053800.646905048,3550.210800285521,1057350.8577053335,4725,0,1699.3417085427136,77,122,37,37.05466936852679,0.6036255411255411,42.975427350427324,8199.999214408188,106.49349629101543,0
4728,32.075588101639426,2,2,198,0.01,0.01,0.99,200,5050,3900,1150,0.7722772277227723,62,39,23,236.53700000000197,0.42804857621440534,0.7965870000000022,0.14214963942307698,1060943.1660318375,5140.462732734516,1066083.628764572,4726,0,1691.83,80,120,40,36.71458333333332,0.6041666666666667,42.79835390946499,8249.894059063567,103.12367573829458,0
4729,31.945856393128345,2,0,200,0.01,0.0,1.0,200,5600,3700,1900,0.6607142857142857,75,37,38,236.85342741723557,0.42854847152428815,0.7981959023649927,0.14307105046509463,1058194.7297833713,4527.409724809651,1062722.139508181,4727,0,1691.87,63,137,40,36.514322751991934,0.6147486772486772,42.61067708333335,8222.522347020406,130.51622773048263,0
4730,32.444616646354355,1,0,201,0.004975124378109453,0.0,1.0,201,5800,4000,1800,0.6896551724137931,76,40,36,232.156226546961,0.42903399668325043,0.7955441631045534,0.14103826248604426,1076459.6547055147,3981.362293295528,1080441.0169988102,4728,0,1684.44776119403,67,134,40,36.421661909292766,0.6144278606965174,42.40196078431374,8357.66963120552,124.74133777918685,0
4731,32.90488002429797,1,0,202,0.0049504950495049506,0.0,1.0,202,5900,4500,1400,0.7627118644067796,73,45,28,233.0782573206816,0.42993315189727926,0.7971697169716971,0.1424367128070832,1093549.0218036037,4676.500059344035,1098225.5218629478,4729,0,1677.1039603960396,71,131,43,36.1784511784512,0.6144366197183099,42.1875,8483.28938126432,119.48294903189182,0
4732,33.238777072434935,2,0,204,0.00980392156862745,0.0,1.0,204,5150,3100,2050,0.6019417475728155,72,31,41,225.75892863426705,0.4313363276345021,0.7918337322345037,0.1387137334701273,1106327.227428466,4002.6499166340104,1110329.8773451,4730,0,1661.6519607843138,76,128,39,36.16656617030202,0.6140350877192983,41.991341991342,8575.892266307908,112.84068771457774,0
4733,32.88646634914875,0,2,202,0.0,0.00980392156862745,0.9901960784313726,204,6150,5000,1150,0.8130081300813008,73,50,23,225.25951270322787,0.4313187200167423,0.792521054192008,0.13884383566367695,1095565.8324856109,2407.3251120027935,1097973.1575976138,4731,1,1662.6519607843138,78,126,41,36.06318536302955,0.6143162393162394,41.87763713080168,8488.732400460638,108.82990257000817,0
4734,32.846289333437554,2,0,204,0.00980392156862745,0.0,1.0,204,5400,3900,1500,0.7222222222222222,69,39,30,279.02425763908377,0.43145404713609586,0.8307794840509533,0.16733320640338,1085787.7257485765,14392.222826124933,1100179.9485747013,4732,0,1662.9460784313726,74,130,36,35.70058877545507,0.6059966216216216,42.874999999999986,8445.602144860099,114.12975871432566,8
4735,33.30115993112666,1,1,204,0.004878048780487805,0.004878048780487805,0.9951219512195122,205,5000,3700,1300,0.74,63,37,26,283.07298923109704,0.43202813645783517,0.8350350548039898,0.1705342154636122,1102251.7720475844,16403.540799756753,1118655.3128473412,4733,0,1655.8292682926829,58,147,38,35.425101214574894,0.6172772988505747,42.708333333333336,8568.110940612802,147.72605070022072,0
4736,33.44509950135517,0,0,204,0.0,0.0,1.0,204,5000,3300,1700,0.66,67,33,34,285.7902785218283,0.4313126831192247,0.835446076447576,0.17266204846636637,1107912.6507403112,17526.133006586126,1125438.7837468975,4734,1,1664.9313725490197,59,145,39,35.24804397679753,0.6175847457627119,42.60416666666667,8608.629257067574,145.90897045877244,0
4737,32.918438202813554,2,0,206,0.009708737864077669,0.0,1.0,206,5000,4000,1000,0.8,60,40,20,276.77249936983526,0.4322628068513695,0.8299903372751112,0.16800632153922693,1091928.6215509942,14243.16274402557,1106171.7842950197,4735,0,1649.7572815533981,63,143,40,35.302856766719316,0.6165674603174602,42.431640625,8478.748121086013,134.5833035093018,0
4738,32.62477327081429,1,1,206,0.004830917874396135,0.004830917874396135,0.9951690821256038,207,4900,3500,1400,0.7142857142857143,63,35,28,272.51612792584524,0.4329016384472273,0.8252311130915744,0.16636442203553164,1083922.63036144,12777.27963945959,1096699.9100008996,4736,0,1642.7826086956522,68,139,40,35.20046364080041,0.615655637254902,42.22524154589373,8409.843049504161,123.67416249270825,0
4739,32.477879723285476,0,0,206,0.0,0.0,1.0,206,5250,3900,1350,0.7428571428571429,66,39,27,271.81367395300566,0.4328636830057621,0.8239754840301188,0.16635074757403406,1079800.716450808,12250.919975116314,1092051.6364259245,4737,1,1651.6504854368932,68,138,43,35.125529340592884,0.6165747549019608,42.134661835748794,8374.919437702889,123.16057996621896,0
4740,32.09927809975495,1,1,206,0.004830917874396135,0.004830917874396135,0.9951690821256038,207,6200,4600,1600,0.7419354838709677,78,46,32,276.3827617492409,0.4332407016556447,0.8289649618371766,0.16996573474285548,1068658.6862087268,11471.767812336859,1080130.4540210636,4738,0,1644.6666666666667,70,137,32,34.82831570767951,0.6172619047619048,41.96009389671363,8282.894706844078,118.32706724062967,0
4741,32.308343897280835,1,1,206,0.004830917874396135,0.004830917874396135,0.9951690821256038,207,5850,4000,1850,0.6837606837606838,77,40,37,271.09980324579686,0.4335553366790175,0.8277034908706915,0.16768162129673428,1077352.1501074987,11163.991184115977,1088516.1412916146,4739,0,1645.647342995169,72,135,35,34.751192581132365,0.6183449074074074,41.75228310502284,8343.55604813057,115.88272289070235,0
4742,32.01987112127531,1,1,206,0.004830917874396135,0.004830917874396135,0.9951690821256038,207,5550,4000,1550,0.7207207207207207,71,40,31,274.3711965602336,0.4331136750934134,0.8301370628861067,0.17050922724416007,1069135.827112387,11718.01523404822,1080853.8423464352,4740,0,1646.6280193236714,61,146,35,34.49243384695405,0.6265368852459017,41.58266129032259,8274.489880986837,135.64737509814486,0
4743,32.23704929532431,2,1,207,0.009615384615384616,0.004807692307692308,0.9951923076923077,208,5700,4000,1700,0.7017543859649122,74,40,34,271.9223652628573,0.43366729762789546,0.828526634001725,0.17003312874766607,1078224.886343544,11338.692275962552,1089563.5786195067,4741,0,1639.6778846153845,64,144,36,34.32923869715184,0.6267903645833333,41.362179487179496,8337.720169507053,130.2768776485477,0
4744,32.065430409494475,1,0,208,0.004807692307692308,0.0,1.0,208,6600,5100,1500,0.7727272727272727,81,51,30,271.7714739139053,0.433997778087452,0.8290802507351793,0.17097521839900157,1074279.7715954373,10191.719384477321,1084471.4909799146,4742,0,1640.6009615384614,65,143,39,34.11091549295776,0.6283653846153846,41.14583333333334,8300.270267457707,127.69646565319549,0
4745,32.11317212431005,0,1,207,0.0,0.004807692307692308,0.9951923076923077,208,6250,4500,1750,0.72,80,45,35,272.4321375478568,0.433996810355506,0.829554953631862,0.17187991223473925,1076719.4648908614,10816.597071920594,1087536.061962782,4743,1,1641.6009615384614,66,142,39,33.99000360230547,0.6287878787878788,41.044776119403,8315.873676966883,125.99808601464974,0
4746,32.399283218759415,0,1,206,0.0,0.004830917874396135,0.9951690821256038,207,5300,3500,1800,0.660377358490566,71,35,36,272.57099646502206,0.4337097228084987,0.8283050506767462,0.1723908050761648,1087042.686117139,12559.261630992602,1099601.9477481316,4744,2,1649.3719806763286,71,136,32,33.897014334915774,0.6269072769953052,40.95775462962963,8392.78307337801,118.20821230109874,0
4747,32.10223704695887,1,0,207,0.004830917874396135,0.0,1.0,207,5500,3400,2100,0.6181818181818182,76,34,42,268.2852302491091,0.4337448993949627,0.8260922516454581,0.17037045828116368,1078268.8523948255,10956.72146703794,1089225.5738618635,4745,0,1649.0193236714977,76,131,34,33.860826939471465,0.6259594298245614,40.81439393939396,8320.437764917324,109.47944427522795,0
4748,32.53245558370134,1,1,207,0.004807692307692308,0.004807692307692308,0.9951923076923077,208,6150,4300,1850,0.6991869918699187,80,43,37,267.8989048563729,0.43423729174408526,0.8277919369786835,0.17104314694676137,1094316.828691987,10883.255994496518,1105200.0846864837,4746,0,1642.0865384615386,58,150,38,33.676372155287815,0.6384698275862069,40.62500000000001,8438.105667022552,145.48458046590605,0
4749,32.206125314045664,0,0,207,0.0,0.0,1.0,207,6450,4800,1650,0.7441860465116279,81,48,33,267.7545100054458,0.4334840063786877,0.8271466109656604,0.17145089673547168,1084195.8872372415,10209.667707425233,1094405.5549446668,4747,1,1650.9951690821256,60,147,37,33.57491499396733,0.6380208333333333,40.522540983606554,8356.763561252104,139.27939268753508,0
4750,32.51215871795052,0,1,206,0.0,0.004830917874396135,0.9951690821256038,207,6350,5000,1350,0.7874015748031497,77,50,27,266.4336547818014,0.43355142816941045,0.8242695636906638,0.17164836945104725,1096297.5903282943,10668.114743929698,1106965.705072224,4748,2,1651.9951690821256,65,142,38,33.390310360196075,0.6368589743589743,40.30934343434342,8443.103843831375,129.89390528971347,0
4751,32.31829711440818,0,1,205,0.0,0.0048543689320388345,0.9951456310679612,206,6200,4400,1800,0.7096774193548387,80,44,36,263.9024576241855,0.43361699818454497,0.820954109686401,0.1707627481438898,1091039.5673171184,10185.604636042917,1101225.1719531612,4749,3,1657.6601941747572,68,138,40,33.29968432876286,0.6366421568627452,40.15700483091786,8397.683120972102,123.49534001429562,0
4752,32.51015115584084,0,1,204,0.0,0.004878048780487805,0.9951219512195122,205,6200,4700,1500,0.7580645161290323,77,47,30,261.4954706447893,0.4330125139486689,0.8196256318056936,0.17024198061716977,1099307.8576962166,10292.805126357029,1109600.6628225737,4750,4,1666.560975609756,71,134,35,33.14470329160869,0.6371772300469484,39.945023148148124,8454.426606282335,119.0764310743991,0
4753,32.531527447472186,0,0,204,0.0,0.0,1.0,204,6000,4300,1700,0.7166666666666667,77,43,34,267.02250877914656,0.4323082681348402,0.8221862800393709,0.1741835570512972,1100608.2582182072,11977.435658494378,1112585.6938767016,4751,5,1675.6176470588234,70,134,35,32.93088456476779,0.6383928571428572,39.87676056338027,8462.206303457755,120.88866147796793,0
4754,32.710953686824965,0,0,204,0.0,0.0,1.0,204,5550,4000,1550,0.7207207207207207,71,40,31,266.4562803101737,0.43206628915934187,0.8221635295192942,0.17421406495001768,1107354.2057954557,12662.296532416382,1120016.5023278722,4752,6,1676.6176470588234,72,132,35,32.86411205557077,0.6381655092592593,39.79737442922372,8511.47603423587,118.21494491994264,0
4755,32.643892974031225,0,1,203,0.0,0.004901960784313725,0.9950980392156863,204,6350,4200,2150,0.6614173228346457,85,42,43,238.3183519722151,0.4320441538684439,0.8115820003602301,0.14924475517125219,1092284.9579871392,4912.310214306908,1097197.2682014462,4753,7,1677.6176470588234,63,141,39,35.14350278931254,0.6279761904761905,41.30859374999999,8444.694578926617,134.0427710940733,8
4756,32.984999792402135,0,1,202,0.0,0.0049261083743842365,0.9950738916256158,203,5850,4200,1650,0.717948717948718,75,42,33,240.69022071920304,0.4315760701685932,0.810754373349283,0.14766147621959821,1097409.0847055297,6377.126963406537,1103786.2116689363,4754,9,1686.847290640394,73,130,41,35.838051386994074,0.6148687214611872,42.046734234234236,8508.588417733243,116.55600572237319,8
4757,32.62613034117319,0,0,202,0.0,0.0,1.0,202,5050,3500,1550,0.693069306930693,66,35,31,241.89344331285184,0.43126108319787204,0.8109092560632207,0.14879449955474555,1086277.4097270416,7102.67660636806,1093380.0863334097,4755,13,1696.1534653465346,76,126,38,35.708715596330286,0.6144462719298245,41.950757575757585,8419.148217774355,110.77826602334677,0
4758,32.29029482336001,2,2,202,0.00980392156862745,0.00980392156862745,0.9901960784313726,204,5950,4400,1550,0.7394957983193278,75,44,31,235.7570239334021,0.43247830741491994,0.8098908918406065,0.14616935483870966,1077464.3515711466,4053.9577841493983,1081518.309355296,4756,0,1680.514705882353,80,124,42,35.576276881720425,0.615625,41.66666666666667,8341.659496034685,104.27074370043356,0
4759,32.22088958473727,1,0,203,0.0049261083743842365,0.0,1.0,203,5300,4000,1300,0.7547169811320755,66,40,26,232.89987032396078,0.43296001398169376,0.8050411641746422,0.14522774175016437,1076856.9478997914,4259.968704663786,1081116.916604455,4757,0,1685.615763546798,65,138,41,35.440131351362375,0.6251602564102564,41.46148989898992,8330.340787367168,128.15908903641795,0
4760,32.341895429125444,1,0,204,0.004901960784313725,0.0,1.0,204,6250,4900,1350,0.784,76,49,27,235.87711158506607,0.43376265736179526,0.8086956931552816,0.1479075693669435,1082566.13370634,4020.514543692929,1086586.648250033,4758,0,1678.3480392156862,66,138,43,35.1594109281737,0.6265782828282829,41.262437810945286,8368.063179905275,126.78883605917083,0
4761,32.551265750023866,1,1,204,0.004878048780487805,0.004878048780487805,0.9951219512195122,205,4800,3600,1200,0.75,60,36,24,233.53419931090718,0.4342350151442691,0.8075104801304265,0.14730431403875655,1091338.2505832405,5172.960905464543,1096511.2114887051,4759,0,1671.1560975609757,72,133,44,35.00578608034389,0.6254340277777778,41.05308219178082,8429.049936724914,117.07013801006825,0
4762,32.8054975897318,1,0,205,0.004878048780487805,0.0,1.0,205,5950,3900,2050,0.6554621848739496,80,39,41,234.53177862784312,0.434943408257612,0.8075128012805723,0.14859368693546487,1101200.3346725523,4703.294623266288,1105903.6292958185,4760,0,1671.351219512195,76,129,38,34.81874031918413,0.6251370614035088,40.89556277056279,8500.049991019168,111.8427630397259,0
4763,32.40413242643812,0,1,204,0.0,0.004878048780487805,0.9951219512195122,205,5750,4000,1750,0.6956521739130435,75,40,35,232.01595179818207,0.4349085365853658,0.8049440354045503,0.14774487293262556,1089224.70994503,3793.5015599992544,1093018.2115050294,4761,1,1672.351219512195,78,127,38,34.70152732573908,0.6260683760683761,40.71729957805909,8401.830960357109,107.71578154303985,0
4764,32.19550379750193,0,3,201,0.0,0.014705882352941176,0.9852941176470589,204,5600,3700,1900,0.6607142857142857,75,37,38,236.34845065889562,0.43403884542322674,0.8076623870551347,0.15079031152037617,1082770.3952467486,4782.22106717812,1087552.6163139266,4762,2,1681.5343137254902,81,123,40,34.52071904388718,0.6255144032921811,40.65040650406506,8349.890822279003,103.0850718799877,0
4765,31.73607123451903,1,0,202,0.0049504950495049506,0.0,1.0,202,5650,4400,1250,0.7787610619469026,69,44,25,214.3842200030345,0.43282966356337127,0.7864289385667953,0.13178522464849293,1056446.552635121,-752.9059676847846,1055693.6466674362,4763,0,1698.9108910891089,70,132,39,36.44311138909421,0.6171130952380952,41.974765258215974,8188.707230068783,116.98153185812548,8
4766,31.780036391467057,3,1,204,0.014634146341463415,0.004878048780487805,0.9951219512195122,205,5550,4200,1350,0.7567567567567568,69,42,27,209.48580507167844,0.4338753387533875,0.783772191580479,0.12963023445284144,1059867.9685304894,-2144.5410685408715,1057723.4274619485,4764,0,1675.0341463414634,74,131,43,36.32584924262797,0.6175394144144144,41.736111111111136,8207.63578749075,110.91399712825337,0
4767,32.00287946543992,0,1,203,0.0,0.004901960784313725,0.9950980392156863,204,6600,4900,1700,0.7424242424242424,83,49,34,210.6342457931772,0.43319267362117264,0.7844733440110514,0.1307684229851137,1068271.3685861535,-2397.093195082034,1065874.2753910716,4765,1,1684.2254901960785,64,140,47,36.1761923959561,0.6241861979166667,41.61858974358975,8268.949128546297,129.2023301335359,0
4768,31.63075950779752,0,0,203,0.0,0.0,1.0,203,5850,4500,1350,0.7692307692307693,72,45,27,205.37553212325304,0.43314799460241593,0.7773692687713984,0.12828957574543084,1057646.8108246964,-3007.044685683334,1054639.766139013,4766,2,1670.0492610837439,69,134,47,36.08777381363411,0.6234903381642511,41.39880952380952,8179.752064382507,118.54713136786242,0
4769,31.94483628133627,1,0,204,0.004901960784313725,0.0,1.0,204,5600,3900,1700,0.6964285714285714,73,39,34,203.99240273808653,0.43339038201487495,0.7781183135150298,0.12812556531526992,1069761.0581734632,-2755.3742775114733,1067005.6838959518,4767,0,1662.8578431372548,71,133,45,35.924455873583774,0.6244131455399061,41.203703703703695,8267.205315401361,116.43951148452621,0
4770,31.880094337267035,1,4,201,0.004878048780487805,0.01951219512195122,0.9804878048780488,205,5350,3700,1650,0.6915887850467289,70,37,33,221.57542835951128,0.43411944045911044,0.7945255865442975,0.13884038309132649,1066898.6259826482,929.7040136556934,1067828.329996304,4768,0,1655.7414634146342,65,140,43,35.555453879941375,0.6269230769230769,41.287878787878775,8247.766830436869,126.88872046825952,8
4771,32.31657514499951,1,0,202,0.0049504950495049506,0.0,1.0,202,4700,3300,1400,0.7021276595744681,61,33,28,220.19121242365557,0.43291330065842404,0.7910223409208719,0.13894484680932756,1083591.0063837422,2619.4434934008323,1086210.4498771431,4769,0,1679.1386138613861,67,135,46,35.33650054224589,0.6282649253731343,41.03860294117646,8368.745447705494,124.90664847321634,0
4772,32.101360058611235,0,0,202,0.0,0.0,1.0,202,5750,4200,1550,0.7304347826086957,73,42,31,217.50985869397806,0.4325412951742935,0.788311599683805,0.1377035141768051,1077339.127912138,716.3762955322754,1078055.5042076702,4770,1,1680.1386138613861,69,133,40,35.287430595443226,0.6283212560386473,40.92261904761903,8316.736288994332,120.5324099854251,0
4773,32.58695507727481,0,1,201,0.0,0.0049504950495049506,0.995049504950495,202,5500,3900,1600,0.7090909090909091,71,39,32,245.5475738444426,0.4322595972283796,0.8126487119093779,0.14806778435810963,1078903.0908442545,7084.4072740155025,1085987.49811827,4771,2,1681.1386138613861,59,143,37,36.3550240633293,0.6168785310734464,42.67361111111112,8385.483474919587,142.1268385579591,8
4774,32.344272290300644,0,0,201,0.0,0.0,1.0,201,6350,4800,1550,0.7559055118110236,79,48,31,247.15115230020817,0.4317951907131012,0.8102668475802806,0.14990756807741606,1072644.2297293814,6471.0514771572025,1079115.2812065387,4772,3,1690.4875621890546,62,139,36,36.09519453004625,0.6169354838709677,42.46031746031746,8329.933617621082,134.35376802614647,0
4775,32.19592455104093,2,0,203,0.009852216748768473,0.0,1.0,203,5400,3400,2000,0.6296296296296297,74,34,40,242.88414005796938,0.432434684355135,0.8081824320851534,0.14833377260777844,1069794.2823882466,5967.212863360274,1075761.495251607,4773,0,1674.8226600985222,66,137,39,35.949530587218284,0.6169507575757576,42.21082089552238,8299.760960522528,125.75395394731103,0
4776,32.65068239651782,0,1,202,0.0,0.0049261083743842365,0.9950738916256158,203,5850,4300,1550,0.7350427350427351,74,43,31,241.78752720481282,0.4323909915622104,0.8083581443187362,0.14807177229876403,1085745.9466622458,6053.9655232225305,1091799.9121854682,4774,1,1675.8226600985222,67,136,40,35.87547025047026,0.6173818407960199,42.1109068627451,8420.254873550508,125.67544587388818,0
4777,32.53219498812711,2,1,203,0.00980392156862745,0.004901960784313725,0.9950980392156863,204,4700,2700,2000,0.574468085106383,67,27,40,236.94716784526966,0.433086524839821,0.8055419962687806,0.1460703738987274,1083810.571359535,5861.169072881161,1089671.740432416,4775,0,1668.5098039215686,70,134,37,35.755797430942366,0.6181547619047619,41.872065727699535,8397.468289628952,119.96383270898504,0
4778,32.06851141186592,1,1,203,0.004901960784313725,0.004901960784313725,0.9950980392156863,204,6450,4500,1950,0.6976744186046512,84,45,39,236.09367767642374,0.433064389548923,0.8048560106920437,0.14651098668630025,1070333.5607200507,3289.79733817986,1073623.3580582305,4776,0,1669.4754901960785,63,141,40,35.53425937591872,0.6246693121693121,41.63411458333335,8285.409344921245,131.51443404636896,0
4779,32.52345626473936,2,0,205,0.00975609756097561,0.0,1.0,205,6200,4300,1900,0.6935483870967742,81,43,38,231.4800542856009,0.43360931771082417,0.8025532836909652,0.14481440224573472,1087948.9931503201,3167.6983988803477,1091116.6915492006,4777,0,1662.3073170731707,67,138,40,35.357627578718805,0.6251554726368159,41.34497549019609,8412.355377299722,125.55754294477197,0
4780,32.05784687771882,0,0,205,0.0,0.0,1.0,205,4850,3100,1750,0.6391752577319587,66,31,35,232.71801427508453,0.43360533237685317,0.804227719284059,0.1460279605176352,1073263.1258499124,4103.532688492502,1077366.6585384049,4778,1,1663.3073170731707,67,138,40,35.21588128502644,0.6262437810945274,41.23774509803923,8295.360745380332,123.81135440866167,0
4781,31.95409870778927,0,2,203,0.0,0.00975609756097561,0.9902439024390244,205,6100,5000,1100,0.819672131147541,72,50,22,206.8531777824494,0.4335405706998246,0.7825112534636232,0.12457424904070966,1057562.766959238,-3347.9561900166627,1054214.8107692215,4779,2,1664.3073170731707,83,122,42,37.39883075464724,0.6037901606425703,42.720734126984105,8221.127057173851,99.04972358040784,8
4782,31.82560516351071,1,2,202,0.004901960784313725,0.00980392156862745,0.9901960784313726,204,5550,3900,1650,0.7027027027027027,72,39,33,207.27297336430223,0.43233392494929007,0.7825154738478275,0.12537121212076555,1054613.3472647695,-2631.431152550353,1051981.9161122192,4780,0,1673.4313725490197,70,134,40,37.225617864402246,0.6111607142857143,42.561619718309856,8193.132244778788,117.04474635398269,0
4783,31.718992595442565,1,0,203,0.0049261083743842365,0.0,1.0,203,5850,4100,1750,0.7008547008547008,76,41,35,204.8078378742891,0.4320292558812531,0.7795080780534958,0.12472429408272565,1053101.9098713743,-3313.294955591887,1049788.6149157824,4781,0,1681.9704433497536,73,130,38,37.036581812884684,0.6121575342465753,42.314189189189186,8173.534325058715,111.9662236309413,0
4784,31.49517147524585,2,2,203,0.00975609756097561,0.00975609756097561,0.9902439024390244,205,5400,3600,1800,0.6666666666666666,72,36,36,201.33392341965543,0.4333114139964929,0.7773182856103635,0.12335535307996062,1047458.4764350046,-4222.215064033408,1043236.2613709712,4782,0,1666.551219512195,77,128,33,36.90149475283073,0.6125541125541125,42.09401709401707,8122.793156115695,105.49082020929474,0
4785,31.177759177735172,0,0,203,0.0,0.0,1.0,203,5400,3900,1500,0.7222222222222222,69,39,30,206.27929971247218,0.4316797135378563,0.7808423187007298,0.1264964157045567,1037157.6212394957,-3211.1704398529796,1033946.4507996427,4783,2,1683.9704433497536,78,125,35,36.741514160106334,0.6124465811965811,42.06223628691981,8041.921479889924,103.1015574344862,0
4786,31.66379441944756,1,0,204,0.004901960784313725,0.0,1.0,204,6050,4800,1250,0.7933884297520661,73,48,25,206.16696417144217,0.4321176027882417,0.7814358426625538,0.12720758328752346,1055139.6219535877,-3343.0134729655156,1051796.6084806223,4784,0,1676.7107843137255,83,121,37,36.51787715758795,0.6127008032128514,41.84027777777774,8174.316371826045,98.4857394195909,0
4787,31.44034010661077,3,0,207,0.014492753623188406,0.0,1.0,207,6850,5200,1650,0.7591240875912408,85,52,33,202.92407416344307,0.43377616747181963,0.7817360809452989,0.1262256529118369,1050056.5286201423,-5633.650222095548,1044422.8783980467,4785,0,1653.3961352657004,70,137,40,36.30470878746598,0.6214285714285714,41.5492957746479,8125.77804163816,116.08254345197372,0
4788,31.645300285542778,0,1,206,0.0,0.004830917874396135,0.9951690821256038,207,5550,3600,1950,0.6486486486486487,75,36,39,201.78033677506096,0.43382990947891753,0.7799916674319551,0.12617707963147085,1058441.542907548,-4235.461803079787,1054206.081104468,4786,1,1654.3961352657004,74,133,42,36.142286900798354,0.6213400900900901,41.36111111111113,8184.705304408062,110.60412573524408,0
4789,31.684397790957387,2,1,207,0.009615384615384616,0.004807692307692308,0.9951923076923077,208,5650,3900,1750,0.6902654867256637,74,39,35,196.8280153576126,0.43453099838969406,0.7754409194402321,0.12371236354321438,1061243.7922206519,-5473.498113324381,1055770.2941073275,4787,0,1647.389423076923,78,130,42,36.08447110567699,0.6213942307692308,41.17879746835444,8200.593937746624,105.1358197147003,0
4790,31.864232058788044,2,2,207,0.009569377990430622,0.009569377990430622,0.9904306220095693,209,5700,4100,1600,0.7192982456140351,73,41,32,196.20719064016157,0.43492362900257636,0.7733872379201499,0.12419147876832619,1069321.058678055,-5538.303836882949,1063782.754841172,4788,0,1635.9760765550238,81,128,34,35.84673596809522,0.6226851851851851,40.9298780487805,8255.070485352211,101.91445043644705,0
4791,32.281994660237324,1,1,207,0.004807692307692308,0.004807692307692308,0.9951923076923077,208,5750,4300,1450,0.7478260869565218,72,43,29,199.9111277284088,0.4346205135946984,0.7779307890740057,0.12712329693215402,1084707.751161773,-3980.970041900453,1080726.7811198726,4789,0,1644.8365384615386,80,128,35,35.584093990805975,0.6247395833333333,40.76646090534981,8368.575724807964,104.60719656009955,0
4792,32.43630202367441,1,0,208,0.004807692307692308,0.0,1.0,208,5200,3800,1400,0.7307692307692307,66,38,28,201.41020936035025,0.4348580917874396,0.7801593126632311,0.12826782475051893,1090334.450815531,-2879.101997688029,1087455.348817843,4790,0,1645.8125,81,127,37,35.49163645419956,0.6248713991769548,40.71392276422766,8410.28151175333,103.83063594757198,0
4793,32.848967893133526,0,1,207,0.0,0.004807692307692308,0.9951923076923077,208,7400,5700,1700,0.7702702702702703,91,57,34,207.48963631578707,0.43485180152979064,0.7873903745792539,0.13286804217548204,1105851.2724788017,-3109.464330804676,1102741.808147997,4791,1,1646.8125,69,139,36,35.13690954101429,0.632397342995169,40.52083333333333,8523.62281477037,123.53076543145463,0
4794,32.61517679593351,0,1,206,0.0,0.004830917874396135,0.9951690821256038,207,6600,4600,2000,0.696969696969697,86,46,40,207.99981404003213,0.43482267091912513,0.7878027960843692,0.13383422378131365,1099399.3776932298,-2265.0267768161525,1097134.3509164136,4792,2,1655.7391304347825,68,139,42,34.952613524042086,0.6346507352941176,40.35326086956522,8468.424301226763,124.53565148862887,0
4795,32.65065094414233,0,0,206,0.0,0.0,1.0,206,4900,3400,1500,0.6938775510204082,64,34,30,207.5941734034337,0.4349657628857842,0.7852178991167247,0.13402924787697396,1101603.2496470115,-362.71679419849715,1101240.532852813,4793,3,1660.4320388349515,71,135,40,34.84179197994988,0.6342429577464789,40.23437499999999,8481.516749161954,119.45798238256273,0
4796,32.145002025211426,0,0,206,0.0,0.0,1.0,206,6100,3800,2300,0.6229508196721312,84,38,46,208.43058031827462,0.4347970439655853,0.786353127686988,0.13504611025744356,1085571.0440406972,-2046.7594627765034,1083524.2845779206,4794,4,1661.4320388349515,72,134,41,34.69442614249895,0.6349826388888888,40.111301369863014,8354.122743795317,116.02948255271274,0
4797,32.0658750433865,0,0,206,0.0,0.0,1.0,206,6300,4500,1800,0.7142857142857143,81,45,36,204.97036280399345,0.4344679927381798,0.7836204061087593,0.1336429909630273,1084718.6823909439,-3032.9636260116877,1081685.7187649321,4795,5,1662.4320388349515,73,133,39,34.56159577154812,0.6367009132420092,39.89301801801802,8340.557982146624,114.25421893351539,0
4798,32.11198622511352,0,0,206,0.0,0.0,1.0,206,5700,4200,1500,0.7368421052631579,72,42,30,205.56847857118694,0.4342825005919962,0.7848649055467756,0.13457064880794384,1087433.7473855047,-2191.579800599564,1085242.1675849052,4796,6,1663.4320388349515,78,128,41,34.404924760601915,0.6358173076923077,39.75474683544303,8356.991984771412,107.14092288168477,0
4799,32.55139568771794,0,0,206,0.0,0.0,1.0,206,6650,5100,1550,0.7669172932330827,82,51,31,205.689251461575,0.43413548819954223,0.7849192706865473,0.13517193290182375,1103443.3711436107,-2456.711791846924,1100986.6593517638,4797,7,1664.4320388349515,81,125,43,34.265736042672906,0.6359310699588477,39.621443089430876,8475.685434592871,104.63809178509717,0
4800,32.654867495807665,0,1,205,0.0,0.0048543689320388345,0.9951456310679612,206,5550,3700,1850,0.6666666666666666,74,37,37,201.6016571623533,0.4340294222116978,0.7800886400057729,0.13303012360579372,1108148.4824718481,-2069.0859103457137,1106079.3965615025,4798,8,1665.4320388349515,70,136,43,34.2285202079931,0.6424107142857143,39.480633802816904,8507.225383260817,121.53179118944024,0
4801,32.291539097679106,2,0,207,0.00966183574879227,0.0,1.0,207,5450,3900,1550,0.7155963302752294,70,39,31,195.76939125242683,0.43471518690492944,0.7741761117137365,0.12975152423809744,1097086.8346121146,-3894.795647386851,1093192.0389647277,4799,0,1656.231884057971,73,134,45,34.22683335133382,0.6424086757990868,39.32995495495496,8417.436951165851,115.30735549542263,0
4802,31.93289634864587,0,0,207,0.0,0.0,1.0,207,5350,3600,1750,0.6728971962616822,71,36,35,195.47750327466284,0.434323358816816,0.7732494904534277,0.1300540535772824,1085987.8102298097,-4292.762853911892,1081695.0473758979,4800,1,1657.231884057971,75,132,45,34.10149954453085,0.6427777777777778,39.19956140350876,8328.11337338311,111.04151164510813,0
4803,31.444906008446214,0,0,207,0.0,0.0,1.0,207,5650,4200,1450,0.7433628318584071,71,42,29,197.46443957697505,0.4340497631443178,0.7749255244976869,0.13161793253932963,1069905.9219116399,-4796.3253459261905,1065109.5965657136,4801,2,1658.231884057971,76,131,45,33.98578627115423,0.6429550438596492,39.13690476190476,8202.815510834249,107.93178303729275,0
4804,31.66575939607574,0,0,207,0.0,0.0,1.0,207,5350,3700,1650,0.6915887850467289,70,37,33,196.67051950973058,0.43385433766396203,0.7739383823861528,0.1316641569542246,1078649.9901920536,-4322.269211952442,1074327.7209801013,4802,3,1659.231884057971,76,131,49,33.85476054732039,0.6444627192982456,38.98809523809525,8265.14017570194,108.75184441713078,0
4805,31.80283646760506,0,1,206,0.0,0.004830917874396135,0.9951690821256038,207,6200,4600,1600,0.7419354838709677,78,46,32,197.59365097329078,0.4337830073636321,0.775606434371465,0.1326700227963524,1084142.990076228,-4756.045682747536,1079386.9443934804,4803,4,1660.231884057971,77,130,38,33.729499113475114,0.645021645021645,38.888888888888886,8304.073966541322,107.8451164485886,0
4806,32.1380286584218,0,0,206,0.0,0.0,1.0,206,5200,2800,2400,0.5384615384615384,76,28,48,195.8770976168127,0.4332958402399558,0.7720105900095509,0.13190393811382764,1096402.1841238588,-3447.9844706169474,1092954.1996532418,4804,5,1669.0776699029127,83,123,38,33.67317065451325,0.643574297188755,38.78968253968253,8394.784668415114,101.1419839568086,0
4807,32.33786762055614,0,1,205,0.0,0.0048543689320388345,0.9951456310679612,206,6150,4200,1950,0.6829268292682927,81,42,39,195.48343775195667,0.43304078853895334,0.7727485914659133,0.13207510367896683,1104162.7184722126,-4180.895191101246,1099981.8232811112,4805,6,1670.0776699029127,83,123,40,33.56966457868681,0.6447038152610443,38.67807539682539,8450.593804166396,101.81438318272767,0
4808,32.64171136440892,0,2,203,0.0,0.00975609756097561,0.9902439024390244,205,4650,3200,1450,0.6881720430107527,61,32,29,193.57482725271495,0.43309222062808866,0.7686780742498269,0.13117668461315257,1115394.6707913515,-2467.5338565931393,1112927.1369347584,4806,7,1676.2487804878049,86,119,40,33.517106347897744,0.6446220930232558,38.57758620689655,8533.274975221551,99.22412761885525,0
4809,32.642751396906895,0,1,202,0.0,0.0049261083743842365,0.9950738916256158,203,4700,3100,1600,0.6595744680851063,63,31,32,196.97686423536652,0.43224873595733954,0.7712725403600005,0.13368163186106868,1115858.5404150388,-1340.3367557585057,1114518.2036592802,4807,8,1693.3399014778324,72,131,41,33.37699192316088,0.6510416666666667,38.52739726027397,8535.18516833507,118.5442384490982,0
4810,32.77535269645555,0,1,201,0.0,0.0049504950495049506,0.995049504950495,202,5850,4000,1850,0.6837606837606838,77,40,37,198.32357233233571,0.43152430914733264,0.7725904288298433,0.13533181213338652,1121958.5183532117,-1747.835726299401,1120210.6826269124,4808,9,1702.3910891089108,73,129,40,33.155351122588044,0.6523972602739726,38.34459459459459,8575.848197096208,117.47737256296175,0
4811,32.9574677719576,0,1,200,0.0,0.004975124378109453,0.9950248756218906,201,6000,4100,1900,0.6833333333333333,79,41,38,199.994708472545,0.43155161691542293,0.7735639827981935,0.13695586006156768,1129211.9025257835,-1032.7189501257694,1128179.1835756577,4809,10,1700.3681592039802,75,126,43,32.99109246557411,0.6526388888888889,38.22642543859648,8627.394147157565,115.03192196210087,0
4812,32.89178900700125,0,0,200,0.0,0.0,1.0,200,6150,4600,1550,0.7479674796747967,77,46,31,200.02458597561076,0.4311809045226131,0.7722698349572481,0.1376092534707724,1128283.6995193358,-1013.1040281229361,1127270.5954912128,4810,11,1696.525,79,121,42,32.83373102671173,0.6524261603375527,38.072916666666664,8615.250360219228,109.0538020280915,0
4813,32.49854733406733,0,0,200,0.0,0.0,1.0,200,5850,4400,1450,0.7521367521367521,73,44,29,203.26083480748355,0.4307993090452262,0.7756557055214743,0.1402451577786133,1115621.0086657957,-497.5884899650223,1115123.4201758306,4811,12,1697.525,80,120,44,32.64989775051123,0.6529947916666667,37.97582304526747,8515.40511743335,106.44256396791688,0
4814,32.149114019509575,0,0,200,0.0,0.0,1.0,200,6500,4800,1700,0.7384615384615385,82,48,34,205.2443672037148,0.4304208542713568,0.777321283217622,0.1419850483289021,1104356.576179396,-1167.4066709601002,1103189.1695084358,4812,13,1698.525,82,118,38,32.50937674567071,0.6530741869918699,37.889056224899576,8426.634617186906,102.76383679496227,0
4815,31.830687409039005,0,0,200,0.0,0.0,1.0,200,5650,4300,1350,0.7610619469026548,70,43,27,202.34266975747545,0.43040829145728643,0.7749721026998906,0.14062915289848277,1094698.8408120598,-1349.142793934996,1093349.6980181248,4813,14,1699.525,83,117,39,32.42888749665069,0.6542419678714859,37.73561507936506,8348.055654932574,100.57898379436836,0
4816,32.15350776032079,1,2,199,0.004975124378109453,0.009950248756218905,0.9900497512437811,201,4850,3300,1550,0.6804123711340206,64,33,31,197.36403948672546,0.4301295605306799,0.7606136813440296,0.13285646416455327,1096826.110448281,-1755.1936454830752,1095070.916802798,4814,0,1692.0646766169154,87,114,35,33.64697573944832,0.6420019157088123,38.802083333333314,8398.429240521235,96.53366943127855,8
4817,31.984795568988954,1,1,199,0.005,0.005,0.995,200,5200,3500,1700,0.6730769230769231,69,35,34,199.60833010861126,0.43015912897822445,0.7611025685450703,0.13518209202750014,1092774.2900679202,-1574.6297547841286,1091199.6603131362,4815,0,1699.38,91,109,39,33.38048288358527,0.642742673992674,38.59827898550723,8360.880608030382,91.87780887945475,0
4818,31.574074130641748,0,0,199,0.0,0.0,1.0,199,5650,4200,1450,0.7433628318584071,71,42,29,200.2017858756131,0.430149484797726,0.7624834748982585,0.1359249557403607,1079438.44312226,-2228.899188826016,1077209.543933434,4816,1,1706.3316582914572,74,125,41,33.27889024627751,0.650197072072072,38.51388888888892,8256.181856355524,111.57002508588546,0
4819,32.02494352787675,0,0,199,0.0,0.0,1.0,199,5500,3500,2000,0.6363636363636364,75,35,40,203.42223741007663,0.43012833527908906,0.7671049902009583,0.13225901075552196,1082518.513618672,-1258.332384371468,1081260.1812343006,4817,2,1707.3316582914572,91,108,37,34.70177959705046,0.6286630036630036,39.99094202898553,8326.77539825824,91.50302635448615,8
4820,32.0382554738332,0,0,199,0.0,0.0,1.0,199,5750,4200,1550,0.7304347826086957,73,42,31,204.60351495698617,0.42985656396460414,0.7699332877825837,0.1335834616364752,1084172.1323510737,-1184.9141805114377,1082987.2181705623,4818,3,1708.3316582914572,94,105,39,34.52365899575712,0.6292109929078014,39.84649122807021,8334.86457644929,88.66877208988606,0
4821,31.910598735239645,0,0,199,0.0,0.0,1.0,199,5650,4500,1150,0.7964601769911505,68,45,23,207.22012324310055,0.429760333654806,0.7749397476089555,0.13572231913074725,1080762.698944309,-658.8440656424373,1080103.8548786666,4819,4,1709.3316582914572,94,105,39,34.343665739804536,0.6303191489361701,39.736842105263186,8305.153197145348,88.35269358665263,0
4822,32.17357295924177,0,0,199,0.0,0.0,1.0,199,5000,3800,1200,0.76,62,38,24,205.71079643710436,0.4297867705531022,0.7735807365925571,0.1350374593410537,1090318.7316443776,58.06693137228558,1090376.7985757499,4820,5,1710.3316582914572,95,104,39,34.30379867739207,0.630811403508772,39.659288194444485,8376.090885537102,88.16937774249581,0
4823,31.770850200685427,0,2,197,0.0,0.010050251256281407,0.9899497487437185,199,5100,3400,1700,0.6666666666666666,68,34,34,206.0799999999972,0.429600654789097,0.7756381909547707,0.135578947368421,1077299.3367745585,-498.03053549979813,1076801.3062390587,4821,6,1711.3316582914572,96,103,40,34.216666666666704,0.6312934027777778,39.58333333333337,8273.65890642861,86.18394694196469,0
4824,31.840835336021268,0,1,196,0.0,0.005076142131979695,0.9949238578680203,197,5200,4200,1000,0.8076923076923077,62,42,20,203.08791737042304,0.42839661245208743,0.7703045685279186,0.1342701259414743,1081073.5325290575,-689.4055508772985,1080384.1269781801,4822,8,1726.197969543147,73,124,38,34.12223602708152,0.6415525114155252,39.41441441441442,8297.262721571331,113.66113317221001,0
4825,31.78412451329677,0,0,196,0.0,0.0,1.0,196,5400,4000,1400,0.7407407407407407,68,40,28,203.26602911761455,0.4283610238967382,0.7678008111762054,0.13480194818051028,1080019.5881316157,-693.7413902488775,1079325.8467413667,4823,24,1735.9642857142858,75,121,41,34.0102523659306,0.6416666666666666,39.309210526315795,8285.828512101229,110.47771349468304,0
4826,32.00990189277084,0,0,196,0.0,0.0,1.0,196,5750,4500,1250,0.782608695652174,70,45,25,201.3010823476107,0.42802252311180883,0.7652261826389537,0.1339948922375205,1088747.4793048867,-1116.7908025384745,1087630.6885023483,4824,25,1736.9642857142858,77,119,39,33.93241167434717,0.6420454545454546,39.18269230769232,8348.736431167426,108.42514845671982,0
4827,31.820880789341974,0,0,196,0.0,0.0,1.0,196,4950,3300,1650,0.6666666666666666,66,33,33,181.98445900892213,0.4279096895168324,0.7387797148787969,0.12193117414852228,1084162.3797272258,-4689.859169503568,1079472.520557722,4825,26,1737.9642857142858,91,105,40,34.21008638762373,0.6390796703296704,38.96059782608692,8306.503697897078,91.28026041645141,8
4828,31.97114827846046,0,0,196,0.0,0.0,1.0,196,6500,4500,2000,0.6923076923076923,85,45,40,184.02390607368324,0.42801489185417757,0.7444524613442258,0.11470353790216015,1068389.4153712983,-6378.161315118943,1062011.2540561794,4826,27,1738.9642857142858,81,115,40,36.718660426187064,0.6171553497942387,41.47611788617886,8265.305368584208,102.04080701955812,8
4829,32.24819777647344,1,1,196,0.005076142131979695,0.005076142131979695,0.9949238578680203,197,4950,3600,1350,0.7272727272727273,63,36,27,187.54357925108573,0.42846783383404125,0.7492587748788844,0.11734284056966816,1078779.7502390272,-3886.3568833162244,1074893.393355711,4827,0,1731.1319796954315,82,115,42,36.48936600355814,0.618140243902439,41.340361445783124,8341.3071808875,101.72325830350609,0
4830,31.90892913487432,0,0,196,0.0,0.0,1.0,196,4900,3800,1100,0.7755102040816326,60,38,22,185.44270384504594,0.4277336255014827,0.7450268439012506,0.11644853576138345,1068492.6935831713,-4471.1651726521795,1064021.5284105192,4828,1,1740.75,86,110,41,36.412645353320364,0.6179748062015504,41.211685823754785,8257.657977983388,96.01927881376032,0
4831,31.498626254401643,2,2,196,0.010101010101010102,0.010101010101010102,0.98989898989899,198,5100,3500,1600,0.6862745098039216,67,35,32,179.22373588981583,0.42842020031106326,0.737103599106167,0.1131404297067792,1056284.4081809768,-6837.752440728807,1049446.655740248,4829,0,1724.1565656565656,93,105,33,36.38247040365137,0.6176075268817205,41.02393617021274,8157.390243410468,87.7138735850588,0
4832,31.124255367903356,0,1,195,0.0,0.00510204081632653,0.9948979591836735,196,6250,4800,1450,0.768,77,48,29,181.38341867311559,0.42746380603523465,0.7379964307105598,0.11464726955287634,1044087.4617127407,-7573.96936016183,1036513.4923525789,4830,3,1742.75,93,103,34,36.28140954336727,0.6180555555555556,40.97960992907799,8061.81676606124,86.68620178560472,0
4833,31.30399055022318,0,0,195,0.0,0.0,1.0,195,5700,3900,1800,0.6842105263157895,75,39,36,180.89227909564917,0.4273074720239669,0.737633257049849,0.11482520420027272,1051338.0684870016,-6664.2121382739,1044673.8563487277,4831,4,1750.9641025641026,96,99,36,36.1408351979227,0.6187065972222222,40.82903780068727,8113.085351579481,84.5113057456196,0
4834,31.408472120991533,0,0,195,0.0,0.0,1.0,195,6150,4400,1750,0.7154471544715447,79,44,35,183.061739781011,0.42715547625341443,0.7416514822848894,0.11300410021296935,1046767.6948658128,-6825.376926261447,1039942.3179395513,4832,5,1751.9641025641026,92,103,43,37.097252349963824,0.6098278985507246,41.82347670250894,8108.930134283711,88.14054493786642,7
4835,31.648013641369687,0,0,195,0.0,0.0,1.0,195,6150,4300,1850,0.6991869918699187,80,43,37,181.49887768280595,0.42698475636619965,0.7394870034416905,0.11225185364968356,1055308.0024064335,-6842.556390710031,1048465.4460157234,4833,6,1752.9641025641026,93,102,43,37.068207174733935,0.6102150537634409,41.755319148936145,8172.9311823855605,87.88098045575872,0
4836,32.12409736610414,1,0,196,0.00510204081632653,0.0,1.0,196,6500,4700,1800,0.7230769230769231,83,47,36,183.18828091479847,0.42753684807256237,0.7417536543033167,0.11390729948611994,1072783.2904053915,-6395.734647302719,1066387.5557580888,4834,0,1745.015306122449,79,117,42,36.82822786510819,0.6170886075949367,41.56250000000003,8302.071413052607,105.08951155762793,0
4837,32.5696087648852,0,1,195,0.0,0.00510204081632653,0.9948979591836735,196,4650,3100,1550,0.6666666666666666,62,31,31,182.54511551168986,0.4275951726844584,0.7406547397615744,0.1138627255902372,1088602.2821002488,-4106.194133544002,1084496.0879667047,4835,1,1746.015306122449,81,115,46,36.731020406492085,0.6174125514403292,41.45071138211384,8420.849176723981,103.96110094720964,0
4838,32.48043201106553,0,0,195,0.0,0.0,1.0,195,5600,3900,1700,0.6964285714285714,73,39,34,186.88224028727362,0.4270200017622698,0.7474973241906337,0.11845842271009395,1090425.0380961432,-3843.7852030511494,1086581.252893092,4836,2,1754.8051282051283,85,110,41,36.036855903021234,0.6216911764705882,40.8793604651163,8416.350315076668,99.0158860597255,8
4839,32.11190019684467,0,1,194,0.0,0.005128205128205128,0.9948717948717949,195,5600,4000,1600,0.7142857142857143,72,40,32,190.88750753901897,0.42663230240549826,0.7531750993352657,0.12146479343752555,1079184.6230186312,-3399.427427507198,1075785.195591124,4837,3,1755.8051282051283,87,108,41,35.79448604389251,0.6223659003831418,40.74337121212124,8325.222989006847,95.69221826444651,0
4840,32.176469689649466,0,1,193,0.0,0.005154639175257732,0.9948453608247423,194,5300,3600,1700,0.6792452830188679,70,36,34,188.8736220919525,0.4261402079660987,0.7497138832144452,0.12063755103258939,1082461.376137978,-3210.319822836367,1079251.0563151415,4838,4,1765.8041237113403,72,122,43,35.71155150915025,0.6299189814814814,40.610730593607286,8346.230964875067,115.91987451215371,0
4841,31.717463459102166,0,0,193,0.0,0.0,1.0,193,5150,3600,1550,0.6990291262135923,67,36,31,187.41699438080573,0.4257666324841681,0.7471261339829547,0.12013332898817657,1068045.277434619,-3716.032848118071,1064329.2445865008,4839,5,1775.7512953367875,74,119,43,35.62237980554811,0.6302083333333333,40.4861111111111,8231.12228796281,111.23138226976769,0
4842,31.4726019349982,0,0,193,0.0,0.0,1.0,193,4750,3600,1150,0.7578947368421053,59,36,23,187.52322521491735,0.42553949877662633,0.7470325770260708,0.1205251920188575,1060568.7117523681,-3573.746922033412,1056994.9648303348,4840,6,1776.7512953367875,75,118,43,35.523742586628686,0.6306944444444444,40.39199561403507,8170.539381178688,108.9405250823825,0
4843,31.083323375342513,0,1,192,0.0,0.0051813471502590676,0.9948186528497409,193,4950,3700,1250,0.7474747474747475,62,37,25,189.5860676506413,0.4253697107081174,0.7495935841199264,0.12245614722822876,1048845.932628345,-3780.6848123247796,1045065.2478160202,4841,7,1777.7512953367875,76,117,45,35.29407297470881,0.6319901315789473,40.21915584415582,8074.8519856155035,106.24805244230926,0
4844,30.681053294129004,0,0,192,0.0,0.0,1.0,192,4500,3600,900,0.8,54,36,18,174.83658315904015,0.4248910385762071,0.7289615813845045,0.10551356158560558,1016035.1996878674,-7371.975463452365,1008663.224224415,4842,8,1787.328125,80,112,39,38.144509127856594,0.6057291666666667,42.64403292181067,7895.952141487963,98.69940176859953,8
4845,30.4218795425609,1,0,193,0.0051813471502590676,0.0,1.0,193,5700,4600,1100,0.8070175438596491,68,46,22,171.83347229922327,0.4248580976540011,0.725420391397146,0.10437112713284726,1009293.3318390966,-9613.924444327567,999679.407394769,4843,0,1779.062176165803,86,107,43,37.98272830095134,0.6058624031007752,42.40900383141759,7836.402256688792,91.12095647312549,0
4846,30.882162262635113,1,0,194,0.005154639175257732,0.0,1.0,194,6350,4500,1850,0.7086614173228346,82,45,37,169.80750633882602,0.4252538370457419,0.7243027826446755,0.10382041999934036,1026463.4540872434,-10289.760102701648,1016173.6939845418,4844,0,1770.8865979381444,90,104,41,37.79218833244537,0.6069444444444445,42.17032967032965,7962.337715242547,88.47041905825053,0
4847,30.525300406292647,1,1,194,0.005128205128205128,0.005128205128205128,0.9948717948717949,195,4800,3400,1400,0.7083333333333334,62,34,28,166.63587059280195,0.42619283637324873,0.7204283749898901,0.10229196548783477,1015748.2201946847,-9947.98220495415,1005800.2379897306,4845,0,1762.8,95,100,39,37.72594637223971,0.606907894736842,42.024739583333314,7874.772321610274,82.89234022747657,0
4848,30.694644339447592,1,0,195,0.005128205128205128,0.0,1.0,195,5600,4400,1200,0.7857142857142857,68,44,24,168.99942267496698,0.42661027403295443,0.7250824416178734,0.10427962926332812,1022857.7760734617,-10027.52527299686,1012830.2508004649,4846,0,1757.225641025641,102,93,42,37.475679346051905,0.6069240196078431,41.838592233009706,7924.172593578869,77.6879666037144,0
4849,31.13185318090203,1,0,196,0.00510204081632653,0.0,1.0,196,5100,3900,1200,0.7647058823529411,63,39,24,176.14049489863498,0.4271263954299669,0.7383662417611352,0.1091165849554073,1038570.0632694833,-7713.151013761206,1030856.9122557221,4847,0,1749.2551020408164,104,92,45,37.14665668087723,0.6078725961538461,41.69642857142858,8041.468861816946,77.32181597900909,0
4850,31.2699890583197,1,0,197,0.005076142131979695,0.0,1.0,197,5550,3600,1950,0.6486486486486487,75,36,39,175.04034390638648,0.4271772160640906,0.7368092258544574,0.10927778024636771,1045418.1725134554,-8351.928711451403,1037066.243802004,4848,0,1741.3705583756346,79,118,46,36.89306485724361,0.618539029535865,41.419270833333364,8085.8165717340635,102.35210850296284,0
4851,30.876023737168044,0,0,197,0.0,0.0,1.0,197,5250,3300,1950,0.6285714285714286,72,33,39,174.69020737648142,0.42727541524223905,0.7350701013923231,0.10941626389095846,1033177.9434399873,-8552.786160732021,1024625.1572792552,4849,1,1742.3705583756346,82,115,42,36.783522534323,0.6185213414634146,41.302710843373525,7987.543640741104,97.40906878952566,0
4852,30.445523322205652,2,1,198,0.010050251256281407,0.005025125628140704,0.9949748743718593,199,5850,4300,1550,0.7350427350427351,74,43,31,172.7200192220313,0.42832851124308413,0.7343851665055343,0.10880565266199008,1020381.6311454313,-10401.93301095043,1009979.6981344809,4850,0,1725.8492462311558,87,112,34,36.626737381126595,0.6187739463601533,41.09848484848487,7882.392117699895,90.60220824942408,0
4853,30.12944695599281,0,1,197,0.0,0.005050505050505051,0.9949494949494949,198,5700,4100,1600,0.7192982456140351,73,41,32,171.52874377966484,0.42817664803705413,0.730031918596068,0.10833470786219558,1010502.52519592,-10633.954253392658,999868.5709425274,4851,1,1735.5656565656566,89,109,34,36.564469097734296,0.6190308988764045,41.00694444444447,7803.317529331679,87.67772504867055,0
4854,30.48556144384413,1,1,197,0.005050505050505051,0.005050505050505051,0.9949494949494949,198,5350,3800,1550,0.7102803738317757,69,38,31,173.45451479237485,0.4283347433728144,0.7327680122486222,0.11013340224141867,1023925.8880033129,-9429.086382606387,1014496.8016207065,4852,0,1736.1818181818182,90,108,37,36.3239959661985,0.6206018518518519,40.8195970695971,7901.260098575162,87.79177887305735,0
4855,30.925388225817656,2,1,198,0.010050251256281407,0.005025125628140704,0.9949748743718593,199,5500,3700,1800,0.6727272727272727,73,37,36,175.76188863283332,0.42892069776491887,0.7389022431096088,0.11211328796939901,1039997.6938125256,-8741.608232343473,1031256.0855801821,4853,0,1728.4221105527638,95,104,40,36.09930023848375,0.6207236842105264,40.65755208333336,8020.265885256882,84.42385142375666,0
4856,30.85092811666116,0,0,198,0.0,0.0,1.0,198,5650,4000,1650,0.7079646017699115,73,40,33,194.8668347435542,0.42825302517561403,0.7610524106874468,0.12263527656475995,1033687.3478891968,-4963.723680474543,1028723.6242087223,4854,1,1736.141414141414,85,113,40,36.08927568781584,0.6191176470588236,41.13372093023256,7986.264967408955,93.95605844010535,8
4857,30.834935776366063,1,0,199,0.005025125628140704,0.0,1.0,199,5600,4200,1400,0.75,70,42,28,193.6231907819212,0.42847444292167913,0.7621491597594765,0.12266053521827015,1035020.1372910483,-5319.219698832975,1029700.9175922154,4855,0,1728.4120603015076,90,109,35,35.8829430822472,0.6197916666666667,40.89972527472528,7989.340330792664,88.77044811991848,0
4858,31.333136782705644,0,1,198,0.0,0.005025125628140704,0.9949748743718593,199,5000,3600,1400,0.72,64,36,28,195.5595822259575,0.42826717763903693,0.7651045723111449,0.12421614751155982,1052502.733968754,-3634.6010106785648,1048868.1329580755,4856,1,1729.4120603015076,91,108,37,35.73737550235891,0.6204212454212454,40.80615942028985,8121.35606011885,89.24567099031704,0
4859,31.431212072648655,0,1,197,0.0,0.005050505050505051,0.9949494949494949,198,5350,3500,1850,0.6542056074766355,72,35,37,194.8484355681977,0.427516493189082,0.7651098323554177,0.11378952645462206,1031062.3919848733,-4769.821189708479,1026292.5707951649,4857,2,1739.090909090909,84,114,43,38.86945201983959,0.5918898809523809,43.86029411764708,8050.78141581414,95.84263590254929,8
4860,30.970673560441668,1,0,198,0.005050505050505051,0.0,1.0,198,5700,4300,1400,0.7543859649122807,71,43,28,196.37538138426194,0.4278994470936095,0.7678063149229244,0.11545192208227645,1017940.9060167097,-5320.293270865675,1012620.6127458441,4858,0,1740.040404040404,66,132,44,38.57520768904253,0.6027462121212122,43.61007462686566,7940.56868291732,120.31164671086849,0
4861,31.312018241347676,3,0,201,0.014925373134328358,0.0,1.0,201,5650,3900,1750,0.6902654867256637,74,39,35,191.61452923535734,0.4303202736318408,0.7638481852948356,0.11374860523034482,1032048.33906885,-6298.908672238384,1025749.4303966117,4859,0,1715.0547263681592,72,129,48,38.33087867504028,0.6031539351851851,43.25057077625567,8039.342811309399,111.65753904596387,0
4862,31.336980604336485,2,3,200,0.009852216748768473,0.014778325123152709,0.9852216748768473,203,4600,3200,1400,0.6956521739130435,60,32,28,197.18402202953624,0.4312702206181209,0.7743363714325593,0.11879134985681844,1037238.4167154786,-4294.631437698636,1032943.78527778,4860,0,1699.1477832512314,74,129,44,37.634952766531704,0.6076858108108107,42.70833333333334,8062.743967990767,108.95599956744279,8
4863,31.49301258789264,0,1,199,0.0,0.005,0.995,200,5450,3600,1850,0.6605504587155964,73,36,37,201.69522871305162,0.42940169597989947,0.7755953991880924,0.11924221921515529,1036783.5845577973,-3627.1395573357527,1033156.4450004615,4861,1,1725.625,71,129,44,38.22733423545329,0.602112676056338,43.40277777777775,8081.019549462669,113.81717675299534,8
4864,31.072236438626927,0,0,199,0.0,0.0,1.0,199,5750,4000,1750,0.6956521739130435,75,40,35,202.18621718627946,0.42869016801177606,0.7748903557058267,0.12002615320827065,1024149.6520836375,-4136.211202513214,1020013.4408811243,4862,2,1735.2412060301508,74,125,45,38.0588688737423,0.6021959459459459,43.249999999999986,7977.796705617429,107.80806358942472,0
4865,31.0567214790903,1,0,200,0.005,0.0,1.0,200,5250,3600,1650,0.6857142857142857,69,36,33,200.26283481995924,0.4297356574539364,0.7739196776709156,0.11929562179504152,1024656.5519970383,-4209.87483604587,1020446.6771609924,4863,0,1727.56,77,123,39,37.97802400138637,0.6021374458874459,43.12232905982904,7977.778280586246,103.60751013748371,0
4866,31.554500705967406,1,0,201,0.004975124378109453,0.0,1.0,201,3950,2400,1550,0.6075949367088608,55,24,31,196.37494087219304,0.4303627694859038,0.7704004392102,0.11745790855906829,1042299.5991326105,-3213.6955698447737,1039085.9035627657,4864,0,1719.960199004975,82,119,41,37.924499511718714,0.6016260162601625,42.97188755020079,8110.393755750625,98.90724092378811,0
4867,31.118416726115544,1,0,202,0.0049504950495049506,0.0,1.0,202,5000,3200,1800,0.64,68,32,36,197.85764439392366,0.43080800617375176,0.7736532200832411,0.11888254728524515,1029228.3829862226,-4671.85931979586,1024556.5236664268,4865,0,1712.4405940594058,85,117,43,37.71643747449063,0.6022058823529413,42.80523255813953,8003.49395303217,94.15875238861376,0
4868,31.259650394793034,2,0,204,0.00980392156862745,0.0,1.0,204,5500,3600,1900,0.6545454545454545,74,36,38,196.26214382447642,0.431825819408223,0.7735710265487115,0.11893037768490596,1036401.0413395527,-5618.741952955908,1030782.2993865968,4866,0,1696.6421568627452,72,132,43,37.440430012191094,0.6108217592592593,42.49429223744292,8049.538399321273,111.79914443501768,0
4869,31.516268209808562,0,1,203,0.0,0.004901960784313725,0.9950980392156863,204,5250,3700,1550,0.7047619047619048,68,37,31,194.5806351542962,0.43167338774590297,0.7719818412971784,0.11854201955972415,1046485.5830210601,-5324.8341151894965,1041160.7489058706,4867,1,1697.6421568627452,73,131,45,37.285771835909784,0.6123002283105023,42.30011261261262,8121.738768538386,111.25669545942993,0
4870,31.80197712524556,0,2,201,0.0,0.009852216748768473,0.9901477832512315,203,5750,4100,1650,0.7130434782608696,74,41,33,193.19150117443948,0.43114828724251736,0.768458242249733,0.1181507971421834,1057120.304849512,-5504.668276828256,1051615.6365726837,4868,2,1706.9655172413793,75,128,45,37.17883974767882,0.6127777777777778,42.160087719298254,8199.818992326216,109.33091989768288,0
4871,32.1918012057223,1,1,201,0.0049504950495049506,0.0049504950495049506,0.995049504950495,202,5600,4000,1600,0.7142857142857143,72,40,32,197.59293947428316,0.43130931563305586,0.7730994490681407,0.12146653463514592,1071624.9365938157,-3650.8957528970063,1067974.0408409187,4869,0,1715.7227722772277,77,125,42,36.87540974414717,0.613771645021645,41.9738247863248,8306.327338351528,107.87438101755231,0
4872,32.493262159818016,0,0,201,0.0,0.0,1.0,201,5600,3600,2000,0.6428571428571429,76,36,40,198.97029609412294,0.43126658374792703,0.7738393983958594,0.12262122898823963,1082420.834908878,-2726.0811959461485,1079694.7537129319,4870,1,1725.2437810945273,76,125,42,36.747357617051,0.6151315789473684,41.88311688311691,8387.059550992062,110.35604672357977,0
4873,32.16487903403304,2,1,202,0.009852216748768473,0.0049261083743842365,0.9950738916256158,203,5500,4000,1500,0.7272727272727273,70,40,30,199.21922911709493,0.43274764668585086,0.7761668924298424,0.12361993789376242,1073530.3686732994,-3326.4215038228876,1070203.9471694767,4871,0,1709.2364532019703,68,135,45,36.48937517042574,0.6216299019607843,41.63647342995169,8310.231578931795,122.20928792546756,0
4874,31.881762030082406,0,2,200,0.0,0.009900990099009901,0.9900990099009901,202,5050,3500,1550,0.693069306930693,66,35,31,197.13500162981592,0.432442264748863,0.7726351693058051,0.12282598050627191,1065282.9221835327,-3449.0898798266667,1061833.832303706,4872,1,1718.2821782178219,70,132,45,36.39448543321982,0.6220238095238095,41.49061032863851,8241.734844044222,117.73906920063175,0
4875,31.792370260030804,2,1,201,0.009900990099009901,0.0049504950495049506,0.995049504950495,202,5850,4200,1650,0.717948717948718,75,42,33,195.4080014458896,0.4333494450191288,0.7709095684815284,0.1224660378228632,1064016.202949884,-4666.544055103757,1059349.6588947803,4873,0,1717.5445544554455,72,130,47,36.22582409501221,0.623119212962963,41.28139269406393,8225.277756629846,114.2399688420812,0
4876,31.992563478519,0,0,201,0.0,0.0,1.0,201,5350,3500,1850,0.6542056074766355,72,35,37,200.7661877550563,0.4326378524046435,0.7768346640191996,0.12620193601328009,1071598.9190752623,-2521.8340429641275,1069077.0850322982,4874,1,1727.039800995025,71,130,46,35.97843301658282,0.624706572769953,41.17476851851851,8280.482648013654,116.6265161692064,0
4877,32.27117531124268,1,1,201,0.0049504950495049506,0.0049504950495049506,0.995049504950495,202,5900,4200,1700,0.711864406779661,76,42,34,199.51366838432494,0.4331898674942121,0.7764998024899017,0.12603424417448814,1082391.3555267346,-3109.6260062758747,1079281.7295204587,4875,0,1719.4851485148515,74,128,44,35.832595988846016,0.625,41.0,8358.23440561185,112.94911358934934,0
4878,32.00231880327627,0,0,201,0.0,0.0,1.0,201,5950,3900,2050,0.6554621848739496,80,39,41,207.97885938204604,0.43310012437810946,0.7814760005952364,0.12150412325698863,1049914.488848377,-2477.996432126014,1047436.492416251,4876,1,1712.6616915422885,75,126,40,38.518480121996916,0.5956944444444445,43.84594298245615,8197.52379542807,109.30031727237426,8
4879,31.826434239557848,2,1,202,0.009852216748768473,0.0049261083743842365,0.9950738916256158,203,6050,4500,1550,0.743801652892562,76,45,31,205.26682935157572,0.4342992488904063,0.7811622506582718,0.12109478454354716,1047112.140558539,-3662.5221864016235,1043449.6183721373,4877,0,1696.7783251231526,69,134,42,38.216682136365364,0.6023550724637681,43.48214285714284,8164.048711629402,118.31954654535365,0
4880,31.44803196044379,3,3,202,0.014634146341463415,0.014634146341463415,0.9853658536585366,205,5500,4000,1500,0.7272727272727273,70,40,30,191.66244240934074,0.43664813486370163,0.7699661806771323,0.1141976190433303,1037632.9375302797,-6724.947373713882,1030907.9901565659,4878,0,1680.7365853658537,76,129,41,38.19064107290182,0.6026589912280702,43.11417748917746,8078.553556505162,106.29675732243635,8
4881,30.994191775219882,0,0,202,0.0,0.0,1.0,202,5650,4200,1450,0.7433628318584071,71,42,29,194.74068663257992,0.4347707625240136,0.7700561948086722,0.11621621621621596,1023125.2059287127,-6201.178977268959,1016924.0269514438,4879,1,1706.6930693069307,77,125,41,38.051801801801794,0.6028138528138528,43.05555555555552,7963.785386688358,103.42578424270594,0
4882,31.218095920833267,0,0,202,0.0,0.0,1.0,202,6550,4900,1650,0.7480916030534351,82,49,33,224.8633308653845,0.4347215038668046,0.799942435400232,0.12514765236356215,1009465.8952497218,-1551.627279828023,1007914.2679698938,4880,2,1707.6930693069307,66,136,39,39.97498522548958,0.5815972222222222,45.693407960199,7938.967583598717,120.28738763028359,7
4883,31.658576388959517,5,3,204,0.024154589371980676,0.014492753623188406,0.9855072463768116,207,5300,4100,1200,0.7735849056603774,65,41,24,225.03961409253273,0.4372840548442068,0.8038217245378374,0.12686932405242254,1027711.6525642992,-444.8332617062915,1027266.8193025929,4881,0,1667.4202898550725,71,136,37,39.46267696267693,0.5839201877934272,45.19675925925925,8066.707861145169,113.61560367810097,0
4884,31.739662140885464,3,0,207,0.014492753623188406,0.0,1.0,207,5600,4000,1600,0.7142857142857143,72,40,32,228.09361675531733,0.43754103935087474,0.8071430171423455,0.1292911126764494,1032026.9116681523,79.75017424179532,1032106.6618423942,4882,0,1668.4057971014493,73,134,41,39.17209464929713,0.5850456621004566,44.98873873873873,8093.971274553493,110.8763188294999,0
4885,31.63124586625134,5,2,210,0.02358490566037736,0.009433962264150943,0.9905660377358491,212,5700,4100,1600,0.7192982456140351,73,41,32,215.7784955142847,0.44038384154520255,0.8016938888631144,0.12396434459768592,1032629.5602002012,-3536.14941528462,1029093.4107849166,4883,0,1630.0330188679245,62,150,44,38.963887450929626,0.5964381720430108,44.47751322751322,8082.494603456473,130.36281618478182,0
4886,31.1696173075679,2,0,212,0.009433962264150943,0.0,1.0,212,5300,4100,1200,0.7735849056603774,65,41,24,211.26871572926657,0.4408165109243196,0.796516663988881,0.12219203451493475,1019583.5184015521,-4618.779897715656,1014964.7385038364,4884,0,1630.5471698113208,65,147,46,38.8197272615081,0.5971153846153846,44.22348484848482,7972.456093536015,122.65317066978484,0
4887,31.649501851410626,6,4,214,0.027522935779816515,0.01834862385321101,0.981651376146789,218,5000,3400,1600,0.68,66,34,32,202.88350831705233,0.44328723276821824,0.7921677896626589,0.11878702161129912,1039003.2733300339,-6440.674150780502,1032562.5991792533,4885,0,1586.6422018348624,73,145,46,38.565472266476235,0.5974600456621004,43.764076576576564,8109.739332787518,111.09231962722627,0
4888,32.080139385484394,2,0,216,0.009259259259259259,0.0,1.0,216,6750,4900,1850,0.725925925925926,86,49,37,212.00894757546584,0.44202734711455643,0.7981450235387233,0.12481851284409902,1054837.6042597964,-5222.997931570895,1049614.6063282255,4886,0,1602.3101851851852,64,152,44,38.120885930925255,0.6044921875,43.557692307692314,8226.704975104525,128.5422652360082,0
4889,32.128367957941265,1,0,217,0.004608294930875576,0.0,1.0,217,5700,3900,1800,0.6842105263157895,75,39,36,209.85813628133468,0.4425127652614212,0.7971764912465156,0.12452363801815682,1058820.5734465162,-4659.577560036053,1054160.9958864802,4887,0,1595.921658986175,68,149,47,37.87915539613472,0.6050857843137255,43.26690821256038,8248.415239926759,121.30022411656998,0
4890,31.82383772252699,0,1,216,0.0,0.004608294930875576,0.9953917050691244,217,6450,4700,1750,0.7286821705426356,82,47,35,209.25236382516982,0.4425892145986232,0.7975226352427325,0.12467220668239087,1050018.2846432969,-5906.238375748186,1044112.0462675487,4888,1,1596.921658986175,68,149,35,37.74058239304185,0.6066176470588236,43.1159420289855,8175.036574373763,120.22112609373181,0
4891,31.789723345619226,0,0,216,0.0,0.0,1.0,216,6400,4400,2000,0.6875,84,44,40,209.4826900144949,0.4422171080964685,0.7975449823074177,0.12489790210567954,1049106.2765187058,-5646.079016754355,1043460.1975019514,4889,2,1605.3055555555557,70,146,37,37.70796451754135,0.6058035714285714,43.089788732394354,8167.104540861743,116.67292201231061,0
4892,31.349772795711942,1,1,216,0.004608294930875576,0.004608294930875576,0.9953917050691244,217,6800,5100,1700,0.75,85,51,34,208.54464333007775,0.44234119872560734,0.7983965588670043,0.12509901707083845,1036396.1451643183,-6973.027111608131,1029423.1180527101,4890,0,1598.9032258064517,72,145,41,37.502890307066195,0.6070601851851851,42.86529680365295,8061.11452309827,111.95992393192041,0
4893,31.863433400712996,1,1,216,0.004608294930875576,0.004608294930875576,0.9953917050691244,217,5650,3300,2350,0.584070796460177,80,33,47,211.93594387713287,0.44297501706775905,0.800388066941548,0.12767848326256542,1054663.7415061307,-4345.768894181954,1050317.9726119486,4891,0,1599.8755760368663,65,152,44,37.25539811066124,0.6125,42.708333333333336,8198.195885391784,126.12609054448899,0
4894,32.14988355697176,3,2,217,0.0136986301369863,0.0091324200913242,0.9908675799086758,219,6650,5300,1350,0.7969924812030075,80,53,27,212.58434262335763,0.4440805091254381,0.8024454062493056,0.12945423275911844,1067394.3948226427,-5067.732851354432,1062326.6619712883,4892,0,1586.2237442922374,68,151,43,36.83785908176614,0.6147365196078431,42.315821256038646,8284.516341092254,121.83112266312139,0
4895,32.616717728470306,3,0,220,0.013636363636363636,0.0,1.0,220,5900,3900,2000,0.6610169491525424,79,39,40,209.15111085488874,0.4444855230386053,0.8000064650602277,0.12804768636351066,1084527.5816367527,-4533.970309581254,1079993.6113271716,4893,0,1579.7727272727273,70,150,50,36.72792095731164,0.615625,42.12147887323945,8411.15093182694,120.15929902609915,0
4896,32.63752815827395,1,2,219,0.004524886877828055,0.00904977375565611,0.9909502262443439,221,5750,4200,1550,0.7304347826086957,73,42,31,208.8546099569159,0.44476724256136024,0.8008146447889986,0.1284161139697691,1086525.7971390863,-4564.815686077807,1081960.9814530085,4894,0,1573.6199095022625,72,149,35,36.57717192943648,0.6161747685185186,41.96632420091324,8421.581359675625,116.96640777327258,0
4897,32.773957149264895,0,4,215,0.0,0.0182648401826484,0.9817351598173516,219,6650,4800,1850,0.7218045112781954,85,48,37,211.0276843519744,0.4438719226956,0.8026545150159752,0.13030404172722973,1092361.4093457975,-4346.300262059403,1088015.1090837382,4895,1,1588.9817351598174,70,149,36,36.36492783270827,0.61875,41.813380281690144,8461.797211161445,120.88281730230636,0
4898,32.96773637738937,1,1,215,0.004629629629629629,0.004629629629629629,0.9953703703703703,216,6600,4900,1700,0.7424242424242424,83,49,34,218.91644240857477,0.4427679981337927,0.8075863194684485,0.1356156890552473,1099815.801403077,-1646.4474904207218,1098169.3539126564,4896,0,1611.8287037037037,69,147,38,36.04173867957138,0.6204710144927537,41.696428571428555,8515.684048195273,123.41571084340976,0
4899,32.9160499610819,0,1,214,0.0,0.004651162790697674,0.9953488372093023,215,6650,4800,1850,0.7218045112781954,85,48,37,218.35553150424602,0.44248623487647615,0.806748010866722,0.13582544040152933,1099344.8650117451,-1640.3935387793495,1097704.4714729658,4897,1,1620.2558139534883,61,154,39,35.90563988385446,0.6268784153005464,41.54905913978495,8507.184081843474,139.46203412858154,0
4900,33.2162392045122,0,0,214,0.0,0.0,1.0,214,5150,3400,1750,0.6601941747572816,69,34,35,218.95870981069336,0.44216055679873634,0.8058730159694014,0.136713732360908,1110524.885513035,681.8192289203598,1111206.7047419555,4898,2,1628.7990654205607,61,153,45,35.7526990882117,0.6282445355191257,41.41465053763441,8589.232822524313,140.80709545121823,0
4901,32.858929404987656,0,1,213,0.0,0.004672897196261682,0.9953271028037384,214,5650,3900,1750,0.6902654867256637,74,39,35,219.89346767938085,0.4420238983224372,0.8067948834789049,0.13776928138603717,1099618.5666419107,-90.21205129594318,1099528.3545906148,4899,3,1629.7990654205607,63,151,42,35.60350477089229,0.6281415343915344,41.292317708333336,8500.857468949856,134.93424553888661,0
4902,33.04563376378405,0,1,212,0.0,0.004694835680751174,0.9953051643192489,213,6200,4400,1800,0.7096774193548387,80,44,36,213.26977495752442,0.4417722266513125,0.7995585914805414,0.12778096928940874,1092087.3472344694,-2218.15544426905,1089869.1917902003,4900,4,1621.4647887323943,82,131,41,37.42616548694169,0.6022611788617886,42.90913654618474,8495.73051770979,103.60646972816816,8
4903,33.43550424670943,1,2,211,0.004694835680751174,0.009389671361502348,0.9906103286384976,213,5400,3600,1800,0.6666666666666666,72,36,36,209.15088159538956,0.4417629993799274,0.7958871998087258,0.12571290538422425,1105977.6094979648,-1736.7615897476994,1104240.8479082172,4901,0,1621.2910798122066,86,127,43,37.41262064363964,0.6019864341085271,42.79214559386974,8599.874308283217,99.9985384684095,0
4904,32.908822116793,2,1,212,0.009389671361502348,0.004694835680751174,0.9953051643192489,213,5800,4300,1500,0.7413793103448276,73,43,30,206.86391613694337,0.4420693447899135,0.7933124084185754,0.12509349084855523,1090433.247189506,-3285.7416400907437,1087147.5055494152,4902,0,1614.8215962441313,67,146,45,37.245177526529794,0.6127176616915423,42.57046568627453,8471.702752339299,126.44332466178058,0
4905,33.02879544282428,2,0,214,0.009345794392523364,0.0,1.0,214,5900,4000,1900,0.6779661016949152,78,40,38,194.46095606563836,0.4428388216108698,0.7800406631297674,0.11872041809144218,1097363.4351299189,-6021.131450632326,1091342.3036792865,4903,0,1608.1822429906542,72,142,46,37.21042070301687,0.6135706018518519,42.223173515981756,8514.058071841098,118.25080655334858,0
4906,33.425289859621614,1,1,214,0.004651162790697674,0.004651162790697674,0.9953488372093023,215,5450,3300,2150,0.6055045871559633,76,33,43,195.77948381621022,0.4430757806273999,0.7827704752275013,0.12030724005499975,1112571.0604290643,-4886.282416068687,1107684.7780129956,4904,0,1601.6976744186047,77,138,39,36.93581780538301,0.6136363636363636,41.987179487179496,8624.153313139579,112.0019910797348,0
4907,32.89349549526276,1,1,214,0.004651162790697674,0.004651162790697674,0.9953488372093023,215,6800,5000,1800,0.7352941176470589,86,50,36,196.87714116562623,0.4426691661233065,0.784802745994349,0.121666269443925,1096596.4117840272,-6621.046687095245,1089975.365096932,4905,0,1602.6465116279069,79,136,44,36.70016850721933,0.6148470464135021,41.783854166666686,8493.631629772912,107.51432442750522,0
4908,33.011780521801,0,0,214,0.0,0.0,1.0,214,5100,3700,1400,0.7254901960784313,65,37,28,199.50913928188,0.44206229067029384,0.7868437413765019,0.12380136656100758,1101800.2177688156,-3936.157378471197,1097864.0603903444,4906,1,1611.1261682242991,67,147,46,36.48143207241391,0.6222014925373134,41.6360294117647,8529.054691799867,127.29932375820697,0
4909,32.65604303631398,0,1,213,0.0,0.004672897196261682,0.9953271028037384,214,6550,4900,1650,0.7480916030534351,82,49,33,201.08269106807114,0.4418758135521332,0.7867331183143949,0.12556928075587856,1091836.5533696373,-5440.113528389067,1086396.4398412483,4907,2,1612.1261682242991,72,142,43,36.21001637052569,0.6218171296296297,41.409817351598186,8444.532133334531,117.28516851853516,0
4910,32.734145634014006,0,0,213,0.0,0.0,1.0,213,5400,3800,1600,0.7037037037037037,70,38,32,202.54071660266686,0.44164119939764374,0.7871259324742228,0.12693625069903092,1095535.2199109173,-3621.9022991564016,1091913.317611761,4908,3,1620.5352112676057,72,141,43,36.0412874818451,0.623119212962963,41.28139269406394,8468.93256978182,117.62406346919195,0
4911,33.00911424114822,0,1,212,0.0,0.004694835680751174,0.9953051643192489,213,5450,3800,1650,0.6972477064220184,71,38,33,207.0284831606267,0.4413966767059379,0.7906180908358207,0.1304804385880367,1106444.4987587724,-2236.894744110217,1104207.604014662,4909,4,1621.5352112676057,72,141,45,35.72127307798296,0.6251446759259259,41.081621004566216,8546.666351393196,118.7036993249055,0
4912,33.294971865950416,0,1,211,0.0,0.0047169811320754715,0.9952830188679245,212,5600,3900,1700,0.6964285714285714,73,39,34,206.67184149076567,0.4407624854690155,0.789540295136886,0.13036058072759568,1116272.3019266303,-1859.5895511374279,1114412.7123754928,4910,5,1630.061320754717,72,140,48,35.70137855660255,0.6254340277777778,41.053082191780824,8621.630343199235,119.74486587776715,0
4913,33.35502466326467,0,0,211,0.0,0.0,1.0,211,4950,3400,1550,0.6868686868686869,65,34,31,208.20906174279585,0.440157413676371,0.78938920082211,0.1318752921692327,1119551.819974281,-529.8331981431338,1119021.9867761377,4911,6,1638.7203791469194,73,138,40,35.511970734180906,0.6264269406392694,40.906531531531535,8642.069030856559,118.38450727200765,0
4914,33.535897966346866,3,0,214,0.014018691588785047,0.0,1.0,214,5200,3900,1300,0.75,65,39,26,202.14028743316308,0.441304498851886,0.7861867413015524,0.12887456831939154,1127633.6947422235,-2411.9601650971754,1125221.7345771263,4912,0,1616.733644859813,82,132,45,35.43320185839422,0.6248729674796748,40.675200803212874,8696.69000600691,106.0571951952062,0
4915,33.87884735435085,1,1,214,0.004651162790697674,0.004651162790697674,0.9953488372093023,215,5800,4200,1600,0.7241379310344828,74,42,32,197.49186410368316,0.4413325001811201,0.7820690416837588,0.12656652508209928,1140766.9385176154,-3741.562160860988,1137025.3763567545,4913,0,1610.2093023255813,70,145,46,35.367904794210766,0.6321428571428571,40.492957746478865,8791.7994718861,125.59713531265857,0
4916,33.30065562649736,1,0,215,0.004651162790697674,0.0,1.0,215,6100,4300,1800,0.7049180327868853,79,43,36,182.76434695296325,0.44129718177207855,0.7640868585880549,0.11262494050452157,1109292.3774238124,-8552.18061204772,1100740.1968117647,4914,0,1611.0,94,121,40,37.16856060606059,0.6085992907801419,41.88596491228068,8595.366594821722,91.4400701576779,8
4917,33.12600776302987,0,0,215,0.0,0.0,1.0,215,6500,4300,2200,0.6615384615384615,87,43,44,183.8942333112661,0.4411921321451859,0.7663024251925286,0.11370801307369459,1104523.5390973734,-8876.898120688778,1095646.6409766846,4915,1,1612.0,96,119,42,37.01449245228097,0.6092664930555556,41.76331615120273,8554.35039387428,89.10781660285708,0
4918,33.50748671532049,1,1,215,0.004629629629629629,0.004629629629629629,0.9953703703703703,216,5600,3600,2000,0.6428571428571429,76,36,40,182.9978382336702,0.44140826873385014,0.7666362986188311,0.11366230490352784,1118636.3383523508,-7858.393662378465,1110777.9446899723,4916,0,1605.5324074074074,80,136,43,36.87374541714361,0.6162760416666666,41.60236625514403,8658.25527997599,108.22819099969988,0
4919,33.3177951000988,0,0,215,0.0,0.0,1.0,215,6500,4500,2000,0.6923076923076923,85,45,40,185.02947167673045,0.4408280808519887,0.7666631671752204,0.11540394023652219,1113587.1497373986,-8290.711603618574,1105296.4381337801,4917,1,1613.9813953488372,82,133,42,36.66943756775556,0.6169969512195121,41.45331325301205,8614.20553284558,105.05128698592172,0
4920,33.0304096083179,1,1,215,0.004629629629629629,0.004629629629629629,0.9953703703703703,216,5600,4100,1500,0.7321428571428571,71,41,30,181.06165893178783,0.4410632895492392,0.7627877692601677,0.11358268537517749,1105739.2327810875,-8758.604033338746,1096980.6287477487,4918,0,1607.5046296296296,86,130,42,36.56259158144771,0.6176114341085271,41.247605363984675,8546.697581960709,99.38020444140359,0
4921,33.41818351323896,0,0,215,0.0,0.0,1.0,215,6000,4500,1500,0.75,75,45,30,185.4588294353647,0.4404468231543867,0.7682747648682802,0.1166747319359194,1119600.7068442989,-7472.0326947297945,1112128.6741495691,4919,1,1615.9023255813954,85,130,48,36.34515425888666,0.6189950980392157,41.145833333333336,8650.436044833214,101.76983582156721,0
4922,32.98344454648,0,0,215,0.0,0.0,1.0,215,5450,3500,1950,0.6422018348623854,74,35,39,186.73248166266188,0.4406505832065493,0.7694932748443695,0.11789327432467563,1106109.39232026,-7140.689636331655,1098968.7026839282,4920,2,1616.9023255813954,86,129,47,36.184119278779484,0.6199127906976745,41.02011494252874,8542.048677446888,99.32614741217311,0
4923,32.48585704558756,0,0,215,0.0,0.0,1.0,215,4700,3500,1200,0.7446808510638298,59,35,24,186.00628485171967,0.44049934796783313,0.7693560950210128,0.1176856763220554,1090058.0455316366,-7148.470535586508,1082909.57499605,4921,3,1617.9023255813954,87,128,41,36.12600906252378,0.6203304597701149,40.94460227272728,8415.636617456033,96.73145537305786,0
4924,32.951901105043234,0,1,214,0.0,0.004651162790697674,0.9953488372093023,215,7100,5600,1500,0.7887323943661971,86,56,30,188.1588261114269,0.44067322321234514,0.7718100018690073,0.11962506390003946,1107154.5141648646,-8435.821258154057,1098718.6929067106,4922,4,1618.9023255813954,90,125,41,35.896239954075774,0.6210648148148148,40.77380952380955,8541.9957924086,94.91106436009555,0
4925,33.32058833054886,0,1,213,0.0,0.004672897196261682,0.9953271028037384,214,5600,4000,1600,0.7142857142857143,72,40,32,190.6597127080658,0.4402866445819256,0.7729593173119316,0.12164959478531914,1120629.9465642676,-5668.203267199922,1114961.7432970677,4923,5,1627.3738317757009,90,124,41,35.70309396654462,0.622337962962963,40.6478937728938,8641.764764254263,96.01960849171404,0
4926,33.307093493284796,0,1,212,0.0,0.004694835680751174,0.9953051643192489,213,5750,3400,2350,0.591304347826087,81,34,47,194.16098473559043,0.4399821360025984,0.7751053070744256,0.1242098354404388,1120973.875440888,-4820.121696305528,1116153.7537445826,4924,8,1635.9906103286385,74,139,43,35.518156673804455,0.6295045045045045,40.55555555555554,8641.340367424405,116.77486983005953,0
4927,33.7262809190095,0,0,212,0.0,0.0,1.0,212,5650,3500,2150,0.6194690265486725,78,35,43,203.63900462035755,0.43957765134579274,0.7804561456577508,0.12014321112667155,1109641.8442587173,-2856.7278700113475,1106785.116388706,4925,9,1642.8207547169811,76,136,40,38.2556780227121,0.5989583333333333,43.47943722943723,8651.484561502413,113.83532317766333,8
4928,33.88419737349258,2,0,214,0.009345794392523364,0.0,1.0,214,6000,4800,1200,0.8,72,48,24,205.2307312824374,0.44048180568353,0.7827327986468176,0.1216451784877325,1116334.3067807246,-2978.7787727436753,1113355.528007981,4926,0,1628.4579439252336,79,135,42,38.03916844205474,0.5994198312236287,43.30729166666668,8697.826393503059,110.09906827219062,0
4929,33.51601987753245,2,0,216,0.009259259259259259,0.0,1.0,216,6200,4100,2100,0.6612903225806451,83,41,42,204.59173365156974,0.44145447530864196,0.7844131780201873,0.12201299763365646,1106157.7409960662,-4137.854015502078,1102019.886980564,4927,0,1614.3703703703704,83,133,46,37.82399362872868,0.6001506024096386,43.080357142857146,8610.923856928544,103.74607056540415,0
4930,33.6682253811598,1,1,216,0.004608294930875576,0.004608294930875576,0.9953917050691244,217,6100,4600,1500,0.7540983606557377,76,46,30,206.3666652299968,0.44189317005177225,0.7856289002987846,0.12365112297987291,1112678.5330181506,-3576.0483336075304,1109102.484684543,4928,0,1607.926267281106,88,129,38,37.60176712495072,0.6001420454545454,42.907303370786536,8655.854853962559,98.36198697684726,0
4931,33.92380925412672,0,1,215,0.0,0.004629629629629629,0.9953703703703703,216,6800,4900,1900,0.7205882352941176,87,49,38,208.029311384515,0.4414333907550962,0.7864568775059948,0.12487615663939283,1121712.985224056,-3330.1640225537294,1118382.8212015023,4929,1,1616.3657407407406,94,122,40,37.490228684319,0.5989583333333333,42.83991228070178,8723.849763564058,92.80691237834104,0
4932,34.13594580325747,2,0,217,0.009216589861751152,0.0,1.0,217,5600,4300,1300,0.7678571428571429,69,43,26,203.33367614720004,0.44207984866587013,0.7867313860248357,0.12198335948482833,1128531.6375026284,-3106.3026996340377,1125425.3348029943,4930,0,1609.89400921659,87,130,40,37.63373881753595,0.600933908045977,42.862215909090914,8777.641461697009,100.8924305942185,8
4933,34.36420713429233,3,1,219,0.013636363636363636,0.004545454545454545,0.9954545454545455,220,5750,4000,1750,0.6956521739130435,75,40,35,199.1204877179803,0.4433500242147503,0.7847955464910235,0.1205809813151859,1139113.2702188035,-4385.842013601959,1134727.4282052016,4931,0,1588.9272727272728,76,144,42,37.39196395733725,0.6086896929824561,42.51893939393937,8848.13249982388,116.4227960503142,0
4934,34.68737765364561,0,1,218,0.0,0.0045662100456621,0.995433789954338,219,5800,3800,2000,0.6551724137931034,78,38,40,198.39459183785164,0.4433666024325192,0.7835977229938527,0.12073586792598615,1151432.2620362036,-3912.4132688791788,1147519.8487673244,4932,1,1597.1689497716895,78,141,47,37.22728280708937,0.609642094017094,42.33913502109701,8937.57973008809,114.58435551394986,0
4935,34.39254520314124,0,2,216,0.0,0.009174311926605505,0.9908256880733946,218,6050,4200,1850,0.6942148760330579,79,42,37,195.57936625682268,0.44335197085641004,0.780815313163348,0.11947781155565596,1142874.1040583218,-4945.481403388186,1137928.6226549337,4933,2,1605.2798165137615,79,139,49,37.158494957657794,0.6106276371308017,42.200520833333314,8866.380240585799,112.23266127323795,0
4936,33.864863489361525,1,2,215,0.004608294930875576,0.009216589861751152,0.9907834101382489,217,5300,3400,1900,0.6415094339622641,72,34,38,191.35152832540828,0.44321858821186777,0.7776191796827894,0.11755248689334083,1127111.8013006693,-5565.08684550293,1121546.7144551664,4934,0,1612.6958525345622,84,133,40,37.060632688927896,0.6107390873015873,41.99754901960782,8737.217782371597,104.01449740918568,8
4937,34.142996060508914,0,2,213,0.0,0.009302325581395349,0.9906976744186047,215,5550,4100,1450,0.7387387387387387,70,41,29,193.11160882064743,0.44243552126349345,0.7778901375075513,0.11895652510592664,1137232.5746617652,-4627.437580764201,1132605.137081001,4935,4,1628.6837209302325,84,131,41,36.91528971400535,0.6117311507936508,41.899509803921546,8812.324019980062,104.90861928547693,0
4938,34.22293811031611,0,1,212,0.0,0.004694835680751174,0.9953051643192489,213,5900,4100,1800,0.6949152542372882,77,41,36,192.16532069688057,0.4420914902412378,0.7753645838266534,0.11856839496940273,1140418.5329627413,-4670.221376909873,1135748.3115858315,4936,5,1641.9906103286385,83,130,42,36.87934319659265,0.6127008032128514,41.840277777777764,8834.984196187477,106.44559272515033,0
4939,33.885594787414675,1,0,213,0.004694835680751174,0.0,1.0,213,5650,4100,1550,0.7256637168141593,72,41,31,189.63370307849266,0.44220590840641333,0.7731012226420224,0.11745529361218207,1130381.9995548094,-5378.295106230353,1125003.704448579,4937,0,1641.5633802816901,86,127,43,36.80439669957814,0.6130087209302326,41.702586206896534,8752.56149843023,101.77397091197942,0
4940,33.947487366032924,0,1,212,0.0,0.004694835680751174,0.9953051643192489,213,5450,3600,1850,0.6605504587155964,73,36,37,189.26777130313835,0.4422778811232173,0.7730577175388051,0.11790072429480516,1134243.5083803677,-5114.851810758641,1129128.656569609,4938,1,1642.5633802816901,73,140,44,36.605133231685194,0.620433789954338,41.49774774774777,8775.501942424453,120.21235537567743,0
4941,34.01819111718485,0,1,211,0.0,0.0047169811320754715,0.9952830188679245,212,6600,5000,1600,0.7575757575757576,82,50,32,189.04338157169914,0.44218298235416853,0.7721015518845715,0.11832073646587526,1138094.9797206768,-5970.135296765403,1132124.8444239113,4939,2,1651.2783018867924,76,136,45,36.43844900022666,0.6207510964912281,41.32846320346324,8799.537775320583,115.78339178053399,0
4942,34.34628370778104,0,0,211,0.0,0.0,1.0,211,5800,3900,1900,0.6724137931034483,77,39,38,187.98249651040246,0.4422054840893703,0.7696040413538248,0.11819484409246002,1150514.2017436263,-4744.693617111649,1145769.5081265147,4940,3,1657.5545023696682,76,135,44,36.30050175090159,0.6223958333333333,41.16612554112557,8889.981685348754,116.97344322827307,0
4943,34.550024987918825,0,1,210,0.0,0.004739336492890996,0.995260663507109,211,5700,4300,1400,0.7543859649122807,71,43,28,192.44946492271038,0.44210110584518164,0.775181129814239,0.12132683658170929,1158186.02578284,-3321.5438114260755,1154864.481971414,4941,4,1658.5545023696682,76,135,48,36.088362068965544,0.6233552631578947,41.07142857142859,8945.988612943318,117.7103764860963,0
4944,34.60567285636496,1,1,210,0.004739336492890996,0.004739336492890996,0.995260663507109,211,5700,3900,1800,0.6842105263157895,75,39,36,190.61209655515813,0.4423681636951779,0.7733170359336745,0.12069337811991522,1161434.0406056126,-3623.3245019268343,1157810.7161036858,4942,0,1658.4218009478673,81,130,40,35.97874274740543,0.6228137860082305,40.917174796747986,8965.735491686573,110.6880924899577,0
4945,34.116708710976106,0,1,209,0.0,0.004761904761904762,0.9952380952380953,210,6100,4300,1800,0.7049180327868853,79,43,36,193.58327313921828,0.4417122351332878,0.7763800024440122,0.12297986281588104,1146053.1813787173,-3728.654791418565,1142324.5265872988,4943,6,1667.3190476190475,82,128,41,35.78303797672654,0.6236026422764227,40.800702811244996,8843.026920278526,107.84179171071372,0
4946,33.62007498188098,0,0,209,0.0,0.0,1.0,209,5150,3000,2150,0.5825242718446602,73,30,43,197.51200600815542,0.4410233406943933,0.7800681591625371,0.1257485085754726,1130036.9041709446,-2310.8288387901853,1127726.0753321543,4944,7,1676.2344497607655,83,126,42,35.60319813787386,0.623995983935743,40.724206349206355,8716.8716235264,105.02254968104097,0
4947,33.85067915255899,0,0,209,0.0,0.0,1.0,209,5700,4200,1500,0.7368421052631579,72,42,30,199.78849826123727,0.44086998527787996,0.7822089941266086,0.1277150646104181,1139039.9405917716,-1986.5841619204343,1137053.3564298511,4945,8,1677.2344497607655,71,138,43,35.398715910992124,0.6307218309859155,40.5815972222222,8781.489118699821,123.68294533380029,0
4948,33.56015216684344,0,1,208,0.0,0.004784688995215311,0.9952153110047847,209,5200,4100,1100,0.7884615384615384,63,41,22,200.6456394380788,0.44070129431971533,0.782735867646142,0.12862679747833355,1130128.6188466372,-1648.9241248489934,1128479.6947217882,4946,9,1678.2344497607655,72,137,40,35.275196568977805,0.6312210648148149,40.48230593607304,8709.453302773665,120.9646292051898,0
4949,33.50902846489496,1,0,209,0.004784688995215311,0.0,1.0,209,5250,3600,1650,0.6857142857142857,69,36,33,197.59882705752995,0.440543146546436,0.7786693146083188,0.12733483326698175,1129990.1403808752,-2393.0547348333375,1127597.085646042,4947,0,1678.9234449760766,76,133,42,35.16868955218696,0.6311677631578947,40.30032467532466,8702.283812778485,114.50373437866428,0
4950,33.52004803960534,2,0,211,0.009478672985781991,0.0,1.0,211,5100,3600,1500,0.7058823529411765,66,36,30,201.7920813660591,0.4408843000075227,0.7851587526522086,0.1311356640622819,1132910.3777265453,-1577.5313754707972,1131332.8463510745,4948,0,1664.0,80,131,46,34.76127763763169,0.632421875,40.007716049382694,8714.953847951343,108.93692309939179,0
4951,32.97807600014726,1,2,210,0.0047169811320754715,0.009433962264150943,0.9905660377358491,212,6650,5200,1450,0.7819548872180451,81,52,29,201.1945724487313,0.4409017407374289,0.7864285451061337,0.13139237384406885,1116053.5998463423,-4141.214629809772,1111912.3852165325,4949,0,1657.1462264150944,81,131,36,34.60306803385415,0.6337448559670782,39.837398373983724,8579.662048818756,105.92175368912045,0
4952,33.3697887337141,1,0,211,0.004739336492890996,0.0,1.0,211,5600,3600,2000,0.6428571428571429,76,36,40,205.4428822100532,0.4404677273753103,0.7897524474840492,0.13456963017283835,1130208.4524184756,-1361.3436073971347,1128847.1088110786,4950,0,1665.649289099526,82,129,38,34.38695470472884,0.634400406504065,39.73393574297187,8685.023578812243,105.91492169283222,0
4953,33.64900266146982,0,1,210,0.0,0.004739336492890996,0.995260663507109,211,5950,4500,1450,0.7563025210084033,74,45,29,211.19448733374833,0.440177160911758,0.7944446625364023,0.1388446926629786,1140769.7560500836,34.85675896839166,1140804.612809052,4951,1,1666.649289099526,84,127,38,34.10850432981928,0.6349206349206349,39.60784313725489,8761.936379300341,104.30876642024216,0
4954,33.16806835411214,0,0,210,0.0,0.0,1.0,210,7100,5300,1800,0.7464788732394366,89,53,36,215.50287018863966,0.43965500873395613,0.7968487938231925,0.1422284992418679,1125617.0217380512,-585.2602164523778,1125031.7615215988,4952,2,1675.5666666666666,66,144,39,33.8601032404368,0.6447285353535354,39.47450248756218,8641.127509481585,130.92617438608463,0
4955,33.33599424937125,0,0,210,0.0,0.0,1.0,210,5950,4400,1550,0.7394957983193278,75,44,31,214.24130315239236,0.43951877800562006,0.7959611816754684,0.14202353937453277,1132632.7709236722,581.3441671583769,1133214.1150908307,4953,3,1676.5666666666666,67,143,40,33.738136863136894,0.6456778606965174,39.322916666666664,8689.92975094286,129.70044404392328,0
4956,33.66958350576677,0,0,210,0.0,0.0,1.0,210,5250,3400,1850,0.6476190476190476,71,34,37,213.3539102687196,0.43933697881066297,0.794590930455596,0.14202255925863488,1145208.0067252626,1616.9212611762678,1146824.9279864389,4954,4,1677.5666666666666,69,141,39,33.616883950476414,0.6459842995169083,39.18154761904763,8781.64866228535,127.27027046790363,0
4957,33.59229141823503,0,0,210,0.0,0.0,1.0,210,5800,4000,1800,0.6896551724137931,76,40,36,212.15846631079737,0.4390569226095542,0.7934536176416982,0.14193044436080826,1144060.1492153583,744.4093249666844,1144804.558540325,4955,5,1678.5666666666666,72,138,43,33.475487515946796,0.6461226851851851,39.01255707762559,8767.166239148422,121.76619776595031,0
4958,33.05151400432392,1,1,210,0.004739336492890996,0.004739336492890996,0.995260663507109,211,6100,4400,1700,0.7213114754098361,78,44,34,214.77850126086736,0.4388888888888889,0.7969993894106351,0.14466485828727885,1127632.000406914,138.22220423834187,1127770.2226111523,4956,0,1671.60663507109,77,134,41,33.17165132924335,0.6461038961038961,38.78205128205129,8633.648690232078,112.12530766535166,0
4959,32.62735571631674,1,0,211,0.004739336492890996,0.0,1.0,211,6900,4800,2100,0.6956521739130435,90,48,42,228.10714994241553,0.4388456330399458,0.8054285562140076,0.14650593238569617,1099272.8252446477,1050.398235140884,1100323.2234797885,4957,0,1672.4123222748815,69,142,36,34.495385232744795,0.6334541062801933,40.41666666666668,8469.517754693916,122.74663412599878,8
4960,32.65355427618858,1,0,212,0.0047169811320754715,0.0,1.0,212,6900,5000,1900,0.7246376811594203,88,50,38,224.37812257035142,0.4388725260067364,0.8027605876745694,0.14497384396125831,1101922.1089726947,149.44280601106857,1102071.5517787058,4958,0,1665.5188679245282,74,138,38,34.37917669072441,0.6330236486486487,40.208333333333336,8483.1212880015,114.63677416218242,0
4961,32.15384152408098,0,2,210,0.0,0.009433962264150943,0.9905660377358491,212,5950,4500,1450,0.7563025210084033,74,45,29,222.85411526523419,0.4386252198277147,0.8015395605576405,0.14453506983207573,1086158.271652591,60.968133430651505,1086219.2397860216,4959,1,1666.5188679245282,75,137,40,34.2842578921465,0.633888888888889,40.076754385964904,8357.530847898444,111.43374463864592,0
4962,32.04627801172115,0,0,210,0.0,0.0,1.0,210,5800,4600,1200,0.7931034482758621,70,46,24,222.37480743394377,0.4388385737069948,0.7995844410478561,0.14468669011563173,1083449.8601948905,386.3908050344021,1083836.250999925,4960,2,1678.1333333333334,78,132,34,34.183209945405075,0.6336805555555556,39.96571729957805,8333.130915996197,106.83501174354099,0
4963,32.12325917472877,0,0,210,0.0,0.0,1.0,210,6150,4600,1550,0.7479674796747967,77,46,31,220.127017668938,0.438599339257234,0.7978796523363865,0.14378417587587575,1087180.37833449,-286.44512980833133,1086893.9332046816,4961,3,1679.1333333333334,79,131,34,34.10370059890228,0.6346255274261603,39.83072916666666,8357.484916279347,105.79094830733351,0
4964,31.745242050524052,0,0,210,0.0,0.0,1.0,210,5000,3300,1700,0.66,67,33,34,219.00153835477772,0.4387113617376775,0.7987655889390002,0.1435960524081321,1075474.3899283593,106.10917109515549,1075580.4990994544,4962,4,1680.1333333333334,80,130,37,33.99844375277901,0.635546875,39.69907407407406,8263.315899494019,103.29144874367523,0
4965,31.857267881527992,0,0,210,0.0,0.0,1.0,210,5450,3800,1650,0.6972477064220184,71,38,33,220.67516350036564,0.4385684856079593,0.8005043219297585,0.1451273717226173,1080124.2381184432,221.31856949883831,1080345.556687942,4963,5,1681.1333333333334,81,129,38,33.84956786509911,0.6361882716049383,39.596036585365844,8295.758819911589,102.41677555446407,0
4966,31.435083860587028,0,1,209,0.0,0.004761904761904762,0.9952380952380953,210,7000,5600,1400,0.8,84,56,28,221.81080727114576,0.4386159527606896,0.8023023948154802,0.14612356280632635,1066290.268792535,-1697.0589387522873,1064593.2098537826,4964,6,1682.1333333333334,67,143,38,33.76003499382458,0.6435012437810945,39.53737745098038,8187.664382376836,122.20394600562442,0
4967,31.314266679085044,0,1,208,0.0,0.004784688995215311,0.9952153110047847,209,5200,4100,1100,0.7884615384615384,63,41,22,219.07110806217304,0.4380089482885536,0.7984557373222969,0.14456381035976104,1062666.9346351102,-440.07542569072666,1062226.8592094195,4965,7,1685.244019138756,69,140,39,33.771907903505266,0.6429649758454106,39.479166666666664,8158.018850457464,118.23215725300673,0
4968,31.837649307399207,0,0,208,0.0,0.0,1.0,208,5900,3700,2200,0.6271186440677966,81,37,44,217.90374630471678,0.43740419453734675,0.7955089417632439,0.14420713026940346,1081244.3644025219,-378.5604651656713,1080865.8039373562,4966,8,1684.4615384615386,71,137,39,33.7017967506754,0.6428990610328639,39.38078703703703,8297.50310508519,116.86624091669282,0
4969,31.55414601875804,1,1,208,0.004784688995215311,0.004784688995215311,0.9952153110047847,209,5750,3900,1850,0.6782608695652174,76,39,37,231.90662058392718,0.437458785731812,0.8067971139425862,0.14217438898797277,1049600.9790852508,1131.8832042482263,1050732.862289499,4967,0,1677.3971291866028,71,138,37,36.09023259292499,0.6156103286384976,42.07175925925925,8138.705370694697,114.62965310837602,8
4970,31.67128026347797,2,2,208,0.009523809523809525,0.009523809523809525,0.9904761904761905,210,5900,4300,1600,0.7288135593220338,75,43,32,227.40253246470576,0.4384275081643503,0.8036780789528919,0.14007906734847445,1054903.5160513506,77.54621119973854,1054981.0622625505,4968,0,1647.2380952380952,75,135,40,36.030404209371085,0.6154166666666667,41.89967105263157,8174.367854187938,108.9915713891725,0
4971,31.840478486444105,0,0,208,0.0,0.0,1.0,208,5750,4200,1550,0.7304347826086957,73,42,31,230.68106512705944,0.4378478996345844,0.8038411602263524,0.14265973073479743,1061705.271181967,1633.0605614537167,1063338.3317434208,4969,1,1661.3557692307693,79,129,40,35.80065421267584,0.6151107594936709,41.757812499999986,8222.55481538598,104.08297234665797,0
4972,32.161791020671224,0,0,208,0.0,0.0,1.0,208,7300,5400,1900,0.7397260273972602,92,54,38,233.4806674258559,0.4379466082930757,0.8066394861305215,0.14513521518147338,1073951.6126375769,1249.3878603394132,1075201.0004979162,4970,2,1662.3557692307693,66,142,38,35.53962118477521,0.6234217171717171,41.57338308457714,8311.46284741294,125.93125526383243,0
4973,32.05091008144962,0,1,207,0.0,0.004807692307692308,0.9951923076923077,208,6300,4400,1900,0.6984126984126984,82,44,38,229.25424188407982,0.43793499550972376,0.8024481476308523,0.143072831408111,1071421.05061746,1225.5641395904713,1072646.6147570503,4971,3,1663.3557692307693,70,138,39,35.504142078983236,0.6226190476190476,41.43192488262914,8287.342125520436,118.39060179314909,0
4974,32.014922538740905,0,0,207,0.0,0.0,1.0,207,5500,3600,1900,0.6545454545454545,74,36,38,209.0475985896421,0.43775307599706076,0.7868695246083186,0.12753140482007158,1063456.689896955,-2437.3865545903336,1061019.3033423645,4972,4,1670.6425120772947,74,133,40,36.861798146351965,0.6123310810810811,42.25,8251.846284360465,111.51143627514142,8
4975,32.21749491889489,1,0,208,0.004807692307692308,0.0,1.0,208,5750,4100,1650,0.7130434782608696,74,41,33,208.6993311660527,0.438173057568438,0.7882644121254594,0.1280570610166288,1071925.2348344042,-2607.9840860091604,1069317.250748395,4973,0,1663.6057692307693,77,131,37,36.657002830123524,0.6130952380952381,42.04059829059829,8310.805713853819,107.93254173836128,0
4976,32.394228735033984,1,0,209,0.004784688995215311,0.0,1.0,209,4100,2600,1500,0.6341463414634146,56,26,30,207.13150550036542,0.4382763617960987,0.7888880228314978,0.12773427680211463,1079318.7310840362,-1187.8172631639454,1078130.9138208723,4974,0,1656.641148325359,80,129,39,36.512666268121365,0.613671875,41.85956790123456,8362.260203167903,104.5282525395988,0
4977,31.882132460605096,1,0,210,0.004761904761904762,0.0,1.0,210,6000,4300,1700,0.7166666666666667,77,43,34,206.96170363439666,0.4389714817346397,0.789417145715805,0.12805680339212416,1063246.289046809,-3989.7473271846034,1059256.5417196245,4975,0,1649.747619047619,85,125,40,36.39433449019791,0.6129901960784314,41.73934108527131,8233.90053688252,96.86941808097083,0
4978,31.403585819007976,2,2,210,0.009433962264150943,0.009433962264150943,0.9905660377358491,212,6300,4400,1900,0.6984126984126984,82,44,38,200.9147873414294,0.43972389266446094,0.7854133710898878,0.12502705081575335,1048948.0750775877,-6550.164112716772,1042397.910964871,4976,0,1635.1745283018868,70,142,42,36.34167281602999,0.621577380952381,41.53462441314556,8116.739603483951,115.95342290691359,0
4979,31.831699216586482,0,0,210,0.0,0.0,1.0,210,5200,3100,2100,0.5961538461538461,73,31,42,199.25284023610848,0.4383700729095466,0.7817599305150351,0.12438861381557724,1064185.356363313,-4791.609041386846,1059393.7473219263,4977,1,1651.6714285714286,71,139,42,36.26845194800348,0.622212441314554,41.4207175925926,8231.017941233391,115.92983015821677,0
4980,31.974652857439807,0,1,209,0.0,0.004761904761904762,0.9952380952380953,210,6750,5300,1450,0.7851851851851852,82,53,29,197.47893144157712,0.438342541960963,0.7794865895681866,0.12377649848229187,1070146.679118834,-6483.715464371908,1063662.963654462,4978,2,1652.6714285714286,74,136,39,36.16855897931429,0.6221846846846847,41.27777777777779,8272.553242060989,111.7912600278512,0
4981,32.10046259434321,1,0,210,0.004761904761904762,0.0,1.0,210,5200,4000,1200,0.7692307692307693,64,40,24,198.3813370708158,0.4387369940001519,0.7807015992552679,0.12499249209593521,1075897.366489078,-4512.408376985202,1071384.9581120927,4979,0,1635.7714285714285,77,133,47,35.95617123158131,0.6227002164502164,41.09241452991455,8311.053262774247,107.9357566594058,0
4982,32.00431285427843,0,1,209,0.0,0.004761904761904762,0.9952380952380953,210,5650,3900,1750,0.6902654867256637,74,39,35,195.28377024389283,0.4386145287461077,0.7773242174408461,0.12339849929134498,1073527.001994333,-5721.519918384363,1067805.4820759487,4980,1,1636.7714285714285,79,131,38,35.93153026342249,0.6228902953586498,40.98958333333336,8289.450407517072,104.92975199388698,0
4983,32.04826677826266,1,1,209,0.004761904761904762,0.004761904761904762,0.9952380952380953,210,6450,4300,2150,0.6666666666666666,86,43,43,197.20062412537376,0.43865724918356497,0.7810328411199865,0.12536715578053598,1076778.3112046397,-5981.7289971556365,1070796.5822074842,4981,0,1635.2428571428572,82,128,42,35.663681110304225,0.6238567073170731,40.77560240963857,8307.692649410379,101.3133249928095,0
4984,32.025415491983715,0,1,208,0.0,0.004784688995215311,0.9952153110047847,209,5700,3700,2000,0.6491228070175439,77,37,40,195.30881101617626,0.43821885351490614,0.7777263907262049,0.12474854551866792,1077381.3483181603,-5415.585969795347,1071965.762348365,4982,1,1643.488038277512,71,138,43,35.54442755684454,0.6304284037558685,40.61053240740738,8307.055473897175,117.00078132249543,0
4985,32.394120188016075,0,1,207,0.0,0.004807692307692308,0.9951923076923077,208,5600,3600,2000,0.6428571428571429,76,36,40,198.45027999784256,0.4378987055617491,0.7811045348159378,0.12686181673614752,1090033.3924164143,-3936.5136135930143,1086096.8788028213,4983,2,1652.360576923077,70,138,43,35.4328083173095,0.63125,40.580985915492946,8403.650721310123,120.05215316157319,0
4986,31.964825447032833,1,0,208,0.004807692307692308,0.0,1.0,208,5750,4000,1750,0.6956521739130435,75,40,35,197.5827372156233,0.43844934503901895,0.7798189530053561,0.1270647142679547,1077324.8140533862,-4777.842873804072,1072546.9711795822,4984,0,1651.1826923076924,73,135,43,35.241813055736294,0.6318493150684932,40.37162162162161,8298.975795961023,113.68459994467155,0
4987,32.031160474611056,0,0,208,0.0,0.0,1.0,208,5700,3900,1800,0.6842105263157895,75,39,36,194.24426763605916,0.43813289669267935,0.7761698443771801,0.12545389440141008,1080803.325662834,-5312.029909601271,1075491.295753233,4985,1,1652.1826923076924,74,134,44,35.17618780296549,0.6328828828828829,40.22222222222221,8320.983687737817,112.4457255099705,0
4988,32.20621913274865,0,0,208,0.0,0.0,1.0,208,4950,3500,1450,0.7070707070707071,64,35,29,200.0115913524854,0.43823112148519755,0.7822433520437095,0.12745042416055907,1082769.3337379277,-3236.716498281046,1079532.6172396466,4986,2,1653.1826923076924,90,118,41,35.507254373960805,0.621875,40.693681318681335,8351.276121956947,92.79195691063275,8
4989,32.66060560984147,0,0,208,0.0,0.0,1.0,208,5700,3900,1800,0.6842105263157895,75,39,36,202.14950544728893,0.43781499674842067,0.7847789040612387,0.1293385918338887,1099257.8990077388,-2857.111871312101,1096400.7871364267,4987,3,1654.1826923076924,69,139,43,35.305838351973996,0.6320954106280193,40.55059523809522,8473.774684636655,122.80832876285008,0
4990,32.3543420884477,1,0,209,0.004784688995215311,0.0,1.0,209,6100,4400,1700,0.7213114754098361,78,44,34,176.0798153718406,0.4381795561894246,0.7538041258229136,0.11083302873588663,1084116.7730904499,-9721.783750542972,1074394.989339907,4988,0,1647.2631578947369,82,127,47,36.56877716908261,0.6202997967479675,41.12700803212856,8375.665339588604,102.14226023888541,8
4991,32.164257769405886,0,1,208,0.0,0.004784688995215311,0.9952153110047847,209,6150,4100,2050,0.6666666666666666,82,41,41,179.97380803765859,0.4380865844681634,0.7575553798543113,0.11359637130979197,1078560.2856630483,-9127.479638206823,1069432.8060248415,4989,1,1648.2631578947369,84,125,37,36.368619471260004,0.6205357142857143,41.02941176470591,8329.596754694752,99.16186612731848,0
4992,31.866802339743174,0,1,207,0.0,0.004807692307692308,0.9951923076923077,208,5000,3500,1500,0.7,65,35,30,178.0606163549897,0.43781838381023164,0.7541908957923182,0.11266157944113026,1069293.8054454944,-8520.17718756027,1060773.628257934,4990,2,1645.360576923077,84,124,39,36.330853714303736,0.6214037698412698,40.94362745098042,8255.298218870557,98.27735974845902,0
4993,32.213442266773384,2,0,209,0.009569377990430622,0.0,1.0,209,5200,3900,1300,0.75,65,39,26,171.468676339078,0.43873546957428533,0.7462253901729732,0.10925517230610472,1082992.6166151895,-9860.137908799405,1073132.4787063901,4991,0,1620.5215311004786,87,122,44,36.24977175203143,0.6228448275862069,40.69602272727276,8353.073701419813,96.01234139563003,0
4994,32.41492466088586,1,0,210,0.004761904761904762,0.0,1.0,210,6250,5000,1250,0.8,75,50,25,173.03137681437764,0.43850060757955495,0.748628004686896,0.11064211737972615,1090812.530627521,-10501.041195829079,1080311.4894316918,4992,0,1613.8,77,133,45,36.08265554754796,0.6279761904761905,40.57158119658118,8409.352650405515,109.21237208318851,0
4995,31.964892158879486,1,0,211,0.004739336492890996,0.0,1.0,211,6600,5100,1500,0.7727272727272727,81,51,30,189.7419795430953,0.4386246520725194,0.7691617691699748,0.11619181998168965,1062923.0553667566,-8463.775074543571,1054459.280292213,4993,0,1607.1469194312797,83,128,49,37.21989805731869,0.6099397590361446,42.11309523809521,8243.327099901446,99.31719397471622,8
4996,31.513672533604733,1,0,212,0.0047169811320754715,0.0,1.0,212,5350,3300,2050,0.616822429906542,74,33,41,194.1206865575228,0.4387151070076604,0.776139362665931,0.11951646383168761,1049504.017112308,-7003.911930656273,1042500.1051816517,4994,0,1600.561320754717,86,126,43,36.90819995360704,0.610828488372093,41.91810344827584,8133.108374782643,94.57102761375167,0
4997,31.253246691823865,1,1,212,0.004694835680751174,0.004694835680751174,0.9953051643192489,213,6400,4800,1600,0.75,80,48,32,192.41734734120553,0.43906771340833256,0.7760656752048052,0.11922008386370721,1042668.9406200019,-8874.481658166987,1033794.4589618349,4995,0,1594.0422535211267,87,126,45,36.72001496960252,0.6127873563218391,41.69034090909089,8073.015498449065,92.79328159136855,0
4998,30.851548764329326,0,0,212,0.0,0.0,1.0,212,6350,4900,1450,0.7716535433070866,78,49,29,196.0525149563843,0.4384743211422099,0.7794238833123606,0.12169975198491781,1029802.1416219078,-8370.940045510608,1021431.2015763972,4996,1,1602.5424528301887,71,141,40,36.55772299680834,0.6201584507042254,41.62326388888891,7971.322473700238,112.27214751690477,0
4999,30.73927475888122,1,0,213,0.004694835680751174,0.0,1.0,213,6700,4700,2000,0.7014925373134329,87,47,40,193.23866926690917,0.43872814982136,0.7773923626268169,0.12060088185524878,1027585.638174242,-9586.143744284132,1017999.4944299578,4997,0,1596.0140845070423,74,139,47,36.43399401980266,0.6206362612612613,41.43055555555558,7948.237197029106,107.4086107706636,0
5000,30.858803700916965,0,0,213,0.0,0.0,1.0,213,5600,4300,1300,0.7678571428571429,69,43,26,190.56446484780102,0.43864141347033986,0.7751203405983138,0.11963595825643634,1033260.2163365121,-8819.463965061514,1024440.7523714507,4998,1,1597.0140845070423,76,137,47,36.288815411155866,0.6218475877192983,41.22023809523812,7985.633874389146,105.07412992617297,0
